Cód Cir;Cód Con;Concello;Mesa;Censo;Certif Alta;Censo Total;Votos Totais;Votos nulos;Votos brancos;Abstención;Votos Válidos;Votos Candidaturas;BNG;DO;ECG;ESCANOS EN BRANCO;PACMA;PODEMOS-ALIANZA VERDE;PP;PSdeG-PSOE;PUM+J;SUMAR GALICIA;VOX
32;3;A Arnoia;01-001-A;221;0;221;173;3;1;48;170;169;26;4;0;0;0;0;100;39;0;0;0
32;3;A Arnoia;01-001-B;643;0;643;471;2;1;172;469;468;110;9;0;1;0;0;296;49;0;1;2
32;14;A Bola;01-001-A;210;0;210;158;1;0;52;157;157;43;2;0;1;1;0;98;10;0;0;2
32;14;A Bola;01-001-B;430;0;430;325;1;0;105;324;324;69;12;2;0;0;1;209;22;0;0;9
32;14;A Bola;01-001-C;311;0;311;240;0;1;71;240;239;60;5;0;0;1;0;161;11;0;0;1
32;34;A Gudiña;01-001-A;577;0;577;414;4;5;163;410;405;112;7;0;1;0;0;206;70;0;3;6
32;34;A Gudiña;01-001-B;415;0;415;305;2;1;110;303;302;68;4;0;0;0;0;163;61;0;1;5
32;47;A Merca;01-001-A;329;0;329;234;0;0;95;234;234;36;17;0;1;0;0;154;22;0;0;4
32;47;A Merca;01-001-B;363;0;363;264;0;0;99;264;264;68;16;0;0;0;0;159;18;0;1;2
32;47;A Merca;01-001-C;361;0;361;270;0;1;91;270;269;45;9;0;0;0;0;193;19;0;0;3
32;47;A Merca;01-002-U;660;0;660;474;1;0;186;473;473;136;41;1;0;2;0;244;38;0;4;7
32;48;A Mezquita;01-001-A;577;0;577;366;1;0;211;365;365;133;9;0;0;0;1;159;60;0;0;3
32;48;A Mezquita;01-001-B;234;0;234;141;2;0;93;139;139;44;0;2;0;0;0;56;33;0;0;4
32;59;A Peroxa;01-001-A;287;0;287;205;1;0;82;204;204;54;8;0;0;1;0;110;27;0;0;4
32;59;A Peroxa;01-001-B;284;0;284;228;3;2;56;225;223;32;38;1;0;0;0;121;30;0;0;1
32;59;A Peroxa;02-001-A;568;0;568;354;2;3;214;352;349;54;22;0;0;3;0;226;39;0;1;4
32;59;A Peroxa;02-001-B;211;0;211;168;0;2;43;168;166;23;12;0;0;0;0;89;41;0;0;1
32;59;A Peroxa;02-001-C;243;0;243;188;0;0;55;188;188;26;14;0;1;0;0;126;13;0;1;7
32;63;A Pobra de Trives;01-001-A;570;0;570;402;3;4;168;399;395;79;10;1;3;1;0;208;88;0;0;5
32;63;A Pobra de Trives;01-001-B;467;0;467;323;1;5;144;322;317;82;7;0;1;1;0;136;82;0;3;5
32;63;A Pobra de Trives;01-002-A;331;0;331;215;1;0;116;214;214;53;2;0;0;0;0;104;50;0;2;3
32;63;A Pobra de Trives;01-002-B;345;0;345;223;2;4;122;221;217;27;5;0;0;1;0;128;50;0;1;5
32;72;A Rúa;01-001-A;485;0;485;323;5;2;162;318;316;90;7;0;0;1;0;167;40;0;2;9
32;72;A Rúa;01-001-B;433;0;433;296;3;2;137;293;291;56;9;0;0;0;0;176;40;0;4;6
32;72;A Rúa;01-002-U;596;0;596;389;8;3;207;381;378;97;8;2;0;0;0;200;63;0;2;6
32;72;A Rúa;01-003-U;638;0;638;380;0;1;258;380;379;111;9;0;0;0;0;189;60;0;7;3
32;72;A Rúa;01-004-U;526;0;526;342;3;2;184;339;337;99;5;0;0;2;0;156;61;0;2;12
32;72;A Rúa;01-005-A;425;0;425;275;1;4;150;274;270;78;7;0;0;0;0;123;53;1;3;5
32;72;A Rúa;01-005-B;403;0;403;264;4;1;139;260;259;86;6;0;0;2;1;117;41;0;2;4
32;80;A Teixeira;01-001-U;303;0;303;230;2;2;73;228;226;79;10;0;0;0;0;115;13;0;4;5
32;83;A Veiga;01-001-A;488;0;488;315;4;0;173;311;311;54;2;0;0;0;0;199;50;1;2;3
32;83;A Veiga;01-001-B;312;0;312;209;1;0;103;208;208;51;2;0;1;0;0;137;13;0;1;3
32;1;Allariz;01-001-A;865;0;865;613;7;5;252;606;601;351;21;0;1;1;2;175;41;0;5;4
32;1;Allariz;01-001-B;813;0;813;594;3;4;219;591;587;341;21;0;0;2;1;170;37;0;9;6
32;1;Allariz;01-002-A;260;0;260;169;1;2;91;168;166;82;9;0;0;1;0;59;12;0;0;3
32;1;Allariz;01-002-B;320;0;320;210;3;0;110;207;207;107;8;0;0;0;1;76;13;0;0;2
32;1;Allariz;01-002-C;317;0;317;215;0;0;102;215;215;114;3;0;1;0;0;88;7;0;0;2
32;1;Allariz;01-003-A;518;0;518;388;1;3;130;387;384;210;16;1;0;1;0;124;26;0;3;3
32;1;Allariz;01-003-B;539;0;539;395;4;6;144;391;385;226;17;0;0;0;0;113;26;0;2;1
32;1;Allariz;01-003-C;560;0;560;417;8;2;143;409;407;215;14;0;2;0;0;137;29;1;4;5
32;1;Allariz;02-001-A;655;0;655;427;3;5;228;424;419;167;21;0;0;0;0;180;39;1;6;5
32;1;Allariz;02-001-B;368;0;368;208;3;0;160;205;205;82;6;0;0;0;0;107;7;0;1;2
32;2;Amoeiro;01-001-A;506;10;516;349;0;1;167;349;348;68;30;1;2;0;1;181;60;0;0;5
32;2;Amoeiro;01-001-B;428;0;428;285;2;1;143;283;282;56;30;1;0;0;1;139;48;0;1;6
32;2;Amoeiro;01-001-C;369;0;369;256;0;2;113;256;254;74;31;1;0;0;0;98;46;0;0;4
32;2;Amoeiro;01-002-A;259;0;259;193;0;1;66;193;192;39;15;0;0;0;0;105;29;0;1;3
32;2;Amoeiro;01-002-B;271;0;271;195;0;1;76;195;194;41;26;0;0;1;0;78;40;0;0;8
32;2;Amoeiro;01-002-C;252;0;252;179;0;1;73;179;178;36;18;0;0;1;0;83;37;0;1;2
32;4;Avión;01-001-A;607;0;607;330;1;3;277;329;326;25;9;0;0;0;0;264;15;0;1;12
32;4;Avión;01-001-B;475;0;475;227;0;0;248;227;227;19;0;0;0;1;0;192;7;0;0;8
32;4;Avión;01-001-C;450;0;450;228;1;0;222;227;227;6;0;0;0;0;0;205;9;0;0;7
32;5;Baltar;01-001-A;322;0;322;229;0;2;93;229;227;49;11;0;0;1;0;147;18;0;0;1
32;5;Baltar;01-001-B;200;0;200;148;3;0;52;145;145;23;7;0;1;0;0;105;7;0;0;2
32;5;Baltar;01-001-C;221;0;221;182;1;0;39;181;181;14;5;0;0;0;0;139;22;0;0;1
32;6;Bande;01-001-A;713;0;713;536;5;6;177;531;525;82;8;1;0;0;1;374;50;1;1;7
32;6;Bande;01-001-B;213;0;213;156;0;0;57;156;156;21;6;0;0;0;1;106;21;0;0;1
32;6;Bande;01-001-C;208;0;208;143;1;1;65;142;141;26;2;0;0;0;0;86;23;0;1;3
32;6;Bande;01-001-D;205;0;205;159;0;0;46;159;159;23;0;1;0;0;0;114;18;0;0;3
32;8;Barbadás;01-001-A;940;0;940;616;2;9;324;614;605;161;95;1;1;1;3;254;69;0;4;16
32;8;Barbadás;01-001-B;918;0;918;617;3;5;301;614;609;190;80;1;1;1;1;252;66;0;2;15
32;8;Barbadás;01-002-A;825;0;825;529;0;1;296;529;528;155;79;1;0;3;0;199;77;0;6;8
32;8;Barbadás;01-002-B;474;0;474;241;0;4;233;241;237;50;32;0;0;1;0;123;27;2;1;1
32;8;Barbadás;01-002-C;286;0;286;205;2;0;81;203;203;50;16;2;0;0;0;88;42;0;1;4
32;8;Barbadás;01-003-A;598;0;598;394;5;3;204;389;386;125;42;0;0;3;2;162;48;0;1;3
32;8;Barbadás;01-003-B;607;0;607;384;7;1;223;377;376;117;51;0;0;3;2;165;30;0;6;2
32;8;Barbadás;01-004-A;382;0;382;293;3;0;89;290;290;63;32;0;0;0;1;182;11;0;0;1
32;8;Barbadás;01-004-B;663;0;663;462;2;3;201;460;457;147;90;0;0;2;0;170;38;0;5;5
32;8;Barbadás;01-004-C;654;0;654;420;5;5;234;415;410;141;64;0;1;1;0;148;47;2;1;5
32;8;Barbadás;01-005-A;794;0;794;540;5;0;254;535;535;146;73;0;1;1;1;249;42;0;9;13
32;8;Barbadás;01-005-B;740;0;740;498;4;4;242;494;490;143;68;0;1;3;2;205;52;1;5;10
32;8;Barbadás;02-001-A;415;0;415;287;2;3;128;285;282;78;20;0;0;1;0;148;24;0;3;8
32;8;Barbadás;02-001-B;478;0;478;346;3;3;132;343;340;75;26;0;1;0;0;164;64;0;4;6
32;7;Baños de Molgas;01-001-A;486;0;486;346;0;2;140;346;344;108;15;0;0;0;0;184;37;0;0;0
32;7;Baños de Molgas;01-001-B;384;0;384;254;2;0;130;252;252;65;16;0;0;2;0;151;16;1;0;1
32;7;Baños de Molgas;01-001-C;506;0;506;334;0;1;172;334;333;66;14;0;0;1;0;220;23;0;9;0
32;10;Beade;01-001-U;325;0;325;246;1;3;79;245;242;56;4;1;0;0;0;134;43;0;0;4
32;11;Beariz;01-001-A;648;0;648;348;4;1;300;344;343;33;3;0;0;0;0;292;9;0;4;2
32;11;Beariz;01-001-B;231;0;231;130;3;0;101;127;127;15;0;0;0;0;0;103;4;0;1;4
32;13;Boborás;01-001-A;437;0;437;317;0;1;120;317;316;54;7;0;0;0;0;214;32;0;0;9
32;13;Boborás;01-001-B;425;0;425;324;0;2;101;324;322;36;8;1;0;0;0;252;20;0;2;3
32;13;Boborás;02-001-U;575;0;575;342;2;1;233;340;339;25;5;0;1;0;0;275;24;0;3;6
32;13;Boborás;03-001-U;505;0;505;357;1;0;148;356;356;62;12;2;0;1;0;241;33;0;0;5
32;16;Calvos de Randín;01-001-A;205;0;205;141;1;0;64;140;140;23;6;0;0;0;0;61;48;0;0;2
32;16;Calvos de Randín;01-001-B;206;0;206;157;1;1;49;156;155;15;3;0;1;0;0;49;86;0;0;1
32;16;Calvos de Randín;01-001-C;201;0;201;133;2;1;68;131;130;15;4;0;0;0;1;49;60;0;0;1
32;18;Carballeda de Avia;01-001-A;536;0;536;374;4;4;162;370;366;86;10;1;1;0;2;176;83;0;1;6
32;18;Carballeda de Avia;01-001-B;210;0;210;161;1;0;49;160;160;26;2;0;0;0;0;73;57;0;0;2
32;18;Carballeda de Avia;01-001-C;354;0;354;268;5;1;86;263;262;36;7;0;0;1;0;129;83;0;0;6
32;17;Carballeda de Valdeorras;01-001-A;232;0;232;161;0;1;71;161;160;15;1;0;0;0;0;129;13;0;1;1
32;17;Carballeda de Valdeorras;01-001-B;251;0;251;189;2;0;62;187;187;29;2;10;0;1;0;118;22;0;1;4
32;17;Carballeda de Valdeorras;01-001-C;585;0;585;384;1;1;201;383;382;48;5;4;0;0;1;266;49;0;1;8
32;20;Cartelle;01-001-U;635;0;635;465;0;2;170;465;463;96;21;0;0;0;0;282;58;0;1;5
32;20;Cartelle;01-002-A;538;0;538;423;3;3;115;420;417;84;12;0;0;0;0;271;47;0;1;2
32;20;Cartelle;01-002-B;214;0;214;154;0;0;60;154;154;48;5;0;0;0;0;95;5;0;0;1
32;20;Cartelle;01-002-C;290;0;290;216;0;0;74;216;216;66;4;0;0;0;0;124;18;0;2;2
32;20;Cartelle;01-004-A;419;0;419;310;0;0;109;310;310;63;21;0;0;1;0;187;33;0;0;5
32;20;Cartelle;01-004-B;213;0;213;149;0;0;64;149;149;26;5;0;0;0;0;109;7;0;0;2
32;22;Castrelo de Miño;01-001-A;353;0;353;268;1;3;85;267;264;76;7;0;0;1;0;139;40;0;0;1
32;22;Castrelo de Miño;01-001-B;329;0;329;253;4;3;76;249;246;52;4;0;0;0;0;142;46;0;0;2
32;22;Castrelo de Miño;01-001-C;510;0;510;358;2;2;152;356;354;90;11;0;0;1;1;190;54;0;2;5
32;21;Castrelo do Val;01-001-A;428;0;428;304;2;4;124;302;298;73;8;0;2;5;1;128;75;0;2;4
32;21;Castrelo do Val;01-001-B;227;0;227;163;0;2;64;163;161;37;0;0;0;0;0;63;59;0;0;2
32;21;Castrelo do Val;01-001-C;202;0;202;143;1;0;59;142;142;36;1;0;0;0;0;66;37;0;1;1
32;23;Castro Caldelas;01-001-A;594;0;594;438;4;1;156;434;433;89;12;0;0;1;0;234;78;1;2;16
32;23;Castro Caldelas;01-001-B;244;0;244;167;2;0;77;165;165;14;10;0;0;3;0;96;40;0;0;2
32;23;Castro Caldelas;01-001-C;263;0;263;185;2;1;78;183;182;40;6;0;0;1;0;100;33;0;0;2
32;24;Celanova;01-001-A;883;0;883;576;4;1;307;572;571;152;34;1;0;1;1;304;69;0;2;7
32;24;Celanova;01-001-B;838;0;838;562;2;7;276;560;553;148;25;0;0;3;0;310;60;0;0;7
32;24;Celanova;01-002-A;738;0;738;515;3;7;223;512;505;135;30;1;1;1;0;265;64;0;4;4
32;24;Celanova;01-002-B;681;0;681;471;4;2;210;467;465;157;20;0;0;0;0;228;50;0;1;9
32;24;Celanova;02-001-A;378;0;378;262;1;2;116;261;259;73;14;0;0;0;0;144;23;0;0;5
32;24;Celanova;02-001-B;239;0;239;170;1;2;69;169;167;29;14;1;0;0;1;97;22;0;0;3
32;24;Celanova;02-001-C;364;0;364;246;0;1;118;246;245;69;15;0;0;0;0;125;26;0;2;8
32;24;Celanova;03-001-A;334;0;334;245;0;0;89;245;245;39;8;0;1;0;1;177;12;0;0;7
32;24;Celanova;03-001-B;286;0;286;178;0;0;108;178;178;37;4;0;0;0;0;113;23;0;0;1
32;25;Cenlle;01-001-A;259;0;259;202;2;0;57;200;200;66;7;8;0;3;0;99;10;0;3;4
32;25;Cenlle;01-001-B;238;0;238;195;2;0;43;193;193;41;3;0;0;0;0;125;22;0;0;2
32;25;Cenlle;01-001-C;439;0;439;333;7;1;106;326;325;79;6;1;0;0;0;206;30;0;2;1
32;29;Chandrexa de Queixa;01-001-A;201;0;201;147;2;0;54;145;145;21;5;0;0;0;0;103;13;0;0;3
32;29;Chandrexa de Queixa;01-001-B;256;0;256;157;1;0;99;156;156;26;4;0;0;0;0;109;17;0;0;0
32;26;Coles;01-001-A;455;1;456;314;0;2;142;314;312;88;35;0;0;1;0;133;38;0;9;8
32;26;Coles;01-001-B;467;0;467;287;2;2;180;285;283;77;31;0;0;2;0;120;50;0;1;2
32;26;Coles;02-001-A;353;0;353;259;1;1;94;258;257;50;24;0;0;0;0;133;48;0;0;2
32;26;Coles;02-001-B;224;0;224;168;1;4;56;167;163;43;16;0;1;0;3;76;19;0;2;3
32;26;Coles;02-002-A;472;0;472;318;2;4;154;316;312;75;28;0;0;2;0;152;48;0;3;4
32;26;Coles;02-002-B;513;0;513;357;2;0;156;355;355;82;38;0;1;1;0;163;68;0;1;1
32;26;Coles;02-002-C;270;0;270;179;2;0;91;177;177;37;17;0;0;1;0;87;32;0;0;3
32;27;Cortegada;01-001-A;496;0;496;358;4;2;138;354;352;66;19;0;1;0;0;222;38;0;2;4
32;27;Cortegada;01-001-B;212;0;212;159;2;0;53;157;157;14;2;0;0;0;4;115;20;0;0;2
32;27;Cortegada;01-001-C;211;0;211;162;0;2;49;162;160;32;9;0;0;0;0;108;10;0;0;1
32;28;Cualedro;01-001-A;380;0;380;251;1;0;129;250;250;34;5;0;0;0;0;181;21;0;0;9
32;28;Cualedro;01-001-B;371;0;371;289;1;0;82;288;288;36;12;0;0;0;0;217;20;0;0;3
32;28;Cualedro;01-001-C;233;0;233;174;1;2;59;173;171;29;5;0;0;0;0;126;8;0;0;3
32;28;Cualedro;01-001-D;473;0;473;319;3;2;154;316;314;53;2;0;1;1;0;242;12;0;1;2
32;30;Entrimo;01-001-A;495;1;496;335;0;2;161;335;333;63;8;2;0;0;1;101;155;0;1;2
32;30;Entrimo;01-001-B;411;0;411;291;1;1;120;290;289;28;10;0;1;2;0;100;142;0;0;6
32;31;Esgos;01-001-A;448;0;448;331;4;1;117;327;326;73;22;0;1;0;0;205;19;0;0;6
32;31;Esgos;01-001-B;533;0;533;392;3;4;141;389;385;77;30;0;0;0;0;236;35;0;2;5
32;33;Gomesende;01-001-A;341;0;341;213;3;5;128;210;205;48;6;0;0;0;0;122;27;0;1;1
32;33;Gomesende;01-001-B;263;0;263;170;0;0;93;170;170;29;3;0;0;0;0;127;9;0;0;2
32;38;Larouco;01-001-U;389;0;389;254;3;1;135;251;250;51;3;0;2;0;0;157;31;0;2;4
32;39;Laza;01-001-A;606;0;606;442;3;2;164;439;437;135;9;0;0;1;2;224;58;0;2;6
32;39;Laza;01-001-B;255;0;255;198;0;1;57;198;197;37;6;4;0;0;1;128;19;0;0;2
32;39;Laza;01-001-C;209;0;209;142;0;1;67;142;141;42;0;0;0;1;1;87;9;0;0;1
32;40;Leiro;01-001-A;560;0;560;380;1;4;180;379;375;66;19;1;0;1;2;224;52;0;2;8
32;40;Leiro;01-001-B;226;0;226;180;0;0;46;180;180;13;1;0;0;0;0;158;6;0;1;1
32;40;Leiro;01-001-C;241;0;241;194;1;0;47;193;193;48;2;1;0;0;2;105;30;0;0;5
32;40;Leiro;01-001-D;286;0;286;205;1;0;81;204;204;45;7;0;1;0;0;123;26;0;0;2
32;41;Lobeira;01-001-A;486;0;486;310;3;0;176;307;307;52;20;0;2;1;0;187;38;0;1;6
32;41;Lobeira;01-001-B;204;0;204;123;2;0;81;121;121;20;5;0;0;0;2;76;15;0;1;2
32;42;Lobios;01-001-A;606;0;606;379;3;3;227;376;373;61;13;0;0;0;13;221;61;1;0;3
32;42;Lobios;01-001-B;481;0;481;299;1;5;182;298;293;38;16;0;1;0;0;189;47;0;1;1
32;42;Lobios;01-001-C;273;0;273;170;4;0;103;166;166;30;5;0;0;0;0;102;27;0;0;2
32;42;Lobios;01-001-D;210;0;210;142;0;0;68;142;142;13;11;0;0;1;0;93;20;0;1;3
32;43;Maceda;01-001-A;759;0;759;517;10;7;242;507;500;166;34;5;1;0;0;228;55;1;1;9
32;43;Maceda;01-001-B;651;0;651;433;4;3;218;429;426;133;29;4;1;0;0;201;50;0;1;7
32;43;Maceda;01-001-C;427;0;427;271;2;4;156;269;265;84;11;0;0;0;0;136;25;0;3;6
32;43;Maceda;02-001-A;326;0;326;226;2;2;100;224;222;67;15;1;0;2;0;106;26;0;0;5
32;43;Maceda;02-001-B;255;0;255;163;1;2;92;162;160;38;9;0;0;0;0;85;28;0;0;0
32;44;Manzaneda;01-001-A;456;0;456;342;4;1;114;338;337;89;10;0;1;2;0;169;59;0;4;3
32;44;Manzaneda;01-001-B;258;0;258;197;1;1;61;196;195;44;5;1;0;0;0;119;26;0;0;0
32;45;Maside;01-001-U;651;0;651;454;3;2;197;451;449;59;16;8;0;1;0;218;136;2;0;9
32;45;Maside;02-001-A;641;0;641;466;13;3;175;453;450;87;21;11;0;3;0;242;69;0;4;13
32;45;Maside;02-001-B;314;0;314;237;2;1;77;235;234;47;7;1;2;3;0;145;27;0;1;1
32;45;Maside;02-002-A;353;0;353;238;5;0;115;233;233;44;8;0;0;0;0;142;36;0;2;1
32;45;Maside;02-002-B;369;0;369;251;2;3;118;249;246;54;4;1;0;0;0;158;25;1;0;3
32;46;Melón;01-001-A;450;0;450;297;4;1;153;293;292;80;2;0;0;0;0;147;54;0;2;7
32;46;Melón;01-001-B;208;0;208;160;3;0;48;157;157;45;1;0;2;0;1;89;17;0;0;2
32;46;Melón;01-001-C;365;0;365;238;0;0;127;238;238;48;8;0;1;1;0;125;53;0;0;2
32;49;Montederramo;01-001-A;280;0;280;205;0;3;75;205;202;86;9;0;0;0;0;90;12;0;1;4
32;49;Montederramo;01-001-B;350;0;350;236;0;1;114;236;235;90;3;0;0;0;0;131;7;0;0;4
32;50;Monterrei;01-001-A;339;0;339;238;0;4;101;238;234;92;3;0;0;0;1;109;28;0;0;1
32;50;Monterrei;01-001-B;205;0;205;144;3;0;61;141;141;34;7;0;0;0;0;90;8;0;0;2
32;50;Monterrei;01-001-C;441;0;441;345;3;1;96;342;341;68;5;0;0;0;0;252;15;0;0;1
32;50;Monterrei;01-001-D;416;0;416;326;2;2;90;324;322;106;1;0;1;1;0;195;15;0;2;1
32;50;Monterrei;02-001-A;289;0;289;229;2;1;60;227;226;44;0;0;0;0;0;151;28;0;0;3
32;50;Monterrei;02-001-B;264;0;264;207;1;1;57;206;205;51;6;0;1;0;0;137;8;0;0;2
32;50;Monterrei;02-001-C;225;0;225;170;0;2;55;170;168;51;4;0;0;0;0;102;10;0;0;1
32;51;Muíños;01-001-A;402;0;402;328;3;4;74;325;321;49;6;0;0;1;0;237;26;0;0;2
32;51;Muíños;01-001-B;458;0;458;355;2;1;103;353;352;60;9;0;0;2;0;241;36;1;2;1
32;51;Muíños;01-001-C;242;0;242;206;2;0;36;204;204;10;2;0;0;0;0;160;30;0;1;1
32;51;Muíños;01-001-D;217;0;217;165;0;0;52;165;165;5;3;0;0;0;0;134;23;0;0;0
32;52;Nogueira de Ramuín;01-001-A;256;0;256;172;0;2;84;172;170;39;18;0;0;0;0;106;5;0;0;2
32;52;Nogueira de Ramuín;01-001-B;384;0;384;301;1;3;83;300;297;44;17;0;0;0;0;204;27;1;1;3
32;52;Nogueira de Ramuín;01-003-A;302;0;302;215;2;0;87;213;213;41;16;0;0;1;0;124;25;0;1;5
32;52;Nogueira de Ramuín;01-003-B;651;1;652;460;0;5;192;460;455;57;32;0;0;0;1;319;37;0;1;8
32;52;Nogueira de Ramuín;01-003-C;226;0;226;160;0;1;66;160;159;39;14;0;0;0;0;87;14;0;1;4
32;9;O Barco de Valdeorras;01-001-A;634;0;634;412;4;1;222;408;407;104;6;2;1;0;0;223;63;0;2;6
32;9;O Barco de Valdeorras;01-001-B;646;0;646;409;6;3;237;403;400;83;6;5;0;0;0;210;77;0;5;14
32;9;O Barco de Valdeorras;01-002-U;783;0;783;472;5;4;311;467;463;127;22;1;1;2;0;222;71;1;6;10
32;9;O Barco de Valdeorras;01-003-A;428;0;428;285;2;3;143;283;280;49;1;2;0;2;3;166;46;0;5;6
32;9;O Barco de Valdeorras;01-003-B;254;5;259;178;0;1;81;178;177;22;5;0;0;0;0;83;65;0;0;2
32;9;O Barco de Valdeorras;01-004-A;270;0;270;168;1;1;102;167;166;42;1;1;0;0;0;81;36;0;0;5
32;9;O Barco de Valdeorras;01-004-B;425;0;425;285;2;2;140;283;281;71;4;0;0;0;0;138;59;0;5;4
32;9;O Barco de Valdeorras;01-005-A;751;0;751;438;6;2;313;432;430;115;12;3;0;0;0;219;69;0;2;10
32;9;O Barco de Valdeorras;01-005-B;702;0;702;412;4;5;290;408;403;99;8;2;0;2;0;212;72;1;0;7
32;9;O Barco de Valdeorras;01-006-A;575;0;575;378;2;3;197;376;373;81;5;0;0;0;0;196;69;0;6;16
32;9;O Barco de Valdeorras;01-006-B;591;0;591;351;1;3;240;350;347;94;5;0;1;0;1;154;75;0;3;14
32;9;O Barco de Valdeorras;01-007-A;684;0;684;445;2;3;239;443;440;82;10;0;0;0;1;253;80;1;3;10
32;9;O Barco de Valdeorras;01-007-B;707;0;707;429;7;5;278;422;417;97;8;0;0;0;0;223;73;0;4;12
32;9;O Barco de Valdeorras;01-008-U;584;0;584;377;1;3;207;376;373;103;6;0;1;1;0;171;75;0;6;10
32;9;O Barco de Valdeorras;01-009-A;578;0;578;331;3;2;247;328;326;65;7;0;0;1;1;188;54;2;1;7
32;9;O Barco de Valdeorras;01-009-B;629;0;629;368;2;3;261;366;363;71;12;1;0;4;0;195;64;0;2;14
32;9;O Barco de Valdeorras;02-001-A;455;0;455;268;0;0;187;268;268;58;3;0;0;2;0;138;50;0;4;13
32;9;O Barco de Valdeorras;02-001-B;437;0;437;254;4;3;183;250;247;49;3;0;0;1;0;141;38;0;5;10
32;15;O Bolo;01-001-A;284;0;284;165;2;1;119;163;162;25;4;1;0;0;0;107;21;0;1;3
32;15;O Bolo;01-001-B;208;0;208;132;1;1;76;131;130;17;0;0;0;1;0;97;13;0;0;2
32;15;O Bolo;01-001-C;243;0;243;161;0;1;82;161;160;33;3;0;0;0;0;105;15;0;1;3
32;19;O Carballiño;01-001-A;636;0;636;403;2;6;233;401;395;100;15;14;0;2;1;221;32;1;4;5
32;19;O Carballiño;01-001-B;610;0;610;368;4;4;242;364;360;87;9;22;0;1;2;198;31;0;3;7
32;19;O Carballiño;01-002-A;831;0;831;573;5;8;258;568;560;132;21;17;0;3;1;318;50;0;5;13
32;19;O Carballiño;01-002-B;758;0;758;496;4;4;262;492;488;103;20;17;0;2;2;304;27;0;3;10
32;19;O Carballiño;01-003-A;682;0;682;430;5;1;252;425;424;92;12;15;0;0;1;245;49;0;4;6
32;19;O Carballiño;01-003-B;432;0;432;317;1;4;115;316;312;58;15;10;1;0;0;168;49;0;3;8
32;19;O Carballiño;01-004-A;836;0;836;594;6;2;242;588;586;121;22;30;2;4;0;333;61;1;4;8
32;19;O Carballiño;01-004-B;543;0;543;342;4;2;201;338;336;80;15;12;0;1;0;181;40;0;1;6
32;19;O Carballiño;01-005-A;808;0;808;518;3;3;290;515;512;119;23;8;1;1;1;290;55;0;2;12
32;19;O Carballiño;01-005-B;793;0;793;480;2;1;313;478;477;112;22;14;1;0;1;266;46;0;4;11
32;19;O Carballiño;01-006-A;487;0;487;342;4;1;145;338;337;57;19;9;0;2;0;213;28;0;1;8
32;19;O Carballiño;01-006-B;489;0;489;318;4;0;171;314;314;67;15;12;0;0;1;176;32;0;3;8
32;19;O Carballiño;01-007-A;620;0;620;405;0;8;215;405;397;101;18;10;0;1;0;219;41;0;3;4
32;19;O Carballiño;01-007-B;590;0;590;399;4;1;191;395;394;82;16;12;3;0;0;230;39;0;3;9
32;19;O Carballiño;02-001-A;503;0;503;356;3;3;147;353;350;70;13;11;2;1;2;205;33;0;1;12
32;19;O Carballiño;02-001-B;319;0;319;205;1;0;114;204;204;37;14;12;0;0;0;120;20;0;1;0
32;19;O Carballiño;02-002-U;594;0;594;362;4;2;232;358;356;92;11;8;0;2;1;186;46;0;1;9
32;19;O Carballiño;03-001-A;455;0;455;309;0;4;146;309;305;74;9;9;1;0;0;183;24;0;1;4
32;19;O Carballiño;03-001-B;295;0;295;204;1;0;91;203;203;45;4;12;0;0;0;112;17;0;5;8
32;35;O Irixo;01-001-A;503;0;503;329;0;2;174;329;327;55;9;5;0;1;0;202;43;0;1;11
32;35;O Irixo;01-001-B;216;0;216;151;0;0;65;151;151;35;3;0;0;0;1;91;15;0;0;6
32;35;O Irixo;01-002-A;326;0;326;205;1;1;121;204;203;44;9;3;0;1;0;122;19;0;0;5
32;35;O Irixo;01-002-B;206;0;206;129;0;2;77;129;127;9;2;0;0;0;1;98;14;0;0;3
32;58;O Pereiro de Aguiar;01-001-A;546;0;546;439;3;1;107;436;435;98;30;0;0;0;0;275;28;0;3;1
32;58;O Pereiro de Aguiar;01-001-B;330;0;330;261;0;3;69;261;258;53;47;0;0;0;4;117;28;0;3;6
32;58;O Pereiro de Aguiar;01-002-A;294;0;294;240;1;3;54;239;236;50;23;0;0;0;3;136;22;0;2;0
32;58;O Pereiro de Aguiar;01-002-B;705;0;705;513;8;2;192;505;503;141;44;0;0;1;0;248;59;0;2;8
32;58;O Pereiro de Aguiar;02-001-A;606;0;606;467;1;4;139;466;462;99;59;0;0;2;0;259;36;0;2;5
32;58;O Pereiro de Aguiar;02-001-B;517;0;517;391;1;0;126;390;390;78;43;0;1;2;0;218;40;0;2;6
32;58;O Pereiro de Aguiar;02-001-C;389;0;389;308;1;1;81;307;306;54;49;1;0;1;0;174;18;0;2;7
32;58;O Pereiro de Aguiar;02-002-A;670;0;670;515;1;4;155;514;510;115;38;0;0;1;1;296;41;3;5;10
32;58;O Pereiro de Aguiar;02-002-B;744;0;744;384;1;1;360;383;382;104;35;0;0;0;0;212;26;0;0;5
32;58;O Pereiro de Aguiar;02-003-U;702;0;702;518;4;3;184;514;511;116;85;0;0;3;0;254;40;1;3;9
32;12;Os Blancos;01-001-A;208;0;208;154;3;1;54;151;150;29;4;0;0;0;0;95;22;0;0;0
32;12;Os Blancos;01-001-B;230;0;230;163;0;0;67;163;163;36;5;0;0;0;0;98;20;0;2;2
32;12;Os Blancos;01-001-C;212;0;212;130;0;0;82;130;130;32;5;0;0;0;0;79;11;0;0;3
32;54;Ourense;01-001-U;547;0;547;372;2;0;175;370;370;120;57;1;1;2;3;152;29;1;1;3
32;54;Ourense;01-002-A;448;0;448;329;0;1;119;329;328;59;47;1;0;1;1;181;31;0;4;3
32;54;Ourense;01-002-B;469;0;469;351;4;4;118;347;343;71;42;4;0;0;1;181;36;1;1;6
32;54;Ourense;01-003-U;706;0;706;544;4;4;162;540;536;90;87;3;1;1;0;276;69;2;4;3
32;54;Ourense;01-004-U;641;0;641;472;2;6;169;470;464;94;61;2;0;3;0;258;36;1;3;6
32;54;Ourense;01-005-U;925;0;925;672;2;6;253;670;664;134;96;1;0;1;1;364;53;0;2;12
32;54;Ourense;01-006-A;571;0;571;436;3;3;135;433;430;95;58;0;0;0;1;226;41;0;4;5
32;54;Ourense;01-006-B;617;0;617;483;4;4;134;479;475;94;69;0;0;0;1;263;40;1;2;5
32;54;Ourense;01-007-A;580;0;580;433;5;1;147;428;427;107;66;0;0;2;1;191;54;1;0;5
32;54;Ourense;01-007-B;734;0;734;559;1;7;175;558;551;138;66;1;0;5;0;254;80;0;2;5
32;54;Ourense;01-008-U;594;0;594;435;3;5;159;432;427;138;50;0;0;0;0;176;55;0;4;4
32;54;Ourense;01-009-A;694;0;694;529;3;5;165;526;521;157;69;0;2;0;3;223;58;1;2;6
32;54;Ourense;01-009-B;667;0;667;492;2;8;175;490;482;131;61;0;1;0;0;220;63;0;1;5
32;54;Ourense;01-010-A;639;0;639;451;3;1;188;448;447;123;57;1;2;0;0;209;46;1;1;7
32;54;Ourense;01-010-B;611;0;611;457;5;5;154;452;447;101;70;2;1;0;1;222;47;0;2;1
32;54;Ourense;01-011-A;460;0;460;333;1;0;127;332;332;93;46;0;1;1;1;128;60;0;0;2
32;54;Ourense;01-011-B;444;0;444;341;0;2;103;341;339;102;51;0;0;1;2;127;50;1;2;3
32;54;Ourense;01-012-A;789;0;789;574;4;2;215;570;568;171;107;0;0;3;2;223;53;0;4;5
32;54;Ourense;01-012-B;707;0;707;496;0;4;211;496;492;140;84;1;0;3;2;196;59;0;0;7
32;54;Ourense;01-013-A;536;0;536;374;2;1;162;372;371;92;65;1;0;2;0;159;47;1;2;2
32;54;Ourense;01-013-B;542;0;542;385;1;1;157;384;383;107;75;1;0;0;0;164;31;0;2;3
32;54;Ourense;01-013-C;229;0;229;155;2;1;74;153;152;35;36;0;0;0;0;61;17;0;0;3
32;54;Ourense;01-014-A;432;0;432;294;0;1;138;294;293;48;74;0;0;0;0;135;29;0;1;6
32;54;Ourense;01-014-B;657;0;657;469;7;1;188;462;461;107;109;0;0;2;2;164;62;2;2;11
32;54;Ourense;01-015-U;737;0;737;536;6;6;201;530;524;174;72;1;0;0;0;220;49;0;4;4
32;54;Ourense;01-016-U;687;0;687;502;4;1;185;498;497;150;58;0;0;2;1;212;63;1;2;8
32;54;Ourense;01-017-U;536;0;536;401;1;0;135;400;400;82;63;1;0;1;3;203;39;1;0;7
32;54;Ourense;01-018-U;615;0;615;451;4;3;164;447;444;125;66;2;0;1;0;179;62;0;2;7
32;54;Ourense;02-001-A;470;0;470;302;6;0;168;296;296;101;48;0;0;1;0;103;40;0;2;1
32;54;Ourense;02-001-B;513;0;513;311;0;1;202;311;310;102;43;1;0;0;1;119;36;0;4;4
32;54;Ourense;02-002-U;575;0;575;376;1;2;199;375;373;105;57;0;0;0;2;166;35;0;1;7
32;54;Ourense;02-003-A;815;0;815;594;3;5;221;591;586;172;132;2;0;2;0;203;65;0;5;5
32;54;Ourense;02-003-B;840;0;840;577;4;0;263;573;573;137;120;3;5;0;1;228;66;1;3;9
32;54;Ourense;02-004-A;544;0;544;374;2;0;170;372;372;89;73;0;0;1;0;164;35;1;3;6
32;54;Ourense;02-004-B;574;0;574;380;3;1;194;377;376;114;74;2;1;0;0;128;46;0;4;7
32;54;Ourense;02-004-C;392;0;392;275;3;1;117;272;271;73;51;0;0;0;0;115;26;1;1;4
32;54;Ourense;02-005-A;584;0;584;397;7;2;187;390;388;103;91;1;0;2;0;140;40;2;4;5
32;54;Ourense;02-005-B;538;0;538;376;2;1;162;374;373;80;93;0;0;0;0;158;30;1;5;6
32;54;Ourense;02-005-C;364;0;364;249;4;0;115;245;245;66;46;0;0;0;0;103;25;0;0;5
32;54;Ourense;02-006-A;730;0;730;426;5;4;304;421;417;103;101;1;0;1;1;160;41;0;3;6
32;54;Ourense;02-006-B;653;0;653;395;2;0;258;393;393;96;88;0;0;0;1;147;51;0;2;8
32;54;Ourense;02-007-A;579;0;579;397;1;0;182;396;396;92;84;0;0;1;0;156;46;0;5;12
32;54;Ourense;02-007-B;664;0;664;445;3;4;219;442;438;130;86;0;0;4;0;178;33;0;1;6
32;54;Ourense;02-008-U;642;0;642;416;3;2;226;413;411;109;96;3;0;1;0;136;60;0;1;5
32;54;Ourense;02-009-A;271;0;271;190;0;0;81;190;190;26;31;0;0;1;1;99;28;0;0;4
32;54;Ourense;02-009-B;388;0;388;234;2;2;154;232;230;25;30;0;0;0;0;147;22;0;2;4
32;54;Ourense;02-009-C;543;0;543;352;2;3;191;350;347;64;61;0;0;2;0;170;44;0;2;4
32;54;Ourense;02-010-A;489;0;489;333;2;1;156;331;330;90;69;0;1;1;4;109;54;0;0;2
32;54;Ourense;02-010-B;337;0;337;233;0;2;104;233;231;90;40;0;1;1;0;77;19;0;2;1
32;54;Ourense;02-010-C;810;0;810;590;3;3;220;587;584;171;137;1;0;2;2;211;51;0;2;7
32;54;Ourense;02-011-U;928;0;928;650;3;2;278;647;645;205;119;1;0;1;1;232;68;0;3;15
32;54;Ourense;03-001-A;707;0;707;485;6;5;222;479;474;118;99;1;0;1;0;194;51;0;3;7
32;54;Ourense;03-001-B;745;0;745;505;2;2;240;503;501;143;90;1;0;3;0;202;47;3;2;10
32;54;Ourense;03-002-U;804;0;804;521;6;6;283;515;509;150;95;2;0;2;3;180;69;0;5;3
32;54;Ourense;03-003-A;610;0;610;384;4;5;226;380;375;101;81;0;0;1;1;128;55;0;0;8
32;54;Ourense;03-003-B;647;0;647;421;1;2;226;420;418;104;98;0;1;0;0;152;52;0;0;11
32;54;Ourense;03-004-A;448;0;448;324;1;1;124;323;322;102;60;1;0;0;0;122;30;1;2;4
32;54;Ourense;03-004-B;494;0;494;341;2;6;153;339;333;119;52;0;2;1;0;115;38;0;3;3
32;54;Ourense;03-004-C;732;0;732;460;3;6;272;457;451;153;94;0;0;0;0;143;54;1;1;5
32;54;Ourense;03-005-U;884;0;884;639;1;6;245;638;632;181;110;0;0;2;0;243;83;2;3;8
32;54;Ourense;03-006-U;651;0;651;458;5;2;193;453;451;124;88;0;0;0;0;189;45;0;0;5
32;54;Ourense;03-007-U;687;0;687;491;1;7;196;490;483;143;119;1;0;0;0;144;71;0;1;4
32;54;Ourense;03-008-A;889;0;889;617;2;1;272;615;614;188;117;0;1;1;1;231;69;0;2;4
32;54;Ourense;03-008-B;863;0;863;615;3;10;248;612;602;192;109;1;0;5;4;195;82;0;3;11
32;54;Ourense;03-009-A;356;0;356;236;1;2;120;235;233;58;58;1;0;0;1;87;25;0;0;3
32;54;Ourense;03-009-B;386;0;386;280;1;2;106;279;277;70;53;0;0;1;0;113;35;0;0;5
32;54;Ourense;03-010-A;713;0;713;468;3;2;245;465;463;118;105;0;0;0;4;164;60;1;2;9
32;54;Ourense;03-010-B;289;0;289;214;0;0;75;214;214;81;28;1;0;0;0;77;24;0;0;3
32;54;Ourense;03-011-A;793;0;793;523;0;7;270;523;516;176;95;0;1;0;0;175;59;1;4;5
32;54;Ourense;03-011-B;801;0;801;535;4;9;266;531;522;151;120;0;0;1;0;178;64;0;3;5
32;54;Ourense;03-012-A;275;0;275;200;0;2;75;200;198;23;39;0;1;0;0;101;30;0;1;3
32;54;Ourense;03-012-B;271;0;271;158;5;2;113;153;151;24;35;0;0;0;0;67;22;0;1;2
32;54;Ourense;03-013-U;715;0;715;523;4;9;192;519;510;138;72;1;2;0;0;212;74;0;5;6
32;54;Ourense;03-014-A;773;0;773;544;6;6;229;538;532;152;85;0;0;1;1;213;71;0;3;6
32;54;Ourense;03-014-B;762;0;762;552;0;2;210;552;550;168;82;1;0;2;1;221;62;1;4;8
32;54;Ourense;03-015-A;649;0;649;430;3;4;219;427;423;96;83;1;0;1;0;183;47;2;1;9
32;54;Ourense;03-015-B;724;0;724;496;5;5;228;491;486;99;97;1;0;0;1;226;56;0;2;4
32;54;Ourense;03-016-A;455;0;455;327;1;3;128;326;323;87;54;0;0;1;0;113;61;1;2;4
32;54;Ourense;03-016-B;498;0;498;353;0;0;145;353;353;97;68;0;2;1;2;119;54;1;3;6
32;54;Ourense;03-017-U;613;0;613;385;4;8;228;381;373;87;67;0;0;0;0;156;58;0;2;3
32;54;Ourense;04-002-A;589;0;589;403;2;0;186;401;401;142;55;0;0;1;0;144;45;0;3;11
32;54;Ourense;04-002-B;556;0;556;395;2;1;161;393;392;133;58;0;0;1;2;143;45;0;4;6
32;54;Ourense;04-003-A;505;0;505;352;2;3;153;350;347;123;50;0;0;0;1;126;42;0;0;5
32;54;Ourense;04-003-B;480;0;480;339;3;1;141;336;335;115;38;0;0;0;2;128;45;0;2;5
32;54;Ourense;04-004-U;648;0;648;427;3;0;221;424;424;136;76;0;0;1;0;158;41;0;2;10
32;54;Ourense;04-005-A;767;0;767;526;5;6;241;521;515;153;74;0;1;0;0;225;56;1;2;3
32;54;Ourense;04-005-B;759;0;759;525;2;0;234;523;523;157;67;0;0;0;3;214;74;1;4;3
32;54;Ourense;04-006-A;626;0;626;417;3;0;209;414;414;109;56;0;1;0;2;179;60;0;2;5
32;54;Ourense;04-006-B;409;0;409;276;4;2;133;272;270;77;38;0;0;1;0;110;38;2;1;3
32;54;Ourense;04-007-U;833;1;834;545;1;3;289;544;541;143;122;0;1;6;2;204;56;3;0;4
32;54;Ourense;04-008-U;741;0;741;557;1;5;184;556;551;181;77;0;1;0;1;180;105;0;1;5
32;54;Ourense;04-009-A;689;0;689;475;3;5;214;472;467;130;83;0;0;2;0;174;68;0;3;7
32;54;Ourense;04-009-B;719;0;719;491;1;5;228;490;485;128;75;1;0;0;1;197;69;2;3;9
32;54;Ourense;04-010-A;501;0;501;330;2;5;171;328;323;99;41;0;0;1;0;141;35;1;2;3
32;54;Ourense;04-010-B;516;0;516;359;7;0;157;352;352;108;71;1;1;2;0;141;26;0;0;2
32;54;Ourense;04-011-U;659;0;659;318;3;4;341;315;311;91;48;1;1;3;0;115;44;1;2;5
32;54;Ourense;04-012-U;823;0;823;538;1;8;285;537;529;151;94;0;1;3;1;191;77;2;4;5
32;54;Ourense;04-013-U;790;0;790;518;0;2;272;518;516;148;95;1;0;0;0;200;60;3;4;5
32;54;Ourense;04-014-A;651;0;651;417;4;1;234;413;412;126;93;0;1;0;0;159;26;0;3;4
32;54;Ourense;04-014-B;611;12;623;382;5;1;241;377;376;105;89;0;1;0;0;136;33;0;3;9
32;54;Ourense;04-015-U;600;0;600;432;1;4;168;431;427;153;55;1;0;2;0;148;60;1;2;5
32;54;Ourense;05-001-A;682;0;682;476;3;4;206;473;469;144;77;1;0;3;1;193;43;2;0;5
32;54;Ourense;05-001-B;730;0;730;477;2;3;253;475;472;152;78;1;0;0;0;166;65;0;4;6
32;54;Ourense;05-002-A;432;0;432;319;1;5;113;318;313;91;61;0;0;0;0;106;49;0;5;1
32;54;Ourense;05-002-B;451;0;451;320;2;2;131;318;316;99;62;0;0;6;0;103;39;1;2;4
32;54;Ourense;05-003-A;801;0;801;579;4;5;222;575;570;187;97;0;0;0;0;214;59;1;5;7
32;54;Ourense;05-003-B;745;0;745;554;2;5;191;552;547;181;84;1;0;0;0;190;70;0;8;13
32;54;Ourense;05-004-A;570;0;570;417;1;1;153;416;415;120;65;1;0;0;0;163;63;0;1;2
32;54;Ourense;05-004-B;690;0;690;506;2;4;184;504;500;153;73;0;0;0;2;181;79;1;4;7
32;54;Ourense;05-005-A;943;0;943;682;4;4;261;678;674;210;118;2;0;4;1;216;106;0;10;7
32;54;Ourense;05-005-B;855;0;855;602;4;4;253;598;594;210;104;0;2;3;1;189;73;1;4;7
32;54;Ourense;05-006-A;280;0;280;191;1;0;89;190;190;34;48;0;0;2;0;78;26;0;0;2
32;54;Ourense;05-006-B;754;0;754;446;5;1;308;441;440;74;112;0;0;2;0;182;60;0;3;7
32;54;Ourense;05-008-A;444;0;444;297;1;2;147;296;294;76;58;0;0;1;1;103;48;0;1;6
32;54;Ourense;05-008-B;454;0;454;303;3;0;151;300;300;80;67;0;0;0;0;110;34;0;2;7
32;54;Ourense;05-009-A;468;0;468;291;6;1;177;285;284;75;51;0;0;2;0;111;39;0;1;5
32;54;Ourense;05-009-B;510;0;510;317;5;4;193;312;308;86;60;0;1;4;0;123;30;0;3;1
32;54;Ourense;05-010-A;640;0;640;495;9;5;145;486;481;137;92;1;1;1;0;171;62;0;6;10
32;54;Ourense;05-010-B;556;0;556;406;3;2;150;403;401;151;84;1;0;1;0;104;54;0;0;6
32;54;Ourense;05-011-A;511;0;511;328;1;0;183;327;327;96;69;0;2;0;0;111;47;0;0;2
32;54;Ourense;05-011-B;428;0;428;276;3;0;152;273;273;70;60;1;0;0;0;95;39;1;1;6
32;54;Ourense;05-012-U;788;0;788;507;2;2;281;505;503;92;75;0;2;3;1;250;71;0;2;7
32;54;Ourense;05-013-A;407;0;407;295;3;3;112;292;289;76;53;0;0;1;0;127;27;1;1;3
32;54;Ourense;05-013-B;219;0;219;156;2;0;63;154;154;38;18;0;1;0;0;64;31;0;2;0
32;54;Ourense;05-013-C;378;0;378;257;0;0;121;257;257;78;42;0;0;1;1;103;26;0;0;6
32;54;Ourense;05-014-A;263;0;263;195;0;2;68;195;193;51;37;0;0;0;0;63;35;0;2;5
32;54;Ourense;05-014-B;517;0;517;366;3;2;151;363;361;82;94;0;1;0;0;128;52;0;0;4
32;54;Ourense;05-014-C;323;0;323;226;0;3;97;226;223;51;42;0;0;0;0;89;39;0;0;2
32;54;Ourense;05-015-A;407;0;407;276;0;1;131;276;275;77;50;0;0;0;0;110;34;0;0;4
32;54;Ourense;05-015-B;429;0;429;277;1;0;152;276;276;65;51;0;0;0;0;119;32;0;1;8
32;54;Ourense;05-016-A;228;0;228;154;0;0;74;154;154;39;24;0;0;0;0;74;17;0;0;0
32;54;Ourense;05-016-B;589;0;589;300;1;2;289;299;297;63;41;1;3;1;1;164;13;0;1;9
32;54;Ourense;05-017-A;265;0;265;187;1;0;78;186;186;41;41;0;1;1;0;65;25;0;4;8
32;54;Ourense;05-017-B;249;0;249;161;1;2;88;160;158;54;28;0;0;1;0;56;17;0;1;1
32;54;Ourense;05-018-A;730;0;730;485;1;8;245;484;476;134;101;2;0;4;1;158;61;2;2;11
32;54;Ourense;05-018-B;778;0;778;544;4;5;234;540;535;162;130;1;2;4;1;155;70;2;3;5
32;54;Ourense;05-019-A;565;0;565;397;0;0;168;397;397;104;91;0;0;2;1;125;65;0;4;5
32;54;Ourense;05-019-B;493;0;493;328;0;3;165;328;325;88;68;0;0;1;0;116;44;0;2;6
32;54;Ourense;05-020-A;473;0;473;339;4;5;134;335;330;108;68;2;0;2;0;91;50;0;3;6
32;54;Ourense;05-020-B;528;0;528;373;4;3;155;369;366;113;63;0;0;1;1;127;52;1;2;6
32;54;Ourense;05-021-A;563;0;563;408;2;7;155;406;399;100;76;0;0;2;0;165;51;0;4;1
32;54;Ourense;05-021-B;649;0;649;476;2;7;173;474;467;123;83;1;0;4;1;190;58;0;1;6
32;53;Oímbra;01-001-A;415;0;415;323;2;5;92;321;316;89;7;0;0;0;0;189;30;0;0;1
32;53;Oímbra;01-001-B;239;0;239;192;0;0;47;192;192;30;0;0;0;0;0;147;15;0;0;0
32;53;Oímbra;01-001-C;304;0;304;207;2;1;97;205;204;42;0;0;0;1;0;143;13;0;0;5
32;53;Oímbra;01-001-D;298;0;298;238;3;3;60;235;232;66;3;1;1;0;0;147;13;0;0;1
32;55;Paderne de Allariz;01-001-A;605;0;605;424;3;5;181;421;416;80;36;0;2;2;1;249;38;0;4;4
32;55;Paderne de Allariz;01-001-B;582;0;582;392;3;2;190;389;387;99;30;0;0;2;0;206;44;0;1;5
32;56;Padrenda;01-001-A;418;0;418;324;0;2;94;324;322;37;3;7;0;0;0;247;25;0;0;3
32;56;Padrenda;01-001-B;217;0;217;150;1;0;67;149;149;13;5;0;0;0;0;118;9;0;0;4
32;56;Padrenda;01-002-A;308;0;308;202;1;0;106;201;201;18;8;0;0;0;0;127;47;0;0;1
32;56;Padrenda;01-002-B;425;0;425;309;3;3;116;306;303;32;6;0;0;0;0;203;59;0;0;3
32;57;Parada de Sil;01-001-U;463;0;463;297;1;2;166;296;294;64;26;2;0;2;1;115;79;1;0;4
32;60;Petín;01-001-A;410;0;410;269;3;3;141;266;263;84;6;1;0;0;1;93;73;0;0;5
32;60;Petín;01-001-B;335;0;335;231;1;3;104;230;227;51;6;0;0;0;1;119;43;0;3;4
32;61;Piñor;01-001-A;290;0;290;232;1;0;58;231;231;24;1;10;1;0;0;176;15;0;2;2
32;61;Piñor;01-001-B;276;0;276;225;1;2;51;224;222;40;1;17;0;1;0;133;25;0;0;5
32;61;Piñor;01-001-C;425;0;425;326;0;2;99;326;324;61;12;10;0;0;0;216;21;0;2;2
32;64;Pontedeva;01-001-U;419;0;419;308;0;1;111;308;307;43;4;0;0;0;0;227;29;0;1;3
32;62;Porqueira;01-001-A;382;0;382;286;1;1;96;285;284;54;1;0;2;0;0;209;18;0;0;0
32;62;Porqueira;01-001-B;398;0;398;302;2;1;96;300;299;46;4;0;0;1;0;225;21;0;0;2
32;65;Punxín;01-001-A;412;0;412;281;0;1;131;281;280;72;13;0;0;0;0;148;41;0;0;6
32;65;Punxín;01-001-B;248;0;248;128;1;0;120;127;127;32;8;1;0;0;0;70;16;0;0;0
32;66;Quintela de Leirado;01-001-U;516;0;516;351;0;0;165;351;351;13;6;0;0;0;0;316;14;0;0;2
32;67;Rairiz de Veiga;01-001-A;436;0;436;334;0;0;102;334;334;92;9;0;1;0;0;172;51;0;0;9
32;67;Rairiz de Veiga;01-001-B;241;0;241;169;1;0;72;168;168;39;2;0;1;0;0;99;23;0;0;4
32;67;Rairiz de Veiga;01-001-C;238;0;238;172;0;2;66;172;170;43;4;0;0;0;0;96;27;0;0;0
32;67;Rairiz de Veiga;01-001-D;204;0;204;111;2;0;93;109;109;20;4;0;0;1;0;56;27;0;0;1
32;68;Ramirás;01-001-A;293;0;293;209;1;2;84;208;206;70;2;0;0;0;0;91;41;0;1;1
32;68;Ramirás;01-001-B;323;0;323;187;1;0;136;186;186;36;1;0;0;1;1;112;29;0;2;4
32;68;Ramirás;02-001-A;323;0;323;206;0;0;117;206;206;60;5;0;0;0;0;92;47;0;1;1
32;68;Ramirás;02-001-B;373;0;373;261;3;1;112;258;257;70;7;0;0;0;1;134;42;0;1;2
32;69;Ribadavia;01-001-U;519;0;519;417;1;0;102;416;416;140;13;0;1;1;0;180;77;0;3;1
32;69;Ribadavia;01-003-A;572;0;572;406;5;2;166;401;399;130;9;1;0;0;0;192;56;0;3;8
32;69;Ribadavia;01-003-B;567;0;567;431;1;3;136;430;427;128;8;0;0;2;0;226;52;0;4;7
32;69;Ribadavia;01-004-U;546;0;546;414;4;0;132;410;410;141;5;0;1;1;2;162;93;0;2;3
32;69;Ribadavia;01-005-A;491;0;491;374;5;1;117;369;368;116;21;1;0;2;1;158;58;2;5;4
32;69;Ribadavia;01-005-B;545;0;545;395;1;2;150;394;392;133;19;0;1;0;0;167;58;0;8;6
32;69;Ribadavia;02-001-A;298;0;298;226;2;2;72;224;222;46;1;0;0;0;0;126;42;0;0;7
32;69;Ribadavia;02-001-B;307;0;307;233;0;0;74;233;233;73;3;0;2;0;0;114;37;0;0;4
32;69;Ribadavia;02-001-C;325;0;325;249;0;0;76;249;249;90;6;0;0;2;1;117;26;1;2;4
32;71;Riós;01-001-A;402;0;402;229;4;1;173;225;224;53;5;0;0;0;0;125;40;0;0;1
32;71;Riós;01-001-B;389;0;389;250;0;1;139;250;249;50;5;0;0;0;0;133;58;0;0;3
32;71;Riós;01-001-C;225;0;225;166;2;1;59;164;163;38;2;0;0;0;0;104;19;0;0;0
32;71;Riós;01-001-D;228;0;228;161;1;0;67;160;160;32;0;0;0;0;0;77;50;1;0;0
32;73;Rubiá;01-001-A;755;0;755;538;5;4;217;533;529;111;9;0;0;0;3;264;127;0;6;9
32;73;Rubiá;01-001-B;265;0;265;169;0;1;96;169;168;22;1;0;0;0;0;100;35;2;3;5
32;73;Rubiá;01-001-C;213;0;213;146;2;0;67;144;144;11;3;0;0;0;1;96;30;0;0;3
32;74;San Amaro;01-001-A;287;0;287;194;0;0;93;194;194;28;3;2;0;1;0;127;26;0;0;7
32;74;San Amaro;01-001-B;294;0;294;222;3;1;72;219;218;36;6;5;0;0;0;146;21;0;0;4
32;74;San Amaro;01-001-C;357;0;357;266;1;0;91;265;265;54;12;1;0;2;0;162;26;0;1;7
32;75;San Cibrao das Viñas;01-001-A;774;0;774;602;9;3;172;593;590;124;81;0;0;2;3;321;41;1;3;14
32;75;San Cibrao das Viñas;01-001-B;778;0;778;587;7;3;191;580;577;137;63;1;0;0;2;325;30;1;2;16
32;75;San Cibrao das Viñas;01-002-A;542;0;542;395;1;2;147;394;392;70;35;0;0;1;0;241;31;0;2;12
32;75;San Cibrao das Viñas;01-002-B;545;0;545;409;3;0;136;406;406;68;26;0;0;0;0;280;28;0;2;2
32;75;San Cibrao das Viñas;01-003-A;564;0;564;395;1;4;169;394;390;74;40;0;0;0;1;207;63;0;1;4
32;75;San Cibrao das Viñas;01-003-B;457;0;457;350;5;1;107;345;344;56;27;0;0;1;0;219;35;0;2;4
32;75;San Cibrao das Viñas;02-001-U;903;0;903;726;5;6;177;721;715;153;44;0;0;0;0;434;71;0;1;12
32;76;San Cristovo de Cea;01-001-A;501;0;501;393;1;2;108;392;390;67;20;6;0;0;0;259;28;0;0;10
32;76;San Cristovo de Cea;01-001-B;224;0;224;174;0;0;50;174;174;36;6;2;0;0;0;101;27;0;0;2
32;76;San Cristovo de Cea;01-001-C;344;0;344;247;4;1;97;243;242;45;3;0;0;0;0;177;14;0;0;3
32;76;San Cristovo de Cea;02-001-A;330;0;330;253;2;0;77;251;251;44;14;13;0;0;0;168;8;0;0;4
32;76;San Cristovo de Cea;02-001-B;432;0;432;319;3;2;113;316;314;77;17;4;0;1;0;192;18;0;3;2
32;70;San Xoán de Río;01-001-U;481;0;481;301;2;2;180;299;297;43;9;0;2;1;0;202;32;0;1;7
32;77;Sandiás;01-001-A;336;0;336;238;0;1;98;238;237;56;10;0;0;1;1;118;42;0;2;7
32;77;Sandiás;01-001-B;335;0;335;234;0;1;101;234;233;54;9;0;0;0;0;137;30;0;0;3
32;77;Sandiás;01-001-C;348;0;348;234;0;2;114;234;232;55;13;0;0;1;0;122;36;0;0;5
32;78;Sarreaus;01-001-A;407;0;407;293;0;1;114;293;292;68;3;0;1;0;0;188;25;0;2;5
32;78;Sarreaus;01-001-B;334;0;334;252;4;3;82;248;245;41;3;0;1;0;0;169;28;0;0;3
32;78;Sarreaus;01-001-C;263;0;263;200;2;1;63;198;197;42;5;0;1;0;0;134;14;0;0;1
32;79;Taboadela;01-001-A;373;0;373;267;4;5;106;263;258;51;21;0;0;0;0;134;46;0;1;5
32;79;Taboadela;01-001-B;295;0;295;223;2;1;72;221;220;51;24;0;0;1;1;100;42;0;0;1
32;79;Taboadela;01-002-U;665;0;665;454;2;2;211;452;450;110;45;0;0;1;0;225;60;0;2;7
32;81;Toén;01-001-A;440;0;440;317;0;0;123;317;317;62;20;0;1;0;0;190;42;0;0;2
32;81;Toén;01-001-B;233;0;233;167;1;0;66;166;166;29;8;1;0;0;0;76;46;0;1;5
32;81;Toén;01-002-A;270;0;270;211;1;1;59;210;209;42;25;0;0;0;1;113;24;0;1;3
32;81;Toén;01-002-B;244;0;244;189;1;2;55;188;186;22;10;0;1;0;1;113;36;0;0;3
32;81;Toén;02-001-A;457;0;457;376;2;2;81;374;372;84;24;0;0;0;0;206;51;0;2;5
32;81;Toén;02-001-B;364;0;364;286;3;3;78;283;280;58;21;0;0;0;0;159;36;0;0;6
32;82;Trasmiras;01-001-A;505;0;505;353;1;4;152;352;348;124;6;1;0;0;0;189;24;0;1;3
32;82;Trasmiras;01-001-B;350;0;350;246;1;3;104;245;242;76;2;0;0;0;0;136;24;0;0;4
32;82;Trasmiras;01-001-C;257;0;257;192;1;0;65;191;191;50;5;0;0;0;0;124;8;0;0;4
32;84;Verea;01-001-A;346;0;346;262;1;1;84;261;260;141;6;0;0;0;1;95;9;1;1;6
32;84;Verea;01-001-B;238;0;238;184;0;3;54;184;181;105;3;0;0;0;0;64;7;0;0;2
32;84;Verea;01-001-C;272;0;272;176;0;0;96;176;176;87;1;0;0;0;0;72;12;0;0;4
32;85;Verín;01-001-A;611;0;611;385;4;1;226;381;380;130;7;0;1;1;0;184;49;0;1;7
32;85;Verín;01-001-B;532;0;532;328;3;1;204;325;324;112;6;0;0;0;0;158;43;0;0;5
32;85;Verín;01-002-A;468;0;468;302;2;3;166;300;297;86;12;0;0;1;1;151;36;0;1;9
32;85;Verín;01-002-B;480;0;480;309;3;0;171;306;306;83;9;0;1;3;0;159;40;0;2;9
32;85;Verín;01-003-A;528;0;528;374;4;2;154;370;368;92;7;2;0;0;0;195;58;0;5;9
32;85;Verín;01-003-B;227;1;228;154;1;0;74;153;153;36;6;0;0;0;0;92;17;0;0;2
32;85;Verín;01-004-A;319;0;319;219;1;0;100;218;218;86;2;0;1;0;2;104;17;0;2;4
32;85;Verín;01-004-B;661;0;661;367;0;1;294;367;366;85;5;0;0;0;1;209;59;0;1;6
32;85;Verín;01-004-C;378;0;378;245;1;2;133;244;242;74;10;0;0;0;0;116;42;0;0;0
32;85;Verín;01-004-D;315;0;315;198;0;1;117;198;197;43;0;0;0;0;0;96;56;0;0;2
32;85;Verín;01-005-A;427;0;427;292;2;4;135;290;286;86;11;1;0;0;0;141;43;0;0;4
32;85;Verín;01-005-B;372;0;372;258;2;2;114;256;254;61;2;0;1;0;1;151;34;1;1;2
32;85;Verín;01-005-C;333;0;333;219;1;0;114;218;218;53;0;0;1;1;0;136;22;0;0;5
32;85;Verín;01-007-A;521;0;521;343;5;2;178;338;336;105;3;0;0;0;0;173;46;1;1;7
32;85;Verín;01-007-B;538;0;538;368;8;5;170;360;355;122;7;2;0;0;0;179;39;0;0;6
32;85;Verín;01-008-A;635;0;635;408;8;0;227;400;400;134;4;0;0;1;2;205;49;0;2;3
32;85;Verín;01-008-B;646;0;646;426;7;3;220;419;416;142;5;0;1;0;1;198;62;0;4;3
32;85;Verín;01-009-A;650;0;650;380;3;2;270;377;375;126;6;0;0;0;0;199;34;0;0;10
32;85;Verín;01-009-B;649;0;649;409;5;1;240;404;403;130;10;0;0;0;0;197;50;0;2;14
32;85;Verín;01-010-A;562;0;562;366;3;2;196;363;361;123;8;0;0;2;1;176;48;0;0;3
32;85;Verín;01-010-B;559;0;559;384;0;4;175;384;380;122;9;0;0;0;0;208;37;1;1;2
32;86;Viana do Bolo;01-001-A;468;0;468;305;5;2;163;300;298;71;1;0;1;0;0;174;41;0;1;9
32;86;Viana do Bolo;01-001-B;504;0;504;352;1;1;152;351;350;103;4;0;1;2;1;198;34;0;1;6
32;86;Viana do Bolo;01-001-C;569;0;569;309;4;0;260;305;305;91;6;0;1;1;0;162;36;0;5;3
32;86;Viana do Bolo;02-001-A;443;0;443;255;2;2;188;253;251;67;3;0;0;0;0;147;33;0;1;0
32;86;Viana do Bolo;02-001-B;405;0;405;242;1;2;163;241;239;58;4;0;1;0;0;145;29;0;0;2
32;88;Vilamartín de Valdeorras;01-001-A;766;0;766;481;7;2;285;474;472;87;9;0;0;1;0;237;118;0;9;11
32;88;Vilamartín de Valdeorras;01-001-B;290;0;290;79;0;1;211;79;78;11;1;0;0;1;0;48;17;0;0;0
32;88;Vilamartín de Valdeorras;01-002-A;281;0;281;179;5;1;102;174;173;39;0;0;0;0;3;91;28;0;4;8
32;88;Vilamartín de Valdeorras;01-002-B;249;0;249;187;1;0;62;186;186;33;3;0;0;0;0;90;51;0;3;6
32;87;Vilamarín;01-001-A;546;0;546;402;8;4;144;394;390;81;24;0;0;0;0;253;23;0;1;8
32;87;Vilamarín;01-001-B;254;0;254;180;1;0;74;179;179;49;10;0;0;0;0;102;14;0;1;3
32;87;Vilamarín;02-001-A;570;0;570;440;6;1;130;434;433;84;29;0;1;1;2;266;43;0;0;7
32;87;Vilamarín;02-001-B;259;0;259;186;1;4;73;185;181;49;25;0;0;1;0;93;7;1;1;4
32;89;Vilar de Barrio;01-001-U;620;0;620;410;1;6;210;409;403;145;11;0;0;1;0;208;31;0;5;2
32;89;Vilar de Barrio;02-001-U;502;0;502;362;4;0;140;358;358;71;24;0;0;0;1;209;49;0;0;4
32;90;Vilar de Santos;01-001-A;362;0;362;276;0;1;86;276;275;160;7;0;0;0;0;93;11;0;0;4
32;90;Vilar de Santos;01-001-B;336;0;336;258;2;2;78;256;254;157;6;0;1;0;0;77;9;0;0;4
32;91;Vilardevós;01-001-A;413;0;413;301;0;3;112;301;298;53;3;0;0;0;0;179;58;0;1;4
32;91;Vilardevós;01-001-B;216;0;216;155;1;1;61;154;153;26;0;0;0;1;0;86;37;0;0;3
32;91;Vilardevós;01-002-A;228;0;228;171;3;0;57;168;168;19;0;0;0;0;0;88;60;0;0;1
32;91;Vilardevós;01-002-B;330;0;330;251;1;3;79;250;247;57;2;0;0;0;2;115;70;0;0;1
32;91;Vilardevós;01-002-C;336;0;336;256;0;0;80;256;256;35;1;3;0;1;1;128;81;0;2;4
32;92;Vilariño de Conso;01-001-U;474;0;474;339;6;3;135;333;330;89;6;0;0;1;3;192;33;0;0;6
32;32;Xinzo de Limia;01-001-A;798;0;798;526;6;2;272;520;518;182;27;2;0;1;1;247;51;0;1;6
32;32;Xinzo de Limia;01-001-B;726;0;726;484;4;1;242;480;479;171;12;0;0;1;1;251;34;0;0;9
32;32;Xinzo de Limia;01-002-A;737;0;737;496;11;2;241;485;483;157;8;0;0;0;0;256;46;1;0;15
32;32;Xinzo de Limia;01-002-B;755;0;755;521;5;3;234;516;513;159;19;0;0;4;0;258;64;0;2;7
32;32;Xinzo de Limia;01-003-A;387;0;387;251;3;1;136;248;247;67;21;0;0;0;0;130;22;0;1;6
32;32;Xinzo de Limia;01-003-B;270;0;270;208;1;3;62;207;204;59;8;0;0;0;0;115;20;1;0;1
32;32;Xinzo de Limia;01-005-A;339;0;339;239;1;1;100;238;237;65;2;0;2;2;0;132;31;0;0;3
32;32;Xinzo de Limia;01-005-B;423;0;423;280;2;2;143;278;276;53;4;0;0;0;0;176;31;0;3;9
32;32;Xinzo de Limia;01-007-A;204;0;204;140;1;0;64;139;139;29;3;0;0;0;0;87;18;0;1;1
32;32;Xinzo de Limia;01-007-B;408;0;408;268;0;1;140;268;267;74;6;0;0;0;0;152;26;0;0;9
32;32;Xinzo de Limia;01-009-A;746;0;746;500;1;5;246;499;494;145;13;0;0;1;1;278;47;0;2;7
32;32;Xinzo de Limia;01-009-B;749;0;749;497;4;3;252;493;490;147;8;0;0;1;2;272;44;0;1;15
32;32;Xinzo de Limia;01-010-A;596;0;596;401;7;3;195;394;391;126;10;0;1;0;1;188;55;1;3;6
32;32;Xinzo de Limia;01-010-B;577;0;577;400;6;6;177;394;388;110;10;0;0;1;0;223;36;0;1;7
32;36;Xunqueira de Ambía;01-001-A;364;0;364;306;1;4;58;305;301;111;19;0;0;0;0;153;10;0;2;6
32;36;Xunqueira de Ambía;01-001-B;250;0;250;190;0;2;60;190;188;79;7;0;0;0;0;80;14;0;3;5
32;36;Xunqueira de Ambía;02-001-A;368;0;368;282;1;2;86;281;279;58;11;0;0;0;0;196;13;0;0;1
32;36;Xunqueira de Ambía;02-001-B;212;0;212;149;0;0;63;149;149;37;7;0;0;1;0;96;4;0;0;4
32;37;Xunqueira de Espadanedo;01-001-U;603;0;603;427;0;3;176;427;424;78;25;0;1;0;1;276;35;1;2;5
32;990;Residentes ausentes-Ourense;99-001-U;0;0;0;0;0;0;;0;0;0;0;0;0;0;0;0;0;0;0;0
32;990;Residentes ausentes-Ourense;99-002-U;0;0;0;0;0;0;;0;0;0;0;0;0;0;0;0;0;0;0;0
32;990;Residentes ausentes-Ourense;99-003-U;0;0;0;0;0;0;;0;0;0;0;0;0;0;0;0;0;0;0;0
32;990;Residentes ausentes-Ourense;99-004-U;0;0;0;0;0;0;;0;0;0;0;0;0;0;0;0;0;0;0;0
32;990;Residentes ausentes-Ourense;99-005-U;0;0;0;0;0;0;;0;0;0;0;0;0;0;0;0;0;0;0;0
32;990;Residentes ausentes-Ourense;99-006-U;0;0;0;0;0;0;;0;0;0;0;0;0;0;0;0;0;0;0;0
32;990;Residentes ausentes-Ourense;99-007-U;0;0;0;0;0;0;;0;0;0;0;0;0;0;0;0;0;0;0;0
32;990;Residentes ausentes-Ourense;99-008-U;0;0;0;0;0;0;;0;0;0;0;0;0;0;0;0;0;0;0;0
Total;;;;251965;32;251997;173786;1178;1088;78211;172608;171520;43758;15312;541;156;372;237;86144;21425;113;855;2607
