Cód Cir;Cód Con;Concello;Mesa;Censo;Certif Alta;Censo Total;Votos Totais;Votos nulos;Votos brancos;Abstención;Votos Válidos;Votos Candidaturas;BNG;ECG;ESCANOS EN BRANCO;PACMA;PODEMOS-ALIANZA VERDE;PP;PSdeG-PSOE;PUM+J;SUMAR GALICIA;VOX
36;9;A Cañiza;01-001-A;512;0;512;376;0;1;136;376;375;113;0;1;1;0;209;43;0;2;6
36;9;A Cañiza;01-001-B;289;0;289;176;2;0;113;174;174;37;2;0;0;0;103;29;0;1;2
36;9;A Cañiza;01-002-A;912;0;912;581;5;3;331;576;573;137;0;1;4;1;308;90;0;9;23
36;9;A Cañiza;01-002-B;827;0;827;520;11;0;307;509;509;138;0;2;3;1;274;64;1;15;11
36;9;A Cañiza;01-003-A;260;0;260;178;1;0;82;177;177;19;0;0;0;1;129;27;0;0;1
36;9;A Cañiza;01-003-B;260;0;260;140;1;0;120;139;139;25;1;0;0;1;91;16;0;1;4
36;9;A Cañiza;02-001-A;322;0;322;172;3;1;150;169;168;30;0;1;0;1;97;37;0;2;0
36;9;A Cañiza;02-001-B;245;0;245;151;0;0;94;151;151;36;0;0;0;0;98;13;0;0;4
36;9;A Cañiza;03-001-U;708;0;708;426;3;1;282;423;422;90;1;1;2;1;242;71;0;5;9
36;17;A Estrada;01-001-U;843;0;843;624;5;8;219;619;611;197;1;1;1;1;330;68;1;4;7
36;17;A Estrada;01-002-A;476;0;476;343;4;7;133;339;332;124;0;1;1;0;160;38;0;3;5
36;17;A Estrada;01-002-B;568;0;568;396;4;7;172;392;385;134;0;2;2;0;192;39;1;9;6
36;17;A Estrada;01-003-A;617;0;617;458;19;2;159;439;437;96;0;0;0;0;268;58;1;8;6
36;17;A Estrada;01-003-B;249;0;249;183;3;0;66;180;180;60;0;0;2;1;86;26;0;3;2
36;17;A Estrada;01-004-A;341;0;341;254;1;2;87;253;251;78;0;0;0;0;131;35;0;6;1
36;17;A Estrada;01-004-B;295;0;295;235;0;2;60;235;233;81;0;0;1;1;123;18;0;6;3
36;17;A Estrada;01-004-C;407;5;412;294;0;0;118;294;294;93;0;0;0;0;147;46;1;4;3
36;17;A Estrada;01-006-A;593;0;593;394;6;2;199;388;386;143;0;0;1;0;189;41;1;6;5
36;17;A Estrada;01-006-B;632;0;632;430;6;2;202;424;422;155;0;0;2;1;206;50;1;3;4
36;17;A Estrada;01-007-A;509;0;509;357;5;8;152;352;344;141;0;0;1;1;169;29;0;0;3
36;17;A Estrada;01-007-B;680;0;680;457;2;5;223;455;450;181;0;0;0;0;213;44;1;6;5
36;17;A Estrada;01-008-A;565;0;565;372;2;4;193;370;366;113;0;2;4;0;185;50;0;10;2
36;17;A Estrada;01-008-B;596;1;597;377;6;1;220;371;370;125;1;0;3;1;182;51;0;7;0
36;17;A Estrada;01-009-A;582;0;582;430;2;0;152;428;428;149;0;0;0;0;230;44;0;2;3
36;17;A Estrada;01-009-B;673;0;673;488;11;6;185;477;471;180;0;0;2;0;223;50;0;11;5
36;17;A Estrada;01-010-A;465;0;465;321;3;0;144;318;318;90;0;0;2;0;165;43;1;8;9
36;17;A Estrada;01-010-B;605;0;605;424;4;2;181;420;418;147;0;1;1;2;195;50;0;12;10
36;17;A Estrada;02-001-A;317;0;317;243;1;0;74;242;242;61;0;0;1;0;153;20;0;1;6
36;17;A Estrada;02-001-B;414;0;414;315;3;2;99;312;310;72;0;1;0;0;211;20;0;2;4
36;17;A Estrada;02-002-A;278;0;278;218;0;4;60;218;214;64;0;0;0;0;121;23;0;3;3
36;17;A Estrada;02-002-B;237;0;237;176;3;0;61;173;173;61;0;0;0;0;89;20;0;2;1
36;17;A Estrada;02-003-A;434;0;434;300;1;3;134;299;296;85;0;0;0;0;160;44;0;3;4
36;17;A Estrada;02-003-B;335;0;335;236;2;1;99;234;233;49;1;0;0;2;149;28;0;3;1
36;17;A Estrada;03-001-A;231;0;231;160;2;0;71;158;158;37;0;0;1;0;99;19;0;1;1
36;17;A Estrada;03-001-B;287;0;287;216;1;0;71;215;215;55;0;2;0;1;114;38;0;3;2
36;17;A Estrada;03-001-C;235;0;235;161;2;1;74;159;158;36;0;1;0;0;92;22;1;3;3
36;17;A Estrada;03-002-A;342;0;342;248;1;1;94;247;246;72;1;0;0;0;136;27;0;0;10
36;17;A Estrada;03-002-B;395;0;395;283;3;3;112;280;277;75;0;0;1;0;164;29;0;2;6
36;17;A Estrada;04-001-A;334;0;334;235;1;0;99;234;234;51;0;0;0;2;156;19;0;2;4
36;17;A Estrada;04-001-B;377;0;377;260;0;1;117;260;259;76;0;0;1;0;152;28;0;2;0
36;17;A Estrada;04-001-C;402;0;402;287;6;0;115;281;281;76;0;0;0;0;169;32;0;0;4
36;17;A Estrada;05-001-A;342;0;342;264;1;4;78;263;259;70;0;0;2;0;160;19;0;1;7
36;17;A Estrada;05-001-B;269;0;269;194;2;0;75;192;192;47;0;0;0;1;115;22;0;3;4
36;17;A Estrada;05-002-A;489;0;489;339;8;1;150;331;330;86;0;0;1;0;198;39;0;4;2
36;17;A Estrada;05-002-B;216;0;216;153;0;0;63;153;153;32;1;0;0;0;97;21;0;1;1
36;17;A Estrada;05-002-C;378;0;378;271;4;1;107;267;266;60;1;1;1;0;161;39;0;0;3
36;17;A Estrada;06-001-A;486;0;486;304;3;4;182;301;297;84;0;2;0;0;140;65;1;2;3
36;17;A Estrada;06-001-B;290;0;290;197;0;1;93;197;196;50;0;0;0;1;108;25;0;4;8
36;17;A Estrada;06-001-C;283;0;283;175;4;2;108;171;169;51;0;2;0;0;93;21;0;1;1
36;23;A Guarda;01-001-A;551;0;551;359;5;4;192;354;350;147;0;1;2;1;159;31;0;5;4
36;23;A Guarda;01-001-B;558;0;558;383;2;6;175;381;375;145;0;1;2;3;163;47;2;10;2
36;23;A Guarda;01-002-A;539;0;539;368;5;0;171;363;363;156;0;0;1;3;157;31;0;6;9
36;23;A Guarda;01-002-B;561;0;561;381;3;1;180;378;377;168;2;0;2;4;162;26;1;7;5
36;23;A Guarda;01-003-A;498;0;498;333;5;4;165;328;324;118;1;2;1;0;146;37;0;10;9
36;23;A Guarda;01-003-B;582;0;582;410;5;4;172;405;401;169;0;1;1;2;179;33;0;9;7
36;23;A Guarda;01-004-U;625;0;625;448;3;1;177;445;444;163;1;2;0;1;185;72;0;10;10
36;23;A Guarda;01-005-A;522;0;522;350;1;0;172;349;349;147;1;0;1;0;155;36;0;4;5
36;23;A Guarda;01-005-B;453;0;453;326;2;2;127;324;322;123;0;0;1;0;145;39;0;8;6
36;23;A Guarda;02-001-A;450;0;450;305;3;0;145;302;302;105;4;0;2;0;152;24;0;9;6
36;23;A Guarda;02-001-B;465;0;465;331;6;0;134;325;325;130;1;1;2;0;155;31;0;4;1
36;23;A Guarda;02-002-A;500;0;500;362;4;2;138;358;356;119;1;0;0;2;179;39;2;4;10
36;23;A Guarda;02-002-B;506;0;506;329;2;1;177;327;326;114;1;0;2;1;168;35;0;0;5
36;23;A Guarda;02-002-C;461;0;461;349;3;0;112;346;346;92;0;1;0;0;191;49;1;3;9
36;23;A Guarda;03-001-A;427;0;427;317;4;1;110;313;312;102;0;1;0;1;151;52;0;5;0
36;23;A Guarda;03-001-B;461;0;461;332;3;4;129;329;325;127;0;1;0;2;136;49;0;5;5
36;901;A Illa de Arousa;01-001-A;660;0;660;500;7;5;160;493;488;163;0;1;3;0;175;132;1;9;4
36;901;A Illa de Arousa;01-001-B;794;0;794;575;5;1;219;570;569;196;1;1;2;0;208;130;1;15;15
36;901;A Illa de Arousa;01-002-A;479;0;479;360;6;0;119;354;354;141;0;0;3;0;117;73;0;14;6
36;901;A Illa de Arousa;01-002-B;648;0;648;486;5;8;162;481;473;175;1;2;4;2;159;112;0;6;12
36;901;A Illa de Arousa;01-003-A;670;0;670;493;14;1;177;479;478;186;0;0;2;1;160;107;0;14;8
36;901;A Illa de Arousa;01-003-B;889;0;889;651;17;4;238;634;630;194;0;1;1;3;264;146;0;8;13
36;25;A Lama;01-001-A;235;0;235;154;1;1;81;153;152;45;0;0;1;0;98;3;0;0;5
36;25;A Lama;01-001-B;398;0;398;231;2;0;167;229;229;50;0;0;0;0;145;19;0;2;13
36;25;A Lama;01-001-C;505;0;505;349;2;3;156;347;344;111;0;0;1;1;178;27;1;7;18
36;25;A Lama;02-001-A;232;0;232;132;0;0;100;132;132;24;0;0;1;0;89;12;1;2;3
36;25;A Lama;02-001-B;309;0;309;189;0;0;120;189;189;32;0;0;0;0;132;22;0;0;3
36;25;A Lama;03-001-A;241;0;241;114;0;0;127;114;114;5;0;0;1;0;94;9;0;1;4
36;25;A Lama;03-001-B;291;0;291;128;0;0;163;128;128;16;0;0;0;0;98;5;0;0;9
36;20;Agolada;01-001-A;731;0;731;554;12;1;177;542;541;133;0;3;0;2;320;70;0;6;7
36;20;Agolada;01-001-B;249;0;249;193;2;2;56;191;189;42;0;0;0;0;126;18;0;1;2
36;20;Agolada;02-001-A;303;0;303;215;2;1;88;213;212;47;0;2;0;0;132;29;1;1;0
36;20;Agolada;02-001-B;337;0;337;254;3;1;83;251;250;64;0;0;0;1;159;21;1;1;3
36;20;Agolada;02-001-C;256;0;256;189;3;0;67;186;186;44;0;1;0;0;127;13;0;0;1
36;20;Agolada;02-001-D;205;0;205;139;0;0;66;139;139;31;0;0;0;0;97;11;0;0;0
36;1;Arbo;01-001-A;504;0;504;388;5;0;116;383;383;120;0;0;2;2;211;43;0;1;4
36;1;Arbo;01-001-B;447;0;447;306;2;0;141;304;304;97;0;0;3;1;143;43;0;8;9
36;1;Arbo;02-001-A;224;0;224;164;0;1;60;164;163;48;0;0;0;0;95;17;0;3;0
36;1;Arbo;02-001-B;214;0;214;158;4;0;56;154;154;35;0;0;0;0;102;15;0;0;2
36;1;Arbo;02-001-C;330;0;330;238;2;1;92;236;235;0;0;0;1;0;145;17;65;2;5
36;1;Arbo;03-001-A;464;0;464;324;1;2;140;323;321;54;0;0;0;2;227;22;0;9;7
36;1;Arbo;03-001-B;225;0;225;189;1;1;36;188;187;45;0;0;0;2;119;16;0;3;2
36;34;As Neves;01-001-U;721;0;721;501;7;1;220;494;493;185;0;0;3;1;230;58;1;5;10
36;34;As Neves;01-002-A;376;0;376;252;4;0;124;248;248;71;0;0;2;0;129;32;0;11;3
36;34;As Neves;01-002-B;557;0;557;420;5;4;137;415;411;125;0;2;4;2;203;59;0;8;8
36;34;As Neves;02-001-A;501;0;501;355;4;1;146;351;350;109;0;0;2;2;176;48;0;10;3
36;34;As Neves;02-001-B;388;0;388;273;3;0;115;270;270;54;0;0;0;1;170;31;1;5;8
36;34;As Neves;03-001-A;274;0;274;191;3;0;83;188;188;46;0;1;1;0;111;20;2;6;1
36;34;As Neves;03-001-B;375;0;375;265;6;1;110;259;258;104;0;0;0;1;115;23;0;10;5
36;3;Baiona;01-001-U;783;0;783;559;1;6;224;558;552;198;0;0;2;2;239;85;0;8;18
36;3;Baiona;01-002-A;817;0;817;517;6;4;300;511;507;158;0;1;6;1;250;65;0;16;10
36;3;Baiona;01-002-B;811;0;811;547;4;1;264;543;542;177;0;3;3;3;268;67;2;9;10
36;3;Baiona;01-003-U;914;18;932;605;5;3;327;600;597;169;0;0;2;1;336;57;0;17;15
36;3;Baiona;01-004-A;789;0;789;518;9;6;271;509;503;174;0;1;0;0;235;70;0;14;9
36;3;Baiona;01-004-B;797;0;797;525;4;2;272;521;519;164;0;0;4;1;242;83;0;18;7
36;3;Baiona;02-001-A;767;0;767;512;6;4;255;506;502;162;0;0;2;1;242;71;1;15;8
36;3;Baiona;02-001-B;795;0;795;511;4;4;284;507;503;168;1;0;2;2;209;85;3;23;10
36;3;Baiona;02-002-A;504;0;504;365;8;4;139;357;353;82;0;1;1;0;215;38;0;12;4
36;3;Baiona;02-002-B;490;0;490;365;4;2;125;361;359;99;0;0;2;1;216;24;0;13;4
36;3;Baiona;02-003-A;672;0;672;449;5;4;223;444;440;117;0;1;0;3;240;52;0;11;16
36;3;Baiona;02-003-B;736;0;736;537;4;3;199;533;530;129;0;0;3;6;293;47;1;23;28
36;3;Baiona;02-004-A;695;0;695;489;10;4;206;479;475;152;0;0;2;1;233;65;0;15;7
36;3;Baiona;02-004-B;706;0;706;502;6;3;204;496;493;154;0;0;2;3;229;54;1;32;18
36;2;Barro;01-001-U;681;0;681;466;3;5;215;463;458;126;0;1;0;0;284;28;0;4;15
36;2;Barro;01-002-U;840;0;840;564;6;9;276;558;549;172;1;1;1;0;286;51;0;10;27
36;2;Barro;02-001-A;374;0;374;267;3;0;107;264;264;84;0;0;1;0;132;33;0;5;9
36;2;Barro;02-001-B;511;0;511;352;6;0;159;346;346;106;0;1;0;0;187;41;0;3;8
36;2;Barro;02-002-U;652;0;652;472;1;5;180;471;466;132;0;1;0;0;246;69;1;6;11
36;4;Bueu;01-001-A;619;0;619;434;1;7;185;433;426;181;1;1;2;0;173;46;1;9;12
36;4;Bueu;01-001-B;821;0;821;558;11;4;263;547;543;259;1;1;4;1;215;42;2;13;5
36;4;Bueu;01-002-U;726;0;726;469;2;4;257;467;463;198;0;1;2;1;192;43;0;11;15
36;4;Bueu;01-003-U;598;0;598;411;5;5;187;406;401;196;0;1;2;0;156;23;0;8;15
36;4;Bueu;01-004-A;455;0;455;287;3;1;168;284;283;116;0;0;1;0;123;29;0;10;4
36;4;Bueu;01-004-B;581;0;581;368;11;0;213;357;357;132;0;0;2;0;166;36;0;12;9
36;4;Bueu;01-005-A;581;0;581;407;3;7;174;404;397;163;0;0;0;2;160;46;0;15;11
36;4;Bueu;01-005-B;673;0;673;444;3;5;229;441;436;201;0;1;1;0;172;41;0;8;12
36;4;Bueu;01-005-C;595;0;595;393;1;6;202;392;386;176;0;0;1;0;169;26;0;7;7
36;4;Bueu;01-006-U;534;0;534;335;7;0;199;328;328;125;0;0;1;0;160;27;0;7;8
36;4;Bueu;02-001-A;530;0;530;375;5;5;155;370;365;124;0;0;0;0;209;21;0;5;6
36;4;Bueu;02-001-B;568;0;568;380;5;2;188;375;373;121;0;1;3;0;216;26;1;0;5
36;4;Bueu;02-001-C;472;0;472;308;3;3;164;305;302;86;0;1;1;0;190;14;0;6;4
36;4;Bueu;03-001-A;583;0;583;349;0;2;234;349;347;89;0;1;2;0;215;22;0;9;9
36;4;Bueu;03-001-B;586;0;586;379;2;3;207;377;374;138;1;0;1;0;178;38;0;10;8
36;4;Bueu;03-002-A;516;0;516;331;2;6;185;329;323;117;0;2;0;3;169;24;0;6;2
36;4;Bueu;03-002-B;678;0;678;443;3;2;235;440;438;189;0;2;2;2;165;53;0;17;8
36;5;Caldas de Reis;01-001-A;888;0;888;621;10;9;267;611;602;234;0;0;1;0;282;68;1;11;5
36;5;Caldas de Reis;01-001-B;790;1;791;520;7;2;271;513;511;155;0;3;2;0;275;62;0;5;9
36;5;Caldas de Reis;01-002-A;332;0;332;247;1;2;85;246;244;71;0;0;1;0;129;36;0;2;5
36;5;Caldas de Reis;01-002-B;341;0;341;268;3;2;73;265;263;59;0;0;2;1;141;53;0;1;6
36;5;Caldas de Reis;01-003-A;728;0;728;496;9;0;232;487;487;136;0;0;0;0;214;116;1;9;11
36;5;Caldas de Reis;01-003-B;495;0;495;357;2;2;138;355;353;80;0;0;3;0;191;63;1;7;8
36;5;Caldas de Reis;01-004-A;571;0;571;379;2;0;192;377;377;115;1;2;2;0;187;57;1;11;1
36;5;Caldas de Reis;01-004-B;750;0;750;502;12;5;248;490;485;179;0;1;1;1;209;76;0;5;13
36;5;Caldas de Reis;01-004-C;625;0;625;435;6;2;190;429;427;171;0;3;0;1;181;52;0;7;12
36;5;Caldas de Reis;02-001-U;544;0;544;374;2;2;170;372;370;102;1;1;2;2;197;50;0;4;11
36;5;Caldas de Reis;02-002-U;658;0;658;458;5;3;200;453;450;122;0;0;0;0;263;52;0;7;6
36;5;Caldas de Reis;03-001-U;619;0;619;390;7;1;229;383;382;93;0;0;0;0;218;54;0;7;10
36;5;Caldas de Reis;03-002-U;690;0;690;521;1;2;169;520;518;122;0;1;0;0;275;108;0;4;8
36;6;Cambados;01-001-A;463;0;463;339;7;3;124;332;329;100;0;0;0;3;181;29;2;7;7
36;6;Cambados;01-001-B;464;0;464;333;4;4;131;329;325;93;0;0;0;3;181;33;0;7;8
36;6;Cambados;01-002-A;543;0;543;378;4;1;165;374;373;91;0;0;0;0;232;35;0;5;10
36;6;Cambados;01-002-B;487;0;487;345;2;2;142;343;341;80;0;0;2;0;204;38;0;10;7
36;6;Cambados;01-002-C;625;0;625;421;7;3;204;414;411;98;0;0;0;1;246;49;0;4;13
36;6;Cambados;02-001-A;695;0;695;493;3;3;202;490;487;182;3;0;2;0;217;62;0;8;13
36;6;Cambados;02-001-B;881;0;881;623;6;4;258;617;613;208;0;1;2;1;297;79;0;11;14
36;6;Cambados;02-002-A;851;0;851;623;3;3;228;620;617;191;0;0;1;1;321;88;0;9;6
36;6;Cambados;02-002-B;496;0;496;381;10;2;115;371;369;78;0;0;0;1;222;51;1;4;12
36;6;Cambados;02-003-A;352;0;352;262;6;2;90;256;254;79;1;1;2;0;136;28;0;2;5
36;6;Cambados;02-003-B;529;0;529;383;7;2;146;376;374;92;0;0;0;1;223;43;0;8;7
36;6;Cambados;02-004-A;571;0;571;401;4;3;170;397;394;142;0;0;0;0;187;35;0;19;11
36;6;Cambados;02-004-B;586;0;586;429;7;1;157;422;421;168;0;0;1;0;201;38;0;9;4
36;6;Cambados;03-001-A;584;0;584;427;2;6;157;425;419;146;0;0;2;1;184;63;0;18;5
36;6;Cambados;03-001-B;567;0;567;406;1;3;161;405;402;148;0;1;3;0;175;53;0;12;10
36;6;Cambados;03-002-A;579;0;579;406;2;3;173;404;401;117;0;0;0;1;227;38;1;11;6
36;6;Cambados;03-002-B;594;0;594;417;3;1;177;414;413;120;0;0;0;1;228;46;0;11;7
36;6;Cambados;03-003-U;787;0;787;572;12;3;215;560;557;192;0;0;3;0;280;66;0;10;6
36;6;Cambados;03-004-A;354;0;354;263;3;2;91;260;258;75;0;0;3;0;152;14;0;6;8
36;6;Cambados;03-004-B;457;0;457;341;5;1;116;336;335;102;0;0;3;2;177;41;0;3;7
36;7;Campo Lameiro;01-001-A;214;0;214;154;2;1;60;152;151;38;0;0;0;0;104;7;0;0;2
36;7;Campo Lameiro;01-001-B;327;0;327;217;2;1;110;215;214;45;0;0;1;0;124;38;0;0;6
36;7;Campo Lameiro;02-001-A;502;0;502;343;6;4;159;337;333;80;0;0;0;2;201;45;0;1;4
36;7;Campo Lameiro;02-001-B;496;0;496;344;6;2;152;338;336;81;0;1;0;0;198;49;1;3;3
36;8;Cangas;01-001-A;896;0;896;580;8;2;316;572;570;264;0;0;4;2;211;57;1;20;11
36;8;Cangas;01-001-B;907;0;907;607;6;6;300;601;595;305;0;2;2;5;186;55;2;26;12
36;8;Cangas;01-002-U;696;0;696;478;5;6;218;473;467;251;1;0;1;2;129;58;1;15;9
36;8;Cangas;01-003-A;771;0;771;523;5;6;248;518;512;235;0;1;0;0;185;58;0;22;11
36;8;Cangas;01-003-B;837;0;837;524;4;3;313;520;517;252;0;0;1;4;190;56;0;11;3
36;8;Cangas;01-004-A;657;0;657;394;4;2;263;390;388;197;0;1;0;4;107;59;1;11;8
36;8;Cangas;01-004-B;786;0;786;467;4;2;319;463;461;237;0;0;1;1;143;43;0;22;14
36;8;Cangas;02-001-A;597;0;597;428;4;1;169;424;423;178;0;1;0;3;176;35;2;14;14
36;8;Cangas;02-001-B;618;0;618;397;0;4;221;397;393;161;0;1;0;1;187;26;0;10;7
36;8;Cangas;02-002-A;508;0;508;348;4;3;160;344;341;176;0;0;1;0;102;35;0;21;6
36;8;Cangas;02-002-B;488;0;488;324;3;6;164;321;315;161;0;0;2;3;103;25;1;16;4
36;8;Cangas;02-003-A;673;0;673;449;6;4;224;443;439;185;2;2;0;3;177;42;0;17;11
36;8;Cangas;02-003-B;683;0;683;448;6;5;235;442;437;204;0;0;3;1;158;46;0;16;9
36;8;Cangas;02-004-A;527;0;527;344;3;3;183;341;338;140;0;0;2;1;150;18;1;14;12
36;8;Cangas;02-004-B;582;0;582;384;3;6;198;381;375;180;1;0;6;0;142;27;0;14;5
36;8;Cangas;02-005-A;710;0;710;471;6;3;239;465;462;217;1;1;2;4;163;44;1;21;8
36;8;Cangas;02-005-B;780;0;780;532;3;4;248;529;525;241;0;1;2;0;201;51;1;19;9
36;8;Cangas;02-006-A;514;0;514;362;3;0;152;359;359;156;0;0;3;1;133;46;0;15;5
36;8;Cangas;02-006-B;611;0;611;430;3;2;181;427;425;182;1;2;2;3;164;47;0;20;4
36;8;Cangas;02-007-A;845;0;845;559;0;6;286;559;553;263;0;2;4;4;172;82;0;14;12
36;8;Cangas;02-007-B;965;0;965;621;11;3;344;610;607;290;0;0;5;2;217;62;0;23;8
36;8;Cangas;02-008-A;694;0;694;455;5;6;239;450;444;197;0;1;1;2;170;43;0;19;11
36;8;Cangas;02-008-B;748;0;748;476;8;7;272;468;461;241;1;0;5;1;130;44;0;25;14
36;8;Cangas;02-009-U;841;0;841;564;4;3;277;560;557;260;0;0;1;1;190;65;0;31;9
36;8;Cangas;02-010-U;744;0;744;520;6;1;224;514;513;255;0;1;0;5;155;70;2;12;13
36;8;Cangas;03-001-A;471;0;471;288;1;1;183;287;286;93;0;1;4;1;158;17;0;7;5
36;8;Cangas;03-001-B;527;9;536;325;5;1;211;320;319;101;2;1;0;1;162;39;0;7;6
36;8;Cangas;03-002-A;520;8;528;363;2;0;165;361;361;122;1;2;0;1;214;16;0;5;0
36;8;Cangas;03-002-B;550;16;566;384;2;5;182;382;377;142;0;2;0;1;195;21;1;8;7
36;8;Cangas;03-003-A;683;0;683;465;3;5;218;462;457;222;0;2;3;1;171;37;2;13;6
36;8;Cangas;03-003-B;749;0;749;513;1;4;236;512;508;268;0;0;1;0;177;42;0;11;9
36;8;Cangas;03-004-A;488;0;488;344;4;1;144;340;339;176;0;0;1;0;128;18;0;11;5
36;8;Cangas;03-004-B;615;0;615;445;3;2;170;442;440;195;0;2;2;2;188;33;0;11;7
36;10;Catoira;01-001-A;396;0;396;287;3;1;109;284;283;111;1;0;2;0;125;28;0;9;7
36;10;Catoira;01-001-B;622;0;622;444;5;4;178;439;435;213;1;3;2;0;153;46;1;8;8
36;10;Catoira;01-001-C;605;0;605;438;5;2;167;433;431;192;0;1;1;3;164;56;1;6;7
36;10;Catoira;01-002-A;747;0;747;542;7;2;205;535;533;226;0;0;2;0;225;64;1;6;9
36;10;Catoira;01-002-B;430;0;430;349;3;3;81;346;343;155;1;1;1;0;122;53;0;7;3
36;902;Cerdedo-Cotobade;01-001-A;399;0;399;286;4;0;113;282;282;90;0;1;1;0;133;46;0;3;8
36;902;Cerdedo-Cotobade;01-001-B;220;0;220;173;4;2;47;169;167;37;0;0;0;0;97;30;0;1;2
36;902;Cerdedo-Cotobade;01-002-A;412;0;412;313;2;2;99;311;309;74;0;0;0;0;178;41;1;10;5
36;902;Cerdedo-Cotobade;01-002-B;204;0;204;147;1;1;57;146;145;37;0;0;1;0;85;14;0;5;3
36;902;Cerdedo-Cotobade;01-003-A;276;0;276;185;2;0;91;183;183;42;0;0;0;0;92;42;0;3;4
36;902;Cerdedo-Cotobade;01-003-B;228;0;228;179;4;1;49;175;174;36;0;0;0;0;94;34;0;8;2
36;902;Cerdedo-Cotobade;01-003-C;243;0;243;188;0;0;55;188;188;64;0;1;0;1;87;32;0;0;3
36;902;Cerdedo-Cotobade;01-003-D;318;0;318;230;11;4;88;219;215;53;0;0;0;0;135;22;0;0;5
36;902;Cerdedo-Cotobade;01-005-A;460;0;460;337;3;4;123;334;330;81;0;0;0;0;192;44;0;5;8
36;902;Cerdedo-Cotobade;01-005-B;483;0;483;352;7;2;131;345;343;81;0;1;1;0;196;51;0;7;6
36;902;Cerdedo-Cotobade;01-005-C;417;0;417;313;1;3;104;312;309;87;2;0;2;1;157;48;0;6;6
36;902;Cerdedo-Cotobade;02-001-A;355;0;355;234;2;1;121;232;231;45;0;1;1;0;147;29;0;4;4
36;902;Cerdedo-Cotobade;02-001-B;366;0;366;237;2;0;129;235;235;66;0;2;0;2;135;22;0;5;3
36;902;Cerdedo-Cotobade;02-002-A;218;0;218;156;3;0;62;153;153;29;0;0;0;0;103;16;0;1;4
36;902;Cerdedo-Cotobade;02-002-B;367;0;367;261;3;1;106;258;257;60;0;0;0;0;152;41;0;2;2
36;13;Covelo;01-001-A;472;0;472;268;4;3;204;264;261;96;0;0;3;0;111;40;0;4;7
36;13;Covelo;01-001-B;638;0;638;366;2;0;272;364;364;93;0;0;0;0;209;45;0;6;11
36;13;Covelo;01-003-U;521;10;531;294;1;0;237;293;293;85;0;0;0;0;157;31;1;8;11
36;13;Covelo;02-001-A;334;0;334;225;1;0;109;224;224;84;0;1;1;2;119;11;1;3;2
36;13;Covelo;02-001-B;232;0;232;146;1;3;86;145;142;58;0;0;1;1;64;10;1;3;4
36;14;Crecente;01-001-A;338;0;338;244;1;0;94;243;243;30;0;1;0;1;183;25;0;3;0
36;14;Crecente;01-001-B;209;0;209;163;0;0;46;163;163;24;0;0;0;0;116;15;0;5;3
36;14;Crecente;01-002-A;378;0;378;286;2;1;92;284;283;57;0;1;3;0;187;26;0;6;3
36;14;Crecente;01-002-B;258;0;258;155;1;0;103;154;154;52;0;0;1;0;80;13;0;5;3
36;14;Crecente;01-002-C;207;0;207;145;1;1;62;144;143;25;0;1;0;0;106;8;0;1;2
36;14;Crecente;01-002-D;204;0;204;158;3;1;46;155;154;29;0;0;2;0;104;19;0;0;0
36;14;Crecente;01-002-E;211;0;211;164;2;1;47;162;161;33;0;0;0;1;88;33;0;5;1
36;15;Cuntis;01-001-A;834;0;834;598;7;7;236;591;584;196;0;0;0;0;295;78;0;8;7
36;15;Cuntis;01-001-B;446;0;446;318;6;4;128;312;308;90;0;1;2;0;153;58;0;0;4
36;15;Cuntis;01-002-A;480;1;481;356;4;3;125;352;349;139;0;1;0;0;135;61;0;11;2
36;15;Cuntis;01-002-B;242;0;242;166;6;3;76;160;157;53;0;0;1;0;75;22;1;1;4
36;15;Cuntis;02-001-A;493;0;493;338;4;5;155;334;329;95;0;2;0;0;168;52;0;7;5
36;15;Cuntis;02-001-B;291;0;291;199;1;1;92;198;197;63;0;0;0;0;92;38;0;1;3
36;15;Cuntis;03-001-A;278;0;278;171;0;0;107;171;171;36;0;0;0;0;103;29;0;0;3
36;15;Cuntis;03-001-B;274;0;274;188;2;3;86;186;183;43;0;0;0;0;108;27;1;1;3
36;15;Cuntis;03-002-U;583;0;583;411;2;7;172;409;402;97;0;0;0;0;213;81;0;6;5
36;16;Dozón;01-001-A;341;0;341;246;3;2;95;243;241;39;0;0;1;0;182;14;0;4;1
36;16;Dozón;01-001-B;220;0;220;184;3;1;36;181;180;28;0;0;0;0;131;15;0;0;6
36;16;Dozón;01-001-C;393;0;393;270;2;1;123;268;267;45;0;0;0;0;208;9;0;2;3
36;18;Forcarei;01-001-U;728;0;728;489;6;2;239;483;481;138;0;0;1;0;241;78;2;4;17
36;18;Forcarei;01-002-A;262;0;262;191;3;2;71;188;186;53;0;0;0;0;107;22;0;2;2
36;18;Forcarei;01-002-B;253;0;253;173;4;2;80;169;167;39;0;0;1;0;104;23;0;0;0
36;18;Forcarei;01-002-C;362;0;362;231;0;2;131;231;229;42;0;1;1;0;148;32;0;0;5
36;18;Forcarei;02-001-A;655;0;655;439;5;2;216;434;432;84;0;0;0;0;276;62;0;3;7
36;18;Forcarei;02-001-B;245;0;245;157;2;0;88;155;155;37;0;0;0;0;67;48;0;2;1
36;18;Forcarei;02-001-C;326;0;326;246;3;2;80;243;241;66;0;1;0;0;139;33;0;0;2
36;19;Fornelos de Montes;01-001-A;479;0;479;286;4;5;193;282;277;72;2;0;3;0;112;73;0;3;12
36;19;Fornelos de Montes;01-001-B;365;0;365;237;1;0;128;236;236;42;1;0;0;0;93;88;1;5;6
36;19;Fornelos de Montes;01-002-A;327;0;327;197;2;1;130;195;194;40;1;1;1;0;67;75;0;1;8
36;19;Fornelos de Montes;01-002-B;287;0;287;194;0;0;93;194;194;27;0;0;0;0;77;76;0;7;7
36;21;Gondomar;01-001-A;554;0;554;341;7;2;213;334;332;134;0;0;4;1;129;48;1;7;8
36;21;Gondomar;01-001-B;550;0;550;355;1;7;195;354;347;123;0;1;3;0;144;50;0;13;13
36;21;Gondomar;01-002-A;660;0;660;459;1;2;201;458;456;118;0;0;0;0;251;69;0;7;11
36;21;Gondomar;01-002-B;552;0;552;365;8;3;187;357;354;86;0;0;0;3;205;38;1;13;8
36;21;Gondomar;01-003-A;685;0;685;447;6;5;238;441;436;140;0;0;1;3;217;55;1;10;9
36;21;Gondomar;01-003-B;671;0;671;438;3;1;233;435;434;122;0;1;2;2;201;80;0;15;11
36;21;Gondomar;01-004-A;578;0;578;377;1;3;201;376;373;129;0;0;1;5;161;56;0;12;9
36;21;Gondomar;01-004-B;596;0;596;406;4;3;190;402;399;137;0;0;1;1;187;60;0;8;5
36;21;Gondomar;01-005-A;598;0;598;397;6;3;201;391;388;118;0;0;1;3;202;43;3;10;8
36;21;Gondomar;01-005-B;572;0;572;379;5;4;193;374;370;98;0;0;2;0;196;43;1;17;13
36;21;Gondomar;01-006-A;465;0;465;303;9;6;162;294;288;100;1;1;2;0;141;22;0;14;7
36;21;Gondomar;01-006-B;433;0;433;287;5;1;146;282;281;100;0;0;0;1;119;48;0;4;9
36;21;Gondomar;02-001-A;687;0;687;466;6;3;221;460;457;131;0;1;1;0;232;65;2;14;11
36;21;Gondomar;02-001-B;372;0;372;222;3;1;150;219;218;54;0;0;0;0;110;37;1;4;12
36;21;Gondomar;02-002-A;857;0;857;614;3;2;243;611;609;217;3;3;7;3;242;99;0;19;16
36;21;Gondomar;02-002-B;358;0;358;231;8;2;127;223;221;65;0;0;0;2;119;25;0;3;7
36;21;Gondomar;03-001-A;904;0;904;566;10;9;338;556;547;213;0;2;3;7;198;93;0;12;19
36;21;Gondomar;03-001-B;952;0;952;576;9;5;376;567;562;217;0;4;2;4;215;82;0;21;17
36;21;Gondomar;03-002-A;773;0;773;559;3;4;214;556;552;147;0;0;2;1;289;86;1;18;8
36;21;Gondomar;03-002-B;806;0;806;549;7;1;257;542;541;151;0;1;1;0;281;74;2;17;14
36;24;Lalín;01-001-A;643;0;643;452;10;3;191;442;439;134;0;1;0;0;255;39;0;4;6
36;24;Lalín;01-001-B;642;0;642;451;10;2;191;441;439;123;0;1;2;0;263;33;0;4;13
36;24;Lalín;01-002-A;900;0;900;608;10;4;292;598;594;167;1;1;2;2;341;55;1;11;13
36;24;Lalín;01-002-B;876;0;876;608;6;5;268;602;597;147;0;2;3;0;365;60;2;9;9
36;24;Lalín;01-003-A;393;0;393;332;4;1;61;328;327;66;0;0;1;0;237;21;0;1;1
36;24;Lalín;01-003-B;216;0;216;155;2;1;61;153;152;16;0;0;0;0;128;7;0;0;1
36;24;Lalín;01-003-C;272;0;272;225;3;0;47;222;222;35;0;0;0;0;174;9;0;0;4
36;24;Lalín;01-004-A;451;0;451;324;7;1;127;317;316;69;0;1;1;0;221;19;0;0;5
36;24;Lalín;01-004-B;231;0;231;189;2;4;42;187;183;64;0;3;0;0;97;12;0;4;3
36;24;Lalín;01-004-C;403;0;403;323;3;0;80;320;320;55;0;1;0;1;219;28;0;8;8
36;24;Lalín;01-005-A;595;0;595;430;9;1;165;421;420;83;0;0;2;0;283;42;0;6;4
36;24;Lalín;01-005-B;385;0;385;274;7;2;111;267;265;66;0;0;0;0;178;14;0;1;6
36;24;Lalín;01-005-C;358;0;358;248;8;0;110;240;240;62;1;0;1;0;143;23;1;5;4
36;24;Lalín;01-005-D;231;0;231;160;3;2;71;157;155;46;0;0;0;0;84;18;0;3;4
36;24;Lalín;01-006-A;790;0;790;566;4;1;224;562;561;182;0;2;1;0;307;55;3;4;7
36;24;Lalín;01-006-B;843;0;843;628;7;9;215;621;612;186;0;2;2;0;340;64;0;9;9
36;24;Lalín;01-007-A;807;0;807;555;12;2;252;543;541;139;0;1;1;1;334;37;1;9;18
36;24;Lalín;01-007-B;782;0;782;554;8;6;228;546;540;153;0;0;3;2;317;47;1;7;10
36;24;Lalín;01-008-A;772;0;772;566;4;7;206;562;555;157;1;2;1;1;327;49;1;6;10
36;24;Lalín;01-008-B;716;0;716;512;4;6;204;508;502;159;0;1;2;1;266;60;0;4;9
36;24;Lalín;02-001-A;288;0;288;231;1;4;57;230;226;37;0;0;2;0;160;20;0;0;7
36;24;Lalín;02-001-B;207;0;207;163;5;2;44;158;156;37;0;1;1;0;102;10;0;1;4
36;24;Lalín;02-001-C;245;0;245;176;1;2;69;175;173;55;0;0;0;0;105;11;0;0;2
36;24;Lalín;02-001-D;248;0;248;186;2;0;62;184;184;35;0;0;0;0;127;19;0;3;0
36;24;Lalín;02-003-U;543;0;543;414;7;1;129;407;406;62;0;0;0;0;293;40;0;1;10
36;24;Lalín;03-001-A;225;0;225;179;1;4;46;178;174;31;0;0;2;1;130;7;0;1;2
36;24;Lalín;03-001-B;261;0;261;211;3;1;50;208;207;49;0;0;1;0;154;2;0;1;0
36;24;Lalín;03-001-C;284;0;284;225;2;1;59;223;222;38;0;0;0;1;168;12;0;0;3
36;24;Lalín;03-001-D;210;0;210;161;0;2;49;161;159;21;0;0;0;0;124;9;1;3;1
36;24;Lalín;03-001-E;206;0;206;154;1;0;52;153;153;25;0;0;0;0;108;13;0;2;5
36;24;Lalín;04-001-A;387;0;387;300;4;1;87;296;295;61;0;0;1;0;183;38;0;2;10
36;24;Lalín;04-001-B;475;0;475;364;5;2;111;359;357;64;0;0;0;0;256;25;0;6;6
36;24;Lalín;04-001-C;224;0;224;189;3;1;35;186;185;35;0;0;0;0;134;10;0;0;6
36;24;Lalín;05-001-A;354;0;354;272;3;1;82;269;268;44;1;1;0;0;183;33;1;0;5
36;24;Lalín;05-001-B;217;0;217;161;1;1;56;160;159;29;0;0;0;0;107;17;0;2;4
36;24;Lalín;05-001-C;315;0;315;260;4;2;55;256;254;45;0;0;0;1;190;16;0;0;2
36;26;Marín;01-001-A;531;0;531;321;5;2;210;316;314;112;0;1;0;5;136;45;0;6;9
36;26;Marín;01-001-B;550;0;550;330;2;4;220;328;324;125;0;0;4;0;137;40;0;5;13
36;26;Marín;01-002-A;531;0;531;317;6;5;214;311;306;95;0;0;4;1;161;36;0;3;6
36;26;Marín;01-002-B;681;0;681;435;4;4;246;431;427;121;0;3;3;0;225;58;1;3;13
36;26;Marín;01-003-A;822;0;822;533;6;3;289;527;524;179;2;2;1;2;246;70;1;8;13
36;26;Marín;01-003-B;900;0;900;557;2;3;343;555;552;198;0;1;4;0;242;74;0;13;20
36;26;Marín;01-004-A;435;7;442;268;5;1;174;263;262;80;0;0;1;0;113;50;0;9;9
36;26;Marín;01-004-B;527;0;527;310;2;3;217;308;305;93;0;0;2;3;144;45;0;7;11
36;26;Marín;01-005-A;666;0;666;375;2;4;291;373;369;114;1;1;5;0;164;66;0;3;15
36;26;Marín;01-005-B;688;0;688;414;6;3;274;408;405;138;0;0;4;2;179;63;1;8;10
36;26;Marín;01-006-A;711;0;711;465;3;7;246;462;455;162;0;1;3;2;200;60;0;11;16
36;26;Marín;01-006-B;804;0;804;511;6;10;293;505;495;175;1;0;1;0;224;77;0;10;7
36;26;Marín;01-007-A;667;0;667;398;9;7;269;389;382;117;0;1;2;4;187;45;0;11;15
36;26;Marín;01-007-B;769;0;769;453;9;2;316;444;442;152;0;2;2;1;201;45;0;18;21
36;26;Marín;01-008-U;965;0;965;567;9;6;398;558;552;190;1;0;3;2;252;61;0;13;30
36;26;Marín;01-009-U;837;0;837;566;8;3;271;558;555;153;1;0;0;1;308;63;0;15;14
36;26;Marín;01-010-A;416;0;416;252;3;1;164;249;248;76;0;0;2;1;115;39;0;2;13
36;26;Marín;01-010-B;504;0;504;340;6;3;164;334;331;107;0;0;3;2;162;40;0;6;11
36;26;Marín;01-011-A;743;0;743;463;5;5;280;458;453;145;0;2;2;3;218;58;2;11;12
36;26;Marín;01-011-B;886;0;886;568;8;6;318;560;554;172;0;1;3;0;278;70;2;13;15
36;26;Marín;02-001-A;592;0;592;379;2;3;213;377;374;103;0;0;1;4;206;44;0;3;13
36;26;Marín;02-001-B;673;0;673;397;4;0;276;393;393;101;0;0;2;3;216;47;0;5;19
36;26;Marín;02-002-A;904;0;904;603;6;7;301;597;590;155;0;1;0;0;342;76;0;10;6
36;26;Marín;02-002-B;497;0;497;313;1;3;184;312;309;95;0;1;0;2;169;32;1;2;7
36;26;Marín;03-001-A;670;0;670;414;8;8;256;406;398;117;0;1;0;0;210;51;0;4;15
36;26;Marín;03-001-B;708;0;708;459;4;7;249;455;448;153;0;0;1;0;228;52;0;4;10
36;26;Marín;03-002-U;900;10;910;562;4;6;348;558;552;150;0;0;0;0;322;50;0;12;18
36;26;Marín;03-003-A;678;0;678;480;1;1;198;479;478;125;0;1;0;1;290;42;0;10;9
36;26;Marín;03-003-B;667;0;667;448;2;8;219;446;438;145;0;1;2;2;240;36;0;7;5
36;27;Meaño;01-001-A;394;0;394;308;3;2;86;305;303;76;1;0;0;1;179;37;0;4;5
36;27;Meaño;01-001-B;544;0;544;409;4;1;135;405;404;99;0;2;0;1;240;43;0;12;7
36;27;Meaño;01-002-A;264;0;264;206;3;0;58;203;203;49;0;1;1;0;129;15;0;4;4
36;27;Meaño;01-002-B;387;0;387;286;2;0;101;284;284;66;0;0;0;0;172;34;0;3;9
36;27;Meaño;02-001-A;509;0;509;354;3;2;155;351;349;71;0;0;4;1;219;44;0;4;6
36;27;Meaño;02-001-B;449;0;449;294;0;1;155;294;293;49;0;0;0;0;211;18;0;6;9
36;27;Meaño;02-002-U;815;0;815;564;8;3;251;556;553;149;0;0;0;0;309;67;0;6;22
36;27;Meaño;02-003-A;485;0;485;348;1;1;137;347;346;114;0;1;0;0;190;28;0;3;10
36;27;Meaño;02-003-B;540;0;540;366;4;3;174;362;359;110;0;1;1;0;211;27;0;3;6
36;28;Meis;01-001-U;643;0;643;454;3;6;189;451;445;77;0;0;0;0;322;33;0;3;10
36;28;Meis;01-002-A;373;0;373;293;2;3;80;291;288;76;0;0;0;0;142;56;0;0;14
36;28;Meis;01-002-B;397;0;397;306;0;2;91;306;304;63;1;0;1;0;179;50;1;7;2
36;28;Meis;02-001-U;767;0;767;545;3;2;222;542;540;140;0;2;1;1;310;66;0;7;13
36;28;Meis;02-002-U;766;0;766;545;7;1;221;538;537;170;0;0;2;0;253;101;0;6;5
36;28;Meis;02-003-A;601;0;601;411;2;3;190;409;406;110;0;0;0;1;179;97;1;4;14
36;28;Meis;02-003-B;459;0;459;353;7;1;106;346;345;80;0;1;0;0;192;64;0;3;5
36;29;Moaña;01-001-U;887;0;887;570;12;8;317;558;550;284;1;0;2;4;206;29;1;14;9
36;29;Moaña;01-002-A;479;0;479;350;8;2;129;342;340;165;0;3;1;1;115;27;1;18;9
36;29;Moaña;01-002-B;633;0;633;432;8;4;201;424;420;170;0;0;1;0;178;46;0;15;10
36;29;Moaña;01-003-U;521;0;521;349;4;2;172;345;343;156;0;0;1;2;152;18;0;5;9
36;29;Moaña;01-004-A;535;0;535;367;2;3;168;365;362;196;0;5;1;1;120;28;1;5;5
36;29;Moaña;01-004-B;598;0;598;409;6;3;189;403;400;206;0;1;2;1;143;31;2;7;7
36;29;Moaña;01-004-C;245;0;245;182;0;4;63;182;178;97;0;0;2;1;54;21;0;2;1
36;29;Moaña;01-005-A;678;0;678;499;8;5;179;491;486;252;0;0;0;3;161;35;0;20;15
36;29;Moaña;01-005-B;546;0;546;390;2;3;156;388;385;179;0;0;0;6;139;44;0;7;10
36;29;Moaña;01-005-C;707;0;707;481;5;6;226;476;470;237;2;1;2;3;151;47;0;20;7
36;29;Moaña;01-006-U;785;0;785;504;8;6;281;496;490;210;0;2;1;1;203;39;1;18;15
36;29;Moaña;01-007-U;812;0;812;558;10;2;254;548;546;219;0;2;2;0;234;67;1;12;9
36;29;Moaña;02-001-A;528;9;537;346;5;4;191;341;337;176;0;0;0;0;126;22;0;11;2
36;29;Moaña;02-001-B;714;0;714;478;7;3;236;471;468;242;0;1;5;2;147;44;0;14;13
36;29;Moaña;02-002-A;454;0;454;314;5;6;140;309;303;138;0;1;2;1;100;42;1;13;5
36;29;Moaña;02-002-B;557;0;557;378;4;5;179;374;369;157;0;0;1;1;149;39;0;15;7
36;29;Moaña;02-003-A;710;0;710;480;4;4;230;476;472;229;0;0;1;1;184;42;1;12;2
36;29;Moaña;02-003-B;765;0;765;525;0;6;240;525;519;263;0;0;2;0;185;46;0;12;11
36;29;Moaña;03-001-A;715;0;715;495;1;2;220;494;492;208;0;2;3;5;214;48;0;2;10
36;29;Moaña;03-001-B;545;0;545;342;2;5;203;340;335;141;0;0;2;2;101;60;0;21;8
36;29;Moaña;03-002-A;273;0;273;182;2;3;91;180;177;69;0;0;2;3;81;12;0;5;5
36;29;Moaña;03-002-B;544;0;544;391;6;4;153;385;381;170;0;0;0;2;141;44;0;4;20
36;29;Moaña;03-003-A;575;0;575;393;9;5;182;384;379;188;0;0;1;0;127;42;0;9;12
36;29;Moaña;03-003-B;712;0;712;485;9;4;227;476;472;193;0;1;1;2;205;45;0;14;11
36;29;Moaña;03-004-U;883;0;883;598;12;3;285;586;583;294;0;2;2;2;162;89;0;21;11
36;29;Moaña;03-005-U;871;0;871;598;7;2;273;591;589;248;2;0;2;5;232;74;0;10;16
36;30;Mondariz;01-001-A;665;1;666;480;1;8;186;479;471;175;0;0;0;2;166;80;0;34;14
36;30;Mondariz;01-001-B;534;0;534;361;3;2;173;358;356;139;0;0;1;1;129;46;1;30;9
36;30;Mondariz;01-001-C;268;0;268;170;6;2;98;164;162;42;0;0;5;0;81;20;0;12;2
36;30;Mondariz;02-001-A;383;0;383;260;8;1;123;252;251;88;0;0;0;1;116;29;0;10;7
36;30;Mondariz;02-001-B;260;0;260;174;3;3;86;171;168;23;0;2;1;0;119;18;0;2;3
36;30;Mondariz;02-001-C;229;0;229;137;1;3;92;136;133;35;0;0;1;1;78;13;0;3;2
36;30;Mondariz;02-001-D;215;0;215;159;5;0;56;154;154;54;0;0;0;0;68;18;0;10;4
36;30;Mondariz;02-003-A;242;0;242;140;1;2;102;139;137;34;0;0;0;0;79;16;0;8;0
36;30;Mondariz;02-003-B;293;0;293;192;1;2;101;191;189;44;0;0;0;0;113;25;0;7;0
36;30;Mondariz;03-001-A;212;0;212;142;2;0;70;140;140;54;0;2;2;0;64;9;0;6;3
36;30;Mondariz;03-001-B;305;0;305;236;2;4;69;234;230;78;0;1;0;0;104;31;0;8;8
36;30;Mondariz;03-001-C;262;0;262;177;1;2;85;176;174;69;0;0;1;0;73;19;0;8;4
36;31;Mondariz-Balneario;01-001-U;588;0;588;426;5;4;162;421;417;179;0;1;1;1;184;30;0;8;13
36;32;Moraña;01-001-A;872;0;872;630;12;4;242;618;614;182;2;1;1;0;335;76;0;3;14
36;32;Moraña;01-001-B;669;0;669;470;9;4;199;461;457;152;0;0;1;0;231;59;2;5;7
36;32;Moraña;01-002-A;369;0;369;286;7;1;83;279;278;64;0;0;0;0;160;40;0;7;7
36;32;Moraña;01-002-B;300;0;300;220;0;1;80;220;219;41;0;0;1;3;133;31;1;3;6
36;32;Moraña;01-002-C;254;0;254;192;3;1;62;189;188;51;0;0;0;0;113;17;0;3;4
36;32;Moraña;02-001-A;292;0;292;228;2;2;64;226;224;71;0;1;0;1;116;24;0;0;11
36;32;Moraña;02-001-B;282;0;282;220;4;1;62;216;215;48;0;0;0;0;131;26;0;5;5
36;32;Moraña;02-001-C;422;0;422;307;6;2;115;301;299;62;0;0;0;0;179;46;0;6;6
36;33;Mos;01-001-A;621;0;621;464;7;3;157;457;454;143;0;0;1;0;247;46;0;10;7
36;33;Mos;01-001-B;625;0;625;466;13;4;159;453;449;124;1;0;5;1;237;55;1;12;13
36;33;Mos;01-002-A;670;0;670;468;6;5;202;462;457;161;0;0;0;3;195;63;1;16;18
36;33;Mos;01-002-B;705;0;705;496;11;7;209;485;478;162;3;1;4;0;216;68;0;10;14
36;33;Mos;02-001-A;641;0;641;445;2;1;196;443;442;173;1;0;2;0;177;74;1;9;5
36;33;Mos;02-001-B;666;0;666;503;7;6;163;496;490;200;0;1;2;1;211;55;0;6;14
36;33;Mos;02-002-A;484;0;484;347;5;1;137;342;341;111;0;1;1;3;179;35;0;8;3
36;33;Mos;02-002-B;563;0;563;409;4;3;154;405;402;136;0;1;0;0;192;54;0;3;16
36;33;Mos;02-003-A;593;0;593;418;10;5;175;408;403;128;0;1;2;3;184;72;0;8;5
36;33;Mos;02-003-B;622;0;622;422;6;4;200;416;412;143;1;1;1;1;194;56;0;10;5
36;33;Mos;03-001-A;615;0;615;438;7;2;177;431;429;162;0;0;0;0;199;48;0;14;6
36;33;Mos;03-001-B;538;0;538;406;7;0;132;399;399;166;0;1;1;0;176;45;0;8;2
36;33;Mos;03-001-C;555;0;555;434;7;1;121;427;426;160;0;1;1;0;186;62;0;13;3
36;33;Mos;03-002-U;723;0;723;539;7;4;184;532;528;195;0;0;1;0;232;88;0;8;4
36;33;Mos;03-003-A;494;0;494;367;2;2;127;365;363;124;0;2;1;1;169;46;0;8;12
36;33;Mos;03-003-B;574;0;574;426;7;3;148;419;416;123;0;0;2;0;220;61;0;1;9
36;33;Mos;03-004-A;777;0;777;532;6;5;245;526;521;217;2;2;2;3;183;79;1;11;21
36;33;Mos;03-004-B;500;0;500;338;3;2;162;335;333;146;0;0;0;2;117;48;0;11;9
36;33;Mos;03-004-C;600;0;600;406;7;5;194;399;394;179;1;1;3;1;140;55;0;7;7
36;33;Mos;03-005-U;811;0;811;517;5;3;294;512;509;251;0;1;3;2;162;69;0;10;11
36;35;Nigrán;01-001-A;733;0;733;580;12;5;153;568;563;176;0;2;1;2;287;61;2;18;14
36;35;Nigrán;01-001-B;805;0;805;487;2;2;318;485;483;150;0;0;2;1;253;54;0;9;14
36;35;Nigrán;01-002-A;599;0;599;381;4;4;218;377;373;104;1;1;3;1;181;54;0;13;15
36;35;Nigrán;01-002-B;600;0;600;395;4;2;205;391;389;113;0;0;0;2;178;72;0;16;8
36;35;Nigrán;01-002-C;402;0;402;266;8;3;136;258;255;95;1;2;1;0;92;51;0;8;5
36;35;Nigrán;01-003-A;671;0;671;448;5;5;223;443;438;155;1;2;1;1;198;58;2;6;14
36;35;Nigrán;01-003-B;665;0;665;449;6;1;216;443;442;160;1;0;0;2;194;58;1;8;18
36;35;Nigrán;01-003-C;513;0;513;351;7;0;162;344;344;127;0;0;4;2;144;53;0;7;7
36;35;Nigrán;02-001-A;825;0;825;540;3;8;285;537;529;147;0;0;1;1;287;67;0;18;8
36;35;Nigrán;02-001-B;751;0;751;496;3;3;255;493;490;156;0;2;2;2;240;62;0;13;13
36;35;Nigrán;02-002-A;470;0;470;333;1;2;137;332;330;86;0;1;1;4;191;36;0;7;4
36;35;Nigrán;02-002-B;506;1;507;345;1;0;162;344;344;81;0;0;1;2;198;56;0;3;3
36;35;Nigrán;02-003-U;910;0;910;553;9;5;357;544;539;150;1;1;2;3;275;87;0;8;12
36;35;Nigrán;02-004-A;733;0;733;507;11;6;226;496;490;151;0;1;0;0;230;80;0;13;15
36;35;Nigrán;02-004-B;796;0;796;552;4;3;244;548;545;184;0;1;2;2;271;58;0;12;15
36;35;Nigrán;03-001-A;754;0;754;510;6;2;244;504;502;152;1;0;4;6;259;58;0;11;11
36;35;Nigrán;03-001-B;738;0;738;493;5;1;245;488;487;166;0;2;0;4;225;67;0;12;11
36;35;Nigrán;03-002-A;660;0;660;458;2;7;202;456;449;121;1;1;2;1;231;65;0;13;14
36;35;Nigrán;03-002-B;530;0;530;351;10;3;179;341;338;108;0;1;3;2;155;42;0;14;13
36;35;Nigrán;03-002-C;582;0;582;397;1;3;185;396;393;104;0;0;1;2;187;74;1;14;10
36;35;Nigrán;03-003-A;568;0;568;364;9;2;204;355;353;107;0;0;2;2;168;59;0;6;9
36;35;Nigrán;03-003-B;623;0;623;408;3;4;215;405;401;116;0;0;3;1;188;75;0;9;9
36;35;Nigrán;03-003-C;602;0;602;393;10;4;209;383;379;114;1;1;4;4;172;68;0;4;11
36;22;O Grove;01-001-A;726;0;726;452;6;2;274;446;444;220;0;0;3;3;127;58;1;18;14
36;22;O Grove;01-001-B;641;0;641;411;1;11;230;410;399;185;0;0;0;2;120;56;0;30;6
36;22;O Grove;01-002-A;758;0;758;473;4;4;285;469;465;222;0;0;2;1;144;74;0;13;9
36;22;O Grove;01-002-B;722;0;722;452;5;4;270;447;443;198;1;1;2;1;150;59;1;21;9
36;22;O Grove;01-003-A;513;0;513;333;5;2;180;328;326;144;0;0;1;2;110;43;0;14;12
36;22;O Grove;01-003-B;616;0;616;393;6;8;223;387;379;155;0;1;2;3;125;67;0;14;12
36;22;O Grove;01-004-A;768;0;768;509;7;2;259;502;500;226;0;2;2;0;174;73;1;12;10
36;22;O Grove;01-004-B;714;0;714;473;7;4;241;466;462;201;0;2;2;2;174;60;0;9;12
36;22;O Grove;01-005-A;470;0;470;304;5;3;166;299;296;130;0;1;0;0;102;45;0;13;5
36;22;O Grove;01-005-B;413;0;413;283;12;4;130;271;267;121;1;1;0;3;82;38;0;15;6
36;22;O Grove;02-001-A;760;0;760;510;11;5;250;499;494;225;0;0;3;1;150;68;0;26;21
36;22;O Grove;02-001-B;486;0;486;305;3;1;181;302;301;126;0;0;2;0;117;37;0;14;5
36;22;O Grove;02-001-C;439;0;439;285;6;3;154;279;276;125;0;1;5;2;92;34;1;10;6
36;22;O Grove;02-002-A;442;0;442;284;3;2;158;281;279;82;1;0;1;0;156;28;0;6;5
36;22;O Grove;02-002-B;573;0;573;370;7;2;203;363;361;139;0;0;2;0;151;53;1;6;9
36;39;O Porriño;01-001-A;470;0;470;286;2;5;184;284;279;117;0;0;1;1;109;44;0;3;4
36;39;O Porriño;01-001-B;406;0;406;260;4;0;146;256;256;108;0;1;0;1;86;41;0;13;6
36;39;O Porriño;01-001-C;489;0;489;329;6;4;160;323;319;133;1;2;1;1;130;33;0;15;3
36;39;O Porriño;01-002-A;554;0;554;357;10;5;197;347;342;145;0;0;0;3;131;41;0;17;5
36;39;O Porriño;01-002-B;591;0;591;391;6;1;200;385;384;186;0;0;1;1;124;46;0;17;9
36;39;O Porriño;01-003-A;520;0;520;313;0;2;207;313;311;123;0;1;2;2;138;26;0;9;10
36;39;O Porriño;01-003-B;495;0;495;292;5;4;203;287;283;90;1;0;0;1;146;28;0;6;11
36;39;O Porriño;01-004-U;733;0;733;501;9;3;232;492;489;147;0;1;2;1;267;48;0;14;9
36;39;O Porriño;01-005-A;710;0;710;476;8;3;234;468;465;193;0;1;2;1;183;62;1;12;10
36;39;O Porriño;01-005-B;778;0;778;539;5;6;239;534;528;226;0;0;3;1;207;72;0;13;6
36;39;O Porriño;01-006-A;638;0;638;444;6;4;194;438;434;164;0;1;4;4;181;59;1;13;7
36;39;O Porriño;01-006-B;684;0;684;481;8;1;203;473;472;196;0;0;3;4;182;55;1;24;7
36;39;O Porriño;01-006-C;368;0;368;275;8;1;93;267;266;79;0;1;1;2;141;34;0;4;4
36;39;O Porriño;01-007-A;686;0;686;388;9;7;298;379;372;142;0;0;2;6;146;54;2;11;9
36;39;O Porriño;01-007-B;619;0;619;346;6;7;273;340;333;122;1;2;1;3;150;32;0;7;15
36;39;O Porriño;01-008-U;767;0;767;491;7;2;276;484;482;198;1;1;0;1;182;78;0;14;7
36;39;O Porriño;01-009-U;772;0;772;531;8;5;241;523;518;192;0;0;7;0;231;56;2;18;12
36;39;O Porriño;02-001-U;834;0;834;583;13;5;251;570;565;179;0;1;1;0;293;59;2;15;15
36;39;O Porriño;02-002-U;846;0;846;544;8;6;302;536;530;170;0;0;4;1;279;54;1;9;12
36;39;O Porriño;02-003-A;570;0;570;420;4;5;150;416;411;121;0;1;3;1;233;37;0;6;9
36;39;O Porriño;02-003-B;571;0;571;390;4;1;181;386;385;107;1;0;1;1;224;42;1;5;3
36;39;O Porriño;02-003-C;722;0;722;476;6;2;246;470;468;144;1;0;4;2;265;41;0;7;4
36;39;O Porriño;03-001-A;730;0;730;526;6;4;204;520;516;132;1;0;6;2;329;31;0;5;10
36;39;O Porriño;03-001-B;437;0;437;317;2;0;120;315;315;74;0;0;3;0;196;19;0;11;12
36;39;O Porriño;03-002-A;573;0;573;434;8;1;139;426;425;95;0;0;2;1;302;14;0;6;5
36;39;O Porriño;03-002-B;587;0;587;432;2;0;155;430;430;103;0;0;2;2;284;26;0;4;9
36;48;O Rosal;01-001-A;785;0;785;517;6;6;268;511;505;214;0;1;3;2;207;55;0;13;10
36;48;O Rosal;01-001-B;676;0;676;446;11;1;230;435;434;213;0;1;1;2;162;33;1;13;8
36;48;O Rosal;01-002-U;861;0;861;588;16;10;273;572;562;196;0;0;2;2;265;57;0;17;23
36;48;O Rosal;01-003-U;541;0;541;358;8;6;183;350;344;148;0;1;0;1;154;28;0;12;0
36;48;O Rosal;01-004-A;451;0;451;335;9;4;116;326;322;123;1;1;2;0;164;22;0;2;7
36;48;O Rosal;01-004-B;644;0;644;452;6;1;192;446;445;174;0;0;3;1;213;40;0;6;8
36;48;O Rosal;02-001-U;771;0;771;564;10;1;207;554;553;248;0;1;1;1;224;63;1;9;5
36;48;O Rosal;02-002-U;743;0;743;490;4;3;253;486;483;189;0;1;1;1;219;50;0;14;8
36;36;Oia;01-001-A;596;0;596;439;3;0;157;436;436;127;0;0;3;0;201;80;0;11;14
36;36;Oia;01-001-B;319;0;319;225;5;1;94;220;219;90;0;0;2;3;79;34;0;8;3
36;36;Oia;01-002-A;412;0;412;296;5;0;116;291;291;99;0;1;0;1;160;18;0;10;2
36;36;Oia;01-002-B;613;0;613;432;6;3;181;426;423;138;1;2;1;1;193;62;0;16;9
36;36;Oia;02-001-A;313;0;313;239;3;0;74;236;236;50;0;0;0;0;152;30;0;2;2
36;36;Oia;02-001-B;323;0;323;234;3;2;89;231;229;37;1;1;0;1;152;27;0;3;7
36;37;Pazos de Borbén;01-001-A;451;0;451;306;1;3;145;305;302;125;0;0;3;0;141;18;0;7;8
36;37;Pazos de Borbén;01-001-B;418;0;418;274;6;1;144;268;267;121;0;2;4;0;99;24;0;7;10
36;37;Pazos de Borbén;01-001-C;428;0;428;290;6;3;138;284;281;114;2;0;2;0;127;25;0;9;2
36;37;Pazos de Borbén;02-001-A;223;0;223;153;0;1;70;153;152;48;0;1;0;0;82;15;1;3;2
36;37;Pazos de Borbén;02-001-B;218;0;218;138;4;1;80;134;133;46;0;0;1;0;57;22;0;3;4
36;37;Pazos de Borbén;02-001-C;481;0;481;318;3;0;163;315;315;100;0;1;3;0;156;38;0;7;10
36;37;Pazos de Borbén;02-001-D;338;0;338;241;3;3;97;238;235;70;0;0;4;0;127;25;0;5;4
36;41;Poio;01-001-A;502;0;502;304;2;3;198;302;299;119;0;0;2;0;124;37;0;6;11
36;41;Poio;01-001-B;534;0;534;335;4;3;199;331;328;133;0;2;1;3;139;32;0;8;10
36;41;Poio;01-002-A;472;0;472;336;3;3;136;333;330;67;0;0;2;0;192;56;0;4;9
36;41;Poio;01-002-B;502;0;502;352;3;4;150;349;345;100;0;0;1;0;181;39;1;13;10
36;41;Poio;01-002-C;547;0;547;358;5;1;189;353;352;90;0;1;3;1;201;44;0;9;3
36;41;Poio;01-003-A;504;1;505;347;3;1;158;344;343;87;0;0;0;0;189;42;1;13;11
36;41;Poio;01-003-B;425;0;425;293;4;2;132;289;287;63;0;0;1;0;172;33;1;5;12
36;41;Poio;01-003-C;483;0;483;331;3;3;152;328;325;77;0;1;2;0;204;25;1;3;12
36;41;Poio;01-004-U;809;0;809;527;2;8;282;525;517;179;0;2;3;3;253;57;0;11;9
36;41;Poio;01-005-A;514;0;514;357;5;1;157;352;351;97;0;0;2;1;191;49;0;4;7
36;41;Poio;01-005-B;537;0;537;340;4;2;197;336;334;84;0;0;0;1;198;40;0;5;6
36;41;Poio;01-005-C;513;0;513;352;2;0;161;350;350;101;0;2;0;1;195;45;0;5;1
36;41;Poio;01-006-A;564;0;564;369;0;7;195;369;362;96;0;0;1;0;220;31;0;4;10
36;41;Poio;01-006-B;544;1;545;333;1;6;212;332;326;61;1;0;3;1;194;52;0;7;7
36;41;Poio;01-006-C;542;0;542;362;1;2;180;361;359;89;0;0;5;1;211;44;0;2;7
36;41;Poio;01-007-A;641;0;641;390;0;2;251;390;388;141;1;0;3;1;170;46;0;11;15
36;41;Poio;01-007-B;662;0;662;402;1;5;260;401;396;154;1;0;2;1;160;48;0;12;18
36;41;Poio;01-008-A;662;0;662;408;5;5;254;403;398;104;1;1;3;1;233;40;0;8;7
36;41;Poio;01-008-B;713;0;713;446;3;6;267;443;437;146;1;0;0;0;228;48;2;5;7
36;41;Poio;02-001-A;456;0;456;309;3;1;147;306;305;90;0;0;1;0;160;42;1;6;5
36;41;Poio;02-001-B;539;0;539;340;2;3;199;338;335;97;0;0;5;0;180;40;1;3;9
36;41;Poio;02-001-C;516;0;516;344;1;0;172;343;343;111;0;0;1;0;177;43;0;3;8
36;41;Poio;02-002-A;452;0;452;322;4;2;130;318;316;82;0;1;0;1;164;54;0;10;4
36;41;Poio;02-002-B;496;0;496;328;7;0;168;321;321;89;1;0;2;1;168;47;0;6;7
36;41;Poio;02-003-A;446;0;446;303;2;1;143;301;300;87;0;0;1;1;173;23;0;5;10
36;41;Poio;02-003-B;527;0;527;360;3;5;167;357;352;100;0;0;3;2;219;15;0;8;5
36;43;Ponte Caldelas;01-001-A;480;0;480;294;6;2;186;288;286;94;1;0;3;2;148;27;0;4;7
36;43;Ponte Caldelas;01-001-B;513;0;513;313;2;1;200;311;310;86;1;0;0;2;169;47;0;0;5
36;43;Ponte Caldelas;01-002-A;794;0;794;542;2;2;252;540;538;183;0;1;3;0;270;61;0;7;13
36;43;Ponte Caldelas;01-002-B;461;0;461;311;1;0;150;310;310;82;0;1;3;1;162;46;0;6;9
36;43;Ponte Caldelas;02-001-A;271;0;271;184;1;3;87;183;180;67;0;0;0;0;71;38;0;0;4
36;43;Ponte Caldelas;02-001-B;553;0;553;381;2;4;172;379;375;131;0;0;1;2;168;61;1;3;8
36;43;Ponte Caldelas;03-001-U;665;0;665;389;4;2;276;385;383;133;0;1;1;1;155;69;0;6;17
36;43;Ponte Caldelas;03-002-A;431;0;431;281;5;1;150;276;275;77;0;0;1;1;141;35;0;11;9
36;43;Ponte Caldelas;03-002-B;567;0;567;374;6;2;193;368;366;92;0;1;1;0;205;47;0;8;12
36;42;Ponteareas;01-001-A;533;0;533;346;3;1;187;343;342;122;0;1;2;3;153;46;0;8;7
36;42;Ponteareas;01-001-B;587;0;587;378;4;3;209;374;371;142;2;3;1;1;159;42;0;10;11
36;42;Ponteareas;01-001-C;570;0;570;362;3;5;208;359;354;130;0;0;0;1;158;47;1;12;5
36;42;Ponteareas;01-002-A;640;0;640;431;7;4;209;424;420;171;1;2;3;0;148;64;1;20;10
36;42;Ponteareas;01-002-B;599;0;599;394;6;4;205;388;384;148;0;0;0;0;167;39;1;18;11
36;42;Ponteareas;01-003-U;675;0;675;442;6;7;233;436;429;154;0;0;2;0;194;52;0;15;12
36;42;Ponteareas;01-004-A;223;0;223;147;5;0;76;142;142;41;0;0;0;0;75;18;0;5;3
36;42;Ponteareas;01-004-B;325;0;325;206;7;0;119;199;199;66;0;0;0;3;92;20;0;7;11
36;42;Ponteareas;01-004-C;492;0;492;333;3;1;159;330;329;106;0;0;2;0;166;42;0;8;5
36;42;Ponteareas;01-006-A;747;0;747;474;5;5;273;469;464;205;0;0;0;1;178;56;0;15;9
36;42;Ponteareas;01-006-B;679;0;679;465;9;4;214;456;452;204;0;3;1;0;180;45;2;11;6
36;42;Ponteareas;01-007-A;608;1;609;377;9;2;232;368;366;169;0;0;3;0;123;44;0;17;10
36;42;Ponteareas;01-007-B;553;0;553;348;5;1;205;343;342;165;0;0;1;0;117;35;0;11;13
36;42;Ponteareas;01-008-A;564;1;565;354;4;1;211;350;349;148;0;0;3;3;128;50;0;11;6
36;42;Ponteareas;01-008-B;536;0;536;344;4;3;192;340;337;135;0;0;3;6;127;48;0;10;8
36;42;Ponteareas;01-009-A;668;0;668;427;13;8;241;414;406;184;0;1;5;3;138;41;1;19;14
36;42;Ponteareas;01-009-B;533;0;533;339;5;2;194;334;332;164;0;0;4;0;104;38;0;10;12
36;42;Ponteareas;01-009-C;580;0;580;366;5;4;214;361;357;156;0;4;1;0;136;34;0;15;11
36;42;Ponteareas;01-010-A;631;0;631;382;5;7;249;377;370;164;0;0;1;2;132;52;0;7;12
36;42;Ponteareas;01-010-B;625;16;641;422;5;2;219;417;415;192;0;1;3;1;162;39;0;9;8
36;42;Ponteareas;02-001-A;411;0;411;267;6;4;144;261;257;83;1;0;2;0;105;44;0;15;7
36;42;Ponteareas;02-001-B;494;0;494;330;6;3;164;324;321;130;0;0;1;1;151;31;1;3;3
36;42;Ponteareas;02-002-U;737;0;737;472;7;3;265;465;462;179;2;0;0;3;190;57;0;21;10
36;42;Ponteareas;03-001-A;424;0;424;269;2;2;155;267;265;96;0;0;0;1;128;29;0;4;7
36;42;Ponteareas;03-001-B;440;0;440;286;4;2;154;282;280;105;0;1;0;0;144;16;0;8;6
36;42;Ponteareas;03-001-C;216;0;216;168;3;0;48;165;165;53;1;0;2;1;80;18;1;1;8
36;42;Ponteareas;03-002-A;514;0;514;372;6;1;142;366;365;159;0;0;1;0;136;56;0;9;4
36;42;Ponteareas;03-002-B;457;0;457;313;3;1;144;310;309;133;1;0;1;0;105;60;0;3;6
36;42;Ponteareas;03-003-A;612;0;612;432;3;2;180;429;427;195;0;1;2;1;172;40;1;10;5
36;42;Ponteareas;03-003-B;381;0;381;257;6;1;124;251;250;83;1;1;1;2;117;29;0;7;9
36;42;Ponteareas;04-001-A;713;0;713;481;4;1;232;477;476;155;1;0;1;1;250;50;2;12;4
36;42;Ponteareas;04-001-B;500;0;500;332;5;4;168;327;323;116;0;0;1;3;143;42;1;8;9
36;42;Ponteareas;04-003-A;435;0;435;308;4;3;127;304;301;117;0;0;2;1;136;28;2;7;8
36;42;Ponteareas;04-003-B;343;0;343;254;4;1;89;250;249;93;0;0;2;0;111;28;0;10;5
36;42;Ponteareas;04-003-C;315;0;315;230;2;1;85;228;227;80;2;0;2;1;111;25;0;5;1
36;42;Ponteareas;04-003-D;243;0;243;180;0;3;63;180;177;66;0;0;0;1;74;21;1;7;7
36;44;Pontecesures;01-001-U;712;0;712;483;8;3;229;475;472;167;0;0;0;1;250;43;1;3;7
36;44;Pontecesures;01-002-A;617;0;617;420;2;2;197;418;416;154;0;0;1;3;194;46;0;5;13
36;44;Pontecesures;01-002-B;677;0;677;454;5;2;223;449;447;173;1;1;1;1;206;53;0;7;4
36;44;Pontecesures;01-002-C;605;0;605;427;0;3;178;427;424;174;0;0;0;1;200;35;0;6;8
36;38;Pontevedra;01-001-U;773;0;773;506;6;2;267;500;498;177;0;0;2;2;232;66;0;8;11
36;38;Pontevedra;01-002-A;633;0;633;458;1;3;175;457;454;182;0;3;3;0;181;68;0;9;8
36;38;Pontevedra;01-002-B;542;0;542;389;5;5;153;384;379;128;1;1;1;0;179;51;0;10;8
36;38;Pontevedra;01-002-C;696;0;696;516;3;4;180;513;509;190;1;1;4;0;227;64;0;10;12
36;38;Pontevedra;01-003-A;693;0;693;488;6;8;205;482;474;167;0;1;2;1;205;76;2;14;6
36;38;Pontevedra;01-003-B;724;0;724;512;3;5;212;509;504;168;0;3;5;2;223;83;0;9;11
36;38;Pontevedra;01-004-A;503;0;503;363;2;3;140;361;358;97;0;1;1;0;201;44;0;9;5
36;38;Pontevedra;01-004-B;539;0;539;398;2;3;141;396;393;103;0;0;2;0;232;43;0;3;10
36;38;Pontevedra;01-005-U;869;0;869;586;8;2;283;578;576;251;2;2;1;2;220;84;0;8;6
36;38;Pontevedra;01-006-A;608;0;608;421;3;7;187;418;411;117;1;4;1;0;214;54;2;9;9
36;38;Pontevedra;01-006-B;602;0;602;424;2;6;178;422;416;149;0;3;3;3;197;46;0;8;7
36;38;Pontevedra;01-007-A;796;0;796;574;4;8;222;570;562;170;1;0;2;3;282;76;0;10;18
36;38;Pontevedra;01-007-B;960;0;960;674;8;6;286;666;660;205;0;0;3;1;302;109;0;18;22
36;38;Pontevedra;01-008-A;630;0;630;416;5;8;214;411;403;158;1;0;5;2;165;51;0;8;13
36;38;Pontevedra;01-008-B;674;0;674;436;3;3;238;433;430;155;0;2;1;2;187;58;0;15;10
36;38;Pontevedra;01-009-A;605;0;605;386;1;2;219;385;383;161;0;1;2;4;152;47;1;7;8
36;38;Pontevedra;01-009-B;646;0;646;450;1;6;196;449;443;189;4;1;0;0;187;43;0;14;5
36;38;Pontevedra;01-010-U;997;0;997;626;5;8;371;621;613;234;1;2;10;0;259;65;3;22;17
36;38;Pontevedra;02-001-A;657;0;657;462;2;4;195;460;456;145;1;0;3;1;223;64;0;12;7
36;38;Pontevedra;02-001-B;780;0;780;553;5;2;227;548;546;168;0;1;3;4;272;77;0;9;12
36;38;Pontevedra;02-002-A;706;0;706;526;4;1;180;522;521;136;0;1;0;0;289;59;0;16;20
36;38;Pontevedra;02-002-B;801;0;801;601;4;5;200;597;592;153;2;4;2;2;341;64;3;10;11
36;38;Pontevedra;02-003-A;553;0;553;400;2;4;153;398;394;116;0;1;1;1;214;54;0;2;5
36;38;Pontevedra;02-003-B;612;0;612;440;2;7;172;438;431;148;0;0;0;2;210;60;0;1;10
36;38;Pontevedra;02-004-A;583;0;583;432;4;4;151;428;424;155;0;0;4;0;202;56;1;3;3
36;38;Pontevedra;02-004-B;720;0;720;511;5;2;209;506;504;184;0;0;3;1;230;64;1;10;11
36;38;Pontevedra;02-005-A;451;0;451;296;1;0;155;295;295;104;0;0;1;0;142;38;1;5;4
36;38;Pontevedra;02-005-B;494;0;494;345;2;5;149;343;338;111;1;1;2;0;159;46;1;10;7
36;38;Pontevedra;02-006-A;678;0;678;478;4;9;200;474;465;189;0;0;2;2;176;79;0;6;11
36;38;Pontevedra;02-006-B;772;0;772;483;4;3;289;479;476;181;0;1;4;2;197;72;1;9;9
36;38;Pontevedra;02-007-A;539;0;539;332;1;1;207;331;330;127;2;0;1;1;132;48;0;8;11
36;38;Pontevedra;02-007-B;522;0;522;352;8;5;170;344;339;132;1;1;0;2;133;52;1;8;9
36;38;Pontevedra;02-008-A;725;0;725;533;3;6;192;530;524;177;0;2;1;1;237;77;1;14;14
36;38;Pontevedra;02-008-B;754;0;754;552;4;5;202;548;543;183;0;0;2;3;261;71;1;13;9
36;38;Pontevedra;02-009-A;414;0;414;275;1;3;139;274;271;104;0;0;0;0;114;42;0;8;3
36;38;Pontevedra;02-009-B;464;0;464;307;4;5;157;303;298;107;1;0;1;0;129;48;0;10;2
36;38;Pontevedra;02-010-A;444;0;444;340;1;8;104;339;331;100;0;0;0;2;166;55;0;3;5
36;38;Pontevedra;02-010-B;461;0;461;355;1;2;106;354;352;99;0;0;4;1;174;55;1;7;11
36;38;Pontevedra;02-011-A;831;0;831;609;1;10;222;608;598;260;0;2;2;2;226;81;0;11;14
36;38;Pontevedra;02-011-B;844;0;844;619;1;6;225;618;612;216;0;2;4;2;273;92;0;16;7
36;38;Pontevedra;02-012-A;597;0;597;430;5;3;167;425;422;141;2;4;3;0;190;64;0;7;11
36;38;Pontevedra;02-012-B;623;0;623;449;3;5;174;446;441;141;0;0;3;1;206;55;0;23;12
36;38;Pontevedra;02-013-U;599;0;599;428;5;5;171;423;418;139;1;0;2;1;198;61;0;9;7
36;38;Pontevedra;02-014-A;828;0;828;538;3;7;290;535;528;203;0;1;1;1;229;71;0;10;12
36;38;Pontevedra;02-014-B;826;1;827;542;1;5;285;541;536;216;1;2;3;5;211;75;1;11;11
36;38;Pontevedra;02-015-A;722;0;722;471;3;6;251;468;462;159;0;0;1;1;202;77;0;12;10
36;38;Pontevedra;02-015-B;675;0;675;451;2;5;224;449;444;162;1;2;1;1;172;81;0;17;7
36;38;Pontevedra;02-016-A;538;0;538;384;3;9;154;381;372;139;0;0;0;1;164;61;0;4;3
36;38;Pontevedra;02-016-B;578;0;578;456;8;6;122;448;442;148;0;1;1;0;213;64;0;7;8
36;38;Pontevedra;02-017-A;468;0;468;336;2;3;132;334;331;109;0;0;0;0;165;41;0;10;6
36;38;Pontevedra;02-017-B;528;0;528;389;4;3;139;385;382;142;0;0;2;2;190;32;1;8;5
36;38;Pontevedra;02-018-A;712;0;712;498;5;3;214;493;490;202;1;4;3;1;186;73;2;8;10
36;38;Pontevedra;02-018-B;682;0;682;454;3;0;228;451;451;172;0;4;5;1;197;59;0;7;6
36;38;Pontevedra;02-019-U;684;0;684;466;2;4;218;464;460;154;0;0;3;2;211;68;1;11;10
36;38;Pontevedra;02-020-A;763;0;763;462;5;3;301;457;454;169;0;1;0;0;178;83;0;12;11
36;38;Pontevedra;02-020-B;755;0;755;484;3;2;271;481;479;196;0;3;4;4;175;75;2;11;9
36;38;Pontevedra;02-021-U;930;1;931;697;5;8;234;692;684;308;2;2;2;2;267;76;0;12;13
36;38;Pontevedra;02-022-A;894;0;894;611;6;7;283;605;598;238;1;1;6;0;251;75;2;15;9
36;38;Pontevedra;02-022-B;861;0;861;629;10;6;232;619;613;263;0;3;2;0;254;62;0;21;8
36;38;Pontevedra;02-023-A;858;0;858;601;3;7;257;598;591;235;0;1;4;0;238;76;1;20;16
36;38;Pontevedra;02-023-B;832;0;832;592;7;5;240;585;580;245;0;3;0;2;218;84;0;16;12
36;38;Pontevedra;02-024-U;941;0;941;690;5;6;251;685;679;264;2;2;4;1;289;84;0;16;17
36;38;Pontevedra;02-025-A;661;0;661;498;0;9;163;498;489;198;0;1;2;1;195;69;1;12;10
36;38;Pontevedra;02-025-B;715;0;715;512;3;9;203;509;500;201;0;3;2;2;212;59;0;10;11
36;38;Pontevedra;02-026-A;581;0;581;439;3;3;142;436;433;164;0;1;2;0;204;50;1;4;7
36;38;Pontevedra;02-026-B;643;0;643;491;2;3;152;489;486;178;0;3;0;1;221;56;1;20;6
36;38;Pontevedra;03-001-A;554;0;554;361;4;5;193;357;352;116;0;0;0;0;166;51;1;6;12
36;38;Pontevedra;03-001-B;578;0;578;375;6;0;203;369;369;128;0;1;2;0;178;45;1;5;9
36;38;Pontevedra;03-002-U;628;0;628;379;6;8;249;373;365;134;1;1;0;0;166;41;1;14;7
36;38;Pontevedra;03-003-U;605;0;605;375;6;1;230;369;368;82;0;1;2;1;201;49;0;12;20
36;38;Pontevedra;03-004-A;452;0;452;271;4;2;181;267;265;90;0;0;3;1;112;42;0;7;10
36;38;Pontevedra;03-004-B;470;0;470;274;3;4;196;271;267;96;2;0;8;1;115;33;1;5;6
36;38;Pontevedra;03-005-A;415;0;415;245;3;0;170;242;242;102;0;0;0;0;105;21;0;6;8
36;38;Pontevedra;03-005-B;511;0;511;302;4;6;209;298;292;90;0;2;3;1;144;36;0;7;9
36;38;Pontevedra;04-001-U;549;0;549;298;1;4;251;297;293;62;0;3;0;1;172;39;0;5;11
36;38;Pontevedra;04-002-U;726;0;726;481;4;5;245;477;472;146;1;3;0;0;221;82;0;8;11
36;38;Pontevedra;04-003-A;386;0;386;268;3;3;118;265;262;92;0;0;2;1;128;25;0;9;5
36;38;Pontevedra;04-003-B;516;0;516;355;2;3;161;353;350;118;0;0;2;2;180;37;0;6;5
36;38;Pontevedra;04-004-A;425;0;425;283;0;5;142;283;278;102;0;0;0;0;112;43;0;14;7
36;38;Pontevedra;04-004-B;491;0;491;341;2;7;150;339;332;130;0;0;3;2;123;58;0;9;7
36;38;Pontevedra;04-005-U;774;0;774;535;8;3;239;527;524;162;0;1;1;0;244;89;2;11;14
36;38;Pontevedra;04-006-U;615;0;615;386;6;2;229;380;378;114;0;0;0;2;197;52;1;7;5
36;38;Pontevedra;04-007-U;822;0;822;515;16;5;307;499;494;155;1;1;5;1;233;66;1;15;16
36;38;Pontevedra;04-008-A;552;0;552;363;2;3;189;361;358;112;0;1;2;3;169;46;0;13;12
36;38;Pontevedra;04-008-B;624;0;624;360;1;0;264;359;359;125;0;0;2;2;159;47;1;14;9
36;38;Pontevedra;04-009-A;450;0;450;250;0;3;200;250;247;71;0;0;1;1;101;57;0;6;10
36;38;Pontevedra;04-009-B;370;0;370;216;1;2;154;215;213;50;1;0;2;0;98;55;0;5;2
36;38;Pontevedra;04-010-A;810;0;810;484;6;3;326;478;475;154;0;0;6;2;192;84;1;10;26
36;38;Pontevedra;04-010-B;902;0;902;518;7;2;384;511;509;184;1;0;5;3;198;91;2;17;8
36;38;Pontevedra;04-011-A;606;0;606;378;6;4;228;372;368;137;0;0;1;0;154;49;1;11;15
36;38;Pontevedra;04-011-B;634;0;634;377;6;2;257;371;369;131;0;0;2;1;147;56;0;16;16
36;38;Pontevedra;05-001-A;294;5;299;218;2;1;81;216;215;70;0;2;0;0;113;24;0;4;2
36;38;Pontevedra;05-001-B;301;0;301;192;2;3;109;190;187;39;1;0;0;0;103;29;0;7;8
36;38;Pontevedra;05-002-U;624;0;624;436;4;4;188;432;428;93;11;0;3;0;243;63;0;7;8
36;38;Pontevedra;05-003-A;475;0;475;321;0;0;154;321;321;76;1;0;1;0;196;31;1;8;7
36;38;Pontevedra;05-003-B;447;0;447;290;1;1;157;289;288;54;0;0;3;1;176;43;2;3;6
36;38;Pontevedra;05-004-U;600;0;600;407;5;1;193;402;401;96;1;2;2;0;225;53;2;10;10
36;38;Pontevedra;05-005-U;744;0;744;500;5;4;244;495;491;146;0;0;3;4;194;114;0;19;11
36;38;Pontevedra;05-006-U;645;0;645;437;5;6;208;432;426;127;0;0;0;2;224;56;1;7;9
36;38;Pontevedra;06-001-U;752;0;752;495;2;1;257;493;492;130;1;0;0;0;254;87;0;5;15
36;38;Pontevedra;06-002-U;697;0;697;462;0;4;235;462;458;154;0;0;5;1;187;83;0;10;18
36;38;Pontevedra;06-003-A;468;0;468;306;4;1;162;302;301;93;0;2;2;1;156;37;0;7;3
36;38;Pontevedra;06-003-B;430;0;430;320;0;0;110;320;320;89;1;0;2;1;164;48;0;11;4
36;38;Pontevedra;07-001-A;400;0;400;285;5;6;115;280;274;111;0;1;1;1;120;32;1;4;3
36;38;Pontevedra;07-001-B;457;0;457;331;4;2;126;327;325;136;0;0;0;0;128;42;2;9;8
36;38;Pontevedra;07-001-C;203;0;203;142;2;5;61;140;135;92;0;0;0;0;34;7;0;2;0
36;40;Portas;01-001-A;314;0;314;215;3;1;99;212;211;74;0;0;1;0;104;27;0;1;4
36;40;Portas;01-001-B;752;0;752;516;8;3;236;508;505;131;0;3;1;0;312;42;1;6;9
36;40;Portas;02-001-U;579;0;579;399;6;2;180;393;391;135;0;2;0;0;188;45;0;6;15
36;40;Portas;02-002-U;765;0;765;566;8;5;199;558;553;127;0;1;1;0;315;85;0;10;14
36;45;Redondela;01-001-A;736;0;736;484;3;3;252;481;478;210;0;0;3;2;170;62;0;16;15
36;45;Redondela;01-001-B;718;0;718;490;8;1;228;482;481;204;0;1;4;1;164;77;1;13;16
36;45;Redondela;01-002-A;735;0;735;539;5;5;196;534;529;248;1;0;4;0;171;81;1;17;6
36;45;Redondela;01-002-B;551;0;551;387;7;2;164;380;378;187;0;0;0;0;131;49;0;6;5
36;45;Redondela;01-002-C;689;0;689;509;6;2;180;503;501;221;0;4;1;2;196;62;2;13;0
36;45;Redondela;01-003-A;650;0;650;434;2;3;216;432;429;179;0;0;3;0;180;56;0;5;6
36;45;Redondela;01-003-B;581;0;581;394;10;3;187;384;381;170;0;1;2;0;142;46;0;14;6
36;45;Redondela;01-004-A;574;0;574;385;3;3;189;382;379;144;0;1;2;2;145;65;0;10;10
36;45;Redondela;01-004-B;580;0;580;396;5;5;184;391;386;175;2;1;1;0;127;68;0;7;5
36;45;Redondela;01-005-U;686;0;686;505;7;4;181;498;494;173;0;0;4;1;190;95;2;10;19
36;45;Redondela;01-006-A;806;0;806;577;10;2;229;567;565;257;1;0;3;3;195;80;0;10;16
36;45;Redondela;01-006-B;741;0;741;497;4;3;244;493;490;205;0;2;2;2;171;76;1;20;11
36;45;Redondela;02-001-A;448;1;449;329;2;6;120;327;321;116;2;0;1;0;118;68;1;9;6
36;45;Redondela;02-001-B;397;0;397;279;3;3;118;276;273;113;0;0;1;0;95;51;0;7;6
36;45;Redondela;02-002-A;411;0;411;270;4;8;141;266;258;91;0;2;1;0;113;41;0;5;5
36;45;Redondela;02-002-B;421;0;421;283;1;5;138;282;277;98;0;0;1;0;112;48;0;10;8
36;45;Redondela;02-003-A;425;0;425;287;2;2;138;285;283;125;0;0;1;0;79;63;1;8;6
36;45;Redondela;02-003-B;468;0;468;295;6;1;173;289;288;109;0;3;2;2;97;61;1;9;4
36;45;Redondela;02-004-A;649;0;649;386;3;0;263;383;383;140;0;1;2;1;125;85;0;17;12
36;45;Redondela;02-004-B;450;0;450;271;2;3;179;269;266;105;0;2;1;0;90;62;0;4;2
36;45;Redondela;02-004-C;635;0;635;366;2;1;269;364;363;144;0;1;3;2;117;66;1;19;10
36;45;Redondela;02-005-A;654;0;654;451;4;2;203;447;445;194;1;3;1;3;129;84;0;18;12
36;45;Redondela;02-005-B;422;0;422;286;0;2;136;286;284;141;0;1;0;1;71;50;0;11;9
36;45;Redondela;02-005-C;611;0;611;427;5;2;184;422;420;173;0;0;3;2;138;74;3;12;15
36;45;Redondela;02-006-A;466;0;466;340;2;1;126;338;337;94;0;1;1;0;157;65;1;9;9
36;45;Redondela;02-006-B;449;0;449;291;2;0;158;289;289;107;0;2;3;1;114;50;0;7;5
36;45;Redondela;02-007-A;487;0;487;305;1;2;182;304;302;142;1;1;1;1;86;57;0;3;10
36;45;Redondela;02-007-B;444;0;444;272;1;2;172;271;269;123;0;0;0;0;101;30;1;9;5
36;45;Redondela;02-008-U;804;1;805;518;1;2;287;517;515;209;0;0;5;1;177;95;0;16;12
36;45;Redondela;03-001-A;743;0;743;507;4;3;236;503;500;201;0;0;0;1;200;76;0;14;8
36;45;Redondela;03-001-B;636;0;636;433;5;0;203;428;428;162;0;0;0;0;169;77;1;7;12
36;45;Redondela;03-002-A;657;0;657;439;6;0;218;433;433;161;1;0;3;1;183;66;0;9;9
36;45;Redondela;03-002-B;743;0;743;495;6;7;248;489;482;203;0;1;2;1;190;60;1;17;7
36;45;Redondela;03-003-A;621;0;621;425;7;0;196;418;418;165;0;0;2;0;176;57;0;9;9
36;45;Redondela;03-003-B;589;0;589;374;6;1;215;368;367;132;1;3;2;0;144;75;1;6;3
36;45;Redondela;03-003-C;550;1;551;400;9;1;151;391;390;148;0;0;3;0;153;73;0;3;10
36;45;Redondela;04-001-A;575;0;575;382;5;1;193;377;376;129;0;0;2;0;131;95;0;13;6
36;45;Redondela;04-001-B;434;0;434;278;6;2;156;272;270;100;0;1;2;2;118;43;0;2;2
36;45;Redondela;04-002-A;597;0;597;426;3;3;171;423;420;151;0;0;4;1;183;60;0;13;8
36;45;Redondela;04-002-B;563;0;563;413;4;5;150;409;404;142;0;0;1;0;190;54;0;7;10
36;45;Redondela;04-003-A;638;0;638;430;7;4;208;423;419;151;3;0;4;1;146;92;0;6;16
36;45;Redondela;04-003-B;386;0;386;241;1;3;145;240;237;70;1;2;0;0;102;49;0;5;8
36;46;Ribadumia;01-001-A;701;0;701;534;6;4;167;528;524;108;0;2;0;1;340;50;0;9;14
36;46;Ribadumia;01-001-B;344;0;344;213;2;2;131;211;209;45;0;0;0;0;125;28;0;4;7
36;46;Ribadumia;01-001-C;410;0;410;299;9;3;111;290;287;94;0;3;4;2;136;41;0;4;3
36;46;Ribadumia;01-002-A;466;0;466;346;8;3;120;338;335;61;0;1;2;0;196;60;0;6;9
36;46;Ribadumia;01-002-B;350;0;350;276;1;3;74;275;272;84;0;1;0;0;143;36;0;0;8
36;46;Ribadumia;02-001-A;580;0;580;400;6;3;180;394;391;105;1;0;3;1;227;36;0;4;14
36;46;Ribadumia;02-001-B;536;0;536;374;4;2;162;370;368;107;1;1;4;3;195;43;0;7;7
36;46;Ribadumia;02-001-C;211;0;211;178;4;0;33;174;174;52;0;0;0;0;88;23;0;2;9
36;46;Ribadumia;02-002-U;575;0;575;450;5;1;125;445;444;111;0;0;0;2;255;60;1;6;9
36;47;Rodeiro;01-001-A;613;0;613;454;3;3;159;451;448;91;1;0;0;0;271;75;0;2;8
36;47;Rodeiro;01-001-B;207;0;207;143;1;0;64;142;142;35;0;0;0;1;79;24;0;2;1
36;47;Rodeiro;02-001-A;336;0;336;259;2;0;77;257;257;39;0;0;0;0;173;44;0;0;1
36;47;Rodeiro;02-001-B;305;0;305;206;3;1;99;203;202;33;0;0;0;0;115;49;0;0;5
36;47;Rodeiro;03-001-A;324;0;324;241;0;1;83;241;240;51;0;1;0;0;137;48;0;1;2
36;47;Rodeiro;03-001-B;262;0;262;179;1;2;83;178;176;37;0;0;0;0;103;31;0;2;3
36;49;Salceda de Caselas;01-001-A;622;0;622;421;5;4;201;416;412;164;1;0;1;1;185;36;0;18;6
36;49;Salceda de Caselas;01-001-B;662;0;662;454;5;3;208;449;446;167;0;2;2;2;211;37;1;18;6
36;49;Salceda de Caselas;01-002-A;424;0;424;309;2;2;115;307;305;91;0;0;1;0;164;28;2;6;13
36;49;Salceda de Caselas;01-002-B;561;0;561;386;6;4;175;380;376;125;0;0;2;1;201;37;0;3;7
36;49;Salceda de Caselas;01-003-U;602;0;602;454;6;3;148;448;445;185;0;2;1;2;195;40;2;9;9
36;49;Salceda de Caselas;01-004-A;786;0;786;543;15;1;243;528;527;221;0;3;6;1;217;44;2;21;12
36;49;Salceda de Caselas;01-004-B;808;0;808;536;8;2;272;528;526;235;1;2;2;2;202;51;0;18;13
36;49;Salceda de Caselas;01-005-U;578;0;578;367;11;5;211;356;351;148;0;1;1;3;138;36;0;11;13
36;49;Salceda de Caselas;02-001-A;573;0;573;386;3;2;187;383;381;97;0;0;3;0;212;43;0;7;19
36;49;Salceda de Caselas;02-001-B;793;0;793;601;9;2;192;592;590;181;0;1;1;3;329;49;3;9;14
36;49;Salceda de Caselas;02-002-A;469;0;469;326;2;2;143;324;322;124;0;0;1;0;143;29;0;12;13
36;49;Salceda de Caselas;02-002-B;393;0;393;302;4;3;91;298;295;83;0;1;1;1;170;15;0;9;15
36;50;Salvaterra de Miño;01-001-A;667;0;667;438;5;2;229;433;431;205;1;1;2;1;147;55;0;9;10
36;50;Salvaterra de Miño;01-001-B;688;0;688;472;5;5;216;467;462;225;2;2;4;2;156;52;0;5;14
36;50;Salvaterra de Miño;01-002-A;413;0;413;275;4;1;138;271;270;110;0;0;3;0;103;44;0;5;5
36;50;Salvaterra de Miño;01-002-B;720;0;720;507;10;3;213;497;494;199;0;2;1;1;190;83;0;7;11
36;50;Salvaterra de Miño;01-003-A;263;0;263;175;4;2;88;171;169;53;0;0;1;0;75;31;0;7;2
36;50;Salvaterra de Miño;01-003-B;258;0;258;167;4;0;91;163;163;44;0;0;2;0;84;32;0;0;1
36;50;Salvaterra de Miño;01-004-U;561;0;561;405;6;3;156;399;396;115;0;0;0;1;198;59;0;7;16
36;50;Salvaterra de Miño;01-005-A;284;3;287;195;3;1;92;192;191;57;0;0;1;0;93;27;0;3;10
36;50;Salvaterra de Miño;01-005-B;361;0;361;267;4;3;94;263;260;108;0;2;0;0;99;39;0;7;5
36;50;Salvaterra de Miño;01-005-C;275;0;275;177;2;2;98;175;173;46;0;1;1;0;88;23;1;4;9
36;50;Salvaterra de Miño;01-006-A;359;0;359;271;2;2;88;269;267;103;0;0;1;0;85;64;0;6;8
36;50;Salvaterra de Miño;01-006-B;232;0;232;141;1;1;91;140;139;41;0;0;0;0;62;32;0;2;2
36;50;Salvaterra de Miño;01-006-C;211;0;211;147;3;0;64;144;144;53;0;2;2;1;58;24;1;1;2
36;50;Salvaterra de Miño;01-007-A;380;0;380;274;3;3;106;271;268;98;0;1;0;0;111;46;1;6;5
36;50;Salvaterra de Miño;01-007-B;648;0;648;445;9;2;203;436;434;176;0;0;0;0;166;61;1;14;16
36;50;Salvaterra de Miño;01-008-A;894;0;894;580;8;5;314;572;567;227;2;1;5;0;233;73;0;10;16
36;50;Salvaterra de Miño;01-008-B;863;0;863;562;7;8;301;555;547;210;0;1;0;0;204;97;0;16;19
36;51;Sanxenxo;01-001-A;649;0;649;448;3;5;201;445;440;107;1;1;0;0;255;59;0;8;9
36;51;Sanxenxo;01-001-B;635;0;635;418;1;3;217;417;414;127;1;1;2;1;238;32;0;3;9
36;51;Sanxenxo;01-002-U;538;0;538;372;6;3;166;366;363;132;1;0;0;1;179;42;0;2;6
36;51;Sanxenxo;01-003-A;574;2;576;382;6;5;194;376;371;116;0;0;0;0;207;41;0;2;5
36;51;Sanxenxo;01-003-B;611;0;611;406;4;4;205;402;398;130;0;1;2;0;210;44;0;2;9
36;51;Sanxenxo;01-004-A;628;0;628;445;1;3;183;444;441;127;0;1;3;2;243;50;1;5;9
36;51;Sanxenxo;01-004-B;708;0;708;500;7;5;208;493;488;123;0;3;3;2;269;69;0;7;12
36;51;Sanxenxo;01-004-C;518;0;518;362;4;0;156;358;358;103;0;1;0;2;172;73;0;1;6
36;51;Sanxenxo;01-005-A;730;0;730;482;5;5;248;477;472;143;0;1;3;0;272;33;0;9;11
36;51;Sanxenxo;01-005-B;809;0;809;526;3;0;283;523;523;180;1;1;0;0;291;33;0;7;10
36;51;Sanxenxo;01-006-A;509;0;509;325;9;4;184;316;312;95;0;1;1;1;181;22;0;4;7
36;51;Sanxenxo;01-006-B;562;0;562;387;5;2;175;382;380;113;0;0;0;1;209;43;0;3;11
36;51;Sanxenxo;01-007-U;689;0;689;450;4;4;239;446;442;140;0;1;5;1;219;62;0;7;7
36;51;Sanxenxo;02-001-U;661;0;661;432;8;2;229;424;422;107;0;0;1;1;258;37;0;9;9
36;51;Sanxenxo;02-002-A;491;0;491;312;5;3;179;307;304;95;0;0;1;1;160;42;0;1;4
36;51;Sanxenxo;02-002-B;658;0;658;436;1;0;222;435;435;127;0;0;2;4;236;51;0;6;9
36;51;Sanxenxo;02-003-U;699;0;699;487;3;5;212;484;479;158;0;2;0;0;254;41;1;5;18
36;51;Sanxenxo;03-001-A;576;0;576;370;8;6;206;362;356;117;0;0;0;0;174;50;0;8;7
36;51;Sanxenxo;03-001-B;534;0;534;335;5;4;199;330;326;92;0;0;1;0;168;45;0;9;11
36;51;Sanxenxo;03-002-U;731;0;731;486;1;5;245;485;480;152;0;0;1;1;245;67;0;5;9
36;51;Sanxenxo;03-003-A;477;0;477;337;3;4;140;334;330;88;1;0;2;0;182;35;0;9;13
36;51;Sanxenxo;03-003-B;596;0;596;413;3;2;183;410;408;85;0;0;0;0;252;49;1;4;17
36;51;Sanxenxo;03-004-A;484;0;484;320;5;1;164;315;314;71;0;0;0;2;202;24;0;3;12
36;51;Sanxenxo;03-004-B;728;0;728;497;1;3;231;496;493;134;0;0;1;0;290;56;0;3;9
36;52;Silleda;01-001-A;886;0;886;626;11;1;260;615;614;191;0;1;0;1;305;94;0;8;14
36;52;Silleda;01-001-B;996;0;996;672;15;7;324;657;650;196;0;0;2;0;327;96;0;13;16
36;52;Silleda;01-002-A;262;0;262;188;1;1;74;187;186;31;0;0;0;0;121;30;0;1;3
36;52;Silleda;01-002-B;230;0;230;168;5;1;62;163;162;31;0;0;0;2;90;32;0;2;5
36;52;Silleda;01-002-C;207;0;207;132;1;0;75;131;131;39;0;0;0;0;66;23;0;2;1
36;52;Silleda;01-003-A;506;0;506;365;2;4;141;363;359;102;0;1;1;0;186;54;0;3;12
36;52;Silleda;01-003-B;601;0;601;455;13;4;146;442;438;113;1;1;1;1;249;52;0;9;11
36;52;Silleda;01-003-C;233;0;233;154;2;1;79;152;151;39;0;0;0;0;90;19;0;2;1
36;52;Silleda;01-003-D;204;0;204;152;2;0;52;150;150;39;0;0;0;1;85;21;0;2;2
36;52;Silleda;02-001-A;378;0;378;257;2;1;121;255;254;61;0;2;0;1;156;30;0;3;1
36;52;Silleda;02-001-B;273;0;273;204;1;1;69;203;202;43;0;1;1;0;129;24;0;1;3
36;52;Silleda;02-001-C;436;0;436;300;2;2;136;298;296;54;1;1;1;0;176;55;1;1;6
36;52;Silleda;04-001-A;586;0;586;402;2;3;184;400;397;105;0;1;1;1;203;73;0;3;10
36;52;Silleda;04-001-B;712;0;712;493;9;2;219;484;482;125;0;0;1;0;277;67;0;6;6
36;52;Silleda;04-002-A;418;0;418;313;2;0;105;311;311;70;1;0;0;1;186;43;0;3;7
36;52;Silleda;04-002-B;300;0;300;221;2;2;79;219;217;49;0;0;0;3;124;37;0;4;0
36;53;Soutomaior;01-001-A;441;0;441;320;5;0;121;315;315;155;0;0;2;1;119;25;0;4;9
36;53;Soutomaior;01-001-B;523;0;523;372;5;1;151;367;366;167;0;0;1;1;154;29;0;5;9
36;53;Soutomaior;01-002-A;501;0;501;398;3;0;103;395;395;166;0;0;0;3;173;41;0;4;8
36;53;Soutomaior;01-002-B;460;0;460;329;2;0;131;327;327;144;0;0;0;0;155;19;0;5;4
36;53;Soutomaior;02-001-A;764;0;764;518;0;5;246;518;513;248;1;1;0;1;196;43;0;9;14
36;53;Soutomaior;02-001-B;849;0;849;609;6;5;240;603;598;282;1;2;2;1;233;49;0;18;10
36;53;Soutomaior;02-002-A;560;0;560;377;2;1;183;375;374;171;0;0;1;0;163;21;0;7;11
36;53;Soutomaior;02-002-B;655;0;655;458;1;1;197;457;456;199;1;0;0;3;202;31;1;6;13
36;53;Soutomaior;02-003-A;595;0;595;391;5;5;204;386;381;157;0;1;4;1;171;29;1;9;8
36;53;Soutomaior;02-003-B;692;0;692;501;12;9;191;489;480;227;0;1;3;0;170;52;0;9;18
36;54;Tomiño;01-001-A;959;0;959;634;9;6;325;625;619;248;1;1;2;2;293;37;1;14;20
36;54;Tomiño;01-001-B;924;0;924;603;9;9;321;594;585;253;0;0;4;3;257;45;1;6;16
36;54;Tomiño;01-002-A;699;0;699;453;4;6;246;449;443;194;1;0;0;1;190;35;0;6;16
36;54;Tomiño;01-002-B;661;0;661;410;6;2;251;404;402;175;1;0;0;1;175;31;1;6;12
36;54;Tomiño;02-001-A;687;0;687;451;11;2;236;440;438;149;0;2;1;0;206;51;0;9;20
36;54;Tomiño;02-001-B;663;0;663;421;1;2;242;420;418;146;0;1;2;0;202;47;0;6;14
36;54;Tomiño;02-001-C;583;0;583;410;1;6;173;409;403;196;0;1;1;0;145;49;0;3;8
36;54;Tomiño;02-002-A;826;0;826;610;2;6;216;608;602;250;0;5;1;0;250;61;0;12;23
36;54;Tomiño;02-002-B;291;0;291;221;4;5;70;217;212;79;0;0;0;0;91;32;0;2;8
36;54;Tomiño;02-002-C;425;0;425;281;2;7;144;279;272;99;0;0;0;4;129;24;0;9;7
36;54;Tomiño;03-001-A;619;0;619;410;5;4;209;405;401;169;0;0;0;0;182;34;0;6;10
36;54;Tomiño;03-001-B;517;0;517;333;0;1;184;333;332;124;0;0;1;1;158;32;2;11;3
36;54;Tomiño;03-002-A;738;0;738;489;8;1;249;481;480;168;0;2;1;0;260;29;3;9;8
36;54;Tomiño;03-002-B;311;0;311;171;1;0;140;170;170;88;1;0;1;0;66;12;0;0;2
36;54;Tomiño;04-001-A;804;0;804;546;4;5;258;542;537;227;1;0;5;3;218;56;1;8;18
36;54;Tomiño;04-001-B;856;0;856;581;6;3;275;575;572;269;1;0;1;2;212;59;0;13;15
36;54;Tomiño;04-002-A;359;1;360;266;4;1;94;262;261;108;0;0;1;0;128;18;0;2;4
36;54;Tomiño;04-002-B;420;0;420;289;2;0;131;287;287;107;2;0;0;3;130;33;2;4;6
36;55;Tui;01-001-A;663;0;663;442;4;6;221;438;432;173;0;0;4;0;201;44;1;3;6
36;55;Tui;01-001-B;576;0;576;379;2;4;197;377;373;142;0;1;0;1;176;39;0;3;11
36;55;Tui;01-001-C;642;0;642;455;9;2;187;446;444;151;0;0;0;1;212;55;0;10;15
36;55;Tui;01-002-A;537;1;538;370;5;4;168;365;361;130;0;0;2;1;173;37;0;7;11
36;55;Tui;01-002-B;450;1;451;289;3;1;162;286;285;93;1;4;0;1;141;35;0;1;9
36;55;Tui;01-002-C;461;1;462;300;3;1;162;297;296;112;0;1;0;2;142;32;0;0;7
36;55;Tui;01-003-A;698;0;698;493;12;5;205;481;476;174;1;2;0;1;241;33;0;4;20
36;55;Tui;01-003-B;687;0;687;460;2;4;227;458;454;149;0;3;2;1;237;42;0;7;13
36;55;Tui;02-001-A;634;0;634;463;7;5;171;456;451;162;0;1;0;1;221;44;0;1;21
36;55;Tui;02-001-B;579;0;579;432;5;6;147;427;421;122;0;1;0;1;226;58;1;9;3
36;55;Tui;02-002-A;699;0;699;492;10;7;207;482;475;185;0;0;3;0;201;64;0;6;16
36;55;Tui;02-002-B;610;0;610;394;2;2;216;392;390;145;0;4;4;2;178;37;1;13;6
36;55;Tui;02-003-A;487;0;487;339;6;0;148;333;333;123;0;0;0;0;153;38;0;9;10
36;55;Tui;02-003-B;458;0;458;330;2;5;128;328;323;114;0;0;2;0;154;36;0;6;11
36;55;Tui;02-004-A;327;0;327;215;1;1;112;214;213;62;0;0;0;0;119;24;0;3;5
36;55;Tui;02-004-B;407;0;407;296;3;6;111;293;287;76;0;0;3;0;186;10;0;5;7
36;55;Tui;03-001-A;532;0;532;381;7;2;151;374;372;120;0;0;1;0;207;30;0;3;11
36;55;Tui;03-001-B;484;0;484;354;4;3;130;350;347;125;0;1;1;1;164;38;0;3;14
36;55;Tui;03-002-U;752;0;752;495;3;1;257;492;491;142;0;0;1;1;276;50;2;6;13
36;55;Tui;04-001-A;589;0;589;400;6;2;189;394;392;133;0;2;1;0;206;39;0;4;7
36;55;Tui;04-001-B;470;0;470;328;5;4;142;323;319;102;0;0;2;1;163;32;0;6;13
36;55;Tui;04-001-C;520;0;520;359;7;0;161;352;352;101;0;1;1;0;213;18;0;5;13
36;55;Tui;04-002-A;375;0;375;271;5;0;104;266;266;88;0;1;1;0;133;30;0;6;7
36;55;Tui;04-002-B;474;0;474;330;5;7;144;325;318;96;0;1;3;0;156;46;0;7;9
36;55;Tui;04-003-U;702;0;702;483;11;4;219;472;468;203;1;1;2;1;180;57;2;14;7
36;56;Valga;01-001-A;714;0;714;525;5;2;189;520;518;197;0;0;0;1;257;41;1;7;14
36;56;Valga;01-001-B;215;0;215;157;3;1;58;154;153;29;0;0;2;0;108;8;0;2;4
36;56;Valga;01-002-U;774;0;774;543;1;2;231;542;540;179;0;4;1;0;300;37;0;10;9
36;56;Valga;02-001-A;625;0;625;469;6;3;156;463;460;103;0;0;1;4;299;44;0;7;2
36;56;Valga;02-001-B;442;0;442;337;5;3;105;332;329;74;0;0;1;1;216;28;0;4;5
36;56;Valga;02-002-U;665;0;665;483;8;4;182;475;471;170;1;2;2;0;238;45;0;8;5
36;56;Valga;02-003-A;394;0;394;263;4;1;131;259;258;57;1;1;0;0;177;15;0;1;6
36;56;Valga;02-003-B;206;0;206;160;3;1;46;157;156;47;0;0;0;0;92;15;0;1;1
36;56;Valga;03-001-U;795;0;795;574;4;2;221;570;568;134;0;0;2;1;354;62;0;7;8
36;57;Vigo;01-001-U;750;0;750;477;4;1;273;473;472;174;1;4;5;0;141;124;1;12;10
36;57;Vigo;01-002-U;547;0;547;342;1;5;205;341;336;194;0;0;1;4;74;51;0;10;2
36;57;Vigo;01-003-A;539;0;539;347;5;3;192;342;339;133;1;0;1;0;130;54;1;13;6
36;57;Vigo;01-003-B;609;0;609;417;1;4;192;416;412;171;0;0;1;1;153;57;0;18;11
36;57;Vigo;01-004-A;655;0;655;458;2;3;197;456;453;90;1;2;3;4;290;43;0;10;10
36;57;Vigo;01-004-B;770;0;770;565;1;10;205;564;554;119;0;1;3;1;354;50;1;13;12
36;57;Vigo;01-005-U;664;0;664;479;6;5;185;473;468;102;0;0;1;2;253;85;0;10;15
36;57;Vigo;01-006-U;864;0;864;609;2;5;255;607;602;203;0;2;2;0;280;88;0;15;12
36;57;Vigo;01-007-A;626;0;626;489;1;5;137;488;483;159;0;1;2;0;235;58;1;10;17
36;57;Vigo;01-007-B;693;0;693;517;2;13;176;515;502;153;1;1;4;1;235;77;0;18;12
36;57;Vigo;01-008-A;590;0;590;436;2;3;154;434;431;149;0;2;1;0;166;95;1;13;4
36;57;Vigo;01-008-B;559;0;559;402;4;9;157;398;389;129;1;1;1;2;165;70;0;8;12
36;57;Vigo;01-009-U;755;0;755;450;1;5;305;449;444;147;0;0;3;0;164;102;1;16;11
36;57;Vigo;01-010-A;743;0;743;526;1;4;217;525;521;147;1;2;4;1;239;93;1;16;17
36;57;Vigo;01-010-B;815;0;815;559;4;6;256;555;549;143;0;2;4;0;290;85;0;8;17
36;57;Vigo;01-011-A;499;0;499;331;2;4;168;329;325;91;0;1;3;0;141;75;0;8;6
36;57;Vigo;01-011-B;569;0;569;416;1;6;153;415;409;112;0;0;3;2;198;75;0;13;6
36;57;Vigo;01-012-U;1006;0;1006;697;3;7;309;694;687;177;0;1;2;2;393;81;0;9;22
36;57;Vigo;01-013-A;559;0;559;383;4;5;176;379;374;119;0;2;2;0;162;70;0;9;10
36;57;Vigo;01-013-B;647;0;647;398;0;3;249;398;395;148;1;0;2;2;161;60;0;13;8
36;57;Vigo;01-014-U;1213;0;1213;850;6;14;363;844;830;197;0;2;2;0;504;90;1;8;26
36;57;Vigo;01-015-U;819;0;819;522;1;4;297;521;517;174;0;0;3;1;258;55;0;8;18
36;57;Vigo;01-016-A;748;0;748;495;2;4;253;493;489;243;0;4;2;0;137;64;0;26;13
36;57;Vigo;01-016-B;833;0;833;556;4;8;277;552;544;256;0;1;0;3;182;66;0;22;14
36;57;Vigo;02-001-A;457;0;457;288;1;5;169;287;282;93;0;0;4;0;121;45;0;11;8
36;57;Vigo;02-001-B;549;0;549;332;2;5;217;330;325;111;0;1;2;3;148;41;0;13;6
36;57;Vigo;02-002-U;800;0;800;543;3;7;257;540;533;161;0;3;2;1;256;81;0;16;13
36;57;Vigo;02-003-A;551;0;551;354;2;4;197;352;348;98;0;0;2;0;179;53;2;6;8
36;57;Vigo;02-003-B;541;0;541;360;3;3;181;357;354;105;0;0;2;2;182;43;0;8;12
36;57;Vigo;02-004-A;434;0;434;294;2;3;140;292;289;84;1;1;0;1;132;54;0;8;8
36;57;Vigo;02-004-B;425;0;425;284;4;3;141;280;277;83;0;1;3;0;128;51;0;9;2
36;57;Vigo;02-005-U;801;0;801;573;0;5;228;573;568;187;1;0;2;3;262;89;0;14;10
36;57;Vigo;02-006-A;495;0;495;350;3;5;145;347;342;122;0;0;0;4;151;53;1;7;4
36;57;Vigo;02-006-B;440;0;440;312;2;1;128;310;309;93;1;1;3;0;149;51;0;6;5
36;57;Vigo;02-007-U;901;0;901;633;2;4;268;631;627;146;0;0;0;2;369;92;0;9;9
36;57;Vigo;02-008-U;689;0;689;469;4;6;220;465;459;138;0;1;3;2;225;65;3;14;8
36;57;Vigo;02-009-A;416;0;416;282;3;2;134;279;277;62;0;0;0;0;158;50;0;5;2
36;57;Vigo;02-009-B;464;0;464;317;3;0;147;314;314;68;0;0;1;3;184;50;1;2;5
36;57;Vigo;02-010-U;773;0;773;500;2;2;273;498;496;167;0;1;2;2;237;65;0;10;12
36;57;Vigo;02-011-U;716;0;716;476;2;1;240;474;473;123;0;0;4;2;212;95;0;17;20
36;57;Vigo;02-012-U;636;0;636;395;2;4;241;393;389;151;0;1;5;3;129;84;1;8;7
36;57;Vigo;02-013-U;821;0;821;552;4;5;269;548;543;172;0;1;1;1;246;92;1;15;14
36;57;Vigo;02-014-U;915;0;915;566;0;3;349;566;563;199;1;0;5;0;196;125;0;16;21
36;57;Vigo;02-015-A;468;0;468;328;2;4;140;326;322;105;0;1;4;1;149;51;1;7;3
36;57;Vigo;02-015-B;608;0;608;419;6;6;189;413;407;130;0;0;2;4;181;69;0;13;8
36;57;Vigo;02-016-U;524;0;524;385;2;6;139;383;377;124;0;0;4;0;175;55;1;14;4
36;57;Vigo;02-017-A;525;0;525;365;2;3;160;363;360;121;0;2;6;8;127;87;0;5;4
36;57;Vigo;02-017-B;590;0;590;398;0;5;192;398;393;151;0;1;0;4;147;73;0;4;13
36;57;Vigo;02-018-U;732;0;732;463;6;5;269;457;452;169;0;3;1;4;178;76;0;9;12
36;57;Vigo;02-019-U;842;0;842;562;3;2;280;559;557;164;1;1;5;0;245;117;0;10;14
36;57;Vigo;02-020-U;749;0;749;469;2;4;280;467;463;150;0;0;3;0;195;84;0;18;13
36;57;Vigo;02-021-U;608;0;608;384;4;10;224;380;370;125;0;1;5;0;151;66;0;17;5
36;57;Vigo;02-022-U;756;0;756;490;7;6;266;483;477;149;0;2;4;4;168;121;1;12;16
36;57;Vigo;02-023-A;657;0;657;406;1;5;251;405;400;145;0;3;2;1;140;74;2;15;18
36;57;Vigo;02-023-B;651;0;651;429;0;5;222;429;424;161;0;1;1;5;147;82;1;14;12
36;57;Vigo;02-025-U;855;0;855;550;2;3;305;548;545;201;0;3;4;0;222;89;1;8;17
36;57;Vigo;02-026-A;552;0;552;318;0;3;234;318;315;115;0;2;4;2;114;61;1;9;7
36;57;Vigo;02-026-B;519;0;519;282;0;2;237;282;280;94;0;0;1;1;93;67;0;10;14
36;57;Vigo;02-027-A;424;0;424;280;0;3;144;280;277;87;0;0;0;0;110;58;0;8;14
36;57;Vigo;02-027-B;453;0;453;297;6;3;156;291;288;102;0;1;2;1;92;58;0;18;14
36;57;Vigo;02-028-A;659;0;659;440;4;6;219;436;430;152;0;1;5;1;180;74;1;4;12
36;57;Vigo;02-028-B;646;0;646;467;5;4;179;462;458;140;0;2;3;1;213;76;2;7;14
36;57;Vigo;02-029-A;623;0;623;421;4;6;202;417;411;158;0;0;1;1;146;76;0;12;17
36;57;Vigo;02-029-B;684;0;684;449;1;3;235;448;445;175;0;1;0;0;165;80;1;13;10
36;57;Vigo;02-030-U;722;0;722;509;5;2;213;504;502;198;0;0;4;1;167;96;0;19;17
36;57;Vigo;02-031-U;676;0;676;402;8;4;274;394;390;153;0;1;5;2;125;80;0;12;12
36;57;Vigo;03-001-A;561;0;561;353;0;6;208;353;347;126;1;0;2;2;121;73;0;12;10
36;57;Vigo;03-001-B;558;0;558;350;2;4;208;348;344;133;0;1;1;2;123;68;0;10;6
36;57;Vigo;03-002-A;582;0;582;393;2;5;189;391;386;151;0;1;1;3;117;83;1;12;17
36;57;Vigo;03-002-B;603;0;603;407;2;4;196;405;401;140;0;1;2;6;139;87;0;14;12
36;57;Vigo;03-003-A;451;0;451;299;2;0;152;297;297;113;0;0;4;4;104;58;0;9;5
36;57;Vigo;03-003-B;484;0;484;297;3;4;187;294;290;103;0;1;3;1;109;59;0;7;7
36;57;Vigo;03-004-A;635;0;635;445;7;1;190;438;437;159;0;0;1;0;172;78;0;12;15
36;57;Vigo;03-004-B;696;0;696;462;0;4;234;462;458;170;0;0;6;1;175;73;0;20;13
36;57;Vigo;03-005-U;542;0;542;352;6;4;190;346;342;130;0;0;1;0;125;72;0;10;4
36;57;Vigo;03-006-U;901;0;901;591;6;7;310;585;578;226;0;3;5;2;211;89;0;29;13
36;57;Vigo;03-007-U;943;0;943;684;6;13;259;678;665;284;2;4;2;0;230;113;1;15;14
36;57;Vigo;03-008-U;606;0;606;341;3;3;265;338;335;137;1;0;2;1;95;81;0;9;9
36;57;Vigo;03-009-U;596;0;596;400;3;2;196;397;395;132;0;0;2;2;162;73;0;13;11
36;57;Vigo;03-010-U;874;0;874;587;4;7;287;583;576;200;0;0;2;2;228;109;0;23;12
36;57;Vigo;03-011-U;736;0;736;508;2;5;228;506;501;196;0;1;1;3;184;95;0;11;10
36;57;Vigo;03-012-A;508;0;508;353;2;2;155;351;349;144;0;0;2;1;125;58;0;9;10
36;57;Vigo;03-012-B;532;0;532;355;1;9;177;354;345;135;1;1;1;1;123;61;1;9;12
36;57;Vigo;03-013-U;656;0;656;416;2;7;240;414;407;135;0;1;3;0;156;89;0;13;10
36;57;Vigo;03-014-U;878;0;878;540;6;3;338;534;531;228;0;1;2;3;168;95;4;13;17
36;57;Vigo;03-015-A;469;0;469;303;4;4;166;299;295;104;0;1;2;3;120;40;0;10;15
36;57;Vigo;03-015-B;498;0;498;322;2;2;176;320;318;131;0;0;3;3;101;63;0;12;5
36;57;Vigo;03-016-A;398;0;398;271;1;3;127;270;267;102;0;0;3;0;102;54;0;2;4
36;57;Vigo;03-016-B;422;0;422;290;1;2;132;289;287;91;0;0;0;2;125;51;0;10;8
36;57;Vigo;03-017-A;546;0;546;345;0;2;201;345;343;115;1;2;4;2;131;64;0;5;19
36;57;Vigo;03-017-B;618;0;618;394;3;4;224;391;387;140;0;2;3;3;136;72;0;11;20
36;57;Vigo;03-018-U;735;0;735;500;2;4;235;498;494;194;0;1;1;2;179;78;0;20;19
36;57;Vigo;03-019-U;938;0;938;684;3;9;254;681;672;203;0;0;2;2;331;102;2;14;16
36;57;Vigo;03-020-A;476;0;476;303;1;4;173;302;298;102;0;0;1;0;112;67;1;9;6
36;57;Vigo;03-020-B;497;0;497;327;4;3;170;323;320;98;0;0;2;2;117;79;1;11;10
36;57;Vigo;03-021-A;534;0;534;362;3;2;172;359;357;120;0;1;3;0;159;59;0;10;5
36;57;Vigo;03-021-B;629;0;629;441;2;3;188;439;436;133;0;2;0;4;181;94;0;14;8
36;57;Vigo;03-022-A;500;0;500;337;3;3;163;334;331;98;1;0;2;1;144;67;1;7;10
36;57;Vigo;03-022-B;577;0;577;411;0;4;166;411;407;121;0;1;0;0;196;67;1;16;5
36;57;Vigo;03-023-U;684;1;685;434;4;5;251;430;425;170;0;1;2;1;138;84;0;21;8
36;57;Vigo;03-024-U;944;0;944;632;5;8;312;627;619;214;1;2;4;2;220;134;1;18;23
36;57;Vigo;03-025-U;584;0;584;437;4;11;147;433;422;135;0;1;1;5;193;71;0;9;7
36;57;Vigo;03-026-U;727;0;727;524;2;4;203;522;518;140;0;0;1;1;276;79;4;11;6
36;57;Vigo;03-027-A;428;0;428;299;3;3;129;296;293;106;0;0;0;1;124;48;0;8;6
36;57;Vigo;03-027-B;436;0;436;273;2;2;163;271;269;105;0;0;1;0;106;41;0;6;10
36;57;Vigo;03-028-U;842;0;842;525;7;5;317;518;513;182;0;4;2;1;210;91;1;11;11
36;57;Vigo;03-029-U;732;0;732;515;0;8;217;515;507;145;0;0;0;0;264;82;0;10;6
36;57;Vigo;03-030-A;521;0;521;350;4;2;171;346;344;112;0;0;4;0;138;68;0;7;15
36;57;Vigo;03-030-B;540;0;540;339;8;1;201;331;330;109;0;1;1;1;148;53;1;10;6
36;57;Vigo;03-031-A;536;0;536;368;4;5;168;364;359;125;0;0;2;1;161;55;1;5;9
36;57;Vigo;03-031-B;517;0;517;363;3;7;154;360;353;115;0;0;1;1;153;68;0;6;9
36;57;Vigo;03-032-U;522;0;522;368;1;4;154;367;363;137;1;2;1;1;135;69;0;9;8
36;57;Vigo;03-033-U;666;0;666;449;1;2;217;448;446;152;1;2;4;1;201;63;1;8;13
36;57;Vigo;03-034-A;482;0;482;288;2;2;194;286;284;96;0;0;2;2;132;38;2;2;10
36;57;Vigo;03-034-B;493;0;493;291;1;5;202;290;285;97;0;0;2;4;127;46;0;3;6
36;57;Vigo;03-035-A;470;0;470;313;1;2;157;312;310;100;0;1;3;1;120;66;1;8;10
36;57;Vigo;03-035-B;471;0;471;324;4;4;147;320;316;84;0;2;2;0;126;72;3;12;15
36;57;Vigo;03-036-A;588;11;599;390;2;4;209;388;384;149;0;0;2;0;111;107;0;6;9
36;57;Vigo;03-036-B;590;0;590;343;3;9;247;340;331;128;1;0;0;2;118;61;1;15;5
36;57;Vigo;03-037-A;748;0;748;539;4;7;209;535;528;184;0;2;2;0;239;76;0;16;9
36;57;Vigo;03-037-B;817;0;817;596;6;5;221;590;585;193;0;1;2;0;265;103;0;11;10
36;57;Vigo;04-001-A;677;0;677;451;2;7;226;449;442;205;0;2;2;3;119;86;0;16;9
36;57;Vigo;04-001-B;625;0;625;451;6;0;174;445;445;181;0;2;6;3;145;81;0;14;13
36;57;Vigo;04-002-A;517;0;517;366;3;2;151;363;361;149;0;2;4;1;132;50;0;18;5
36;57;Vigo;04-002-B;502;0;502;373;2;8;129;371;363;147;0;1;2;3;140;51;0;13;6
36;57;Vigo;04-003-U;781;0;781;467;2;2;314;465;463;202;0;0;1;3;121;105;0;22;9
36;57;Vigo;04-004-A;490;0;490;282;3;2;208;279;277;103;1;0;0;0;84;69;2;7;11
36;57;Vigo;04-004-B;500;0;500;308;0;1;192;308;307;103;0;2;3;1;107;73;1;11;6
36;57;Vigo;04-005-A;590;0;590;373;3;5;217;370;365;132;3;5;1;0;112;85;0;19;8
36;57;Vigo;04-005-B;581;0;581;368;2;5;213;366;361;139;1;1;3;0;113;85;0;9;10
36;57;Vigo;04-006-U;655;0;655;414;4;2;241;410;408;155;0;0;4;2;139;88;0;13;7
36;57;Vigo;04-007-A;525;0;525;338;6;3;187;332;329;160;0;0;2;3;71;76;1;11;5
36;57;Vigo;04-007-B;545;0;545;355;3;5;190;352;347;176;2;0;3;2;72;80;0;8;4
36;57;Vigo;04-008-A;529;0;529;291;0;0;238;291;291;111;0;0;2;1;109;58;0;7;3
36;57;Vigo;04-008-B;487;0;487;294;2;2;193;292;290;104;0;3;4;0;111;55;1;7;5
36;57;Vigo;04-010-A;515;0;515;373;3;4;142;370;366;142;1;0;0;3;123;72;0;14;11
36;57;Vigo;04-010-B;446;0;446;331;4;5;115;327;322;116;0;0;1;2;121;63;0;15;4
36;57;Vigo;04-011-A;476;0;476;289;1;4;187;288;284;106;0;0;1;2;105;48;0;12;10
36;57;Vigo;04-011-B;548;0;548;329;5;2;219;324;322;112;0;0;0;3;128;73;0;2;4
36;57;Vigo;04-012-U;793;0;793;498;4;7;295;494;487;214;1;0;1;2;101;130;0;29;9
36;57;Vigo;04-013-U;647;0;647;381;5;5;266;376;371;157;0;0;2;1;77;103;0;19;12
36;57;Vigo;04-014-U;623;0;623;439;2;1;184;437;436;165;0;1;3;4;124;109;0;17;13
36;57;Vigo;04-015-A;528;0;528;355;2;3;173;353;350;153;0;2;2;1;93;80;1;13;5
36;57;Vigo;04-015-B;613;0;613;416;0;2;197;416;414;170;1;2;5;4;115;94;1;18;4
36;57;Vigo;04-016-U;719;0;719;510;3;1;209;507;506;192;2;1;0;2;178;105;1;15;10
36;57;Vigo;04-017-U;564;0;564;399;5;2;165;394;392;123;0;0;1;1;156;94;0;11;6
36;57;Vigo;04-018-A;532;0;532;364;1;5;168;363;358;122;1;1;1;1;136;76;0;11;9
36;57;Vigo;04-018-B;548;6;554;399;1;4;155;398;394;129;2;0;1;2;135;95;1;21;8
36;57;Vigo;04-019-A;531;0;531;375;1;5;156;374;369;144;0;1;2;1;127;70;0;10;14
36;57;Vigo;04-019-B;506;0;506;357;2;3;149;355;352;138;1;0;2;1;118;70;0;11;11
36;57;Vigo;04-020-A;826;0;826;542;1;3;284;541;538;249;0;1;3;2;158;91;0;20;14
36;57;Vigo;04-020-B;791;0;791;546;3;6;245;543;537;236;0;0;2;3;161;104;2;14;15
36;57;Vigo;04-021-U;996;0;996;687;7;0;309;680;680;287;0;4;2;0;215;141;0;15;16
36;57;Vigo;04-022-U;697;0;697;473;8;3;224;465;462;212;2;0;7;0;122;100;0;13;6
36;57;Vigo;04-023-A;443;0;443;287;4;3;156;283;280;115;0;1;0;0;72;74;0;10;8
36;57;Vigo;04-023-B;465;0;465;311;6;2;154;305;303;121;0;2;0;2;87;78;0;9;4
36;57;Vigo;04-024-A;862;0;862;591;8;5;271;583;578;263;1;3;4;2;156;123;0;16;10
36;57;Vigo;04-024-B;876;12;888;593;7;6;295;586;580;270;1;2;4;4;151;119;1;15;13
36;57;Vigo;04-025-A;468;7;475;325;3;3;150;322;319;142;0;3;2;3;59;82;0;23;5
36;57;Vigo;04-025-B;447;0;447;325;3;2;122;322;320;135;0;0;0;3;77;78;0;22;5
36;57;Vigo;04-026-U;610;0;610;410;2;3;200;408;405;155;0;0;1;4;92;121;0;24;8
36;57;Vigo;04-027-U;524;0;524;378;3;3;146;375;372;127;0;1;1;5;97;120;1;12;8
36;57;Vigo;04-028-A;547;0;547;382;5;4;165;377;373;151;1;0;5;3;114;80;0;12;7
36;57;Vigo;04-028-B;465;0;465;342;2;2;123;340;338;159;0;0;2;0;92;63;0;13;9
36;57;Vigo;04-029-A;520;0;520;355;3;1;165;352;351;152;0;1;3;1;86;81;2;16;9
36;57;Vigo;04-029-B;484;0;484;330;2;6;154;328;322;138;0;0;1;1;85;81;0;14;2
36;57;Vigo;04-030-U;735;0;735;507;0;3;228;507;504;202;0;0;3;4;125;137;1;18;14
36;57;Vigo;04-031-A;572;0;572;361;2;1;211;359;358;141;1;0;1;0;97;102;0;9;7
36;57;Vigo;04-031-B;557;0;557;338;5;1;219;333;332;149;1;0;2;0;84;77;0;12;7
36;57;Vigo;04-032-U;777;0;777;480;5;5;297;475;470;159;1;0;2;3;137;134;2;20;12
36;57;Vigo;04-033-A;706;0;706;464;1;1;242;463;462;195;0;0;3;0;152;91;1;10;10
36;57;Vigo;04-033-B;673;0;673;447;3;3;226;444;441;165;1;2;2;1;143;103;1;18;5
36;57;Vigo;04-034-A;493;0;493;320;3;1;173;317;316;113;0;0;2;0;109;77;0;10;5
36;57;Vigo;04-034-B;478;0;478;300;3;0;178;297;297;116;3;2;1;1;100;57;1;10;6
36;57;Vigo;04-035-A;581;0;581;412;1;2;169;411;409;161;0;0;3;5;130;83;1;14;12
36;57;Vigo;04-035-B;574;0;574;400;2;1;174;398;397;162;0;0;1;6;125;79;1;16;7
36;57;Vigo;04-036-A;576;0;576;385;8;4;191;377;373;145;0;0;3;3;115;85;1;16;5
36;57;Vigo;04-036-B;564;0;564;371;3;7;193;368;361;143;1;0;0;2;99;81;1;21;13
36;57;Vigo;04-037-U;670;0;670;406;3;8;264;403;395;186;0;0;4;1;98;87;0;10;9
36;57;Vigo;04-038-A;651;0;651;456;5;6;195;451;445;180;1;0;4;1;132;100;0;20;7
36;57;Vigo;04-038-B;635;0;635;457;2;4;178;455;451;185;0;2;4;3;140;95;0;12;10
36;57;Vigo;04-039-U;788;0;788;537;6;5;251;531;526;219;1;1;2;5;155;108;0;16;19
36;57;Vigo;04-040-A;613;0;613;430;4;5;183;426;421;174;0;1;1;0;124;92;0;14;15
36;57;Vigo;04-040-B;574;0;574;398;2;7;176;396;389;141;0;2;1;2;139;85;0;10;9
36;57;Vigo;04-041-U;851;0;851;558;4;8;293;554;546;242;0;1;0;3;188;83;1;13;15
36;57;Vigo;04-042-A;653;0;653;458;2;3;195;456;453;185;0;1;5;0;149;84;1;12;16
36;57;Vigo;04-042-B;628;0;628;428;6;5;200;422;417;174;0;0;1;4;138;78;0;8;14
36;57;Vigo;05-001-A;492;0;492;303;1;4;189;302;298;109;0;0;1;1;117;49;1;13;7
36;57;Vigo;05-001-B;480;0;480;292;1;1;188;291;290;106;0;0;3;1;100;63;1;9;7
36;57;Vigo;05-002-A;485;0;485;305;4;3;180;301;298;123;0;0;3;4;92;57;0;8;11
36;57;Vigo;05-002-B;477;0;477;300;1;3;177;299;296;121;0;1;1;1;88;66;0;6;12
36;57;Vigo;05-003-U;942;0;942;631;0;1;311;631;630;219;0;2;0;1;298;76;0;19;15
36;57;Vigo;05-004-A;566;0;566;373;2;3;193;371;368;126;0;0;2;0;125;91;1;18;5
36;57;Vigo;05-004-B;523;0;523;342;0;1;181;342;341;113;0;0;1;0;130;67;0;21;9
36;57;Vigo;05-005-A;596;0;596;394;0;4;202;394;390;160;0;1;4;0;147;59;1;12;6
36;57;Vigo;05-005-B;611;0;611;406;2;3;205;404;401;173;0;3;2;0;137;73;0;8;5
36;57;Vigo;05-006-A;515;0;515;370;0;2;145;370;368;139;0;2;2;0;108;98;0;15;4
36;57;Vigo;05-006-B;493;0;493;351;0;3;142;351;348;127;0;3;1;2;114;82;1;11;7
36;57;Vigo;05-007-A;523;0;523;320;3;4;203;317;313;120;0;2;2;2;92;69;1;16;9
36;57;Vigo;05-007-B;454;0;454;281;2;1;173;279;278;107;0;0;1;1;87;61;0;17;4
36;57;Vigo;05-008-A;573;0;573;367;2;5;206;365;360;148;1;0;3;2;89;82;0;20;15
36;57;Vigo;05-008-B;624;0;624;404;5;3;220;399;396;161;1;0;0;0;114;92;0;17;11
36;57;Vigo;05-009-A;796;0;796;503;5;4;293;498;494;208;0;2;5;3;141;112;1;14;8
36;57;Vigo;05-009-B;695;0;695;463;5;1;232;458;457;225;0;0;4;4;116;91;0;11;6
36;57;Vigo;05-010-A;766;0;766;519;4;5;247;515;510;189;1;0;1;1;159;125;0;20;14
36;57;Vigo;05-010-B;640;0;640;445;6;4;195;439;435;174;0;0;5;3;138;88;0;18;9
36;57;Vigo;05-011-A;628;0;628;412;0;6;216;412;406;150;0;0;1;3;142;93;0;13;4
36;57;Vigo;05-011-B;567;0;567;412;0;6;155;412;406;150;0;0;1;3;142;93;0;13;4
36;57;Vigo;05-012-U;571;0;571;372;7;1;199;365;364;131;1;0;1;1;116;92;0;8;14
36;57;Vigo;06-001-U;671;0;671;496;5;3;175;491;488;152;0;1;1;1;237;68;1;12;15
36;57;Vigo;06-002-U;708;0;708;497;3;3;211;494;491;137;0;0;1;1;236;93;1;12;10
36;57;Vigo;06-003-A;530;0;530;338;1;2;192;337;335;156;0;0;5;1;84;75;0;9;5
36;57;Vigo;06-003-B;620;0;620;387;3;7;233;384;377;155;0;3;1;4;115;80;1;11;7
36;57;Vigo;06-004-U;769;0;769;496;8;4;273;488;484;178;0;1;5;1;166;115;0;12;6
36;57;Vigo;06-005-U;649;0;649;402;0;6;247;402;396;152;1;0;2;0;124;91;1;14;11
36;57;Vigo;06-006-U;669;0;669;441;5;8;228;436;428;175;0;1;4;2;113;104;1;18;10
36;57;Vigo;06-007-U;685;0;685;362;3;8;323;359;351;125;0;1;7;0;113;83;0;13;9
36;57;Vigo;06-008-U;588;0;588;374;2;6;214;372;366;176;1;0;0;2;96;65;1;14;11
36;57;Vigo;06-009-A;712;0;712;446;2;4;266;444;440;202;0;0;2;3;100;91;0;29;13
36;57;Vigo;06-009-B;597;0;597;391;0;6;206;391;385;149;0;0;4;4;115;89;0;13;11
36;57;Vigo;06-010-U;802;0;802;531;6;9;271;525;516;198;0;0;4;3;164;123;0;12;12
36;57;Vigo;06-011-A;420;0;420;241;3;5;179;238;233;95;0;0;0;1;65;57;0;10;5
36;57;Vigo;06-011-B;422;0;422;265;0;3;157;265;262;97;0;1;1;1;68;76;0;6;12
36;57;Vigo;06-012-U;746;0;746;503;1;2;243;502;500;209;0;1;4;1;145;117;0;16;7
36;57;Vigo;06-013-A;374;0;374;196;4;3;178;192;189;72;0;2;1;1;68;32;0;8;5
36;57;Vigo;06-013-B;363;0;363;172;0;0;191;172;172;66;0;1;0;0;47;51;0;4;3
36;57;Vigo;06-014-U;625;0;625;385;2;3;240;383;380;129;0;0;2;1;122;113;0;6;7
36;57;Vigo;06-015-A;595;0;595;365;3;4;230;362;358;127;0;2;1;2;121;87;0;9;9
36;57;Vigo;06-015-B;539;0;539;312;0;2;227;312;310;121;0;0;3;1;113;59;1;8;4
36;57;Vigo;06-016-U;879;0;879;491;8;0;388;483;483;202;0;0;1;0;138;107;0;21;14
36;57;Vigo;06-017-A;527;0;527;323;3;4;204;320;316;126;0;2;1;0;98;68;2;12;7
36;57;Vigo;06-017-B;533;0;533;324;1;7;209;323;316;129;1;0;3;1;100;67;2;7;6
36;57;Vigo;06-018-A;566;0;566;346;2;2;220;344;342;144;0;0;0;1;110;72;0;6;9
36;57;Vigo;06-018-B;537;0;537;330;1;4;207;329;325;120;0;0;2;1;101;83;0;6;12
36;57;Vigo;06-019-U;878;0;878;518;7;7;360;511;504;195;0;2;5;2;158;118;0;14;10
36;57;Vigo;06-020-U;669;0;669;351;1;1;318;350;349;126;0;0;0;1;110;86;0;6;20
36;57;Vigo;06-021-A;621;0;621;352;3;1;269;349;348;105;1;0;3;0;127;88;1;7;16
36;57;Vigo;06-021-B;713;0;713;418;1;2;295;417;415;148;0;0;6;0;151;98;1;6;5
36;57;Vigo;06-022-U;671;0;671;409;0;2;262;409;407;152;1;1;6;0;129;99;0;14;5
36;57;Vigo;06-023-A;513;0;513;300;3;1;213;297;296;117;1;0;1;2;81;76;0;11;7
36;57;Vigo;06-023-B;489;0;489;280;1;2;209;279;277;123;0;0;2;0;85;54;0;7;6
36;57;Vigo;06-024-A;507;0;507;305;3;1;202;302;301;116;0;0;1;1;94;77;0;9;3
36;57;Vigo;06-024-B;536;0;536;331;7;3;205;324;321;117;0;1;2;0;121;64;1;10;5
36;57;Vigo;06-025-A;378;0;378;228;0;1;150;228;227;71;0;1;0;3;92;47;1;6;6
36;57;Vigo;06-025-B;444;0;444;283;2;3;161;281;278;97;0;2;1;2;109;61;0;3;3
36;57;Vigo;07-001-U;881;0;881;523;2;6;358;521;515;195;0;1;1;2;186;108;0;13;9
36;57;Vigo;07-002-A;596;0;596;365;3;2;231;362;360;121;0;0;4;1;144;77;0;9;4
36;57;Vigo;07-002-B;608;15;623;411;1;3;212;410;407;172;0;1;3;4;113;97;0;10;7
36;57;Vigo;07-003-A;434;0;434;268;1;3;166;267;264;97;0;0;1;1;92;62;0;5;6
36;57;Vigo;07-003-B;509;0;509;301;2;1;208;299;298;111;0;0;1;0;92;78;0;8;8
36;57;Vigo;07-004-A;593;0;593;365;0;1;228;365;364;150;0;0;2;2;113;82;0;5;10
36;57;Vigo;07-004-B;626;0;626;392;2;1;234;390;389;154;0;0;0;2;128;89;0;9;7
36;57;Vigo;07-005-U;1089;27;1116;711;13;7;405;698;691;231;1;4;8;1;251;159;2;22;12
36;57;Vigo;07-006-A;536;0;536;320;1;4;216;319;315;110;0;1;2;0;115;62;0;18;7
36;57;Vigo;07-006-B;441;0;441;239;0;3;202;239;236;89;0;0;0;1;84;48;0;12;2
36;57;Vigo;07-007-U;901;0;901;550;2;7;351;548;541;186;0;0;3;2;207;109;0;22;12
36;57;Vigo;07-008-U;675;0;675;460;0;6;215;460;454;157;0;2;3;1;189;83;0;9;10
36;57;Vigo;07-009-A;527;0;527;359;2;4;168;357;353;114;0;0;2;1;163;56;0;5;12
36;57;Vigo;07-009-B;592;0;592;401;2;2;191;399;397;128;0;0;1;0;179;64;0;13;12
36;57;Vigo;07-010-A;407;0;407;243;2;2;164;241;239;64;0;0;0;0;110;49;0;9;7
36;57;Vigo;07-010-B;422;0;422;231;0;3;191;231;228;61;1;0;0;2;107;49;0;4;4
36;57;Vigo;07-011-A;506;0;506;335;1;5;171;334;329;116;1;1;3;3;125;60;0;8;12
36;57;Vigo;07-011-B;469;0;469;306;3;2;163;303;301;110;0;1;1;2;122;47;0;9;9
36;57;Vigo;07-012-U;903;0;903;507;2;5;396;505;500;194;5;0;6;5;161;104;0;14;11
36;57;Vigo;07-013-U;691;0;691;408;5;2;283;403;401;154;0;2;0;1;141;77;0;15;11
36;57;Vigo;07-014-A;838;0;838;551;3;7;287;548;541;232;0;1;3;2;159;116;1;12;15
36;57;Vigo;07-014-B;907;0;907;604;6;9;303;598;589;278;1;0;2;1;167;116;0;13;11
36;57;Vigo;07-015-U;951;0;951;632;8;8;319;624;616;227;0;1;0;3;233;122;0;19;11
36;57;Vigo;07-016-U;803;0;803;543;9;6;260;534;528;197;0;0;1;1;202;106;0;12;9
36;57;Vigo;07-017-U;681;0;681;405;2;5;276;403;398;162;0;2;0;0;133;70;1;11;19
36;57;Vigo;07-018-U;847;0;847;485;8;4;362;477;473;172;2;4;6;5;152;96;0;16;20
36;57;Vigo;07-019-U;757;0;757;413;2;0;344;411;411;159;0;1;1;0;148;78;0;11;13
36;57;Vigo;07-020-A;575;5;580;330;1;4;250;329;325;111;0;2;5;1;111;77;0;13;5
36;57;Vigo;07-020-B;533;6;539;319;5;4;220;314;310;119;0;0;2;0;109;66;0;7;7
36;57;Vigo;07-021-A;732;0;732;400;1;4;332;399;395;149;0;5;1;0;128;92;1;9;10
36;57;Vigo;07-021-B;695;695;1390;411;1;0;979;410;410;151;0;0;3;2;146;71;0;21;16
36;57;Vigo;07-022-A;559;0;559;375;7;4;184;368;364;124;1;0;6;2;115;95;1;6;14
36;57;Vigo;07-022-B;547;0;547;383;3;4;164;380;376;140;0;0;3;0;118;99;0;10;6
36;57;Vigo;07-023-A;550;0;550;339;3;0;211;336;336;137;0;0;2;2;106;69;1;15;4
36;57;Vigo;07-023-B;450;0;450;274;0;2;176;274;272;90;0;0;1;2;99;65;0;5;10
36;57;Vigo;07-024-A;772;12;784;501;7;4;283;494;490;204;0;2;1;4;149;102;2;17;9
36;57;Vigo;07-024-B;707;10;717;473;3;4;244;470;466;179;0;3;3;4;143;98;2;18;16
36;57;Vigo;07-025-U;924;0;924;615;2;5;309;613;608;239;1;1;0;4;194;130;5;18;16
36;57;Vigo;07-026-A;921;0;921;584;7;7;337;577;570;250;0;0;2;2;171;115;0;15;15
36;57;Vigo;07-026-B;865;0;865;567;10;4;298;557;553;232;2;2;3;4;165;112;0;13;20
36;57;Vigo;07-027-A;635;0;635;394;4;5;241;390;385;141;0;0;2;1;90;127;0;11;13
36;57;Vigo;07-027-B;568;0;568;343;2;3;225;341;338;132;1;0;2;2;82;89;1;17;12
36;57;Vigo;07-028-U;665;0;665;408;4;4;257;404;400;167;1;0;3;1;102;99;0;14;13
36;57;Vigo;07-029-A;769;0;769;458;5;2;311;453;451;170;1;1;3;1;152;90;0;21;12
36;57;Vigo;07-029-B;708;0;708;441;3;6;267;438;432;172;0;2;1;2;130;92;2;21;10
36;57;Vigo;07-030-A;572;0;572;359;5;2;213;354;352;154;0;0;0;2;100;79;0;9;8
36;57;Vigo;07-030-B;557;0;557;359;0;3;198;359;356;148;0;1;2;3;89;91;0;12;10
36;57;Vigo;07-031-A;504;0;504;309;2;6;195;307;301;103;0;0;2;0;109;70;0;10;7
36;57;Vigo;07-031-B;427;0;427;283;1;6;144;282;276;77;0;1;2;0;97;80;1;13;5
36;57;Vigo;07-032-U;604;0;604;369;3;6;235;366;360;131;0;0;1;0;85;115;0;19;9
36;57;Vigo;07-033-U;592;0;592;331;5;1;261;326;325;95;0;0;2;3;118;95;0;3;9
36;57;Vigo;07-034-U;727;0;727;487;5;8;240;482;474;155;0;0;2;0;141;147;0;16;13
36;57;Vigo;07-035-U;798;0;798;475;3;5;323;472;467;173;0;0;8;0;124;125;0;19;18
36;57;Vigo;07-036-A;963;0;963;617;3;6;346;614;608;283;1;1;3;1;157;128;2;22;10
36;57;Vigo;07-036-B;937;0;937;613;3;5;324;610;605;277;0;3;0;2;156;140;1;13;13
36;57;Vigo;07-037-A;703;0;703;435;5;5;268;430;425;189;0;0;2;1;108;107;0;9;9
36;57;Vigo;07-037-B;531;0;531;331;3;1;200;328;327;145;0;0;0;2;84;76;0;12;8
36;57;Vigo;07-038-U;845;0;845;577;4;3;268;573;570;240;0;1;2;1;171;127;0;20;8
36;57;Vigo;07-039-A;903;0;903;600;2;4;303;598;594;244;0;0;3;2;176;129;2;24;14
36;57;Vigo;07-039-B;833;0;833;617;7;6;216;610;604;267;0;0;0;2;161;142;1;21;10
36;57;Vigo;07-040-U;892;0;892;616;3;8;276;613;605;237;0;0;2;1;186;147;0;19;13
36;57;Vigo;07-041-A;707;0;707;493;5;2;214;488;486;221;1;0;1;3;131;107;1;12;9
36;57;Vigo;07-041-B;561;0;561;381;3;3;180;378;375;164;0;2;2;1;103;80;0;13;10
36;57;Vigo;07-042-A;711;0;711;438;6;2;273;432;430;178;0;0;2;1;122;105;0;14;8
36;57;Vigo;07-042-B;590;8;598;362;2;3;236;360;357;154;0;1;3;3;81;84;1;20;10
36;57;Vigo;07-043-A;493;0;493;317;1;1;176;316;315;103;0;2;0;2;120;69;1;10;8
36;57;Vigo;07-043-B;584;0;584;360;2;3;224;358;355;128;0;1;0;1;120;91;0;6;8
36;57;Vigo;07-044-A;567;0;567;367;2;3;200;365;362;151;0;0;0;1;100;93;0;15;2
36;57;Vigo;07-044-B;466;0;466;305;4;3;161;301;298;119;0;0;1;0;78;87;0;8;5
36;57;Vigo;08-001-U;623;0;623;387;5;1;236;382;381;150;1;0;0;3;129;87;0;5;6
36;57;Vigo;08-002-U;738;0;738;485;4;0;253;481;481;187;0;1;2;1;163;103;1;14;9
36;57;Vigo;08-003-U;736;0;736;477;4;7;259;473;466;169;1;0;0;2;167;98;0;13;16
36;57;Vigo;08-004-A;578;0;578;372;2;3;206;370;367;127;1;1;3;2;123;87;0;17;6
36;57;Vigo;08-004-B;383;0;383;240;1;4;143;239;235;84;0;0;1;0;91;50;0;4;5
36;57;Vigo;08-005-A;590;0;590;378;6;4;212;372;368;144;0;0;7;3;98;106;0;7;3
36;57;Vigo;08-005-B;437;0;437;290;7;5;147;283;278;114;0;1;3;1;67;74;0;13;5
36;57;Vigo;08-006-A;554;0;554;391;3;3;163;388;385;150;0;1;2;1;123;84;0;20;4
36;57;Vigo;08-006-B;441;2;443;285;0;2;158;285;283;114;0;1;0;1;96;54;0;12;5
36;57;Vigo;08-007-U;706;0;706;451;3;7;255;448;441;186;0;0;3;1;135;96;0;14;6
36;57;Vigo;08-008-A;622;0;622;391;4;4;231;387;383;159;0;1;4;1;100;98;0;11;9
36;57;Vigo;08-008-B;456;0;456;302;4;3;154;298;295;117;0;0;3;0;90;69;0;10;6
36;57;Vigo;08-009-U;640;0;640;402;6;5;238;396;391;161;0;1;4;1;118;74;1;21;10
36;57;Vigo;08-010-U;1017;0;1017;683;4;6;334;679;673;262;0;2;5;3;201;164;2;21;13
36;57;Vigo;08-011-A;778;0;778;442;6;4;336;436;432;163;0;0;1;0;134;99;0;19;16
36;57;Vigo;08-011-B;692;0;692;397;3;4;295;394;390;141;1;0;1;0;151;78;0;10;8
36;57;Vigo;08-012-A;651;0;651;434;7;4;217;427;423;161;0;1;2;1;138;94;1;18;7
36;57;Vigo;08-012-B;519;0;519;329;2;4;190;327;323;130;0;1;1;2;119;55;0;12;3
36;57;Vigo;08-013-A;516;0;516;311;7;7;205;304;297;126;0;2;3;2;77;71;0;7;9
36;57;Vigo;08-013-B;514;0;514;313;4;5;201;309;304;127;1;0;0;5;86;61;2;13;9
36;57;Vigo;08-013-C;486;1;487;278;6;4;209;272;268;105;0;1;1;4;86;56;0;7;8
36;57;Vigo;08-014-A;629;0;629;425;3;6;204;422;416;189;1;1;4;1;132;75;0;7;6
36;57;Vigo;08-014-B;514;0;514;313;4;7;201;309;302;101;0;7;3;1;120;56;0;4;10
36;57;Vigo;08-016-U;874;0;874;568;7;4;306;561;557;209;0;1;3;8;165;141;2;18;10
36;57;Vigo;08-017-U;1063;0;1063;703;14;13;360;689;676;246;0;2;2;3;226;165;1;18;13
36;57;Vigo;08-018-U;713;0;713;467;5;1;246;462;461;212;0;2;0;0;140;76;0;18;13
36;57;Vigo;09-001-A;704;0;704;489;1;7;215;488;481;174;0;0;6;0;213;61;2;15;10
36;57;Vigo;09-001-B;702;0;702;476;2;6;226;474;468;169;1;0;4;2;198;76;1;8;9
36;57;Vigo;09-002-A;674;0;674;471;5;2;203;466;464;180;0;0;4;3;203;51;0;16;7
36;57;Vigo;09-002-B;497;0;497;359;1;1;138;358;357;133;0;0;5;1;149;55;0;5;9
36;57;Vigo;09-002-C;702;0;702;507;4;6;195;503;497;180;0;0;3;1;205;88;0;7;13
36;57;Vigo;09-003-U;789;0;789;544;2;3;245;542;539;161;0;0;1;2;245;104;1;15;10
36;57;Vigo;09-004-A;671;0;671;441;4;3;230;437;434;168;0;0;0;0;153;85;0;20;8
36;57;Vigo;09-004-B;475;0;475;320;2;4;155;318;314;112;0;0;1;0;128;57;0;6;10
36;57;Vigo;09-005-A;752;0;752;509;3;4;243;506;502;186;0;0;4;2;179;97;1;22;11
36;57;Vigo;09-005-B;635;0;635;424;3;2;211;421;419;178;1;2;3;2;132;74;1;20;6
36;57;Vigo;09-006-A;749;0;749;465;12;0;284;453;453;154;0;4;3;1;162;97;1;14;17
36;57;Vigo;09-006-B;453;0;453;295;0;1;158;295;294;101;0;1;0;1;123;53;0;8;7
36;57;Vigo;09-007-A;562;0;562;329;1;3;233;328;325;129;0;0;0;0;109;62;0;14;11
36;57;Vigo;09-007-B;556;0;556;352;4;0;204;348;348;114;1;0;2;0;130;78;0;14;9
36;57;Vigo;09-008-A;585;0;585;384;8;1;201;376;375;134;0;0;2;0;135;84;0;16;4
36;57;Vigo;09-008-B;459;0;459;308;5;2;151;303;301;117;0;0;0;1;111;54;0;9;9
36;57;Vigo;09-009-A;577;0;577;373;9;2;204;364;362;142;0;0;4;2;128;68;0;12;6
36;57;Vigo;09-009-B;526;0;526;338;3;3;188;335;332;116;1;2;6;4;124;61;0;9;9
36;57;Vigo;09-010-A;610;0;610;400;1;1;210;399;398;118;1;1;2;1;174;71;2;13;15
36;57;Vigo;09-010-B;601;0;601;425;2;2;176;423;421;136;0;0;4;1;180;69;2;19;10
36;57;Vigo;09-011-U;674;0;674;495;1;3;179;494;491;86;0;1;5;0;338;41;2;10;8
36;57;Vigo;09-012-U;732;0;732;511;4;5;221;507;502;199;1;0;1;2;174;95;0;15;15
36;57;Vigo;09-013-U;870;0;870;559;4;7;311;555;548;198;0;1;2;1;188;125;0;26;7
36;57;Vigo;09-014-A;552;0;552;376;1;1;176;375;374;117;0;0;2;0;180;62;0;8;5
36;57;Vigo;09-014-B;447;0;447;307;3;1;140;304;303;93;0;0;3;1;146;46;0;8;6
36;57;Vigo;09-015-U;979;0;979;641;1;5;338;640;635;241;2;1;1;3;248;108;0;14;17
36;57;Vigo;09-016-A;825;0;825;537;5;2;288;532;530;242;3;1;6;2;114;122;0;29;11
36;57;Vigo;09-016-B;752;0;752;494;3;6;258;491;485;211;2;1;5;1;104;113;1;32;15
36;57;Vigo;09-017-U;862;0;862;624;4;34;238;620;586;300;0;1;5;2;134;109;0;29;6
36;57;Vigo;09-018-A;970;0;970;738;4;2;232;734;732;358;1;5;2;5;179;136;1;31;14
36;57;Vigo;09-018-B;942;0;942;688;7;2;254;681;679;320;0;3;8;4;150;150;2;32;10
36;57;Vigo;09-019-U;778;0;778;588;3;3;190;585;582;264;0;1;7;1;128;138;0;36;7
36;59;Vila de Cruces;01-001-A;499;0;499;313;4;3;186;309;306;89;0;0;0;0;182;22;0;3;10
36;59;Vila de Cruces;01-001-B;686;0;686;448;5;0;238;443;443;121;0;0;1;0;265;35;0;8;13
36;59;Vila de Cruces;01-002-A;638;0;638;438;6;1;200;432;431;111;1;2;2;2;263;30;2;6;12
36;59;Vila de Cruces;01-002-B;243;0;243;166;2;1;77;164;163;44;0;0;1;0;99;12;0;4;3
36;59;Vila de Cruces;01-002-C;262;0;262;177;1;2;85;176;174;45;0;1;1;2;101;20;0;1;3
36;59;Vila de Cruces;02-001-A;359;0;359;239;3;1;120;236;235;54;0;1;0;0;155;16;0;2;7
36;59;Vila de Cruces;02-001-B;274;0;274;197;7;1;77;190;189;41;0;0;0;1;129;12;0;1;5
36;59;Vila de Cruces;02-001-C;319;0;319;230;1;1;89;229;228;69;0;0;0;0;140;15;0;0;4
36;59;Vila de Cruces;03-001-A;459;0;459;330;1;0;129;329;329;69;0;0;0;0;228;19;0;8;5
36;59;Vila de Cruces;03-001-B;399;0;399;295;4;5;104;291;286;95;0;0;0;0;165;17;0;3;6
36;59;Vila de Cruces;03-001-C;228;0;228;159;2;0;69;157;157;56;0;0;0;0;80;12;0;7;2
36;58;Vilaboa;01-001-A;703;0;703;384;4;2;319;380;378;122;0;0;1;0;161;76;1;5;12
36;58;Vilaboa;01-001-B;642;0;642;437;10;1;205;427;426;170;0;0;1;0;166;85;0;2;2
36;58;Vilaboa;01-002-A;716;0;716;439;4;4;277;435;431;91;1;0;2;0;251;68;0;5;13
36;58;Vilaboa;01-002-B;613;0;613;392;7;4;221;385;381;112;0;1;2;0;199;48;0;7;12
36;58;Vilaboa;02-001-A;699;0;699;436;9;4;263;427;423;136;0;0;0;3;166;99;2;12;5
36;58;Vilaboa;02-001-B;545;0;545;365;4;5;180;361;356;117;0;2;1;1;156;68;0;7;4
36;58;Vilaboa;02-002-A;542;0;542;365;4;3;177;361;358;124;1;0;3;3;168;50;0;5;4
36;58;Vilaboa;02-002-B;530;0;530;362;4;8;168;358;350;134;0;1;2;1;144;58;0;6;4
36;60;Vilagarcía de Arousa;01-001-A;486;0;486;326;5;5;160;321;316;105;0;0;2;1;130;62;0;6;10
36;60;Vilagarcía de Arousa;01-001-B;460;0;460;314;2;1;146;312;311;113;0;0;3;0;115;68;0;7;5
36;60;Vilagarcía de Arousa;01-001-C;415;0;415;282;3;5;133;279;274;90;0;1;2;1;127;42;0;6;5
36;60;Vilagarcía de Arousa;01-002-A;595;0;595;402;3;3;193;399;396;111;0;1;2;1;203;58;0;9;11
36;60;Vilagarcía de Arousa;01-002-B;644;0;644;446;2;5;198;444;439;117;0;1;1;0;242;60;0;7;11
36;60;Vilagarcía de Arousa;01-003-U;681;0;681;442;5;2;239;437;435;135;0;0;1;3;218;60;0;9;9
36;60;Vilagarcía de Arousa;01-004-A;474;0;474;316;3;2;158;313;311;93;0;0;0;0;145;65;0;4;4
36;60;Vilagarcía de Arousa;01-004-B;800;0;800;485;2;1;315;483;482;151;0;2;4;0;208;102;1;10;4
36;60;Vilagarcía de Arousa;01-005-A;465;0;465;344;1;2;121;343;341;104;0;1;2;3;157;60;0;7;7
36;60;Vilagarcía de Arousa;01-005-B;501;0;501;314;1;2;187;313;311;104;0;0;0;4;142;47;0;5;9
36;60;Vilagarcía de Arousa;01-006-U;601;0;601;394;6;2;207;388;386;97;3;0;2;1;191;46;1;22;23
36;60;Vilagarcía de Arousa;01-007-A;688;0;688;403;8;6;285;395;389;143;0;2;1;0;172;49;0;13;9
36;60;Vilagarcía de Arousa;01-007-B;548;0;548;336;4;2;212;332;330;130;0;2;3;3;127;44;1;10;10
36;60;Vilagarcía de Arousa;01-007-C;591;0;591;370;11;3;221;359;356;121;1;0;1;0;168;38;0;16;11
36;60;Vilagarcía de Arousa;01-008-A;628;0;628;406;1;7;222;405;398;131;0;0;1;0;172;56;1;25;12
36;60;Vilagarcía de Arousa;01-008-B;654;0;654;398;1;5;256;397;392;143;0;0;4;3;168;53;1;11;9
36;60;Vilagarcía de Arousa;01-009-A;647;0;647;407;3;3;240;404;401;156;0;0;2;1;172;59;0;6;5
36;60;Vilagarcía de Arousa;01-009-B;499;0;499;316;3;2;183;313;311;114;0;1;1;0;134;42;1;7;11
36;60;Vilagarcía de Arousa;01-009-C;698;0;698;455;3;6;243;452;446;141;1;0;1;0;209;69;0;7;18
36;60;Vilagarcía de Arousa;01-010-A;677;0;677;434;1;2;243;433;431;158;0;1;0;2;182;75;0;9;4
36;60;Vilagarcía de Arousa;01-010-B;574;0;574;363;1;4;211;362;358;137;0;0;1;0;154;54;1;5;6
36;60;Vilagarcía de Arousa;01-010-C;642;0;642;426;5;1;216;421;420;151;0;0;1;5;180;68;0;6;9
36;60;Vilagarcía de Arousa;01-011-A;635;0;635;402;6;2;233;396;394;130;0;1;2;2;169;74;2;11;3
36;60;Vilagarcía de Arousa;01-011-B;511;0;511;336;4;2;175;332;330;136;1;1;1;0;135;44;0;9;3
36;60;Vilagarcía de Arousa;01-011-C;577;0;577;395;1;3;182;394;391;140;0;0;1;1;169;62;1;11;6
36;60;Vilagarcía de Arousa;01-012-A;487;0;487;298;4;3;189;294;291;118;0;1;0;1;118;34;0;11;8
36;60;Vilagarcía de Arousa;01-012-B;486;0;486;305;4;4;181;301;297;114;0;0;4;0;131;36;0;6;6
36;60;Vilagarcía de Arousa;01-013-A;505;0;505;332;1;0;173;331;331;139;0;0;4;1;117;56;0;6;8
36;60;Vilagarcía de Arousa;01-013-B;599;0;599;391;10;0;208;381;381;117;0;0;5;4;176;64;1;8;6
36;60;Vilagarcía de Arousa;01-014-U;667;0;667;449;3;6;218;446;440;181;0;0;2;3;169;69;1;8;7
36;60;Vilagarcía de Arousa;02-001-A;393;0;393;257;4;1;136;253;252;104;0;0;5;2;98;35;0;7;1
36;60;Vilagarcía de Arousa;02-001-B;396;0;396;267;4;0;129;263;263;114;0;0;1;0;104;35;1;5;3
36;60;Vilagarcía de Arousa;02-002-A;579;0;579;395;2;1;184;393;392;133;0;1;1;6;160;65;0;21;5
36;60;Vilagarcía de Arousa;02-002-B;754;0;754;506;3;0;248;503;503;174;0;0;3;3;210;79;1;15;18
36;60;Vilagarcía de Arousa;02-003-U;589;0;589;391;8;4;198;383;379;89;0;0;2;2;236;27;0;10;13
36;60;Vilagarcía de Arousa;03-001-A;509;0;509;369;4;2;140;365;363;126;0;0;4;0;171;45;3;8;6
36;60;Vilagarcía de Arousa;03-001-B;532;0;532;388;5;3;144;383;380;133;1;0;1;1;167;55;0;9;13
36;60;Vilagarcía de Arousa;03-001-C;467;0;467;317;5;2;150;312;310;109;0;0;1;2;134;46;1;10;7
36;60;Vilagarcía de Arousa;03-003-A;581;0;581;368;3;1;213;365;364;130;0;0;4;4;151;60;0;8;7
36;60;Vilagarcía de Arousa;03-003-B;576;0;576;387;4;1;189;383;382;111;0;0;1;0;189;73;0;5;3
36;60;Vilagarcía de Arousa;04-001-A;586;0;586;411;7;1;175;404;403;148;0;1;0;1;166;67;1;14;5
36;60;Vilagarcía de Arousa;04-001-B;501;0;501;331;4;2;170;327;325;121;1;1;0;1;134;54;0;6;7
36;60;Vilagarcía de Arousa;04-002-A;498;0;498;295;4;1;203;291;290;87;0;1;1;2;137;59;0;2;1
36;60;Vilagarcía de Arousa;04-002-B;506;0;506;297;1;2;209;296;294;85;0;1;2;0;145;46;0;8;7
36;60;Vilagarcía de Arousa;04-003-A;655;0;655;432;6;3;223;426;423;137;0;2;2;3;199;62;1;11;6
36;60;Vilagarcía de Arousa;04-003-B;641;0;641;437;3;1;204;434;433;125;0;2;4;1;194;86;0;10;11
36;60;Vilagarcía de Arousa;04-004-A;530;0;530;355;4;2;175;351;349;129;1;2;1;0;143;59;0;8;6
36;60;Vilagarcía de Arousa;04-004-B;487;0;487;316;1;0;171;315;315;97;0;1;2;1;134;57;0;8;15
36;60;Vilagarcía de Arousa;04-005-A;513;0;513;310;5;3;203;305;302;97;0;0;0;2;135;44;0;7;17
36;60;Vilagarcía de Arousa;04-005-B;608;0;608;375;3;2;233;372;370;121;0;0;2;3;169;51;0;10;14
36;60;Vilagarcía de Arousa;04-005-C;566;0;566;350;2;2;216;348;346;102;0;1;2;4;167;55;0;9;6
36;60;Vilagarcía de Arousa;04-006-U;546;0;546;355;2;3;191;353;350;100;0;1;2;2;172;52;0;11;10
36;60;Vilagarcía de Arousa;04-007-A;558;0;558;362;4;1;196;358;357;130;0;2;1;2;146;57;0;11;8
36;60;Vilagarcía de Arousa;04-007-B;660;0;660;412;5;3;248;407;404;153;0;1;0;1;157;69;0;10;13
36;61;Vilanova de Arousa;01-001-A;418;0;418;297;4;2;121;293;291;75;0;0;1;1;171;33;0;2;8
36;61;Vilanova de Arousa;01-001-B;570;0;570;393;12;3;177;381;378;99;1;0;3;0;224;30;2;6;13
36;61;Vilanova de Arousa;01-005-A;698;0;698;446;3;2;252;443;441;136;0;1;0;0;249;35;0;6;14
36;61;Vilanova de Arousa;01-005-B;819;0;819;553;6;8;266;547;539;139;1;5;2;0;302;52;1;19;18
36;61;Vilanova de Arousa;02-001-U;701;0;701;481;8;7;220;473;466;72;1;1;0;2;309;57;0;11;13
36;61;Vilanova de Arousa;02-002-A;381;0;381;298;1;2;83;297;295;74;0;0;1;0;165;46;0;6;3
36;61;Vilanova de Arousa;02-002-B;747;0;747;532;6;3;215;526;523;136;0;1;1;0;319;46;1;12;7
36;61;Vilanova de Arousa;03-001-A;404;0;404;292;9;2;112;283;281;66;0;0;1;0;189;16;0;4;5
36;61;Vilanova de Arousa;03-001-B;569;0;569;447;11;2;122;436;434;88;0;0;1;0;310;27;0;2;6
36;61;Vilanova de Arousa;03-001-C;370;0;370;281;3;2;89;278;276;75;0;0;0;0;157;31;1;5;7
36;61;Vilanova de Arousa;03-002-A;581;0;581;401;3;6;180;398;392;72;0;0;1;0;260;41;0;11;7
36;61;Vilanova de Arousa;03-002-B;837;0;837;598;11;2;239;587;585;138;0;1;2;0;368;47;1;14;14
36;61;Vilanova de Arousa;03-003-A;674;0;674;514;5;5;160;509;504;87;0;0;0;0;346;51;1;7;12
36;61;Vilanova de Arousa;03-003-B;785;0;785;587;15;4;198;572;568;140;0;2;3;0;353;49;1;6;14
36;990;Residentes ausentes-Pontevedra;99-001-U;0;0;0;0;0;0;;0;0;0;0;0;0;0;0;0;0;0;0
36;990;Residentes ausentes-Pontevedra;99-002-U;0;0;0;0;0;0;;0;0;0;0;0;0;0;0;0;0;0;0
36;990;Residentes ausentes-Pontevedra;99-003-U;0;0;0;0;0;0;;0;0;0;0;0;0;0;0;0;0;0;0
36;990;Residentes ausentes-Pontevedra;99-004-U;0;0;0;0;0;0;;0;0;0;0;0;0;0;0;0;0;0;0
36;990;Residentes ausentes-Pontevedra;99-005-U;0;0;0;0;0;0;;0;0;0;0;0;0;0;0;0;0;0;0
36;990;Residentes ausentes-Pontevedra;99-006-U;0;0;0;0;0;0;;0;0;0;0;0;0;0;0;0;0;0;0
36;990;Residentes ausentes-Pontevedra;99-007-U;0;0;0;0;0;0;;0;0;0;0;0;0;0;0;0;0;0;0
36;990;Residentes ausentes-Pontevedra;99-008-U;0;0;0;0;0;0;;0;0;0;0;0;0;0;0;0;0;0;0
36;990;Residentes ausentes-Pontevedra;99-009-U;0;0;0;0;0;0;;0;0;0;0;0;0;0;0;0;0;0;0
36;990;Residentes ausentes-Pontevedra;99-010-U;0;0;0;0;0;0;;0;0;0;0;0;0;0;0;0;0;0;0
36;990;Residentes ausentes-Pontevedra;99-011-U;0;0;0;0;0;0;;0;0;0;0;0;0;0;0;0;0;0;0
36;990;Residentes ausentes-Pontevedra;99-012-U;0;0;0;0;0;0;;0;0;0;0;0;0;0;0;0;0;0;0
36;990;Residentes ausentes-Pontevedra;99-013-U;0;0;0;0;0;0;;0;0;0;0;0;0;0;0;0;0;0;0
Total;;;;773510;954;774464;520794;5375;4262;253670;515419;511157;178812;351;934;2208;1522;226633;75963;555;12537;11642
