﻿Codi Província;Nom Província;Codi Comarca;Nom Comarca;Codi Municipi;Nom Municipi;Districte;Secció;Mesa;Població;Cens;Participació 20:00;Abstenció;Vots nuls;Vots en blanc;Vots a candidatures;Vots vàlids
25;Lleida;25;Pallars Jussà;25001;Abella de la Conca;1;1;A;;133;47;86;0;0;47;47
8;Barcelona;11;Baix Llobregat;08001;Abrera;1;1;A;;582;372;210;1;1;370;371
8;Barcelona;11;Baix Llobregat;08001;Abrera;1;1;B;;566;356;210;0;2;354;356
8;Barcelona;11;Baix Llobregat;08001;Abrera;1;1;C;;598;382;216;0;1;381;382
8;Barcelona;11;Baix Llobregat;08001;Abrera;1;2;A;;634;388;246;9;3;376;379
8;Barcelona;11;Baix Llobregat;08001;Abrera;1;2;B;;714;432;282;9;6;417;423
25;Lleida;23;Noguera;25002;Àger;1;1;A;;524;334;190;2;5;327;332
25;Lleida;38;Urgell;25003;Agramunt;1;1;A;;939;565;374;2;4;559;563
25;Lleida;38;Urgell;25003;Agramunt;1;2;A;;1026;637;389;4;6;627;633
25;Lleida;38;Urgell;25003;Agramunt;1;3;A;;836;515;321;3;6;506;512
25;Lleida;38;Urgell;25003;Agramunt;1;4;A;;776;496;280;1;4;491;495
8;Barcelona;7;Bages;08002;Aguilar de Segarra;1;1;A;;177;131;46;0;1;130;131
17;Girona;2;Alt Empordà;17001;Agullana;1;1;A;;524;366;158;3;4;359;363
8;Barcelona;41;Vallès Oriental;08014;Aiguafreda;1;1;A;;619;453;166;1;3;449;452
8;Barcelona;41;Vallès Oriental;08014;Aiguafreda;1;1;B;;933;707;226;2;5;700;705
43;Tarragona;1;Alt Camp;43001;Aiguamúrcia;1;1;A;;247;186;61;0;1;185;186
43;Tarragona;1;Alt Camp;43001;Aiguamúrcia;1;1;B;;240;170;70;0;1;169;170
17;Girona;20;Gironès;17002;Aiguaviva;1;1;A;;277;181;96;1;0;180;180
25;Lleida;33;Segrià;25038;Aitona;1;1;A;;883;630;253;7;2;621;623
25;Lleida;33;Segrià;25038;Aitona;1;2;A;;921;572;349;2;1;569;570
25;Lleida;33;Segrià;25004;Alamús, els;1;1;A;;523;310;213;1;0;309;309
25;Lleida;4;Alt Urgell;25005;Alàs i Cerc;1;1;A;;349;211;138;0;0;211;211
25;Lleida;18;Garrigues;25006;Albagés, l';1;1;A;;472;326;146;4;3;319;322
17;Girona;2;Alt Empordà;17003;Albanyà;1;1;A;;87;58;29;0;2;56;58
25;Lleida;33;Segrià;25007;Albatàrrec;1;1;A;;814;529;285;2;5;522;527
25;Lleida;23;Noguera;25008;Albesa;1;1;A;;1160;774;386;2;8;764;772
25;Lleida;18;Garrigues;25009;Albi, l';1;1;A;;657;380;277;4;7;369;376
43;Tarragona;12;Baix Penedès;43002;Albinyana;1;1;A;;494;341;153;1;0;340;340
43;Tarragona;8;Baix Camp;43003;Albiol, l';1;1;A;;60;40;20;0;0;40;40
17;Girona;10;Baix Empordà;17004;Albons;1;1;A;;382;275;107;1;4;270;274
43;Tarragona;22;Montsià;43004;Alcanar;1;1;A;;762;390;372;0;9;381;390
43;Tarragona;22;Montsià;43004;Alcanar;1;2;A;;612;339;273;2;5;332;337
43;Tarragona;22;Montsià;43004;Alcanar;1;2;B;;349;176;173;1;1;174;175
43;Tarragona;22;Montsià;43004;Alcanar;1;2;C;;732;414;318;0;9;405;414
43;Tarragona;22;Montsià;43004;Alcanar;1;3;A;;742;416;326;1;6;409;415
43;Tarragona;22;Montsià;43004;Alcanar;2;1;A;;542;277;265;0;3;274;277
43;Tarragona;22;Montsià;43004;Alcanar;2;1;B;;547;263;284;1;5;257;262
43;Tarragona;22;Montsià;43004;Alcanar;2;2;A;;751;394;357;3;7;384;391
43;Tarragona;22;Montsià;43004;Alcanar;2;3;A;;546;303;243;0;7;296;303
25;Lleida;33;Segrià;25010;Alcanó;1;1;A;;234;132;102;0;2;130;132
25;Lleida;33;Segrià;25011;Alcarràs;1;1;A;;813;416;397;4;1;411;412
25;Lleida;33;Segrià;25011;Alcarràs;1;1;B;;685;340;345;7;2;331;333
25;Lleida;33;Segrià;25011;Alcarràs;1;2;A;;691;355;336;17;1;337;338
25;Lleida;33;Segrià;25011;Alcarràs;1;2;B;;621;274;347;13;0;261;261
25;Lleida;33;Segrià;25011;Alcarràs;1;3;A;;626;267;359;1;2;264;266
25;Lleida;33;Segrià;25012;Alcoletge;1;1;A;;1106;698;408;3;7;688;695
43;Tarragona;1;Alt Camp;43005;Alcover;1;1;A;;751;458;293;8;2;448;450
43;Tarragona;1;Alt Camp;43005;Alcover;1;1;B;;770;464;306;4;3;457;460
43;Tarragona;1;Alt Camp;43005;Alcover;2;1;A;;547;327;220;2;6;319;325
43;Tarragona;1;Alt Camp;43005;Alcover;2;1;B;;575;353;222;1;2;350;352
43;Tarragona;9;Baix Ebre;43904;Aldea, l';1;1;A;;840;378;462;3;3;372;375
43;Tarragona;9;Baix Ebre;43904;Aldea, l';1;1;B;;756;315;441;0;3;312;315
43;Tarragona;9;Baix Ebre;43904;Aldea, l';1;2;A;;780;355;425;1;2;352;354
43;Tarragona;9;Baix Ebre;43904;Aldea, l';1;2;B;;566;263;303;5;0;258;258
43;Tarragona;9;Baix Ebre;43006;Aldover;1;1;A;;677;394;283;0;2;392;394
43;Tarragona;8;Baix Camp;43007;Aleixar, l';1;1;A;;522;409;113;0;0;409;409
8;Barcelona;21;Maresme;08003;Alella;1;1;A;;1213;854;359;3;6;845;851
8;Barcelona;21;Maresme;08003;Alella;1;2;A;;1187;685;502;0;3;682;685
8;Barcelona;21;Maresme;08003;Alella;1;3;A;;708;472;236;0;5;467;472
8;Barcelona;21;Maresme;08003;Alella;1;3;B;;725;464;261;1;3;460;463
43;Tarragona;9;Baix Ebre;43008;Alfara de Carles;1;1;A;;358;207;151;0;0;207;207
25;Lleida;33;Segrià;25013;Alfarràs;1;1;A;;1263;815;448;6;3;806;809
25;Lleida;33;Segrià;25013;Alfarràs;1;2;A;;1143;699;444;6;2;691;693
25;Lleida;33;Segrià;25014;Alfés;1;1;A;;286;134;152;0;1;133;134
43;Tarragona;8;Baix Camp;43009;Alforja;1;1;A;;911;710;201;5;7;698;705
25;Lleida;23;Noguera;25015;Algerri;1;1;A;;479;336;143;0;7;329;336
25;Lleida;33;Segrià;25016;Alguaire;1;1;A;;660;377;283;1;2;374;376
25;Lleida;33;Segrià;25016;Alguaire;1;1;B;;767;410;357;0;2;408;410
25;Lleida;33;Segrià;25016;Alguaire;1;2;A;;801;405;396;0;1;404;405
25;Lleida;26;Pallars Sobirà;25017;Alins;1;1;A;;260;162;98;1;0;161;161
43;Tarragona;1;Alt Camp;43010;Alió;1;1;A;;280;188;92;4;2;182;184
25;Lleida;33;Segrià;25019;Almacelles;1;1;A;;726;418;308;5;6;407;413
25;Lleida;33;Segrià;25019;Almacelles;1;2;A;;1170;745;425;1;8;736;744
25;Lleida;33;Segrià;25019;Almacelles;2;1;A;;589;363;226;3;2;358;360
25;Lleida;33;Segrià;25019;Almacelles;2;1;B;;676;396;280;2;2;392;394
25;Lleida;33;Segrià;25019;Almacelles;2;2;A;;1049;542;507;0;6;536;542
25;Lleida;33;Segrià;25020;Almatret;1;1;A;;508;311;197;0;5;306;311
25;Lleida;33;Segrià;25021;Almenar;1;1;A;;1009;497;512;2;3;492;495
25;Lleida;33;Segrià;25021;Almenar;2;1;A;;1001;585;416;5;5;575;580
25;Lleida;33;Segrià;25021;Almenar;2;2;A;;806;449;357;4;3;442;445
43;Tarragona;8;Baix Camp;43011;Almoster;1;1;A;;321;254;67;3;0;251;251
25;Lleida;23;Noguera;25022;Alòs de Balaguer;1;1;A;;147;119;28;0;1;118;119
17;Girona;15;Cerdanya;17006;Alp;1;1;A;;654;436;218;3;10;423;433
8;Barcelona;24;Osona;08004;Alpens;1;1;A;;197;145;52;0;3;142;145
25;Lleida;33;Segrià;25023;Alpicat;1;1;A;;846;485;361;0;2;483;485
25;Lleida;33;Segrià;25023;Alpicat;1;1;B;;835;477;358;1;5;471;476
25;Lleida;33;Segrià;25023;Alpicat;1;2;A;;650;312;338;3;4;305;309
25;Lleida;33;Segrià;25023;Alpicat;1;2;B;;349;195;154;0;2;193;195
43;Tarragona;36;Tarragonès;43012;Altafulla;1;1;A;;476;308;168;2;2;304;306
43;Tarragona;36;Tarragonès;43012;Altafulla;1;1;B;;617;415;202;6;3;406;409
25;Lleida;26;Pallars Sobirà;25024;Alt Àneu;1;1;A;;286;179;107;0;0;179;179
17;Girona;34;Selva;17007;Amer;1;1;A;;615;434;181;1;4;429;433
17;Girona;34;Selva;17007;Amer;1;1;B;;583;405;178;0;1;404;405
17;Girona;34;Selva;17007;Amer;1;1;C;;615;512;103;2;5;505;510
8;Barcelona;41;Vallès Oriental;08005;Ametlla del Vallès, l';1;1;A;;958;641;317;7;4;630;634
8;Barcelona;41;Vallès Oriental;08005;Ametlla del Vallès, l';1;1;B;;1020;657;363;4;7;646;653
43;Tarragona;9;Baix Ebre;43013;Ametlla de Mar, l';1;1;A;;469;352;117;1;0;351;351
43;Tarragona;9;Baix Ebre;43013;Ametlla de Mar, l';1;1;B;;525;404;121;0;3;401;404
43;Tarragona;9;Baix Ebre;43013;Ametlla de Mar, l';1;2;A;;773;583;190;4;0;579;579
43;Tarragona;9;Baix Ebre;43013;Ametlla de Mar, l';1;2;B;;625;420;205;1;4;415;419
43;Tarragona;9;Baix Ebre;43013;Ametlla de Mar, l';1;2;C;;595;409;186;4;2;403;405
43;Tarragona;22;Montsià;43014;Amposta;1;1;A;;601;344;257;6;1;337;338
43;Tarragona;22;Montsià;43014;Amposta;1;2;A;;509;288;221;0;6;282;288
43;Tarragona;22;Montsià;43014;Amposta;1;2;B;;524;315;209;4;0;311;311
43;Tarragona;22;Montsià;43014;Amposta;1;3;A;;518;322;196;2;1;319;320
43;Tarragona;22;Montsià;43014;Amposta;2;1;A;;779;479;300;2;5;472;477
43;Tarragona;22;Montsià;43014;Amposta;2;2;A;;981;575;406;0;7;568;575
43;Tarragona;22;Montsià;43014;Amposta;3;1;A;;971;516;455;2;8;506;514
43;Tarragona;22;Montsià;43014;Amposta;3;2;A;;524;297;227;1;0;296;296
43;Tarragona;22;Montsià;43014;Amposta;3;2;B;;621;363;258;1;4;358;362
43;Tarragona;22;Montsià;43014;Amposta;4;1;A;;605;363;242;2;4;357;361
43;Tarragona;22;Montsià;43014;Amposta;4;1;B;;681;407;274;1;3;403;406
43;Tarragona;22;Montsià;43014;Amposta;4;2;A;;723;389;334;1;6;382;388
43;Tarragona;22;Montsià;43014;Amposta;4;2;B;;699;377;322;4;4;369;373
43;Tarragona;22;Montsià;43014;Amposta;4;3;A;;723;355;368;4;1;350;351
43;Tarragona;22;Montsià;43014;Amposta;4;3;B;;774;426;348;1;0;425;425
43;Tarragona;22;Montsià;43014;Amposta;4;4;A;;643;333;310;2;3;328;331
43;Tarragona;22;Montsià;43014;Amposta;4;4;B;;653;331;322;1;5;325;330
17;Girona;34;Selva;17008;Anglès;1;1;A;;529;390;139;2;2;386;388
17;Girona;34;Selva;17008;Anglès;1;1;B;;702;472;230;0;3;469;472
17;Girona;34;Selva;17008;Anglès;1;2;A;;647;489;158;5;5;479;484
17;Girona;34;Selva;17008;Anglès;1;2;B;;772;570;202;0;1;569;570
17;Girona;34;Selva;17008;Anglès;1;3;A;;548;381;167;0;3;378;381
17;Girona;34;Selva;17008;Anglès;1;3;B;;616;442;174;2;4;436;440
25;Lleida;38;Urgell;25027;Anglesola;1;1;A;;1034;649;385;0;3;646;649
25;Lleida;18;Garrigues;25029;Arbeca;1;1;A;;976;695;281;9;6;680;686
25;Lleida;18;Garrigues;25029;Arbeca;1;2;A;;969;663;306;5;1;657;658
43;Tarragona;12;Baix Penedès;43016;Arboç, l';1;1;A;;578;357;221;1;1;355;356
43;Tarragona;12;Baix Penedès;43016;Arboç, l';1;1;B;;829;524;305;3;3;518;521
43;Tarragona;12;Baix Penedès;43016;Arboç, l';1;2;A;;678;354;324;3;2;349;351
43;Tarragona;12;Baix Penedès;43016;Arboç, l';1;2;B;;706;417;289;2;2;413;415
43;Tarragona;8;Baix Camp;43015;Arbolí;1;1;A;;109;66;43;0;1;65;66
17;Girona;34;Selva;17009;Arbúcies;1;1;A;;681;504;177;1;1;502;503
17;Girona;34;Selva;17009;Arbúcies;1;1;B;;774;565;209;2;2;561;563
17;Girona;34;Selva;17009;Arbúcies;1;2;A;;653;496;157;2;1;493;494
17;Girona;34;Selva;17009;Arbúcies;1;2;B;;709;526;183;0;2;524;526
17;Girona;34;Selva;17009;Arbúcies;2;1;A;;536;395;141;4;0;391;391
8;Barcelona;21;Maresme;08006;Arenys de Mar;1;1;A;;570;355;215;1;1;353;354
8;Barcelona;21;Maresme;08006;Arenys de Mar;1;1;B;;698;488;210;1;3;484;487
8;Barcelona;21;Maresme;08006;Arenys de Mar;1;2;A;;623;437;186;1;1;435;436
8;Barcelona;21;Maresme;08006;Arenys de Mar;1;2;B;;686;478;208;0;2;476;478
8;Barcelona;21;Maresme;08006;Arenys de Mar;1;3;A;;854;599;255;4;2;593;595
8;Barcelona;21;Maresme;08006;Arenys de Mar;2;1;A;;1088;678;410;7;1;670;671
8;Barcelona;21;Maresme;08006;Arenys de Mar;2;2;A;;690;475;215;1;3;471;474
8;Barcelona;21;Maresme;08006;Arenys de Mar;2;2;B;;788;547;241;0;6;541;547
8;Barcelona;21;Maresme;08006;Arenys de Mar;2;3;A;;1001;618;383;1;2;615;617
8;Barcelona;21;Maresme;08006;Arenys de Mar;2;4;A;;851;459;392;0;4;455;459
8;Barcelona;21;Maresme;08007;Arenys de Munt;1;1;A;;581;470;111;3;7;460;467
8;Barcelona;21;Maresme;08007;Arenys de Munt;1;2;A;;515;363;152;7;2;354;356
8;Barcelona;21;Maresme;08007;Arenys de Munt;1;2;B;;607;436;171;8;0;428;428
8;Barcelona;21;Maresme;08007;Arenys de Munt;2;1;A;;805;600;205;0;4;596;600
8;Barcelona;21;Maresme;08007;Arenys de Munt;2;2;A;;411;276;135;4;1;271;272
8;Barcelona;21;Maresme;08007;Arenys de Munt;2;2;B;;483;325;158;0;2;323;325
17;Girona;19;Garrotxa;17010;Argelaguer;1;1;A;;289;212;77;4;2;206;208
8;Barcelona;6;Anoia;08008;Argençola;1;1;A;;140;73;67;0;0;73;73
43;Tarragona;8;Baix Camp;43017;Argentera, l';1;1;A;;118;87;31;0;1;86;87
8;Barcelona;21;Maresme;08009;Argentona;1;1;A;;575;383;192;0;1;382;383
8;Barcelona;21;Maresme;08009;Argentona;1;1;B;;582;378;204;1;3;374;377
8;Barcelona;21;Maresme;08009;Argentona;1;2;A;;715;526;189;1;1;524;525
8;Barcelona;21;Maresme;08009;Argentona;1;2;B;;749;510;239;2;2;506;508
8;Barcelona;21;Maresme;08009;Argentona;1;3;A;;861;509;352;2;2;505;507
8;Barcelona;21;Maresme;08009;Argentona;2;1;A;;698;515;183;1;1;513;514
8;Barcelona;21;Maresme;08009;Argentona;2;1;B;;500;356;144;3;0;353;353
8;Barcelona;21;Maresme;08009;Argentona;2;1;C;;632;439;193;1;6;432;438
17;Girona;2;Alt Empordà;17011;Armentera, l';1;1;A;;599;464;135;2;3;459;462
43;Tarragona;37;Terra Alta;43018;Arnes;1;1;A;;481;336;145;2;5;329;334
25;Lleida;39;Consell General d'Aran;25031;Arres;1;1;A;;44;26;18;0;0;26;26
25;Lleida;4;Alt Urgell;25032;Arsèguel;1;1;A;;68;46;22;1;1;44;45
8;Barcelona;7;Bages;08010;Artés;1;1;A;;972;645;327;2;2;641;643
8;Barcelona;7;Bages;08010;Artés;2;1;A;;827;528;299;0;2;526;528
8;Barcelona;7;Bages;08010;Artés;2;1;B;;827;545;282;7;2;536;538
8;Barcelona;7;Bages;08010;Artés;2;2;A;;604;415;189;0;0;415;415
25;Lleida;33;Segrià;25033;Artesa de Lleida;1;1;A;;936;611;325;4;0;607;607
25;Lleida;23;Noguera;25034;Artesa de Segre;1;1;A;;1116;773;343;11;5;757;762
25;Lleida;23;Noguera;25034;Artesa de Segre;1;2;A;;711;502;209;10;1;491;492
25;Lleida;23;Noguera;25034;Artesa de Segre;2;1;A;;201;124;77;0;0;124;124
25;Lleida;23;Noguera;25034;Artesa de Segre;2;1;B;;325;176;149;3;0;173;173
25;Lleida;23;Noguera;25034;Artesa de Segre;2;1;C;;240;153;87;1;0;152;152
43;Tarragona;30;Ribera d'Ebre;43019;Ascó;1;1;A;;931;580;351;5;5;570;575
43;Tarragona;30;Ribera d'Ebre;43019;Ascó;1;2;A;;488;279;209;6;3;270;273
25;Lleida;33;Segrià;25036;Aspa;1;1;A;;232;165;67;1;2;162;164
25;Lleida;23;Noguera;25037;Avellanes i Santa Linya, les;1;1;A;;454;274;180;0;5;269;274
8;Barcelona;14;Berguedà;08011;Avià;1;1;A;;679;456;223;11;8;437;445
8;Barcelona;14;Berguedà;08011;Avià;1;1;B;;761;513;248;2;1;510;511
8;Barcelona;7;Bages;08012;Avinyó;1;1;A;;808;600;208;2;3;595;598
8;Barcelona;7;Bages;08012;Avinyó;1;1;B;;790;568;222;3;1;564;565
8;Barcelona;3;Alt Penedès;08013;Avinyonet del Penedès;1;1;A;;926;588;338;6;1;581;582
17;Girona;2;Alt Empordà;17012;Avinyonet de Puigventós;1;1;A;;256;123;133;0;0;123;123
8;Barcelona;13;Barcelonès;08015;Badalona;1;1;A;;418;274;144;2;1;271;272
8;Barcelona;13;Barcelonès;08015;Badalona;1;1;B;;501;317;184;0;5;312;317
8;Barcelona;13;Barcelonès;08015;Badalona;1;2;A;;469;311;158;0;2;309;311
8;Barcelona;13;Barcelonès;08015;Badalona;1;3;A;;448;319;129;0;0;319;319
8;Barcelona;13;Barcelonès;08015;Badalona;1;3;B;;480;370;110;0;2;368;370
8;Barcelona;13;Barcelonès;08015;Badalona;1;4;A;;763;552;211;2;8;542;550
8;Barcelona;13;Barcelonès;08015;Badalona;1;5;A;;477;349;128;1;3;345;348
8;Barcelona;13;Barcelonès;08015;Badalona;1;5;B;;534;381;153;0;3;378;381
8;Barcelona;13;Barcelonès;08015;Badalona;1;6;A;;760;531;229;2;3;526;529
8;Barcelona;13;Barcelonès;08015;Badalona;1;7;A;;540;365;175;0;3;362;365
8;Barcelona;13;Barcelonès;08015;Badalona;1;7;B;;598;405;193;1;1;403;404
8;Barcelona;13;Barcelonès;08015;Badalona;1;8;A;;691;487;204;0;3;484;487
8;Barcelona;13;Barcelonès;08015;Badalona;1;9;A;;502;382;120;0;3;379;382
8;Barcelona;13;Barcelonès;08015;Badalona;2;1;A;;568;340;228;2;1;337;338
8;Barcelona;13;Barcelonès;08015;Badalona;2;1;B;;629;371;258;1;1;369;370
8;Barcelona;13;Barcelonès;08015;Badalona;2;10;A;;616;303;313;2;0;301;301
8;Barcelona;13;Barcelonès;08015;Badalona;2;10;B;;741;351;390;0;8;343;351
8;Barcelona;13;Barcelonès;08015;Badalona;2;11;A;;593;299;294;5;6;288;294
8;Barcelona;13;Barcelonès;08015;Badalona;2;11;B;;751;336;415;0;4;332;336
8;Barcelona;13;Barcelonès;08015;Badalona;2;12;A;;442;202;240;0;2;200;202
8;Barcelona;13;Barcelonès;08015;Badalona;2;12;B;;525;248;277;1;0;247;247
8;Barcelona;13;Barcelonès;08015;Badalona;2;13;A;;466;210;256;1;2;207;209
8;Barcelona;13;Barcelonès;08015;Badalona;2;13;B;;647;268;379;0;3;265;268
8;Barcelona;13;Barcelonès;08015;Badalona;2;14;A;;548;284;264;0;3;281;284
8;Barcelona;13;Barcelonès;08015;Badalona;2;15;A;;517;250;267;0;1;249;250
8;Barcelona;13;Barcelonès;08015;Badalona;2;15;B;;600;314;286;1;0;313;313
8;Barcelona;13;Barcelonès;08015;Badalona;2;2;A;;504;320;184;2;1;317;318
8;Barcelona;13;Barcelonès;08015;Badalona;2;2;B;;596;378;218;1;3;374;377
8;Barcelona;13;Barcelonès;08015;Badalona;2;3;A;;826;502;324;0;6;496;502
8;Barcelona;13;Barcelonès;08015;Badalona;2;4;A;;547;375;172;1;5;369;374
8;Barcelona;13;Barcelonès;08015;Badalona;2;4;B;;461;324;137;0;0;324;324
8;Barcelona;13;Barcelonès;08015;Badalona;2;4;C;;576;400;176;0;0;400;400
8;Barcelona;13;Barcelonès;08015;Badalona;2;5;A;;577;328;249;0;4;324;328
8;Barcelona;13;Barcelonès;08015;Badalona;2;6;A;;628;330;298;3;1;326;327
8;Barcelona;13;Barcelonès;08015;Badalona;2;7;A;;763;358;405;1;2;355;357
8;Barcelona;13;Barcelonès;08015;Badalona;2;8;A;;557;315;242;1;0;314;314
8;Barcelona;13;Barcelonès;08015;Badalona;2;8;B;;505;296;209;0;3;293;296
8;Barcelona;13;Barcelonès;08015;Badalona;2;8;C;;589;375;214;2;2;371;373
8;Barcelona;13;Barcelonès;08015;Badalona;2;9;A;;534;249;285;0;1;248;249
8;Barcelona;13;Barcelonès;08015;Badalona;2;9;B;;674;339;335;0;1;338;339
8;Barcelona;13;Barcelonès;08015;Badalona;3;1;A;;466;234;232;2;2;230;232
8;Barcelona;13;Barcelonès;08015;Badalona;3;10;A;;566;316;250;1;4;311;315
8;Barcelona;13;Barcelonès;08015;Badalona;3;10;B;;675;363;312;3;0;360;360
8;Barcelona;13;Barcelonès;08015;Badalona;3;11;A;;725;412;313;0;4;408;412
8;Barcelona;13;Barcelonès;08015;Badalona;3;12;A;;560;354;206;2;5;347;352
8;Barcelona;13;Barcelonès;08015;Badalona;3;12;B;;655;400;255;1;7;392;399
8;Barcelona;13;Barcelonès;08015;Badalona;3;2;A;;690;360;330;0;0;360;360
8;Barcelona;13;Barcelonès;08015;Badalona;3;2;B;;762;379;383;0;3;376;379
8;Barcelona;13;Barcelonès;08015;Badalona;3;3;A;;613;308;305;1;2;305;307
8;Barcelona;13;Barcelonès;08015;Badalona;3;3;B;;681;360;321;2;0;358;358
8;Barcelona;13;Barcelonès;08015;Badalona;3;4;A;;792;432;360;1;1;430;431
8;Barcelona;13;Barcelonès;08015;Badalona;3;5;A;;578;293;285;5;1;287;288
8;Barcelona;13;Barcelonès;08015;Badalona;3;5;B;;659;364;295;5;1;358;359
8;Barcelona;13;Barcelonès;08015;Badalona;3;6;A;;794;536;258;0;1;535;536
8;Barcelona;13;Barcelonès;08015;Badalona;3;7;A;;749;515;234;3;4;508;512
8;Barcelona;13;Barcelonès;08015;Badalona;3;8;A;;659;409;250;0;4;405;409
8;Barcelona;13;Barcelonès;08015;Badalona;3;9;A;;562;371;191;0;7;364;371
8;Barcelona;13;Barcelonès;08015;Badalona;4;1;A;;743;410;333;2;0;408;408
8;Barcelona;13;Barcelonès;08015;Badalona;4;10;A;;458;251;207;3;2;246;248
8;Barcelona;13;Barcelonès;08015;Badalona;4;10;B;;526;266;260;0;3;263;266
8;Barcelona;13;Barcelonès;08015;Badalona;4;11;A;;441;223;218;0;1;222;223
8;Barcelona;13;Barcelonès;08015;Badalona;4;11;B;;529;260;269;0;4;256;260
8;Barcelona;13;Barcelonès;08015;Badalona;4;2;A;;473;278;195;0;2;276;278
8;Barcelona;13;Barcelonès;08015;Badalona;4;2;B;;525;324;201;0;3;321;324
8;Barcelona;13;Barcelonès;08015;Badalona;4;3;A;;463;260;203;3;2;255;257
8;Barcelona;13;Barcelonès;08015;Badalona;4;3;B;;512;261;251;0;5;256;261
8;Barcelona;13;Barcelonès;08015;Badalona;4;4;A;;492;251;241;0;2;249;251
8;Barcelona;13;Barcelonès;08015;Badalona;4;4;B;;558;302;256;0;0;302;302
8;Barcelona;13;Barcelonès;08015;Badalona;4;5;A;;825;475;350;3;4;468;472
8;Barcelona;13;Barcelonès;08015;Badalona;4;6;A;;549;283;266;1;1;281;282
8;Barcelona;13;Barcelonès;08015;Badalona;4;6;B;;774;420;354;2;0;418;418
8;Barcelona;13;Barcelonès;08015;Badalona;4;7;A;;613;353;260;1;3;349;352
8;Barcelona;13;Barcelonès;08015;Badalona;4;7;B;;821;467;354;4;4;459;463
8;Barcelona;13;Barcelonès;08015;Badalona;4;8;A;;462;222;240;1;0;221;221
8;Barcelona;13;Barcelonès;08015;Badalona;4;8;B;;577;296;281;0;1;295;296
8;Barcelona;13;Barcelonès;08015;Badalona;4;8;C;;605;318;287;0;4;314;318
8;Barcelona;13;Barcelonès;08015;Badalona;4;9;A;;591;331;260;1;8;322;330
8;Barcelona;13;Barcelonès;08015;Badalona;5;1;A;;703;484;219;0;3;481;484
8;Barcelona;13;Barcelonès;08015;Badalona;5;1;B;;802;596;206;0;2;594;596
8;Barcelona;13;Barcelonès;08015;Badalona;5;2;A;;419;278;141;0;5;273;278
8;Barcelona;13;Barcelonès;08015;Badalona;5;2;B;;443;309;134;0;3;306;309
8;Barcelona;13;Barcelonès;08015;Badalona;5;3;A;;579;341;238;0;2;339;341
8;Barcelona;13;Barcelonès;08015;Badalona;5;3;B;;594;322;272;0;2;320;322
8;Barcelona;13;Barcelonès;08015;Badalona;5;4;A;;520;288;232;0;0;288;288
8;Barcelona;13;Barcelonès;08015;Badalona;5;4;B;;575;293;282;0;1;292;293
8;Barcelona;13;Barcelonès;08015;Badalona;5;4;C;;527;268;259;4;1;263;264
8;Barcelona;13;Barcelonès;08015;Badalona;5;5;A;;489;282;207;1;0;281;281
8;Barcelona;13;Barcelonès;08015;Badalona;5;5;B;;496;270;226;1;5;264;269
8;Barcelona;13;Barcelonès;08015;Badalona;5;5;C;;554;307;247;1;5;301;306
8;Barcelona;13;Barcelonès;08015;Badalona;5;6;A;;534;384;150;0;4;380;384
8;Barcelona;13;Barcelonès;08015;Badalona;5;6;B;;527;360;167;3;0;357;357
8;Barcelona;13;Barcelonès;08015;Badalona;6;1;A;;881;532;349;1;1;530;531
8;Barcelona;13;Barcelonès;08015;Badalona;6;2;A;;180;209;29;0;0;209;209
8;Barcelona;13;Barcelonès;08015;Badalona;6;2;B;;447;194;253;0;1;193;194
8;Barcelona;13;Barcelonès;08015;Badalona;6;3;A;;635;299;336;0;1;298;299
8;Barcelona;13;Barcelonès;08015;Badalona;6;3;B;;776;393;383;4;0;389;389
8;Barcelona;13;Barcelonès;08015;Badalona;6;4;A;;596;249;347;0;1;248;249
8;Barcelona;13;Barcelonès;08015;Badalona;6;4;B;;783;361;422;3;2;356;358
8;Barcelona;13;Barcelonès;08015;Badalona;6;5;A;;431;197;234;1;0;196;196
8;Barcelona;13;Barcelonès;08015;Badalona;6;5;B;;613;295;318;4;1;290;291
8;Barcelona;13;Barcelonès;08015;Badalona;6;5;C;;571;269;302;0;2;267;269
8;Barcelona;13;Barcelonès;08015;Badalona;6;6;A;;554;251;303;0;4;247;251
8;Barcelona;13;Barcelonès;08015;Badalona;6;6;B;;693;362;331;3;4;355;359
8;Barcelona;13;Barcelonès;08015;Badalona;7;1;A;;497;212;285;1;1;210;211
8;Barcelona;13;Barcelonès;08015;Badalona;7;1;B;;616;314;302;2;0;312;312
8;Barcelona;13;Barcelonès;08015;Badalona;7;10;A;;414;180;234;0;0;180;180
8;Barcelona;13;Barcelonès;08015;Badalona;7;10;B;;539;267;272;0;2;265;267
8;Barcelona;13;Barcelonès;08015;Badalona;7;11;A;;714;350;364;1;2;347;349
8;Barcelona;13;Barcelonès;08015;Badalona;7;11;B;;815;398;417;1;2;395;397
8;Barcelona;13;Barcelonès;08015;Badalona;7;12;A;;550;299;251;1;1;297;298
8;Barcelona;13;Barcelonès;08015;Badalona;7;12;B;;702;359;343;1;1;357;358
8;Barcelona;13;Barcelonès;08015;Badalona;7;13;A;;470;176;294;0;0;176;176
8;Barcelona;13;Barcelonès;08015;Badalona;7;13;B;;645;279;366;0;3;276;279
8;Barcelona;13;Barcelonès;08015;Badalona;7;14;A;;530;226;304;1;2;223;225
8;Barcelona;13;Barcelonès;08015;Badalona;7;14;B;;695;343;352;0;3;340;343
8;Barcelona;13;Barcelonès;08015;Badalona;7;15;A;;831;396;435;6;0;390;390
8;Barcelona;13;Barcelonès;08015;Badalona;7;16;A;;409;193;216;0;0;193;193
8;Barcelona;13;Barcelonès;08015;Badalona;7;17;A;;669;305;364;4;2;299;301
8;Barcelona;13;Barcelonès;08015;Badalona;7;18;A;;522;235;287;0;1;234;235
8;Barcelona;13;Barcelonès;08015;Badalona;7;18;B;;731;307;424;0;3;304;307
8;Barcelona;13;Barcelonès;08015;Badalona;7;18;C;;693;316;377;0;3;313;316
8;Barcelona;13;Barcelonès;08015;Badalona;7;19;A;;567;268;299;0;1;267;268
8;Barcelona;13;Barcelonès;08015;Badalona;7;2;A;;595;308;287;0;1;307;308
8;Barcelona;13;Barcelonès;08015;Badalona;7;2;B;;653;309;344;3;0;306;306
8;Barcelona;13;Barcelonès;08015;Badalona;7;20;A;;627;345;282;0;9;336;345
8;Barcelona;13;Barcelonès;08015;Badalona;7;20;B;;715;380;335;1;1;378;379
8;Barcelona;13;Barcelonès;08015;Badalona;7;21;A;;895;415;480;0;5;410;415
8;Barcelona;13;Barcelonès;08015;Badalona;7;22;A;;708;419;289;2;4;413;417
8;Barcelona;13;Barcelonès;08015;Badalona;7;23;A;;629;395;234;0;4;391;395
8;Barcelona;13;Barcelonès;08015;Badalona;7;23;B;;719;417;302;0;4;413;417
8;Barcelona;13;Barcelonès;08015;Badalona;7;24;A;;496;224;272;0;1;223;224
8;Barcelona;13;Barcelonès;08015;Badalona;7;24;B;;617;272;345;2;3;267;270
8;Barcelona;13;Barcelonès;08015;Badalona;7;25;A;;671;269;402;0;1;268;269
8;Barcelona;13;Barcelonès;08015;Badalona;7;26;A;;702;300;402;1;2;297;299
8;Barcelona;13;Barcelonès;08015;Badalona;7;27;A;;618;277;341;0;3;274;277
8;Barcelona;13;Barcelonès;08015;Badalona;7;27;B;;682;343;339;0;1;342;343
8;Barcelona;13;Barcelonès;08015;Badalona;7;28;A;;477;202;275;0;2;200;202
8;Barcelona;13;Barcelonès;08015;Badalona;7;28;B;;632;282;350;0;0;282;282
8;Barcelona;13;Barcelonès;08015;Badalona;7;28;C;;580;270;310;0;2;268;270
8;Barcelona;13;Barcelonès;08015;Badalona;7;29;A;;641;334;307;2;2;330;332
8;Barcelona;13;Barcelonès;08015;Badalona;7;29;B;;786;371;415;2;1;368;369
8;Barcelona;13;Barcelonès;08015;Badalona;7;3;A;;680;384;296;2;1;381;382
8;Barcelona;13;Barcelonès;08015;Badalona;7;3;B;;789;413;376;2;0;411;411
8;Barcelona;13;Barcelonès;08015;Badalona;7;4;A;;870;482;388;0;3;479;482
8;Barcelona;13;Barcelonès;08015;Badalona;7;5;A;;801;368;433;0;2;366;368
8;Barcelona;13;Barcelonès;08015;Badalona;7;6;A;;661;348;313;0;5;343;348
8;Barcelona;13;Barcelonès;08015;Badalona;7;7;A;;872;371;501;2;0;369;369
8;Barcelona;13;Barcelonès;08015;Badalona;7;8;A;;537;233;304;3;0;230;230
8;Barcelona;13;Barcelonès;08015;Badalona;7;8;B;;700;276;424;0;1;275;276
8;Barcelona;13;Barcelonès;08015;Badalona;7;9;A;;653;307;346;2;2;303;305
8;Barcelona;13;Barcelonès;08015;Badalona;8;1;A;;796;326;470;0;2;324;326
8;Barcelona;13;Barcelonès;08015;Badalona;8;10;A;;683;323;360;2;5;316;321
8;Barcelona;13;Barcelonès;08015;Badalona;8;10;B;;757;373;384;3;0;370;370
8;Barcelona;13;Barcelonès;08015;Badalona;8;11;A;;512;262;250;0;0;262;262
8;Barcelona;13;Barcelonès;08015;Badalona;8;2;A;;642;314;328;0;0;314;314
8;Barcelona;13;Barcelonès;08015;Badalona;8;2;B;;796;402;394;0;0;402;402
8;Barcelona;13;Barcelonès;08015;Badalona;8;3;A;;579;256;323;0;0;256;256
8;Barcelona;13;Barcelonès;08015;Badalona;8;3;B;;729;345;384;0;1;344;345
8;Barcelona;13;Barcelonès;08015;Badalona;8;4;A;;627;291;336;7;3;281;284
8;Barcelona;13;Barcelonès;08015;Badalona;8;5;A;;461;286;175;1;1;284;285
8;Barcelona;13;Barcelonès;08015;Badalona;8;5;B;;528;284;244;0;3;281;284
8;Barcelona;13;Barcelonès;08015;Badalona;8;6;A;;641;278;363;1;4;273;277
8;Barcelona;13;Barcelonès;08015;Badalona;8;6;B;;759;328;431;0;0;328;328
8;Barcelona;13;Barcelonès;08015;Badalona;8;7;A;;588;318;270;0;0;318;318
8;Barcelona;13;Barcelonès;08015;Badalona;8;7;B;;617;326;291;3;1;322;323
8;Barcelona;13;Barcelonès;08015;Badalona;8;8;A;;629;279;350;0;1;278;279
8;Barcelona;13;Barcelonès;08015;Badalona;8;8;B;;769;334;435;5;0;329;329
8;Barcelona;13;Barcelonès;08015;Badalona;8;9;A;;541;269;272;9;1;259;260
8;Barcelona;13;Barcelonès;08015;Badalona;8;9;B;;646;339;307;1;1;337;338
8;Barcelona;13;Barcelonès;08015;Badalona;9;1;A;;647;335;312;6;1;328;329
8;Barcelona;13;Barcelonès;08015;Badalona;9;10;A;;640;323;317;5;1;317;318
8;Barcelona;13;Barcelonès;08015;Badalona;9;10;B;;837;378;459;4;2;372;374
8;Barcelona;13;Barcelonès;08015;Badalona;9;11;A;;560;298;262;0;0;298;298
8;Barcelona;13;Barcelonès;08015;Badalona;9;11;B;;628;322;306;3;3;316;319
8;Barcelona;13;Barcelonès;08015;Badalona;9;12;A;;810;412;398;0;4;408;412
8;Barcelona;13;Barcelonès;08015;Badalona;9;13;A;;763;364;399;2;0;362;362
8;Barcelona;13;Barcelonès;08015;Badalona;9;14;A;;635;332;303;2;2;328;330
8;Barcelona;13;Barcelonès;08015;Badalona;9;14;B;;783;418;365;8;8;402;410
8;Barcelona;13;Barcelonès;08015;Badalona;9;15;A;;856;395;461;0;0;395;395
8;Barcelona;13;Barcelonès;08015;Badalona;9;16;A;;671;320;351;2;3;315;318
8;Barcelona;13;Barcelonès;08015;Badalona;9;16;B;;732;341;391;1;0;340;340
8;Barcelona;13;Barcelonès;08015;Badalona;9;17;A;;715;344;371;0;1;343;344
8;Barcelona;13;Barcelonès;08015;Badalona;9;18;A;;556;290;266;0;1;289;290
8;Barcelona;13;Barcelonès;08015;Badalona;9;19;A;;472;254;218;0;3;251;254
8;Barcelona;13;Barcelonès;08015;Badalona;9;19;B;;574;285;289;0;3;282;285
8;Barcelona;13;Barcelonès;08015;Badalona;9;2;A;;450;210;240;0;2;208;210
8;Barcelona;13;Barcelonès;08015;Badalona;9;2;B;;522;214;308;3;1;210;211
8;Barcelona;13;Barcelonès;08015;Badalona;9;20;A;;469;228;241;0;1;227;228
8;Barcelona;13;Barcelonès;08015;Badalona;9;20;B;;574;260;314;0;0;260;260
8;Barcelona;13;Barcelonès;08015;Badalona;9;20;C;;568;274;294;0;2;272;274
8;Barcelona;13;Barcelonès;08015;Badalona;9;21;A;;498;219;279;0;3;216;219
8;Barcelona;13;Barcelonès;08015;Badalona;9;21;B;;610;277;333;0;1;276;277
8;Barcelona;13;Barcelonès;08015;Badalona;9;22;A;;901;445;456;0;4;441;445
8;Barcelona;13;Barcelonès;08015;Badalona;9;23;A;;647;341;306;1;1;339;340
8;Barcelona;13;Barcelonès;08015;Badalona;9;24;A;;528;268;260;0;2;266;268
8;Barcelona;13;Barcelonès;08015;Badalona;9;24;B;;557;274;283;1;1;272;273
8;Barcelona;13;Barcelonès;08015;Badalona;9;24;C;;611;283;328;0;2;281;283
8;Barcelona;13;Barcelonès;08015;Badalona;9;25;A;;541;287;254;1;1;285;286
8;Barcelona;13;Barcelonès;08015;Badalona;9;25;B;;540;275;265;0;2;273;275
8;Barcelona;13;Barcelonès;08015;Badalona;9;26;A;;458;238;220;0;0;238;238
8;Barcelona;13;Barcelonès;08015;Badalona;9;26;B;;586;292;294;0;1;291;292
8;Barcelona;13;Barcelonès;08015;Badalona;9;27;A;;806;376;430;0;7;369;376
8;Barcelona;13;Barcelonès;08015;Badalona;9;28;A;;638;220;418;0;0;220;220
8;Barcelona;13;Barcelonès;08015;Badalona;9;28;B;;658;243;415;0;0;243;243
8;Barcelona;13;Barcelonès;08015;Badalona;9;29;A;;523;218;305;1;1;216;217
8;Barcelona;13;Barcelonès;08015;Badalona;9;29;B;;545;242;303;0;1;241;242
8;Barcelona;13;Barcelonès;08015;Badalona;9;29;C;;550;274;276;0;3;271;274
8;Barcelona;13;Barcelonès;08015;Badalona;9;3;A;;679;265;414;5;2;258;260
8;Barcelona;13;Barcelonès;08015;Badalona;9;30;A;;439;173;266;0;0;173;173
8;Barcelona;13;Barcelonès;08015;Badalona;9;30;B;;510;236;274;1;1;234;235
8;Barcelona;13;Barcelonès;08015;Badalona;9;31;A;;492;233;259;1;0;232;232
8;Barcelona;13;Barcelonès;08015;Badalona;9;31;B;;546;262;284;0;3;259;262
8;Barcelona;13;Barcelonès;08015;Badalona;9;32;A;;835;383;452;2;10;371;381
8;Barcelona;13;Barcelonès;08015;Badalona;9;33;A;;641;337;304;6;1;330;331
8;Barcelona;13;Barcelonès;08015;Badalona;9;33;B;;789;381;408;0;1;380;381
8;Barcelona;13;Barcelonès;08015;Badalona;9;34;A;;653;336;317;0;0;336;336
8;Barcelona;13;Barcelonès;08015;Badalona;9;34;B;;749;394;355;0;6;388;394
8;Barcelona;13;Barcelonès;08015;Badalona;9;35;A;;568;244;324;0;1;243;244
8;Barcelona;13;Barcelonès;08015;Badalona;9;35;B;;611;248;363;0;1;247;248
8;Barcelona;13;Barcelonès;08015;Badalona;9;36;A;;510;230;280;1;1;228;229
8;Barcelona;13;Barcelonès;08015;Badalona;9;36;B;;634;283;351;0;2;281;283
8;Barcelona;13;Barcelonès;08015;Badalona;9;37;A;;452;175;277;0;0;175;175
8;Barcelona;13;Barcelonès;08015;Badalona;9;37;B;;563;231;332;1;0;230;230
8;Barcelona;13;Barcelonès;08015;Badalona;9;38;A;;502;236;266;0;0;236;236
8;Barcelona;13;Barcelonès;08015;Badalona;9;39;A;;602;301;301;5;3;293;296
8;Barcelona;13;Barcelonès;08015;Badalona;9;4;A;;449;218;231;0;0;218;218
8;Barcelona;13;Barcelonès;08015;Badalona;9;40;A;;515;217;298;0;1;216;217
8;Barcelona;13;Barcelonès;08015;Badalona;9;41;A;;588;248;340;1;3;244;247
8;Barcelona;13;Barcelonès;08015;Badalona;9;41;B;;627;259;368;0;2;257;259
8;Barcelona;13;Barcelonès;08015;Badalona;9;42;A;;529;249;280;0;0;249;249
8;Barcelona;13;Barcelonès;08015;Badalona;9;42;B;;729;357;372;3;3;351;354
8;Barcelona;13;Barcelonès;08015;Badalona;9;43;A;;553;254;299;2;2;250;252
8;Barcelona;13;Barcelonès;08015;Badalona;9;43;B;;657;276;381;2;0;274;274
8;Barcelona;13;Barcelonès;08015;Badalona;9;44;A;;893;405;488;0;4;401;405
8;Barcelona;13;Barcelonès;08015;Badalona;9;45;A;;573;272;301;0;2;270;272
8;Barcelona;13;Barcelonès;08015;Badalona;9;45;B;;655;292;363;2;2;288;290
8;Barcelona;13;Barcelonès;08015;Badalona;9;46;A;;724;350;374;0;0;350;350
8;Barcelona;13;Barcelonès;08015;Badalona;9;47;A;;839;377;462;7;0;370;370
8;Barcelona;13;Barcelonès;08015;Badalona;9;48;A;;429;222;207;1;1;220;221
8;Barcelona;13;Barcelonès;08015;Badalona;9;48;B;;444;223;221;0;2;221;223
8;Barcelona;13;Barcelonès;08015;Badalona;9;49;A;;531;265;266;0;1;264;265
8;Barcelona;13;Barcelonès;08015;Badalona;9;49;B;;615;301;314;0;0;301;301
8;Barcelona;13;Barcelonès;08015;Badalona;9;5;A;;583;259;324;0;0;259;259
8;Barcelona;13;Barcelonès;08015;Badalona;9;5;B;;711;305;406;10;0;295;295
8;Barcelona;13;Barcelonès;08015;Badalona;9;50;A;;756;298;458;3;2;293;295
8;Barcelona;13;Barcelonès;08015;Badalona;9;51;A;;476;206;270;0;0;206;206
8;Barcelona;13;Barcelonès;08015;Badalona;9;52;A;;867;400;467;1;0;399;399
8;Barcelona;13;Barcelonès;08015;Badalona;9;53;A;;476;221;255;0;1;220;221
8;Barcelona;13;Barcelonès;08015;Badalona;9;53;B;;635;296;339;1;1;294;295
8;Barcelona;13;Barcelonès;08015;Badalona;9;54;A;;467;216;251;0;2;214;216
8;Barcelona;13;Barcelonès;08015;Badalona;9;54;B;;587;272;315;0;2;270;272
8;Barcelona;13;Barcelonès;08015;Badalona;9;55;A;;466;234;232;0;0;234;234
8;Barcelona;13;Barcelonès;08015;Badalona;9;55;B;;498;231;267;1;1;229;230
8;Barcelona;13;Barcelonès;08015;Badalona;9;56;A;;670;302;368;0;2;300;302
8;Barcelona;13;Barcelonès;08015;Badalona;9;57;A;;769;365;404;1;2;362;364
8;Barcelona;13;Barcelonès;08015;Badalona;9;6;A;;554;236;318;1;0;235;235
8;Barcelona;13;Barcelonès;08015;Badalona;9;6;B;;555;256;299;1;0;255;255
8;Barcelona;13;Barcelonès;08015;Badalona;9;7;A;;552;266;286;0;0;266;266
8;Barcelona;13;Barcelonès;08015;Badalona;9;8;A;;771;340;431;1;3;336;339
8;Barcelona;13;Barcelonès;08015;Badalona;9;8;B;;942;420;522;1;2;417;419
8;Barcelona;13;Barcelonès;08015;Badalona;9;9;A;;707;283;424;7;2;274;276
8;Barcelona;13;Barcelonès;08015;Badalona;9;9;B;;707;383;324;2;1;380;381
8;Barcelona;14;Berguedà;08016;Bagà;1;1;A;;1706;1095;611;5;7;1083;1090
25;Lleida;26;Pallars Sobirà;25039;Baix Pallars;1;1;A;;357;183;174;1;2;180;182
25;Lleida;23;Noguera;25040;Balaguer;1;1;A;;796;515;281;0;3;512;515
25;Lleida;23;Noguera;25040;Balaguer;1;2;A;;467;305;162;1;1;303;304
25;Lleida;23;Noguera;25040;Balaguer;1;3;A;;849;561;288;1;6;554;560
25;Lleida;23;Noguera;25040;Balaguer;2;1;A;;524;332;192;1;3;328;331
25;Lleida;23;Noguera;25040;Balaguer;2;1;B;;288;205;83;0;0;205;205
25;Lleida;23;Noguera;25040;Balaguer;2;2;A;;532;358;174;3;3;352;355
25;Lleida;23;Noguera;25040;Balaguer;3;1;A;;700;445;255;1;2;442;444
25;Lleida;23;Noguera;25040;Balaguer;3;1;B;;772;503;269;0;2;501;503
25;Lleida;23;Noguera;25040;Balaguer;3;2;A;;744;448;296;7;1;440;441
25;Lleida;23;Noguera;25040;Balaguer;4;1;A;;640;461;179;2;2;457;459
25;Lleida;23;Noguera;25040;Balaguer;4;1;B;;752;551;201;6;6;539;545
25;Lleida;23;Noguera;25040;Balaguer;4;2;A;;674;460;214;1;4;455;459
25;Lleida;23;Noguera;25040;Balaguer;4;2;B;;796;518;278;3;6;509;515
25;Lleida;23;Noguera;25040;Balaguer;4;3;A;;1336;966;370;6;3;957;960
8;Barcelona;24;Osona;08017;Balenyà;1;1;A;;805;541;264;0;5;536;541
8;Barcelona;24;Osona;08017;Balenyà;1;1;B;;1034;722;312;0;4;718;722
8;Barcelona;24;Osona;08017;Balenyà;1;2;A;;431;277;154;1;2;274;276
8;Barcelona;7;Bages;08018;Balsareny;1;1;A;;1220;792;428;2;4;786;790
8;Barcelona;7;Bages;08018;Balsareny;1;2;A;;898;574;324;4;1;569;570
8;Barcelona;7;Bages;08018;Balsareny;1;3;A;;305;224;81;3;2;219;221
8;Barcelona;7;Bages;08018;Balsareny;1;3;B;;281;171;110;1;0;170;170
43;Tarragona;12;Baix Penedès;43020;Banyeres del Penedès;1;1;A;;1079;760;319;5;6;749;755
17;Girona;28;Pla de l'Estany;17015;Banyoles;1;1;A;;505;354;151;2;4;348;352
17;Girona;28;Pla de l'Estany;17015;Banyoles;1;1;B;;613;475;138;0;6;469;475
17;Girona;28;Pla de l'Estany;17015;Banyoles;1;2;A;;682;495;187;4;5;486;491
17;Girona;28;Pla de l'Estany;17015;Banyoles;1;3;A;;567;385;182;1;6;378;384
17;Girona;28;Pla de l'Estany;17015;Banyoles;1;3;B;;655;427;228;2;0;425;425
17;Girona;28;Pla de l'Estany;17015;Banyoles;1;4;A;;565;421;144;8;1;412;413
17;Girona;28;Pla de l'Estany;17015;Banyoles;1;4;B;;752;541;211;4;4;533;537
17;Girona;28;Pla de l'Estany;17015;Banyoles;2;1;A;;727;534;193;4;5;525;530
17;Girona;28;Pla de l'Estany;17015;Banyoles;2;1;B;;847;582;265;6;8;568;576
17;Girona;28;Pla de l'Estany;17015;Banyoles;2;2;A;;769;576;193;6;6;564;570
17;Girona;28;Pla de l'Estany;17015;Banyoles;2;3;A;;640;430;210;4;1;425;426
17;Girona;28;Pla de l'Estany;17015;Banyoles;2;3;B;;712;475;237;4;3;468;471
17;Girona;28;Pla de l'Estany;17015;Banyoles;3;1;A;;577;533;44;3;3;527;530
17;Girona;28;Pla de l'Estany;17015;Banyoles;3;1;B;;668;515;153;2;7;506;513
17;Girona;28;Pla de l'Estany;17015;Banyoles;3;2;A;;655;393;262;1;11;381;392
25;Lleida;27;Pla d'Urgell;25041;Barbens;1;1;A;;649;415;234;0;2;413;415
43;Tarragona;16;Conca de Barberà;43021;Barberà de la Conca;1;1;A;;370;222;148;3;3;216;219
8;Barcelona;40;Vallès Occidental;08252;Barberà del Vallès;1;1;A;;1198;654;544;1;1;652;653
8;Barcelona;40;Vallès Occidental;08252;Barberà del Vallès;1;10;A;;705;387;318;0;5;382;387
8;Barcelona;40;Vallès Occidental;08252;Barberà del Vallès;1;10;B;;857;444;413;2;1;441;442
8;Barcelona;40;Vallès Occidental;08252;Barberà del Vallès;1;11;A;;627;344;283;1;1;342;343
8;Barcelona;40;Vallès Occidental;08252;Barberà del Vallès;1;11;B;;710;382;328;0;0;382;382
8;Barcelona;40;Vallès Occidental;08252;Barberà del Vallès;1;12;A;;1049;477;572;4;3;470;473
8;Barcelona;40;Vallès Occidental;08252;Barberà del Vallès;1;13;A;;1299;551;748;6;5;540;545
8;Barcelona;40;Vallès Occidental;08252;Barberà del Vallès;1;14;A;;1233;504;729;2;2;500;502
8;Barcelona;40;Vallès Occidental;08252;Barberà del Vallès;1;15;A;;1026;427;599;1;0;426;426
8;Barcelona;40;Vallès Occidental;08252;Barberà del Vallès;1;16;A;;1053;471;582;7;2;462;464
8;Barcelona;40;Vallès Occidental;08252;Barberà del Vallès;1;17;A;;991;447;544;0;3;444;447
8;Barcelona;40;Vallès Occidental;08252;Barberà del Vallès;1;2;A;;1159;629;530;0;5;624;629
8;Barcelona;40;Vallès Occidental;08252;Barberà del Vallès;1;3;A;;1248;667;581;2;0;665;665
8;Barcelona;40;Vallès Occidental;08252;Barberà del Vallès;1;4;A;;1047;535;512;2;2;531;533
8;Barcelona;40;Vallès Occidental;08252;Barberà del Vallès;1;5;A;;1036;550;486;0;3;547;550
8;Barcelona;40;Vallès Occidental;08252;Barberà del Vallès;1;6;A;;710;348;362;0;2;346;348
8;Barcelona;40;Vallès Occidental;08252;Barberà del Vallès;1;6;B;;796;404;392;0;3;401;404
8;Barcelona;40;Vallès Occidental;08252;Barberà del Vallès;1;7;A;;660;349;311;0;2;347;349
8;Barcelona;40;Vallès Occidental;08252;Barberà del Vallès;1;7;B;;717;396;321;3;4;389;393
8;Barcelona;40;Vallès Occidental;08252;Barberà del Vallès;1;8;A;;1076;528;548;0;5;523;528
8;Barcelona;40;Vallès Occidental;08252;Barberà del Vallès;1;9;A;;663;371;292;1;1;369;370
8;Barcelona;40;Vallès Occidental;08252;Barberà del Vallès;1;9;B;;775;388;387;3;0;385;385
8;Barcelona;13;Barcelonès;08019;Barcelona;1;1;A;;701;338;363;0;0;338;338
8;Barcelona;13;Barcelonès;08019;Barcelona;1;10;A;;586;307;279;9;0;298;298
8;Barcelona;13;Barcelonès;08019;Barcelona;1;100;A;;606;248;358;1;0;247;247
8;Barcelona;13;Barcelonès;08019;Barcelona;1;101;A;;519;240;279;1;0;239;239
8;Barcelona;13;Barcelonès;08019;Barcelona;1;102;A;;656;308;348;1;2;305;307
8;Barcelona;13;Barcelonès;08019;Barcelona;1;103;A;;467;221;246;0;0;221;221
8;Barcelona;13;Barcelonès;08019;Barcelona;1;103;B;;462;225;237;9;0;216;216
8;Barcelona;13;Barcelonès;08019;Barcelona;1;104;A;;435;222;213;2;1;219;220
8;Barcelona;13;Barcelonès;08019;Barcelona;1;104;B;;429;224;205;0;2;222;224
8;Barcelona;13;Barcelonès;08019;Barcelona;1;105;A;;635;289;346;0;1;288;289
8;Barcelona;13;Barcelonès;08019;Barcelona;1;106;A;;382;174;208;0;4;170;174
8;Barcelona;13;Barcelonès;08019;Barcelona;1;107;A;;502;206;296;2;1;203;204
8;Barcelona;13;Barcelonès;08019;Barcelona;1;108;A;;609;251;358;7;1;243;244
8;Barcelona;13;Barcelonès;08019;Barcelona;1;109;A;;430;210;220;0;1;209;210
8;Barcelona;13;Barcelonès;08019;Barcelona;1;11;A;;418;234;184;9;0;225;225
8;Barcelona;13;Barcelonès;08019;Barcelona;1;110;A;;613;295;318;0;0;295;295
8;Barcelona;13;Barcelonès;08019;Barcelona;1;111;A;;517;266;251;1;2;263;265
8;Barcelona;13;Barcelonès;08019;Barcelona;1;112;A;;433;232;201;3;2;227;229
8;Barcelona;13;Barcelonès;08019;Barcelona;1;113;A;;686;330;356;0;5;325;330
8;Barcelona;13;Barcelonès;08019;Barcelona;1;114;A;;671;342;329;1;1;340;341
8;Barcelona;13;Barcelonès;08019;Barcelona;1;115;A;;699;331;368;4;2;325;327
8;Barcelona;13;Barcelonès;08019;Barcelona;1;116;A;;549;293;256;11;0;282;282
8;Barcelona;13;Barcelonès;08019;Barcelona;1;116;B;;549;277;272;2;1;274;275
8;Barcelona;13;Barcelonès;08019;Barcelona;1;117;A;;722;315;407;3;7;305;312
8;Barcelona;13;Barcelonès;08019;Barcelona;1;118;A;;393;211;182;3;1;207;208
8;Barcelona;13;Barcelonès;08019;Barcelona;1;119;A;;453;224;229;10;0;214;214
8;Barcelona;13;Barcelonès;08019;Barcelona;1;12;A;;546;295;251;1;1;293;294
8;Barcelona;13;Barcelonès;08019;Barcelona;1;120;A;;759;403;356;8;1;394;395
8;Barcelona;13;Barcelonès;08019;Barcelona;1;121;A;;394;207;187;0;0;207;207
8;Barcelona;13;Barcelonès;08019;Barcelona;1;122;A;;765;389;376;8;0;381;381
8;Barcelona;13;Barcelonès;08019;Barcelona;1;123;A;;683;383;300;0;3;380;383
8;Barcelona;13;Barcelonès;08019;Barcelona;1;124;A;;579;276;303;2;3;271;274
8;Barcelona;13;Barcelonès;08019;Barcelona;1;125;A;;411;238;173;5;1;232;233
8;Barcelona;13;Barcelonès;08019;Barcelona;1;126;A;;451;265;186;1;1;263;264
8;Barcelona;13;Barcelonès;08019;Barcelona;1;127;A;;405;205;200;0;0;205;205
8;Barcelona;13;Barcelonès;08019;Barcelona;1;128;A;;390;237;153;1;2;234;236
8;Barcelona;13;Barcelonès;08019;Barcelona;1;129;A;;563;369;194;1;1;367;368
8;Barcelona;13;Barcelonès;08019;Barcelona;1;13;A;;527;323;204;1;1;321;322
8;Barcelona;13;Barcelonès;08019;Barcelona;1;130;A;;519;307;212;3;1;303;304
8;Barcelona;13;Barcelonès;08019;Barcelona;1;131;A;;389;214;175;3;4;207;211
8;Barcelona;13;Barcelonès;08019;Barcelona;1;132;A;;397;237;160;0;0;237;237
8;Barcelona;13;Barcelonès;08019;Barcelona;1;133;A;;420;222;198;12;0;210;210
8;Barcelona;13;Barcelonès;08019;Barcelona;1;134;A;;427;230;197;0;2;228;230
8;Barcelona;13;Barcelonès;08019;Barcelona;1;135;A;;452;265;187;0;1;264;265
8;Barcelona;13;Barcelonès;08019;Barcelona;1;136;A;;494;257;237;4;1;252;253
8;Barcelona;13;Barcelonès;08019;Barcelona;1;137;A;;601;326;275;8;0;318;318
8;Barcelona;13;Barcelonès;08019;Barcelona;1;138;A;;556;277;279;3;2;272;274
8;Barcelona;13;Barcelonès;08019;Barcelona;1;139;A;;764;376;388;4;0;372;372
8;Barcelona;13;Barcelonès;08019;Barcelona;1;14;A;;554;301;253;8;1;292;293
8;Barcelona;13;Barcelonès;08019;Barcelona;1;140;A;;734;400;334;0;2;398;400
8;Barcelona;13;Barcelonès;08019;Barcelona;1;141;A;;726;412;314;1;0;411;411
8;Barcelona;13;Barcelonès;08019;Barcelona;1;142;A;;506;277;229;3;2;272;274
8;Barcelona;13;Barcelonès;08019;Barcelona;1;143;A;;349;209;140;4;0;205;205
8;Barcelona;13;Barcelonès;08019;Barcelona;1;144;A;;488;272;216;1;2;269;271
8;Barcelona;13;Barcelonès;08019;Barcelona;1;145;A;;347;202;145;0;0;202;202
8;Barcelona;13;Barcelonès;08019;Barcelona;1;146;A;;523;351;172;0;2;349;351
8;Barcelona;13;Barcelonès;08019;Barcelona;1;147;A;;333;222;111;1;0;221;221
8;Barcelona;13;Barcelonès;08019;Barcelona;1;148;A;;584;395;189;1;1;393;394
8;Barcelona;13;Barcelonès;08019;Barcelona;1;149;A;;588;326;262;2;0;324;324
8;Barcelona;13;Barcelonès;08019;Barcelona;1;15;A;;742;371;371;9;0;362;362
8;Barcelona;13;Barcelonès;08019;Barcelona;1;150;A;;691;386;305;0;0;386;386
8;Barcelona;13;Barcelonès;08019;Barcelona;1;151;A;;714;405;309;8;2;395;397
8;Barcelona;13;Barcelonès;08019;Barcelona;1;16;A;;577;341;236;0;1;340;341
8;Barcelona;13;Barcelonès;08019;Barcelona;1;17;A;;536;260;276;4;1;255;256
8;Barcelona;13;Barcelonès;08019;Barcelona;1;18;A;;705;283;422;2;2;279;281
8;Barcelona;13;Barcelonès;08019;Barcelona;1;19;A;;724;374;350;9;1;364;365
8;Barcelona;13;Barcelonès;08019;Barcelona;1;2;A;;610;321;289;5;0;316;316
8;Barcelona;13;Barcelonès;08019;Barcelona;1;20;A;;501;237;264;0;1;236;237
8;Barcelona;13;Barcelonès;08019;Barcelona;1;21;A;;467;238;229;0;5;233;238
8;Barcelona;13;Barcelonès;08019;Barcelona;1;22;A;;590;262;328;2;1;259;260
8;Barcelona;13;Barcelonès;08019;Barcelona;1;23;A;;430;227;203;1;0;226;226
8;Barcelona;13;Barcelonès;08019;Barcelona;1;24;A;;765;371;394;0;1;370;371
8;Barcelona;13;Barcelonès;08019;Barcelona;1;25;A;;460;277;183;3;3;271;274
8;Barcelona;13;Barcelonès;08019;Barcelona;1;26;A;;381;209;172;0;6;203;209
8;Barcelona;13;Barcelonès;08019;Barcelona;1;27;A;;566;334;232;14;2;318;320
8;Barcelona;13;Barcelonès;08019;Barcelona;1;28;A;;482;237;245;2;1;234;235
8;Barcelona;13;Barcelonès;08019;Barcelona;1;29;A;;694;364;330;2;2;360;362
8;Barcelona;13;Barcelonès;08019;Barcelona;1;3;A;;417;196;221;3;0;193;193
8;Barcelona;13;Barcelonès;08019;Barcelona;1;30;A;;596;316;280;4;1;311;312
8;Barcelona;13;Barcelonès;08019;Barcelona;1;31;A;;705;385;320;7;0;378;378
8;Barcelona;13;Barcelonès;08019;Barcelona;1;32;A;;644;366;278;2;1;363;364
8;Barcelona;13;Barcelonès;08019;Barcelona;1;33;A;;425;228;197;4;1;223;224
8;Barcelona;13;Barcelonès;08019;Barcelona;1;33;B;;425;233;192;0;0;233;233
8;Barcelona;13;Barcelonès;08019;Barcelona;1;34;A;;527;267;260;3;2;262;264
8;Barcelona;13;Barcelonès;08019;Barcelona;1;35;A;;464;274;190;1;0;273;273
8;Barcelona;13;Barcelonès;08019;Barcelona;1;36;A;;491;256;235;0;2;254;256
8;Barcelona;13;Barcelonès;08019;Barcelona;1;37;A;;331;221;110;3;2;216;218
8;Barcelona;13;Barcelonès;08019;Barcelona;1;38;A;;683;405;278;3;1;401;402
8;Barcelona;13;Barcelonès;08019;Barcelona;1;39;A;;793;477;316;8;2;467;469
8;Barcelona;13;Barcelonès;08019;Barcelona;1;4;A;;524;230;294;0;0;230;230
8;Barcelona;13;Barcelonès;08019;Barcelona;1;40;A;;310;156;154;2;0;154;154
8;Barcelona;13;Barcelonès;08019;Barcelona;1;41;A;;306;163;143;5;0;158;158
8;Barcelona;13;Barcelonès;08019;Barcelona;1;42;A;;470;229;241;0;1;228;229
8;Barcelona;13;Barcelonès;08019;Barcelona;1;43;A;;597;276;321;14;0;262;262
8;Barcelona;13;Barcelonès;08019;Barcelona;1;44;A;;551;264;287;0;1;263;264
8;Barcelona;13;Barcelonès;08019;Barcelona;1;45;A;;678;367;311;2;1;364;365
8;Barcelona;13;Barcelonès;08019;Barcelona;1;46;A;;680;264;416;8;1;255;256
8;Barcelona;13;Barcelonès;08019;Barcelona;1;47;A;;635;332;303;10;1;321;322
8;Barcelona;13;Barcelonès;08019;Barcelona;1;48;A;;680;371;309;1;2;368;370
8;Barcelona;13;Barcelonès;08019;Barcelona;1;49;A;;563;303;260;0;1;302;303
8;Barcelona;13;Barcelonès;08019;Barcelona;1;49;B;;565;316;249;6;2;308;310
8;Barcelona;13;Barcelonès;08019;Barcelona;1;5;A;;672;323;349;0;0;323;323
8;Barcelona;13;Barcelonès;08019;Barcelona;1;50;A;;435;275;160;5;5;265;270
8;Barcelona;13;Barcelonès;08019;Barcelona;1;51;A;;701;421;280;0;3;418;421
8;Barcelona;13;Barcelonès;08019;Barcelona;1;52;A;;687;411;276;12;2;397;399
8;Barcelona;13;Barcelonès;08019;Barcelona;1;53;A;;765;437;328;11;3;423;426
8;Barcelona;13;Barcelonès;08019;Barcelona;1;54;A;;623;352;271;12;0;340;340
8;Barcelona;13;Barcelonès;08019;Barcelona;1;55;A;;529;271;258;0;0;271;271
8;Barcelona;13;Barcelonès;08019;Barcelona;1;56;A;;573;302;271;0;2;300;302
8;Barcelona;13;Barcelonès;08019;Barcelona;1;57;A;;525;356;169;0;2;354;356
8;Barcelona;13;Barcelonès;08019;Barcelona;1;58;A;;773;509;264;0;5;504;509
8;Barcelona;13;Barcelonès;08019;Barcelona;1;59;A;;406;236;170;0;3;233;236
8;Barcelona;13;Barcelonès;08019;Barcelona;1;6;A;;799;369;430;3;3;363;366
8;Barcelona;13;Barcelonès;08019;Barcelona;1;60;A;;414;242;172;4;0;238;238
8;Barcelona;13;Barcelonès;08019;Barcelona;1;61;A;;444;246;198;4;0;242;242
8;Barcelona;13;Barcelonès;08019;Barcelona;1;62;A;;518;318;200;1;3;314;317
8;Barcelona;13;Barcelonès;08019;Barcelona;1;63;A;;596;367;229;0;3;364;367
8;Barcelona;13;Barcelonès;08019;Barcelona;1;64;A;;427;309;118;0;2;307;309
8;Barcelona;13;Barcelonès;08019;Barcelona;1;65;A;;390;221;169;0;0;221;221
8;Barcelona;13;Barcelonès;08019;Barcelona;1;66;A;;444;270;174;3;1;266;267
8;Barcelona;13;Barcelonès;08019;Barcelona;1;67;A;;474;273;201;0;3;270;273
8;Barcelona;13;Barcelonès;08019;Barcelona;1;68;A;;796;540;256;0;1;539;540
8;Barcelona;13;Barcelonès;08019;Barcelona;1;69;A;;491;243;248;5;1;237;238
8;Barcelona;13;Barcelonès;08019;Barcelona;1;7;A;;421;216;205;5;1;210;211
8;Barcelona;13;Barcelonès;08019;Barcelona;1;7;B;;425;197;228;3;1;193;194
8;Barcelona;13;Barcelonès;08019;Barcelona;1;70;A;;449;252;197;0;3;249;252
8;Barcelona;13;Barcelonès;08019;Barcelona;1;71;A;;447;242;205;0;3;239;242
8;Barcelona;13;Barcelonès;08019;Barcelona;1;72;A;;358;176;182;1;0;175;175
8;Barcelona;13;Barcelonès;08019;Barcelona;1;73;A;;581;242;339;2;1;239;240
8;Barcelona;13;Barcelonès;08019;Barcelona;1;74;A;;369;201;168;7;0;194;194
8;Barcelona;13;Barcelonès;08019;Barcelona;1;75;A;;450;244;206;6;3;235;238
8;Barcelona;13;Barcelonès;08019;Barcelona;1;76;A;;542;303;239;6;2;295;297
8;Barcelona;13;Barcelonès;08019;Barcelona;1;77;A;;515;264;251;0;0;264;264
8;Barcelona;13;Barcelonès;08019;Barcelona;1;78;A;;501;290;211;0;5;285;290
8;Barcelona;13;Barcelonès;08019;Barcelona;1;79;A;;776;384;392;0;0;384;384
8;Barcelona;13;Barcelonès;08019;Barcelona;1;8;A;;430;188;242;0;0;188;188
8;Barcelona;13;Barcelonès;08019;Barcelona;1;8;B;;432;216;216;5;0;211;211
8;Barcelona;13;Barcelonès;08019;Barcelona;1;80;A;;338;190;148;1;1;188;189
8;Barcelona;13;Barcelonès;08019;Barcelona;1;81;A;;324;170;154;0;1;169;170
8;Barcelona;13;Barcelonès;08019;Barcelona;1;82;A;;395;214;181;7;1;206;207
8;Barcelona;13;Barcelonès;08019;Barcelona;1;83;A;;586;303;283;6;2;295;297
8;Barcelona;13;Barcelonès;08019;Barcelona;1;84;A;;670;290;380;6;1;283;284
8;Barcelona;13;Barcelonès;08019;Barcelona;1;85;A;;361;158;203;0;0;158;158
8;Barcelona;13;Barcelonès;08019;Barcelona;1;86;A;;610;294;316;3;4;287;291
8;Barcelona;13;Barcelonès;08019;Barcelona;1;87;A;;454;182;272;0;0;182;182
8;Barcelona;13;Barcelonès;08019;Barcelona;1;88;A;;756;383;373;1;1;381;382
8;Barcelona;13;Barcelonès;08019;Barcelona;1;89;A;;663;311;352;2;4;305;309
8;Barcelona;13;Barcelonès;08019;Barcelona;1;9;A;;754;374;380;10;0;364;364
8;Barcelona;13;Barcelonès;08019;Barcelona;1;90;A;;518;245;273;0;0;245;245
8;Barcelona;13;Barcelonès;08019;Barcelona;1;91;A;;620;252;368;1;1;250;251
8;Barcelona;13;Barcelonès;08019;Barcelona;1;92;A;;547;245;302;0;1;244;245
8;Barcelona;13;Barcelonès;08019;Barcelona;1;93;A;;190;87;103;0;0;87;87
8;Barcelona;13;Barcelonès;08019;Barcelona;1;94;A;;425;190;235;6;3;181;184
8;Barcelona;13;Barcelonès;08019;Barcelona;1;95;A;;374;183;191;0;1;182;183
8;Barcelona;13;Barcelonès;08019;Barcelona;1;96;A;;604;300;304;0;4;296;300
8;Barcelona;13;Barcelonès;08019;Barcelona;1;97;A;;463;207;256;7;3;197;200
8;Barcelona;13;Barcelonès;08019;Barcelona;1;97;B;;459;210;249;1;2;207;209
8;Barcelona;13;Barcelonès;08019;Barcelona;1;98;A;;397;156;241;0;0;156;156
8;Barcelona;13;Barcelonès;08019;Barcelona;1;99;A;;419;207;212;0;0;207;207
8;Barcelona;13;Barcelonès;08019;Barcelona;10;1;A;;577;350;227;5;3;342;345
8;Barcelona;13;Barcelonès;08019;Barcelona;10;1;B;;578;331;247;1;3;327;330
8;Barcelona;13;Barcelonès;08019;Barcelona;10;10;A;;462;268;194;0;2;266;268
8;Barcelona;13;Barcelonès;08019;Barcelona;10;100;A;;541;317;224;2;0;315;315
8;Barcelona;13;Barcelonès;08019;Barcelona;10;101;A;;640;342;298;0;4;338;342
8;Barcelona;13;Barcelonès;08019;Barcelona;10;101;B;;644;360;284;0;3;357;360
8;Barcelona;13;Barcelonès;08019;Barcelona;10;101;C;;633;347;286;1;0;346;346
8;Barcelona;13;Barcelonès;08019;Barcelona;10;101;D;;631;341;290;0;0;341;341
8;Barcelona;13;Barcelonès;08019;Barcelona;10;102;A;;475;294;181;0;0;294;294
8;Barcelona;13;Barcelonès;08019;Barcelona;10;102;B;;478;257;221;0;4;253;257
8;Barcelona;13;Barcelonès;08019;Barcelona;10;103;A;;686;374;312;0;5;369;374
8;Barcelona;13;Barcelonès;08019;Barcelona;10;103;B;;676;349;327;1;5;343;348
8;Barcelona;13;Barcelonès;08019;Barcelona;10;104;A;;769;445;324;0;3;442;445
8;Barcelona;13;Barcelonès;08019;Barcelona;10;105;A;;426;269;157;0;0;269;269
8;Barcelona;13;Barcelonès;08019;Barcelona;10;105;B;;423;256;167;1;0;255;255
8;Barcelona;13;Barcelonès;08019;Barcelona;10;106;A;;474;277;197;1;3;273;276
8;Barcelona;13;Barcelonès;08019;Barcelona;10;106;B;;478;310;168;0;5;305;310
8;Barcelona;13;Barcelonès;08019;Barcelona;10;107;A;;595;371;224;1;3;367;370
8;Barcelona;13;Barcelonès;08019;Barcelona;10;108;A;;598;367;231;0;2;365;367
8;Barcelona;13;Barcelonès;08019;Barcelona;10;109;A;;774;453;321;7;1;445;446
8;Barcelona;13;Barcelonès;08019;Barcelona;10;11;A;;581;368;213;1;4;363;367
8;Barcelona;13;Barcelonès;08019;Barcelona;10;110;A;;773;424;349;2;1;421;422
8;Barcelona;13;Barcelonès;08019;Barcelona;10;111;A;;428;248;180;6;2;240;242
8;Barcelona;13;Barcelonès;08019;Barcelona;10;112;A;;506;294;212;4;6;284;290
8;Barcelona;13;Barcelonès;08019;Barcelona;10;113;A;;423;232;191;0;4;228;232
8;Barcelona;13;Barcelonès;08019;Barcelona;10;114;A;;469;283;186;3;3;277;280
8;Barcelona;13;Barcelonès;08019;Barcelona;10;114;B;;460;292;168;0;1;291;292
8;Barcelona;13;Barcelonès;08019;Barcelona;10;115;A;;821;396;425;8;1;387;388
8;Barcelona;13;Barcelonès;08019;Barcelona;10;116;A;;484;317;167;1;3;313;316
8;Barcelona;13;Barcelonès;08019;Barcelona;10;116;B;;302;302;0;0;3;299;302
8;Barcelona;13;Barcelonès;08019;Barcelona;10;117;A;;742;462;280;2;2;458;460
8;Barcelona;13;Barcelonès;08019;Barcelona;10;118;A;;612;389;223;0;1;388;389
8;Barcelona;13;Barcelonès;08019;Barcelona;10;119;A;;406;271;135;5;1;265;266
8;Barcelona;13;Barcelonès;08019;Barcelona;10;12;A;;344;133;211;0;3;130;133
8;Barcelona;13;Barcelonès;08019;Barcelona;10;120;A;;679;426;253;0;2;424;426
8;Barcelona;13;Barcelonès;08019;Barcelona;10;121;A;;456;299;157;0;3;296;299
8;Barcelona;13;Barcelonès;08019;Barcelona;10;121;B;;457;303;154;0;1;302;303
8;Barcelona;13;Barcelonès;08019;Barcelona;10;122;A;;475;287;188;5;3;279;282
8;Barcelona;13;Barcelonès;08019;Barcelona;10;122;B;;481;278;203;2;2;274;276
8;Barcelona;13;Barcelonès;08019;Barcelona;10;123;A;;452;289;163;3;0;286;286
8;Barcelona;13;Barcelonès;08019;Barcelona;10;124;A;;671;406;265;2;3;401;404
8;Barcelona;13;Barcelonès;08019;Barcelona;10;125;A;;649;404;245;3;4;397;401
8;Barcelona;13;Barcelonès;08019;Barcelona;10;126;A;;574;313;261;5;4;304;308
8;Barcelona;13;Barcelonès;08019;Barcelona;10;127;A;;508;327;181;4;1;322;323
8;Barcelona;13;Barcelonès;08019;Barcelona;10;128;A;;598;356;242;0;2;354;356
8;Barcelona;13;Barcelonès;08019;Barcelona;10;129;A;;550;348;202;5;3;340;343
8;Barcelona;13;Barcelonès;08019;Barcelona;10;13;A;;617;316;301;0;4;312;316
8;Barcelona;13;Barcelonès;08019;Barcelona;10;130;A;;577;370;207;0;0;370;370
8;Barcelona;13;Barcelonès;08019;Barcelona;10;131;A;;531;313;218;0;4;309;313
8;Barcelona;13;Barcelonès;08019;Barcelona;10;132;A;;486;294;192;0;1;293;294
8;Barcelona;13;Barcelonès;08019;Barcelona;10;133;A;;557;388;169;0;3;385;388
8;Barcelona;13;Barcelonès;08019;Barcelona;10;133;B;;550;398;152;2;2;394;396
8;Barcelona;13;Barcelonès;08019;Barcelona;10;134;A;;783;492;291;9;1;482;483
8;Barcelona;13;Barcelonès;08019;Barcelona;10;135;A;;325;325;0;1;3;321;324
8;Barcelona;13;Barcelonès;08019;Barcelona;10;136;A;;479;288;191;0;1;287;288
8;Barcelona;13;Barcelonès;08019;Barcelona;10;137;A;;641;365;276;1;1;363;364
8;Barcelona;13;Barcelonès;08019;Barcelona;10;138;A;;540;357;183;0;4;353;357
8;Barcelona;13;Barcelonès;08019;Barcelona;10;138;B;;544;330;214;0;3;327;330
8;Barcelona;13;Barcelonès;08019;Barcelona;10;139;A;;770;440;330;10;7;423;430
8;Barcelona;13;Barcelonès;08019;Barcelona;10;14;A;;411;167;244;1;0;166;166
8;Barcelona;13;Barcelonès;08019;Barcelona;10;14;B;;406;168;238;0;1;167;168
8;Barcelona;13;Barcelonès;08019;Barcelona;10;140;A;;512;319;193;6;1;312;313
8;Barcelona;13;Barcelonès;08019;Barcelona;10;141;A;;743;419;324;8;4;407;411
8;Barcelona;13;Barcelonès;08019;Barcelona;10;142;A;;805;497;308;0;0;497;497
8;Barcelona;13;Barcelonès;08019;Barcelona;10;143;A;;502;256;246;1;2;253;255
8;Barcelona;13;Barcelonès;08019;Barcelona;10;144;A;;772;423;349;1;1;421;422
8;Barcelona;13;Barcelonès;08019;Barcelona;10;145;A;;503;300;203;0;5;295;300
8;Barcelona;13;Barcelonès;08019;Barcelona;10;145;B;;491;309;182;0;2;307;309
8;Barcelona;13;Barcelonès;08019;Barcelona;10;146;A;;722;431;291;0;3;428;431
8;Barcelona;13;Barcelonès;08019;Barcelona;10;147;A;;724;450;274;0;2;448;450
8;Barcelona;13;Barcelonès;08019;Barcelona;10;148;A;;393;275;118;1;0;274;274
8;Barcelona;13;Barcelonès;08019;Barcelona;10;149;A;;456;295;161;0;1;294;295
8;Barcelona;13;Barcelonès;08019;Barcelona;10;15;A;;285;161;124;0;1;160;161
8;Barcelona;13;Barcelonès;08019;Barcelona;10;150;A;;471;275;196;3;1;271;272
8;Barcelona;13;Barcelonès;08019;Barcelona;10;150;B;;464;291;173;0;0;291;291
8;Barcelona;13;Barcelonès;08019;Barcelona;10;151;A;;623;357;266;2;0;355;355
8;Barcelona;13;Barcelonès;08019;Barcelona;10;152;A;;484;293;191;2;0;291;291
8;Barcelona;13;Barcelonès;08019;Barcelona;10;153;A;;704;477;227;0;1;476;477
8;Barcelona;13;Barcelonès;08019;Barcelona;10;154;A;;552;363;189;0;2;361;363
8;Barcelona;13;Barcelonès;08019;Barcelona;10;155;A;;628;327;301;0;3;324;327
8;Barcelona;13;Barcelonès;08019;Barcelona;10;155;B;;619;350;269;0;4;346;350
8;Barcelona;13;Barcelonès;08019;Barcelona;10;156;A;;616;420;196;0;9;411;420
8;Barcelona;13;Barcelonès;08019;Barcelona;10;156;B;;624;396;228;0;3;393;396
8;Barcelona;13;Barcelonès;08019;Barcelona;10;157;A;;471;274;197;0;4;270;274
8;Barcelona;13;Barcelonès;08019;Barcelona;10;158;A;;588;303;285;0;2;301;303
8;Barcelona;13;Barcelonès;08019;Barcelona;10;159;A;;323;226;97;3;0;223;223
8;Barcelona;13;Barcelonès;08019;Barcelona;10;16;A;;404;193;211;0;0;193;193
8;Barcelona;13;Barcelonès;08019;Barcelona;10;160;A;;751;461;290;0;0;461;461
8;Barcelona;13;Barcelonès;08019;Barcelona;10;161;A;;446;277;169;0;3;274;277
8;Barcelona;13;Barcelonès;08019;Barcelona;10;162;A;;619;366;253;2;1;363;364
8;Barcelona;13;Barcelonès;08019;Barcelona;10;163;A;;557;287;270;2;1;284;285
8;Barcelona;13;Barcelonès;08019;Barcelona;10;163;B;;557;304;253;2;0;302;302
8;Barcelona;13;Barcelonès;08019;Barcelona;10;164;A;;518;267;251;0;0;267;267
8;Barcelona;13;Barcelonès;08019;Barcelona;10;164;B;;511;258;253;0;0;258;258
8;Barcelona;13;Barcelonès;08019;Barcelona;10;165;A;;454;267;187;0;1;266;267
8;Barcelona;13;Barcelonès;08019;Barcelona;10;165;B;;444;264;180;0;1;263;264
8;Barcelona;13;Barcelonès;08019;Barcelona;10;166;A;;531;290;241;3;2;285;287
8;Barcelona;13;Barcelonès;08019;Barcelona;10;167;A;;470;312;158;3;0;309;309
8;Barcelona;13;Barcelonès;08019;Barcelona;10;168;A;;529;286;243;2;0;284;284
8;Barcelona;13;Barcelonès;08019;Barcelona;10;169;A;;533;290;243;2;1;287;288
8;Barcelona;13;Barcelonès;08019;Barcelona;10;17;A;;345;180;165;0;5;175;180
8;Barcelona;13;Barcelonès;08019;Barcelona;10;170;A;;325;325;0;0;2;323;325
8;Barcelona;13;Barcelonès;08019;Barcelona;10;171;A;;617;325;292;0;0;325;325
8;Barcelona;13;Barcelonès;08019;Barcelona;10;172;A;;463;463;0;1;0;462;462
8;Barcelona;13;Barcelonès;08019;Barcelona;10;173;A;;585;369;216;0;2;367;369
8;Barcelona;13;Barcelonès;08019;Barcelona;10;173;B;;589;351;238;0;5;346;351
8;Barcelona;13;Barcelonès;08019;Barcelona;10;174;A;;620;357;263;2;0;355;355
8;Barcelona;13;Barcelonès;08019;Barcelona;10;175;A;;516;311;205;5;0;306;306
8;Barcelona;13;Barcelonès;08019;Barcelona;10;175;B;;515;310;205;2;3;305;308
8;Barcelona;13;Barcelonès;08019;Barcelona;10;176;A;;737;266;471;1;4;261;265
8;Barcelona;13;Barcelonès;08019;Barcelona;10;176;B;;750;259;491;0;1;258;259
8;Barcelona;13;Barcelonès;08019;Barcelona;10;177;A;;694;402;292;1;2;399;401
8;Barcelona;13;Barcelonès;08019;Barcelona;10;178;A;;621;328;293;0;1;327;328
8;Barcelona;13;Barcelonès;08019;Barcelona;10;179;A;;454;231;223;1;1;229;230
8;Barcelona;13;Barcelonès;08019;Barcelona;10;18;A;;442;233;209;0;0;233;233
8;Barcelona;13;Barcelonès;08019;Barcelona;10;180;A;;423;242;181;1;1;240;241
8;Barcelona;13;Barcelonès;08019;Barcelona;10;181;A;;444;225;219;0;1;224;225
8;Barcelona;13;Barcelonès;08019;Barcelona;10;181;B;;445;234;211;1;1;232;233
8;Barcelona;13;Barcelonès;08019;Barcelona;10;182;A;;649;355;294;2;1;352;353
8;Barcelona;13;Barcelonès;08019;Barcelona;10;183;A;;591;337;254;6;2;329;331
8;Barcelona;13;Barcelonès;08019;Barcelona;10;183;B;;595;342;253;0;13;329;342
8;Barcelona;13;Barcelonès;08019;Barcelona;10;184;A;;483;257;226;0;2;255;257
8;Barcelona;13;Barcelonès;08019;Barcelona;10;185;A;;711;378;333;0;1;377;378
8;Barcelona;13;Barcelonès;08019;Barcelona;10;186;A;;769;476;293;4;1;471;472
8;Barcelona;13;Barcelonès;08019;Barcelona;10;187;A;;472;290;182;1;2;287;289
8;Barcelona;13;Barcelonès;08019;Barcelona;10;187;B;;472;267;205;1;2;264;266
8;Barcelona;13;Barcelonès;08019;Barcelona;10;188;A;;448;278;170;0;3;275;278
8;Barcelona;13;Barcelonès;08019;Barcelona;10;188;B;;451;256;195;2;2;252;254
8;Barcelona;13;Barcelonès;08019;Barcelona;10;189;A;;802;454;348;5;3;446;449
8;Barcelona;13;Barcelonès;08019;Barcelona;10;19;A;;762;423;339;1;4;418;422
8;Barcelona;13;Barcelonès;08019;Barcelona;10;190;A;;504;504;0;2;6;496;502
8;Barcelona;13;Barcelonès;08019;Barcelona;10;191;A;;497;341;156;0;0;341;341
8;Barcelona;13;Barcelonès;08019;Barcelona;10;191;B;;537;312;225;1;0;311;311
8;Barcelona;13;Barcelonès;08019;Barcelona;10;192;A;;637;400;237;0;1;399;400
8;Barcelona;13;Barcelonès;08019;Barcelona;10;192;B;;639;373;266;0;7;366;373
8;Barcelona;13;Barcelonès;08019;Barcelona;10;193;A;;630;266;364;5;1;260;261
8;Barcelona;13;Barcelonès;08019;Barcelona;10;194;A;;594;313;281;4;1;308;309
8;Barcelona;13;Barcelonès;08019;Barcelona;10;194;B;;593;311;282;1;2;308;310
8;Barcelona;13;Barcelonès;08019;Barcelona;10;195;A;;585;334;251;1;0;333;333
8;Barcelona;13;Barcelonès;08019;Barcelona;10;195;B;;580;307;273;2;4;301;305
8;Barcelona;13;Barcelonès;08019;Barcelona;10;195;C;;639;313;326;0;1;312;313
8;Barcelona;13;Barcelonès;08019;Barcelona;10;196;A;;247;54;193;0;0;54;54
8;Barcelona;13;Barcelonès;08019;Barcelona;10;197;A;;609;364;245;0;3;361;364
8;Barcelona;13;Barcelonès;08019;Barcelona;10;197;B;;602;352;250;0;3;349;352
8;Barcelona;13;Barcelonès;08019;Barcelona;10;198;A;;442;244;198;0;1;243;244
8;Barcelona;13;Barcelonès;08019;Barcelona;10;198;B;;438;238;200;0;0;238;238
8;Barcelona;13;Barcelonès;08019;Barcelona;10;199;A;;610;292;318;1;2;289;291
8;Barcelona;13;Barcelonès;08019;Barcelona;10;199;B;;607;315;292;1;5;309;314
8;Barcelona;13;Barcelonès;08019;Barcelona;10;2;A;;448;253;195;0;2;251;253
8;Barcelona;13;Barcelonès;08019;Barcelona;10;2;B;;466;291;175;0;2;289;291
8;Barcelona;13;Barcelonès;08019;Barcelona;10;20;A;;751;381;370;2;0;379;379
8;Barcelona;13;Barcelonès;08019;Barcelona;10;200;A;;461;249;212;1;0;248;248
8;Barcelona;13;Barcelonès;08019;Barcelona;10;200;B;;461;240;221;0;0;240;240
8;Barcelona;13;Barcelonès;08019;Barcelona;10;201;A;;468;257;211;0;2;255;257
8;Barcelona;13;Barcelonès;08019;Barcelona;10;202;A;;750;364;386;9;1;354;355
8;Barcelona;13;Barcelonès;08019;Barcelona;10;202;B;;710;373;337;5;0;368;368
8;Barcelona;13;Barcelonès;08019;Barcelona;10;203;A;;614;326;288;0;4;322;326
8;Barcelona;13;Barcelonès;08019;Barcelona;10;204;A;;720;385;335;1;1;383;384
8;Barcelona;13;Barcelonès;08019;Barcelona;10;205;A;;568;311;257;4;1;306;307
8;Barcelona;13;Barcelonès;08019;Barcelona;10;206;A;;629;286;343;0;1;285;286
8;Barcelona;13;Barcelonès;08019;Barcelona;10;207;A;;563;275;288;0;0;275;275
8;Barcelona;13;Barcelonès;08019;Barcelona;10;207;B;;569;309;260;3;0;306;306
8;Barcelona;13;Barcelonès;08019;Barcelona;10;208;A;;634;297;337;4;0;293;293
8;Barcelona;13;Barcelonès;08019;Barcelona;10;209;A;;686;335;351;1;3;331;334
8;Barcelona;13;Barcelonès;08019;Barcelona;10;21;A;;625;346;279;0;1;345;346
8;Barcelona;13;Barcelonès;08019;Barcelona;10;210;A;;525;249;276;1;4;244;248
8;Barcelona;13;Barcelonès;08019;Barcelona;10;211;A;;462;269;193;8;1;260;261
8;Barcelona;13;Barcelonès;08019;Barcelona;10;211;B;;450;245;205;3;0;242;242
8;Barcelona;13;Barcelonès;08019;Barcelona;10;212;A;;500;227;273;0;2;225;227
8;Barcelona;13;Barcelonès;08019;Barcelona;10;212;B;;476;216;260;0;1;215;216
8;Barcelona;13;Barcelonès;08019;Barcelona;10;213;A;;494;230;264;0;3;227;230
8;Barcelona;13;Barcelonès;08019;Barcelona;10;214;A;;636;333;303;12;0;321;321
8;Barcelona;13;Barcelonès;08019;Barcelona;10;215;A;;483;262;221;1;2;259;261
8;Barcelona;13;Barcelonès;08019;Barcelona;10;215;B;;479;233;246;6;3;224;227
8;Barcelona;13;Barcelonès;08019;Barcelona;10;216;A;;751;368;383;7;4;357;361
8;Barcelona;13;Barcelonès;08019;Barcelona;10;217;A;;507;245;262;3;2;240;242
8;Barcelona;13;Barcelonès;08019;Barcelona;10;218;A;;469;229;240;1;0;228;228
8;Barcelona;13;Barcelonès;08019;Barcelona;10;218;B;;472;237;235;7;0;230;230
8;Barcelona;13;Barcelonès;08019;Barcelona;10;219;A;;421;227;194;0;0;227;227
8;Barcelona;13;Barcelonès;08019;Barcelona;10;22;A;;726;413;313;0;1;412;413
8;Barcelona;13;Barcelonès;08019;Barcelona;10;220;A;;543;305;238;0;3;302;305
8;Barcelona;13;Barcelonès;08019;Barcelona;10;220;B;;581;282;299;1;3;278;281
8;Barcelona;13;Barcelonès;08019;Barcelona;10;221;A;;225;225;0;0;3;222;225
8;Barcelona;13;Barcelonès;08019;Barcelona;10;221;B;;425;220;205;1;1;218;219
8;Barcelona;13;Barcelonès;08019;Barcelona;10;222;A;;497;249;248;1;1;247;248
8;Barcelona;13;Barcelonès;08019;Barcelona;10;222;B;;491;259;232;1;0;258;258
8;Barcelona;13;Barcelonès;08019;Barcelona;10;223;A;;767;372;395;1;1;370;371
8;Barcelona;13;Barcelonès;08019;Barcelona;10;223;B;;782;398;384;0;3;395;398
8;Barcelona;13;Barcelonès;08019;Barcelona;10;224;A;;720;387;333;2;2;383;385
8;Barcelona;13;Barcelonès;08019;Barcelona;10;224;B;;717;384;333;1;0;383;383
8;Barcelona;13;Barcelonès;08019;Barcelona;10;225;A;;489;226;263;0;4;222;226
8;Barcelona;13;Barcelonès;08019;Barcelona;10;225;B;;479;209;270;0;1;208;209
8;Barcelona;13;Barcelonès;08019;Barcelona;10;226;A;;457;244;213;0;1;243;244
8;Barcelona;13;Barcelonès;08019;Barcelona;10;226;B;;461;218;243;3;0;215;215
8;Barcelona;13;Barcelonès;08019;Barcelona;10;227;A;;441;254;187;0;1;253;254
8;Barcelona;13;Barcelonès;08019;Barcelona;10;228;A;;419;219;200;7;1;211;212
8;Barcelona;13;Barcelonès;08019;Barcelona;10;23;A;;541;300;241;7;0;293;293
8;Barcelona;13;Barcelonès;08019;Barcelona;10;24;A;;437;236;201;0;0;236;236
8;Barcelona;13;Barcelonès;08019;Barcelona;10;25;A;;428;254;174;1;1;252;253
8;Barcelona;13;Barcelonès;08019;Barcelona;10;25;B;;428;269;159;0;0;269;269
8;Barcelona;13;Barcelonès;08019;Barcelona;10;26;A;;457;249;208;0;0;249;249
8;Barcelona;13;Barcelonès;08019;Barcelona;10;27;A;;469;255;214;2;4;249;253
8;Barcelona;13;Barcelonès;08019;Barcelona;10;28;A;;569;323;246;1;2;320;322
8;Barcelona;13;Barcelonès;08019;Barcelona;10;29;A;;398;251;147;3;2;246;248
8;Barcelona;13;Barcelonès;08019;Barcelona;10;3;A;;421;262;159;0;3;259;262
8;Barcelona;13;Barcelonès;08019;Barcelona;10;30;A;;579;338;241;1;2;335;337
8;Barcelona;13;Barcelonès;08019;Barcelona;10;31;A;;741;444;297;0;3;441;444
8;Barcelona;13;Barcelonès;08019;Barcelona;10;32;A;;422;291;131;5;1;285;286
8;Barcelona;13;Barcelonès;08019;Barcelona;10;33;A;;423;257;166;0;5;252;257
8;Barcelona;13;Barcelonès;08019;Barcelona;10;34;A;;563;347;216;0;3;344;347
8;Barcelona;13;Barcelonès;08019;Barcelona;10;35;A;;571;370;201;0;3;367;370
8;Barcelona;13;Barcelonès;08019;Barcelona;10;36;A;;411;230;181;1;0;229;229
8;Barcelona;13;Barcelonès;08019;Barcelona;10;36;B;;413;262;151;0;5;257;262
8;Barcelona;13;Barcelonès;08019;Barcelona;10;37;A;;657;347;310;0;2;345;347
8;Barcelona;13;Barcelonès;08019;Barcelona;10;38;A;;657;347;310;4;2;341;343
8;Barcelona;13;Barcelonès;08019;Barcelona;10;39;A;;610;364;246;2;2;360;362
8;Barcelona;13;Barcelonès;08019;Barcelona;10;4;A;;801;438;363;5;7;426;433
8;Barcelona;13;Barcelonès;08019;Barcelona;10;40;A;;779;390;389;1;2;387;389
8;Barcelona;13;Barcelonès;08019;Barcelona;10;40;B;;779;407;372;1;1;405;406
8;Barcelona;13;Barcelonès;08019;Barcelona;10;41;A;;464;252;212;0;1;251;252
8;Barcelona;13;Barcelonès;08019;Barcelona;10;42;A;;359;197;162;0;3;194;197
8;Barcelona;13;Barcelonès;08019;Barcelona;10;43;A;;455;242;213;2;3;237;240
8;Barcelona;13;Barcelonès;08019;Barcelona;10;44;A;;465;295;170;1;1;293;294
8;Barcelona;13;Barcelonès;08019;Barcelona;10;44;B;;474;293;181;0;2;291;293
8;Barcelona;13;Barcelonès;08019;Barcelona;10;45;A;;789;413;376;6;0;407;407
8;Barcelona;13;Barcelonès;08019;Barcelona;10;46;A;;465;282;183;0;0;282;282
8;Barcelona;13;Barcelonès;08019;Barcelona;10;46;B;;484;255;229;1;2;252;254
8;Barcelona;13;Barcelonès;08019;Barcelona;10;47;A;;560;342;218;0;1;341;342
8;Barcelona;13;Barcelonès;08019;Barcelona;10;48;A;;741;499;242;3;2;494;496
8;Barcelona;13;Barcelonès;08019;Barcelona;10;49;A;;496;315;181;2;2;311;313
8;Barcelona;13;Barcelonès;08019;Barcelona;10;5;A;;555;330;225;1;2;327;329
8;Barcelona;13;Barcelonès;08019;Barcelona;10;5;B;;553;344;209;0;1;343;344
8;Barcelona;13;Barcelonès;08019;Barcelona;10;50;A;;423;231;192;1;0;230;230
8;Barcelona;13;Barcelonès;08019;Barcelona;10;50;B;;414;239;175;1;0;238;238
8;Barcelona;13;Barcelonès;08019;Barcelona;10;51;A;;656;328;328;0;2;326;328
8;Barcelona;13;Barcelonès;08019;Barcelona;10;52;A;;405;254;151;9;2;243;245
8;Barcelona;13;Barcelonès;08019;Barcelona;10;53;A;;556;309;247;1;1;307;308
8;Barcelona;13;Barcelonès;08019;Barcelona;10;54;A;;432;234;198;5;1;228;229
8;Barcelona;13;Barcelonès;08019;Barcelona;10;54;B;;439;234;205;4;1;229;230
8;Barcelona;13;Barcelonès;08019;Barcelona;10;55;A;;338;197;141;9;0;188;188
8;Barcelona;13;Barcelonès;08019;Barcelona;10;56;A;;753;471;282;0;4;467;471
8;Barcelona;13;Barcelonès;08019;Barcelona;10;57;A;;722;407;315;2;4;401;405
8;Barcelona;13;Barcelonès;08019;Barcelona;10;57;B;;744;381;363;3;2;376;378
8;Barcelona;13;Barcelonès;08019;Barcelona;10;58;A;;756;416;340;2;0;414;414
8;Barcelona;13;Barcelonès;08019;Barcelona;10;59;A;;430;430;0;0;6;424;430
8;Barcelona;13;Barcelonès;08019;Barcelona;10;59;B;;811;437;374;5;1;431;432
8;Barcelona;13;Barcelonès;08019;Barcelona;10;6;A;;320;178;142;4;1;173;174
8;Barcelona;13;Barcelonès;08019;Barcelona;10;60;A;;647;355;292;1;5;349;354
8;Barcelona;13;Barcelonès;08019;Barcelona;10;60;B;;656;383;273;3;3;377;380
8;Barcelona;13;Barcelonès;08019;Barcelona;10;60;C;;657;340;317;2;2;336;338
8;Barcelona;13;Barcelonès;08019;Barcelona;10;61;A;;301;153;148;2;0;151;151
8;Barcelona;13;Barcelonès;08019;Barcelona;10;62;A;;332;332;0;0;0;332;332
8;Barcelona;13;Barcelonès;08019;Barcelona;10;63;A;;496;235;261;0;1;234;235
8;Barcelona;13;Barcelonès;08019;Barcelona;10;64;A;;518;278;240;4;0;274;274
8;Barcelona;13;Barcelonès;08019;Barcelona;10;65;A;;628;387;241;0;3;384;387
8;Barcelona;13;Barcelonès;08019;Barcelona;10;65;B;;631;355;276;3;3;349;352
8;Barcelona;13;Barcelonès;08019;Barcelona;10;65;C;;631;387;244;0;3;384;387
8;Barcelona;13;Barcelonès;08019;Barcelona;10;65;D;;633;342;291;5;0;337;337
8;Barcelona;13;Barcelonès;08019;Barcelona;10;66;A;;469;247;222;5;1;241;242
8;Barcelona;13;Barcelonès;08019;Barcelona;10;67;A;;571;307;264;1;3;303;306
8;Barcelona;13;Barcelonès;08019;Barcelona;10;68;A;;406;219;187;0;1;218;219
8;Barcelona;13;Barcelonès;08019;Barcelona;10;68;B;;421;211;210;0;2;209;211
8;Barcelona;13;Barcelonès;08019;Barcelona;10;69;A;;606;347;259;0;1;346;347
8;Barcelona;13;Barcelonès;08019;Barcelona;10;7;A;;710;418;292;1;1;416;417
8;Barcelona;13;Barcelonès;08019;Barcelona;10;70;A;;653;319;334;2;2;315;317
8;Barcelona;13;Barcelonès;08019;Barcelona;10;71;A;;537;245;292;0;2;243;245
8;Barcelona;13;Barcelonès;08019;Barcelona;10;71;B;;538;284;254;5;2;277;279
8;Barcelona;13;Barcelonès;08019;Barcelona;10;72;A;;219;222;3;1;2;219;221
8;Barcelona;13;Barcelonès;08019;Barcelona;10;72;B;;405;218;187;0;1;217;218
8;Barcelona;13;Barcelonès;08019;Barcelona;10;73;A;;571;271;300;1;1;269;270
8;Barcelona;13;Barcelonès;08019;Barcelona;10;73;B;;568;260;308;0;0;260;260
8;Barcelona;13;Barcelonès;08019;Barcelona;10;74;A;;152;58;94;0;0;58;58
8;Barcelona;13;Barcelonès;08019;Barcelona;10;75;A;;714;329;385;1;1;327;328
8;Barcelona;13;Barcelonès;08019;Barcelona;10;76;A;;564;280;284;0;6;274;280
8;Barcelona;13;Barcelonès;08019;Barcelona;10;77;A;;564;230;334;0;3;227;230
8;Barcelona;13;Barcelonès;08019;Barcelona;10;78;A;;673;358;315;7;1;350;351
8;Barcelona;13;Barcelonès;08019;Barcelona;10;79;A;;471;255;216;0;1;254;255
8;Barcelona;13;Barcelonès;08019;Barcelona;10;79;B;;473;259;214;6;3;250;253
8;Barcelona;13;Barcelonès;08019;Barcelona;10;8;A;;692;446;246;0;3;443;446
8;Barcelona;13;Barcelonès;08019;Barcelona;10;80;A;;576;335;241;0;1;334;335
8;Barcelona;13;Barcelonès;08019;Barcelona;10;81;A;;556;250;306;0;0;250;250
8;Barcelona;13;Barcelonès;08019;Barcelona;10;82;A;;559;269;290;4;2;263;265
8;Barcelona;13;Barcelonès;08019;Barcelona;10;82;B;;566;262;304;0;1;261;262
8;Barcelona;13;Barcelonès;08019;Barcelona;10;83;A;;460;237;223;3;0;234;234
8;Barcelona;13;Barcelonès;08019;Barcelona;10;84;A;;517;249;268;0;1;248;249
8;Barcelona;13;Barcelonès;08019;Barcelona;10;85;A;;798;435;363;1;2;432;434
8;Barcelona;13;Barcelonès;08019;Barcelona;10;86;A;;596;316;280;4;1;311;312
8;Barcelona;13;Barcelonès;08019;Barcelona;10;87;A;;578;334;244;0;0;334;334
8;Barcelona;13;Barcelonès;08019;Barcelona;10;88;A;;446;226;220;2;0;224;224
8;Barcelona;13;Barcelonès;08019;Barcelona;10;88;B;;449;233;216;2;3;228;231
8;Barcelona;13;Barcelonès;08019;Barcelona;10;89;A;;429;231;198;0;1;230;231
8;Barcelona;13;Barcelonès;08019;Barcelona;10;89;B;;442;207;235;0;1;206;207
8;Barcelona;13;Barcelonès;08019;Barcelona;10;9;A;;453;263;190;0;4;259;263
8;Barcelona;13;Barcelonès;08019;Barcelona;10;9;B;;455;277;178;1;3;273;276
8;Barcelona;13;Barcelonès;08019;Barcelona;10;90;A;;665;373;292;2;5;366;371
8;Barcelona;13;Barcelonès;08019;Barcelona;10;91;A;;528;312;216;2;1;309;310
8;Barcelona;13;Barcelonès;08019;Barcelona;10;92;A;;645;320;325;0;2;318;320
8;Barcelona;13;Barcelonès;08019;Barcelona;10;93;A;;479;222;257;0;1;221;222
8;Barcelona;13;Barcelonès;08019;Barcelona;10;93;B;;468;217;251;1;1;215;216
8;Barcelona;13;Barcelonès;08019;Barcelona;10;94;A;;802;444;358;1;2;441;443
8;Barcelona;13;Barcelonès;08019;Barcelona;10;95;A;;154;64;90;0;0;64;64
8;Barcelona;13;Barcelonès;08019;Barcelona;10;96;A;;506;252;254;7;4;241;245
8;Barcelona;13;Barcelonès;08019;Barcelona;10;96;B;;508;277;231;0;3;274;277
8;Barcelona;13;Barcelonès;08019;Barcelona;10;97;A;;165;83;82;0;0;83;83
8;Barcelona;13;Barcelonès;08019;Barcelona;10;98;A;;738;346;392;0;2;344;346
8;Barcelona;13;Barcelonès;08019;Barcelona;10;98;B;;741;373;368;0;3;370;373
8;Barcelona;13;Barcelonès;08019;Barcelona;10;98;C;;743;374;369;0;3;371;374
8;Barcelona;13;Barcelonès;08019;Barcelona;10;99;A;;511;238;273;1;1;236;237
8;Barcelona;13;Barcelonès;08019;Barcelona;2;1;A;;532;341;191;0;3;338;341
8;Barcelona;13;Barcelonès;08019;Barcelona;2;10;A;;597;354;243;11;3;340;343
8;Barcelona;13;Barcelonès;08019;Barcelona;2;100;A;;587;410;177;4;0;406;406
8;Barcelona;13;Barcelonès;08019;Barcelona;2;101;A;;479;324;155;2;4;318;322
8;Barcelona;13;Barcelonès;08019;Barcelona;2;101;B;;479;297;182;1;2;294;296
8;Barcelona;13;Barcelonès;08019;Barcelona;2;102;A;;446;295;151;1;2;292;294
8;Barcelona;13;Barcelonès;08019;Barcelona;2;102;B;;459;290;169;3;3;284;287
8;Barcelona;13;Barcelonès;08019;Barcelona;2;103;A;;789;470;319;1;2;467;469
8;Barcelona;13;Barcelonès;08019;Barcelona;2;104;A;;692;400;292;1;1;398;399
8;Barcelona;13;Barcelonès;08019;Barcelona;2;105;A;;733;464;269;8;0;456;456
8;Barcelona;13;Barcelonès;08019;Barcelona;2;106;A;;782;497;285;0;6;491;497
8;Barcelona;13;Barcelonès;08019;Barcelona;2;107;A;;555;354;201;2;2;350;352
8;Barcelona;13;Barcelonès;08019;Barcelona;2;108;A;;604;420;184;0;4;416;420
8;Barcelona;13;Barcelonès;08019;Barcelona;2;109;A;;598;360;238;1;4;355;359
8;Barcelona;13;Barcelonès;08019;Barcelona;2;11;A;;449;256;193;1;0;255;255
8;Barcelona;13;Barcelonès;08019;Barcelona;2;11;B;;445;271;174;1;0;270;270
8;Barcelona;13;Barcelonès;08019;Barcelona;2;110;A;;437;245;192;2;0;243;243
8;Barcelona;13;Barcelonès;08019;Barcelona;2;111;A;;487;340;147;0;2;338;340
8;Barcelona;13;Barcelonès;08019;Barcelona;2;112;A;;455;305;150;0;3;302;305
8;Barcelona;13;Barcelonès;08019;Barcelona;2;113;A;;401;279;122;2;2;275;277
8;Barcelona;13;Barcelonès;08019;Barcelona;2;114;A;;456;316;140;2;0;314;314
8;Barcelona;13;Barcelonès;08019;Barcelona;2;115;A;;535;350;185;0;3;347;350
8;Barcelona;13;Barcelonès;08019;Barcelona;2;116;A;;443;294;149;1;0;293;293
8;Barcelona;13;Barcelonès;08019;Barcelona;2;117;A;;499;343;156;3;3;337;340
8;Barcelona;13;Barcelonès;08019;Barcelona;2;118;A;;606;416;190;3;4;409;413
8;Barcelona;13;Barcelonès;08019;Barcelona;2;119;A;;735;491;244;0;3;488;491
8;Barcelona;13;Barcelonès;08019;Barcelona;2;12;A;;783;489;294;7;2;480;482
8;Barcelona;13;Barcelonès;08019;Barcelona;2;120;A;;563;401;162;0;5;396;401
8;Barcelona;13;Barcelonès;08019;Barcelona;2;121;A;;588;401;187;2;4;395;399
8;Barcelona;13;Barcelonès;08019;Barcelona;2;122;A;;682;465;217;2;3;460;463
8;Barcelona;13;Barcelonès;08019;Barcelona;2;123;A;;524;333;191;1;2;330;332
8;Barcelona;13;Barcelonès;08019;Barcelona;2;124;A;;667;455;212;5;4;446;450
8;Barcelona;13;Barcelonès;08019;Barcelona;2;125;A;;970;547;423;1;6;540;546
8;Barcelona;13;Barcelonès;08019;Barcelona;2;126;A;;598;422;176;2;5;415;420
8;Barcelona;13;Barcelonès;08019;Barcelona;2;127;A;;419;252;167;0;3;249;252
8;Barcelona;13;Barcelonès;08019;Barcelona;2;127;B;;435;278;157;2;3;273;276
8;Barcelona;13;Barcelonès;08019;Barcelona;2;128;A;;590;387;203;1;2;384;386
8;Barcelona;13;Barcelonès;08019;Barcelona;2;128;B;;602;371;231;0;3;368;371
8;Barcelona;13;Barcelonès;08019;Barcelona;2;129;A;;474;347;127;1;4;342;346
8;Barcelona;13;Barcelonès;08019;Barcelona;2;129;B;;482;329;153;1;5;323;328
8;Barcelona;13;Barcelonès;08019;Barcelona;2;13;A;;641;427;214;3;3;421;424
8;Barcelona;13;Barcelonès;08019;Barcelona;2;13;B;;649;442;207;1;7;434;441
8;Barcelona;13;Barcelonès;08019;Barcelona;2;130;A;;423;290;133;1;1;288;289
8;Barcelona;13;Barcelonès;08019;Barcelona;2;130;B;;439;284;155;0;1;283;284
8;Barcelona;13;Barcelonès;08019;Barcelona;2;131;A;;460;271;189;1;0;270;270
8;Barcelona;13;Barcelonès;08019;Barcelona;2;131;B;;442;292;150;1;3;288;291
8;Barcelona;13;Barcelonès;08019;Barcelona;2;132;A;;574;399;175;3;4;392;396
8;Barcelona;13;Barcelonès;08019;Barcelona;2;132;B;;555;394;161;3;5;386;391
8;Barcelona;13;Barcelonès;08019;Barcelona;2;133;A;;419;274;145;1;2;271;273
8;Barcelona;13;Barcelonès;08019;Barcelona;2;133;B;;416;310;106;3;2;305;307
8;Barcelona;13;Barcelonès;08019;Barcelona;2;134;A;;688;407;281;0;1;406;407
8;Barcelona;13;Barcelonès;08019;Barcelona;2;134;B;;682;438;244;1;5;432;437
8;Barcelona;13;Barcelonès;08019;Barcelona;2;135;A;;579;324;255;6;0;318;318
8;Barcelona;13;Barcelonès;08019;Barcelona;2;135;B;;565;376;189;4;3;369;372
8;Barcelona;13;Barcelonès;08019;Barcelona;2;136;A;;455;297;158;1;2;294;296
8;Barcelona;13;Barcelonès;08019;Barcelona;2;137;A;;543;372;171;0;3;369;372
8;Barcelona;13;Barcelonès;08019;Barcelona;2;137;B;;531;388;143;0;4;384;388
8;Barcelona;13;Barcelonès;08019;Barcelona;2;138;A;;434;279;155;1;4;274;278
8;Barcelona;13;Barcelonès;08019;Barcelona;2;139;A;;498;317;181;4;1;312;313
8;Barcelona;13;Barcelonès;08019;Barcelona;2;139;B;;499;276;223;0;5;271;276
8;Barcelona;13;Barcelonès;08019;Barcelona;2;14;A;;733;417;316;0;1;416;417
8;Barcelona;13;Barcelonès;08019;Barcelona;2;140;A;;581;377;204;0;2;375;377
8;Barcelona;13;Barcelonès;08019;Barcelona;2;140;B;;580;345;235;2;3;340;343
8;Barcelona;13;Barcelonès;08019;Barcelona;2;141;A;;716;400;316;9;1;390;391
8;Barcelona;13;Barcelonès;08019;Barcelona;2;142;A;;705;420;285;6;6;408;414
8;Barcelona;13;Barcelonès;08019;Barcelona;2;143;A;;720;166;554;0;1;165;166
8;Barcelona;13;Barcelonès;08019;Barcelona;2;143;B;;719;172;547;0;1;171;172
8;Barcelona;13;Barcelonès;08019;Barcelona;2;143;C;;720;174;546;1;3;170;173
8;Barcelona;13;Barcelonès;08019;Barcelona;2;144;A;;437;280;157;0;0;280;280
8;Barcelona;13;Barcelonès;08019;Barcelona;2;144;B;;445;290;155;0;6;284;290
8;Barcelona;13;Barcelonès;08019;Barcelona;2;145;A;;607;396;211;1;0;395;395
8;Barcelona;13;Barcelonès;08019;Barcelona;2;145;B;;592;390;202;1;3;386;389
8;Barcelona;13;Barcelonès;08019;Barcelona;2;146;A;;399;274;125;0;3;271;274
8;Barcelona;13;Barcelonès;08019;Barcelona;2;147;A;;518;381;137;1;0;380;380
8;Barcelona;13;Barcelonès;08019;Barcelona;2;147;B;;504;337;167;0;4;333;337
8;Barcelona;13;Barcelonès;08019;Barcelona;2;148;A;;508;345;163;0;5;340;345
8;Barcelona;13;Barcelonès;08019;Barcelona;2;148;B;;495;352;143;2;3;347;350
8;Barcelona;13;Barcelonès;08019;Barcelona;2;149;A;;407;255;152;2;1;252;253
8;Barcelona;13;Barcelonès;08019;Barcelona;2;15;A;;537;361;176;2;1;358;359
8;Barcelona;13;Barcelonès;08019;Barcelona;2;150;A;;503;301;202;0;2;299;301
8;Barcelona;13;Barcelonès;08019;Barcelona;2;151;A;;654;415;239;1;3;411;414
8;Barcelona;13;Barcelonès;08019;Barcelona;2;152;A;;509;321;188;7;3;311;314
8;Barcelona;13;Barcelonès;08019;Barcelona;2;152;B;;511;333;178;3;2;328;330
8;Barcelona;13;Barcelonès;08019;Barcelona;2;153;A;;672;427;245;0;5;422;427
8;Barcelona;13;Barcelonès;08019;Barcelona;2;154;A;;550;352;198;1;6;345;351
8;Barcelona;13;Barcelonès;08019;Barcelona;2;154;B;;538;352;186;5;3;344;347
8;Barcelona;13;Barcelonès;08019;Barcelona;2;155;A;;528;344;184;0;2;342;344
8;Barcelona;13;Barcelonès;08019;Barcelona;2;155;B;;519;344;175;0;2;342;344
8;Barcelona;13;Barcelonès;08019;Barcelona;2;156;A;;795;525;270;3;3;519;522
8;Barcelona;13;Barcelonès;08019;Barcelona;2;157;A;;473;332;141;0;0;332;332
8;Barcelona;13;Barcelonès;08019;Barcelona;2;157;B;;479;343;136;0;4;339;343
8;Barcelona;13;Barcelonès;08019;Barcelona;2;158;A;;442;335;107;0;4;331;335
8;Barcelona;13;Barcelonès;08019;Barcelona;2;158;B;;432;311;121;2;3;306;309
8;Barcelona;13;Barcelonès;08019;Barcelona;2;159;A;;592;393;199;1;10;382;392
8;Barcelona;13;Barcelonès;08019;Barcelona;2;16;A;;617;407;210;1;2;404;406
8;Barcelona;13;Barcelonès;08019;Barcelona;2;160;A;;616;439;177;0;3;436;439
8;Barcelona;13;Barcelonès;08019;Barcelona;2;161;A;;801;577;224;0;5;572;577
8;Barcelona;13;Barcelonès;08019;Barcelona;2;162;A;;429;303;126;4;2;297;299
8;Barcelona;13;Barcelonès;08019;Barcelona;2;162;B;;430;313;117;0;1;312;313
8;Barcelona;13;Barcelonès;08019;Barcelona;2;163;A;;531;359;172;6;2;351;353
8;Barcelona;13;Barcelonès;08019;Barcelona;2;164;A;;407;292;115;0;2;290;292
8;Barcelona;13;Barcelonès;08019;Barcelona;2;165;A;;527;353;174;4;2;347;349
8;Barcelona;13;Barcelonès;08019;Barcelona;2;166;A;;334;257;77;2;1;254;255
8;Barcelona;13;Barcelonès;08019;Barcelona;2;167;A;;705;509;196;0;1;508;509
8;Barcelona;13;Barcelonès;08019;Barcelona;2;168;A;;453;309;144;3;4;302;306
8;Barcelona;13;Barcelonès;08019;Barcelona;2;168;B;;452;295;157;1;4;290;294
8;Barcelona;13;Barcelonès;08019;Barcelona;2;169;A;;576;396;180;0;1;395;396
8;Barcelona;13;Barcelonès;08019;Barcelona;2;17;A;;639;418;221;1;5;412;417
8;Barcelona;13;Barcelonès;08019;Barcelona;2;170;A;;514;368;146;2;4;362;366
8;Barcelona;13;Barcelonès;08019;Barcelona;2;170;B;;501;374;127;1;3;370;373
8;Barcelona;13;Barcelonès;08019;Barcelona;2;171;A;;705;442;263;3;7;432;439
8;Barcelona;13;Barcelonès;08019;Barcelona;2;172;A;;821;619;202;0;6;613;619
8;Barcelona;13;Barcelonès;08019;Barcelona;2;173;A;;660;474;186;1;1;472;473
8;Barcelona;13;Barcelonès;08019;Barcelona;2;174;A;;592;393;199;1;2;390;392
8;Barcelona;13;Barcelonès;08019;Barcelona;2;175;A;;699;505;194;0;8;497;505
8;Barcelona;13;Barcelonès;08019;Barcelona;2;176;A;;506;325;181;2;1;322;323
8;Barcelona;13;Barcelonès;08019;Barcelona;2;176;B;;500;304;196;0;0;304;304
8;Barcelona;13;Barcelonès;08019;Barcelona;2;177;A;;665;445;220;0;5;440;445
8;Barcelona;13;Barcelonès;08019;Barcelona;2;178;A;;727;531;196;1;2;528;530
8;Barcelona;13;Barcelonès;08019;Barcelona;2;179;A;;712;481;231;4;2;475;477
8;Barcelona;13;Barcelonès;08019;Barcelona;2;18;A;;708;462;246;1;3;458;461
8;Barcelona;13;Barcelonès;08019;Barcelona;2;18;B;;710;437;273;2;7;428;435
8;Barcelona;13;Barcelonès;08019;Barcelona;2;180;A;;478;337;141;2;0;335;335
8;Barcelona;13;Barcelonès;08019;Barcelona;2;181;A;;491;354;137;0;4;350;354
8;Barcelona;13;Barcelonès;08019;Barcelona;2;182;A;;598;401;197;6;11;384;395
8;Barcelona;13;Barcelonès;08019;Barcelona;2;183;A;;457;319;138;0;1;318;319
8;Barcelona;13;Barcelonès;08019;Barcelona;2;183;B;;469;317;152;0;5;312;317
8;Barcelona;13;Barcelonès;08019;Barcelona;2;184;A;;421;297;124;0;1;296;297
8;Barcelona;13;Barcelonès;08019;Barcelona;2;184;B;;420;279;141;0;0;279;279
8;Barcelona;13;Barcelonès;08019;Barcelona;2;185;A;;632;466;166;1;6;459;465
8;Barcelona;13;Barcelonès;08019;Barcelona;2;186;A;;524;366;158;0;3;363;366
8;Barcelona;13;Barcelonès;08019;Barcelona;2;187;A;;525;348;177;0;3;345;348
8;Barcelona;13;Barcelonès;08019;Barcelona;2;188;A;;322;237;85;0;4;233;237
8;Barcelona;13;Barcelonès;08019;Barcelona;2;189;A;;761;539;222;3;5;531;536
8;Barcelona;13;Barcelonès;08019;Barcelona;2;19;A;;550;353;197;1;2;350;352
8;Barcelona;13;Barcelonès;08019;Barcelona;2;19;B;;549;357;192;0;4;353;357
8;Barcelona;13;Barcelonès;08019;Barcelona;2;190;A;;648;496;152;0;1;495;496
8;Barcelona;13;Barcelonès;08019;Barcelona;2;191;A;;658;442;216;1;7;434;441
8;Barcelona;13;Barcelonès;08019;Barcelona;2;192;A;;475;334;141;2;0;332;332
8;Barcelona;13;Barcelonès;08019;Barcelona;2;192;B;;473;326;147;1;15;310;325
8;Barcelona;13;Barcelonès;08019;Barcelona;2;193;A;;481;352;129;0;5;347;352
8;Barcelona;13;Barcelonès;08019;Barcelona;2;194;A;;480;328;152;3;0;325;325
8;Barcelona;13;Barcelonès;08019;Barcelona;2;195;A;;525;402;123;1;0;401;401
8;Barcelona;13;Barcelonès;08019;Barcelona;2;196;A;;605;438;167;3;4;431;435
8;Barcelona;13;Barcelonès;08019;Barcelona;2;197;A;;786;534;252;0;4;530;534
8;Barcelona;13;Barcelonès;08019;Barcelona;2;198;A;;359;228;131;4;0;224;224
8;Barcelona;13;Barcelonès;08019;Barcelona;2;199;A;;400;301;99;2;2;297;299
8;Barcelona;13;Barcelonès;08019;Barcelona;2;2;A;;791;469;322;0;0;469;469
8;Barcelona;13;Barcelonès;08019;Barcelona;2;20;A;;496;304;192;0;2;302;304
8;Barcelona;13;Barcelonès;08019;Barcelona;2;20;B;;512;306;206;1;3;302;305
8;Barcelona;13;Barcelonès;08019;Barcelona;2;200;A;;316;227;89;0;1;226;227
8;Barcelona;13;Barcelonès;08019;Barcelona;2;201;A;;483;342;141;1;4;337;341
8;Barcelona;13;Barcelonès;08019;Barcelona;2;202;A;;621;444;177;1;11;432;443
8;Barcelona;13;Barcelonès;08019;Barcelona;2;203;A;;460;341;119;0;2;339;341
8;Barcelona;13;Barcelonès;08019;Barcelona;2;204;A;;356;238;118;0;2;236;238
8;Barcelona;13;Barcelonès;08019;Barcelona;2;205;A;;395;250;145;1;0;249;249
8;Barcelona;13;Barcelonès;08019;Barcelona;2;206;A;;463;318;145;0;5;313;318
8;Barcelona;13;Barcelonès;08019;Barcelona;2;207;A;;441;307;134;2;4;301;305
8;Barcelona;13;Barcelonès;08019;Barcelona;2;208;A;;371;277;94;0;3;274;277
8;Barcelona;13;Barcelonès;08019;Barcelona;2;209;A;;559;407;152;0;2;405;407
8;Barcelona;13;Barcelonès;08019;Barcelona;2;21;A;;447;296;151;6;1;289;290
8;Barcelona;13;Barcelonès;08019;Barcelona;2;210;A;;539;347;192;0;2;345;347
8;Barcelona;13;Barcelonès;08019;Barcelona;2;211;A;;745;521;224;0;2;519;521
8;Barcelona;13;Barcelonès;08019;Barcelona;2;212;A;;447;293;154;0;1;292;293
8;Barcelona;13;Barcelonès;08019;Barcelona;2;212;B;;443;276;167;0;3;273;276
8;Barcelona;13;Barcelonès;08019;Barcelona;2;213;A;;710;477;233;0;7;470;477
8;Barcelona;13;Barcelonès;08019;Barcelona;2;214;A;;414;273;141;0;2;271;273
8;Barcelona;13;Barcelonès;08019;Barcelona;2;214;B;;410;242;168;0;1;241;242
8;Barcelona;13;Barcelonès;08019;Barcelona;2;215;A;;491;324;167;0;3;321;324
8;Barcelona;13;Barcelonès;08019;Barcelona;2;215;B;;492;310;182;0;2;308;310
8;Barcelona;13;Barcelonès;08019;Barcelona;2;216;A;;580;375;205;0;6;369;375
8;Barcelona;13;Barcelonès;08019;Barcelona;2;217;A;;282;182;100;0;2;180;182
8;Barcelona;13;Barcelonès;08019;Barcelona;2;218;A;;381;269;112;2;1;266;267
8;Barcelona;13;Barcelonès;08019;Barcelona;2;219;A;;637;444;193;7;2;435;437
8;Barcelona;13;Barcelonès;08019;Barcelona;2;22;A;;377;231;146;1;0;230;230
8;Barcelona;13;Barcelonès;08019;Barcelona;2;220;A;;561;387;174;3;4;380;384
8;Barcelona;13;Barcelonès;08019;Barcelona;2;221;A;;398;279;119;3;3;273;276
8;Barcelona;13;Barcelonès;08019;Barcelona;2;222;A;;372;259;113;0;3;256;259
8;Barcelona;13;Barcelonès;08019;Barcelona;2;223;A;;563;328;235;3;1;324;325
8;Barcelona;13;Barcelonès;08019;Barcelona;2;224;A;;684;463;221;6;7;450;457
8;Barcelona;13;Barcelonès;08019;Barcelona;2;225;A;;416;303;113;0;1;302;303
8;Barcelona;13;Barcelonès;08019;Barcelona;2;226;A;;664;466;198;1;7;458;465
8;Barcelona;13;Barcelonès;08019;Barcelona;2;227;A;;517;364;153;0;1;363;364
8;Barcelona;13;Barcelonès;08019;Barcelona;2;228;A;;358;229;129;0;1;228;229
8;Barcelona;13;Barcelonès;08019;Barcelona;2;229;A;;429;303;126;0;0;303;303
8;Barcelona;13;Barcelonès;08019;Barcelona;2;23;A;;415;267;148;1;1;265;266
8;Barcelona;13;Barcelonès;08019;Barcelona;2;23;B;;408;264;144;6;4;254;258
8;Barcelona;13;Barcelonès;08019;Barcelona;2;230;A;;423;281;142;0;2;279;281
8;Barcelona;13;Barcelonès;08019;Barcelona;2;231;A;;623;459;164;0;4;455;459
8;Barcelona;13;Barcelonès;08019;Barcelona;2;232;A;;551;338;213;1;3;334;337
8;Barcelona;13;Barcelonès;08019;Barcelona;2;233;A;;797;563;234;0;4;559;563
8;Barcelona;13;Barcelonès;08019;Barcelona;2;234;A;;685;480;205;2;7;471;478
8;Barcelona;13;Barcelonès;08019;Barcelona;2;235;A;;371;279;92;0;3;276;279
8;Barcelona;13;Barcelonès;08019;Barcelona;2;236;A;;428;313;115;0;0;313;313
8;Barcelona;13;Barcelonès;08019;Barcelona;2;237;A;;728;481;247;1;2;478;480
8;Barcelona;13;Barcelonès;08019;Barcelona;2;238;A;;542;335;207;5;1;329;330
8;Barcelona;13;Barcelonès;08019;Barcelona;2;238;B;;530;357;173;5;4;348;352
8;Barcelona;13;Barcelonès;08019;Barcelona;2;239;A;;442;292;150;3;3;286;289
8;Barcelona;13;Barcelonès;08019;Barcelona;2;239;B;;442;272;170;0;4;268;272
8;Barcelona;13;Barcelonès;08019;Barcelona;2;24;A;;796;523;273;1;7;515;522
8;Barcelona;13;Barcelonès;08019;Barcelona;2;240;A;;649;405;244;2;2;401;403
8;Barcelona;13;Barcelonès;08019;Barcelona;2;240;B;;640;428;212;1;0;427;427
8;Barcelona;13;Barcelonès;08019;Barcelona;2;241;A;;657;468;189;1;3;464;467
8;Barcelona;13;Barcelonès;08019;Barcelona;2;242;A;;443;314;129;3;1;310;311
8;Barcelona;13;Barcelonès;08019;Barcelona;2;243;A;;801;476;325;2;2;472;474
8;Barcelona;13;Barcelonès;08019;Barcelona;2;244;A;;610;375;235;0;5;370;375
8;Barcelona;13;Barcelonès;08019;Barcelona;2;245;A;;538;297;241;4;1;292;293
8;Barcelona;13;Barcelonès;08019;Barcelona;2;246;A;;566;339;227;3;1;335;336
8;Barcelona;13;Barcelonès;08019;Barcelona;2;246;B;;564;306;258;1;3;302;305
8;Barcelona;13;Barcelonès;08019;Barcelona;2;247;A;;436;268;168;0;3;265;268
8;Barcelona;13;Barcelonès;08019;Barcelona;2;247;B;;442;248;194;0;5;243;248
8;Barcelona;13;Barcelonès;08019;Barcelona;2;248;A;;482;312;170;0;5;307;312
8;Barcelona;13;Barcelonès;08019;Barcelona;2;248;B;;495;335;160;1;6;328;334
8;Barcelona;13;Barcelonès;08019;Barcelona;2;249;A;;630;398;232;5;2;391;393
8;Barcelona;13;Barcelonès;08019;Barcelona;2;25;A;;594;352;242;0;4;348;352
8;Barcelona;13;Barcelonès;08019;Barcelona;2;25;B;;595;394;201;0;1;393;394
8;Barcelona;13;Barcelonès;08019;Barcelona;2;250;A;;468;288;180;0;3;285;288
8;Barcelona;13;Barcelonès;08019;Barcelona;2;251;A;;605;359;246;0;0;359;359
8;Barcelona;13;Barcelonès;08019;Barcelona;2;251;B;;591;369;222;0;3;366;369
8;Barcelona;13;Barcelonès;08019;Barcelona;2;252;A;;488;323;165;3;4;316;320
8;Barcelona;13;Barcelonès;08019;Barcelona;2;252;B;;477;303;174;4;4;295;299
8;Barcelona;13;Barcelonès;08019;Barcelona;2;253;A;;511;299;212;2;0;297;297
8;Barcelona;13;Barcelonès;08019;Barcelona;2;254;A;;597;360;237;3;1;356;357
8;Barcelona;13;Barcelonès;08019;Barcelona;2;255;A;;799;522;277;2;5;515;520
8;Barcelona;13;Barcelonès;08019;Barcelona;2;256;A;;800;500;300;0;2;498;500
8;Barcelona;13;Barcelonès;08019;Barcelona;2;257;A;;633;347;286;0;2;345;347
8;Barcelona;13;Barcelonès;08019;Barcelona;2;258;A;;578;373;205;4;1;368;369
8;Barcelona;13;Barcelonès;08019;Barcelona;2;258;B;;585;361;224;2;2;357;359
8;Barcelona;13;Barcelonès;08019;Barcelona;2;259;A;;815;525;290;4;1;520;521
8;Barcelona;13;Barcelonès;08019;Barcelona;2;26;A;;462;303;159;1;0;302;302
8;Barcelona;13;Barcelonès;08019;Barcelona;2;26;B;;444;309;135;0;0;309;309
8;Barcelona;13;Barcelonès;08019;Barcelona;2;260;A;;802;535;267;1;6;528;534
8;Barcelona;13;Barcelonès;08019;Barcelona;2;261;A;;633;389;244;0;1;388;389
8;Barcelona;13;Barcelonès;08019;Barcelona;2;262;A;;578;379;199;0;4;375;379
8;Barcelona;13;Barcelonès;08019;Barcelona;2;262;B;;561;401;160;2;9;390;399
8;Barcelona;13;Barcelonès;08019;Barcelona;2;263;A;;495;310;185;0;5;305;310
8;Barcelona;13;Barcelonès;08019;Barcelona;2;264;A;;490;287;203;0;0;287;287
8;Barcelona;13;Barcelonès;08019;Barcelona;2;264;B;;499;298;201;0;5;293;298
8;Barcelona;13;Barcelonès;08019;Barcelona;2;265;A;;421;246;175;3;1;242;243
8;Barcelona;13;Barcelonès;08019;Barcelona;2;265;B;;426;268;158;1;0;267;267
8;Barcelona;13;Barcelonès;08019;Barcelona;2;266;A;;634;351;283;0;3;348;351
8;Barcelona;13;Barcelonès;08019;Barcelona;2;267;A;;682;421;261;1;5;415;420
8;Barcelona;13;Barcelonès;08019;Barcelona;2;268;A;;717;419;298;2;2;415;417
8;Barcelona;13;Barcelonès;08019;Barcelona;2;269;A;;477;281;196;0;3;278;281
8;Barcelona;13;Barcelonès;08019;Barcelona;2;269;B;;478;272;206;0;1;271;272
8;Barcelona;13;Barcelonès;08019;Barcelona;2;27;A;;713;471;242;2;5;464;469
8;Barcelona;13;Barcelonès;08019;Barcelona;2;270;A;;412;262;150;0;0;262;262
8;Barcelona;13;Barcelonès;08019;Barcelona;2;271;A;;492;287;205;2;5;280;285
8;Barcelona;13;Barcelonès;08019;Barcelona;2;272;A;;445;216;229;3;2;211;213
8;Barcelona;13;Barcelonès;08019;Barcelona;2;272;B;;450;248;202;6;3;239;242
8;Barcelona;13;Barcelonès;08019;Barcelona;2;273;A;;462;244;218;2;0;242;242
8;Barcelona;13;Barcelonès;08019;Barcelona;2;273;B;;473;269;204;3;1;265;266
8;Barcelona;13;Barcelonès;08019;Barcelona;2;274;A;;792;406;386;0;7;399;406
8;Barcelona;13;Barcelonès;08019;Barcelona;2;275;A;;428;237;191;0;0;237;237
8;Barcelona;13;Barcelonès;08019;Barcelona;2;275;B;;428;240;188;0;0;240;240
8;Barcelona;13;Barcelonès;08019;Barcelona;2;276;A;;546;342;204;0;1;341;342
8;Barcelona;13;Barcelonès;08019;Barcelona;2;276;B;;554;351;203;3;6;342;348
8;Barcelona;13;Barcelonès;08019;Barcelona;2;277;A;;453;289;164;2;1;286;287
8;Barcelona;13;Barcelonès;08019;Barcelona;2;277;B;;445;290;155;0;4;286;290
8;Barcelona;13;Barcelonès;08019;Barcelona;2;278;A;;426;268;158;2;2;264;266
8;Barcelona;13;Barcelonès;08019;Barcelona;2;278;B;;427;264;163;2;2;260;262
8;Barcelona;13;Barcelonès;08019;Barcelona;2;279;A;;432;274;158;1;4;269;273
8;Barcelona;13;Barcelonès;08019;Barcelona;2;279;B;;441;287;154;1;0;286;286
8;Barcelona;13;Barcelonès;08019;Barcelona;2;28;A;;469;290;179;0;5;285;290
8;Barcelona;13;Barcelonès;08019;Barcelona;2;28;B;;473;304;169;0;5;299;304
8;Barcelona;13;Barcelonès;08019;Barcelona;2;280;A;;715;429;286;2;5;422;427
8;Barcelona;13;Barcelonès;08019;Barcelona;2;280;B;;706;460;246;1;12;447;459
8;Barcelona;13;Barcelonès;08019;Barcelona;2;281;A;;621;412;209;1;4;407;411
8;Barcelona;13;Barcelonès;08019;Barcelona;2;282;A;;482;273;209;0;1;272;273
8;Barcelona;13;Barcelonès;08019;Barcelona;2;283;A;;519;332;187;0;1;331;332
8;Barcelona;13;Barcelonès;08019;Barcelona;2;283;B;;520;320;200;2;3;315;318
8;Barcelona;13;Barcelonès;08019;Barcelona;2;284;A;;589;347;242;3;1;343;344
8;Barcelona;13;Barcelonès;08019;Barcelona;2;284;B;;590;334;256;3;1;330;331
8;Barcelona;13;Barcelonès;08019;Barcelona;2;285;A;;706;442;264;0;1;441;442
8;Barcelona;13;Barcelonès;08019;Barcelona;2;285;B;;699;445;254;2;8;435;443
8;Barcelona;13;Barcelonès;08019;Barcelona;2;286;A;;418;292;126;0;3;289;292
8;Barcelona;13;Barcelonès;08019;Barcelona;2;286;B;;424;288;136;5;2;281;283
8;Barcelona;13;Barcelonès;08019;Barcelona;2;287;A;;449;268;181;0;4;264;268
8;Barcelona;13;Barcelonès;08019;Barcelona;2;287;B;;454;266;188;0;5;261;266
8;Barcelona;13;Barcelonès;08019;Barcelona;2;288;A;;424;250;174;1;1;248;249
8;Barcelona;13;Barcelonès;08019;Barcelona;2;288;B;;422;245;177;8;0;237;237
8;Barcelona;13;Barcelonès;08019;Barcelona;2;289;A;;546;348;198;3;2;343;345
8;Barcelona;13;Barcelonès;08019;Barcelona;2;289;B;;550;315;235;1;1;313;314
8;Barcelona;13;Barcelonès;08019;Barcelona;2;29;A;;457;298;159;3;2;293;295
8;Barcelona;13;Barcelonès;08019;Barcelona;2;29;B;;450;313;137;1;1;311;312
8;Barcelona;13;Barcelonès;08019;Barcelona;2;290;A;;429;262;167;2;1;259;260
8;Barcelona;13;Barcelonès;08019;Barcelona;2;291;A;;407;247;160;5;3;239;242
8;Barcelona;13;Barcelonès;08019;Barcelona;2;292;A;;442;283;159;0;5;278;283
8;Barcelona;13;Barcelonès;08019;Barcelona;2;293;A;;386;263;123;0;2;261;263
8;Barcelona;13;Barcelonès;08019;Barcelona;2;294;A;;632;407;225;5;8;394;402
8;Barcelona;13;Barcelonès;08019;Barcelona;2;295;A;;426;279;147;5;3;271;274
8;Barcelona;13;Barcelonès;08019;Barcelona;2;295;B;;431;297;134;6;2;289;291
8;Barcelona;13;Barcelonès;08019;Barcelona;2;296;A;;483;330;153;0;2;328;330
8;Barcelona;13;Barcelonès;08019;Barcelona;2;296;B;;474;299;175;5;2;292;294
8;Barcelona;13;Barcelonès;08019;Barcelona;2;297;A;;438;244;194;0;0;244;244
8;Barcelona;13;Barcelonès;08019;Barcelona;2;297;B;;448;278;170;0;2;276;278
8;Barcelona;13;Barcelonès;08019;Barcelona;2;298;A;;455;248;207;0;1;247;248
8;Barcelona;13;Barcelonès;08019;Barcelona;2;298;B;;455;242;213;9;1;232;233
8;Barcelona;13;Barcelonès;08019;Barcelona;2;299;A;;346;228;118;1;0;227;227
8;Barcelona;13;Barcelonès;08019;Barcelona;2;3;A;;701;404;297;3;1;400;401
8;Barcelona;13;Barcelonès;08019;Barcelona;2;30;A;;660;407;253;0;2;405;407
8;Barcelona;13;Barcelonès;08019;Barcelona;2;30;B;;642;383;259;0;0;383;383
8;Barcelona;13;Barcelonès;08019;Barcelona;2;300;A;;671;421;250;3;2;416;418
8;Barcelona;13;Barcelonès;08019;Barcelona;2;301;A;;768;525;243;2;1;522;523
8;Barcelona;13;Barcelonès;08019;Barcelona;2;301;B;;769;499;270;2;2;495;497
8;Barcelona;13;Barcelonès;08019;Barcelona;2;302;A;;500;337;163;2;1;334;335
8;Barcelona;13;Barcelonès;08019;Barcelona;2;302;B;;513;341;172;1;2;338;340
8;Barcelona;13;Barcelonès;08019;Barcelona;2;303;A;;564;392;172;1;3;388;391
8;Barcelona;13;Barcelonès;08019;Barcelona;2;303;B;;573;414;159;0;3;411;414
8;Barcelona;13;Barcelonès;08019;Barcelona;2;304;A;;563;340;223;1;4;335;339
8;Barcelona;13;Barcelonès;08019;Barcelona;2;304;B;;570;372;198;6;1;365;366
8;Barcelona;13;Barcelonès;08019;Barcelona;2;305;A;;562;359;203;2;5;352;357
8;Barcelona;13;Barcelonès;08019;Barcelona;2;305;B;;557;352;205;0;8;344;352
8;Barcelona;13;Barcelonès;08019;Barcelona;2;306;A;;498;324;174;1;1;322;323
8;Barcelona;13;Barcelonès;08019;Barcelona;2;306;B;;488;333;155;0;7;326;333
8;Barcelona;13;Barcelonès;08019;Barcelona;2;307;A;;609;405;204;1;1;403;404
8;Barcelona;13;Barcelonès;08019;Barcelona;2;307;B;;607;399;208;2;2;395;397
8;Barcelona;13;Barcelonès;08019;Barcelona;2;308;A;;515;329;186;2;2;325;327
8;Barcelona;13;Barcelonès;08019;Barcelona;2;308;B;;520;344;176;0;3;341;344
8;Barcelona;13;Barcelonès;08019;Barcelona;2;309;A;;548;343;205;0;1;342;343
8;Barcelona;13;Barcelonès;08019;Barcelona;2;31;A;;500;321;179;1;5;315;320
8;Barcelona;13;Barcelonès;08019;Barcelona;2;31;B;;496;321;175;0;3;318;321
8;Barcelona;13;Barcelonès;08019;Barcelona;2;310;A;;535;314;221;0;1;313;314
8;Barcelona;13;Barcelonès;08019;Barcelona;2;311;A;;547;314;233;0;2;312;314
8;Barcelona;13;Barcelonès;08019;Barcelona;2;311;B;;546;326;220;0;4;322;326
8;Barcelona;13;Barcelonès;08019;Barcelona;2;312;A;;589;380;209;2;3;375;378
8;Barcelona;13;Barcelonès;08019;Barcelona;2;313;A;;501;287;214;2;1;284;285
8;Barcelona;13;Barcelonès;08019;Barcelona;2;314;A;;667;427;240;1;10;416;426
8;Barcelona;13;Barcelonès;08019;Barcelona;2;315;A;;447;245;202;0;5;240;245
8;Barcelona;13;Barcelonès;08019;Barcelona;2;315;B;;451;263;188;0;1;262;263
8;Barcelona;13;Barcelonès;08019;Barcelona;2;316;A;;356;206;150;2;3;201;204
8;Barcelona;13;Barcelonès;08019;Barcelona;2;317;A;;534;323;211;1;3;319;322
8;Barcelona;13;Barcelonès;08019;Barcelona;2;317;B;;509;291;218;0;0;291;291
8;Barcelona;13;Barcelonès;08019;Barcelona;2;32;A;;437;284;153;2;1;281;282
8;Barcelona;13;Barcelonès;08019;Barcelona;2;32;B;;435;300;135;3;6;291;297
8;Barcelona;13;Barcelonès;08019;Barcelona;2;33;A;;431;298;133;0;2;296;298
8;Barcelona;13;Barcelonès;08019;Barcelona;2;33;B;;425;287;138;0;1;286;287
8;Barcelona;13;Barcelonès;08019;Barcelona;2;34;A;;520;354;166;0;1;353;354
8;Barcelona;13;Barcelonès;08019;Barcelona;2;34;B;;507;344;163;1;2;341;343
8;Barcelona;13;Barcelonès;08019;Barcelona;2;35;A;;404;251;153;0;2;249;251
8;Barcelona;13;Barcelonès;08019;Barcelona;2;35;B;;403;271;132;1;3;267;270
8;Barcelona;13;Barcelonès;08019;Barcelona;2;36;A;;459;309;150;2;1;306;307
8;Barcelona;13;Barcelonès;08019;Barcelona;2;36;B;;459;308;151;1;3;304;307
8;Barcelona;13;Barcelonès;08019;Barcelona;2;37;A;;480;290;190;5;1;284;285
8;Barcelona;13;Barcelonès;08019;Barcelona;2;38;A;;534;337;197;0;3;334;337
8;Barcelona;13;Barcelonès;08019;Barcelona;2;39;A;;788;479;309;0;5;474;479
8;Barcelona;13;Barcelonès;08019;Barcelona;2;4;A;;701;399;302;1;4;394;398
8;Barcelona;13;Barcelonès;08019;Barcelona;2;40;A;;796;504;292;2;3;499;502
8;Barcelona;13;Barcelonès;08019;Barcelona;2;41;A;;443;281;162;1;1;279;280
8;Barcelona;13;Barcelonès;08019;Barcelona;2;41;B;;449;308;141;0;2;306;308
8;Barcelona;13;Barcelonès;08019;Barcelona;2;42;A;;728;435;293;1;1;433;434
8;Barcelona;13;Barcelonès;08019;Barcelona;2;43;A;;554;363;191;5;2;356;358
8;Barcelona;13;Barcelonès;08019;Barcelona;2;44;A;;424;252;172;3;2;247;249
8;Barcelona;13;Barcelonès;08019;Barcelona;2;45;A;;749;455;294;0;8;447;455
8;Barcelona;13;Barcelonès;08019;Barcelona;2;46;A;;353;243;110;2;1;240;241
8;Barcelona;13;Barcelonès;08019;Barcelona;2;47;A;;580;365;215;2;0;363;363
8;Barcelona;13;Barcelonès;08019;Barcelona;2;48;A;;534;342;192;2;2;338;340
8;Barcelona;13;Barcelonès;08019;Barcelona;2;49;A;;663;424;239;0;2;422;424
8;Barcelona;13;Barcelonès;08019;Barcelona;2;5;A;;687;433;254;4;5;424;429
8;Barcelona;13;Barcelonès;08019;Barcelona;2;50;A;;504;318;186;1;2;315;317
8;Barcelona;13;Barcelonès;08019;Barcelona;2;51;A;;581;374;207;0;7;367;374
8;Barcelona;13;Barcelonès;08019;Barcelona;2;52;A;;738;498;240;4;6;488;494
8;Barcelona;13;Barcelonès;08019;Barcelona;2;53;A;;740;467;273;3;7;457;464
8;Barcelona;13;Barcelonès;08019;Barcelona;2;54;A;;408;289;119;0;3;286;289
8;Barcelona;13;Barcelonès;08019;Barcelona;2;54;B;;417;268;149;0;3;265;268
8;Barcelona;13;Barcelonès;08019;Barcelona;2;55;A;;576;368;208;6;3;359;362
8;Barcelona;13;Barcelonès;08019;Barcelona;2;56;A;;657;439;218;8;3;428;431
8;Barcelona;13;Barcelonès;08019;Barcelona;2;57;A;;738;513;225;4;2;507;509
8;Barcelona;13;Barcelonès;08019;Barcelona;2;58;A;;685;460;225;5;4;451;455
8;Barcelona;13;Barcelonès;08019;Barcelona;2;59;A;;742;475;267;8;5;462;467
8;Barcelona;13;Barcelonès;08019;Barcelona;2;6;A;;684;395;289;0;3;392;395
8;Barcelona;13;Barcelonès;08019;Barcelona;2;60;A;;447;303;144;0;5;298;303
8;Barcelona;13;Barcelonès;08019;Barcelona;2;60;B;;459;281;178;0;5;276;281
8;Barcelona;13;Barcelonès;08019;Barcelona;2;61;A;;456;321;135;2;3;316;319
8;Barcelona;13;Barcelonès;08019;Barcelona;2;61;B;;457;327;130;0;4;323;327
8;Barcelona;13;Barcelonès;08019;Barcelona;2;62;A;;426;292;134;1;0;291;291
8;Barcelona;13;Barcelonès;08019;Barcelona;2;62;B;;418;256;162;2;1;253;254
8;Barcelona;13;Barcelonès;08019;Barcelona;2;63;A;;668;425;243;5;4;416;420
8;Barcelona;13;Barcelonès;08019;Barcelona;2;64;A;;401;254;147;0;0;254;254
8;Barcelona;13;Barcelonès;08019;Barcelona;2;65;A;;473;327;146;4;0;323;323
8;Barcelona;13;Barcelonès;08019;Barcelona;2;65;B;;469;310;159;1;1;308;309
8;Barcelona;13;Barcelonès;08019;Barcelona;2;66;A;;489;350;139;0;4;346;350
8;Barcelona;13;Barcelonès;08019;Barcelona;2;66;B;;492;309;183;1;2;306;308
8;Barcelona;13;Barcelonès;08019;Barcelona;2;67;A;;451;323;128;6;2;315;317
8;Barcelona;13;Barcelonès;08019;Barcelona;2;67;B;;468;320;148;9;3;308;311
8;Barcelona;13;Barcelonès;08019;Barcelona;2;68;A;;597;381;216;1;2;378;380
8;Barcelona;13;Barcelonès;08019;Barcelona;2;69;A;;340;214;126;1;1;212;213
8;Barcelona;13;Barcelonès;08019;Barcelona;2;7;A;;761;430;331;4;0;426;426
8;Barcelona;13;Barcelonès;08019;Barcelona;2;70;A;;762;453;309;2;5;446;451
8;Barcelona;13;Barcelonès;08019;Barcelona;2;71;A;;458;280;178;0;1;279;280
8;Barcelona;13;Barcelonès;08019;Barcelona;2;71;B;;460;294;166;0;3;291;294
8;Barcelona;13;Barcelonès;08019;Barcelona;2;72;A;;427;271;156;0;1;270;271
8;Barcelona;13;Barcelonès;08019;Barcelona;2;72;B;;422;278;144;3;1;274;275
8;Barcelona;13;Barcelonès;08019;Barcelona;2;73;A;;521;337;184;3;2;332;334
8;Barcelona;13;Barcelonès;08019;Barcelona;2;73;B;;516;342;174;0;2;340;342
8;Barcelona;13;Barcelonès;08019;Barcelona;2;74;A;;450;289;161;0;2;287;289
8;Barcelona;13;Barcelonès;08019;Barcelona;2;74;B;;450;288;162;0;0;288;288
8;Barcelona;13;Barcelonès;08019;Barcelona;2;75;A;;407;261;146;0;1;260;261
8;Barcelona;13;Barcelonès;08019;Barcelona;2;75;B;;408;292;116;0;2;290;292
8;Barcelona;13;Barcelonès;08019;Barcelona;2;76;A;;440;299;141;0;4;295;299
8;Barcelona;13;Barcelonès;08019;Barcelona;2;77;A;;444;292;152;2;2;288;290
8;Barcelona;13;Barcelonès;08019;Barcelona;2;77;B;;439;283;156;0;1;282;283
8;Barcelona;13;Barcelonès;08019;Barcelona;2;78;A;;754;468;286;3;1;464;465
8;Barcelona;13;Barcelonès;08019;Barcelona;2;79;A;;504;324;180;0;3;321;324
8;Barcelona;13;Barcelonès;08019;Barcelona;2;79;B;;514;340;174;0;0;340;340
8;Barcelona;13;Barcelonès;08019;Barcelona;2;8;A;;417;244;173;1;1;242;243
8;Barcelona;13;Barcelonès;08019;Barcelona;2;8;B;;424;237;187;2;0;235;235
8;Barcelona;13;Barcelonès;08019;Barcelona;2;80;A;;497;325;172;0;1;324;325
8;Barcelona;13;Barcelonès;08019;Barcelona;2;80;B;;493;332;161;1;1;330;331
8;Barcelona;13;Barcelonès;08019;Barcelona;2;81;A;;550;316;234;1;4;311;315
8;Barcelona;13;Barcelonès;08019;Barcelona;2;81;B;;541;300;241;2;0;298;298
8;Barcelona;13;Barcelonès;08019;Barcelona;2;82;A;;483;285;198;1;2;282;284
8;Barcelona;13;Barcelonès;08019;Barcelona;2;82;B;;488;290;198;0;2;288;290
8;Barcelona;13;Barcelonès;08019;Barcelona;2;83;A;;663;423;240;3;7;413;420
8;Barcelona;13;Barcelonès;08019;Barcelona;2;84;A;;682;441;241;4;8;429;437
8;Barcelona;13;Barcelonès;08019;Barcelona;2;84;B;;659;432;227;2;2;428;430
8;Barcelona;13;Barcelonès;08019;Barcelona;2;85;A;;807;519;288;1;3;515;518
8;Barcelona;13;Barcelonès;08019;Barcelona;2;86;A;;583;370;213;0;8;362;370
8;Barcelona;13;Barcelonès;08019;Barcelona;2;86;B;;584;342;242;0;3;339;342
8;Barcelona;13;Barcelonès;08019;Barcelona;2;87;A;;750;475;275;1;1;473;474
8;Barcelona;13;Barcelonès;08019;Barcelona;2;88;A;;503;304;199;2;2;300;302
8;Barcelona;13;Barcelonès;08019;Barcelona;2;89;A;;578;376;202;0;2;374;376
8;Barcelona;13;Barcelonès;08019;Barcelona;2;89;B;;586;376;210;1;0;375;375
8;Barcelona;13;Barcelonès;08019;Barcelona;2;9;A;;428;268;160;0;3;265;268
8;Barcelona;13;Barcelonès;08019;Barcelona;2;9;B;;429;290;139;3;2;285;287
8;Barcelona;13;Barcelonès;08019;Barcelona;2;90;A;;563;377;186;0;4;373;377
8;Barcelona;13;Barcelonès;08019;Barcelona;2;90;B;;562;362;200;0;0;362;362
8;Barcelona;13;Barcelonès;08019;Barcelona;2;91;A;;559;365;194;1;5;359;364
8;Barcelona;13;Barcelonès;08019;Barcelona;2;92;A;;571;362;209;2;4;356;360
8;Barcelona;13;Barcelonès;08019;Barcelona;2;92;B;;566;374;192;1;2;371;373
8;Barcelona;13;Barcelonès;08019;Barcelona;2;93;A;;715;463;252;0;1;462;463
8;Barcelona;13;Barcelonès;08019;Barcelona;2;94;A;;571;360;211;1;2;357;359
8;Barcelona;13;Barcelonès;08019;Barcelona;2;94;B;;566;344;222;0;3;341;344
8;Barcelona;13;Barcelonès;08019;Barcelona;2;95;A;;582;401;181;0;3;398;401
8;Barcelona;13;Barcelonès;08019;Barcelona;2;95;B;;592;423;169;1;9;413;422
8;Barcelona;13;Barcelonès;08019;Barcelona;2;96;A;;541;372;169;0;9;363;372
8;Barcelona;13;Barcelonès;08019;Barcelona;2;97;A;;505;330;175;0;3;327;330
8;Barcelona;13;Barcelonès;08019;Barcelona;2;97;B;;499;353;146;1;1;351;352
8;Barcelona;13;Barcelonès;08019;Barcelona;2;98;A;;725;483;242;2;4;477;481
8;Barcelona;13;Barcelonès;08019;Barcelona;2;99;A;;630;403;227;3;3;397;400
8;Barcelona;13;Barcelonès;08019;Barcelona;3;1;A;;736;448;288;0;4;444;448
8;Barcelona;13;Barcelonès;08019;Barcelona;3;10;A;;674;378;296;4;3;371;374
8;Barcelona;13;Barcelonès;08019;Barcelona;3;100;A;;576;358;218;1;5;352;357
8;Barcelona;13;Barcelonès;08019;Barcelona;3;100;B;;565;360;205;1;2;357;359
8;Barcelona;13;Barcelonès;08019;Barcelona;3;101;A;;533;322;211;1;0;321;321
8;Barcelona;13;Barcelonès;08019;Barcelona;3;101;B;;531;353;178;1;1;351;352
8;Barcelona;13;Barcelonès;08019;Barcelona;3;102;A;;761;457;304;2;0;455;455
8;Barcelona;13;Barcelonès;08019;Barcelona;3;103;A;;752;416;336;4;1;411;412
8;Barcelona;13;Barcelonès;08019;Barcelona;3;104;A;;519;322;197;1;2;319;321
8;Barcelona;13;Barcelonès;08019;Barcelona;3;105;A;;412;237;175;0;0;237;237
8;Barcelona;13;Barcelonès;08019;Barcelona;3;106;A;;650;425;225;1;1;423;424
8;Barcelona;13;Barcelonès;08019;Barcelona;3;107;A;;577;351;226;5;4;342;346
8;Barcelona;13;Barcelonès;08019;Barcelona;3;108;A;;456;236;220;1;3;232;235
8;Barcelona;13;Barcelonès;08019;Barcelona;3;109;A;;737;343;394;1;3;339;342
8;Barcelona;13;Barcelonès;08019;Barcelona;3;109;B;;728;376;352;1;3;372;375
8;Barcelona;13;Barcelonès;08019;Barcelona;3;11;A;;430;212;218;0;0;212;212
8;Barcelona;13;Barcelonès;08019;Barcelona;3;110;A;;707;380;327;1;4;375;379
8;Barcelona;13;Barcelonès;08019;Barcelona;3;110;B;;707;386;321;0;2;384;386
8;Barcelona;13;Barcelonès;08019;Barcelona;3;111;A;;715;372;343;1;4;367;371
8;Barcelona;13;Barcelonès;08019;Barcelona;3;111;B;;715;365;350;1;0;364;364
8;Barcelona;13;Barcelonès;08019;Barcelona;3;112;A;;524;270;254;0;0;270;270
8;Barcelona;13;Barcelonès;08019;Barcelona;3;113;A;;603;363;240;3;1;359;360
8;Barcelona;13;Barcelonès;08019;Barcelona;3;114;A;;558;320;238;0;2;318;320
8;Barcelona;13;Barcelonès;08019;Barcelona;3;115;A;;652;369;283;1;5;363;368
8;Barcelona;13;Barcelonès;08019;Barcelona;3;116;A;;497;310;187;0;2;308;310
8;Barcelona;13;Barcelonès;08019;Barcelona;3;117;A;;647;420;227;0;7;413;420
8;Barcelona;13;Barcelonès;08019;Barcelona;3;118;A;;435;274;161;0;1;273;274
8;Barcelona;13;Barcelonès;08019;Barcelona;3;118;B;;441;294;147;0;4;290;294
8;Barcelona;13;Barcelonès;08019;Barcelona;3;119;A;;556;328;228;0;0;328;328
8;Barcelona;13;Barcelonès;08019;Barcelona;3;12;A;;775;443;332;1;4;438;442
8;Barcelona;13;Barcelonès;08019;Barcelona;3;120;A;;749;462;287;14;0;448;448
8;Barcelona;13;Barcelonès;08019;Barcelona;3;121;A;;560;356;204;6;2;348;350
8;Barcelona;13;Barcelonès;08019;Barcelona;3;122;A;;648;438;210;0;2;436;438
8;Barcelona;13;Barcelonès;08019;Barcelona;3;123;A;;438;314;124;0;2;312;314
8;Barcelona;13;Barcelonès;08019;Barcelona;3;124;A;;781;501;280;3;0;498;498
8;Barcelona;13;Barcelonès;08019;Barcelona;3;125;A;;466;286;180;3;0;283;283
8;Barcelona;13;Barcelonès;08019;Barcelona;3;126;A;;389;225;164;2;1;222;223
8;Barcelona;13;Barcelonès;08019;Barcelona;3;127;A;;770;492;278;4;3;485;488
8;Barcelona;13;Barcelonès;08019;Barcelona;3;128;A;;604;354;250;0;3;351;354
8;Barcelona;13;Barcelonès;08019;Barcelona;3;129;A;;593;356;237;1;0;355;355
8;Barcelona;13;Barcelonès;08019;Barcelona;3;13;A;;401;193;208;1;0;192;192
8;Barcelona;13;Barcelonès;08019;Barcelona;3;130;A;;655;394;261;0;4;390;394
8;Barcelona;13;Barcelonès;08019;Barcelona;3;131;A;;268;174;94;0;1;173;174
8;Barcelona;13;Barcelonès;08019;Barcelona;3;132;A;;670;426;244;3;1;422;423
8;Barcelona;13;Barcelonès;08019;Barcelona;3;133;A;;574;370;204;0;4;366;370
8;Barcelona;13;Barcelonès;08019;Barcelona;3;134;A;;615;392;223;0;3;389;392
8;Barcelona;13;Barcelonès;08019;Barcelona;3;134;B;;598;377;221;0;0;377;377
8;Barcelona;13;Barcelonès;08019;Barcelona;3;134;C;;610;348;262;0;4;344;348
8;Barcelona;13;Barcelonès;08019;Barcelona;3;135;A;;456;235;221;1;1;233;234
8;Barcelona;13;Barcelonès;08019;Barcelona;3;136;A;;514;316;198;2;2;312;314
8;Barcelona;13;Barcelonès;08019;Barcelona;3;137;A;;524;324;200;0;0;324;324
8;Barcelona;13;Barcelonès;08019;Barcelona;3;137;B;;541;350;191;0;3;347;350
8;Barcelona;13;Barcelonès;08019;Barcelona;3;138;A;;438;278;160;1;0;277;277
8;Barcelona;13;Barcelonès;08019;Barcelona;3;138;B;;442;304;138;0;4;300;304
8;Barcelona;13;Barcelonès;08019;Barcelona;3;139;A;;626;412;214;1;3;408;411
8;Barcelona;13;Barcelonès;08019;Barcelona;3;14;A;;425;227;198;0;1;226;227
8;Barcelona;13;Barcelonès;08019;Barcelona;3;14;B;;427;225;202;0;0;225;225
8;Barcelona;13;Barcelonès;08019;Barcelona;3;140;A;;588;355;233;1;2;352;354
8;Barcelona;13;Barcelonès;08019;Barcelona;3;141;A;;749;467;282;6;4;457;461
8;Barcelona;13;Barcelonès;08019;Barcelona;3;142;A;;427;279;148;1;3;275;278
8;Barcelona;13;Barcelonès;08019;Barcelona;3;142;B;;427;266;161;2;2;262;264
8;Barcelona;13;Barcelonès;08019;Barcelona;3;143;A;;635;370;265;2;2;366;368
8;Barcelona;13;Barcelonès;08019;Barcelona;3;144;A;;531;347;184;3;3;341;344
8;Barcelona;13;Barcelonès;08019;Barcelona;3;145;A;;432;287;145;2;1;284;285
8;Barcelona;13;Barcelonès;08019;Barcelona;3;146;A;;707;457;250;4;4;449;453
8;Barcelona;13;Barcelonès;08019;Barcelona;3;147;A;;637;428;209;0;3;425;428
8;Barcelona;13;Barcelonès;08019;Barcelona;3;147;B;;626;419;207;0;2;417;419
8;Barcelona;13;Barcelonès;08019;Barcelona;3;148;A;;736;437;299;0;1;436;437
8;Barcelona;13;Barcelonès;08019;Barcelona;3;148;B;;717;466;251;4;4;458;462
8;Barcelona;13;Barcelonès;08019;Barcelona;3;149;A;;490;287;203;2;2;283;285
8;Barcelona;13;Barcelonès;08019;Barcelona;3;149;B;;467;269;198;0;3;266;269
8;Barcelona;13;Barcelonès;08019;Barcelona;3;15;A;;665;395;270;2;3;390;393
8;Barcelona;13;Barcelonès;08019;Barcelona;3;150;A;;399;237;162;5;0;232;232
8;Barcelona;13;Barcelonès;08019;Barcelona;3;150;B;;412;257;155;4;0;253;253
8;Barcelona;13;Barcelonès;08019;Barcelona;3;151;A;;464;284;180;1;2;281;283
8;Barcelona;13;Barcelonès;08019;Barcelona;3;151;B;;464;291;173;1;1;289;290
8;Barcelona;13;Barcelonès;08019;Barcelona;3;152;A;;662;510;152;4;1;505;506
8;Barcelona;13;Barcelonès;08019;Barcelona;3;153;A;;463;280;183;1;0;279;279
8;Barcelona;13;Barcelonès;08019;Barcelona;3;153;B;;464;262;202;3;1;258;259
8;Barcelona;13;Barcelonès;08019;Barcelona;3;154;A;;509;329;180;1;1;327;328
8;Barcelona;13;Barcelonès;08019;Barcelona;3;155;A;;451;260;191;0;1;259;260
8;Barcelona;13;Barcelonès;08019;Barcelona;3;156;A;;563;382;181;0;1;381;382
8;Barcelona;13;Barcelonès;08019;Barcelona;3;157;A;;502;294;208;0;3;291;294
8;Barcelona;13;Barcelonès;08019;Barcelona;3;158;A;;452;318;134;1;1;316;317
8;Barcelona;13;Barcelonès;08019;Barcelona;3;159;A;;400;257;143;0;2;255;257
8;Barcelona;13;Barcelonès;08019;Barcelona;3;159;B;;413;249;164;2;2;245;247
8;Barcelona;13;Barcelonès;08019;Barcelona;3;16;A;;713;395;318;0;0;395;395
8;Barcelona;13;Barcelonès;08019;Barcelona;3;160;A;;494;316;178;1;0;315;315
8;Barcelona;13;Barcelonès;08019;Barcelona;3;161;A;;520;339;181;2;2;335;337
8;Barcelona;13;Barcelonès;08019;Barcelona;3;162;A;;432;247;185;1;2;244;246
8;Barcelona;13;Barcelonès;08019;Barcelona;3;163;A;;546;359;187;1;1;357;358
8;Barcelona;13;Barcelonès;08019;Barcelona;3;164;A;;693;455;238;1;4;450;454
8;Barcelona;13;Barcelonès;08019;Barcelona;3;165;A;;693;426;267;0;2;424;426
8;Barcelona;13;Barcelonès;08019;Barcelona;3;166;A;;349;218;131;0;1;217;218
8;Barcelona;13;Barcelonès;08019;Barcelona;3;167;A;;456;286;170;0;4;282;286
8;Barcelona;13;Barcelonès;08019;Barcelona;3;168;A;;781;471;310;7;1;463;464
8;Barcelona;13;Barcelonès;08019;Barcelona;3;168;B;;775;455;320;1;1;453;454
8;Barcelona;13;Barcelonès;08019;Barcelona;3;169;A;;557;328;229;1;6;321;327
8;Barcelona;13;Barcelonès;08019;Barcelona;3;169;B;;565;328;237;0;2;326;328
8;Barcelona;13;Barcelonès;08019;Barcelona;3;17;A;;765;399;366;5;4;390;394
8;Barcelona;13;Barcelonès;08019;Barcelona;3;170;A;;427;223;204;2;1;220;221
8;Barcelona;13;Barcelonès;08019;Barcelona;3;170;B;;425;230;195;0;2;228;230
8;Barcelona;13;Barcelonès;08019;Barcelona;3;171;A;;468;221;247;2;0;219;219
8;Barcelona;13;Barcelonès;08019;Barcelona;3;172;A;;815;511;304;0;2;509;511
8;Barcelona;13;Barcelonès;08019;Barcelona;3;173;A;;452;299;153;0;1;298;299
8;Barcelona;13;Barcelonès;08019;Barcelona;3;174;A;;519;287;232;2;0;285;285
8;Barcelona;13;Barcelonès;08019;Barcelona;3;175;A;;526;300;226;0;2;298;300
8;Barcelona;13;Barcelonès;08019;Barcelona;3;176;A;;628;395;233;0;5;390;395
8;Barcelona;13;Barcelonès;08019;Barcelona;3;177;A;;657;344;313;4;2;338;340
8;Barcelona;13;Barcelonès;08019;Barcelona;3;178;A;;746;454;292;0;5;449;454
8;Barcelona;13;Barcelonès;08019;Barcelona;3;179;A;;783;446;337;2;2;442;444
8;Barcelona;13;Barcelonès;08019;Barcelona;3;18;A;;683;364;319;11;1;352;353
8;Barcelona;13;Barcelonès;08019;Barcelona;3;180;A;;431;238;193;0;0;238;238
8;Barcelona;13;Barcelonès;08019;Barcelona;3;180;B;;427;249;178;4;0;245;245
8;Barcelona;13;Barcelonès;08019;Barcelona;3;181;A;;332;202;130;0;1;201;202
8;Barcelona;13;Barcelonès;08019;Barcelona;3;182;A;;631;368;263;2;3;363;366
8;Barcelona;13;Barcelonès;08019;Barcelona;3;183;A;;431;238;193;2;2;234;236
8;Barcelona;13;Barcelonès;08019;Barcelona;3;183;B;;444;248;196;2;0;246;246
8;Barcelona;13;Barcelonès;08019;Barcelona;3;184;A;;625;337;288;5;1;331;332
8;Barcelona;13;Barcelonès;08019;Barcelona;3;185;A;;410;205;205;0;1;204;205
8;Barcelona;13;Barcelonès;08019;Barcelona;3;186;A;;537;299;238;0;1;298;299
8;Barcelona;13;Barcelonès;08019;Barcelona;3;187;A;;421;217;204;2;1;214;215
8;Barcelona;13;Barcelonès;08019;Barcelona;3;188;A;;546;307;239;6;0;301;301
8;Barcelona;13;Barcelonès;08019;Barcelona;3;189;A;;797;421;376;1;1;419;420
8;Barcelona;13;Barcelonès;08019;Barcelona;3;19;A;;652;388;264;14;1;373;374
8;Barcelona;13;Barcelonès;08019;Barcelona;3;190;A;;346;198;148;6;3;189;192
8;Barcelona;13;Barcelonès;08019;Barcelona;3;191;A;;568;388;180;4;0;384;384
8;Barcelona;13;Barcelonès;08019;Barcelona;3;192;A;;632;393;239;0;2;391;393
8;Barcelona;13;Barcelonès;08019;Barcelona;3;193;A;;530;339;191;4;1;334;335
8;Barcelona;13;Barcelonès;08019;Barcelona;3;193;B;;529;317;212;0;1;316;317
8;Barcelona;13;Barcelonès;08019;Barcelona;3;194;A;;487;249;238;7;0;242;242
8;Barcelona;13;Barcelonès;08019;Barcelona;3;195;A;;652;414;238;0;6;408;414
8;Barcelona;13;Barcelonès;08019;Barcelona;3;196;A;;682;365;317;0;0;365;365
8;Barcelona;13;Barcelonès;08019;Barcelona;3;197;A;;575;302;273;1;4;297;301
8;Barcelona;13;Barcelonès;08019;Barcelona;3;198;A;;559;330;229;0;2;328;330
8;Barcelona;13;Barcelonès;08019;Barcelona;3;198;B;;554;325;229;0;1;324;325
8;Barcelona;13;Barcelonès;08019;Barcelona;3;199;A;;670;386;284;0;2;384;386
8;Barcelona;13;Barcelonès;08019;Barcelona;3;2;A;;414;240;174;0;3;237;240
8;Barcelona;13;Barcelonès;08019;Barcelona;3;20;A;;736;462;274;6;9;447;456
8;Barcelona;13;Barcelonès;08019;Barcelona;3;200;A;;478;283;195;0;4;279;283
8;Barcelona;13;Barcelonès;08019;Barcelona;3;200;B;;486;296;190;4;5;287;292
8;Barcelona;13;Barcelonès;08019;Barcelona;3;201;A;;679;373;306;0;1;372;373
8;Barcelona;13;Barcelonès;08019;Barcelona;3;201;B;;674;366;308;5;3;358;361
8;Barcelona;13;Barcelonès;08019;Barcelona;3;202;A;;485;273;212;6;2;265;267
8;Barcelona;13;Barcelonès;08019;Barcelona;3;202;B;;482;282;200;7;1;274;275
8;Barcelona;13;Barcelonès;08019;Barcelona;3;203;A;;313;176;137;0;1;175;176
8;Barcelona;13;Barcelonès;08019;Barcelona;3;204;A;;494;297;197;0;4;293;297
8;Barcelona;13;Barcelonès;08019;Barcelona;3;204;B;;496;293;203;0;4;289;293
8;Barcelona;13;Barcelonès;08019;Barcelona;3;205;A;;542;344;198;0;1;343;344
8;Barcelona;13;Barcelonès;08019;Barcelona;3;206;A;;416;261;155;0;0;261;261
8;Barcelona;13;Barcelonès;08019;Barcelona;3;207;A;;399;215;184;1;1;213;214
8;Barcelona;13;Barcelonès;08019;Barcelona;3;207;B;;406;216;190;0;0;216;216
8;Barcelona;13;Barcelonès;08019;Barcelona;3;208;A;;622;380;242;1;3;376;379
8;Barcelona;13;Barcelonès;08019;Barcelona;3;209;A;;400;265;135;0;5;260;265
8;Barcelona;13;Barcelonès;08019;Barcelona;3;209;B;;401;269;132;0;5;264;269
8;Barcelona;13;Barcelonès;08019;Barcelona;3;21;A;;348;210;138;5;1;204;205
8;Barcelona;13;Barcelonès;08019;Barcelona;3;210;A;;523;289;234;1;5;283;288
8;Barcelona;13;Barcelonès;08019;Barcelona;3;210;B;;526;278;248;1;3;274;277
8;Barcelona;13;Barcelonès;08019;Barcelona;3;22;A;;522;290;232;7;0;283;283
8;Barcelona;13;Barcelonès;08019;Barcelona;3;23;A;;486;265;221;6;3;256;259
8;Barcelona;13;Barcelonès;08019;Barcelona;3;24;A;;734;410;324;3;1;406;407
8;Barcelona;13;Barcelonès;08019;Barcelona;3;25;A;;564;334;230;3;1;330;331
8;Barcelona;13;Barcelonès;08019;Barcelona;3;26;A;;535;352;183;0;1;351;352
8;Barcelona;13;Barcelonès;08019;Barcelona;3;27;A;;383;211;172;9;2;200;202
8;Barcelona;13;Barcelonès;08019;Barcelona;3;28;A;;458;272;186;3;0;269;269
8;Barcelona;13;Barcelonès;08019;Barcelona;3;29;A;;358;213;145;0;0;213;213
8;Barcelona;13;Barcelonès;08019;Barcelona;3;3;A;;669;326;343;3;3;320;323
8;Barcelona;13;Barcelonès;08019;Barcelona;3;30;A;;420;259;161;1;1;257;258
8;Barcelona;13;Barcelonès;08019;Barcelona;3;31;A;;591;346;245;0;0;346;346
8;Barcelona;13;Barcelonès;08019;Barcelona;3;32;A;;436;206;230;5;1;200;201
8;Barcelona;13;Barcelonès;08019;Barcelona;3;33;A;;406;239;167;1;1;237;238
8;Barcelona;13;Barcelonès;08019;Barcelona;3;33;B;;406;213;193;2;3;208;211
8;Barcelona;13;Barcelonès;08019;Barcelona;3;34;A;;687;420;267;5;1;414;415
8;Barcelona;13;Barcelonès;08019;Barcelona;3;35;A;;485;307;178;0;2;305;307
8;Barcelona;13;Barcelonès;08019;Barcelona;3;36;A;;439;231;208;13;0;218;218
8;Barcelona;13;Barcelonès;08019;Barcelona;3;37;A;;754;431;323;2;1;428;429
8;Barcelona;13;Barcelonès;08019;Barcelona;3;38;A;;659;339;320;11;0;328;328
8;Barcelona;13;Barcelonès;08019;Barcelona;3;39;A;;478;277;201;0;0;277;277
8;Barcelona;13;Barcelonès;08019;Barcelona;3;4;A;;652;331;321;5;6;320;326
8;Barcelona;13;Barcelonès;08019;Barcelona;3;40;A;;372;239;133;3;3;233;236
8;Barcelona;13;Barcelonès;08019;Barcelona;3;41;A;;703;436;267;3;4;429;433
8;Barcelona;13;Barcelonès;08019;Barcelona;3;42;A;;621;355;266;2;2;351;353
8;Barcelona;13;Barcelonès;08019;Barcelona;3;43;A;;433;259;174;3;0;256;256
8;Barcelona;13;Barcelonès;08019;Barcelona;3;43;B;;439;262;177;0;1;261;262
8;Barcelona;13;Barcelonès;08019;Barcelona;3;44;A;;503;276;227;1;1;274;275
8;Barcelona;13;Barcelonès;08019;Barcelona;3;45;A;;409;239;170;1;1;237;238
8;Barcelona;13;Barcelonès;08019;Barcelona;3;46;A;;386;216;170;0;2;214;216
8;Barcelona;13;Barcelonès;08019;Barcelona;3;47;A;;437;253;184;0;2;251;253
8;Barcelona;13;Barcelonès;08019;Barcelona;3;48;A;;451;229;222;1;0;228;228
8;Barcelona;13;Barcelonès;08019;Barcelona;3;48;B;;444;247;197;0;1;246;247
8;Barcelona;13;Barcelonès;08019;Barcelona;3;49;A;;419;263;156;0;1;262;263
8;Barcelona;13;Barcelonès;08019;Barcelona;3;49;B;;418;243;175;0;2;241;243
8;Barcelona;13;Barcelonès;08019;Barcelona;3;5;A;;400;192;208;3;2;187;189
8;Barcelona;13;Barcelonès;08019;Barcelona;3;50;A;;544;361;183;1;3;357;360
8;Barcelona;13;Barcelonès;08019;Barcelona;3;51;A;;469;280;189;6;1;273;274
8;Barcelona;13;Barcelonès;08019;Barcelona;3;52;A;;338;227;111;0;6;221;227
8;Barcelona;13;Barcelonès;08019;Barcelona;3;53;A;;591;329;262;5;2;322;324
8;Barcelona;13;Barcelonès;08019;Barcelona;3;54;A;;504;275;229;0;3;272;275
8;Barcelona;13;Barcelonès;08019;Barcelona;3;55;A;;412;255;157;1;1;253;254
8;Barcelona;13;Barcelonès;08019;Barcelona;3;56;A;;585;368;217;2;0;366;366
8;Barcelona;13;Barcelonès;08019;Barcelona;3;57;A;;253;163;90;1;2;160;162
8;Barcelona;13;Barcelonès;08019;Barcelona;3;58;A;;185;185;0;6;2;177;179
8;Barcelona;13;Barcelonès;08019;Barcelona;3;59;A;;482;183;299;0;2;181;183
8;Barcelona;13;Barcelonès;08019;Barcelona;3;6;A;;290;322;32;0;5;317;322
8;Barcelona;13;Barcelonès;08019;Barcelona;3;60;A;;269;60;209;0;0;60;60
8;Barcelona;13;Barcelonès;08019;Barcelona;3;61;A;;275;23;252;0;0;23;23
8;Barcelona;13;Barcelonès;08019;Barcelona;3;62;A;;436;207;229;1;3;203;206
8;Barcelona;13;Barcelonès;08019;Barcelona;3;63;A;;498;271;227;1;0;270;270
8;Barcelona;13;Barcelonès;08019;Barcelona;3;64;A;;488;238;250;0;0;238;238
8;Barcelona;13;Barcelonès;08019;Barcelona;3;65;A;;750;410;340;1;1;408;409
8;Barcelona;13;Barcelonès;08019;Barcelona;3;65;B;;750;396;354;0;1;395;396
8;Barcelona;13;Barcelonès;08019;Barcelona;3;66;A;;435;263;172;0;3;260;263
8;Barcelona;13;Barcelonès;08019;Barcelona;3;66;B;;436;272;164;0;1;271;272
8;Barcelona;13;Barcelonès;08019;Barcelona;3;67;A;;765;379;386;3;1;375;376
8;Barcelona;13;Barcelonès;08019;Barcelona;3;68;A;;518;268;250;0;3;265;268
8;Barcelona;13;Barcelonès;08019;Barcelona;3;68;B;;503;272;231;0;3;269;272
8;Barcelona;13;Barcelonès;08019;Barcelona;3;69;A;;729;361;368;3;2;356;358
8;Barcelona;13;Barcelonès;08019;Barcelona;3;7;A;;568;288;280;0;3;285;288
8;Barcelona;13;Barcelonès;08019;Barcelona;3;70;A;;466;236;230;2;4;230;234
8;Barcelona;13;Barcelonès;08019;Barcelona;3;71;A;;588;339;249;3;2;334;336
8;Barcelona;13;Barcelonès;08019;Barcelona;3;71;B;;580;310;270;0;1;309;310
8;Barcelona;13;Barcelonès;08019;Barcelona;3;72;A;;782;428;354;2;1;425;426
8;Barcelona;13;Barcelonès;08019;Barcelona;3;72;B;;779;439;340;0;4;435;439
8;Barcelona;13;Barcelonès;08019;Barcelona;3;72;C;;776;387;389;1;3;383;386
8;Barcelona;13;Barcelonès;08019;Barcelona;3;72;D;;776;424;352;1;0;423;423
8;Barcelona;13;Barcelonès;08019;Barcelona;3;72;E;;814;408;406;1;0;407;407
8;Barcelona;13;Barcelonès;08019;Barcelona;3;72;F;;799;416;383;3;3;410;413
8;Barcelona;13;Barcelonès;08019;Barcelona;3;72;G;;800;408;392;2;3;403;406
8;Barcelona;13;Barcelonès;08019;Barcelona;3;73;A;;364;364;0;1;0;363;363
8;Barcelona;13;Barcelonès;08019;Barcelona;3;73;B;;817;363;454;1;3;359;362
8;Barcelona;13;Barcelonès;08019;Barcelona;3;74;A;;601;287;314;3;1;283;284
8;Barcelona;13;Barcelonès;08019;Barcelona;3;74;B;;271;271;0;2;0;269;269
8;Barcelona;13;Barcelonès;08019;Barcelona;3;74;C;;599;276;323;1;1;274;275
8;Barcelona;13;Barcelonès;08019;Barcelona;3;75;A;;673;364;309;0;1;363;364
8;Barcelona;13;Barcelonès;08019;Barcelona;3;75;B;;647;332;315;0;0;332;332
8;Barcelona;13;Barcelonès;08019;Barcelona;3;76;A;;363;368;5;0;2;366;368
8;Barcelona;13;Barcelonès;08019;Barcelona;3;77;A;;468;216;252;1;1;214;215
8;Barcelona;13;Barcelonès;08019;Barcelona;3;78;A;;790;381;409;1;2;378;380
8;Barcelona;13;Barcelonès;08019;Barcelona;3;79;A;;696;342;354;3;1;338;339
8;Barcelona;13;Barcelonès;08019;Barcelona;3;8;A;;568;313;255;0;4;309;313
8;Barcelona;13;Barcelonès;08019;Barcelona;3;80;A;;559;248;311;2;0;246;246
8;Barcelona;13;Barcelonès;08019;Barcelona;3;81;A;;537;269;268;1;0;268;268
8;Barcelona;13;Barcelonès;08019;Barcelona;3;82;A;;583;318;265;0;4;314;318
8;Barcelona;13;Barcelonès;08019;Barcelona;3;82;B;;581;313;268;0;2;311;313
8;Barcelona;13;Barcelonès;08019;Barcelona;3;83;A;;499;248;251;0;5;243;248
8;Barcelona;13;Barcelonès;08019;Barcelona;3;83;B;;506;268;238;0;2;266;268
8;Barcelona;13;Barcelonès;08019;Barcelona;3;84;A;;632;334;298;0;4;330;334
8;Barcelona;13;Barcelonès;08019;Barcelona;3;85;A;;778;439;339;0;2;437;439
8;Barcelona;13;Barcelonès;08019;Barcelona;3;86;A;;757;411;346;0;7;404;411
8;Barcelona;13;Barcelonès;08019;Barcelona;3;87;A;;612;358;254;1;6;351;357
8;Barcelona;13;Barcelonès;08019;Barcelona;3;88;A;;757;480;277;0;1;479;480
8;Barcelona;13;Barcelonès;08019;Barcelona;3;89;A;;564;335;229;0;4;331;335
8;Barcelona;13;Barcelonès;08019;Barcelona;3;9;A;;457;262;195;2;0;260;260
8;Barcelona;13;Barcelonès;08019;Barcelona;3;90;A;;589;324;265;1;1;322;323
8;Barcelona;13;Barcelonès;08019;Barcelona;3;91;A;;460;274;186;2;1;271;272
8;Barcelona;13;Barcelonès;08019;Barcelona;3;91;B;;460;287;173;1;0;286;286
8;Barcelona;13;Barcelonès;08019;Barcelona;3;92;A;;660;373;287;6;0;367;367
8;Barcelona;13;Barcelonès;08019;Barcelona;3;93;A;;718;417;301;0;5;412;417
8;Barcelona;13;Barcelonès;08019;Barcelona;3;94;A;;708;414;294;1;0;413;413
8;Barcelona;13;Barcelonès;08019;Barcelona;3;95;A;;712;417;295;2;4;411;415
8;Barcelona;13;Barcelonès;08019;Barcelona;3;96;A;;344;213;131;0;0;213;213
8;Barcelona;13;Barcelonès;08019;Barcelona;3;97;A;;465;314;151;0;2;312;314
8;Barcelona;13;Barcelonès;08019;Barcelona;3;98;A;;529;339;190;0;2;337;339
8;Barcelona;13;Barcelonès;08019;Barcelona;3;99;A;;604;376;228;0;0;376;376
8;Barcelona;13;Barcelonès;08019;Barcelona;4;1;A;;616;407;209;0;2;405;407
8;Barcelona;13;Barcelonès;08019;Barcelona;4;1;B;;617;397;220;0;8;389;397
8;Barcelona;13;Barcelonès;08019;Barcelona;4;1;C;;626;420;206;1;1;418;419
8;Barcelona;13;Barcelonès;08019;Barcelona;4;10;A;;641;417;224;2;5;410;415
8;Barcelona;13;Barcelonès;08019;Barcelona;4;10;B;;641;382;259;1;6;375;381
8;Barcelona;13;Barcelonès;08019;Barcelona;4;10;C;;634;416;218;0;6;410;416
8;Barcelona;13;Barcelonès;08019;Barcelona;4;10;D;;641;453;188;0;3;450;453
8;Barcelona;13;Barcelonès;08019;Barcelona;4;11;A;;679;440;239;1;4;435;439
8;Barcelona;13;Barcelonès;08019;Barcelona;4;11;B;;698;439;259;2;3;434;437
8;Barcelona;13;Barcelonès;08019;Barcelona;4;11;C;;723;449;274;1;4;444;448
8;Barcelona;13;Barcelonès;08019;Barcelona;4;12;A;;637;375;262;1;2;372;374
8;Barcelona;13;Barcelonès;08019;Barcelona;4;13;A;;476;234;242;4;2;228;230
8;Barcelona;13;Barcelonès;08019;Barcelona;4;13;B;;470;249;221;0;5;244;249
8;Barcelona;13;Barcelonès;08019;Barcelona;4;14;A;;446;220;226;0;3;217;220
8;Barcelona;13;Barcelonès;08019;Barcelona;4;15;A;;707;357;350;0;1;356;357
8;Barcelona;13;Barcelonès;08019;Barcelona;4;16;A;;765;387;378;2;3;382;385
8;Barcelona;13;Barcelonès;08019;Barcelona;4;16;B;;778;396;382;0;2;394;396
8;Barcelona;13;Barcelonès;08019;Barcelona;4;17;A;;595;284;311;0;1;283;284
8;Barcelona;13;Barcelonès;08019;Barcelona;4;18;A;;524;321;203;1;1;319;320
8;Barcelona;13;Barcelonès;08019;Barcelona;4;18;B;;525;326;199;0;1;325;326
8;Barcelona;13;Barcelonès;08019;Barcelona;4;19;A;;617;395;222;1;6;388;394
8;Barcelona;13;Barcelonès;08019;Barcelona;4;19;B;;625;379;246;0;3;376;379
8;Barcelona;13;Barcelonès;08019;Barcelona;4;19;C;;636;400;236;1;2;397;399
8;Barcelona;13;Barcelonès;08019;Barcelona;4;2;A;;632;388;244;1;2;385;387
8;Barcelona;13;Barcelonès;08019;Barcelona;4;20;A;;716;475;241;0;2;473;475
8;Barcelona;13;Barcelonès;08019;Barcelona;4;20;B;;719;467;252;1;4;462;466
8;Barcelona;13;Barcelonès;08019;Barcelona;4;21;A;;517;391;126;0;1;390;391
8;Barcelona;13;Barcelonès;08019;Barcelona;4;21;B;;513;378;135;0;4;374;378
8;Barcelona;13;Barcelonès;08019;Barcelona;4;22;A;;514;300;214;0;4;296;300
8;Barcelona;13;Barcelonès;08019;Barcelona;4;22;B;;525;343;182;0;1;342;343
8;Barcelona;13;Barcelonès;08019;Barcelona;4;23;A;;645;402;243;1;0;401;401
8;Barcelona;13;Barcelonès;08019;Barcelona;4;24;A;;726;500;226;6;6;488;494
8;Barcelona;13;Barcelonès;08019;Barcelona;4;25;A;;666;381;285;1;7;373;380
8;Barcelona;13;Barcelonès;08019;Barcelona;4;26;A;;607;370;237;4;6;360;366
8;Barcelona;13;Barcelonès;08019;Barcelona;4;27;A;;584;331;253;1;2;328;330
8;Barcelona;13;Barcelonès;08019;Barcelona;4;28;A;;699;421;278;3;1;417;418
8;Barcelona;13;Barcelonès;08019;Barcelona;4;29;A;;489;309;180;0;0;309;309
8;Barcelona;13;Barcelonès;08019;Barcelona;4;29;B;;496;310;186;0;2;308;310
8;Barcelona;13;Barcelonès;08019;Barcelona;4;3;A;;495;293;202;1;1;291;292
8;Barcelona;13;Barcelonès;08019;Barcelona;4;30;A;;453;304;149;0;0;304;304
8;Barcelona;13;Barcelonès;08019;Barcelona;4;31;A;;599;343;256;7;3;333;336
8;Barcelona;13;Barcelonès;08019;Barcelona;4;32;A;;779;493;286;1;11;481;492
8;Barcelona;13;Barcelonès;08019;Barcelona;4;33;A;;426;253;173;1;2;250;252
8;Barcelona;13;Barcelonès;08019;Barcelona;4;33;B;;411;248;163;0;4;244;248
8;Barcelona;13;Barcelonès;08019;Barcelona;4;34;A;;410;240;170;1;2;237;239
8;Barcelona;13;Barcelonès;08019;Barcelona;4;34;B;;419;292;127;1;3;288;291
8;Barcelona;13;Barcelonès;08019;Barcelona;4;35;A;;496;301;195;0;3;298;301
8;Barcelona;13;Barcelonès;08019;Barcelona;4;35;B;;501;300;201;1;1;298;299
8;Barcelona;13;Barcelonès;08019;Barcelona;4;36;A;;565;341;224;0;5;336;341
8;Barcelona;13;Barcelonès;08019;Barcelona;4;37;A;;493;319;174;0;2;317;319
8;Barcelona;13;Barcelonès;08019;Barcelona;4;37;B;;491;290;201;0;2;288;290
8;Barcelona;13;Barcelonès;08019;Barcelona;4;38;A;;721;417;304;0;6;411;417
8;Barcelona;13;Barcelonès;08019;Barcelona;4;39;A;;615;429;186;0;2;427;429
8;Barcelona;13;Barcelonès;08019;Barcelona;4;4;A;;671;405;266;4;2;399;401
8;Barcelona;13;Barcelonès;08019;Barcelona;4;40;A;;673;442;231;0;5;437;442
8;Barcelona;13;Barcelonès;08019;Barcelona;4;40;B;;660;444;216;0;6;438;444
8;Barcelona;13;Barcelonès;08019;Barcelona;4;41;A;;604;402;202;0;5;397;402
8;Barcelona;13;Barcelonès;08019;Barcelona;4;41;B;;608;385;223;7;6;372;378
8;Barcelona;13;Barcelonès;08019;Barcelona;4;42;A;;571;367;204;2;1;364;365
8;Barcelona;13;Barcelonès;08019;Barcelona;4;42;B;;580;353;227;1;4;348;352
8;Barcelona;13;Barcelonès;08019;Barcelona;4;43;A;;612;398;214;0;1;397;398
8;Barcelona;13;Barcelonès;08019;Barcelona;4;44;A;;516;328;188;1;0;327;327
8;Barcelona;13;Barcelonès;08019;Barcelona;4;44;B;;503;320;183;1;4;315;319
8;Barcelona;13;Barcelonès;08019;Barcelona;4;45;A;;407;233;174;0;0;233;233
8;Barcelona;13;Barcelonès;08019;Barcelona;4;46;A;;593;379;214;0;2;377;379
8;Barcelona;13;Barcelonès;08019;Barcelona;4;47;A;;206;138;68;0;3;135;138
8;Barcelona;13;Barcelonès;08019;Barcelona;4;48;A;;463;301;162;0;3;298;301
8;Barcelona;13;Barcelonès;08019;Barcelona;4;49;A;;434;307;127;0;0;307;307
8;Barcelona;13;Barcelonès;08019;Barcelona;4;5;A;;607;369;238;2;5;362;367
8;Barcelona;13;Barcelonès;08019;Barcelona;4;50;A;;800;525;275;2;3;520;523
8;Barcelona;13;Barcelonès;08019;Barcelona;4;51;A;;637;433;204;2;2;429;431
8;Barcelona;13;Barcelonès;08019;Barcelona;4;52;A;;506;358;148;1;3;354;357
8;Barcelona;13;Barcelonès;08019;Barcelona;4;52;B;;503;338;165;0;1;337;338
8;Barcelona;13;Barcelonès;08019;Barcelona;4;53;A;;416;275;141;0;7;268;275
8;Barcelona;13;Barcelonès;08019;Barcelona;4;53;B;;409;278;131;2;2;274;276
8;Barcelona;13;Barcelonès;08019;Barcelona;4;54;A;;473;335;138;4;2;329;331
8;Barcelona;13;Barcelonès;08019;Barcelona;4;54;B;;470;328;142;0;5;323;328
8;Barcelona;13;Barcelonès;08019;Barcelona;4;55;A;;609;400;209;3;1;396;397
8;Barcelona;13;Barcelonès;08019;Barcelona;4;56;A;;547;396;151;0;3;393;396
8;Barcelona;13;Barcelonès;08019;Barcelona;4;57;A;;502;349;153;0;7;342;349
8;Barcelona;13;Barcelonès;08019;Barcelona;4;58;A;;651;451;200;0;5;446;451
8;Barcelona;13;Barcelonès;08019;Barcelona;4;59;A;;333;243;90;0;3;240;243
8;Barcelona;13;Barcelonès;08019;Barcelona;4;6;A;;673;380;293;3;3;374;377
8;Barcelona;13;Barcelonès;08019;Barcelona;4;60;A;;362;260;102;0;2;258;260
8;Barcelona;13;Barcelonès;08019;Barcelona;4;61;A;;590;402;188;0;4;398;402
8;Barcelona;13;Barcelonès;08019;Barcelona;4;62;A;;660;436;224;0;2;434;436
8;Barcelona;13;Barcelonès;08019;Barcelona;4;63;A;;483;338;145;0;7;331;338
8;Barcelona;13;Barcelonès;08019;Barcelona;4;64;A;;456;288;168;0;2;286;288
8;Barcelona;13;Barcelonès;08019;Barcelona;4;65;A;;508;364;144;0;8;356;364
8;Barcelona;13;Barcelonès;08019;Barcelona;4;66;A;;590;395;195;0;4;391;395
8;Barcelona;13;Barcelonès;08019;Barcelona;4;66;B;;594;438;156;1;2;435;437
8;Barcelona;13;Barcelonès;08019;Barcelona;4;67;A;;410;304;106;1;2;301;303
8;Barcelona;13;Barcelonès;08019;Barcelona;4;68;A;;413;290;123;5;3;282;285
8;Barcelona;13;Barcelonès;08019;Barcelona;4;68;B;;401;295;106;5;2;288;290
8;Barcelona;13;Barcelonès;08019;Barcelona;4;69;A;;658;421;237;0;5;416;421
8;Barcelona;13;Barcelonès;08019;Barcelona;4;69;B;;666;472;194;1;3;468;471
8;Barcelona;13;Barcelonès;08019;Barcelona;4;7;A;;560;366;194;2;3;361;364
8;Barcelona;13;Barcelonès;08019;Barcelona;4;7;B;;551;319;232;0;3;316;319
8;Barcelona;13;Barcelonès;08019;Barcelona;4;7;C;;552;348;204;0;1;347;348
8;Barcelona;13;Barcelonès;08019;Barcelona;4;70;A;;585;360;225;0;3;357;360
8;Barcelona;13;Barcelonès;08019;Barcelona;4;71;A;;462;348;114;1;5;342;347
8;Barcelona;13;Barcelonès;08019;Barcelona;4;71;B;;508;347;161;0;4;343;347
8;Barcelona;13;Barcelonès;08019;Barcelona;4;72;A;;294;204;90;0;4;200;204
8;Barcelona;13;Barcelonès;08019;Barcelona;4;73;A;;424;308;116;0;0;308;308
8;Barcelona;13;Barcelonès;08019;Barcelona;4;73;B;;418;312;106;0;2;310;312
8;Barcelona;13;Barcelonès;08019;Barcelona;4;74;A;;663;441;222;0;2;439;441
8;Barcelona;13;Barcelonès;08019;Barcelona;4;74;B;;682;456;226;0;5;451;456
8;Barcelona;13;Barcelonès;08019;Barcelona;4;74;C;;675;491;184;1;6;484;490
8;Barcelona;13;Barcelonès;08019;Barcelona;4;75;A;;527;360;167;0;4;356;360
8;Barcelona;13;Barcelonès;08019;Barcelona;4;76;A;;602;437;165;2;3;432;435
8;Barcelona;13;Barcelonès;08019;Barcelona;4;76;B;;606;466;140;0;1;465;466
8;Barcelona;13;Barcelonès;08019;Barcelona;4;77;A;;627;459;168;1;3;455;458
8;Barcelona;13;Barcelonès;08019;Barcelona;4;77;B;;613;449;164;1;4;444;448
8;Barcelona;13;Barcelonès;08019;Barcelona;4;78;A;;427;203;224;3;1;199;200
8;Barcelona;13;Barcelonès;08019;Barcelona;4;79;A;;448;330;118;1;3;326;329
8;Barcelona;13;Barcelonès;08019;Barcelona;4;79;B;;442;342;100;0;3;339;342
8;Barcelona;13;Barcelonès;08019;Barcelona;4;8;A;;395;193;202;2;0;191;191
8;Barcelona;13;Barcelonès;08019;Barcelona;4;80;A;;688;406;282;1;2;403;405
8;Barcelona;13;Barcelonès;08019;Barcelona;4;81;A;;488;355;133;1;2;352;354
8;Barcelona;13;Barcelonès;08019;Barcelona;4;81;B;;517;381;136;0;7;374;381
8;Barcelona;13;Barcelonès;08019;Barcelona;4;82;A;;812;535;277;1;2;532;534
8;Barcelona;13;Barcelonès;08019;Barcelona;4;9;A;;853;512;341;0;8;504;512
8;Barcelona;13;Barcelonès;08019;Barcelona;5;1;A;;402;258;144;0;0;258;258
8;Barcelona;13;Barcelonès;08019;Barcelona;5;10;A;;625;427;198;0;4;423;427
8;Barcelona;13;Barcelonès;08019;Barcelona;5;100;A;;626;459;167;0;4;455;459
8;Barcelona;13;Barcelonès;08019;Barcelona;5;101;A;;427;236;191;0;0;236;236
8;Barcelona;13;Barcelonès;08019;Barcelona;5;101;B;;436;225;211;2;2;221;223
8;Barcelona;13;Barcelonès;08019;Barcelona;5;102;A;;793;576;217;0;0;576;576
8;Barcelona;13;Barcelonès;08019;Barcelona;5;103;A;;540;405;135;1;3;401;404
8;Barcelona;13;Barcelonès;08019;Barcelona;5;104;A;;423;292;131;1;4;287;291
8;Barcelona;13;Barcelonès;08019;Barcelona;5;105;A;;630;439;191;2;3;434;437
8;Barcelona;13;Barcelonès;08019;Barcelona;5;105;B;;641;464;177;5;0;459;459
8;Barcelona;13;Barcelonès;08019;Barcelona;5;106;A;;773;573;200;1;4;568;572
8;Barcelona;13;Barcelonès;08019;Barcelona;5;107;A;;589;402;187;0;4;398;402
8;Barcelona;13;Barcelonès;08019;Barcelona;5;108;A;;443;320;123;2;3;315;318
8;Barcelona;13;Barcelonès;08019;Barcelona;5;109;A;;643;460;183;0;5;455;460
8;Barcelona;13;Barcelonès;08019;Barcelona;5;11;A;;537;401;136;1;2;398;400
8;Barcelona;13;Barcelonès;08019;Barcelona;5;110;A;;451;312;139;0;5;307;312
8;Barcelona;13;Barcelonès;08019;Barcelona;5;111;A;;771;562;209;0;7;555;562
8;Barcelona;13;Barcelonès;08019;Barcelona;5;112;A;;435;288;147;1;5;282;287
8;Barcelona;13;Barcelonès;08019;Barcelona;5;112;B;;420;295;125;0;7;288;295
8;Barcelona;13;Barcelonès;08019;Barcelona;5;113;A;;469;338;131;2;5;331;336
8;Barcelona;13;Barcelonès;08019;Barcelona;5;114;A;;545;366;179;0;3;363;366
8;Barcelona;13;Barcelonès;08019;Barcelona;5;115;A;;518;323;195;0;1;322;323
8;Barcelona;13;Barcelonès;08019;Barcelona;5;116;A;;573;383;190;0;4;379;383
8;Barcelona;13;Barcelonès;08019;Barcelona;5;117;A;;677;516;161;3;3;510;513
8;Barcelona;13;Barcelonès;08019;Barcelona;5;118;A;;433;327;106;2;0;325;325
8;Barcelona;13;Barcelonès;08019;Barcelona;5;119;A;;537;378;159;1;6;371;377
8;Barcelona;13;Barcelonès;08019;Barcelona;5;12;A;;785;514;271;2;4;508;512
8;Barcelona;13;Barcelonès;08019;Barcelona;5;120;A;;578;391;187;0;3;388;391
8;Barcelona;13;Barcelonès;08019;Barcelona;5;121;A;;441;333;108;0;0;333;333
8;Barcelona;13;Barcelonès;08019;Barcelona;5;122;A;;435;323;112;1;3;319;322
8;Barcelona;13;Barcelonès;08019;Barcelona;5;122;B;;432;327;105;0;1;326;327
8;Barcelona;13;Barcelonès;08019;Barcelona;5;123;A;;446;326;120;3;2;321;323
8;Barcelona;13;Barcelonès;08019;Barcelona;5;124;A;;651;487;164;0;4;483;487
8;Barcelona;13;Barcelonès;08019;Barcelona;5;125;A;;647;439;208;1;4;434;438
8;Barcelona;13;Barcelonès;08019;Barcelona;5;126;A;;584;405;179;0;3;402;405
8;Barcelona;13;Barcelonès;08019;Barcelona;5;127;A;;591;454;137;0;2;452;454
8;Barcelona;13;Barcelonès;08019;Barcelona;5;128;A;;466;309;157;1;0;308;308
8;Barcelona;13;Barcelonès;08019;Barcelona;5;129;A;;629;476;153;8;2;466;468
8;Barcelona;13;Barcelonès;08019;Barcelona;5;13;A;;511;350;161;0;1;349;350
8;Barcelona;13;Barcelonès;08019;Barcelona;5;13;B;;504;349;155;3;1;345;346
8;Barcelona;13;Barcelonès;08019;Barcelona;5;130;A;;491;378;113;0;6;372;378
8;Barcelona;13;Barcelonès;08019;Barcelona;5;131;A;;433;343;90;2;7;334;341
8;Barcelona;13;Barcelonès;08019;Barcelona;5;132;A;;501;351;150;0;3;348;351
8;Barcelona;13;Barcelonès;08019;Barcelona;5;133;A;;501;379;122;0;2;377;379
8;Barcelona;13;Barcelonès;08019;Barcelona;5;133;B;;486;364;122;0;3;361;364
8;Barcelona;13;Barcelonès;08019;Barcelona;5;134;A;;642;461;181;0;7;454;461
8;Barcelona;13;Barcelonès;08019;Barcelona;5;135;A;;537;409;128;0;6;403;409
8;Barcelona;13;Barcelonès;08019;Barcelona;5;135;B;;500;383;117;0;1;382;383
8;Barcelona;13;Barcelonès;08019;Barcelona;5;136;A;;854;642;212;0;4;638;642
8;Barcelona;13;Barcelonès;08019;Barcelona;5;137;A;;607;461;146;1;3;457;460
8;Barcelona;13;Barcelonès;08019;Barcelona;5;138;A;;758;504;254;1;5;498;503
8;Barcelona;13;Barcelonès;08019;Barcelona;5;139;A;;736;544;192;2;2;540;542
8;Barcelona;13;Barcelonès;08019;Barcelona;5;14;A;;605;408;197;0;18;390;408
8;Barcelona;13;Barcelonès;08019;Barcelona;5;140;A;;623;447;176;0;3;444;447
8;Barcelona;13;Barcelonès;08019;Barcelona;5;141;A;;472;343;129;1;5;337;342
8;Barcelona;13;Barcelonès;08019;Barcelona;5;142;A;;448;259;189;0;5;254;259
8;Barcelona;13;Barcelonès;08019;Barcelona;5;143;A;;527;371;156;0;4;367;371
8;Barcelona;13;Barcelonès;08019;Barcelona;5;144;A;;613;469;144;3;3;463;466
8;Barcelona;13;Barcelonès;08019;Barcelona;5;145;A;;777;556;221;2;2;552;554
8;Barcelona;13;Barcelonès;08019;Barcelona;5;146;A;;768;515;253;2;3;510;513
8;Barcelona;13;Barcelonès;08019;Barcelona;5;147;A;;632;484;148;3;2;479;481
8;Barcelona;13;Barcelonès;08019;Barcelona;5;148;A;;624;481;143;0;5;476;481
8;Barcelona;13;Barcelonès;08019;Barcelona;5;148;B;;663;503;160;0;1;502;503
8;Barcelona;13;Barcelonès;08019;Barcelona;5;149;A;;519;339;180;3;5;331;336
8;Barcelona;13;Barcelonès;08019;Barcelona;5;15;A;;532;399;133;0;0;399;399
8;Barcelona;13;Barcelonès;08019;Barcelona;5;150;A;;427;277;150;0;2;275;277
8;Barcelona;13;Barcelonès;08019;Barcelona;5;150;B;;420;294;126;3;2;289;291
8;Barcelona;13;Barcelonès;08019;Barcelona;5;151;A;;392;262;130;0;1;261;262
8;Barcelona;13;Barcelonès;08019;Barcelona;5;152;A;;660;385;275;4;5;376;381
8;Barcelona;13;Barcelonès;08019;Barcelona;5;153;A;;687;529;158;0;5;524;529
8;Barcelona;13;Barcelonès;08019;Barcelona;5;154;A;;602;481;121;0;5;476;481
8;Barcelona;13;Barcelonès;08019;Barcelona;5;155;A;;511;387;124;0;1;386;387
8;Barcelona;13;Barcelonès;08019;Barcelona;5;156;A;;723;556;167;1;2;553;555
8;Barcelona;13;Barcelonès;08019;Barcelona;5;157;A;;680;478;202;0;2;476;478
8;Barcelona;13;Barcelonès;08019;Barcelona;5;158;A;;718;503;215;2;10;491;501
8;Barcelona;13;Barcelonès;08019;Barcelona;5;159;A;;377;277;100;0;1;276;277
8;Barcelona;13;Barcelonès;08019;Barcelona;5;16;A;;578;419;159;0;1;418;419
8;Barcelona;13;Barcelonès;08019;Barcelona;5;160;A;;642;461;181;1;6;454;460
8;Barcelona;13;Barcelonès;08019;Barcelona;5;161;A;;698;562;136;3;8;551;559
8;Barcelona;13;Barcelonès;08019;Barcelona;5;162;A;;554;353;201;1;5;347;352
8;Barcelona;13;Barcelonès;08019;Barcelona;5;163;A;;565;365;200;4;2;359;361
8;Barcelona;13;Barcelonès;08019;Barcelona;5;164;A;;625;409;216;4;1;404;405
8;Barcelona;13;Barcelonès;08019;Barcelona;5;165;A;;669;480;189;0;6;474;480
8;Barcelona;13;Barcelonès;08019;Barcelona;5;166;A;;391;288;103;1;1;286;287
8;Barcelona;13;Barcelonès;08019;Barcelona;5;167;A;;489;335;154;0;0;335;335
8;Barcelona;13;Barcelonès;08019;Barcelona;5;168;A;;568;409;159;0;5;404;409
8;Barcelona;13;Barcelonès;08019;Barcelona;5;169;A;;737;592;145;1;12;579;591
8;Barcelona;13;Barcelonès;08019;Barcelona;5;17;A;;566;434;132;0;2;432;434
8;Barcelona;13;Barcelonès;08019;Barcelona;5;170;A;;654;448;206;1;4;443;447
8;Barcelona;13;Barcelonès;08019;Barcelona;5;171;A;;573;416;157;0;5;411;416
8;Barcelona;13;Barcelonès;08019;Barcelona;5;172;A;;406;305;101;1;1;303;304
8;Barcelona;13;Barcelonès;08019;Barcelona;5;173;A;;267;158;109;1;0;157;157
8;Barcelona;13;Barcelonès;08019;Barcelona;5;174;A;;304;183;121;1;0;182;182
8;Barcelona;13;Barcelonès;08019;Barcelona;5;175;A;;644;419;225;8;5;406;411
8;Barcelona;13;Barcelonès;08019;Barcelona;5;176;A;;519;410;109;0;3;407;410
8;Barcelona;13;Barcelonès;08019;Barcelona;5;177;A;;613;473;140;1;4;468;472
8;Barcelona;13;Barcelonès;08019;Barcelona;5;178;A;;510;367;143;0;3;364;367
8;Barcelona;13;Barcelonès;08019;Barcelona;5;179;A;;528;349;179;0;2;347;349
8;Barcelona;13;Barcelonès;08019;Barcelona;5;18;A;;420;320;100;1;1;318;319
8;Barcelona;13;Barcelonès;08019;Barcelona;5;18;B;;442;306;136;1;0;305;305
8;Barcelona;13;Barcelonès;08019;Barcelona;5;180;A;;465;334;131;0;2;332;334
8;Barcelona;13;Barcelonès;08019;Barcelona;5;181;A;;115;66;49;0;0;66;66
8;Barcelona;13;Barcelonès;08019;Barcelona;5;182;A;;710;451;259;2;8;441;449
8;Barcelona;13;Barcelonès;08019;Barcelona;5;183;A;;410;239;171;0;1;238;239
8;Barcelona;13;Barcelonès;08019;Barcelona;5;19;A;;738;527;211;3;5;519;524
8;Barcelona;13;Barcelonès;08019;Barcelona;5;2;A;;650;487;163;1;1;485;486
8;Barcelona;13;Barcelonès;08019;Barcelona;5;20;A;;676;466;210;0;0;466;466
8;Barcelona;13;Barcelonès;08019;Barcelona;5;21;A;;491;375;116;1;2;372;374
8;Barcelona;13;Barcelonès;08019;Barcelona;5;22;A;;633;419;214;3;4;412;416
8;Barcelona;13;Barcelonès;08019;Barcelona;5;23;A;;695;493;202;2;8;483;491
8;Barcelona;13;Barcelonès;08019;Barcelona;5;24;A;;723;522;201;0;4;518;522
8;Barcelona;13;Barcelonès;08019;Barcelona;5;25;A;;674;447;227;0;6;441;447
8;Barcelona;13;Barcelonès;08019;Barcelona;5;26;A;;366;242;124;0;2;240;242
8;Barcelona;13;Barcelonès;08019;Barcelona;5;27;A;;420;309;111;3;3;303;306
8;Barcelona;13;Barcelonès;08019;Barcelona;5;28;A;;711;477;234;5;7;465;472
8;Barcelona;13;Barcelonès;08019;Barcelona;5;29;A;;532;382;150;1;1;380;381
8;Barcelona;13;Barcelonès;08019;Barcelona;5;3;A;;580;385;195;0;3;382;385
8;Barcelona;13;Barcelonès;08019;Barcelona;5;3;B;;586;401;185;2;3;396;399
8;Barcelona;13;Barcelonès;08019;Barcelona;5;30;A;;665;520;145;1;6;513;519
8;Barcelona;13;Barcelonès;08019;Barcelona;5;31;A;;776;537;239;3;6;528;534
8;Barcelona;13;Barcelonès;08019;Barcelona;5;32;A;;603;403;200;1;4;398;402
8;Barcelona;13;Barcelonès;08019;Barcelona;5;33;A;;614;452;162;1;2;449;451
8;Barcelona;13;Barcelonès;08019;Barcelona;5;34;A;;727;499;228;0;5;494;499
8;Barcelona;13;Barcelonès;08019;Barcelona;5;35;A;;784;506;278;1;2;503;505
8;Barcelona;13;Barcelonès;08019;Barcelona;5;36;A;;519;332;187;0;4;328;332
8;Barcelona;13;Barcelonès;08019;Barcelona;5;37;A;;486;321;165;1;7;313;320
8;Barcelona;13;Barcelonès;08019;Barcelona;5;37;B;;494;337;157;1;1;335;336
8;Barcelona;13;Barcelonès;08019;Barcelona;5;38;A;;598;399;199;0;3;396;399
8;Barcelona;13;Barcelonès;08019;Barcelona;5;39;A;;589;426;163;1;0;425;425
8;Barcelona;13;Barcelonès;08019;Barcelona;5;39;B;;586;417;169;1;6;410;416
8;Barcelona;13;Barcelonès;08019;Barcelona;5;4;A;;456;329;127;0;2;327;329
8;Barcelona;13;Barcelonès;08019;Barcelona;5;4;B;;444;313;131;0;0;313;313
8;Barcelona;13;Barcelonès;08019;Barcelona;5;40;A;;648;499;149;1;4;494;498
8;Barcelona;13;Barcelonès;08019;Barcelona;5;41;A;;570;427;143;0;1;426;427
8;Barcelona;13;Barcelonès;08019;Barcelona;5;41;B;;571;424;147;0;6;418;424
8;Barcelona;13;Barcelonès;08019;Barcelona;5;42;A;;461;322;139;0;3;319;322
8;Barcelona;13;Barcelonès;08019;Barcelona;5;42;B;;476;292;184;0;2;290;292
8;Barcelona;13;Barcelonès;08019;Barcelona;5;43;A;;622;438;184;0;3;435;438
8;Barcelona;13;Barcelonès;08019;Barcelona;5;44;A;;656;484;172;2;1;481;482
8;Barcelona;13;Barcelonès;08019;Barcelona;5;45;A;;516;346;170;0;10;336;346
8;Barcelona;13;Barcelonès;08019;Barcelona;5;46;A;;768;570;198;1;2;567;569
8;Barcelona;13;Barcelonès;08019;Barcelona;5;47;A;;599;428;171;0;1;427;428
8;Barcelona;13;Barcelonès;08019;Barcelona;5;48;A;;476;344;132;0;0;344;344
8;Barcelona;13;Barcelonès;08019;Barcelona;5;49;A;;819;550;269;2;3;545;548
8;Barcelona;13;Barcelonès;08019;Barcelona;5;5;A;;533;391;142;0;2;389;391
8;Barcelona;13;Barcelonès;08019;Barcelona;5;5;B;;525;371;154;0;1;370;371
8;Barcelona;13;Barcelonès;08019;Barcelona;5;50;A;;637;429;208;7;3;419;422
8;Barcelona;13;Barcelonès;08019;Barcelona;5;51;A;;650;464;186;4;5;455;460
8;Barcelona;13;Barcelonès;08019;Barcelona;5;52;A;;707;528;179;0;6;522;528
8;Barcelona;13;Barcelonès;08019;Barcelona;5;53;A;;634;487;147;0;2;485;487
8;Barcelona;13;Barcelonès;08019;Barcelona;5;54;A;;755;563;192;4;4;555;559
8;Barcelona;13;Barcelonès;08019;Barcelona;5;55;A;;496;360;136;3;2;355;357
8;Barcelona;13;Barcelonès;08019;Barcelona;5;55;B;;514;376;138;0;3;373;376
8;Barcelona;13;Barcelonès;08019;Barcelona;5;56;A;;708;497;211;0;3;494;497
8;Barcelona;13;Barcelonès;08019;Barcelona;5;57;A;;692;475;217;0;5;470;475
8;Barcelona;13;Barcelonès;08019;Barcelona;5;58;A;;457;313;144;3;0;310;310
8;Barcelona;13;Barcelonès;08019;Barcelona;5;58;B;;441;296;145;0;3;293;296
8;Barcelona;13;Barcelonès;08019;Barcelona;5;59;A;;595;406;189;0;3;403;406
8;Barcelona;13;Barcelonès;08019;Barcelona;5;6;A;;630;437;193;0;3;434;437
8;Barcelona;13;Barcelonès;08019;Barcelona;5;6;B;;630;442;188;0;8;434;442
8;Barcelona;13;Barcelonès;08019;Barcelona;5;60;A;;417;285;132;2;2;281;283
8;Barcelona;13;Barcelonès;08019;Barcelona;5;60;B;;405;278;127;0;4;274;278
8;Barcelona;13;Barcelonès;08019;Barcelona;5;61;A;;435;298;137;0;4;294;298
8;Barcelona;13;Barcelonès;08019;Barcelona;5;61;B;;430;296;134;3;1;292;293
8;Barcelona;13;Barcelonès;08019;Barcelona;5;62;A;;433;329;104;0;1;328;329
8;Barcelona;13;Barcelonès;08019;Barcelona;5;63;A;;592;426;166;0;1;425;426
8;Barcelona;13;Barcelonès;08019;Barcelona;5;64;A;;573;356;217;0;2;354;356
8;Barcelona;13;Barcelonès;08019;Barcelona;5;65;A;;545;377;168;2;0;375;375
8;Barcelona;13;Barcelonès;08019;Barcelona;5;66;A;;504;358;146;0;5;353;358
8;Barcelona;13;Barcelonès;08019;Barcelona;5;67;A;;580;392;188;1;6;385;391
8;Barcelona;13;Barcelonès;08019;Barcelona;5;68;A;;558;368;190;1;3;364;367
8;Barcelona;13;Barcelonès;08019;Barcelona;5;69;A;;786;502;284;0;5;497;502
8;Barcelona;13;Barcelonès;08019;Barcelona;5;7;A;;635;459;176;1;1;457;458
8;Barcelona;13;Barcelonès;08019;Barcelona;5;70;A;;680;442;238;0;0;442;442
8;Barcelona;13;Barcelonès;08019;Barcelona;5;71;A;;445;315;130;0;1;314;315
8;Barcelona;13;Barcelonès;08019;Barcelona;5;72;A;;730;475;255;0;1;474;475
8;Barcelona;13;Barcelonès;08019;Barcelona;5;73;A;;577;393;184;0;4;389;393
8;Barcelona;13;Barcelonès;08019;Barcelona;5;74;A;;644;467;177;0;4;463;467
8;Barcelona;13;Barcelonès;08019;Barcelona;5;75;A;;812;552;260;4;3;545;548
8;Barcelona;13;Barcelonès;08019;Barcelona;5;76;A;;616;460;156;1;4;455;459
8;Barcelona;13;Barcelonès;08019;Barcelona;5;77;A;;536;419;117;2;2;415;417
8;Barcelona;13;Barcelonès;08019;Barcelona;5;77;B;;549;394;155;3;4;387;391
8;Barcelona;13;Barcelonès;08019;Barcelona;5;78;A;;463;351;112;0;3;348;351
8;Barcelona;13;Barcelonès;08019;Barcelona;5;79;A;;673;513;160;1;6;506;512
8;Barcelona;13;Barcelonès;08019;Barcelona;5;8;A;;795;531;264;0;5;526;531
8;Barcelona;13;Barcelonès;08019;Barcelona;5;80;A;;512;379;133;0;3;376;379
8;Barcelona;13;Barcelonès;08019;Barcelona;5;81;A;;573;398;175;1;5;392;397
8;Barcelona;13;Barcelonès;08019;Barcelona;5;82;A;;692;488;204;0;7;481;488
8;Barcelona;13;Barcelonès;08019;Barcelona;5;83;A;;562;395;167;1;2;392;394
8;Barcelona;13;Barcelonès;08019;Barcelona;5;84;A;;515;363;152;0;2;361;363
8;Barcelona;13;Barcelonès;08019;Barcelona;5;85;A;;448;318;130;0;2;316;318
8;Barcelona;13;Barcelonès;08019;Barcelona;5;85;B;;442;314;128;0;8;306;314
8;Barcelona;13;Barcelonès;08019;Barcelona;5;86;A;;773;526;247;0;4;522;526
8;Barcelona;13;Barcelonès;08019;Barcelona;5;87;A;;579;377;202;1;3;373;376
8;Barcelona;13;Barcelonès;08019;Barcelona;5;88;A;;571;436;135;0;0;436;436
8;Barcelona;13;Barcelonès;08019;Barcelona;5;89;A;;461;338;123;0;4;334;338
8;Barcelona;13;Barcelonès;08019;Barcelona;5;89;B;;455;317;138;1;2;314;316
8;Barcelona;13;Barcelonès;08019;Barcelona;5;9;A;;355;249;106;0;2;247;249
8;Barcelona;13;Barcelonès;08019;Barcelona;5;90;A;;623;445;178;1;2;442;444
8;Barcelona;13;Barcelonès;08019;Barcelona;5;91;A;;772;577;195;0;4;573;577
8;Barcelona;13;Barcelonès;08019;Barcelona;5;91;B;;763;585;178;0;2;583;585
8;Barcelona;13;Barcelonès;08019;Barcelona;5;92;A;;535;406;129;0;7;399;406
8;Barcelona;13;Barcelonès;08019;Barcelona;5;93;A;;557;410;147;0;3;407;410
8;Barcelona;13;Barcelonès;08019;Barcelona;5;94;A;;557;406;151;0;2;404;406
8;Barcelona;13;Barcelonès;08019;Barcelona;5;95;A;;721;496;225;2;10;484;494
8;Barcelona;13;Barcelonès;08019;Barcelona;5;96;A;;616;457;159;1;3;453;456
8;Barcelona;13;Barcelonès;08019;Barcelona;5;97;A;;734;504;230;0;7;497;504
8;Barcelona;13;Barcelonès;08019;Barcelona;5;97;B;;731;545;186;2;10;533;543
8;Barcelona;13;Barcelonès;08019;Barcelona;5;98;A;;682;448;234;1;4;443;447
8;Barcelona;13;Barcelonès;08019;Barcelona;5;99;A;;602;416;186;0;5;411;416
8;Barcelona;13;Barcelonès;08019;Barcelona;6;1;A;;548;343;205;5;4;334;338
8;Barcelona;13;Barcelonès;08019;Barcelona;6;10;A;;469;294;175;7;1;286;287
8;Barcelona;13;Barcelonès;08019;Barcelona;6;10;B;;459;263;196;1;0;262;262
8;Barcelona;13;Barcelonès;08019;Barcelona;6;100;A;;510;297;213;0;0;297;297
8;Barcelona;13;Barcelonès;08019;Barcelona;6;101;A;;452;291;161;0;0;291;291
8;Barcelona;13;Barcelonès;08019;Barcelona;6;102;A;;666;462;204;0;1;461;462
8;Barcelona;13;Barcelonès;08019;Barcelona;6;103;A;;481;334;147;3;1;330;331
8;Barcelona;13;Barcelonès;08019;Barcelona;6;103;B;;485;328;157;1;3;324;327
8;Barcelona;13;Barcelonès;08019;Barcelona;6;104;A;;742;505;237;1;7;497;504
8;Barcelona;13;Barcelonès;08019;Barcelona;6;105;A;;782;500;282;0;3;497;500
8;Barcelona;13;Barcelonès;08019;Barcelona;6;106;A;;435;271;164;0;2;269;271
8;Barcelona;13;Barcelonès;08019;Barcelona;6;106;B;;438;250;188;1;3;246;249
8;Barcelona;13;Barcelonès;08019;Barcelona;6;107;A;;608;423;185;1;5;417;422
8;Barcelona;13;Barcelonès;08019;Barcelona;6;108;A;;480;329;151;3;1;325;326
8;Barcelona;13;Barcelonès;08019;Barcelona;6;109;A;;768;486;282;3;5;478;483
8;Barcelona;13;Barcelonès;08019;Barcelona;6;11;A;;511;309;202;0;1;308;309
8;Barcelona;13;Barcelonès;08019;Barcelona;6;11;B;;517;312;205;1;1;310;311
8;Barcelona;13;Barcelonès;08019;Barcelona;6;110;A;;514;383;131;0;2;381;383
8;Barcelona;13;Barcelonès;08019;Barcelona;6;111;A;;569;378;191;3;4;371;375
8;Barcelona;13;Barcelonès;08019;Barcelona;6;112;A;;467;304;163;0;3;301;304
8;Barcelona;13;Barcelonès;08019;Barcelona;6;112;B;;443;316;127;0;1;315;316
8;Barcelona;13;Barcelonès;08019;Barcelona;6;113;A;;481;347;134;4;4;339;343
8;Barcelona;13;Barcelonès;08019;Barcelona;6;113;B;;479;305;174;1;6;298;304
8;Barcelona;13;Barcelonès;08019;Barcelona;6;114;A;;813;517;296;1;2;514;516
8;Barcelona;13;Barcelonès;08019;Barcelona;6;114;B;;791;514;277;0;4;510;514
8;Barcelona;13;Barcelonès;08019;Barcelona;6;115;A;;485;354;131;1;3;350;353
8;Barcelona;13;Barcelonès;08019;Barcelona;6;115;B;;470;346;124;0;3;343;346
8;Barcelona;13;Barcelonès;08019;Barcelona;6;116;A;;582;390;192;2;5;383;388
8;Barcelona;13;Barcelonès;08019;Barcelona;6;117;A;;768;486;282;0;6;480;486
8;Barcelona;13;Barcelonès;08019;Barcelona;6;118;A;;786;547;239;0;7;540;547
8;Barcelona;13;Barcelonès;08019;Barcelona;6;119;A;;475;335;140;0;5;330;335
8;Barcelona;13;Barcelonès;08019;Barcelona;6;119;B;;476;337;139;0;3;334;337
8;Barcelona;13;Barcelonès;08019;Barcelona;6;12;A;;650;401;249;0;3;398;401
8;Barcelona;13;Barcelonès;08019;Barcelona;6;120;A;;755;507;248;0;7;500;507
8;Barcelona;13;Barcelonès;08019;Barcelona;6;121;A;;444;288;156;0;2;286;288
8;Barcelona;13;Barcelonès;08019;Barcelona;6;121;B;;448;258;190;2;1;255;256
8;Barcelona;13;Barcelonès;08019;Barcelona;6;122;A;;655;476;179;0;7;469;476
8;Barcelona;13;Barcelonès;08019;Barcelona;6;123;A;;372;246;126;0;1;245;246
8;Barcelona;13;Barcelonès;08019;Barcelona;6;124;A;;410;241;169;1;3;237;240
8;Barcelona;13;Barcelonès;08019;Barcelona;6;124;B;;414;222;192;1;1;220;221
8;Barcelona;13;Barcelonès;08019;Barcelona;6;125;A;;627;400;227;3;1;396;397
8;Barcelona;13;Barcelonès;08019;Barcelona;6;126;A;;376;223;153;0;3;220;223
8;Barcelona;13;Barcelonès;08019;Barcelona;6;127;A;;542;366;176;0;0;366;366
8;Barcelona;13;Barcelonès;08019;Barcelona;6;128;A;;784;527;257;3;7;517;524
8;Barcelona;13;Barcelonès;08019;Barcelona;6;129;A;;466;290;176;0;5;285;290
8;Barcelona;13;Barcelonès;08019;Barcelona;6;13;A;;694;467;227;2;8;457;465
8;Barcelona;13;Barcelonès;08019;Barcelona;6;130;A;;593;358;235;1;7;350;357
8;Barcelona;13;Barcelonès;08019;Barcelona;6;131;A;;483;254;229;0;2;252;254
8;Barcelona;13;Barcelonès;08019;Barcelona;6;131;B;;486;273;213;4;3;266;269
8;Barcelona;13;Barcelonès;08019;Barcelona;6;132;A;;754;433;321;2;1;430;431
8;Barcelona;13;Barcelonès;08019;Barcelona;6;133;A;;724;424;300;0;7;417;424
8;Barcelona;13;Barcelonès;08019;Barcelona;6;134;A;;470;276;194;3;3;270;273
8;Barcelona;13;Barcelonès;08019;Barcelona;6;135;A;;482;336;146;2;0;334;334
8;Barcelona;13;Barcelonès;08019;Barcelona;6;135;B;;482;340;142;10;3;327;330
8;Barcelona;13;Barcelonès;08019;Barcelona;6;136;A;;597;384;213;1;4;379;383
8;Barcelona;13;Barcelonès;08019;Barcelona;6;136;B;;614;407;207;0;2;405;407
8;Barcelona;13;Barcelonès;08019;Barcelona;6;137;A;;712;493;219;4;6;483;489
8;Barcelona;13;Barcelonès;08019;Barcelona;6;138;A;;443;247;196;1;2;244;246
8;Barcelona;13;Barcelonès;08019;Barcelona;6;138;B;;427;248;179;0;1;247;248
8;Barcelona;13;Barcelonès;08019;Barcelona;6;139;A;;755;441;314;1;4;436;440
8;Barcelona;13;Barcelonès;08019;Barcelona;6;14;A;;476;322;154;1;8;313;321
8;Barcelona;13;Barcelonès;08019;Barcelona;6;140;A;;615;411;204;1;5;405;410
8;Barcelona;13;Barcelonès;08019;Barcelona;6;141;A;;597;404;193;1;2;401;403
8;Barcelona;13;Barcelonès;08019;Barcelona;6;142;A;;746;423;323;6;3;414;417
8;Barcelona;13;Barcelonès;08019;Barcelona;6;143;A;;587;281;306;0;1;280;281
8;Barcelona;13;Barcelonès;08019;Barcelona;6;144;A;;725;420;305;2;2;416;418
8;Barcelona;13;Barcelonès;08019;Barcelona;6;145;A;;518;273;245;3;0;270;270
8;Barcelona;13;Barcelonès;08019;Barcelona;6;146;A;;789;383;406;3;2;378;380
8;Barcelona;13;Barcelonès;08019;Barcelona;6;147;A;;496;298;198;1;1;296;297
8;Barcelona;13;Barcelonès;08019;Barcelona;6;148;A;;588;348;240;15;1;332;333
8;Barcelona;13;Barcelonès;08019;Barcelona;6;149;A;;622;363;259;2;2;359;361
8;Barcelona;13;Barcelonès;08019;Barcelona;6;15;A;;505;306;199;0;2;304;306
8;Barcelona;13;Barcelonès;08019;Barcelona;6;150;A;;425;294;131;0;3;291;294
8;Barcelona;13;Barcelonès;08019;Barcelona;6;151;A;;712;441;271;2;2;437;439
8;Barcelona;13;Barcelonès;08019;Barcelona;6;152;A;;631;408;223;2;3;403;406
8;Barcelona;13;Barcelonès;08019;Barcelona;6;153;A;;792;489;303;1;4;484;488
8;Barcelona;13;Barcelonès;08019;Barcelona;6;154;A;;459;283;176;0;2;281;283
8;Barcelona;13;Barcelonès;08019;Barcelona;6;155;A;;542;338;204;0;0;338;338
8;Barcelona;13;Barcelonès;08019;Barcelona;6;155;B;;578;345;233;2;7;336;343
8;Barcelona;13;Barcelonès;08019;Barcelona;6;156;A;;356;208;148;7;0;201;201
8;Barcelona;13;Barcelonès;08019;Barcelona;6;157;A;;611;422;189;4;1;417;418
8;Barcelona;13;Barcelonès;08019;Barcelona;6;157;B;;615;393;222;1;5;387;392
8;Barcelona;13;Barcelonès;08019;Barcelona;6;157;C;;610;434;176;1;0;433;433
8;Barcelona;13;Barcelonès;08019;Barcelona;6;158;A;;596;369;227;8;4;357;361
8;Barcelona;13;Barcelonès;08019;Barcelona;6;159;A;;474;257;217;0;3;254;257
8;Barcelona;13;Barcelonès;08019;Barcelona;6;16;A;;761;460;301;0;4;456;460
8;Barcelona;13;Barcelonès;08019;Barcelona;6;17;A;;628;384;244;10;2;372;374
8;Barcelona;13;Barcelonès;08019;Barcelona;6;18;A;;428;270;158;0;1;269;270
8;Barcelona;13;Barcelonès;08019;Barcelona;6;18;B;;429;247;182;0;2;245;247
8;Barcelona;13;Barcelonès;08019;Barcelona;6;19;A;;679;460;219;0;0;460;460
8;Barcelona;13;Barcelonès;08019;Barcelona;6;2;A;;532;338;194;3;2;333;335
8;Barcelona;13;Barcelonès;08019;Barcelona;6;20;A;;430;267;163;1;1;265;266
8;Barcelona;13;Barcelonès;08019;Barcelona;6;20;B;;418;244;174;5;3;236;239
8;Barcelona;13;Barcelonès;08019;Barcelona;6;21;A;;676;446;230;3;1;442;443
8;Barcelona;13;Barcelonès;08019;Barcelona;6;22;A;;481;301;180;5;0;296;296
8;Barcelona;13;Barcelonès;08019;Barcelona;6;23;A;;525;349;176;3;0;346;346
8;Barcelona;13;Barcelonès;08019;Barcelona;6;23;B;;521;340;181;3;2;335;337
8;Barcelona;13;Barcelonès;08019;Barcelona;6;24;A;;317;201;116;2;2;197;199
8;Barcelona;13;Barcelonès;08019;Barcelona;6;25;A;;337;239;98;0;1;238;239
8;Barcelona;13;Barcelonès;08019;Barcelona;6;26;A;;504;326;178;0;1;325;326
8;Barcelona;13;Barcelonès;08019;Barcelona;6;27;A;;763;525;238;1;4;520;524
8;Barcelona;13;Barcelonès;08019;Barcelona;6;28;A;;708;448;260;1;5;442;447
8;Barcelona;13;Barcelonès;08019;Barcelona;6;29;A;;465;303;162;0;1;302;303
8;Barcelona;13;Barcelonès;08019;Barcelona;6;29;B;;471;313;158;1;1;311;312
8;Barcelona;13;Barcelonès;08019;Barcelona;6;3;A;;409;292;117;0;3;289;292
8;Barcelona;13;Barcelonès;08019;Barcelona;6;30;A;;795;511;284;2;1;508;509
8;Barcelona;13;Barcelonès;08019;Barcelona;6;31;A;;422;286;136;7;0;279;279
8;Barcelona;13;Barcelonès;08019;Barcelona;6;31;B;;438;291;147;7;2;282;284
8;Barcelona;13;Barcelonès;08019;Barcelona;6;32;A;;429;254;175;1;2;251;253
8;Barcelona;13;Barcelonès;08019;Barcelona;6;32;B;;434;277;157;9;0;268;268
8;Barcelona;13;Barcelonès;08019;Barcelona;6;33;A;;687;445;242;1;1;443;444
8;Barcelona;13;Barcelonès;08019;Barcelona;6;34;A;;427;297;130;0;2;295;297
8;Barcelona;13;Barcelonès;08019;Barcelona;6;34;B;;427;280;147;3;0;277;277
8;Barcelona;13;Barcelonès;08019;Barcelona;6;35;A;;501;334;167;4;4;326;330
8;Barcelona;13;Barcelonès;08019;Barcelona;6;35;B;;510;339;171;4;1;334;335
8;Barcelona;13;Barcelonès;08019;Barcelona;6;36;A;;600;434;166;1;1;432;433
8;Barcelona;13;Barcelonès;08019;Barcelona;6;37;A;;673;455;218;0;7;448;455
8;Barcelona;13;Barcelonès;08019;Barcelona;6;38;A;;721;511;210;0;5;506;511
8;Barcelona;13;Barcelonès;08019;Barcelona;6;39;A;;588;396;192;0;4;392;396
8;Barcelona;13;Barcelonès;08019;Barcelona;6;4;A;;597;397;200;12;3;382;385
8;Barcelona;13;Barcelonès;08019;Barcelona;6;40;A;;828;557;271;2;9;546;555
8;Barcelona;13;Barcelonès;08019;Barcelona;6;41;A;;628;394;234;0;2;392;394
8;Barcelona;13;Barcelonès;08019;Barcelona;6;41;B;;625;394;231;3;4;387;391
8;Barcelona;13;Barcelonès;08019;Barcelona;6;42;A;;516;353;163;0;3;350;353
8;Barcelona;13;Barcelonès;08019;Barcelona;6;42;B;;516;350;166;0;3;347;350
8;Barcelona;13;Barcelonès;08019;Barcelona;6;43;A;;419;289;130;0;5;284;289
8;Barcelona;13;Barcelonès;08019;Barcelona;6;43;B;;423;284;139;0;2;282;284
8;Barcelona;13;Barcelonès;08019;Barcelona;6;44;A;;562;341;221;0;2;339;341
8;Barcelona;13;Barcelonès;08019;Barcelona;6;45;A;;748;460;288;4;2;454;456
8;Barcelona;13;Barcelonès;08019;Barcelona;6;46;A;;254;47;207;0;0;47;47
8;Barcelona;13;Barcelonès;08019;Barcelona;6;47;A;;658;408;250;0;2;406;408
8;Barcelona;13;Barcelonès;08019;Barcelona;6;48;A;;528;340;188;0;0;340;340
8;Barcelona;13;Barcelonès;08019;Barcelona;6;49;A;;603;367;236;0;2;365;367
8;Barcelona;13;Barcelonès;08019;Barcelona;6;5;A;;540;389;151;1;6;382;388
8;Barcelona;13;Barcelonès;08019;Barcelona;6;50;A;;821;542;279;0;1;541;542
8;Barcelona;13;Barcelonès;08019;Barcelona;6;51;A;;472;292;180;0;1;291;292
8;Barcelona;13;Barcelonès;08019;Barcelona;6;52;A;;555;362;193;7;4;351;355
8;Barcelona;13;Barcelonès;08019;Barcelona;6;53;A;;499;306;193;1;1;304;305
8;Barcelona;13;Barcelonès;08019;Barcelona;6;54;A;;639;434;205;1;3;430;433
8;Barcelona;13;Barcelonès;08019;Barcelona;6;55;A;;744;480;264;1;1;478;479
8;Barcelona;13;Barcelonès;08019;Barcelona;6;56;A;;456;287;169;2;3;282;285
8;Barcelona;13;Barcelonès;08019;Barcelona;6;56;B;;456;258;198;2;2;254;256
8;Barcelona;13;Barcelonès;08019;Barcelona;6;57;A;;677;476;201;0;4;472;476
8;Barcelona;13;Barcelonès;08019;Barcelona;6;58;A;;704;505;199;0;6;499;505
8;Barcelona;13;Barcelonès;08019;Barcelona;6;59;A;;537;362;175;0;2;360;362
8;Barcelona;13;Barcelonès;08019;Barcelona;6;59;B;;532;356;176;0;4;352;356
8;Barcelona;13;Barcelonès;08019;Barcelona;6;6;A;;530;346;184;2;1;343;344
8;Barcelona;13;Barcelonès;08019;Barcelona;6;60;A;;609;423;186;0;4;419;423
8;Barcelona;13;Barcelonès;08019;Barcelona;6;61;A;;612;405;207;2;2;401;403
8;Barcelona;13;Barcelonès;08019;Barcelona;6;62;A;;529;341;188;3;1;337;338
8;Barcelona;13;Barcelonès;08019;Barcelona;6;63;A;;553;367;186;0;1;366;367
8;Barcelona;13;Barcelonès;08019;Barcelona;6;64;A;;455;300;155;0;1;299;300
8;Barcelona;13;Barcelonès;08019;Barcelona;6;65;A;;398;210;188;0;1;209;210
8;Barcelona;13;Barcelonès;08019;Barcelona;6;66;A;;631;358;273;5;5;348;353
8;Barcelona;13;Barcelonès;08019;Barcelona;6;67;A;;373;216;157;6;2;208;210
8;Barcelona;13;Barcelonès;08019;Barcelona;6;68;A;;520;332;188;4;1;327;328
8;Barcelona;13;Barcelonès;08019;Barcelona;6;69;A;;473;314;159;0;1;313;314
8;Barcelona;13;Barcelonès;08019;Barcelona;6;7;A;;666;424;242;0;3;421;424
8;Barcelona;13;Barcelonès;08019;Barcelona;6;70;A;;785;481;304;5;2;474;476
8;Barcelona;13;Barcelonès;08019;Barcelona;6;71;A;;489;311;178;1;1;309;310
8;Barcelona;13;Barcelonès;08019;Barcelona;6;72;A;;480;341;139;7;0;334;334
8;Barcelona;13;Barcelonès;08019;Barcelona;6;73;A;;480;311;169;1;0;310;310
8;Barcelona;13;Barcelonès;08019;Barcelona;6;74;A;;562;368;194;1;3;364;367
8;Barcelona;13;Barcelonès;08019;Barcelona;6;75;A;;459;303;156;6;3;294;297
8;Barcelona;13;Barcelonès;08019;Barcelona;6;76;A;;705;449;256;0;3;446;449
8;Barcelona;13;Barcelonès;08019;Barcelona;6;77;A;;615;388;227;2;3;383;386
8;Barcelona;13;Barcelonès;08019;Barcelona;6;78;A;;439;266;173;5;1;260;261
8;Barcelona;13;Barcelonès;08019;Barcelona;6;79;A;;532;336;196;0;4;332;336
8;Barcelona;13;Barcelonès;08019;Barcelona;6;8;A;;702;460;242;10;2;448;450
8;Barcelona;13;Barcelonès;08019;Barcelona;6;80;A;;474;282;192;0;2;280;282
8;Barcelona;13;Barcelonès;08019;Barcelona;6;81;A;;706;454;252;1;4;449;453
8;Barcelona;13;Barcelonès;08019;Barcelona;6;82;A;;498;313;185;3;0;310;310
8;Barcelona;13;Barcelonès;08019;Barcelona;6;83;A;;509;329;180;1;6;322;328
8;Barcelona;13;Barcelonès;08019;Barcelona;6;84;A;;737;469;268;0;2;467;469
8;Barcelona;13;Barcelonès;08019;Barcelona;6;85;A;;756;516;240;1;4;511;515
8;Barcelona;13;Barcelonès;08019;Barcelona;6;86;A;;548;370;178;8;1;361;362
8;Barcelona;13;Barcelonès;08019;Barcelona;6;87;A;;547;372;175;0;0;372;372
8;Barcelona;13;Barcelonès;08019;Barcelona;6;88;A;;531;356;175;0;3;353;356
8;Barcelona;13;Barcelonès;08019;Barcelona;6;89;A;;490;351;139;1;2;348;350
8;Barcelona;13;Barcelonès;08019;Barcelona;6;89;B;;476;345;131;1;1;343;344
8;Barcelona;13;Barcelonès;08019;Barcelona;6;9;A;;464;277;187;0;0;277;277
8;Barcelona;13;Barcelonès;08019;Barcelona;6;90;A;;677;432;245;4;2;426;428
8;Barcelona;13;Barcelonès;08019;Barcelona;6;91;A;;544;353;191;4;1;348;349
8;Barcelona;13;Barcelonès;08019;Barcelona;6;92;A;;593;396;197;6;2;388;390
8;Barcelona;13;Barcelonès;08019;Barcelona;6;93;A;;748;471;277;1;1;469;470
8;Barcelona;13;Barcelonès;08019;Barcelona;6;94;A;;424;295;129;1;1;293;294
8;Barcelona;13;Barcelonès;08019;Barcelona;6;94;B;;424;273;151;3;1;269;270
8;Barcelona;13;Barcelonès;08019;Barcelona;6;95;A;;637;448;189;4;1;443;444
8;Barcelona;13;Barcelonès;08019;Barcelona;6;96;A;;622;376;246;2;2;372;374
8;Barcelona;13;Barcelonès;08019;Barcelona;6;97;A;;512;348;164;3;1;344;345
8;Barcelona;13;Barcelonès;08019;Barcelona;6;97;B;;507;359;148;1;2;356;358
8;Barcelona;13;Barcelonès;08019;Barcelona;6;98;A;;380;260;120;0;2;258;260
8;Barcelona;13;Barcelonès;08019;Barcelona;6;99;A;;551;348;203;2;2;344;346
8;Barcelona;13;Barcelonès;08019;Barcelona;7;1;A;;598;385;213;0;1;384;385
8;Barcelona;13;Barcelonès;08019;Barcelona;7;1;B;;580;393;187;0;4;389;393
8;Barcelona;13;Barcelonès;08019;Barcelona;7;10;A;;422;247;175;0;3;244;247
8;Barcelona;13;Barcelonès;08019;Barcelona;7;10;B;;425;255;170;1;4;250;254
8;Barcelona;13;Barcelonès;08019;Barcelona;7;100;A;;441;224;217;0;2;222;224
8;Barcelona;13;Barcelonès;08019;Barcelona;7;101;A;;567;362;205;0;2;360;362
8;Barcelona;13;Barcelonès;08019;Barcelona;7;102;A;;494;301;193;0;2;299;301
8;Barcelona;13;Barcelonès;08019;Barcelona;7;103;A;;502;352;150;1;4;347;351
8;Barcelona;13;Barcelonès;08019;Barcelona;7;104;A;;534;317;217;0;2;315;317
8;Barcelona;13;Barcelonès;08019;Barcelona;7;104;B;;531;318;213;4;6;308;314
8;Barcelona;13;Barcelonès;08019;Barcelona;7;105;A;;565;372;193;2;2;368;370
8;Barcelona;13;Barcelonès;08019;Barcelona;7;106;A;;695;471;224;0;0;471;471
8;Barcelona;13;Barcelonès;08019;Barcelona;7;107;A;;503;360;143;1;4;355;359
8;Barcelona;13;Barcelonès;08019;Barcelona;7;108;A;;593;351;242;1;2;348;350
8;Barcelona;13;Barcelonès;08019;Barcelona;7;109;A;;656;364;292;9;3;352;355
8;Barcelona;13;Barcelonès;08019;Barcelona;7;11;A;;626;387;239;1;2;384;386
8;Barcelona;13;Barcelonès;08019;Barcelona;7;110;A;;434;233;201;0;0;233;233
8;Barcelona;13;Barcelonès;08019;Barcelona;7;111;A;;419;215;204;2;1;212;213
8;Barcelona;13;Barcelonès;08019;Barcelona;7;112;A;;592;284;308;0;2;282;284
8;Barcelona;13;Barcelonès;08019;Barcelona;7;113;A;;729;337;392;6;2;329;331
8;Barcelona;13;Barcelonès;08019;Barcelona;7;114;A;;770;393;377;2;1;390;391
8;Barcelona;13;Barcelonès;08019;Barcelona;7;115;A;;426;215;211;0;3;212;215
8;Barcelona;13;Barcelonès;08019;Barcelona;7;116;A;;451;229;222;1;2;226;228
8;Barcelona;13;Barcelonès;08019;Barcelona;7;116;B;;455;229;226;2;3;224;227
8;Barcelona;13;Barcelonès;08019;Barcelona;7;117;A;;797;419;378;1;3;415;418
8;Barcelona;13;Barcelonès;08019;Barcelona;7;118;A;;564;257;307;8;3;246;249
8;Barcelona;13;Barcelonès;08019;Barcelona;7;118;B;;562;261;301;5;0;256;256
8;Barcelona;13;Barcelonès;08019;Barcelona;7;119;A;;480;234;246;0;0;234;234
8;Barcelona;13;Barcelonès;08019;Barcelona;7;119;B;;490;240;250;0;1;239;240
8;Barcelona;13;Barcelonès;08019;Barcelona;7;12;A;;787;503;284;0;7;496;503
8;Barcelona;13;Barcelonès;08019;Barcelona;7;120;A;;700;322;378;0;1;321;322
8;Barcelona;13;Barcelonès;08019;Barcelona;7;121;A;;539;238;301;5;2;231;233
8;Barcelona;13;Barcelonès;08019;Barcelona;7;122;A;;465;200;265;0;0;200;200
8;Barcelona;13;Barcelonès;08019;Barcelona;7;122;B;;465;222;243;0;1;221;222
8;Barcelona;13;Barcelonès;08019;Barcelona;7;123;A;;418;192;226;4;1;187;188
8;Barcelona;13;Barcelonès;08019;Barcelona;7;124;A;;807;377;430;7;1;369;370
8;Barcelona;13;Barcelonès;08019;Barcelona;7;125;A;;247;247;0;0;1;246;247
8;Barcelona;13;Barcelonès;08019;Barcelona;7;125;B;;495;276;219;0;2;274;276
8;Barcelona;13;Barcelonès;08019;Barcelona;7;126;A;;508;252;256;3;1;248;249
8;Barcelona;13;Barcelonès;08019;Barcelona;7;126;B;;516;280;236;0;2;278;280
8;Barcelona;13;Barcelonès;08019;Barcelona;7;127;A;;715;329;386;0;3;326;329
8;Barcelona;13;Barcelonès;08019;Barcelona;7;128;A;;757;348;409;0;0;348;348
8;Barcelona;13;Barcelonès;08019;Barcelona;7;129;A;;619;330;289;0;0;330;330
8;Barcelona;13;Barcelonès;08019;Barcelona;7;13;A;;817;485;332;0;8;477;485
8;Barcelona;13;Barcelonès;08019;Barcelona;7;130;A;;455;227;228;2;1;224;225
8;Barcelona;13;Barcelonès;08019;Barcelona;7;131;A;;414;203;211;2;0;201;201
8;Barcelona;13;Barcelonès;08019;Barcelona;7;131;B;;419;198;221;1;0;197;197
8;Barcelona;13;Barcelonès;08019;Barcelona;7;132;A;;559;240;319;0;3;237;240
8;Barcelona;13;Barcelonès;08019;Barcelona;7;133;A;;468;225;243;0;0;225;225
8;Barcelona;13;Barcelonès;08019;Barcelona;7;133;B;;471;215;256;0;0;215;215
8;Barcelona;13;Barcelonès;08019;Barcelona;7;134;A;;417;218;199;0;2;216;218
8;Barcelona;13;Barcelonès;08019;Barcelona;7;134;B;;411;204;207;0;1;203;204
8;Barcelona;13;Barcelonès;08019;Barcelona;7;135;A;;470;244;226;0;2;242;244
8;Barcelona;13;Barcelonès;08019;Barcelona;7;136;A;;563;316;247;4;2;310;312
8;Barcelona;13;Barcelonès;08019;Barcelona;7;137;A;;478;308;170;6;4;298;302
8;Barcelona;13;Barcelonès;08019;Barcelona;7;138;A;;712;396;316;5;0;391;391
8;Barcelona;13;Barcelonès;08019;Barcelona;7;139;A;;562;270;292;4;0;266;266
8;Barcelona;13;Barcelonès;08019;Barcelona;7;139;B;;560;285;275;2;2;281;283
8;Barcelona;13;Barcelonès;08019;Barcelona;7;14;A;;578;298;280;0;3;295;298
8;Barcelona;13;Barcelonès;08019;Barcelona;7;140;A;;560;331;229;2;0;329;329
8;Barcelona;13;Barcelonès;08019;Barcelona;7;141;A;;639;368;271;1;2;365;367
8;Barcelona;13;Barcelonès;08019;Barcelona;7;142;A;;458;216;242;0;1;215;216
8;Barcelona;13;Barcelonès;08019;Barcelona;7;143;A;;672;362;310;2;1;359;360
8;Barcelona;13;Barcelonès;08019;Barcelona;7;144;A;;521;256;265;2;0;254;254
8;Barcelona;13;Barcelonès;08019;Barcelona;7;145;A;;646;323;323;0;1;322;323
8;Barcelona;13;Barcelonès;08019;Barcelona;7;146;A;;469;235;234;1;5;229;234
8;Barcelona;13;Barcelonès;08019;Barcelona;7;147;A;;415;234;181;0;5;229;234
8;Barcelona;13;Barcelonès;08019;Barcelona;7;147;B;;421;236;185;0;0;236;236
8;Barcelona;13;Barcelonès;08019;Barcelona;7;148;A;;643;358;285;1;3;354;357
8;Barcelona;13;Barcelonès;08019;Barcelona;7;149;A;;486;235;251;5;3;227;230
8;Barcelona;13;Barcelonès;08019;Barcelona;7;15;A;;512;286;226;1;3;282;285
8;Barcelona;13;Barcelonès;08019;Barcelona;7;150;A;;512;302;210;0;1;301;302
8;Barcelona;13;Barcelonès;08019;Barcelona;7;151;A;;673;346;327;0;3;343;346
8;Barcelona;13;Barcelonès;08019;Barcelona;7;152;A;;624;363;261;1;2;360;362
8;Barcelona;13;Barcelonès;08019;Barcelona;7;153;A;;387;231;156;2;1;228;229
8;Barcelona;13;Barcelonès;08019;Barcelona;7;154;A;;587;299;288;9;3;287;290
8;Barcelona;13;Barcelonès;08019;Barcelona;7;155;A;;438;273;165;0;1;272;273
8;Barcelona;13;Barcelonès;08019;Barcelona;7;156;A;;497;270;227;0;0;270;270
8;Barcelona;13;Barcelonès;08019;Barcelona;7;157;A;;632;392;240;0;6;386;392
8;Barcelona;13;Barcelonès;08019;Barcelona;7;158;A;;676;379;297;0;4;375;379
8;Barcelona;13;Barcelonès;08019;Barcelona;7;159;A;;673;397;276;0;0;397;397
8;Barcelona;13;Barcelonès;08019;Barcelona;7;16;A;;510;279;231;0;2;277;279
8;Barcelona;13;Barcelonès;08019;Barcelona;7;16;B;;514;300;214;0;0;300;300
8;Barcelona;13;Barcelonès;08019;Barcelona;7;160;A;;536;310;226;1;3;306;309
8;Barcelona;13;Barcelonès;08019;Barcelona;7;161;A;;489;314;175;0;2;312;314
8;Barcelona;13;Barcelonès;08019;Barcelona;7;162;A;;764;458;306;1;6;451;457
8;Barcelona;13;Barcelonès;08019;Barcelona;7;163;A;;620;371;249;4;5;362;367
8;Barcelona;13;Barcelonès;08019;Barcelona;7;164;A;;460;268;192;0;0;268;268
8;Barcelona;13;Barcelonès;08019;Barcelona;7;165;A;;632;350;282;4;4;342;346
8;Barcelona;13;Barcelonès;08019;Barcelona;7;166;A;;510;313;197;0;1;312;313
8;Barcelona;13;Barcelonès;08019;Barcelona;7;166;B;;502;325;177;0;4;321;325
8;Barcelona;13;Barcelonès;08019;Barcelona;7;167;A;;760;505;255;2;7;496;503
8;Barcelona;13;Barcelonès;08019;Barcelona;7;168;A;;174;106;68;0;2;104;106
8;Barcelona;13;Barcelonès;08019;Barcelona;7;169;A;;663;415;248;9;2;404;406
8;Barcelona;13;Barcelonès;08019;Barcelona;7;17;A;;533;317;216;1;3;313;316
8;Barcelona;13;Barcelonès;08019;Barcelona;7;170;A;;681;421;260;1;2;418;420
8;Barcelona;13;Barcelonès;08019;Barcelona;7;171;A;;323;180;143;1;0;179;179
8;Barcelona;13;Barcelonès;08019;Barcelona;7;172;A;;568;330;238;2;3;325;328
8;Barcelona;13;Barcelonès;08019;Barcelona;7;173;A;;389;236;153;1;0;235;235
8;Barcelona;13;Barcelonès;08019;Barcelona;7;174;A;;813;530;283;7;2;521;523
8;Barcelona;13;Barcelonès;08019;Barcelona;7;175;A;;761;414;347;1;0;413;413
8;Barcelona;13;Barcelonès;08019;Barcelona;7;176;A;;535;393;142;2;2;389;391
8;Barcelona;13;Barcelonès;08019;Barcelona;7;177;A;;733;432;301;11;0;421;421
8;Barcelona;13;Barcelonès;08019;Barcelona;7;178;A;;438;242;196;4;3;235;238
8;Barcelona;13;Barcelonès;08019;Barcelona;7;179;A;;616;371;245;0;1;370;371
8;Barcelona;13;Barcelonès;08019;Barcelona;7;18;A;;574;335;239;1;5;329;334
8;Barcelona;13;Barcelonès;08019;Barcelona;7;180;A;;641;350;291;0;5;345;350
8;Barcelona;13;Barcelonès;08019;Barcelona;7;181;A;;471;239;232;6;0;233;233
8;Barcelona;13;Barcelonès;08019;Barcelona;7;182;A;;416;239;177;2;2;235;237
8;Barcelona;13;Barcelonès;08019;Barcelona;7;183;A;;653;306;347;0;2;304;306
8;Barcelona;13;Barcelonès;08019;Barcelona;7;184;A;;523;273;250;0;1;272;273
8;Barcelona;13;Barcelonès;08019;Barcelona;7;184;B;;509;286;223;0;0;286;286
8;Barcelona;13;Barcelonès;08019;Barcelona;7;185;A;;544;380;164;0;1;379;380
8;Barcelona;13;Barcelonès;08019;Barcelona;7;186;A;;358;190;168;3;0;187;187
8;Barcelona;13;Barcelonès;08019;Barcelona;7;187;A;;438;215;223;3;1;211;212
8;Barcelona;13;Barcelonès;08019;Barcelona;7;188;A;;778;409;369;7;2;400;402
8;Barcelona;13;Barcelonès;08019;Barcelona;7;189;A;;778;393;385;2;2;389;391
8;Barcelona;13;Barcelonès;08019;Barcelona;7;19;A;;752;473;279;0;5;468;473
8;Barcelona;13;Barcelonès;08019;Barcelona;7;190;A;;664;372;292;3;2;367;369
8;Barcelona;13;Barcelonès;08019;Barcelona;7;190;B;;673;358;315;0;3;355;358
8;Barcelona;13;Barcelonès;08019;Barcelona;7;191;A;;447;232;215;1;1;230;231
8;Barcelona;13;Barcelonès;08019;Barcelona;7;191;B;;447;220;227;0;0;220;220
8;Barcelona;13;Barcelonès;08019;Barcelona;7;192;A;;558;318;240;0;2;316;318
8;Barcelona;13;Barcelonès;08019;Barcelona;7;192;B;;570;309;261;0;2;307;309
8;Barcelona;13;Barcelonès;08019;Barcelona;7;193;A;;625;315;310;0;5;310;315
8;Barcelona;13;Barcelonès;08019;Barcelona;7;194;A;;509;353;156;0;3;350;353
8;Barcelona;13;Barcelonès;08019;Barcelona;7;195;A;;451;227;224;1;0;226;226
8;Barcelona;13;Barcelonès;08019;Barcelona;7;195;B;;435;236;199;0;2;234;236
8;Barcelona;13;Barcelonès;08019;Barcelona;7;196;A;;503;283;220;0;3;280;283
8;Barcelona;13;Barcelonès;08019;Barcelona;7;196;B;;501;281;220;0;3;278;281
8;Barcelona;13;Barcelonès;08019;Barcelona;7;197;A;;467;278;189;1;1;276;277
8;Barcelona;13;Barcelonès;08019;Barcelona;7;197;B;;485;306;179;0;4;302;306
8;Barcelona;13;Barcelonès;08019;Barcelona;7;198;A;;565;302;263;0;2;300;302
8;Barcelona;13;Barcelonès;08019;Barcelona;7;199;A;;472;299;173;1;2;296;298
8;Barcelona;13;Barcelonès;08019;Barcelona;7;2;A;;706;431;275;3;1;427;428
8;Barcelona;13;Barcelonès;08019;Barcelona;7;20;A;;745;441;304;0;3;438;441
8;Barcelona;13;Barcelonès;08019;Barcelona;7;200;A;;421;243;178;2;2;239;241
8;Barcelona;13;Barcelonès;08019;Barcelona;7;200;B;;424;264;160;0;5;259;264
8;Barcelona;13;Barcelonès;08019;Barcelona;7;201;A;;446;230;216;1;4;225;229
8;Barcelona;13;Barcelonès;08019;Barcelona;7;201;B;;450;280;170;1;4;275;279
8;Barcelona;13;Barcelonès;08019;Barcelona;7;202;A;;809;523;286;3;7;513;520
8;Barcelona;13;Barcelonès;08019;Barcelona;7;203;A;;584;319;265;7;2;310;312
8;Barcelona;13;Barcelonès;08019;Barcelona;7;204;A;;413;244;169;0;2;242;244
8;Barcelona;13;Barcelonès;08019;Barcelona;7;205;A;;581;324;257;1;5;318;323
8;Barcelona;13;Barcelonès;08019;Barcelona;7;205;B;;589;313;276;0;2;311;313
8;Barcelona;13;Barcelonès;08019;Barcelona;7;206;A;;718;409;309;1;2;406;408
8;Barcelona;13;Barcelonès;08019;Barcelona;7;207;A;;627;378;249;1;3;374;377
8;Barcelona;13;Barcelonès;08019;Barcelona;7;207;B;;619;360;259;2;8;350;358
8;Barcelona;13;Barcelonès;08019;Barcelona;7;208;A;;242;126;116;0;0;126;126
8;Barcelona;13;Barcelonès;08019;Barcelona;7;209;A;;518;284;234;0;0;284;284
8;Barcelona;13;Barcelonès;08019;Barcelona;7;21;A;;272;178;94;1;1;176;177
8;Barcelona;13;Barcelonès;08019;Barcelona;7;210;A;;455;246;209;2;0;244;244
8;Barcelona;13;Barcelonès;08019;Barcelona;7;210;B;;441;245;196;1;2;242;244
8;Barcelona;13;Barcelonès;08019;Barcelona;7;211;A;;527;242;285;0;1;241;242
8;Barcelona;13;Barcelonès;08019;Barcelona;7;211;B;;519;237;282;0;4;233;237
8;Barcelona;13;Barcelonès;08019;Barcelona;7;212;A;;433;198;235;0;2;196;198
8;Barcelona;13;Barcelonès;08019;Barcelona;7;213;A;;688;400;288;8;2;390;392
8;Barcelona;13;Barcelonès;08019;Barcelona;7;214;A;;580;306;274;2;0;304;304
8;Barcelona;13;Barcelonès;08019;Barcelona;7;215;A;;569;285;284;0;1;284;285
8;Barcelona;13;Barcelonès;08019;Barcelona;7;216;A;;426;186;240;0;0;186;186
8;Barcelona;13;Barcelonès;08019;Barcelona;7;217;A;;518;258;260;2;1;255;256
8;Barcelona;13;Barcelonès;08019;Barcelona;7;218;A;;753;378;375;0;2;376;378
8;Barcelona;13;Barcelonès;08019;Barcelona;7;219;A;;743;388;355;3;2;383;385
8;Barcelona;13;Barcelonès;08019;Barcelona;7;22;A;;275;181;94;0;1;180;181
8;Barcelona;13;Barcelonès;08019;Barcelona;7;220;A;;738;380;358;1;1;378;379
8;Barcelona;13;Barcelonès;08019;Barcelona;7;221;A;;685;362;323;2;5;355;360
8;Barcelona;13;Barcelonès;08019;Barcelona;7;222;A;;425;246;179;5;3;238;241
8;Barcelona;13;Barcelonès;08019;Barcelona;7;23;A;;667;402;265;0;5;397;402
8;Barcelona;13;Barcelonès;08019;Barcelona;7;24;A;;531;295;236;0;3;292;295
8;Barcelona;13;Barcelonès;08019;Barcelona;7;25;A;;426;261;165;0;1;260;261
8;Barcelona;13;Barcelonès;08019;Barcelona;7;26;A;;580;339;241;0;1;338;339
8;Barcelona;13;Barcelonès;08019;Barcelona;7;27;A;;556;339;217;0;1;338;339
8;Barcelona;13;Barcelonès;08019;Barcelona;7;28;A;;567;333;234;3;3;327;330
8;Barcelona;13;Barcelonès;08019;Barcelona;7;29;A;;487;283;204;2;2;279;281
8;Barcelona;13;Barcelonès;08019;Barcelona;7;3;A;;703;403;300;7;3;393;396
8;Barcelona;13;Barcelonès;08019;Barcelona;7;30;A;;355;192;163;0;4;188;192
8;Barcelona;13;Barcelonès;08019;Barcelona;7;31;A;;802;511;291;1;8;502;510
8;Barcelona;13;Barcelonès;08019;Barcelona;7;32;A;;514;304;210;1;1;302;303
8;Barcelona;13;Barcelonès;08019;Barcelona;7;33;A;;571;361;210;0;4;357;361
8;Barcelona;13;Barcelonès;08019;Barcelona;7;34;A;;655;362;293;0;3;359;362
8;Barcelona;13;Barcelonès;08019;Barcelona;7;35;A;;359;223;136;1;5;217;222
8;Barcelona;13;Barcelonès;08019;Barcelona;7;36;A;;515;326;189;0;3;323;326
8;Barcelona;13;Barcelonès;08019;Barcelona;7;37;A;;520;339;181;0;2;337;339
8;Barcelona;13;Barcelonès;08019;Barcelona;7;38;A;;731;394;337;0;2;392;394
8;Barcelona;13;Barcelonès;08019;Barcelona;7;39;A;;610;380;230;2;4;374;378
8;Barcelona;13;Barcelonès;08019;Barcelona;7;4;A;;503;308;195;0;2;306;308
8;Barcelona;13;Barcelonès;08019;Barcelona;7;40;A;;579;350;229;0;7;343;350
8;Barcelona;13;Barcelonès;08019;Barcelona;7;41;A;;563;360;203;2;7;351;358
8;Barcelona;13;Barcelonès;08019;Barcelona;7;42;A;;573;353;220;0;1;352;353
8;Barcelona;13;Barcelonès;08019;Barcelona;7;43;A;;811;510;301;0;2;508;510
8;Barcelona;13;Barcelonès;08019;Barcelona;7;44;A;;703;441;262;2;3;436;439
8;Barcelona;13;Barcelonès;08019;Barcelona;7;45;A;;442;309;133;0;3;306;309
8;Barcelona;13;Barcelonès;08019;Barcelona;7;45;B;;437;276;161;0;2;274;276
8;Barcelona;13;Barcelonès;08019;Barcelona;7;46;A;;344;223;121;4;1;218;219
8;Barcelona;13;Barcelonès;08019;Barcelona;7;47;A;;512;306;206;0;1;305;306
8;Barcelona;13;Barcelonès;08019;Barcelona;7;48;A;;566;331;235;6;3;322;325
8;Barcelona;13;Barcelonès;08019;Barcelona;7;49;A;;462;307;155;3;2;302;304
8;Barcelona;13;Barcelonès;08019;Barcelona;7;5;A;;439;256;183;0;6;250;256
8;Barcelona;13;Barcelonès;08019;Barcelona;7;50;A;;696;415;281;1;0;414;414
8;Barcelona;13;Barcelonès;08019;Barcelona;7;51;A;;452;282;170;0;0;282;282
8;Barcelona;13;Barcelonès;08019;Barcelona;7;51;B;;447;273;174;1;4;268;272
8;Barcelona;13;Barcelonès;08019;Barcelona;7;52;A;;614;348;266;0;0;348;348
8;Barcelona;13;Barcelonès;08019;Barcelona;7;53;A;;573;351;222;1;6;344;350
8;Barcelona;13;Barcelonès;08019;Barcelona;7;54;A;;564;358;206;0;4;354;358
8;Barcelona;13;Barcelonès;08019;Barcelona;7;55;A;;478;295;183;2;2;291;293
8;Barcelona;13;Barcelonès;08019;Barcelona;7;55;B;;481;281;200;1;2;278;280
8;Barcelona;13;Barcelonès;08019;Barcelona;7;56;A;;615;377;238;1;3;373;376
8;Barcelona;13;Barcelonès;08019;Barcelona;7;57;A;;545;347;198;7;2;338;340
8;Barcelona;13;Barcelonès;08019;Barcelona;7;57;B;;554;345;209;1;7;337;344
8;Barcelona;13;Barcelonès;08019;Barcelona;7;58;A;;704;399;305;2;1;396;397
8;Barcelona;13;Barcelonès;08019;Barcelona;7;59;A;;362;191;171;5;1;185;186
8;Barcelona;13;Barcelonès;08019;Barcelona;7;6;A;;617;266;351;2;1;263;264
8;Barcelona;13;Barcelonès;08019;Barcelona;7;60;A;;431;213;218;0;2;211;213
8;Barcelona;13;Barcelonès;08019;Barcelona;7;61;A;;517;356;161;0;1;355;356
8;Barcelona;13;Barcelonès;08019;Barcelona;7;62;A;;549;305;244;0;4;301;305
8;Barcelona;13;Barcelonès;08019;Barcelona;7;63;A;;431;279;152;1;4;274;278
8;Barcelona;13;Barcelonès;08019;Barcelona;7;64;A;;646;378;268;0;1;377;378
8;Barcelona;13;Barcelonès;08019;Barcelona;7;65;A;;450;261;189;0;2;259;261
8;Barcelona;13;Barcelonès;08019;Barcelona;7;65;B;;442;263;179;1;1;261;262
8;Barcelona;13;Barcelonès;08019;Barcelona;7;66;A;;652;392;260;6;1;385;386
8;Barcelona;13;Barcelonès;08019;Barcelona;7;67;A;;599;338;261;6;4;328;332
8;Barcelona;13;Barcelonès;08019;Barcelona;7;68;A;;615;368;247;0;2;366;368
8;Barcelona;13;Barcelonès;08019;Barcelona;7;69;A;;457;267;190;2;0;265;265
8;Barcelona;13;Barcelonès;08019;Barcelona;7;7;A;;587;384;203;0;2;382;384
8;Barcelona;13;Barcelonès;08019;Barcelona;7;70;A;;429;241;188;1;1;239;240
8;Barcelona;13;Barcelonès;08019;Barcelona;7;71;A;;623;349;274;4;1;344;345
8;Barcelona;13;Barcelonès;08019;Barcelona;7;72;A;;631;397;234;0;4;393;397
8;Barcelona;13;Barcelonès;08019;Barcelona;7;72;B;;594;392;202;1;3;388;391
8;Barcelona;13;Barcelonès;08019;Barcelona;7;72;C;;587;386;201;0;3;383;386
8;Barcelona;13;Barcelonès;08019;Barcelona;7;73;A;;486;283;203;1;0;282;282
8;Barcelona;13;Barcelonès;08019;Barcelona;7;74;A;;785;428;357;7;5;416;421
8;Barcelona;13;Barcelonès;08019;Barcelona;7;75;A;;477;274;203;0;2;272;274
8;Barcelona;13;Barcelonès;08019;Barcelona;7;75;B;;481;241;240;0;0;241;241
8;Barcelona;13;Barcelonès;08019;Barcelona;7;76;A;;713;399;314;1;5;393;398
8;Barcelona;13;Barcelonès;08019;Barcelona;7;77;A;;464;290;174;0;3;287;290
8;Barcelona;13;Barcelonès;08019;Barcelona;7;78;A;;576;351;225;1;2;348;350
8;Barcelona;13;Barcelonès;08019;Barcelona;7;78;B;;565;319;246;8;0;311;311
8;Barcelona;13;Barcelonès;08019;Barcelona;7;78;C;;575;342;233;2;2;338;340
8;Barcelona;13;Barcelonès;08019;Barcelona;7;79;A;;710;457;253;1;6;450;456
8;Barcelona;13;Barcelonès;08019;Barcelona;7;79;B;;708;425;283;0;2;423;425
8;Barcelona;13;Barcelonès;08019;Barcelona;7;8;A;;737;429;308;4;1;424;425
8;Barcelona;13;Barcelonès;08019;Barcelona;7;8;B;;711;452;259;4;4;444;448
8;Barcelona;13;Barcelonès;08019;Barcelona;7;80;A;;746;466;280;4;1;461;462
8;Barcelona;13;Barcelonès;08019;Barcelona;7;81;A;;481;278;203;0;3;275;278
8;Barcelona;13;Barcelonès;08019;Barcelona;7;81;B;;489;304;185;0;4;300;304
8;Barcelona;13;Barcelonès;08019;Barcelona;7;82;A;;363;227;136;0;1;226;227
8;Barcelona;13;Barcelonès;08019;Barcelona;7;83;A;;636;344;292;1;2;341;343
8;Barcelona;13;Barcelonès;08019;Barcelona;7;84;A;;448;261;187;5;2;254;256
8;Barcelona;13;Barcelonès;08019;Barcelona;7;84;B;;452;278;174;1;1;276;277
8;Barcelona;13;Barcelonès;08019;Barcelona;7;85;A;;573;352;221;0;2;350;352
8;Barcelona;13;Barcelonès;08019;Barcelona;7;86;A;;474;318;156;2;0;316;316
8;Barcelona;13;Barcelonès;08019;Barcelona;7;87;A;;425;275;150;1;2;272;274
8;Barcelona;13;Barcelonès;08019;Barcelona;7;88;A;;531;321;210;0;1;320;321
8;Barcelona;13;Barcelonès;08019;Barcelona;7;88;B;;508;295;213;0;2;293;295
8;Barcelona;13;Barcelonès;08019;Barcelona;7;89;A;;495;313;182;2;2;309;311
8;Barcelona;13;Barcelonès;08019;Barcelona;7;9;A;;570;354;216;2;6;346;352
8;Barcelona;13;Barcelonès;08019;Barcelona;7;9;B;;560;359;201;2;1;356;357
8;Barcelona;13;Barcelonès;08019;Barcelona;7;90;A;;447;220;227;1;1;218;219
8;Barcelona;13;Barcelonès;08019;Barcelona;7;91;A;;472;274;198;0;2;272;274
8;Barcelona;13;Barcelonès;08019;Barcelona;7;91;B;;470;282;188;1;6;275;281
8;Barcelona;13;Barcelonès;08019;Barcelona;7;92;A;;711;349;362;10;0;339;339
8;Barcelona;13;Barcelonès;08019;Barcelona;7;93;A;;779;415;364;1;0;414;414
8;Barcelona;13;Barcelonès;08019;Barcelona;7;93;B;;795;420;375;0;2;418;420
8;Barcelona;13;Barcelonès;08019;Barcelona;7;93;C;;777;452;325;3;3;446;449
8;Barcelona;13;Barcelonès;08019;Barcelona;7;94;A;;791;344;447;0;3;341;344
8;Barcelona;13;Barcelonès;08019;Barcelona;7;95;A;;472;227;245;1;1;225;226
8;Barcelona;13;Barcelonès;08019;Barcelona;7;96;A;;450;215;235;0;2;213;215
8;Barcelona;13;Barcelonès;08019;Barcelona;7;96;B;;467;231;236;0;3;228;231
8;Barcelona;13;Barcelonès;08019;Barcelona;7;97;A;;773;372;401;0;2;370;372
8;Barcelona;13;Barcelonès;08019;Barcelona;7;98;A;;720;380;340;0;4;376;380
8;Barcelona;13;Barcelonès;08019;Barcelona;7;99;A;;395;263;132;0;2;261;263
8;Barcelona;13;Barcelonès;08019;Barcelona;8;1;A;;595;314;281;0;1;313;314
8;Barcelona;13;Barcelonès;08019;Barcelona;8;1;B;;602;349;253;1;3;345;348
8;Barcelona;13;Barcelonès;08019;Barcelona;8;10;A;;448;229;219;4;1;224;225
8;Barcelona;13;Barcelonès;08019;Barcelona;8;10;B;;448;226;222;1;3;222;225
8;Barcelona;13;Barcelonès;08019;Barcelona;8;100;A;;442;258;184;0;5;253;258
8;Barcelona;13;Barcelonès;08019;Barcelona;8;100;B;;452;251;201;0;2;249;251
8;Barcelona;13;Barcelonès;08019;Barcelona;8;101;A;;562;305;257;1;1;303;304
8;Barcelona;13;Barcelonès;08019;Barcelona;8;101;B;;573;283;290;8;0;275;275
8;Barcelona;13;Barcelonès;08019;Barcelona;8;102;A;;714;358;356;6;1;351;352
8;Barcelona;13;Barcelonès;08019;Barcelona;8;103;A;;417;228;189;0;0;228;228
8;Barcelona;13;Barcelonès;08019;Barcelona;8;104;A;;457;191;266;0;1;190;191
8;Barcelona;13;Barcelonès;08019;Barcelona;8;105;A;;560;251;309;7;0;244;244
8;Barcelona;13;Barcelonès;08019;Barcelona;8;106;A;;542;307;235;0;0;307;307
8;Barcelona;13;Barcelonès;08019;Barcelona;8;107;A;;481;226;255;4;0;222;222
8;Barcelona;13;Barcelonès;08019;Barcelona;8;107;B;;476;253;223;0;0;253;253
8;Barcelona;13;Barcelonès;08019;Barcelona;8;108;A;;447;251;196;7;2;242;244
8;Barcelona;13;Barcelonès;08019;Barcelona;8;109;A;;410;223;187;1;0;222;222
8;Barcelona;13;Barcelonès;08019;Barcelona;8;109;B;;401;227;174;2;2;223;225
8;Barcelona;13;Barcelonès;08019;Barcelona;8;11;A;;793;443;350;0;4;439;443
8;Barcelona;13;Barcelonès;08019;Barcelona;8;110;A;;427;210;217;1;2;207;209
8;Barcelona;13;Barcelonès;08019;Barcelona;8;111;A;;647;342;305;4;1;337;338
8;Barcelona;13;Barcelonès;08019;Barcelona;8;112;A;;663;334;329;4;1;329;330
8;Barcelona;13;Barcelonès;08019;Barcelona;8;113;A;;450;241;209;0;1;240;241
8;Barcelona;13;Barcelonès;08019;Barcelona;8;113;B;;464;266;198;0;1;265;266
8;Barcelona;13;Barcelonès;08019;Barcelona;8;114;A;;482;238;244;0;3;235;238
8;Barcelona;13;Barcelonès;08019;Barcelona;8;114;B;;492;237;255;0;1;236;237
8;Barcelona;13;Barcelonès;08019;Barcelona;8;115;A;;481;274;207;1;1;272;273
8;Barcelona;13;Barcelonès;08019;Barcelona;8;116;A;;559;285;274;0;1;284;285
8;Barcelona;13;Barcelonès;08019;Barcelona;8;116;B;;552;299;253;3;4;292;296
8;Barcelona;13;Barcelonès;08019;Barcelona;8;117;A;;727;397;330;1;0;396;396
8;Barcelona;13;Barcelonès;08019;Barcelona;8;118;A;;524;262;262;2;1;259;260
8;Barcelona;13;Barcelonès;08019;Barcelona;8;119;A;;446;229;217;0;0;229;229
8;Barcelona;13;Barcelonès;08019;Barcelona;8;12;A;;648;345;303;2;1;342;343
8;Barcelona;13;Barcelonès;08019;Barcelona;8;120;A;;458;229;229;0;0;229;229
8;Barcelona;13;Barcelonès;08019;Barcelona;8;121;A;;654;283;371;0;0;283;283
8;Barcelona;13;Barcelonès;08019;Barcelona;8;122;A;;517;292;225;2;2;288;290
8;Barcelona;13;Barcelonès;08019;Barcelona;8;122;B;;517;270;247;4;1;265;266
8;Barcelona;13;Barcelonès;08019;Barcelona;8;123;A;;551;305;246;4;1;300;301
8;Barcelona;13;Barcelonès;08019;Barcelona;8;124;A;;441;208;233;3;1;204;205
8;Barcelona;13;Barcelonès;08019;Barcelona;8;125;A;;485;224;261;1;0;223;223
8;Barcelona;13;Barcelonès;08019;Barcelona;8;126;A;;602;296;306;8;4;284;288
8;Barcelona;13;Barcelonès;08019;Barcelona;8;127;A;;783;395;388;11;3;381;384
8;Barcelona;13;Barcelonès;08019;Barcelona;8;128;A;;523;280;243;2;2;276;278
8;Barcelona;13;Barcelonès;08019;Barcelona;8;129;A;;607;259;348;2;1;256;257
8;Barcelona;13;Barcelonès;08019;Barcelona;8;13;A;;467;267;200;0;3;264;267
8;Barcelona;13;Barcelonès;08019;Barcelona;8;13;B;;470;248;222;0;1;247;248
8;Barcelona;13;Barcelonès;08019;Barcelona;8;130;A;;471;256;215;3;1;252;253
8;Barcelona;13;Barcelonès;08019;Barcelona;8;131;A;;587;299;288;4;1;294;295
8;Barcelona;13;Barcelonès;08019;Barcelona;8;132;A;;550;273;277;0;1;272;273
8;Barcelona;13;Barcelonès;08019;Barcelona;8;133;A;;652;335;317;3;1;331;332
8;Barcelona;13;Barcelonès;08019;Barcelona;8;134;A;;575;327;248;0;0;327;327
8;Barcelona;13;Barcelonès;08019;Barcelona;8;135;A;;646;330;316;1;2;327;329
8;Barcelona;13;Barcelonès;08019;Barcelona;8;136;A;;634;318;316;0;7;311;318
8;Barcelona;13;Barcelonès;08019;Barcelona;8;137;A;;461;266;195;5;2;259;261
8;Barcelona;13;Barcelonès;08019;Barcelona;8;138;A;;373;206;167;0;0;206;206
8;Barcelona;13;Barcelonès;08019;Barcelona;8;139;A;;364;157;207;6;0;151;151
8;Barcelona;13;Barcelonès;08019;Barcelona;8;14;A;;570;320;250;0;2;318;320
8;Barcelona;13;Barcelonès;08019;Barcelona;8;140;A;;546;261;285;0;2;259;261
8;Barcelona;13;Barcelonès;08019;Barcelona;8;140;B;;535;266;269;2;0;264;264
8;Barcelona;13;Barcelonès;08019;Barcelona;8;141;A;;502;271;231;11;5;255;260
8;Barcelona;13;Barcelonès;08019;Barcelona;8;141;B;;505;270;235;11;0;259;259
8;Barcelona;13;Barcelonès;08019;Barcelona;8;142;A;;721;365;356;6;3;356;359
8;Barcelona;13;Barcelonès;08019;Barcelona;8;142;B;;726;373;353;4;1;368;369
8;Barcelona;13;Barcelonès;08019;Barcelona;8;143;A;;590;331;259;1;1;329;330
8;Barcelona;13;Barcelonès;08019;Barcelona;8;143;B;;591;347;244;0;1;346;347
8;Barcelona;13;Barcelonès;08019;Barcelona;8;144;A;;508;263;245;2;0;261;261
8;Barcelona;13;Barcelonès;08019;Barcelona;8;144;B;;501;271;230;5;0;266;266
8;Barcelona;13;Barcelonès;08019;Barcelona;8;145;A;;614;325;289;3;2;320;322
8;Barcelona;13;Barcelonès;08019;Barcelona;8;146;A;;490;267;223;2;0;265;265
8;Barcelona;13;Barcelonès;08019;Barcelona;8;147;A;;618;295;323;5;1;289;290
8;Barcelona;13;Barcelonès;08019;Barcelona;8;148;A;;468;242;226;1;1;240;241
8;Barcelona;13;Barcelonès;08019;Barcelona;8;149;A;;702;393;309;2;5;386;391
8;Barcelona;13;Barcelonès;08019;Barcelona;8;15;A;;432;249;183;0;3;246;249
8;Barcelona;13;Barcelonès;08019;Barcelona;8;150;A;;712;370;342;1;2;367;369
8;Barcelona;13;Barcelonès;08019;Barcelona;8;151;A;;658;325;333;3;1;321;322
8;Barcelona;13;Barcelonès;08019;Barcelona;8;152;A;;479;260;219;0;3;257;260
8;Barcelona;13;Barcelonès;08019;Barcelona;8;152;B;;472;255;217;4;2;249;251
8;Barcelona;13;Barcelonès;08019;Barcelona;8;153;A;;652;328;324;0;2;326;328
8;Barcelona;13;Barcelonès;08019;Barcelona;8;154;A;;726;385;341;3;3;379;382
8;Barcelona;13;Barcelonès;08019;Barcelona;8;155;A;;751;379;372;3;2;374;376
8;Barcelona;13;Barcelonès;08019;Barcelona;8;156;A;;606;302;304;4;2;296;298
8;Barcelona;13;Barcelonès;08019;Barcelona;8;157;A;;436;206;230;2;0;204;204
8;Barcelona;13;Barcelonès;08019;Barcelona;8;157;B;;440;218;222;8;1;209;210
8;Barcelona;13;Barcelonès;08019;Barcelona;8;158;A;;464;212;252;0;3;209;212
8;Barcelona;13;Barcelonès;08019;Barcelona;8;159;A;;592;313;279;0;4;309;313
8;Barcelona;13;Barcelonès;08019;Barcelona;8;16;A;;467;265;202;0;2;263;265
8;Barcelona;13;Barcelonès;08019;Barcelona;8;160;A;;498;249;249;0;1;248;249
8;Barcelona;13;Barcelonès;08019;Barcelona;8;160;B;;501;243;258;0;1;242;243
8;Barcelona;13;Barcelonès;08019;Barcelona;8;161;A;;427;198;229;4;0;194;194
8;Barcelona;13;Barcelonès;08019;Barcelona;8;161;B;;437;219;218;0;3;216;219
8;Barcelona;13;Barcelonès;08019;Barcelona;8;162;A;;407;209;198;8;2;199;201
8;Barcelona;13;Barcelonès;08019;Barcelona;8;162;B;;413;180;233;8;1;171;172
8;Barcelona;13;Barcelonès;08019;Barcelona;8;163;A;;419;198;221;5;0;193;193
8;Barcelona;13;Barcelonès;08019;Barcelona;8;163;B;;427;205;222;0;2;203;205
8;Barcelona;13;Barcelonès;08019;Barcelona;8;164;A;;741;349;392;0;1;348;349
8;Barcelona;13;Barcelonès;08019;Barcelona;8;165;A;;504;243;261;1;0;242;242
8;Barcelona;13;Barcelonès;08019;Barcelona;8;166;A;;505;240;265;0;1;239;240
8;Barcelona;13;Barcelonès;08019;Barcelona;8;166;B;;511;274;237;0;0;274;274
8;Barcelona;13;Barcelonès;08019;Barcelona;8;167;A;;723;306;417;1;1;304;305
8;Barcelona;13;Barcelonès;08019;Barcelona;8;168;A;;457;238;219;7;3;228;231
8;Barcelona;13;Barcelonès;08019;Barcelona;8;169;A;;352;207;145;0;1;206;207
8;Barcelona;13;Barcelonès;08019;Barcelona;8;17;A;;517;330;187;0;4;326;330
8;Barcelona;13;Barcelonès;08019;Barcelona;8;170;A;;698;365;333;0;1;364;365
8;Barcelona;13;Barcelonès;08019;Barcelona;8;171;A;;449;233;216;0;3;230;233
8;Barcelona;13;Barcelonès;08019;Barcelona;8;171;B;;455;261;194;8;1;252;253
8;Barcelona;13;Barcelonès;08019;Barcelona;8;172;A;;759;394;365;1;0;393;393
8;Barcelona;13;Barcelonès;08019;Barcelona;8;173;A;;614;308;306;0;2;306;308
8;Barcelona;13;Barcelonès;08019;Barcelona;8;174;A;;563;304;259;2;4;298;302
8;Barcelona;13;Barcelonès;08019;Barcelona;8;175;A;;527;277;250;0;0;277;277
8;Barcelona;13;Barcelonès;08019;Barcelona;8;176;A;;461;216;245;0;1;215;216
8;Barcelona;13;Barcelonès;08019;Barcelona;8;177;A;;394;187;207;0;0;187;187
8;Barcelona;13;Barcelonès;08019;Barcelona;8;178;A;;757;377;380;3;3;371;374
8;Barcelona;13;Barcelonès;08019;Barcelona;8;179;A;;324;216;108;1;0;215;215
8;Barcelona;13;Barcelonès;08019;Barcelona;8;18;A;;492;280;212;1;1;278;279
8;Barcelona;13;Barcelonès;08019;Barcelona;8;18;B;;489;312;177;1;1;310;311
8;Barcelona;13;Barcelonès;08019;Barcelona;8;180;A;;553;277;276;3;0;274;274
8;Barcelona;13;Barcelonès;08019;Barcelona;8;181;A;;679;363;316;0;6;357;363
8;Barcelona;13;Barcelonès;08019;Barcelona;8;182;A;;575;321;254;2;2;317;319
8;Barcelona;13;Barcelonès;08019;Barcelona;8;183;A;;813;405;408;1;1;403;404
8;Barcelona;13;Barcelonès;08019;Barcelona;8;184;A;;698;356;342;0;4;352;356
8;Barcelona;13;Barcelonès;08019;Barcelona;8;185;A;;732;349;383;0;2;347;349
8;Barcelona;13;Barcelonès;08019;Barcelona;8;186;A;;438;187;251;1;0;186;186
8;Barcelona;13;Barcelonès;08019;Barcelona;8;186;B;;410;175;235;1;1;173;174
8;Barcelona;13;Barcelonès;08019;Barcelona;8;187;A;;598;252;346;1;0;251;251
8;Barcelona;13;Barcelonès;08019;Barcelona;8;188;A;;565;299;266;2;0;297;297
8;Barcelona;13;Barcelonès;08019;Barcelona;8;189;A;;588;326;262;2;0;324;324
8;Barcelona;13;Barcelonès;08019;Barcelona;8;189;B;;562;284;278;2;6;276;282
8;Barcelona;13;Barcelonès;08019;Barcelona;8;19;A;;565;362;203;1;3;358;361
8;Barcelona;13;Barcelonès;08019;Barcelona;8;19;B;;573;383;190;3;2;378;380
8;Barcelona;13;Barcelonès;08019;Barcelona;8;190;A;;533;267;266;2;2;263;265
8;Barcelona;13;Barcelonès;08019;Barcelona;8;190;B;;522;264;258;2;1;261;262
8;Barcelona;13;Barcelonès;08019;Barcelona;8;191;A;;753;344;409;4;0;340;340
8;Barcelona;13;Barcelonès;08019;Barcelona;8;191;B;;782;390;392;4;1;385;386
8;Barcelona;13;Barcelonès;08019;Barcelona;8;191;C;;780;399;381;8;1;390;391
8;Barcelona;13;Barcelonès;08019;Barcelona;8;192;A;;601;232;369;2;0;230;230
8;Barcelona;13;Barcelonès;08019;Barcelona;8;193;A;;578;271;307;2;0;269;269
8;Barcelona;13;Barcelonès;08019;Barcelona;8;193;B;;581;252;329;3;4;245;249
8;Barcelona;13;Barcelonès;08019;Barcelona;8;193;C;;582;285;297;3;4;278;282
8;Barcelona;13;Barcelonès;08019;Barcelona;8;194;A;;330;132;198;0;0;132;132
8;Barcelona;13;Barcelonès;08019;Barcelona;8;195;A;;520;263;257;0;1;262;263
8;Barcelona;13;Barcelonès;08019;Barcelona;8;196;A;;776;390;386;0;0;390;390
8;Barcelona;13;Barcelonès;08019;Barcelona;8;197;A;;478;235;243;3;1;231;232
8;Barcelona;13;Barcelonès;08019;Barcelona;8;197;B;;475;251;224;4;0;247;247
8;Barcelona;13;Barcelonès;08019;Barcelona;8;198;A;;622;280;342;7;2;271;273
8;Barcelona;13;Barcelonès;08019;Barcelona;8;199;A;;356;174;182;0;0;174;174
8;Barcelona;13;Barcelonès;08019;Barcelona;8;2;A;;414;219;195;0;1;218;219
8;Barcelona;13;Barcelonès;08019;Barcelona;8;2;B;;416;237;179;0;2;235;237
8;Barcelona;13;Barcelonès;08019;Barcelona;8;20;A;;429;272;157;5;2;265;267
8;Barcelona;13;Barcelonès;08019;Barcelona;8;200;A;;622;283;339;2;0;281;281
8;Barcelona;13;Barcelonès;08019;Barcelona;8;201;A;;494;250;244;0;2;248;250
8;Barcelona;13;Barcelonès;08019;Barcelona;8;202;A;;456;225;231;0;2;223;225
8;Barcelona;13;Barcelonès;08019;Barcelona;8;202;B;;459;226;233;5;5;216;221
8;Barcelona;13;Barcelonès;08019;Barcelona;8;203;A;;582;288;294;0;0;288;288
8;Barcelona;13;Barcelonès;08019;Barcelona;8;204;A;;426;184;242;0;0;184;184
8;Barcelona;13;Barcelonès;08019;Barcelona;8;205;A;;504;287;217;1;2;284;286
8;Barcelona;13;Barcelonès;08019;Barcelona;8;205;B;;526;282;244;3;3;276;279
8;Barcelona;13;Barcelonès;08019;Barcelona;8;206;A;;347;163;184;0;0;163;163
8;Barcelona;13;Barcelonès;08019;Barcelona;8;207;A;;542;275;267;4;0;271;271
8;Barcelona;13;Barcelonès;08019;Barcelona;8;208;A;;537;245;292;1;0;244;244
8;Barcelona;13;Barcelonès;08019;Barcelona;8;209;A;;454;204;250;0;0;204;204
8;Barcelona;13;Barcelonès;08019;Barcelona;8;21;A;;470;314;156;0;2;312;314
8;Barcelona;13;Barcelonès;08019;Barcelona;8;210;A;;445;204;241;0;0;204;204
8;Barcelona;13;Barcelonès;08019;Barcelona;8;210;B;;448;231;217;0;0;231;231
8;Barcelona;13;Barcelonès;08019;Barcelona;8;211;A;;550;204;346;2;0;202;202
8;Barcelona;13;Barcelonès;08019;Barcelona;8;212;A;;308;121;187;1;0;120;120
8;Barcelona;13;Barcelonès;08019;Barcelona;8;22;A;;557;330;227;2;3;325;328
8;Barcelona;13;Barcelonès;08019;Barcelona;8;23;A;;586;363;223;0;0;363;363
8;Barcelona;13;Barcelonès;08019;Barcelona;8;24;A;;436;227;209;0;1;226;227
8;Barcelona;13;Barcelonès;08019;Barcelona;8;25;A;;420;249;171;3;1;245;246
8;Barcelona;13;Barcelonès;08019;Barcelona;8;26;A;;435;246;189;2;2;242;244
8;Barcelona;13;Barcelonès;08019;Barcelona;8;27;A;;432;252;180;0;2;250;252
8;Barcelona;13;Barcelonès;08019;Barcelona;8;27;B;;416;239;177;2;0;237;237
8;Barcelona;13;Barcelonès;08019;Barcelona;8;28;A;;666;375;291;0;4;371;375
8;Barcelona;13;Barcelonès;08019;Barcelona;8;28;B;;673;384;289;4;4;376;380
8;Barcelona;13;Barcelonès;08019;Barcelona;8;29;A;;423;247;176;1;2;244;246
8;Barcelona;13;Barcelonès;08019;Barcelona;8;3;A;;778;452;326;0;5;447;452
8;Barcelona;13;Barcelonès;08019;Barcelona;8;30;A;;424;273;151;0;2;271;273
8;Barcelona;13;Barcelonès;08019;Barcelona;8;31;A;;425;268;157;2;5;261;266
8;Barcelona;13;Barcelonès;08019;Barcelona;8;31;B;;414;258;156;0;2;256;258
8;Barcelona;13;Barcelonès;08019;Barcelona;8;32;A;;387;198;189;0;3;195;198
8;Barcelona;13;Barcelonès;08019;Barcelona;8;33;A;;450;242;208;1;0;241;241
8;Barcelona;13;Barcelonès;08019;Barcelona;8;34;A;;456;271;185;1;4;266;270
8;Barcelona;13;Barcelonès;08019;Barcelona;8;35;A;;364;222;142;0;1;221;222
8;Barcelona;13;Barcelonès;08019;Barcelona;8;36;A;;464;313;151;1;1;311;312
8;Barcelona;13;Barcelonès;08019;Barcelona;8;37;A;;549;343;206;5;4;334;338
8;Barcelona;13;Barcelonès;08019;Barcelona;8;38;A;;591;371;220;0;0;371;371
8;Barcelona;13;Barcelonès;08019;Barcelona;8;39;A;;664;393;271;0;2;391;393
8;Barcelona;13;Barcelonès;08019;Barcelona;8;4;A;;467;249;218;0;0;249;249
8;Barcelona;13;Barcelonès;08019;Barcelona;8;40;A;;571;342;229;0;5;337;342
8;Barcelona;13;Barcelonès;08019;Barcelona;8;41;A;;605;377;228;3;3;371;374
8;Barcelona;13;Barcelonès;08019;Barcelona;8;42;A;;652;368;284;2;2;364;366
8;Barcelona;13;Barcelonès;08019;Barcelona;8;43;A;;549;324;225;0;3;321;324
8;Barcelona;13;Barcelonès;08019;Barcelona;8;44;A;;592;333;259;0;3;330;333
8;Barcelona;13;Barcelonès;08019;Barcelona;8;44;B;;592;343;249;0;2;341;343
8;Barcelona;13;Barcelonès;08019;Barcelona;8;45;A;;539;295;244;0;1;294;295
8;Barcelona;13;Barcelonès;08019;Barcelona;8;46;A;;729;390;339;2;2;386;388
8;Barcelona;13;Barcelonès;08019;Barcelona;8;46;B;;773;378;395;0;3;375;378
8;Barcelona;13;Barcelonès;08019;Barcelona;8;46;C;;783;414;369;1;0;413;413
8;Barcelona;13;Barcelonès;08019;Barcelona;8;47;A;;612;342;270;1;0;341;341
8;Barcelona;13;Barcelonès;08019;Barcelona;8;48;A;;636;331;305;0;2;329;331
8;Barcelona;13;Barcelonès;08019;Barcelona;8;49;A;;485;247;238;1;1;245;246
8;Barcelona;13;Barcelonès;08019;Barcelona;8;49;B;;488;244;244;1;2;241;243
8;Barcelona;13;Barcelonès;08019;Barcelona;8;5;A;;433;251;182;0;0;251;251
8;Barcelona;13;Barcelonès;08019;Barcelona;8;5;B;;444;253;191;0;3;250;253
8;Barcelona;13;Barcelonès;08019;Barcelona;8;50;A;;589;281;308;0;1;280;281
8;Barcelona;13;Barcelonès;08019;Barcelona;8;51;A;;735;422;313;1;3;418;421
8;Barcelona;13;Barcelonès;08019;Barcelona;8;52;A;;703;337;366;0;0;337;337
8;Barcelona;13;Barcelonès;08019;Barcelona;8;53;A;;491;249;242;2;0;247;247
8;Barcelona;13;Barcelonès;08019;Barcelona;8;53;B;;500;244;256;1;0;243;243
8;Barcelona;13;Barcelonès;08019;Barcelona;8;54;A;;644;307;337;6;1;300;301
8;Barcelona;13;Barcelonès;08019;Barcelona;8;55;A;;566;285;281;7;0;278;278
8;Barcelona;13;Barcelonès;08019;Barcelona;8;56;A;;708;381;327;2;1;378;379
8;Barcelona;13;Barcelonès;08019;Barcelona;8;56;B;;708;361;347;3;3;355;358
8;Barcelona;13;Barcelonès;08019;Barcelona;8;57;A;;478;264;214;0;2;262;264
8;Barcelona;13;Barcelonès;08019;Barcelona;8;57;B;;477;270;207;0;3;267;270
8;Barcelona;13;Barcelonès;08019;Barcelona;8;58;A;;401;210;191;0;1;209;210
8;Barcelona;13;Barcelonès;08019;Barcelona;8;59;A;;601;306;295;3;5;298;303
8;Barcelona;13;Barcelonès;08019;Barcelona;8;6;A;;741;444;297;0;4;440;444
8;Barcelona;13;Barcelonès;08019;Barcelona;8;60;A;;381;201;180;0;2;199;201
8;Barcelona;13;Barcelonès;08019;Barcelona;8;61;A;;738;359;379;0;4;355;359
8;Barcelona;13;Barcelonès;08019;Barcelona;8;62;A;;421;264;157;0;1;263;264
8;Barcelona;13;Barcelonès;08019;Barcelona;8;63;A;;606;340;266;0;1;339;340
8;Barcelona;13;Barcelonès;08019;Barcelona;8;64;A;;582;354;228;1;5;348;353
8;Barcelona;13;Barcelonès;08019;Barcelona;8;65;A;;486;265;221;0;0;265;265
8;Barcelona;13;Barcelonès;08019;Barcelona;8;65;B;;490;256;234;1;2;253;255
8;Barcelona;13;Barcelonès;08019;Barcelona;8;66;A;;768;379;389;10;3;366;369
8;Barcelona;13;Barcelonès;08019;Barcelona;8;67;A;;406;228;178;2;2;224;226
8;Barcelona;13;Barcelonès;08019;Barcelona;8;67;B;;419;232;187;1;0;231;231
8;Barcelona;13;Barcelonès;08019;Barcelona;8;68;A;;472;250;222;0;1;249;250
8;Barcelona;13;Barcelonès;08019;Barcelona;8;68;B;;468;241;227;0;1;240;241
8;Barcelona;13;Barcelonès;08019;Barcelona;8;69;A;;715;421;294;0;0;421;421
8;Barcelona;13;Barcelonès;08019;Barcelona;8;7;A;;793;437;356;0;1;436;437
8;Barcelona;13;Barcelonès;08019;Barcelona;8;70;A;;772;431;341;0;3;428;431
8;Barcelona;13;Barcelonès;08019;Barcelona;8;71;A;;441;272;169;6;0;266;266
8;Barcelona;13;Barcelonès;08019;Barcelona;8;72;A;;627;369;258;2;1;366;367
8;Barcelona;13;Barcelonès;08019;Barcelona;8;73;A;;441;242;199;3;3;236;239
8;Barcelona;13;Barcelonès;08019;Barcelona;8;73;B;;452;249;203;4;1;244;245
8;Barcelona;13;Barcelonès;08019;Barcelona;8;74;A;;417;237;180;0;1;236;237
8;Barcelona;13;Barcelonès;08019;Barcelona;8;74;B;;425;242;183;1;3;238;241
8;Barcelona;13;Barcelonès;08019;Barcelona;8;75;A;;539;329;210;0;0;329;329
8;Barcelona;13;Barcelonès;08019;Barcelona;8;76;A;;742;412;330;0;4;408;412
8;Barcelona;13;Barcelonès;08019;Barcelona;8;77;A;;425;246;179;0;1;245;246
8;Barcelona;13;Barcelonès;08019;Barcelona;8;78;A;;608;316;292;0;2;314;316
8;Barcelona;13;Barcelonès;08019;Barcelona;8;79;A;;499;268;231;2;3;263;266
8;Barcelona;13;Barcelonès;08019;Barcelona;8;8;A;;510;310;200;0;5;305;310
8;Barcelona;13;Barcelonès;08019;Barcelona;8;8;B;;502;310;192;0;3;307;310
8;Barcelona;13;Barcelonès;08019;Barcelona;8;80;A;;555;339;216;8;2;329;331
8;Barcelona;13;Barcelonès;08019;Barcelona;8;81;A;;521;263;258;0;1;262;263
8;Barcelona;13;Barcelonès;08019;Barcelona;8;81;B;;505;270;235;3;2;265;267
8;Barcelona;13;Barcelonès;08019;Barcelona;8;82;A;;715;396;319;2;4;390;394
8;Barcelona;13;Barcelonès;08019;Barcelona;8;83;A;;717;379;338;0;2;377;379
8;Barcelona;13;Barcelonès;08019;Barcelona;8;84;A;;744;410;334;3;4;403;407
8;Barcelona;13;Barcelonès;08019;Barcelona;8;84;B;;744;421;323;1;3;417;420
8;Barcelona;13;Barcelonès;08019;Barcelona;8;85;A;;454;233;221;0;1;232;233
8;Barcelona;13;Barcelonès;08019;Barcelona;8;85;B;;456;219;237;2;2;215;217
8;Barcelona;13;Barcelonès;08019;Barcelona;8;86;A;;595;306;289;9;1;296;297
8;Barcelona;13;Barcelonès;08019;Barcelona;8;87;A;;279;123;156;0;0;123;123
8;Barcelona;13;Barcelonès;08019;Barcelona;8;88;A;;647;350;297;0;1;349;350
8;Barcelona;13;Barcelonès;08019;Barcelona;8;89;A;;534;303;231;0;1;302;303
8;Barcelona;13;Barcelonès;08019;Barcelona;8;89;B;;523;287;236;1;3;283;286
8;Barcelona;13;Barcelonès;08019;Barcelona;8;9;A;;479;257;222;0;5;252;257
8;Barcelona;13;Barcelonès;08019;Barcelona;8;90;A;;505;284;221;0;0;284;284
8;Barcelona;13;Barcelonès;08019;Barcelona;8;90;B;;507;301;206;0;7;294;301
8;Barcelona;13;Barcelonès;08019;Barcelona;8;91;A;;806;370;436;5;2;363;365
8;Barcelona;13;Barcelonès;08019;Barcelona;8;91;B;;822;359;463;0;1;358;359
8;Barcelona;13;Barcelonès;08019;Barcelona;8;91;C;;795;356;439;3;4;349;353
8;Barcelona;13;Barcelonès;08019;Barcelona;8;92;A;;637;332;305;0;2;330;332
8;Barcelona;13;Barcelonès;08019;Barcelona;8;92;B;;629;321;308;0;0;321;321
8;Barcelona;13;Barcelonès;08019;Barcelona;8;92;C;;643;357;286;0;2;355;357
8;Barcelona;13;Barcelonès;08019;Barcelona;8;93;A;;540;285;255;0;3;282;285
8;Barcelona;13;Barcelonès;08019;Barcelona;8;93;B;;563;282;281;0;3;279;282
8;Barcelona;13;Barcelonès;08019;Barcelona;8;93;C;;556;302;254;0;1;301;302
8;Barcelona;13;Barcelonès;08019;Barcelona;8;94;A;;592;392;200;0;2;390;392
8;Barcelona;13;Barcelonès;08019;Barcelona;8;95;A;;412;266;146;0;2;264;266
8;Barcelona;13;Barcelonès;08019;Barcelona;8;95;B;;422;282;140;3;4;275;279
8;Barcelona;13;Barcelonès;08019;Barcelona;8;96;A;;498;294;204;4;1;289;290
8;Barcelona;13;Barcelonès;08019;Barcelona;8;96;B;;507;288;219;0;1;287;288
8;Barcelona;13;Barcelonès;08019;Barcelona;8;97;A;;549;311;238;1;1;309;310
8;Barcelona;13;Barcelonès;08019;Barcelona;8;97;B;;568;303;265;2;0;301;301
8;Barcelona;13;Barcelonès;08019;Barcelona;8;98;A;;760;399;361;0;3;396;399
8;Barcelona;13;Barcelonès;08019;Barcelona;8;99;A;;521;277;244;0;2;275;277
8;Barcelona;13;Barcelonès;08019;Barcelona;9;1;A;;378;252;126;1;1;250;251
8;Barcelona;13;Barcelonès;08019;Barcelona;9;10;A;;607;315;292;2;0;313;313
8;Barcelona;13;Barcelonès;08019;Barcelona;9;100;A;;639;333;306;0;1;332;333
8;Barcelona;13;Barcelonès;08019;Barcelona;9;101;A;;453;240;213;6;3;231;234
8;Barcelona;13;Barcelonès;08019;Barcelona;9;102;A;;662;341;321;0;4;337;341
8;Barcelona;13;Barcelonès;08019;Barcelona;9;102;B;;657;333;324;0;2;331;333
8;Barcelona;13;Barcelonès;08019;Barcelona;9;103;A;;544;247;297;2;0;245;245
8;Barcelona;13;Barcelonès;08019;Barcelona;9;103;B;;548;232;316;0;1;231;232
8;Barcelona;13;Barcelonès;08019;Barcelona;9;103;C;;557;255;302;0;1;254;255
8;Barcelona;13;Barcelonès;08019;Barcelona;9;104;A;;620;301;319;1;2;298;300
8;Barcelona;13;Barcelonès;08019;Barcelona;9;105;A;;559;310;249;6;1;303;304
8;Barcelona;13;Barcelonès;08019;Barcelona;9;106;A;;739;362;377;7;1;354;355
8;Barcelona;13;Barcelonès;08019;Barcelona;9;107;A;;586;324;262;1;1;322;323
8;Barcelona;13;Barcelonès;08019;Barcelona;9;108;A;;554;276;278;2;1;273;274
8;Barcelona;13;Barcelonès;08019;Barcelona;9;108;B;;568;285;283;0;1;284;285
8;Barcelona;13;Barcelonès;08019;Barcelona;9;109;A;;478;262;216;1;2;259;261
8;Barcelona;13;Barcelonès;08019;Barcelona;9;109;B;;473;261;212;1;2;258;260
8;Barcelona;13;Barcelonès;08019;Barcelona;9;11;A;;574;332;242;0;4;328;332
8;Barcelona;13;Barcelonès;08019;Barcelona;9;110;A;;465;256;209;0;1;255;256
8;Barcelona;13;Barcelonès;08019;Barcelona;9;110;B;;464;260;204;0;5;255;260
8;Barcelona;13;Barcelonès;08019;Barcelona;9;111;A;;712;406;306;1;3;402;405
8;Barcelona;13;Barcelonès;08019;Barcelona;9;112;A;;606;286;320;0;2;284;286
8;Barcelona;13;Barcelonès;08019;Barcelona;9;113;A;;484;265;219;0;1;264;265
8;Barcelona;13;Barcelonès;08019;Barcelona;9;113;B;;489;263;226;0;4;259;263
8;Barcelona;13;Barcelonès;08019;Barcelona;9;114;A;;593;339;254;1;1;337;338
8;Barcelona;13;Barcelonès;08019;Barcelona;9;115;A;;453;256;197;0;2;254;256
8;Barcelona;13;Barcelonès;08019;Barcelona;9;115;B;;433;246;187;3;2;241;243
8;Barcelona;13;Barcelonès;08019;Barcelona;9;116;A;;576;383;193;7;0;376;376
8;Barcelona;13;Barcelonès;08019;Barcelona;9;117;A;;536;368;168;1;1;366;367
8;Barcelona;13;Barcelonès;08019;Barcelona;9;118;A;;817;453;364;0;1;452;453
8;Barcelona;13;Barcelonès;08019;Barcelona;9;119;A;;518;313;205;3;2;308;310
8;Barcelona;13;Barcelonès;08019;Barcelona;9;12;A;;591;252;339;0;0;252;252
8;Barcelona;13;Barcelonès;08019;Barcelona;9;120;A;;444;239;205;0;1;238;239
8;Barcelona;13;Barcelonès;08019;Barcelona;9;120;B;;441;222;219;1;0;221;221
8;Barcelona;13;Barcelonès;08019;Barcelona;9;121;A;;411;220;191;3;3;214;217
8;Barcelona;13;Barcelonès;08019;Barcelona;9;121;B;;417;229;188;0;2;227;229
8;Barcelona;13;Barcelonès;08019;Barcelona;9;122;A;;594;403;191;1;1;401;402
8;Barcelona;13;Barcelonès;08019;Barcelona;9;123;A;;659;402;257;1;3;398;401
8;Barcelona;13;Barcelonès;08019;Barcelona;9;124;A;;602;384;218;4;1;379;380
8;Barcelona;13;Barcelonès;08019;Barcelona;9;125;A;;760;481;279;1;4;476;480
8;Barcelona;13;Barcelonès;08019;Barcelona;9;126;A;;414;267;147;1;2;264;266
8;Barcelona;13;Barcelonès;08019;Barcelona;9;126;B;;409;262;147;7;0;255;255
8;Barcelona;13;Barcelonès;08019;Barcelona;9;127;A;;211;127;84;0;0;127;127
8;Barcelona;13;Barcelonès;08019;Barcelona;9;128;A;;795;406;389;2;1;403;404
8;Barcelona;13;Barcelonès;08019;Barcelona;9;129;A;;662;336;326;4;2;330;332
8;Barcelona;13;Barcelonès;08019;Barcelona;9;13;A;;525;345;180;0;1;344;345
8;Barcelona;13;Barcelonès;08019;Barcelona;9;13;B;;543;333;210;1;2;330;332
8;Barcelona;13;Barcelonès;08019;Barcelona;9;130;A;;594;331;263;0;1;330;331
8;Barcelona;13;Barcelonès;08019;Barcelona;9;131;A;;598;309;289;0;1;308;309
8;Barcelona;13;Barcelonès;08019;Barcelona;9;132;A;;578;269;309;0;0;269;269
8;Barcelona;13;Barcelonès;08019;Barcelona;9;132;B;;591;279;312;0;1;278;279
8;Barcelona;13;Barcelonès;08019;Barcelona;9;133;A;;449;234;215;1;5;228;233
8;Barcelona;13;Barcelonès;08019;Barcelona;9;133;B;;429;245;184;6;0;239;239
8;Barcelona;13;Barcelonès;08019;Barcelona;9;134;A;;450;204;246;2;1;201;202
8;Barcelona;13;Barcelonès;08019;Barcelona;9;135;A;;282;158;124;0;0;158;158
8;Barcelona;13;Barcelonès;08019;Barcelona;9;136;A;;482;238;244;8;0;230;230
8;Barcelona;13;Barcelonès;08019;Barcelona;9;136;B;;489;233;256;1;0;232;232
8;Barcelona;13;Barcelonès;08019;Barcelona;9;137;A;;494;278;216;13;4;261;265
8;Barcelona;13;Barcelonès;08019;Barcelona;9;138;A;;505;234;271;3;0;231;231
8;Barcelona;13;Barcelonès;08019;Barcelona;9;139;A;;749;413;336;0;0;413;413
8;Barcelona;13;Barcelonès;08019;Barcelona;9;14;A;;520;329;191;0;1;328;329
8;Barcelona;13;Barcelonès;08019;Barcelona;9;14;B;;491;309;182;0;1;308;309
8;Barcelona;13;Barcelonès;08019;Barcelona;9;140;A;;482;286;196;0;0;286;286
8;Barcelona;13;Barcelonès;08019;Barcelona;9;141;A;;381;167;214;1;1;165;166
8;Barcelona;13;Barcelonès;08019;Barcelona;9;142;A;;563;288;275;3;4;281;285
8;Barcelona;13;Barcelonès;08019;Barcelona;9;143;A;;685;338;347;0;2;336;338
8;Barcelona;13;Barcelonès;08019;Barcelona;9;144;A;;686;346;340;1;1;344;345
8;Barcelona;13;Barcelonès;08019;Barcelona;9;145;A;;649;347;302;1;0;346;346
8;Barcelona;13;Barcelonès;08019;Barcelona;9;146;A;;717;395;322;0;0;395;395
8;Barcelona;13;Barcelonès;08019;Barcelona;9;147;A;;686;352;334;13;0;339;339
8;Barcelona;13;Barcelonès;08019;Barcelona;9;148;A;;753;344;409;1;0;343;343
8;Barcelona;13;Barcelonès;08019;Barcelona;9;149;A;;674;330;344;2;1;327;328
8;Barcelona;13;Barcelonès;08019;Barcelona;9;15;A;;555;353;202;1;8;344;352
8;Barcelona;13;Barcelonès;08019;Barcelona;9;15;B;;546;349;197;0;2;347;349
8;Barcelona;13;Barcelonès;08019;Barcelona;9;150;A;;484;221;263;0;0;221;221
8;Barcelona;13;Barcelonès;08019;Barcelona;9;150;B;;481;244;237;0;1;243;244
8;Barcelona;13;Barcelonès;08019;Barcelona;9;151;A;;630;320;310;0;5;315;320
8;Barcelona;13;Barcelonès;08019;Barcelona;9;152;A;;362;172;190;0;1;171;172
8;Barcelona;13;Barcelonès;08019;Barcelona;9;153;A;;728;274;454;0;0;274;274
8;Barcelona;13;Barcelonès;08019;Barcelona;9;154;A;;732;353;379;1;2;350;352
8;Barcelona;13;Barcelonès;08019;Barcelona;9;16;A;;366;231;135;3;2;226;228
8;Barcelona;13;Barcelonès;08019;Barcelona;9;17;A;;641;391;250;1;1;389;390
8;Barcelona;13;Barcelonès;08019;Barcelona;9;18;A;;646;424;222;1;3;420;423
8;Barcelona;13;Barcelonès;08019;Barcelona;9;19;A;;439;259;180;0;2;257;259
8;Barcelona;13;Barcelonès;08019;Barcelona;9;19;B;;433;271;162;0;1;270;271
8;Barcelona;13;Barcelonès;08019;Barcelona;9;2;A;;574;304;270;0;4;300;304
8;Barcelona;13;Barcelonès;08019;Barcelona;9;2;B;;565;343;222;0;4;339;343
8;Barcelona;13;Barcelonès;08019;Barcelona;9;20;A;;439;273;166;0;1;272;273
8;Barcelona;13;Barcelonès;08019;Barcelona;9;20;B;;453;276;177;1;1;274;275
8;Barcelona;13;Barcelonès;08019;Barcelona;9;21;A;;477;320;157;1;2;317;319
8;Barcelona;13;Barcelonès;08019;Barcelona;9;21;B;;490;320;170;1;0;319;319
8;Barcelona;13;Barcelonès;08019;Barcelona;9;22;A;;653;420;233;1;2;417;419
8;Barcelona;13;Barcelonès;08019;Barcelona;9;23;A;;684;393;291;0;5;388;393
8;Barcelona;13;Barcelonès;08019;Barcelona;9;24;A;;451;263;188;0;0;263;263
8;Barcelona;13;Barcelonès;08019;Barcelona;9;25;A;;795;473;322;2;3;468;471
8;Barcelona;13;Barcelonès;08019;Barcelona;9;26;A;;339;339;0;2;1;336;337
8;Barcelona;13;Barcelonès;08019;Barcelona;9;26;B;;314;315;1;2;1;312;313
8;Barcelona;13;Barcelonès;08019;Barcelona;9;26;C;;571;313;258;2;4;307;311
8;Barcelona;13;Barcelonès;08019;Barcelona;9;27;A;;444;257;187;0;5;252;257
8;Barcelona;13;Barcelonès;08019;Barcelona;9;27;B;;440;228;212;0;2;226;228
8;Barcelona;13;Barcelonès;08019;Barcelona;9;28;A;;385;238;147;0;4;234;238
8;Barcelona;13;Barcelonès;08019;Barcelona;9;29;A;;164;81;83;0;0;81;81
8;Barcelona;13;Barcelonès;08019;Barcelona;9;3;A;;629;366;263;5;4;357;361
8;Barcelona;13;Barcelonès;08019;Barcelona;9;3;B;;631;357;274;0;5;352;357
8;Barcelona;13;Barcelonès;08019;Barcelona;9;3;C;;648;380;268;2;1;377;378
8;Barcelona;13;Barcelonès;08019;Barcelona;9;30;A;;717;362;355;0;3;359;362
8;Barcelona;13;Barcelonès;08019;Barcelona;9;30;B;;716;384;332;1;0;383;383
8;Barcelona;13;Barcelonès;08019;Barcelona;9;31;A;;694;401;293;0;2;399;401
8;Barcelona;13;Barcelonès;08019;Barcelona;9;32;A;;793;428;365;4;2;422;424
8;Barcelona;13;Barcelonès;08019;Barcelona;9;33;A;;398;254;144;0;1;253;254
8;Barcelona;13;Barcelonès;08019;Barcelona;9;34;A;;430;290;140;1;2;287;289
8;Barcelona;13;Barcelonès;08019;Barcelona;9;35;A;;530;334;196;3;2;329;331
8;Barcelona;13;Barcelonès;08019;Barcelona;9;36;A;;528;355;173;1;4;350;354
8;Barcelona;13;Barcelonès;08019;Barcelona;9;37;A;;402;220;182;1;3;216;219
8;Barcelona;13;Barcelonès;08019;Barcelona;9;37;B;;404;226;178;3;6;217;223
8;Barcelona;13;Barcelonès;08019;Barcelona;9;38;A;;323;173;150;5;1;167;168
8;Barcelona;13;Barcelonès;08019;Barcelona;9;39;A;;760;466;294;5;4;457;461
8;Barcelona;13;Barcelonès;08019;Barcelona;9;39;B;;770;441;329;4;0;437;437
8;Barcelona;13;Barcelonès;08019;Barcelona;9;39;C;;768;464;304;0;3;461;464
8;Barcelona;13;Barcelonès;08019;Barcelona;9;4;A;;546;336;210;0;2;334;336
8;Barcelona;13;Barcelonès;08019;Barcelona;9;4;B;;556;340;216;2;0;338;338
8;Barcelona;13;Barcelonès;08019;Barcelona;9;40;A;;492;298;194;4;3;291;294
8;Barcelona;13;Barcelonès;08019;Barcelona;9;40;B;;486;281;205;1;2;278;280
8;Barcelona;13;Barcelonès;08019;Barcelona;9;41;A;;781;470;311;3;1;466;467
8;Barcelona;13;Barcelonès;08019;Barcelona;9;42;A;;453;281;172;2;1;278;279
8;Barcelona;13;Barcelonès;08019;Barcelona;9;42;B;;452;272;180;2;1;269;270
8;Barcelona;13;Barcelonès;08019;Barcelona;9;43;A;;553;300;253;1;2;297;299
8;Barcelona;13;Barcelonès;08019;Barcelona;9;43;B;;580;304;276;0;0;304;304
8;Barcelona;13;Barcelonès;08019;Barcelona;9;44;A;;767;410;357;1;4;405;409
8;Barcelona;13;Barcelonès;08019;Barcelona;9;44;B;;817;395;422;2;5;388;393
8;Barcelona;13;Barcelonès;08019;Barcelona;9;45;A;;600;345;255;1;1;343;344
8;Barcelona;13;Barcelonès;08019;Barcelona;9;45;B;;590;334;256;3;0;331;331
8;Barcelona;13;Barcelonès;08019;Barcelona;9;45;C;;591;336;255;3;1;332;333
8;Barcelona;13;Barcelonès;08019;Barcelona;9;46;A;;688;355;333;0;4;351;355
8;Barcelona;13;Barcelonès;08019;Barcelona;9;46;B;;669;354;315;11;2;341;343
8;Barcelona;13;Barcelonès;08019;Barcelona;9;47;A;;590;280;310;0;5;275;280
8;Barcelona;13;Barcelonès;08019;Barcelona;9;47;B;;587;287;300;1;5;281;286
8;Barcelona;13;Barcelonès;08019;Barcelona;9;48;A;;521;288;233;1;0;287;287
8;Barcelona;13;Barcelonès;08019;Barcelona;9;48;B;;519;323;196;1;2;320;322
8;Barcelona;13;Barcelonès;08019;Barcelona;9;49;A;;468;292;176;3;3;286;289
8;Barcelona;13;Barcelonès;08019;Barcelona;9;5;A;;547;337;210;0;2;335;337
8;Barcelona;13;Barcelonès;08019;Barcelona;9;5;B;;552;323;229;0;7;316;323
8;Barcelona;13;Barcelonès;08019;Barcelona;9;50;A;;479;263;216;0;2;261;263
8;Barcelona;13;Barcelonès;08019;Barcelona;9;51;A;;499;299;200;3;2;294;296
8;Barcelona;13;Barcelonès;08019;Barcelona;9;51;B;;505;312;193;0;3;309;312
8;Barcelona;13;Barcelonès;08019;Barcelona;9;52;A;;454;278;176;1;1;276;277
8;Barcelona;13;Barcelonès;08019;Barcelona;9;53;A;;473;260;213;0;1;259;260
8;Barcelona;13;Barcelonès;08019;Barcelona;9;54;A;;526;308;218;1;0;307;307
8;Barcelona;13;Barcelonès;08019;Barcelona;9;55;A;;483;278;205;0;1;277;278
8;Barcelona;13;Barcelonès;08019;Barcelona;9;56;A;;427;235;192;0;3;232;235
8;Barcelona;13;Barcelonès;08019;Barcelona;9;57;A;;573;354;219;0;2;352;354
8;Barcelona;13;Barcelonès;08019;Barcelona;9;58;A;;382;229;153;0;3;226;229
8;Barcelona;13;Barcelonès;08019;Barcelona;9;59;A;;487;306;181;2;2;302;304
8;Barcelona;13;Barcelonès;08019;Barcelona;9;6;A;;557;338;219;1;1;336;337
8;Barcelona;13;Barcelonès;08019;Barcelona;9;6;B;;551;340;211;1;3;336;339
8;Barcelona;13;Barcelonès;08019;Barcelona;9;60;A;;525;347;178;1;1;345;346
8;Barcelona;13;Barcelonès;08019;Barcelona;9;61;A;;803;461;342;0;0;461;461
8;Barcelona;13;Barcelonès;08019;Barcelona;9;62;A;;596;382;214;0;6;376;382
8;Barcelona;13;Barcelonès;08019;Barcelona;9;63;A;;410;273;137;2;5;266;271
8;Barcelona;13;Barcelonès;08019;Barcelona;9;63;B;;414;284;130;4;5;275;280
8;Barcelona;13;Barcelonès;08019;Barcelona;9;64;A;;473;328;145;1;1;326;327
8;Barcelona;13;Barcelonès;08019;Barcelona;9;65;A;;422;266;156;2;2;262;264
8;Barcelona;13;Barcelonès;08019;Barcelona;9;65;B;;420;286;134;1;1;284;285
8;Barcelona;13;Barcelonès;08019;Barcelona;9;66;A;;526;327;199;5;3;319;322
8;Barcelona;13;Barcelonès;08019;Barcelona;9;66;B;;522;332;190;7;1;324;325
8;Barcelona;13;Barcelonès;08019;Barcelona;9;67;A;;565;380;185;1;3;376;379
8;Barcelona;13;Barcelonès;08019;Barcelona;9;68;A;;451;300;151;2;6;292;298
8;Barcelona;13;Barcelonès;08019;Barcelona;9;68;B;;446;288;158;0;0;288;288
8;Barcelona;13;Barcelonès;08019;Barcelona;9;69;A;;485;331;154;0;2;329;331
8;Barcelona;13;Barcelonès;08019;Barcelona;9;69;B;;477;330;147;0;6;324;330
8;Barcelona;13;Barcelonès;08019;Barcelona;9;7;A;;620;391;229;0;1;390;391
8;Barcelona;13;Barcelonès;08019;Barcelona;9;70;A;;409;245;164;0;6;239;245
8;Barcelona;13;Barcelonès;08019;Barcelona;9;71;A;;557;352;205;0;3;349;352
8;Barcelona;13;Barcelonès;08019;Barcelona;9;72;A;;537;319;218;0;2;317;319
8;Barcelona;13;Barcelonès;08019;Barcelona;9;72;B;;530;366;164;0;3;363;366
8;Barcelona;13;Barcelonès;08019;Barcelona;9;73;A;;399;261;138;3;0;258;258
8;Barcelona;13;Barcelonès;08019;Barcelona;9;73;B;;413;263;150;0;1;262;263
8;Barcelona;13;Barcelonès;08019;Barcelona;9;74;A;;556;317;239;1;4;312;316
8;Barcelona;13;Barcelonès;08019;Barcelona;9;75;A;;557;335;222;1;0;334;334
8;Barcelona;13;Barcelonès;08019;Barcelona;9;76;A;;453;294;159;1;2;291;293
8;Barcelona;13;Barcelonès;08019;Barcelona;9;77;A;;423;311;112;0;6;305;311
8;Barcelona;13;Barcelonès;08019;Barcelona;9;78;A;;524;328;196;1;0;327;327
8;Barcelona;13;Barcelonès;08019;Barcelona;9;79;A;;792;484;308;2;1;481;482
8;Barcelona;13;Barcelonès;08019;Barcelona;9;8;A;;528;344;184;0;2;342;344
8;Barcelona;13;Barcelonès;08019;Barcelona;9;80;A;;512;353;159;2;0;351;351
8;Barcelona;13;Barcelonès;08019;Barcelona;9;81;A;;411;286;125;6;0;280;280
8;Barcelona;13;Barcelonès;08019;Barcelona;9;81;B;;410;272;138;1;0;271;271
8;Barcelona;13;Barcelonès;08019;Barcelona;9;82;A;;468;292;176;9;1;282;283
8;Barcelona;13;Barcelonès;08019;Barcelona;9;83;A;;575;355;220;3;4;348;352
8;Barcelona;13;Barcelonès;08019;Barcelona;9;84;A;;602;356;246;2;5;349;354
8;Barcelona;13;Barcelonès;08019;Barcelona;9;85;A;;427;272;155;8;2;262;264
8;Barcelona;13;Barcelonès;08019;Barcelona;9;86;A;;689;440;249;0;4;436;440
8;Barcelona;13;Barcelonès;08019;Barcelona;9;86;B;;687;431;256;2;3;426;429
8;Barcelona;13;Barcelonès;08019;Barcelona;9;87;A;;721;443;278;1;2;440;442
8;Barcelona;13;Barcelonès;08019;Barcelona;9;88;A;;533;356;177;1;0;355;355
8;Barcelona;13;Barcelonès;08019;Barcelona;9;89;A;;544;344;200;3;5;336;341
8;Barcelona;13;Barcelonès;08019;Barcelona;9;89;B;;545;335;210;0;3;332;335
8;Barcelona;13;Barcelonès;08019;Barcelona;9;9;A;;594;336;258;2;4;330;334
8;Barcelona;13;Barcelonès;08019;Barcelona;9;90;A;;597;377;220;5;1;371;372
8;Barcelona;13;Barcelonès;08019;Barcelona;9;91;A;;533;341;192;1;0;340;340
8;Barcelona;13;Barcelonès;08019;Barcelona;9;92;A;;766;453;313;0;3;450;453
8;Barcelona;13;Barcelonès;08019;Barcelona;9;93;A;;419;239;180;0;0;239;239
8;Barcelona;13;Barcelonès;08019;Barcelona;9;94;A;;717;465;252;0;2;463;465
8;Barcelona;13;Barcelonès;08019;Barcelona;9;95;A;;563;388;175;3;1;384;385
8;Barcelona;13;Barcelonès;08019;Barcelona;9;96;A;;506;342;164;2;1;339;340
8;Barcelona;13;Barcelonès;08019;Barcelona;9;97;A;;641;447;194;2;0;445;445
8;Barcelona;13;Barcelonès;08019;Barcelona;9;98;A;;448;279;169;0;3;276;279
8;Barcelona;13;Barcelonès;08019;Barcelona;9;99;A;;645;370;275;6;0;364;364
25;Lleida;23;Noguera;25042;Baronia de Rialb, la;1;1;A;;238;157;81;1;1;155;156
17;Girona;2;Alt Empordà;17016;Bàscara;1;1;A;;585;446;139;3;0;443;443
25;Lleida;4;Alt Urgell;25044;Bassella;1;1;A;;328;217;111;0;0;217;217
43;Tarragona;37;Terra Alta;43022;Batea;1;1;A;;994;729;265;6;0;723;723
43;Tarragona;37;Terra Alta;43022;Batea;1;2;A;;656;441;215;0;3;438;441
25;Lleida;39;Consell General d'Aran;25045;Bausen;1;1;A;;66;55;11;1;0;54;54
8;Barcelona;11;Baix Llobregat;08020;Begues;1;1;A;;450;317;133;9;2;306;308
8;Barcelona;11;Baix Llobregat;08020;Begues;1;1;B;;785;559;226;8;0;551;551
17;Girona;10;Baix Empordà;17013;Begur;1;1;A;;641;464;177;0;0;464;464
17;Girona;10;Baix Empordà;17013;Begur;1;1;B;;692;483;209;1;1;481;482
17;Girona;10;Baix Empordà;17013;Begur;1;1;C;;446;332;114;4;4;324;328
25;Lleida;38;Urgell;25046;Belianes;1;1;A;;540;361;179;0;5;356;361
25;Lleida;18;Garrigues;25170;Bellaguarda;1;1;A;;337;173;164;1;0;172;172
17;Girona;10;Baix Empordà;17018;Bellcaire d'Empordà;1;1;A;;390;282;108;2;4;276;280
25;Lleida;23;Noguera;25047;Bellcaire d'Urgell;1;1;A;;568;400;168;0;6;394;400
25;Lleida;23;Noguera;25047;Bellcaire d'Urgell;1;1;B;;649;471;178;0;3;468;471
25;Lleida;27;Pla d'Urgell;25048;Bell-lloc d'Urgell;1;1;A;;737;522;215;7;3;512;515
25;Lleida;27;Pla d'Urgell;25048;Bell-lloc d'Urgell;1;2;A;;995;677;318;1;5;671;676
25;Lleida;23;Noguera;25049;Bellmunt d'Urgell;1;1;A;;197;134;63;0;1;133;134
43;Tarragona;29;Priorat;43023;Bellmunt del Priorat;1;1;A;;286;216;70;1;2;213;215
8;Barcelona;6;Anoia;08021;Bellprat;1;1;A;;81;54;27;0;0;54;54
25;Lleida;38;Urgell;25050;Bellpuig;1;1;A;;1021;669;352;2;10;657;667
25;Lleida;38;Urgell;25050;Bellpuig;1;2;A;;980;680;300;11;9;660;669
25;Lleida;38;Urgell;25050;Bellpuig;1;3;A;;913;587;326;4;3;580;583
43;Tarragona;12;Baix Penedès;43024;Bellvei;1;1;A;;686;553;133;2;5;546;551
25;Lleida;15;Cerdanya;25051;Bellver de Cerdanya;1;1;A;;1262;861;401;4;6;851;857
25;Lleida;27;Pla d'Urgell;25052;Bellvís;1;1;A;;775;474;301;7;6;461;467
25;Lleida;27;Pla d'Urgell;25052;Bellvís;1;1;B;;211;117;94;0;0;117;117
25;Lleida;27;Pla d'Urgell;25052;Bellvís;1;2;A;;925;521;404;1;3;517;520
25;Lleida;33;Segrià;25053;Benavent de Segrià;1;1;A;;556;331;225;0;2;329;331
43;Tarragona;9;Baix Ebre;43025;Benifallet;1;1;A;;819;487;332;2;1;484;485
43;Tarragona;30;Ribera d'Ebre;43026;Benissanet;1;1;A;;852;431;421;1;3;427;430
8;Barcelona;14;Berguedà;08022;Berga;1;1;A;;1045;697;348;7;7;683;690
8;Barcelona;14;Berguedà;08022;Berga;1;1;B;;1142;737;405;8;4;725;729
8;Barcelona;14;Berguedà;08022;Berga;1;2;A;;1013;703;310;2;1;700;701
8;Barcelona;14;Berguedà;08022;Berga;1;2;B;;1134;753;381;3;8;742;750
8;Barcelona;14;Berguedà;08022;Berga;1;3;A;;739;533;206;2;3;528;531
8;Barcelona;14;Berguedà;08022;Berga;2;1;A;;594;354;240;2;6;346;352
8;Barcelona;14;Berguedà;08022;Berga;2;1;B;;595;360;235;0;2;358;360
8;Barcelona;14;Berguedà;08022;Berga;2;2;A;;952;615;337;8;3;604;607
8;Barcelona;14;Berguedà;08022;Berga;2;2;B;;1037;674;363;8;5;661;666
8;Barcelona;14;Berguedà;08022;Berga;2;3;A;;751;439;312;3;0;436;436
8;Barcelona;14;Berguedà;08022;Berga;2;3;B;;923;534;389;2;1;531;532
8;Barcelona;14;Berguedà;08022;Berga;3;1;A;;569;385;184;4;1;380;381
8;Barcelona;14;Berguedà;08022;Berga;4;1;A;;383;252;131;2;2;248;250
17;Girona;19;Garrotxa;17019;Besalú;1;1;A;;528;351;177;155;2;194;196
17;Girona;19;Garrotxa;17019;Besalú;1;1;B;;394;298;96;118;6;174;180
17;Girona;19;Garrotxa;17019;Besalú;1;1;C;;770;560;210;222;4;334;338
17;Girona;20;Gironès;17020;Bescanó;1;1;A;;540;411;129;4;3;404;407
17;Girona;20;Gironès;17020;Bescanó;1;1;B;;592;419;173;1;3;415;418
17;Girona;20;Gironès;17020;Bescanó;1;1;C;;583;452;131;1;8;443;451
17;Girona;20;Gironès;17020;Bescanó;1;2;A;;402;222;180;1;1;220;221
17;Girona;19;Garrotxa;17021;Beuda;1;1;A;;91;52;39;1;1;50;51
8;Barcelona;41;Vallès Oriental;08023;Bigues i Riells;1;1;A;;1264;778;486;0;1;777;778
8;Barcelona;41;Vallès Oriental;08023;Bigues i Riells;1;2;A;;256;207;49;2;0;205;205
25;Lleida;32;Segarra;25055;Biosca;1;1;A;;241;183;58;4;1;178;179
17;Girona;10;Baix Empordà;17022;Bisbal d'Empordà, la;1;1;A;;613;402;211;7;3;392;395
17;Girona;10;Baix Empordà;17022;Bisbal d'Empordà, la;1;2;A;;773;551;222;0;3;548;551
17;Girona;10;Baix Empordà;17022;Bisbal d'Empordà, la;1;2;B;;981;676;305;0;2;674;676
17;Girona;10;Baix Empordà;17022;Bisbal d'Empordà, la;1;3;A;;709;516;193;2;4;510;514
17;Girona;10;Baix Empordà;17022;Bisbal d'Empordà, la;2;1;A;;504;377;127;1;3;373;376
17;Girona;10;Baix Empordà;17022;Bisbal d'Empordà, la;2;2;A;;592;389;203;2;0;387;387
17;Girona;10;Baix Empordà;17022;Bisbal d'Empordà, la;2;2;B;;704;469;235;9;0;460;460
17;Girona;10;Baix Empordà;17022;Bisbal d'Empordà, la;2;3;A;;888;583;305;2;3;578;581
43;Tarragona;29;Priorat;43027;Bisbal de Falset, la;1;1;A;;262;130;132;1;4;125;129
43;Tarragona;12;Baix Penedès;43028;Bisbal del Penedès, la;1;1;A;;989;623;366;0;4;619;623
17;Girona;2;Alt Empordà;17234;Biure;1;1;A;;240;138;102;2;0;136;136
43;Tarragona;16;Conca de Barberà;43029;Blancafort;1;1;A;;360;239;121;0;0;239;239
17;Girona;34;Selva;17023;Blanes;1;1;A;;893;667;226;0;5;662;667
17;Girona;34;Selva;17023;Blanes;1;2;A;;1113;821;292;2;1;818;819
17;Girona;34;Selva;17023;Blanes;2;1;A;;872;568;304;1;3;564;567
17;Girona;34;Selva;17023;Blanes;2;2;A;;1072;733;339;5;3;725;728
17;Girona;34;Selva;17023;Blanes;2;3;A;;801;477;324;1;5;471;476
17;Girona;34;Selva;17023;Blanes;2;3;B;;868;566;302;6;3;557;560
17;Girona;34;Selva;17023;Blanes;2;4;A;;934;487;447;2;0;485;485
17;Girona;34;Selva;17023;Blanes;2;5;A;;697;387;310;1;0;386;386
17;Girona;34;Selva;17023;Blanes;2;5;B;;780;422;358;0;0;422;422
17;Girona;34;Selva;17023;Blanes;2;6;A;;554;313;241;5;2;306;308
17;Girona;34;Selva;17023;Blanes;2;6;B;;591;298;293;2;3;293;296
17;Girona;34;Selva;17023;Blanes;2;6;C;;590;333;257;2;1;330;331
17;Girona;34;Selva;17023;Blanes;3;1;A;;760;492;268;3;1;488;489
17;Girona;34;Selva;17023;Blanes;3;1;B;;839;530;309;5;0;525;525
17;Girona;34;Selva;17023;Blanes;3;2;A;;476;257;219;6;0;251;251
17;Girona;34;Selva;17023;Blanes;3;2;B;;610;307;303;1;0;306;306
17;Girona;34;Selva;17023;Blanes;3;2;C;;594;322;272;0;3;319;322
17;Girona;34;Selva;17023;Blanes;3;3;A;;622;310;312;4;0;306;306
17;Girona;34;Selva;17023;Blanes;3;3;B;;719;370;349;0;1;369;370
17;Girona;34;Selva;17023;Blanes;3;4;A;;407;265;142;0;3;262;265
17;Girona;34;Selva;17023;Blanes;3;4;B;;472;271;201;2;2;267;269
17;Girona;34;Selva;17023;Blanes;3;5;A;;1128;629;499;0;2;627;629
17;Girona;2;Alt Empordà;17029;Boadella i les Escaules;1;1;A;;188;127;61;0;1;126;127
17;Girona;15;Cerdanya;17024;Bolvir;1;1;A;;172;135;37;0;0;135;135
43;Tarragona;12;Baix Penedès;43030;Bonastre;1;1;A;;234;213;21;1;1;211;212
25;Lleida;39;Consell General d'Aran;25057;Bòrdes, es;1;1;A;;149;96;53;4;0;92;92
17;Girona;20;Gironès;17025;Bordils;1;1;A;;965;668;297;3;9;656;665
25;Lleida;18;Garrigues;25058;Borges Blanques, les;1;1;A;;847;540;307;4;1;535;536
25;Lleida;18;Garrigues;25058;Borges Blanques, les;1;2;A;;946;620;326;5;5;610;615
25;Lleida;18;Garrigues;25058;Borges Blanques, les;2;1;A;;1034;678;356;3;9;666;675
25;Lleida;18;Garrigues;25058;Borges Blanques, les;2;2;A;;1200;735;465;2;6;727;733
43;Tarragona;8;Baix Camp;43031;Borges del Camp, les;1;1;A;;1084;835;249;2;3;830;833
17;Girona;2;Alt Empordà;17026;Borrassà;1;1;A;;386;263;123;3;1;259;260
8;Barcelona;14;Berguedà;08024;Borredà;1;1;A;;371;281;90;0;1;280;281
25;Lleida;39;Consell General d'Aran;25059;Bossòst;1;1;A;;607;466;141;3;8;455;463
43;Tarragona;37;Terra Alta;43032;Bot;1;1;A;;818;560;258;4;2;554;556
43;Tarragona;8;Baix Camp;43033;Botarell;1;1;A;;337;245;92;1;5;239;244
25;Lleida;18;Garrigues;25056;Bovera;1;1;A;;418;230;188;1;2;227;229
43;Tarragona;1;Alt Camp;43034;Bràfim;1;1;A;;479;374;105;1;1;372;373
17;Girona;34;Selva;17027;Breda;1;1;A;;648;476;172;4;4;468;472
17;Girona;34;Selva;17027;Breda;1;1;B;;770;589;181;5;2;582;584
17;Girona;34;Selva;17027;Breda;1;2;A;;1003;737;266;2;3;732;735
8;Barcelona;6;Anoia;08025;Bruc, el;1;1;A;;558;373;185;1;0;372;372
8;Barcelona;24;Osona;08026;Brull, el;1;1;A;;140;104;36;0;0;104;104
17;Girona;34;Selva;17028;Brunyola i Sant Martí Sapresa;1;1;A;;330;231;99;2;2;227;229
43;Tarragona;29;Priorat;43035;Cabacés;1;1;A;;292;208;84;2;1;205;206
25;Lleida;23;Noguera;25060;Cabanabona;1;1;A;;114;78;36;0;0;78;78
17;Girona;2;Alt Empordà;17031;Cabanelles;1;1;A;;205;107;98;0;0;107;107
17;Girona;2;Alt Empordà;17030;Cabanes;1;1;A;;630;382;248;5;3;374;377
8;Barcelona;3;Alt Penedès;08027;Cabanyes, les;1;1;A;;279;232;47;1;0;231;231
25;Lleida;4;Alt Urgell;25061;Cabó;1;1;A;;135;89;46;1;0;88;88
43;Tarragona;1;Alt Camp;43036;Cabra del Camp;1;1;A;;344;244;100;0;4;240;244
8;Barcelona;6;Anoia;08028;Cabrera d'Anoia;1;1;A;;213;120;93;1;0;119;119
8;Barcelona;21;Maresme;08029;Cabrera de Mar;1;1;A;;649;478;171;1;0;477;477
8;Barcelona;21;Maresme;08029;Cabrera de Mar;1;1;B;;923;670;253;0;4;666;670
8;Barcelona;21;Maresme;08030;Cabrils;1;1;A;;757;570;187;2;8;560;568
8;Barcelona;21;Maresme;08030;Cabrils;1;1;B;;747;563;184;2;3;558;561
17;Girona;2;Alt Empordà;17032;Cadaqués;1;1;A;;597;438;159;3;7;428;435
17;Girona;2;Alt Empordà;17032;Cadaqués;1;1;B;;642;446;196;0;5;441;446
8;Barcelona;6;Anoia;08031;Calaf;1;1;A;;785;530;255;2;0;528;528
8;Barcelona;6;Anoia;08031;Calaf;1;2;A;;723;519;204;8;1;510;511
8;Barcelona;6;Anoia;08031;Calaf;1;2;B;;963;691;272;2;9;680;689
43;Tarragona;12;Baix Penedès;43037;Calafell;1;1;A;;745;488;257;3;3;482;485
43;Tarragona;12;Baix Penedès;43037;Calafell;1;1;B;;1198;798;400;3;2;793;795
43;Tarragona;12;Baix Penedès;43037;Calafell;2;1;A;;1114;809;305;6;6;797;803
43;Tarragona;12;Baix Penedès;43037;Calafell;2;2;A;;608;332;276;2;1;329;330
43;Tarragona;12;Baix Penedès;43037;Calafell;2;3;A;;735;350;385;2;3;345;348
8;Barcelona;;;08034;Calders;1;1;A;;399;320;79;2;3;315;318
8;Barcelona;21;Maresme;08032;Caldes d'Estrac;1;1;A;;1009;735;274;11;9;715;724
17;Girona;34;Selva;17033;Caldes de Malavella;1;1;A;;837;577;260;6;7;564;571
17;Girona;34;Selva;17033;Caldes de Malavella;1;1;B;;849;596;253;5;1;590;591
17;Girona;34;Selva;17033;Caldes de Malavella;1;2;A;;509;293;216;2;3;288;291
8;Barcelona;41;Vallès Oriental;08033;Caldes de Montbui;1;1;A;;480;318;162;0;2;316;318
8;Barcelona;41;Vallès Oriental;08033;Caldes de Montbui;1;1;B;;700;473;227;4;1;468;469
8;Barcelona;41;Vallès Oriental;08033;Caldes de Montbui;1;2;A;;657;373;284;5;1;367;368
8;Barcelona;41;Vallès Oriental;08033;Caldes de Montbui;1;2;B;;768;436;332;1;3;432;435
8;Barcelona;41;Vallès Oriental;08033;Caldes de Montbui;1;3;A;;734;518;216;4;0;514;514
8;Barcelona;41;Vallès Oriental;08033;Caldes de Montbui;2;1;A;;764;508;256;4;7;497;504
8;Barcelona;41;Vallès Oriental;08033;Caldes de Montbui;2;1;B;;921;583;338;8;6;569;575
8;Barcelona;41;Vallès Oriental;08033;Caldes de Montbui;3;1;A;;826;553;273;1;4;548;552
8;Barcelona;41;Vallès Oriental;08033;Caldes de Montbui;3;1;B;;1026;666;360;5;2;659;661
8;Barcelona;41;Vallès Oriental;08033;Caldes de Montbui;3;2;A;;739;488;251;7;2;479;481
8;Barcelona;41;Vallès Oriental;08033;Caldes de Montbui;3;3;A;;450;245;205;3;3;239;242
8;Barcelona;21;Maresme;08035;Calella;1;1;A;;1110;763;347;3;5;755;760
8;Barcelona;21;Maresme;08035;Calella;1;2;A;;594;407;187;1;0;406;406
8;Barcelona;21;Maresme;08035;Calella;1;3;A;;850;436;414;0;4;432;436
8;Barcelona;21;Maresme;08035;Calella;2;1;A;;529;369;160;0;2;367;369
8;Barcelona;21;Maresme;08035;Calella;2;2;A;;637;445;192;1;1;443;444
8;Barcelona;21;Maresme;08035;Calella;2;2;B;;834;550;284;5;0;545;545
8;Barcelona;21;Maresme;08035;Calella;3;1;A;;713;454;259;2;2;450;452
8;Barcelona;21;Maresme;08035;Calella;3;1;B;;822;500;322;0;3;497;500
8;Barcelona;21;Maresme;08035;Calella;3;2;A;;573;346;227;0;3;343;346
8;Barcelona;21;Maresme;08035;Calella;3;2;B;;676;392;284;0;6;386;392
8;Barcelona;21;Maresme;08035;Calella;3;3;A;;1315;778;537;10;1;767;768
8;Barcelona;24;Osona;08037;Calldetenes;1;1;A;;1037;801;236;0;3;798;801
8;Barcelona;7;Bages;08038;Callús;1;1;A;;945;685;260;11;9;665;674
8;Barcelona;7;Bages;08038;Callús;1;2;A;;209;121;88;4;0;117;117
17;Girona;10;Baix Empordà;17034;Calonge i Sant Antoni;1;1;A;;579;388;191;4;2;382;384
17;Girona;10;Baix Empordà;17034;Calonge i Sant Antoni;1;1;B;;856;532;324;3;2;527;529
17;Girona;10;Baix Empordà;17034;Calonge i Sant Antoni;1;2;A;;645;449;196;1;1;447;448
17;Girona;10;Baix Empordà;17034;Calonge i Sant Antoni;1;3;A;;522;339;183;0;2;337;339
17;Girona;10;Baix Empordà;17034;Calonge i Sant Antoni;1;4;A;;685;399;286;2;4;393;397
8;Barcelona;6;Anoia;08036;Calonge de Segarra;1;1;A;;163;136;27;0;1;135;136
25;Lleida;23;Noguera;25062;Camarasa;1;1;A;;834;564;270;2;7;555;562
43;Tarragona;9;Baix Ebre;43903;Camarles;1;1;A;;801;564;237;0;1;563;564
43;Tarragona;9;Baix Ebre;43903;Camarles;1;1;B;;689;505;184;0;0;505;505
43;Tarragona;9;Baix Ebre;43903;Camarles;1;2;A;;735;444;291;0;1;443;444
43;Tarragona;8;Baix Camp;43038;Cambrils;1;1;A;;659;330;329;1;1;328;329
43;Tarragona;8;Baix Camp;43038;Cambrils;1;1;B;;759;428;331;2;0;426;426
43;Tarragona;8;Baix Camp;43038;Cambrils;1;2;A;;1041;557;484;1;5;551;556
43;Tarragona;8;Baix Camp;43038;Cambrils;1;3;A;;1316;760;556;11;7;742;749
43;Tarragona;8;Baix Camp;43038;Cambrils;1;4;A;;908;385;523;4;6;375;381
43;Tarragona;8;Baix Camp;43038;Cambrils;2;1;A;;678;409;269;0;1;408;409
43;Tarragona;8;Baix Camp;43038;Cambrils;2;1;B;;673;397;276;1;5;391;396
43;Tarragona;8;Baix Camp;43038;Cambrils;2;2;A;;987;502;485;1;0;501;501
43;Tarragona;8;Baix Camp;43038;Cambrils;2;2;B;;1043;489;554;0;3;486;489
43;Tarragona;8;Baix Camp;43038;Cambrils;2;3;A;;757;314;443;0;4;310;314
43;Tarragona;8;Baix Camp;43038;Cambrils;2;3;B;;879;369;510;0;2;367;369
17;Girona;28;Pla de l'Estany;17035;Camós;1;1;A;;470;320;150;4;1;315;316
17;Girona;31;Ripollès;17036;Campdevànol;1;1;A;;416;302;114;1;1;300;301
17;Girona;31;Ripollès;17036;Campdevànol;1;1;B;;531;372;159;0;5;367;372
17;Girona;31;Ripollès;17036;Campdevànol;1;2;A;;501;364;137;1;0;363;363
17;Girona;31;Ripollès;17036;Campdevànol;1;2;B;;567;419;148;0;2;417;419
17;Girona;31;Ripollès;17036;Campdevànol;1;3;A;;769;516;253;0;3;513;516
17;Girona;31;Ripollès;17037;Campelles;1;1;A;;116;77;39;0;0;77;77
8;Barcelona;41;Vallès Oriental;08039;Campins;1;1;A;;149;112;37;0;0;112;112
17;Girona;20;Gironès;17038;Campllong;1;1;A;;219;146;73;2;0;144;144
17;Girona;31;Ripollès;17039;Camprodon;1;1;A;;558;441;117;1;7;433;440
17;Girona;31;Ripollès;17039;Camprodon;1;1;B;;769;605;164;3;3;599;602
17;Girona;31;Ripollès;17039;Camprodon;1;1;C;;489;382;107;1;3;378;381
25;Lleida;39;Consell General d'Aran;25063;Canejan;1;1;A;;105;52;53;0;0;52;52
17;Girona;20;Gironès;17040;Canet d'Adri;1;1;A;;350;216;134;0;2;214;216
8;Barcelona;21;Maresme;08040;Canet de Mar;1;1;A;;1737;1226;511;6;10;1210;1220
8;Barcelona;21;Maresme;08040;Canet de Mar;1;2;A;;1308;824;484;4;5;815;820
8;Barcelona;21;Maresme;08040;Canet de Mar;1;3;A;;1608;1005;603;1;8;996;1004
8;Barcelona;21;Maresme;08040;Canet de Mar;1;4;A;;1766;1145;621;2;4;1139;1143
8;Barcelona;41;Vallès Oriental;08041;Canovelles;1;1;A;;1048;562;486;2;2;558;560
8;Barcelona;41;Vallès Oriental;08041;Canovelles;1;2;A;;714;432;282;10;1;421;422
8;Barcelona;41;Vallès Oriental;08041;Canovelles;1;2;B;;882;512;370;0;5;507;512
8;Barcelona;41;Vallès Oriental;08041;Canovelles;1;3;A;;616;349;267;1;6;342;348
8;Barcelona;41;Vallès Oriental;08041;Canovelles;1;3;B;;780;436;344;0;0;436;436
8;Barcelona;41;Vallès Oriental;08041;Canovelles;1;4;A;;969;526;443;4;2;520;522
8;Barcelona;41;Vallès Oriental;08041;Canovelles;1;5;A;;565;370;195;0;0;370;370
8;Barcelona;41;Vallès Oriental;08041;Canovelles;1;5;B;;729;434;295;1;1;432;433
8;Barcelona;41;Vallès Oriental;08041;Canovelles;1;6;A;;970;546;424;2;1;543;544
8;Barcelona;41;Vallès Oriental;08041;Canovelles;1;7;A;;999;678;321;5;4;669;673
8;Barcelona;41;Vallès Oriental;08041;Canovelles;1;8;A;;544;346;198;5;1;340;341
8;Barcelona;41;Vallès Oriental;08042;Cànoves i Samalús;1;1;A;;572;395;177;0;1;394;395
17;Girona;2;Alt Empordà;17041;Cantallops;1;1;A;;219;171;48;4;0;167;167
8;Barcelona;17;Garraf;08043;Canyelles;1;1;A;;437;294;143;1;1;292;293
43;Tarragona;8;Baix Camp;43039;Capafonts;1;1;A;;92;49;43;0;2;47;49
43;Tarragona;29;Priorat;43040;Capçanes;1;1;A;;342;219;123;0;7;212;219
8;Barcelona;6;Anoia;08044;Capellades;1;1;A;;808;526;282;1;3;522;525
8;Barcelona;6;Anoia;08044;Capellades;1;1;B;;879;606;273;0;8;598;606
8;Barcelona;6;Anoia;08044;Capellades;2;1;A;;842;589;253;1;2;586;588
8;Barcelona;6;Anoia;08044;Capellades;2;1;B;;1044;756;288;1;3;752;755
17;Girona;2;Alt Empordà;17042;Capmany;1;1;A;;361;278;83;0;0;278;278
8;Barcelona;14;Berguedà;08045;Capolat;1;1;A;;61;36;25;1;0;35;35
8;Barcelona;41;Vallès Oriental;08046;Cardedeu;1;1;A;;714;473;241;2;4;467;471
8;Barcelona;41;Vallès Oriental;08046;Cardedeu;1;1;B;;846;530;316;3;1;526;527
8;Barcelona;41;Vallès Oriental;08046;Cardedeu;1;2;A;;822;566;256;0;3;563;566
8;Barcelona;41;Vallès Oriental;08046;Cardedeu;2;1;A;;626;428;198;12;1;415;416
8;Barcelona;41;Vallès Oriental;08046;Cardedeu;2;1;B;;650;406;244;9;4;393;397
8;Barcelona;41;Vallès Oriental;08046;Cardedeu;2;1;C;;725;475;250;3;4;468;472
8;Barcelona;41;Vallès Oriental;08046;Cardedeu;2;2;A;;641;448;193;1;0;447;447
8;Barcelona;41;Vallès Oriental;08046;Cardedeu;2;2;B;;832;509;323;0;5;504;509
8;Barcelona;7;Bages;08047;Cardona;1;1;A;;871;604;267;3;4;597;601
8;Barcelona;7;Bages;08047;Cardona;1;1;B;;975;677;298;2;5;670;675
8;Barcelona;7;Bages;08047;Cardona;1;2;A;;677;451;226;0;5;446;451
8;Barcelona;7;Bages;08047;Cardona;1;2;B;;707;444;263;2;4;438;442
8;Barcelona;7;Bages;08047;Cardona;2;1;A;;611;360;251;0;4;356;360
8;Barcelona;7;Bages;08047;Cardona;2;2;A;;843;535;308;8;2;525;527
8;Barcelona;7;Bages;08047;Cardona;2;3;A;;582;399;183;0;3;396;399
8;Barcelona;6;Anoia;08048;Carme;1;1;A;;532;408;124;1;0;407;407
43;Tarragona;37;Terra Alta;43041;Caseres;1;1;A;;288;220;68;0;1;219;220
17;Girona;20;Gironès;17044;Cassà de la Selva;1;1;A;;833;506;327;1;5;500;505
17;Girona;20;Gironès;17044;Cassà de la Selva;1;2;A;;444;295;149;3;2;290;292
17;Girona;20;Gironès;17044;Cassà de la Selva;1;2;B;;558;359;199;2;2;355;357
17;Girona;20;Gironès;17044;Cassà de la Selva;2;1;A;;682;432;250;3;5;424;429
17;Girona;20;Gironès;17044;Cassà de la Selva;2;1;B;;758;471;287;4;7;460;467
17;Girona;20;Gironès;17044;Cassà de la Selva;2;2;A;;674;448;226;4;0;444;444
17;Girona;20;Gironès;17044;Cassà de la Selva;2;2;B;;779;472;307;7;3;462;465
17;Girona;20;Gironès;17044;Cassà de la Selva;2;3;A;;646;441;205;2;0;439;439
8;Barcelona;14;Berguedà;08049;Casserres;1;1;A;;1055;690;365;4;3;683;686
8;Barcelona;14;Berguedà;08049;Casserres;1;2;A;;386;292;94;1;1;290;291
25;Lleida;35;Solsonès;25064;Castellar de la Ribera;1;1;A;;135;95;40;0;0;95;95
8;Barcelona;14;Berguedà;08050;Castellar del Riu;1;1;A;;41;20;21;0;0;20;20
8;Barcelona;40;Vallès Occidental;08051;Castellar del Vallès;1;1;A;;994;636;358;1;0;635;635
8;Barcelona;40;Vallès Occidental;08051;Castellar del Vallès;1;2;A;;867;532;335;1;0;531;531
8;Barcelona;40;Vallès Occidental;08051;Castellar del Vallès;1;2;B;;1067;686;381;2;5;679;684
8;Barcelona;40;Vallès Occidental;08051;Castellar del Vallès;1;3;A;;1013;662;351;0;2;660;662
8;Barcelona;40;Vallès Occidental;08051;Castellar del Vallès;1;4;A;;725;463;262;0;2;461;463
8;Barcelona;40;Vallès Occidental;08051;Castellar del Vallès;1;4;B;;815;499;316;1;1;497;498
8;Barcelona;40;Vallès Occidental;08051;Castellar del Vallès;1;5;A;;666;454;212;1;1;452;453
8;Barcelona;40;Vallès Occidental;08051;Castellar del Vallès;1;5;B;;711;476;235;1;2;473;475
8;Barcelona;40;Vallès Occidental;08051;Castellar del Vallès;1;6;A;;955;579;376;0;0;579;579
8;Barcelona;40;Vallès Occidental;08051;Castellar del Vallès;1;7;A;;561;350;211;2;3;345;348
8;Barcelona;40;Vallès Occidental;08051;Castellar del Vallès;1;7;B;;567;332;235;1;1;330;331
8;Barcelona;14;Berguedà;08052;Castellar de n'Hug;1;1;A;;149;103;46;0;0;103;103
8;Barcelona;7;Bages;08053;Castellbell i el Vilar;1;1;A;;1266;884;382;1;4;879;883
8;Barcelona;7;Bages;08053;Castellbell i el Vilar;1;2;A;;1258;594;664;2;4;588;592
8;Barcelona;40;Vallès Occidental;08054;Castellbisbal;1;1;A;;558;361;197;2;3;356;359
8;Barcelona;40;Vallès Occidental;08054;Castellbisbal;1;1;B;;837;533;304;1;3;529;532
8;Barcelona;40;Vallès Occidental;08054;Castellbisbal;1;2;A;;670;376;294;2;4;370;374
8;Barcelona;40;Vallès Occidental;08054;Castellbisbal;1;2;B;;900;574;326;3;0;571;571
8;Barcelona;;;08055;Castellcir;1;1;A;;175;133;42;1;2;130;132
25;Lleida;18;Garrigues;25067;Castelldans;1;1;A;;845;455;390;0;2;453;455
8;Barcelona;11;Baix Llobregat;08056;Castelldefels;1;1;A;;656;366;290;3;1;362;363
8;Barcelona;11;Baix Llobregat;08056;Castelldefels;1;2;A;;568;337;231;0;2;335;337
8;Barcelona;11;Baix Llobregat;08056;Castelldefels;1;2;B;;661;410;251;0;4;406;410
8;Barcelona;11;Baix Llobregat;08056;Castelldefels;1;3;A;;1001;542;459;0;2;540;542
8;Barcelona;11;Baix Llobregat;08056;Castelldefels;1;4;A;;863;379;484;2;1;376;377
8;Barcelona;11;Baix Llobregat;08056;Castelldefels;1;4;B;;877;372;505;4;3;365;368
8;Barcelona;11;Baix Llobregat;08056;Castelldefels;1;5;A;;916;426;490;0;4;422;426
8;Barcelona;11;Baix Llobregat;08056;Castelldefels;1;6;A;;667;334;333;2;3;329;332
8;Barcelona;11;Baix Llobregat;08056;Castelldefels;1;6;B;;774;386;388;3;5;378;383
8;Barcelona;11;Baix Llobregat;08056;Castelldefels;2;1;A;;1072;582;490;4;2;576;578
8;Barcelona;11;Baix Llobregat;08056;Castelldefels;2;2;A;;802;402;400;0;2;400;402
8;Barcelona;11;Baix Llobregat;08056;Castelldefels;2;2;B;;845;436;409;7;1;428;429
8;Barcelona;11;Baix Llobregat;08056;Castelldefels;2;3;A;;1030;609;421;1;3;605;608
8;Barcelona;11;Baix Llobregat;08056;Castelldefels;2;4;A;;674;395;279;3;2;390;392
8;Barcelona;11;Baix Llobregat;08056;Castelldefels;2;4;B;;703;376;327;2;1;373;374
8;Barcelona;11;Baix Llobregat;08056;Castelldefels;2;4;C;;695;362;333;5;0;357;357
8;Barcelona;11;Baix Llobregat;08056;Castelldefels;3;1;A;;795;405;390;3;3;399;402
8;Barcelona;11;Baix Llobregat;08056;Castelldefels;3;1;B;;1041;507;534;1;1;505;506
8;Barcelona;11;Baix Llobregat;08056;Castelldefels;3;2;A;;883;530;353;1;0;529;529
8;Barcelona;11;Baix Llobregat;08056;Castelldefels;4;1;A;;1074;618;456;1;3;614;617
8;Barcelona;11;Baix Llobregat;08056;Castelldefels;4;2;A;;579;282;297;2;2;278;280
8;Barcelona;11;Baix Llobregat;08056;Castelldefels;4;2;B;;659;336;323;1;2;333;335
8;Barcelona;11;Baix Llobregat;08056;Castelldefels;5;1;A;;786;368;418;0;1;367;368
8;Barcelona;11;Baix Llobregat;08056;Castelldefels;5;1;B;;843;368;475;0;0;368;368
8;Barcelona;14;Berguedà;08057;Castell de l'Areny;1;1;A;;28;23;5;1;0;22;22
25;Lleida;25;Pallars Jussà;25904;Castell de Mur;1;1;A;;130;89;41;0;0;89;89
8;Barcelona;3;Alt Penedès;08058;Castellet i la Gornal;1;1;A;;403;230;173;3;2;225;227
8;Barcelona;3;Alt Penedès;08058;Castellet i la Gornal;1;2;A;;432;313;119;9;2;302;304
17;Girona;19;Garrotxa;17046;Castellfollit de la Roca;1;1;A;;458;347;111;4;6;337;343
17;Girona;19;Garrotxa;17046;Castellfollit de la Roca;1;1;B;;432;316;116;4;8;304;312
8;Barcelona;7;Bages;08059;Castellfollit del Boix;1;1;A;;278;176;102;0;1;175;176
8;Barcelona;6;Anoia;08060;Castellfollit de Riubregós;1;1;A;;233;171;62;1;2;168;170
8;Barcelona;7;Bages;08061;Castellgalí;1;1;A;;566;427;139;5;2;420;422
8;Barcelona;7;Bages;08062;Castellnou de Bages;1;1;A;;75;64;11;0;2;62;64
25;Lleida;27;Pla d'Urgell;25068;Castellnou de Seana;1;1;A;;621;380;241;1;6;373;379
17;Girona;2;Alt Empordà;17047;Castelló d'Empúries;1;1;A;;763;539;224;1;1;537;538
17;Girona;2;Alt Empordà;17047;Castelló d'Empúries;1;1;B;;461;236;225;0;1;235;236
17;Girona;2;Alt Empordà;17047;Castelló d'Empúries;1;2;A;;979;696;283;7;3;686;689
25;Lleida;23;Noguera;25069;Castelló de Farfanya;1;1;A;;527;313;214;10;3;300;303
8;Barcelona;6;Anoia;08063;Castellolí;1;1;A;;343;257;86;5;2;250;252
17;Girona;10;Baix Empordà;17048;Castell-Platja d'Aro;1;1;A;;652;470;182;2;2;466;468
17;Girona;10;Baix Empordà;17048;Castell-Platja d'Aro;1;2;A;;539;360;179;0;4;356;360
17;Girona;10;Baix Empordà;17048;Castell-Platja d'Aro;1;2;B;;513;350;163;0;3;347;350
17;Girona;10;Baix Empordà;17048;Castell-Platja d'Aro;1;3;A;;558;329;229;0;1;328;329
17;Girona;10;Baix Empordà;17048;Castell-Platja d'Aro;1;3;B;;724;473;251;2;1;470;471
25;Lleida;38;Urgell;25070;Castellserà;1;1;A;;986;637;349;4;3;630;633
8;Barcelona;;;08064;Castellterçol;1;1;A;;804;655;149;5;2;648;650
8;Barcelona;;;08064;Castellterçol;1;1;B;;746;612;134;2;4;606;610
43;Tarragona;8;Baix Camp;43042;Castellvell del Camp;1;1;A;;553;393;160;2;3;388;391
8;Barcelona;3;Alt Penedès;08065;Castellví de la Marca;1;1;A;;1047;569;478;2;6;561;567
8;Barcelona;11;Baix Llobregat;08066;Castellví de Rosanes;1;1;A;;354;254;100;0;0;254;254
43;Tarragona;36;Tarragonès;43043;Catllar, el;1;1;A;;705;518;187;1;2;515;517
25;Lleida;4;Alt Urgell;25071;Cava;1;1;A;;49;28;21;0;0;28;28
17;Girona;34;Selva;17189;Cellera de Ter, la;1;1;A;;821;576;245;2;1;573;574
17;Girona;34;Selva;17189;Cellera de Ter, la;1;2;A;;745;525;220;1;1;523;524
17;Girona;20;Gironès;17049;Celrà;1;1;A;;839;524;315;6;3;515;518
17;Girona;20;Gironès;17049;Celrà;1;1;B;;903;569;334;4;2;563;565
8;Barcelona;24;Osona;08067;Centelles;1;1;A;;526;363;163;1;6;356;362
8;Barcelona;24;Osona;08067;Centelles;1;1;B;;539;388;151;2;2;384;386
8;Barcelona;24;Osona;08067;Centelles;1;2;A;;425;285;140;1;0;284;284
8;Barcelona;24;Osona;08067;Centelles;1;2;B;;546;384;162;4;3;377;380
8;Barcelona;24;Osona;08067;Centelles;1;3;A;;376;243;133;3;2;238;240
8;Barcelona;24;Osona;08067;Centelles;1;3;B;;531;362;169;2;0;360;360
8;Barcelona;24;Osona;08067;Centelles;1;4;A;;554;370;184;2;0;368;368
8;Barcelona;24;Osona;08067;Centelles;1;4;B;;834;554;280;2;1;551;552
8;Barcelona;14;Berguedà;08268;Cercs;1;1;A;;406;269;137;1;0;268;268
8;Barcelona;14;Berguedà;08268;Cercs;1;1;B;;343;174;169;1;1;172;173
8;Barcelona;14;Berguedà;08268;Cercs;1;2;A;;737;526;211;1;2;523;525
8;Barcelona;40;Vallès Occidental;08266;Cerdanyola del Vallès;1;1;A;;619;352;267;1;2;349;351
8;Barcelona;40;Vallès Occidental;08266;Cerdanyola del Vallès;1;1;B;;713;404;309;2;2;400;402
8;Barcelona;40;Vallès Occidental;08266;Cerdanyola del Vallès;1;10;A;;806;435;371;1;3;431;434
8;Barcelona;40;Vallès Occidental;08266;Cerdanyola del Vallès;1;10;B;;925;530;395;0;6;524;530
8;Barcelona;40;Vallès Occidental;08266;Cerdanyola del Vallès;1;11;A;;693;273;420;0;1;272;273
8;Barcelona;40;Vallès Occidental;08266;Cerdanyola del Vallès;1;12;A;;791;460;331;2;0;458;458
8;Barcelona;40;Vallès Occidental;08266;Cerdanyola del Vallès;1;12;B;;957;549;408;3;0;546;546
8;Barcelona;40;Vallès Occidental;08266;Cerdanyola del Vallès;1;13;A;;800;430;370;2;5;423;428
8;Barcelona;40;Vallès Occidental;08266;Cerdanyola del Vallès;1;13;B;;910;474;436;0;3;471;474
8;Barcelona;40;Vallès Occidental;08266;Cerdanyola del Vallès;1;14;A;;1038;608;430;0;5;603;608
8;Barcelona;40;Vallès Occidental;08266;Cerdanyola del Vallès;1;14;B;;1101;657;444;4;6;647;653
8;Barcelona;40;Vallès Occidental;08266;Cerdanyola del Vallès;1;15;A;;805;383;422;0;4;379;383
8;Barcelona;40;Vallès Occidental;08266;Cerdanyola del Vallès;1;15;B;;890;462;428;0;0;462;462
8;Barcelona;40;Vallès Occidental;08266;Cerdanyola del Vallès;1;16;A;;698;390;308;0;2;388;390
8;Barcelona;40;Vallès Occidental;08266;Cerdanyola del Vallès;1;16;B;;725;406;319;1;2;403;405
8;Barcelona;40;Vallès Occidental;08266;Cerdanyola del Vallès;1;17;A;;929;485;444;2;2;481;483
8;Barcelona;40;Vallès Occidental;08266;Cerdanyola del Vallès;1;17;B;;954;488;466;0;0;488;488
8;Barcelona;40;Vallès Occidental;08266;Cerdanyola del Vallès;1;18;A;;736;413;323;0;3;410;413
8;Barcelona;40;Vallès Occidental;08266;Cerdanyola del Vallès;1;18;B;;831;450;381;0;4;446;450
8;Barcelona;40;Vallès Occidental;08266;Cerdanyola del Vallès;1;19;A;;729;394;335;0;7;387;394
8;Barcelona;40;Vallès Occidental;08266;Cerdanyola del Vallès;1;19;B;;885;471;414;1;4;466;470
8;Barcelona;40;Vallès Occidental;08266;Cerdanyola del Vallès;1;2;A;;552;286;266;2;4;280;284
8;Barcelona;40;Vallès Occidental;08266;Cerdanyola del Vallès;1;2;B;;653;377;276;1;0;376;376
8;Barcelona;40;Vallès Occidental;08266;Cerdanyola del Vallès;1;20;A;;1083;773;310;0;10;763;773
8;Barcelona;40;Vallès Occidental;08266;Cerdanyola del Vallès;1;21;A;;1069;465;604;0;2;463;465
8;Barcelona;40;Vallès Occidental;08266;Cerdanyola del Vallès;1;22;A;;830;362;468;1;5;356;361
8;Barcelona;40;Vallès Occidental;08266;Cerdanyola del Vallès;1;23;A;;1166;517;649;2;1;514;515
8;Barcelona;40;Vallès Occidental;08266;Cerdanyola del Vallès;1;24;A;;1090;470;620;4;1;465;466
8;Barcelona;40;Vallès Occidental;08266;Cerdanyola del Vallès;1;25;A;;1050;465;585;0;1;464;465
8;Barcelona;40;Vallès Occidental;08266;Cerdanyola del Vallès;1;26;A;;1309;570;739;7;3;560;563
8;Barcelona;40;Vallès Occidental;08266;Cerdanyola del Vallès;1;3;A;;686;367;319;0;3;364;367
8;Barcelona;40;Vallès Occidental;08266;Cerdanyola del Vallès;1;3;B;;879;433;446;2;1;430;431
8;Barcelona;40;Vallès Occidental;08266;Cerdanyola del Vallès;1;4;A;;834;452;382;0;3;449;452
8;Barcelona;40;Vallès Occidental;08266;Cerdanyola del Vallès;1;4;B;;995;553;442;0;3;550;553
8;Barcelona;40;Vallès Occidental;08266;Cerdanyola del Vallès;1;5;A;;981;516;465;1;0;515;515
8;Barcelona;40;Vallès Occidental;08266;Cerdanyola del Vallès;1;5;B;;1030;533;497;3;2;528;530
8;Barcelona;40;Vallès Occidental;08266;Cerdanyola del Vallès;1;6;A;;764;397;367;0;1;396;397
8;Barcelona;40;Vallès Occidental;08266;Cerdanyola del Vallès;1;7;A;;896;483;413;2;5;476;481
8;Barcelona;40;Vallès Occidental;08266;Cerdanyola del Vallès;1;7;B;;987;503;484;2;3;498;501
8;Barcelona;40;Vallès Occidental;08266;Cerdanyola del Vallès;1;8;A;;889;481;408;0;3;478;481
8;Barcelona;40;Vallès Occidental;08266;Cerdanyola del Vallès;1;8;B;;1005;580;425;1;4;575;579
8;Barcelona;40;Vallès Occidental;08266;Cerdanyola del Vallès;1;9;A;;716;441;275;0;5;436;441
8;Barcelona;40;Vallès Occidental;08266;Cerdanyola del Vallès;1;9;B;;852;484;368;2;5;477;482
8;Barcelona;11;Baix Llobregat;08068;Cervelló;1;1;A;;641;369;272;1;0;368;368
8;Barcelona;11;Baix Llobregat;08068;Cervelló;1;1;B;;773;414;359;3;0;411;411
8;Barcelona;11;Baix Llobregat;08068;Cervelló;1;2;A;;691;438;253;3;2;433;435
8;Barcelona;11;Baix Llobregat;08068;Cervelló;1;3;A;;1002;630;372;6;3;621;624
25;Lleida;32;Segarra;25072;Cervera;1;1;A;;612;389;223;4;0;385;385
25;Lleida;32;Segarra;25072;Cervera;1;1;B;;755;486;269;3;6;477;483
25;Lleida;32;Segarra;25072;Cervera;2;1;A;;656;445;211;0;1;444;445
25;Lleida;32;Segarra;25072;Cervera;2;1;B;;792;537;255;5;3;529;532
25;Lleida;32;Segarra;25072;Cervera;2;2;A;;754;467;287;4;2;461;463
25;Lleida;32;Segarra;25072;Cervera;2;2;B;;881;560;321;2;7;551;558
25;Lleida;32;Segarra;25072;Cervera;3;1;A;;768;487;281;7;6;474;480
25;Lleida;18;Garrigues;25073;Cervià de les Garrigues;1;1;A;;745;481;264;0;3;478;481
17;Girona;20;Gironès;17050;Cervià de Ter;1;1;A;;503;375;128;6;3;366;369
17;Girona;2;Alt Empordà;17051;Cistella;1;1;A;;170;126;44;0;0;126;126
25;Lleida;38;Urgell;25074;Ciutadilla;1;1;A;;210;153;57;0;2;151;153
25;Lleida;35;Solsonès;25075;Clariana de Cardener;1;1;A;;132;96;36;0;2;94;96
25;Lleida;18;Garrigues;25076;Cogul, el;1;1;A;;196;106;90;0;1;105;106
17;Girona;2;Alt Empordà;17054;Colera;1;1;A;;346;246;100;2;0;244;244
8;Barcelona;11;Baix Llobregat;08069;Collbató;1;1;A;;563;395;168;2;2;391;393
43;Tarragona;8;Baix Camp;43045;Colldejou;1;1;A;;149;87;62;0;2;85;87
25;Lleida;4;Alt Urgell;25077;Coll de Nargó;1;1;A;;563;316;247;1;1;314;315
8;Barcelona;;;08070;Collsuspina;1;1;A;;167;123;44;0;1;122;123
17;Girona;10;Baix Empordà;17055;Colomers;1;1;A;;180;128;52;0;1;127;128
25;Lleida;35;Solsonès;25163;Coma i la Pedra, la;1;1;A;;203;128;75;0;1;127;128
25;Lleida;25;Pallars Jussà;25161;Conca de Dalt;1;1;A;;391;227;164;0;0;227;227
43;Tarragona;16;Conca de Barberà;43046;Conesa;1;1;A;;118;72;46;0;1;71;72
43;Tarragona;36;Tarragonès;43047;Constantí;1;1;A;;503;337;166;4;3;330;333
43;Tarragona;36;Tarragonès;43047;Constantí;1;1;B;;593;405;188;1;0;404;404
43;Tarragona;36;Tarragonès;43047;Constantí;1;2;A;;602;265;337;1;2;262;264
43;Tarragona;36;Tarragonès;43047;Constantí;1;2;B;;733;342;391;0;1;341;342
43;Tarragona;36;Tarragonès;43047;Constantí;2;1;A;;607;392;215;3;1;388;389
43;Tarragona;36;Tarragonès;43047;Constantí;2;1;B;;847;533;314;2;5;526;531
8;Barcelona;6;Anoia;08071;Copons;1;1;A;;254;172;82;1;4;167;171
43;Tarragona;37;Terra Alta;43048;Corbera d'Ebre;1;1;A;;932;550;382;0;5;545;550
8;Barcelona;11;Baix Llobregat;08072;Corbera de Llobregat;1;1;A;;759;497;262;1;3;493;496
8;Barcelona;11;Baix Llobregat;08072;Corbera de Llobregat;1;1;B;;579;356;223;3;0;353;353
8;Barcelona;11;Baix Llobregat;08072;Corbera de Llobregat;1;1;C;;705;444;261;1;3;440;443
8;Barcelona;11;Baix Llobregat;08072;Corbera de Llobregat;1;1;D;;764;500;264;11;4;485;489
25;Lleida;33;Segrià;25078;Corbins;1;1;A;;836;456;380;2;0;454;454
17;Girona;10;Baix Empordà;17057;Corçà;1;1;A;;827;566;261;7;3;556;559
8;Barcelona;11;Baix Llobregat;08073;Cornellà de Llobregat;1;1;A;;619;372;247;1;2;369;371
8;Barcelona;11;Baix Llobregat;08073;Cornellà de Llobregat;1;1;B;;799;472;327;0;2;470;472
8;Barcelona;11;Baix Llobregat;08073;Cornellà de Llobregat;1;10;A;;578;319;259;2;2;315;317
8;Barcelona;11;Baix Llobregat;08073;Cornellà de Llobregat;1;10;B;;639;358;281;4;1;353;354
8;Barcelona;11;Baix Llobregat;08073;Cornellà de Llobregat;1;11;A;;835;399;436;13;3;383;386
8;Barcelona;11;Baix Llobregat;08073;Cornellà de Llobregat;1;12;A;;821;379;442;12;0;367;367
8;Barcelona;11;Baix Llobregat;08073;Cornellà de Llobregat;1;13;A;;504;248;256;0;0;248;248
8;Barcelona;11;Baix Llobregat;08073;Cornellà de Llobregat;1;13;B;;506;270;236;0;3;267;270
8;Barcelona;11;Baix Llobregat;08073;Cornellà de Llobregat;1;14;A;;845;475;370;1;2;472;474
8;Barcelona;11;Baix Llobregat;08073;Cornellà de Llobregat;1;2;A;;640;360;280;0;0;360;360
8;Barcelona;11;Baix Llobregat;08073;Cornellà de Llobregat;1;2;B;;769;431;338;0;1;430;431
8;Barcelona;11;Baix Llobregat;08073;Cornellà de Llobregat;1;3;A;;549;275;274;1;0;274;274
8;Barcelona;11;Baix Llobregat;08073;Cornellà de Llobregat;1;3;B;;612;287;325;0;2;285;287
8;Barcelona;11;Baix Llobregat;08073;Cornellà de Llobregat;1;4;A;;900;475;425;5;1;469;470
8;Barcelona;11;Baix Llobregat;08073;Cornellà de Llobregat;1;5;A;;798;431;367;1;1;429;430
8;Barcelona;11;Baix Llobregat;08073;Cornellà de Llobregat;1;6;A;;482;296;186;3;0;293;293
8;Barcelona;11;Baix Llobregat;08073;Cornellà de Llobregat;1;7;A;;536;316;220;0;1;315;316
8;Barcelona;11;Baix Llobregat;08073;Cornellà de Llobregat;1;7;B;;644;396;248;1;0;395;395
8;Barcelona;11;Baix Llobregat;08073;Cornellà de Llobregat;1;8;A;;470;240;230;0;0;240;240
8;Barcelona;11;Baix Llobregat;08073;Cornellà de Llobregat;1;8;B;;495;248;247;1;3;244;247
8;Barcelona;11;Baix Llobregat;08073;Cornellà de Llobregat;1;9;A;;470;273;197;2;0;271;271
8;Barcelona;11;Baix Llobregat;08073;Cornellà de Llobregat;1;9;B;;500;319;181;1;4;314;318
8;Barcelona;11;Baix Llobregat;08073;Cornellà de Llobregat;2;1;A;;869;432;437;7;0;425;425
8;Barcelona;11;Baix Llobregat;08073;Cornellà de Llobregat;2;2;A;;924;523;401;10;1;512;513
8;Barcelona;11;Baix Llobregat;08073;Cornellà de Llobregat;3;1;A;;455;257;198;0;0;257;257
8;Barcelona;11;Baix Llobregat;08073;Cornellà de Llobregat;3;1;B;;482;271;211;0;2;269;271
8;Barcelona;11;Baix Llobregat;08073;Cornellà de Llobregat;3;2;A;;523;292;231;0;0;292;292
8;Barcelona;11;Baix Llobregat;08073;Cornellà de Llobregat;3;2;B;;560;302;258;1;1;300;301
8;Barcelona;11;Baix Llobregat;08073;Cornellà de Llobregat;3;3;A;;646;348;298;2;1;345;346
8;Barcelona;11;Baix Llobregat;08073;Cornellà de Llobregat;3;4;A;;411;198;213;4;0;194;194
8;Barcelona;11;Baix Llobregat;08073;Cornellà de Llobregat;3;5;A;;798;418;380;2;7;409;416
8;Barcelona;11;Baix Llobregat;08073;Cornellà de Llobregat;3;6;A;;676;393;283;1;3;389;392
8;Barcelona;11;Baix Llobregat;08073;Cornellà de Llobregat;3;7;A;;440;239;201;0;2;237;239
8;Barcelona;11;Baix Llobregat;08073;Cornellà de Llobregat;3;7;B;;575;317;258;0;1;316;317
8;Barcelona;11;Baix Llobregat;08073;Cornellà de Llobregat;3;8;A;;812;387;425;3;2;382;384
8;Barcelona;11;Baix Llobregat;08073;Cornellà de Llobregat;3;9;A;;436;200;236;2;2;196;198
8;Barcelona;11;Baix Llobregat;08073;Cornellà de Llobregat;3;9;B;;517;219;298;1;3;215;218
8;Barcelona;11;Baix Llobregat;08073;Cornellà de Llobregat;4;1;A;;566;297;269;2;2;293;295
8;Barcelona;11;Baix Llobregat;08073;Cornellà de Llobregat;4;1;B;;677;348;329;0;2;346;348
8;Barcelona;11;Baix Llobregat;08073;Cornellà de Llobregat;4;10;A;;490;289;201;2;0;287;287
8;Barcelona;11;Baix Llobregat;08073;Cornellà de Llobregat;4;10;B;;550;332;218;1;3;328;331
8;Barcelona;11;Baix Llobregat;08073;Cornellà de Llobregat;4;11;A;;1021;518;503;1;0;517;517
8;Barcelona;11;Baix Llobregat;08073;Cornellà de Llobregat;4;12;A;;673;389;284;5;2;382;384
8;Barcelona;11;Baix Llobregat;08073;Cornellà de Llobregat;4;12;B;;745;412;333;1;1;410;411
8;Barcelona;11;Baix Llobregat;08073;Cornellà de Llobregat;4;13;A;;659;356;303;4;0;352;352
8;Barcelona;11;Baix Llobregat;08073;Cornellà de Llobregat;4;13;B;;738;390;348;0;2;388;390
8;Barcelona;11;Baix Llobregat;08073;Cornellà de Llobregat;4;14;A;;480;261;219;0;6;255;261
8;Barcelona;11;Baix Llobregat;08073;Cornellà de Llobregat;4;14;B;;554;292;262;0;5;287;292
8;Barcelona;11;Baix Llobregat;08073;Cornellà de Llobregat;4;15;A;;398;222;176;0;3;219;222
8;Barcelona;11;Baix Llobregat;08073;Cornellà de Llobregat;4;15;B;;516;289;227;2;0;287;287
8;Barcelona;11;Baix Llobregat;08073;Cornellà de Llobregat;4;16;A;;604;305;299;0;4;301;305
8;Barcelona;11;Baix Llobregat;08073;Cornellà de Llobregat;4;16;B;;647;359;288;6;3;350;353
8;Barcelona;11;Baix Llobregat;08073;Cornellà de Llobregat;4;17;A;;526;258;268;0;4;254;258
8;Barcelona;11;Baix Llobregat;08073;Cornellà de Llobregat;4;17;B;;604;318;286;0;0;318;318
8;Barcelona;11;Baix Llobregat;08073;Cornellà de Llobregat;4;18;A;;798;404;394;3;1;400;401
8;Barcelona;11;Baix Llobregat;08073;Cornellà de Llobregat;4;19;A;;828;424;404;1;3;420;423
8;Barcelona;11;Baix Llobregat;08073;Cornellà de Llobregat;4;2;A;;694;375;319;1;4;370;374
8;Barcelona;11;Baix Llobregat;08073;Cornellà de Llobregat;4;3;A;;615;326;289;0;3;323;326
8;Barcelona;11;Baix Llobregat;08073;Cornellà de Llobregat;4;3;B;;750;378;372;3;0;375;375
8;Barcelona;11;Baix Llobregat;08073;Cornellà de Llobregat;4;4;A;;560;323;237;3;1;319;320
8;Barcelona;11;Baix Llobregat;08073;Cornellà de Llobregat;4;4;B;;620;370;250;2;4;364;368
8;Barcelona;11;Baix Llobregat;08073;Cornellà de Llobregat;4;5;A;;413;232;181;2;1;229;230
8;Barcelona;11;Baix Llobregat;08073;Cornellà de Llobregat;4;5;B;;499;278;221;0;0;278;278
8;Barcelona;11;Baix Llobregat;08073;Cornellà de Llobregat;4;6;A;;687;342;345;0;0;342;342
8;Barcelona;11;Baix Llobregat;08073;Cornellà de Llobregat;4;6;B;;747;382;365;0;2;380;382
8;Barcelona;11;Baix Llobregat;08073;Cornellà de Llobregat;4;7;A;;437;243;194;2;1;240;241
8;Barcelona;11;Baix Llobregat;08073;Cornellà de Llobregat;4;7;B;;542;303;239;1;2;300;302
8;Barcelona;11;Baix Llobregat;08073;Cornellà de Llobregat;4;8;A;;641;354;287;1;1;352;353
8;Barcelona;11;Baix Llobregat;08073;Cornellà de Llobregat;4;8;B;;662;341;321;0;1;340;341
8;Barcelona;11;Baix Llobregat;08073;Cornellà de Llobregat;4;9;A;;858;498;360;4;4;490;494
8;Barcelona;11;Baix Llobregat;08073;Cornellà de Llobregat;5;1;A;;800;427;373;0;0;427;427
8;Barcelona;11;Baix Llobregat;08073;Cornellà de Llobregat;5;10;A;;556;260;296;1;1;258;259
8;Barcelona;11;Baix Llobregat;08073;Cornellà de Llobregat;5;10;B;;592;297;295;3;1;293;294
8;Barcelona;11;Baix Llobregat;08073;Cornellà de Llobregat;5;2;A;;762;330;432;0;4;326;330
8;Barcelona;11;Baix Llobregat;08073;Cornellà de Llobregat;5;3;A;;539;277;262;3;1;273;274
8;Barcelona;11;Baix Llobregat;08073;Cornellà de Llobregat;5;3;B;;488;245;243;3;1;241;242
8;Barcelona;11;Baix Llobregat;08073;Cornellà de Llobregat;5;4;A;;825;478;347;13;4;461;465
8;Barcelona;11;Baix Llobregat;08073;Cornellà de Llobregat;5;5;A;;917;470;447;1;0;469;469
8;Barcelona;11;Baix Llobregat;08073;Cornellà de Llobregat;5;6;A;;484;246;238;5;0;241;241
8;Barcelona;11;Baix Llobregat;08073;Cornellà de Llobregat;5;6;B;;557;268;289;5;2;261;263
8;Barcelona;11;Baix Llobregat;08073;Cornellà de Llobregat;5;7;A;;537;282;255;0;0;282;282
8;Barcelona;11;Baix Llobregat;08073;Cornellà de Llobregat;5;7;B;;645;309;336;1;3;305;308
8;Barcelona;11;Baix Llobregat;08073;Cornellà de Llobregat;5;8;A;;474;252;222;2;0;250;250
8;Barcelona;11;Baix Llobregat;08073;Cornellà de Llobregat;5;8;B;;475;252;223;3;0;249;249
8;Barcelona;11;Baix Llobregat;08073;Cornellà de Llobregat;5;9;A;;807;463;344;0;5;458;463
8;Barcelona;11;Baix Llobregat;08073;Cornellà de Llobregat;6;1;A;;629;257;372;5;0;252;252
8;Barcelona;11;Baix Llobregat;08073;Cornellà de Llobregat;6;10;A;;866;483;383;0;1;482;483
8;Barcelona;11;Baix Llobregat;08073;Cornellà de Llobregat;6;11;A;;584;295;289;1;4;290;294
8;Barcelona;11;Baix Llobregat;08073;Cornellà de Llobregat;6;12;A;;732;328;404;1;0;327;327
8;Barcelona;11;Baix Llobregat;08073;Cornellà de Llobregat;6;13;A;;705;371;334;1;2;368;370
8;Barcelona;11;Baix Llobregat;08073;Cornellà de Llobregat;6;14;A;;879;406;473;3;1;402;403
8;Barcelona;11;Baix Llobregat;08073;Cornellà de Llobregat;6;15;A;;764;379;385;0;0;379;379
8;Barcelona;11;Baix Llobregat;08073;Cornellà de Llobregat;6;16;A;;604;331;273;7;1;323;324
8;Barcelona;11;Baix Llobregat;08073;Cornellà de Llobregat;6;2;A;;504;267;237;7;3;257;260
8;Barcelona;11;Baix Llobregat;08073;Cornellà de Llobregat;6;2;B;;573;312;261;3;0;309;309
8;Barcelona;11;Baix Llobregat;08073;Cornellà de Llobregat;6;3;A;;591;309;282;0;3;306;309
8;Barcelona;11;Baix Llobregat;08073;Cornellà de Llobregat;6;4;A;;672;320;352;0;7;313;320
8;Barcelona;11;Baix Llobregat;08073;Cornellà de Llobregat;6;5;A;;803;418;385;1;0;417;417
8;Barcelona;11;Baix Llobregat;08073;Cornellà de Llobregat;6;6;A;;630;316;314;0;2;314;316
8;Barcelona;11;Baix Llobregat;08073;Cornellà de Llobregat;6;7;A;;446;222;224;2;0;220;220
8;Barcelona;11;Baix Llobregat;08073;Cornellà de Llobregat;6;7;B;;534;287;247;1;1;285;286
8;Barcelona;11;Baix Llobregat;08073;Cornellà de Llobregat;6;8;A;;700;329;371;10;1;318;319
8;Barcelona;11;Baix Llobregat;08073;Cornellà de Llobregat;6;9;A;;879;487;392;5;2;480;482
8;Barcelona;11;Baix Llobregat;08073;Cornellà de Llobregat;6;9;B;;993;546;447;8;1;537;538
17;Girona;28;Pla de l'Estany;17056;Cornellà del Terri;1;1;A;;625;443;182;5;2;436;438
17;Girona;28;Pla de l'Estany;17056;Cornellà del Terri;1;1;B;;704;479;225;3;0;476;476
43;Tarragona;29;Priorat;43049;Cornudella de Montsant;1;1;A;;763;620;143;3;2;615;617
43;Tarragona;36;Tarragonès;43050;Creixell;1;1;A;;524;345;179;1;0;344;344
17;Girona;28;Pla de l'Estany;17058;Crespià;1;1;A;;179;92;87;1;0;91;91
17;Girona;10;Baix Empordà;17901;Cruïlles, Monells i Sant Sadurní;1;1;A;;363;236;127;0;6;230;236
17;Girona;10;Baix Empordà;17901;Cruïlles, Monells i Sant Sadurní;1;1;B;;217;132;85;0;1;131;132
17;Girona;10;Baix Empordà;17901;Cruïlles, Monells i Sant Sadurní;1;1;C;;204;147;57;0;1;146;147
8;Barcelona;17;Garraf;08074;Cubelles;1;1;A;;931;571;360;1;4;566;570
8;Barcelona;17;Garraf;08074;Cubelles;1;1;B;;952;564;388;0;4;560;564
25;Lleida;23;Noguera;25079;Cubells;1;1;A;;347;257;90;0;0;257;257
43;Tarragona;12;Baix Penedès;43051;Cunit;1;1;A;;538;295;243;7;0;288;288
43;Tarragona;12;Baix Penedès;43051;Cunit;1;1;B;;571;316;255;4;3;309;312
17;Girona;2;Alt Empordà;17060;Darnius;1;1;A;;371;285;86;1;2;282;284
17;Girona;15;Cerdanya;17061;Das;1;1;A;;108;91;17;4;0;87;87
43;Tarragona;9;Baix Ebre;43901;Deltebre;1;1;A;;693;405;288;0;2;403;405
43;Tarragona;9;Baix Ebre;43901;Deltebre;1;1;B;;584;340;244;4;4;332;336
43;Tarragona;9;Baix Ebre;43901;Deltebre;1;2;A;;977;552;425;1;2;549;551
43;Tarragona;9;Baix Ebre;43901;Deltebre;1;2;B;;744;395;349;1;1;393;394
43;Tarragona;9;Baix Ebre;43901;Deltebre;1;3;A;;588;324;264;0;2;322;324
43;Tarragona;9;Baix Ebre;43901;Deltebre;1;3;B;;418;224;194;0;0;224;224
43;Tarragona;9;Baix Ebre;43901;Deltebre;1;4;A;;748;408;340;2;1;405;406
43;Tarragona;9;Baix Ebre;43901;Deltebre;1;4;B;;440;256;184;0;3;253;256
43;Tarragona;9;Baix Ebre;43901;Deltebre;1;5;A;;576;303;273;1;1;301;302
43;Tarragona;9;Baix Ebre;43901;Deltebre;1;5;B;;531;271;260;2;1;268;269
43;Tarragona;9;Baix Ebre;43901;Deltebre;1;6;A;;794;424;370;1;4;419;423
43;Tarragona;9;Baix Ebre;43901;Deltebre;1;6;B;;579;318;261;2;2;314;316
8;Barcelona;21;Maresme;08075;Dosrius;1;1;A;;468;303;165;2;1;300;301
8;Barcelona;21;Maresme;08075;Dosrius;1;1;B;;254;178;76;0;1;177;178
43;Tarragona;8;Baix Camp;43053;Duesaigües;1;1;A;;173;108;65;0;0;108;108
17;Girona;2;Alt Empordà;17062;Escala, l';1;1;A;;946;611;335;2;0;609;609
17;Girona;2;Alt Empordà;17062;Escala, l';1;2;A;;821;517;304;3;4;510;514
17;Girona;2;Alt Empordà;17062;Escala, l';1;2;B;;884;537;347;1;4;532;536
17;Girona;2;Alt Empordà;17062;Escala, l';1;3;A;;772;503;269;3;8;492;500
8;Barcelona;11;Baix Llobregat;08076;Esparreguera;1;1;A;;510;345;165;1;2;342;344
8;Barcelona;11;Baix Llobregat;08076;Esparreguera;1;1;B;;582;397;185;4;1;392;393
8;Barcelona;11;Baix Llobregat;08076;Esparreguera;1;2;A;;461;307;154;8;0;299;299
8;Barcelona;11;Baix Llobregat;08076;Esparreguera;1;2;B;;576;386;190;11;3;372;375
8;Barcelona;11;Baix Llobregat;08076;Esparreguera;1;3;A;;554;393;161;3;0;390;390
8;Barcelona;11;Baix Llobregat;08076;Esparreguera;1;3;B;;707;527;180;4;0;523;523
8;Barcelona;11;Baix Llobregat;08076;Esparreguera;1;4;A;;460;314;146;0;3;311;314
8;Barcelona;11;Baix Llobregat;08076;Esparreguera;1;4;B;;583;389;194;1;4;384;388
8;Barcelona;11;Baix Llobregat;08076;Esparreguera;1;5;A;;574;364;210;3;0;361;361
8;Barcelona;11;Baix Llobregat;08076;Esparreguera;2;1;A;;514;353;161;4;0;349;349
8;Barcelona;11;Baix Llobregat;08076;Esparreguera;2;1;B;;603;401;202;6;0;395;395
8;Barcelona;11;Baix Llobregat;08076;Esparreguera;2;2;A;;953;556;397;6;0;550;550
8;Barcelona;11;Baix Llobregat;08076;Esparreguera;2;3;A;;727;499;228;5;1;493;494
8;Barcelona;11;Baix Llobregat;08076;Esparreguera;2;4;A;;445;302;143;3;0;299;299
17;Girona;24;Osona;17063;Espinelves;1;1;A;;206;156;50;2;2;152;154
25;Lleida;18;Garrigues;25081;Espluga Calba, l';1;1;A;;350;208;142;0;2;206;208
43;Tarragona;16;Conca de Barberà;43054;Espluga de Francolí, l';1;1;A;;605;402;203;5;5;392;397
43;Tarragona;16;Conca de Barberà;43054;Espluga de Francolí, l';1;1;B;;415;244;171;2;2;240;242
43;Tarragona;16;Conca de Barberà;43054;Espluga de Francolí, l';1;1;C;;725;467;258;2;1;464;465
43;Tarragona;16;Conca de Barberà;43054;Espluga de Francolí, l';2;1;A;;477;311;166;3;2;306;308
43;Tarragona;16;Conca de Barberà;43054;Espluga de Francolí, l';2;1;B;;646;414;232;5;1;408;409
8;Barcelona;11;Baix Llobregat;08077;Esplugues de Llobregat;1;1;A;;788;470;318;1;2;467;469
8;Barcelona;11;Baix Llobregat;08077;Esplugues de Llobregat;1;1;B;;1044;584;460;4;3;577;580
8;Barcelona;11;Baix Llobregat;08077;Esplugues de Llobregat;1;2;A;;842;490;352;0;7;483;490
8;Barcelona;11;Baix Llobregat;08077;Esplugues de Llobregat;1;2;B;;915;554;361;2;3;549;552
8;Barcelona;11;Baix Llobregat;08077;Esplugues de Llobregat;1;3;A;;900;524;376;1;3;520;523
8;Barcelona;11;Baix Llobregat;08077;Esplugues de Llobregat;1;4;A;;508;320;188;0;2;318;320
8;Barcelona;11;Baix Llobregat;08077;Esplugues de Llobregat;1;4;B;;595;358;237;1;4;353;357
8;Barcelona;11;Baix Llobregat;08077;Esplugues de Llobregat;1;5;A;;706;458;248;1;8;449;457
8;Barcelona;11;Baix Llobregat;08077;Esplugues de Llobregat;1;6;A;;531;308;223;2;6;300;306
8;Barcelona;11;Baix Llobregat;08077;Esplugues de Llobregat;1;6;B;;612;344;268;4;2;338;340
8;Barcelona;11;Baix Llobregat;08077;Esplugues de Llobregat;1;7;A;;513;316;197;11;2;303;305
8;Barcelona;11;Baix Llobregat;08077;Esplugues de Llobregat;1;7;B;;564;377;187;0;2;375;377
8;Barcelona;11;Baix Llobregat;08077;Esplugues de Llobregat;2;1;A;;621;389;232;0;2;387;389
8;Barcelona;11;Baix Llobregat;08077;Esplugues de Llobregat;2;2;A;;659;407;252;0;6;401;407
8;Barcelona;11;Baix Llobregat;08077;Esplugues de Llobregat;3;1;A;;780;450;330;0;0;450;450
8;Barcelona;11;Baix Llobregat;08077;Esplugues de Llobregat;3;1;B;;930;550;380;5;2;543;545
8;Barcelona;11;Baix Llobregat;08077;Esplugues de Llobregat;3;2;A;;609;315;294;1;1;313;314
8;Barcelona;11;Baix Llobregat;08077;Esplugues de Llobregat;3;2;B;;760;419;341;0;3;416;419
8;Barcelona;11;Baix Llobregat;08077;Esplugues de Llobregat;3;3;A;;930;505;425;2;4;499;503
8;Barcelona;11;Baix Llobregat;08077;Esplugues de Llobregat;3;3;B;;966;524;442;0;3;521;524
8;Barcelona;11;Baix Llobregat;08077;Esplugues de Llobregat;3;4;A;;619;344;275;4;0;340;340
8;Barcelona;11;Baix Llobregat;08077;Esplugues de Llobregat;3;4;B;;838;437;401;5;1;431;432
8;Barcelona;11;Baix Llobregat;08077;Esplugues de Llobregat;3;5;A;;638;319;319;4;1;314;315
8;Barcelona;11;Baix Llobregat;08077;Esplugues de Llobregat;3;5;B;;676;358;318;1;1;356;357
8;Barcelona;11;Baix Llobregat;08077;Esplugues de Llobregat;3;6;A;;778;408;370;2;1;405;406
8;Barcelona;11;Baix Llobregat;08077;Esplugues de Llobregat;3;6;B;;832;431;401;2;4;425;429
8;Barcelona;11;Baix Llobregat;08077;Esplugues de Llobregat;3;7;A;;921;460;461;3;1;456;457
8;Barcelona;11;Baix Llobregat;08077;Esplugues de Llobregat;3;7;B;;1033;568;465;3;5;560;565
8;Barcelona;11;Baix Llobregat;08077;Esplugues de Llobregat;3;8;A;;499;247;252;0;0;247;247
8;Barcelona;11;Baix Llobregat;08077;Esplugues de Llobregat;3;8;B;;584;306;278;1;3;302;305
8;Barcelona;11;Baix Llobregat;08077;Esplugues de Llobregat;4;1;A;;458;260;198;1;3;256;259
8;Barcelona;11;Baix Llobregat;08077;Esplugues de Llobregat;4;1;B;;565;326;239;4;2;320;322
8;Barcelona;11;Baix Llobregat;08077;Esplugues de Llobregat;4;2;A;;875;450;425;1;5;444;449
8;Barcelona;11;Baix Llobregat;08077;Esplugues de Llobregat;4;2;B;;956;485;471;1;2;482;484
8;Barcelona;11;Baix Llobregat;08077;Esplugues de Llobregat;4;3;A;;668;327;341;2;2;323;325
8;Barcelona;11;Baix Llobregat;08077;Esplugues de Llobregat;4;3;B;;800;405;395;2;3;400;403
8;Barcelona;11;Baix Llobregat;08077;Esplugues de Llobregat;4;4;A;;864;439;425;1;2;436;438
8;Barcelona;11;Baix Llobregat;08077;Esplugues de Llobregat;4;4;B;;972;493;479;1;2;490;492
8;Barcelona;11;Baix Llobregat;08077;Esplugues de Llobregat;4;5;A;;675;373;302;2;5;366;371
8;Barcelona;11;Baix Llobregat;08077;Esplugues de Llobregat;4;5;B;;740;407;333;6;4;397;401
8;Barcelona;11;Baix Llobregat;08077;Esplugues de Llobregat;4;6;A;;595;334;261;2;1;331;332
8;Barcelona;11;Baix Llobregat;08077;Esplugues de Llobregat;4;6;B;;637;350;287;0;3;347;350
8;Barcelona;11;Baix Llobregat;08077;Esplugues de Llobregat;4;7;A;;561;318;243;0;1;317;318
8;Barcelona;11;Baix Llobregat;08077;Esplugues de Llobregat;4;7;B;;618;334;284;0;5;329;334
8;Barcelona;11;Baix Llobregat;08077;Esplugues de Llobregat;5;1;A;;667;351;316;2;2;347;349
8;Barcelona;11;Baix Llobregat;08077;Esplugues de Llobregat;5;1;B;;696;372;324;2;0;370;370
8;Barcelona;11;Baix Llobregat;08077;Esplugues de Llobregat;5;2;A;;621;317;304;0;3;314;317
8;Barcelona;11;Baix Llobregat;08077;Esplugues de Llobregat;5;2;B;;625;325;300;1;2;322;324
17;Girona;2;Alt Empordà;17064;Espolla;1;1;A;;333;228;105;0;3;225;228
17;Girona;28;Pla de l'Estany;17065;Esponellà;1;1;A;;289;198;91;1;1;196;197
25;Lleida;26;Pallars Sobirà;25082;Espot;1;1;A;;190;126;64;1;0;125;125
8;Barcelona;14;Berguedà;08078;Espunyola, l';1;1;A;;269;164;105;0;1;163;164
8;Barcelona;24;Osona;08254;Esquirol, l';1;1;A;;1078;652;426;3;6;643;649
8;Barcelona;24;Osona;08254;Esquirol, l';1;2;A;;243;178;65;0;0;178;178
8;Barcelona;24;Osona;08254;Esquirol, l';1;3;A;;213;133;80;1;0;132;132
25;Lleida;4;Alt Urgell;25088;Estamariu;1;1;A;;122;104;18;0;0;104;104
8;Barcelona;;;08079;Estany, l';1;1;A;;309;238;71;0;1;237;238
25;Lleida;32;Segarra;25085;Estaràs;1;1;A;;160;105;55;0;0;105;105
25;Lleida;26;Pallars Sobirà;25086;Esterri d'Àneu;1;1;A;;481;338;143;0;1;337;338
25;Lleida;26;Pallars Sobirà;25087;Esterri de Cardós;1;1;A;;54;35;19;0;0;35;35
43;Tarragona;29;Priorat;43055;Falset;1;1;A;;999;739;260;1;8;730;738
43;Tarragona;29;Priorat;43055;Falset;2;1;A;;971;705;266;6;10;689;699
17;Girona;2;Alt Empordà;17005;Far d'Empordà, el;1;1;A;;337;198;139;0;2;196;198
25;Lleida;26;Pallars Sobirà;25089;Farrera;1;1;A;;74;47;27;0;0;47;47
43;Tarragona;37;Terra Alta;43056;Fatarella, la;1;1;A;;540;191;349;2;2;187;189
43;Tarragona;37;Terra Alta;43056;Fatarella, la;1;2;A;;663;251;412;0;4;247;251
43;Tarragona;8;Baix Camp;43057;Febró, la;1;1;A;;35;22;13;0;0;22;22
8;Barcelona;41;Vallès Oriental;08134;Figaró-Montmany;1;1;A;;495;346;149;2;3;341;344
8;Barcelona;14;Berguedà;08080;Fígols;1;1;A;;22;22;0;0;0;22;22
25;Lleida;4;Alt Urgell;25908;Fígols i Alinyà;1;1;A;;326;156;170;1;0;155;155
43;Tarragona;29;Priorat;43058;Figuera, la;1;1;A;;122;79;43;0;3;76;79
17;Girona;2;Alt Empordà;17066;Figueres;1;1;A;;550;320;230;1;1;318;319
17;Girona;2;Alt Empordà;17066;Figueres;1;1;B;;443;239;204;1;1;237;238
17;Girona;2;Alt Empordà;17066;Figueres;1;1;C;;582;325;257;0;4;321;325
17;Girona;2;Alt Empordà;17066;Figueres;1;2;A;;519;300;219;0;4;296;300
17;Girona;2;Alt Empordà;17066;Figueres;1;2;B;;591;378;213;0;10;368;378
17;Girona;2;Alt Empordà;17066;Figueres;1;3;A;;992;585;407;6;5;574;579
17;Girona;2;Alt Empordà;17066;Figueres;1;4;A;;583;342;241;1;0;341;341
17;Girona;2;Alt Empordà;17066;Figueres;1;4;B;;537;280;257;1;8;271;279
17;Girona;2;Alt Empordà;17066;Figueres;1;4;C;;574;320;254;3;3;314;317
17;Girona;2;Alt Empordà;17066;Figueres;1;5;A;;610;300;310;3;2;295;297
17;Girona;2;Alt Empordà;17066;Figueres;1;5;B;;643;329;314;3;2;324;326
17;Girona;2;Alt Empordà;17066;Figueres;2;1;A;;860;538;322;4;1;533;534
17;Girona;2;Alt Empordà;17066;Figueres;2;2;A;;471;285;186;0;1;284;285
17;Girona;2;Alt Empordà;17066;Figueres;2;2;B;;490;317;173;0;2;315;317
17;Girona;2;Alt Empordà;17066;Figueres;2;3;A;;767;402;365;7;6;389;395
17;Girona;2;Alt Empordà;17066;Figueres;2;3;B;;847;465;382;1;10;454;464
17;Girona;2;Alt Empordà;17066;Figueres;2;4;A;;827;486;341;7;7;472;479
17;Girona;2;Alt Empordà;17066;Figueres;3;1;A;;771;469;302;4;5;460;465
17;Girona;2;Alt Empordà;17066;Figueres;3;2;A;;699;441;258;8;5;428;433
17;Girona;2;Alt Empordà;17066;Figueres;3;3;A;;539;345;194;3;2;340;342
17;Girona;2;Alt Empordà;17066;Figueres;3;3;B;;525;298;227;0;1;297;298
17;Girona;2;Alt Empordà;17066;Figueres;3;4;A;;455;234;221;1;1;232;233
17;Girona;2;Alt Empordà;17066;Figueres;3;4;B;;557;286;271;7;3;276;279
17;Girona;2;Alt Empordà;17066;Figueres;3;5;A;;534;357;177;0;0;357;357
17;Girona;2;Alt Empordà;17066;Figueres;3;5;B;;584;368;216;6;1;361;362
17;Girona;2;Alt Empordà;17066;Figueres;4;1;A;;649;411;238;5;7;399;406
17;Girona;2;Alt Empordà;17066;Figueres;4;1;B;;644;414;230;2;8;404;412
17;Girona;2;Alt Empordà;17066;Figueres;4;2;A;;617;366;251;3;2;361;363
17;Girona;2;Alt Empordà;17066;Figueres;4;2;B;;397;239;158;0;4;235;239
17;Girona;2;Alt Empordà;17066;Figueres;4;2;C;;649;423;226;0;9;414;423
17;Girona;2;Alt Empordà;17066;Figueres;4;3;A;;497;297;200;1;1;295;296
17;Girona;2;Alt Empordà;17066;Figueres;4;3;B;;534;326;208;2;1;323;324
17;Girona;2;Alt Empordà;17066;Figueres;4;4;A;;535;310;225;2;1;307;308
17;Girona;2;Alt Empordà;17066;Figueres;4;4;B;;407;242;165;0;4;238;242
17;Girona;2;Alt Empordà;17066;Figueres;4;4;C;;528;336;192;1;0;335;335
17;Girona;2;Alt Empordà;17066;Figueres;4;5;A;;678;387;291;4;7;376;383
17;Girona;2;Alt Empordà;17066;Figueres;4;5;B;;758;421;337;1;3;417;420
17;Girona;2;Alt Empordà;17066;Figueres;4;6;A;;700;368;332;3;7;358;365
17;Girona;2;Alt Empordà;17066;Figueres;4;6;B;;467;253;214;1;0;252;252
43;Tarragona;1;Alt Camp;43059;Figuerola del Camp;1;1;A;;189;137;52;0;1;136;137
17;Girona;20;Gironès;17067;Flaçà;1;1;A;;746;520;226;18;0;502;502
43;Tarragona;30;Ribera d'Ebre;43060;Flix;1;1;A;;629;424;205;2;3;419;422
43;Tarragona;30;Ribera d'Ebre;43060;Flix;1;1;B;;722;482;240;4;5;473;478
43;Tarragona;30;Ribera d'Ebre;43060;Flix;1;2;A;;628;396;232;4;0;392;392
43;Tarragona;30;Ribera d'Ebre;43060;Flix;1;2;B;;705;428;277;3;0;425;425
43;Tarragona;30;Ribera d'Ebre;43060;Flix;2;1;A;;607;366;241;3;6;357;363
43;Tarragona;30;Ribera d'Ebre;43060;Flix;2;1;B;;607;356;251;2;4;350;354
25;Lleida;18;Garrigues;25092;Floresta, la;1;1;A;;169;138;31;0;5;133;138
8;Barcelona;34;Selva;08082;Fogars de la Selva;1;1;A;;223;154;69;1;0;153;153
8;Barcelona;41;Vallès Oriental;08081;Fogars de Montclús;1;1;A;;210;145;65;1;0;144;144
17;Girona;10;Baix Empordà;17068;Foixà;1;1;A;;254;165;89;0;0;165;165
8;Barcelona;24;Osona;08083;Folgueroles;1;1;A;;846;639;207;2;7;630;637
25;Lleida;27;Pla d'Urgell;25093;Fondarella;1;1;A;;442;241;201;2;2;237;239
8;Barcelona;7;Bages;08084;Fonollosa;1;1;A;;226;226;0;0;0;226;226
8;Barcelona;7;Bages;08084;Fonollosa;1;1;B;;188;133;55;0;1;132;133
17;Girona;15;Cerdanya;17069;Fontanals de Cerdanya;1;1;A;;273;200;73;1;0;199;199
17;Girona;10;Baix Empordà;17070;Fontanilles;1;1;A;;94;58;36;3;0;55;55
17;Girona;28;Pla de l'Estany;17071;Fontcoberta;1;1;A;;546;371;175;0;1;370;371
8;Barcelona;3;Alt Penedès;08085;Font-rubí;1;1;A;;941;595;346;6;2;587;589
25;Lleida;23;Noguera;25094;Foradada;1;1;A;;131;85;46;2;1;82;83
17;Girona;10;Baix Empordà;17902;Forallac;1;1;A;;573;417;156;1;3;413;416
17;Girona;10;Baix Empordà;17902;Forallac;1;2;A;;345;185;160;4;3;178;181
17;Girona;10;Baix Empordà;17902;Forallac;1;2;B;;219;152;67;0;0;152;152
43;Tarragona;16;Conca de Barberà;43061;Forès;1;1;A;;60;37;23;0;0;37;37
17;Girona;20;Gironès;17073;Fornells de la Selva;1;1;A;;778;528;250;1;5;522;527
17;Girona;2;Alt Empordà;17074;Fortià;1;1;A;;382;274;108;1;1;272;273
8;Barcelona;41;Vallès Oriental;08086;Franqueses del Vallès, les;1;1;A;;678;455;223;2;0;453;453
8;Barcelona;41;Vallès Oriental;08086;Franqueses del Vallès, les;1;1;B;;560;347;213;0;3;344;347
8;Barcelona;41;Vallès Oriental;08086;Franqueses del Vallès, les;1;1;C;;699;441;258;1;0;440;440
8;Barcelona;41;Vallès Oriental;08086;Franqueses del Vallès, les;1;2;A;;683;403;280;0;2;401;403
8;Barcelona;41;Vallès Oriental;08086;Franqueses del Vallès, les;1;2;B;;807;466;341;5;1;460;461
8;Barcelona;41;Vallès Oriental;08086;Franqueses del Vallès, les;1;2;C;;802;490;312;4;3;483;486
8;Barcelona;41;Vallès Oriental;08086;Franqueses del Vallès, les;1;3;A;;500;286;214;1;0;285;285
8;Barcelona;41;Vallès Oriental;08086;Franqueses del Vallès, les;1;3;B;;532;299;233;0;0;299;299
8;Barcelona;41;Vallès Oriental;08086;Franqueses del Vallès, les;1;3;C;;598;332;266;0;2;330;332
8;Barcelona;41;Vallès Oriental;08086;Franqueses del Vallès, les;2;1;A;;948;655;293;2;0;653;653
43;Tarragona;22;Montsià;43062;Freginals;1;1;A;;341;277;64;3;3;271;274
25;Lleida;38;Urgell;25096;Fuliola, la;1;1;A;;1048;737;311;3;2;732;734
25;Lleida;18;Garrigues;25097;Fulleda;1;1;A;;100;58;42;0;0;58;58
8;Barcelona;7;Bages;08090;Gaià;1;1;A;;116;76;40;0;0;76;76
43;Tarragona;22;Montsià;43063;Galera, la;1;1;A;;653;335;318;4;6;325;331
8;Barcelona;40;Vallès Occidental;08087;Gallifa;1;1;A;;60;47;13;0;2;45;47
43;Tarragona;37;Terra Alta;43064;Gandesa;1;1;A;;601;425;176;2;7;416;423
43;Tarragona;37;Terra Alta;43064;Gandesa;1;1;B;;649;466;183;8;5;453;458
43;Tarragona;37;Terra Alta;43064;Gandesa;2;1;A;;888;569;319;9;3;557;560
43;Tarragona;30;Ribera d'Ebre;43065;Garcia;1;1;A;;503;367;136;2;4;361;365
43;Tarragona;1;Alt Camp;43066;Garidells, els;1;1;A;;126;91;35;0;0;91;91
8;Barcelona;41;Vallès Oriental;08088;Garriga, la;1;1;A;;1231;859;372;6;1;852;853
8;Barcelona;41;Vallès Oriental;08088;Garriga, la;1;2;A;;993;637;356;1;2;634;636
8;Barcelona;41;Vallès Oriental;08088;Garriga, la;1;2;B;;905;565;340;8;5;552;557
8;Barcelona;41;Vallès Oriental;08088;Garriga, la;2;1;A;;1254;924;330;3;8;913;921
8;Barcelona;41;Vallès Oriental;08088;Garriga, la;2;2;A;;1140;751;389;6;6;739;745
8;Barcelona;41;Vallès Oriental;08088;Garriga, la;2;2;B;;1138;745;393;1;7;737;744
17;Girona;2;Alt Empordà;17075;Garrigàs;1;1;A;;253;180;73;1;1;178;179
17;Girona;10;Baix Empordà;17076;Garrigoles;1;1;A;;130;88;42;0;1;87;88
17;Girona;2;Alt Empordà;17077;Garriguella;1;1;A;;488;356;132;4;1;351;352
8;Barcelona;11;Baix Llobregat;08089;Gavà;1;1;A;;1066;628;438;1;4;623;627
8;Barcelona;11;Baix Llobregat;08089;Gavà;1;2;A;;580;365;215;2;2;361;363
8;Barcelona;11;Baix Llobregat;08089;Gavà;1;2;B;;684;438;246;1;2;435;437
8;Barcelona;11;Baix Llobregat;08089;Gavà;1;3;A;;839;529;310;1;4;524;528
8;Barcelona;11;Baix Llobregat;08089;Gavà;1;3;B;;975;542;433;1;2;539;541
8;Barcelona;11;Baix Llobregat;08089;Gavà;1;4;A;;643;380;263;1;3;376;379
8;Barcelona;11;Baix Llobregat;08089;Gavà;1;4;B;;679;399;280;2;2;395;397
8;Barcelona;11;Baix Llobregat;08089;Gavà;1;5;A;;881;494;387;1;3;490;493
8;Barcelona;11;Baix Llobregat;08089;Gavà;1;6;A;;636;359;277;0;3;356;359
8;Barcelona;11;Baix Llobregat;08089;Gavà;1;7;A;;542;230;312;2;0;228;228
8;Barcelona;11;Baix Llobregat;08089;Gavà;2;1;A;;743;474;269;0;1;473;474
8;Barcelona;11;Baix Llobregat;08089;Gavà;2;1;B;;843;514;329;0;1;513;514
8;Barcelona;11;Baix Llobregat;08089;Gavà;2;2;A;;911;501;410;5;2;494;496
8;Barcelona;11;Baix Llobregat;08089;Gavà;2;2;B;;1060;585;475;0;2;583;585
8;Barcelona;11;Baix Llobregat;08089;Gavà;2;3;A;;462;462;0;2;2;458;460
8;Barcelona;11;Baix Llobregat;08089;Gavà;2;3;B;;453;453;0;0;2;451;453
8;Barcelona;11;Baix Llobregat;08089;Gavà;2;4;A;;530;273;257;0;2;271;273
8;Barcelona;11;Baix Llobregat;08089;Gavà;2;4;B;;663;328;335;0;3;325;328
8;Barcelona;11;Baix Llobregat;08089;Gavà;2;5;A;;640;296;344;1;0;295;295
8;Barcelona;11;Baix Llobregat;08089;Gavà;2;6;A;;925;467;458;2;2;463;465
8;Barcelona;11;Baix Llobregat;08089;Gavà;2;6;B;;1035;527;508;0;1;526;527
8;Barcelona;11;Baix Llobregat;08089;Gavà;3;1;A;;1019;576;443;1;5;570;575
8;Barcelona;11;Baix Llobregat;08089;Gavà;3;2;A;;822;430;392;0;1;429;430
8;Barcelona;11;Baix Llobregat;08089;Gavà;3;3;A;;846;424;422;1;0;423;423
8;Barcelona;11;Baix Llobregat;08089;Gavà;3;4;A;;1000;493;507;4;1;488;489
8;Barcelona;11;Baix Llobregat;08089;Gavà;3;5;A;;1184;567;617;0;1;566;567
8;Barcelona;11;Baix Llobregat;08089;Gavà;3;6;A;;800;448;352;2;5;441;446
8;Barcelona;11;Baix Llobregat;08089;Gavà;4;1;A;;606;359;247;0;0;359;359
8;Barcelona;11;Baix Llobregat;08089;Gavà;4;1;B;;721;410;311;0;1;409;410
8;Barcelona;11;Baix Llobregat;08089;Gavà;4;2;A;;602;331;271;0;1;330;331
8;Barcelona;11;Baix Llobregat;08089;Gavà;4;2;B;;811;472;339;0;6;466;472
25;Lleida;25;Pallars Jussà;25098;Gavet de la Conca;1;1;A;;358;185;173;0;5;180;185
8;Barcelona;3;Alt Penedès;08091;Gelida;1;1;A;;714;528;186;1;2;525;527
8;Barcelona;3;Alt Penedès;08091;Gelida;1;1;B;;956;689;267;3;2;684;686
8;Barcelona;3;Alt Penedès;08091;Gelida;2;1;A;;607;432;175;4;2;426;428
8;Barcelona;3;Alt Penedès;08091;Gelida;2;1;B;;624;424;200;1;2;421;423
17;Girona;15;Cerdanya;17078;Ger;1;1;A;;205;158;47;0;1;157;158
43;Tarragona;30;Ribera d'Ebre;43067;Ginestar;1;1;A;;774;562;212;4;8;550;558
17;Girona;20;Gironès;17079;Girona;1;1;A;;722;429;293;1;8;420;428
17;Girona;20;Gironès;17079;Girona;1;2;A;;727;455;272;2;1;452;453
17;Girona;20;Gironès;17079;Girona;1;3;A;;858;563;295;2;3;558;561
17;Girona;20;Gironès;17079;Girona;1;4;A;;902;548;354;1;4;543;547
17;Girona;20;Gironès;17079;Girona;1;5;A;;817;429;388;8;3;418;421
17;Girona;20;Gironès;17079;Girona;1;5;B;;604;276;328;2;1;273;274
17;Girona;20;Gironès;17079;Girona;1;6;A;;484;342;142;1;2;339;341
17;Girona;20;Gironès;17079;Girona;1;6;B;;710;480;230;5;1;474;475
17;Girona;20;Gironès;17079;Girona;2;1;A;;693;506;187;5;4;497;501
17;Girona;20;Gironès;17079;Girona;2;10;A;;612;374;238;1;6;367;373
17;Girona;20;Gironès;17079;Girona;2;10;B;;718;455;263;5;10;440;450
17;Girona;20;Gironès;17079;Girona;2;11;A;;630;400;230;2;4;394;398
17;Girona;20;Gironès;17079;Girona;2;11;B;;712;471;241;7;4;460;464
17;Girona;20;Gironès;17079;Girona;2;12;A;;1016;690;326;1;2;687;689
17;Girona;20;Gironès;17079;Girona;2;13;A;;1100;774;326;0;3;771;774
17;Girona;20;Gironès;17079;Girona;2;14;A;;825;517;308;3;7;507;514
17;Girona;20;Gironès;17079;Girona;2;2;A;;614;445;169;0;7;438;445
17;Girona;20;Gironès;17079;Girona;2;3;A;;524;363;161;1;5;357;362
17;Girona;20;Gironès;17079;Girona;2;3;B;;569;397;172;0;4;393;397
17;Girona;20;Gironès;17079;Girona;2;4;A;;547;408;139;1;3;404;407
17;Girona;20;Gironès;17079;Girona;2;4;B;;577;408;169;0;1;407;408
17;Girona;20;Gironès;17079;Girona;2;5;A;;844;571;273;1;3;567;570
17;Girona;20;Gironès;17079;Girona;2;6;A;;573;390;183;0;6;384;390
17;Girona;20;Gironès;17079;Girona;2;6;B;;382;254;128;0;1;253;254
17;Girona;20;Gironès;17079;Girona;2;6;C;;642;446;196;2;5;439;444
17;Girona;20;Gironès;17079;Girona;2;7;A;;595;408;187;4;2;402;404
17;Girona;20;Gironès;17079;Girona;2;7;B;;688;455;233;1;4;450;454
17;Girona;20;Gironès;17079;Girona;2;8;A;;549;395;154;1;4;390;394
17;Girona;20;Gironès;17079;Girona;2;8;B;;669;457;212;1;3;453;456
17;Girona;20;Gironès;17079;Girona;2;9;A;;1015;588;427;4;3;581;584
17;Girona;20;Gironès;17079;Girona;3;1;A;;878;624;254;0;5;619;624
17;Girona;20;Gironès;17079;Girona;3;10;A;;833;489;344;0;0;489;489
17;Girona;20;Gironès;17079;Girona;3;11;A;;565;342;223;2;4;336;340
17;Girona;20;Gironès;17079;Girona;3;11;B;;417;237;180;2;0;235;235
17;Girona;20;Gironès;17079;Girona;3;11;C;;627;391;236;1;0;390;390
17;Girona;20;Gironès;17079;Girona;3;12;A;;612;361;251;1;5;355;360
17;Girona;20;Gironès;17079;Girona;3;12;B;;732;405;327;0;2;403;405
17;Girona;20;Gironès;17079;Girona;3;13;A;;675;422;253;3;1;418;419
17;Girona;20;Gironès;17079;Girona;3;13;B;;729;496;233;3;4;489;493
17;Girona;20;Gironès;17079;Girona;3;14;A;;688;372;316;0;2;370;372
17;Girona;20;Gironès;17079;Girona;3;14;B;;634;359;275;3;6;350;356
17;Girona;20;Gironès;17079;Girona;3;15;A;;637;405;232;1;3;401;404
17;Girona;20;Gironès;17079;Girona;3;15;B;;811;496;315;2;0;494;494
17;Girona;20;Gironès;17079;Girona;3;16;A;;866;545;321;0;10;535;545
17;Girona;20;Gironès;17079;Girona;3;2;A;;945;677;268;6;9;662;671
17;Girona;20;Gironès;17079;Girona;3;3;A;;815;586;229;0;2;584;586
17;Girona;20;Gironès;17079;Girona;3;4;A;;918;659;259;3;5;651;656
17;Girona;20;Gironès;17079;Girona;3;5;A;;735;486;249;0;10;476;486
17;Girona;20;Gironès;17079;Girona;3;6;A;;973;694;279;0;5;689;694
17;Girona;20;Gironès;17079;Girona;3;7;A;;711;442;269;3;0;439;439
17;Girona;20;Gironès;17079;Girona;3;7;B;;806;500;306;2;0;498;498
17;Girona;20;Gironès;17079;Girona;3;8;A;;521;355;166;2;5;348;353
17;Girona;20;Gironès;17079;Girona;3;8;B;;637;416;221;2;3;411;414
17;Girona;20;Gironès;17079;Girona;3;9;A;;555;346;209;4;1;341;342
17;Girona;20;Gironès;17079;Girona;3;9;B;;484;288;196;1;4;283;287
17;Girona;20;Gironès;17079;Girona;3;9;C;;630;397;233;0;1;396;397
17;Girona;20;Gironès;17079;Girona;4;1;A;;882;545;337;4;3;538;541
17;Girona;20;Gironès;17079;Girona;4;2;A;;995;596;399;1;5;590;595
17;Girona;20;Gironès;17079;Girona;4;3;A;;704;363;341;2;1;360;361
17;Girona;20;Gironès;17079;Girona;5;1;A;;960;645;315;4;8;633;641
17;Girona;20;Gironès;17079;Girona;5;2;A;;665;424;241;5;2;417;419
17;Girona;20;Gironès;17079;Girona;5;3;A;;882;535;347;0;2;533;535
17;Girona;20;Gironès;17079;Girona;5;4;A;;564;372;192;0;5;367;372
17;Girona;20;Gironès;17079;Girona;5;5;A;;574;362;212;2;1;359;360
17;Girona;20;Gironès;17079;Girona;5;5;B;;620;371;249;2;2;367;369
17;Girona;20;Gironès;17079;Girona;6;1;A;;531;259;272;0;0;259;259
17;Girona;20;Gironès;17079;Girona;6;1;B;;543;238;305;2;4;232;236
17;Girona;20;Gironès;17079;Girona;6;2;A;;551;327;224;1;1;325;326
17;Girona;20;Gironès;17079;Girona;6;2;B;;623;409;214;3;3;403;406
17;Girona;20;Gironès;17079;Girona;6;3;A;;886;595;291;0;4;591;595
8;Barcelona;14;Berguedà;08092;Gironella;1;1;A;;622;412;210;4;2;406;408
8;Barcelona;14;Berguedà;08092;Gironella;1;1;B;;676;452;224;2;1;449;450
8;Barcelona;14;Berguedà;08092;Gironella;2;1;A;;646;452;194;2;1;449;450
8;Barcelona;14;Berguedà;08092;Gironella;2;2;A;;556;398;158;6;2;390;392
8;Barcelona;14;Berguedà;08092;Gironella;2;2;B;;665;464;201;5;1;458;459
8;Barcelona;14;Berguedà;08092;Gironella;2;3;A;;638;440;198;2;1;437;438
8;Barcelona;14;Berguedà;08092;Gironella;2;3;B;;809;543;266;8;0;535;535
8;Barcelona;14;Berguedà;08093;Gisclareny;1;1;A;;29;21;8;0;0;21;21
43;Tarragona;22;Montsià;43068;Godall;1;1;A;;672;433;239;5;3;425;428
25;Lleida;27;Pla d'Urgell;25099;Golmés;1;1;A;;973;598;375;4;4;590;594
17;Girona;31;Ripollès;17080;Gombrèn;1;1;A;;210;157;53;0;0;157;157
25;Lleida;14;Berguedà;25100;Gósol;1;1;A;;158;135;23;0;2;133;135
8;Barcelona;3;Alt Penedès;08094;Granada, la;1;1;A;;941;729;212;1;1;727;728
25;Lleida;18;Garrigues;25101;Granadella, la;1;1;A;;773;492;281;0;5;487;492
8;Barcelona;;;08095;Granera;1;1;A;;45;33;12;0;0;33;33
25;Lleida;33;Segrià;25102;Granja d'Escarp, la;1;1;A;;913;568;345;1;3;564;567
8;Barcelona;41;Vallès Oriental;08096;Granollers;1;1;A;;616;479;137;0;4;475;479
8;Barcelona;41;Vallès Oriental;08096;Granollers;1;10;A;;785;480;305;2;0;478;478
8;Barcelona;41;Vallès Oriental;08096;Granollers;1;11;A;;642;349;293;2;0;347;347
8;Barcelona;41;Vallès Oriental;08096;Granollers;1;11;B;;767;395;372;1;0;394;394
8;Barcelona;41;Vallès Oriental;08096;Granollers;1;2;A;;1109;843;266;11;1;831;832
8;Barcelona;41;Vallès Oriental;08096;Granollers;1;3;A;;634;428;206;0;2;426;428
8;Barcelona;41;Vallès Oriental;08096;Granollers;1;3;B;;721;482;239;3;1;478;479
8;Barcelona;41;Vallès Oriental;08096;Granollers;1;4;A;;555;346;209;0;1;345;346
8;Barcelona;41;Vallès Oriental;08096;Granollers;1;5;A;;1002;687;315;3;5;679;684
8;Barcelona;41;Vallès Oriental;08096;Granollers;1;6;A;;576;371;205;10;1;360;361
8;Barcelona;41;Vallès Oriental;08096;Granollers;1;6;B;;906;574;332;2;1;571;572
8;Barcelona;41;Vallès Oriental;08096;Granollers;1;7;A;;1032;545;487;0;3;542;545
8;Barcelona;41;Vallès Oriental;08096;Granollers;1;8;A;;624;374;250;5;5;364;369
8;Barcelona;41;Vallès Oriental;08096;Granollers;1;9;A;;1167;641;526;9;7;625;632
8;Barcelona;41;Vallès Oriental;08096;Granollers;2;1;A;;604;418;186;0;4;414;418
8;Barcelona;41;Vallès Oriental;08096;Granollers;2;1;B;;711;485;226;1;5;479;484
8;Barcelona;41;Vallès Oriental;08096;Granollers;2;2;A;;521;368;153;0;2;366;368
8;Barcelona;41;Vallès Oriental;08096;Granollers;2;3;A;;528;365;163;0;6;359;365
8;Barcelona;41;Vallès Oriental;08096;Granollers;2;4;A;;1153;657;496;0;3;654;657
8;Barcelona;41;Vallès Oriental;08096;Granollers;2;5;A;;1266;695;571;0;2;693;695
8;Barcelona;41;Vallès Oriental;08096;Granollers;2;6;A;;961;669;292;12;2;655;657
8;Barcelona;41;Vallès Oriental;08096;Granollers;2;7;A;;994;624;370;13;1;610;611
8;Barcelona;41;Vallès Oriental;08096;Granollers;3;1;A;;741;493;248;1;3;489;492
8;Barcelona;41;Vallès Oriental;08096;Granollers;3;1;B;;796;537;259;7;1;529;530
8;Barcelona;41;Vallès Oriental;08096;Granollers;3;2;A;;1030;552;478;1;4;547;551
8;Barcelona;41;Vallès Oriental;08096;Granollers;3;3;A;;771;354;417;0;0;354;354
8;Barcelona;41;Vallès Oriental;08096;Granollers;3;3;B;;861;403;458;3;3;397;400
8;Barcelona;41;Vallès Oriental;08096;Granollers;3;4;A;;606;403;203;8;0;395;395
8;Barcelona;41;Vallès Oriental;08096;Granollers;3;4;B;;719;414;305;1;4;409;413
8;Barcelona;41;Vallès Oriental;08096;Granollers;3;5;A;;1086;653;433;1;6;646;652
8;Barcelona;41;Vallès Oriental;08096;Granollers;3;6;A;;1140;617;523;1;1;615;616
8;Barcelona;41;Vallès Oriental;08096;Granollers;3;7;A;;525;332;193;0;1;331;332
8;Barcelona;41;Vallès Oriental;08096;Granollers;4;1;A;;767;485;282;2;5;478;483
8;Barcelona;41;Vallès Oriental;08096;Granollers;4;1;B;;857;540;317;1;1;538;539
8;Barcelona;41;Vallès Oriental;08096;Granollers;4;10;A;;664;455;209;2;0;453;453
8;Barcelona;41;Vallès Oriental;08096;Granollers;4;10;B;;544;359;185;0;1;358;359
8;Barcelona;41;Vallès Oriental;08096;Granollers;4;2;A;;747;410;337;0;1;409;410
8;Barcelona;41;Vallès Oriental;08096;Granollers;4;2;B;;759;419;340;1;2;416;418
8;Barcelona;41;Vallès Oriental;08096;Granollers;4;3;A;;853;476;377;5;6;465;471
8;Barcelona;41;Vallès Oriental;08096;Granollers;4;4;A;;654;372;282;1;3;368;371
8;Barcelona;41;Vallès Oriental;08096;Granollers;4;5;A;;654;348;306;1;2;345;347
8;Barcelona;41;Vallès Oriental;08096;Granollers;4;6;A;;717;404;313;2;3;399;402
8;Barcelona;41;Vallès Oriental;08096;Granollers;4;7;A;;649;407;242;4;2;401;403
8;Barcelona;41;Vallès Oriental;08096;Granollers;4;8;A;;557;319;238;1;3;315;318
8;Barcelona;41;Vallès Oriental;08096;Granollers;4;9;A;;1196;677;519;2;5;670;675
25;Lleida;32;Segarra;25103;Granyanella;1;1;A;;109;65;44;0;1;64;65
25;Lleida;18;Garrigues;25105;Granyena de les Garrigues;1;1;A;;175;102;73;0;0;102;102
25;Lleida;32;Segarra;25104;Granyena de Segarra;1;1;A;;174;119;55;1;0;118;118
43;Tarragona;29;Priorat;43069;Gratallops;1;1;A;;194;136;58;2;0;134;134
8;Barcelona;41;Vallès Oriental;08097;Gualba;1;1;A;;454;320;134;0;0;320;320
17;Girona;10;Baix Empordà;17081;Gualta;1;1;A;;235;181;54;0;2;179;181
8;Barcelona;14;Berguedà;08099;Guardiola de Berguedà;1;1;A;;861;603;258;1;1;601;602
8;Barcelona;14;Berguedà;08099;Guardiola de Berguedà;1;1;B;;189;167;22;0;0;167;167
43;Tarragona;29;Priorat;43070;Guiamets, els;1;1;A;;243;155;88;1;0;154;154
17;Girona;15;Cerdanya;17082;Guils de Cerdanya;1;1;A;;205;155;50;2;0;153;153
25;Lleida;38;Urgell;25109;Guimerà;1;1;A;;419;295;124;0;1;294;295
25;Lleida;26;Pallars Sobirà;25903;Guingueta d'Àneu, la;1;1;A;;227;122;105;0;0;122;122
25;Lleida;32;Segarra;25110;Guissona;1;1;A;;936;634;302;5;0;629;629
25;Lleida;32;Segarra;25110;Guissona;1;2;A;;1115;775;340;2;3;770;773
25;Lleida;35;Solsonès;25111;Guixers;1;1;A;;135;80;55;1;0;79;79
8;Barcelona;24;Osona;08100;Gurb;1;1;A;;1264;937;327;0;3;934;937
43;Tarragona;37;Terra Alta;43071;Horta de Sant Joan;1;1;A;;1109;727;382;2;6;719;725
8;Barcelona;13;Barcelonès;08101;Hospitalet de Llobregat, l';1;1;A;;718;320;398;0;2;318;320
8;Barcelona;13;Barcelonès;08101;Hospitalet de Llobregat, l';1;10;A;;1011;532;479;1;5;526;531
8;Barcelona;13;Barcelonès;08101;Hospitalet de Llobregat, l';1;11;A;;828;509;319;1;0;508;508
8;Barcelona;13;Barcelonès;08101;Hospitalet de Llobregat, l';1;12;A;;1102;659;443;0;6;653;659
8;Barcelona;13;Barcelonès;08101;Hospitalet de Llobregat, l';1;13;A;;923;499;424;0;3;496;499
8;Barcelona;13;Barcelonès;08101;Hospitalet de Llobregat, l';1;14;A;;689;321;368;0;2;319;321
8;Barcelona;13;Barcelonès;08101;Hospitalet de Llobregat, l';1;14;B;;758;349;409;0;2;347;349
8;Barcelona;13;Barcelonès;08101;Hospitalet de Llobregat, l';1;15;A;;970;448;522;6;2;440;442
8;Barcelona;13;Barcelonès;08101;Hospitalet de Llobregat, l';1;16;A;;1114;592;522;1;2;589;591
8;Barcelona;13;Barcelonès;08101;Hospitalet de Llobregat, l';1;17;A;;646;311;335;0;2;309;311
8;Barcelona;13;Barcelonès;08101;Hospitalet de Llobregat, l';1;17;B;;712;356;356;0;3;353;356
8;Barcelona;13;Barcelonès;08101;Hospitalet de Llobregat, l';1;18;A;;1206;644;562;2;7;635;642
8;Barcelona;13;Barcelonès;08101;Hospitalet de Llobregat, l';1;19;A;;1180;626;554;2;0;624;624
8;Barcelona;13;Barcelonès;08101;Hospitalet de Llobregat, l';1;2;A;;632;375;257;1;5;369;374
8;Barcelona;13;Barcelonès;08101;Hospitalet de Llobregat, l';1;2;B;;707;376;331;2;2;372;374
8;Barcelona;13;Barcelonès;08101;Hospitalet de Llobregat, l';1;20;A;;1138;573;565;2;6;565;571
8;Barcelona;13;Barcelonès;08101;Hospitalet de Llobregat, l';1;21;A;;901;449;452;4;1;444;445
8;Barcelona;13;Barcelonès;08101;Hospitalet de Llobregat, l';1;22;A;;849;425;424;0;4;421;425
8;Barcelona;13;Barcelonès;08101;Hospitalet de Llobregat, l';1;23;A;;1037;596;441;1;8;587;595
8;Barcelona;13;Barcelonès;08101;Hospitalet de Llobregat, l';1;24;A;;713;397;316;1;3;393;396
8;Barcelona;13;Barcelonès;08101;Hospitalet de Llobregat, l';1;25;A;;959;457;502;0;4;453;457
8;Barcelona;13;Barcelonès;08101;Hospitalet de Llobregat, l';1;26;A;;1032;575;457;4;2;569;571
8;Barcelona;13;Barcelonès;08101;Hospitalet de Llobregat, l';1;27;A;;662;303;359;0;0;303;303
8;Barcelona;13;Barcelonès;08101;Hospitalet de Llobregat, l';1;28;A;;867;401;466;7;0;394;394
8;Barcelona;13;Barcelonès;08101;Hospitalet de Llobregat, l';1;29;A;;900;427;473;3;0;424;424
8;Barcelona;13;Barcelonès;08101;Hospitalet de Llobregat, l';1;3;A;;644;346;298;0;3;343;346
8;Barcelona;13;Barcelonès;08101;Hospitalet de Llobregat, l';1;30;A;;975;581;394;2;3;576;579
8;Barcelona;13;Barcelonès;08101;Hospitalet de Llobregat, l';1;31;A;;1056;505;551;0;5;500;505
8;Barcelona;13;Barcelonès;08101;Hospitalet de Llobregat, l';1;32;A;;688;321;367;5;1;315;316
8;Barcelona;13;Barcelonès;08101;Hospitalet de Llobregat, l';1;32;B;;767;350;417;1;2;347;349
8;Barcelona;13;Barcelonès;08101;Hospitalet de Llobregat, l';1;33;A;;803;504;299;0;5;499;504
8;Barcelona;13;Barcelonès;08101;Hospitalet de Llobregat, l';1;34;A;;862;491;371;2;0;489;489
8;Barcelona;13;Barcelonès;08101;Hospitalet de Llobregat, l';1;35;A;;1095;534;561;15;3;516;519
8;Barcelona;13;Barcelonès;08101;Hospitalet de Llobregat, l';1;36;A;;1011;529;482;1;4;524;528
8;Barcelona;13;Barcelonès;08101;Hospitalet de Llobregat, l';1;37;A;;1015;546;469;0;0;546;546
8;Barcelona;13;Barcelonès;08101;Hospitalet de Llobregat, l';1;38;A;;626;360;266;1;2;357;359
8;Barcelona;13;Barcelonès;08101;Hospitalet de Llobregat, l';1;39;A;;573;304;269;0;6;298;304
8;Barcelona;13;Barcelonès;08101;Hospitalet de Llobregat, l';1;4;A;;800;525;275;0;6;519;525
8;Barcelona;13;Barcelonès;08101;Hospitalet de Llobregat, l';1;40;A;;900;462;438;0;5;457;462
8;Barcelona;13;Barcelonès;08101;Hospitalet de Llobregat, l';1;5;A;;880;499;381;1;1;497;498
8;Barcelona;13;Barcelonès;08101;Hospitalet de Llobregat, l';1;6;A;;603;295;308;0;3;292;295
8;Barcelona;13;Barcelonès;08101;Hospitalet de Llobregat, l';1;6;B;;705;328;377;0;0;328;328
8;Barcelona;13;Barcelonès;08101;Hospitalet de Llobregat, l';1;7;A;;674;363;311;3;4;356;360
8;Barcelona;13;Barcelonès;08101;Hospitalet de Llobregat, l';1;7;B;;820;443;377;1;2;440;442
8;Barcelona;13;Barcelonès;08101;Hospitalet de Llobregat, l';1;8;A;;1141;713;428;1;1;711;712
8;Barcelona;13;Barcelonès;08101;Hospitalet de Llobregat, l';1;9;A;;944;582;362;0;4;578;582
8;Barcelona;13;Barcelonès;08101;Hospitalet de Llobregat, l';2;1;A;;625;361;264;3;1;357;358
8;Barcelona;13;Barcelonès;08101;Hospitalet de Llobregat, l';2;10;A;;859;472;387;3;6;463;469
8;Barcelona;13;Barcelonès;08101;Hospitalet de Llobregat, l';2;11;A;;610;290;320;0;1;289;290
8;Barcelona;13;Barcelonès;08101;Hospitalet de Llobregat, l';2;12;A;;1138;546;592;10;2;534;536
8;Barcelona;13;Barcelonès;08101;Hospitalet de Llobregat, l';2;13;A;;742;380;362;2;3;375;378
8;Barcelona;13;Barcelonès;08101;Hospitalet de Llobregat, l';2;14;A;;631;334;297;0;0;334;334
8;Barcelona;13;Barcelonès;08101;Hospitalet de Llobregat, l';2;15;A;;800;426;374;1;0;425;425
8;Barcelona;13;Barcelonès;08101;Hospitalet de Llobregat, l';2;16;A;;1080;518;562;1;4;513;517
8;Barcelona;13;Barcelonès;08101;Hospitalet de Llobregat, l';2;17;A;;512;289;223;0;0;289;289
8;Barcelona;13;Barcelonès;08101;Hospitalet de Llobregat, l';2;18;A;;483;230;253;1;0;229;229
8;Barcelona;13;Barcelonès;08101;Hospitalet de Llobregat, l';2;19;A;;1058;552;506;3;6;543;549
8;Barcelona;13;Barcelonès;08101;Hospitalet de Llobregat, l';2;2;A;;642;329;313;0;1;328;329
8;Barcelona;13;Barcelonès;08101;Hospitalet de Llobregat, l';2;20;A;;746;381;365;3;0;378;378
8;Barcelona;13;Barcelonès;08101;Hospitalet de Llobregat, l';2;21;A;;995;478;517;8;4;466;470
8;Barcelona;13;Barcelonès;08101;Hospitalet de Llobregat, l';2;22;A;;690;332;358;2;2;328;330
8;Barcelona;13;Barcelonès;08101;Hospitalet de Llobregat, l';2;23;A;;1027;533;494;0;3;530;533
8;Barcelona;13;Barcelonès;08101;Hospitalet de Llobregat, l';2;24;A;;544;276;268;1;2;273;275
8;Barcelona;13;Barcelonès;08101;Hospitalet de Llobregat, l';2;25;A;;521;281;240;0;1;280;281
8;Barcelona;13;Barcelonès;08101;Hospitalet de Llobregat, l';2;26;A;;1004;530;474;0;3;527;530
8;Barcelona;13;Barcelonès;08101;Hospitalet de Llobregat, l';2;27;A;;625;325;300;1;3;321;324
8;Barcelona;13;Barcelonès;08101;Hospitalet de Llobregat, l';2;28;A;;583;295;288;0;1;294;295
8;Barcelona;13;Barcelonès;08101;Hospitalet de Llobregat, l';2;29;A;;644;330;314;1;4;325;329
8;Barcelona;13;Barcelonès;08101;Hospitalet de Llobregat, l';2;3;A;;701;369;332;4;3;362;365
8;Barcelona;13;Barcelonès;08101;Hospitalet de Llobregat, l';2;30;A;;741;355;386;0;0;355;355
8;Barcelona;13;Barcelonès;08101;Hospitalet de Llobregat, l';2;31;A;;1008;498;510;3;4;491;495
8;Barcelona;13;Barcelonès;08101;Hospitalet de Llobregat, l';2;32;A;;937;534;403;12;3;519;522
8;Barcelona;13;Barcelonès;08101;Hospitalet de Llobregat, l';2;33;A;;729;387;342;0;0;387;387
8;Barcelona;13;Barcelonès;08101;Hospitalet de Llobregat, l';2;34;A;;886;449;437;1;4;444;448
8;Barcelona;13;Barcelonès;08101;Hospitalet de Llobregat, l';2;35;A;;551;292;259;0;0;292;292
8;Barcelona;13;Barcelonès;08101;Hospitalet de Llobregat, l';2;35;B;;732;385;347;1;6;378;384
8;Barcelona;13;Barcelonès;08101;Hospitalet de Llobregat, l';2;36;A;;569;568;1;5;2;561;563
8;Barcelona;13;Barcelonès;08101;Hospitalet de Llobregat, l';2;37;A;;1154;617;537;9;5;603;608
8;Barcelona;13;Barcelonès;08101;Hospitalet de Llobregat, l';2;38;A;;655;370;285;2;1;367;368
8;Barcelona;13;Barcelonès;08101;Hospitalet de Llobregat, l';2;39;A;;1076;589;487;6;2;581;583
8;Barcelona;13;Barcelonès;08101;Hospitalet de Llobregat, l';2;4;A;;550;282;268;0;3;279;282
8;Barcelona;13;Barcelonès;08101;Hospitalet de Llobregat, l';2;40;A;;669;361;308;4;2;355;357
8;Barcelona;13;Barcelonès;08101;Hospitalet de Llobregat, l';2;41;A;;618;324;294;2;0;322;322
8;Barcelona;13;Barcelonès;08101;Hospitalet de Llobregat, l';2;42;A;;1012;582;430;2;2;578;580
8;Barcelona;13;Barcelonès;08101;Hospitalet de Llobregat, l';2;43;A;;631;330;301;0;3;327;330
8;Barcelona;13;Barcelonès;08101;Hospitalet de Llobregat, l';2;43;B;;675;370;305;1;2;367;369
8;Barcelona;13;Barcelonès;08101;Hospitalet de Llobregat, l';2;44;A;;575;308;267;0;0;308;308
8;Barcelona;13;Barcelonès;08101;Hospitalet de Llobregat, l';2;45;A;;896;433;463;11;2;420;422
8;Barcelona;13;Barcelonès;08101;Hospitalet de Llobregat, l';2;46;A;;928;464;464;0;8;456;464
8;Barcelona;13;Barcelonès;08101;Hospitalet de Llobregat, l';2;47;A;;1045;559;486;5;5;549;554
8;Barcelona;13;Barcelonès;08101;Hospitalet de Llobregat, l';2;48;A;;1006;512;494;1;2;509;511
8;Barcelona;13;Barcelonès;08101;Hospitalet de Llobregat, l';2;49;A;;976;493;483;0;4;489;493
8;Barcelona;13;Barcelonès;08101;Hospitalet de Llobregat, l';2;5;A;;739;409;330;3;1;405;406
8;Barcelona;13;Barcelonès;08101;Hospitalet de Llobregat, l';2;50;A;;556;274;282;0;1;273;274
8;Barcelona;13;Barcelonès;08101;Hospitalet de Llobregat, l';2;6;A;;794;440;354;1;2;437;439
8;Barcelona;13;Barcelonès;08101;Hospitalet de Llobregat, l';2;7;A;;683;408;275;1;6;401;407
8;Barcelona;13;Barcelonès;08101;Hospitalet de Llobregat, l';2;8;A;;810;434;376;2;3;429;432
8;Barcelona;13;Barcelonès;08101;Hospitalet de Llobregat, l';2;8;B;;923;497;426;0;2;495;497
8;Barcelona;13;Barcelonès;08101;Hospitalet de Llobregat, l';2;9;A;;955;533;422;3;0;530;530
8;Barcelona;13;Barcelonès;08101;Hospitalet de Llobregat, l';3;1;A;;644;308;336;1;3;304;307
8;Barcelona;13;Barcelonès;08101;Hospitalet de Llobregat, l';3;1;B;;746;358;388;3;0;355;355
8;Barcelona;13;Barcelonès;08101;Hospitalet de Llobregat, l';3;10;A;;651;308;343;2;1;305;306
8;Barcelona;13;Barcelonès;08101;Hospitalet de Llobregat, l';3;11;A;;1166;657;509;4;6;647;653
8;Barcelona;13;Barcelonès;08101;Hospitalet de Llobregat, l';3;12;A;;921;490;431;1;2;487;489
8;Barcelona;13;Barcelonès;08101;Hospitalet de Llobregat, l';3;13;A;;645;343;302;1;0;342;342
8;Barcelona;13;Barcelonès;08101;Hospitalet de Llobregat, l';3;13;B;;719;368;351;3;2;363;365
8;Barcelona;13;Barcelonès;08101;Hospitalet de Llobregat, l';3;14;A;;673;328;345;5;2;321;323
8;Barcelona;13;Barcelonès;08101;Hospitalet de Llobregat, l';3;14;B;;792;355;437;8;2;345;347
8;Barcelona;13;Barcelonès;08101;Hospitalet de Llobregat, l';3;15;A;;1096;539;557;7;3;529;532
8;Barcelona;13;Barcelonès;08101;Hospitalet de Llobregat, l';3;16;A;;666;379;287;1;6;372;378
8;Barcelona;13;Barcelonès;08101;Hospitalet de Llobregat, l';3;16;B;;832;453;379;4;0;449;449
8;Barcelona;13;Barcelonès;08101;Hospitalet de Llobregat, l';3;17;A;;675;317;358;4;1;312;313
8;Barcelona;13;Barcelonès;08101;Hospitalet de Llobregat, l';3;18;A;;502;275;227;0;2;273;275
8;Barcelona;13;Barcelonès;08101;Hospitalet de Llobregat, l';3;19;A;;623;361;262;1;3;357;360
8;Barcelona;13;Barcelonès;08101;Hospitalet de Llobregat, l';3;2;A;;1177;597;580;0;7;590;597
8;Barcelona;13;Barcelonès;08101;Hospitalet de Llobregat, l';3;20;A;;697;407;290;0;1;406;407
8;Barcelona;13;Barcelonès;08101;Hospitalet de Llobregat, l';3;21;A;;724;377;347;0;0;377;377
8;Barcelona;13;Barcelonès;08101;Hospitalet de Llobregat, l';3;21;B;;717;411;306;1;2;408;410
8;Barcelona;13;Barcelonès;08101;Hospitalet de Llobregat, l';3;22;A;;876;450;426;0;3;447;450
8;Barcelona;13;Barcelonès;08101;Hospitalet de Llobregat, l';3;23;A;;679;285;394;1;0;284;284
8;Barcelona;13;Barcelonès;08101;Hospitalet de Llobregat, l';3;23;B;;822;358;464;2;0;356;356
8;Barcelona;13;Barcelonès;08101;Hospitalet de Llobregat, l';3;24;A;;660;358;302;0;0;358;358
8;Barcelona;13;Barcelonès;08101;Hospitalet de Llobregat, l';3;25;A;;1298;830;468;3;6;821;827
8;Barcelona;13;Barcelonès;08101;Hospitalet de Llobregat, l';3;3;A;;743;410;333;7;6;397;403
8;Barcelona;13;Barcelonès;08101;Hospitalet de Llobregat, l';3;3;B;;819;434;385;4;4;426;430
8;Barcelona;13;Barcelonès;08101;Hospitalet de Llobregat, l';3;4;A;;1030;557;473;1;1;555;556
8;Barcelona;13;Barcelonès;08101;Hospitalet de Llobregat, l';3;5;A;;1097;658;439;0;4;654;658
8;Barcelona;13;Barcelonès;08101;Hospitalet de Llobregat, l';3;6;A;;1250;727;523;4;3;720;723
8;Barcelona;13;Barcelonès;08101;Hospitalet de Llobregat, l';3;7;A;;591;336;255;3;1;332;333
8;Barcelona;13;Barcelonès;08101;Hospitalet de Llobregat, l';3;7;B;;644;339;305;0;1;338;339
8;Barcelona;13;Barcelonès;08101;Hospitalet de Llobregat, l';3;8;A;;1116;614;502;3;1;610;611
8;Barcelona;13;Barcelonès;08101;Hospitalet de Llobregat, l';3;9;A;;516;253;263;0;0;253;253
8;Barcelona;13;Barcelonès;08101;Hospitalet de Llobregat, l';4;1;A;;1130;577;553;5;1;571;572
8;Barcelona;13;Barcelonès;08101;Hospitalet de Llobregat, l';4;10;A;;708;378;330;3;4;371;375
8;Barcelona;13;Barcelonès;08101;Hospitalet de Llobregat, l';4;10;B;;846;444;402;3;1;440;441
8;Barcelona;13;Barcelonès;08101;Hospitalet de Llobregat, l';4;11;A;;969;459;510;1;0;458;458
8;Barcelona;13;Barcelonès;08101;Hospitalet de Llobregat, l';4;12;A;;622;304;318;0;0;304;304
8;Barcelona;13;Barcelonès;08101;Hospitalet de Llobregat, l';4;12;B;;766;406;360;0;3;403;406
8;Barcelona;13;Barcelonès;08101;Hospitalet de Llobregat, l';4;13;A;;515;300;215;2;2;296;298
8;Barcelona;13;Barcelonès;08101;Hospitalet de Llobregat, l';4;14;A;;854;421;433;4;6;411;417
8;Barcelona;13;Barcelonès;08101;Hospitalet de Llobregat, l';4;15;A;;657;335;322;0;0;335;335
8;Barcelona;13;Barcelonès;08101;Hospitalet de Llobregat, l';4;16;A;;688;396;292;0;2;394;396
8;Barcelona;13;Barcelonès;08101;Hospitalet de Llobregat, l';4;17;A;;585;267;318;7;0;260;260
8;Barcelona;13;Barcelonès;08101;Hospitalet de Llobregat, l';4;18;A;;992;477;515;0;2;475;477
8;Barcelona;13;Barcelonès;08101;Hospitalet de Llobregat, l';4;19;A;;711;381;330;0;4;377;381
8;Barcelona;13;Barcelonès;08101;Hospitalet de Llobregat, l';4;2;A;;862;423;439;0;4;419;423
8;Barcelona;13;Barcelonès;08101;Hospitalet de Llobregat, l';4;20;A;;1144;615;529;0;8;607;615
8;Barcelona;13;Barcelonès;08101;Hospitalet de Llobregat, l';4;21;A;;1029;492;537;1;2;489;491
8;Barcelona;13;Barcelonès;08101;Hospitalet de Llobregat, l';4;22;A;;923;477;446;1;2;474;476
8;Barcelona;13;Barcelonès;08101;Hospitalet de Llobregat, l';4;23;A;;899;505;394;1;5;499;504
8;Barcelona;13;Barcelonès;08101;Hospitalet de Llobregat, l';4;24;A;;537;243;294;6;1;236;237
8;Barcelona;13;Barcelonès;08101;Hospitalet de Llobregat, l';4;25;A;;873;439;434;1;0;438;438
8;Barcelona;13;Barcelonès;08101;Hospitalet de Llobregat, l';4;26;A;;827;432;395;0;3;429;432
8;Barcelona;13;Barcelonès;08101;Hospitalet de Llobregat, l';4;27;A;;764;403;361;2;1;400;401
8;Barcelona;13;Barcelonès;08101;Hospitalet de Llobregat, l';4;28;A;;501;244;257;1;2;241;243
8;Barcelona;13;Barcelonès;08101;Hospitalet de Llobregat, l';4;29;A;;914;486;428;1;0;485;485
8;Barcelona;13;Barcelonès;08101;Hospitalet de Llobregat, l';4;3;A;;1101;605;496;0;9;596;605
8;Barcelona;13;Barcelonès;08101;Hospitalet de Llobregat, l';4;30;A;;848;381;467;0;0;381;381
8;Barcelona;13;Barcelonès;08101;Hospitalet de Llobregat, l';4;31;A;;528;297;231;1;2;294;296
8;Barcelona;13;Barcelonès;08101;Hospitalet de Llobregat, l';4;31;B;;711;397;314;1;2;394;396
8;Barcelona;13;Barcelonès;08101;Hospitalet de Llobregat, l';4;32;A;;1033;532;501;1;0;531;531
8;Barcelona;13;Barcelonès;08101;Hospitalet de Llobregat, l';4;33;A;;846;409;437;1;1;407;408
8;Barcelona;13;Barcelonès;08101;Hospitalet de Llobregat, l';4;34;A;;642;354;288;8;1;345;346
8;Barcelona;13;Barcelonès;08101;Hospitalet de Llobregat, l';4;35;A;;1016;511;505;2;3;506;509
8;Barcelona;13;Barcelonès;08101;Hospitalet de Llobregat, l';4;36;A;;644;301;343;5;1;295;296
8;Barcelona;13;Barcelonès;08101;Hospitalet de Llobregat, l';4;37;A;;710;372;338;3;2;367;369
8;Barcelona;13;Barcelonès;08101;Hospitalet de Llobregat, l';4;38;A;;753;391;362;1;5;385;390
8;Barcelona;13;Barcelonès;08101;Hospitalet de Llobregat, l';4;39;A;;924;512;412;1;6;505;511
8;Barcelona;13;Barcelonès;08101;Hospitalet de Llobregat, l';4;4;A;;758;383;375;2;1;380;381
8;Barcelona;13;Barcelonès;08101;Hospitalet de Llobregat, l';4;40;A;;962;502;460;16;0;486;486
8;Barcelona;13;Barcelonès;08101;Hospitalet de Llobregat, l';4;41;A;;700;377;323;0;2;375;377
8;Barcelona;13;Barcelonès;08101;Hospitalet de Llobregat, l';4;41;B;;797;440;357;0;6;434;440
8;Barcelona;13;Barcelonès;08101;Hospitalet de Llobregat, l';4;42;A;;521;275;246;0;1;274;275
8;Barcelona;13;Barcelonès;08101;Hospitalet de Llobregat, l';4;5;A;;838;377;461;2;3;372;375
8;Barcelona;13;Barcelonès;08101;Hospitalet de Llobregat, l';4;6;A;;1095;538;557;0;2;536;538
8;Barcelona;13;Barcelonès;08101;Hospitalet de Llobregat, l';4;7;A;;986;479;507;0;4;475;479
8;Barcelona;13;Barcelonès;08101;Hospitalet de Llobregat, l';4;8;A;;762;391;371;1;0;390;390
8;Barcelona;13;Barcelonès;08101;Hospitalet de Llobregat, l';4;9;A;;607;315;292;2;5;308;313
8;Barcelona;13;Barcelonès;08101;Hospitalet de Llobregat, l';5;1;A;;741;439;302;0;4;435;439
8;Barcelona;13;Barcelonès;08101;Hospitalet de Llobregat, l';5;10;A;;962;481;481;5;3;473;476
8;Barcelona;13;Barcelonès;08101;Hospitalet de Llobregat, l';5;11;A;;689;362;327;3;0;359;359
8;Barcelona;13;Barcelonès;08101;Hospitalet de Llobregat, l';5;12;A;;820;404;416;1;0;403;403
8;Barcelona;13;Barcelonès;08101;Hospitalet de Llobregat, l';5;13;A;;704;324;380;2;1;321;322
8;Barcelona;13;Barcelonès;08101;Hospitalet de Llobregat, l';5;14;A;;710;362;348;4;1;357;358
8;Barcelona;13;Barcelonès;08101;Hospitalet de Llobregat, l';5;15;A;;516;245;271;16;0;229;229
8;Barcelona;13;Barcelonès;08101;Hospitalet de Llobregat, l';5;16;A;;587;288;299;0;0;288;288
8;Barcelona;13;Barcelonès;08101;Hospitalet de Llobregat, l';5;17;A;;988;502;486;0;5;497;502
8;Barcelona;13;Barcelonès;08101;Hospitalet de Llobregat, l';5;18;A;;1024;544;480;6;7;531;538
8;Barcelona;13;Barcelonès;08101;Hospitalet de Llobregat, l';5;19;A;;530;277;253;1;4;272;276
8;Barcelona;13;Barcelonès;08101;Hospitalet de Llobregat, l';5;2;A;;613;334;279;1;0;333;333
8;Barcelona;13;Barcelonès;08101;Hospitalet de Llobregat, l';5;2;B;;679;413;266;5;1;407;408
8;Barcelona;13;Barcelonès;08101;Hospitalet de Llobregat, l';5;20;A;;839;423;416;0;1;422;423
8;Barcelona;13;Barcelonès;08101;Hospitalet de Llobregat, l';5;21;A;;997;516;481;1;3;512;515
8;Barcelona;13;Barcelonès;08101;Hospitalet de Llobregat, l';5;22;A;;672;341;331;0;1;340;341
8;Barcelona;13;Barcelonès;08101;Hospitalet de Llobregat, l';5;23;A;;1211;643;568;1;2;640;642
8;Barcelona;13;Barcelonès;08101;Hospitalet de Llobregat, l';5;24;A;;1114;602;512;1;2;599;601
8;Barcelona;13;Barcelonès;08101;Hospitalet de Llobregat, l';5;25;A;;728;382;346;2;2;378;380
8;Barcelona;13;Barcelonès;08101;Hospitalet de Llobregat, l';5;26;A;;585;299;286;2;3;294;297
8;Barcelona;13;Barcelonès;08101;Hospitalet de Llobregat, l';5;27;A;;922;472;450;0;2;470;472
8;Barcelona;13;Barcelonès;08101;Hospitalet de Llobregat, l';5;28;A;;1054;578;476;0;1;577;578
8;Barcelona;13;Barcelonès;08101;Hospitalet de Llobregat, l';5;29;A;;1121;598;523;2;10;586;596
8;Barcelona;13;Barcelonès;08101;Hospitalet de Llobregat, l';5;3;A;;684;348;336;0;1;347;348
8;Barcelona;13;Barcelonès;08101;Hospitalet de Llobregat, l';5;30;A;;1170;651;519;2;2;647;649
8;Barcelona;13;Barcelonès;08101;Hospitalet de Llobregat, l';5;31;A;;835;431;404;1;3;427;430
8;Barcelona;13;Barcelonès;08101;Hospitalet de Llobregat, l';5;32;A;;1222;682;540;3;6;673;679
8;Barcelona;13;Barcelonès;08101;Hospitalet de Llobregat, l';5;33;A;;873;461;412;0;2;459;461
8;Barcelona;13;Barcelonès;08101;Hospitalet de Llobregat, l';5;34;A;;815;459;356;1;1;457;458
8;Barcelona;13;Barcelonès;08101;Hospitalet de Llobregat, l';5;35;A;;903;491;412;2;1;488;489
8;Barcelona;13;Barcelonès;08101;Hospitalet de Llobregat, l';5;36;A;;838;469;369;1;1;467;468
8;Barcelona;13;Barcelonès;08101;Hospitalet de Llobregat, l';5;37;A;;1049;561;488;0;7;554;561
8;Barcelona;13;Barcelonès;08101;Hospitalet de Llobregat, l';5;38;A;;1155;630;525;1;5;624;629
8;Barcelona;13;Barcelonès;08101;Hospitalet de Llobregat, l';5;4;A;;1106;607;499;0;5;602;607
8;Barcelona;13;Barcelonès;08101;Hospitalet de Llobregat, l';5;5;A;;1144;598;546;2;2;594;596
8;Barcelona;13;Barcelonès;08101;Hospitalet de Llobregat, l';5;6;A;;743;410;333;4;0;406;406
8;Barcelona;13;Barcelonès;08101;Hospitalet de Llobregat, l';5;6;B;;707;366;341;0;4;362;366
8;Barcelona;13;Barcelonès;08101;Hospitalet de Llobregat, l';5;7;A;;672;375;297;0;2;373;375
8;Barcelona;13;Barcelonès;08101;Hospitalet de Llobregat, l';5;8;A;;572;315;257;1;3;311;314
8;Barcelona;13;Barcelonès;08101;Hospitalet de Llobregat, l';5;9;A;;687;409;278;3;1;405;406
8;Barcelona;13;Barcelonès;08101;Hospitalet de Llobregat, l';6;1;A;;1117;635;482;0;2;633;635
8;Barcelona;13;Barcelonès;08101;Hospitalet de Llobregat, l';6;10;A;;1210;635;575;1;3;631;634
8;Barcelona;13;Barcelonès;08101;Hospitalet de Llobregat, l';6;11;A;;1006;554;452;3;5;546;551
8;Barcelona;13;Barcelonès;08101;Hospitalet de Llobregat, l';6;12;A;;1013;521;492;3;3;515;518
8;Barcelona;13;Barcelonès;08101;Hospitalet de Llobregat, l';6;13;A;;1254;646;608;1;3;642;645
8;Barcelona;13;Barcelonès;08101;Hospitalet de Llobregat, l';6;14;A;;886;491;395;3;6;482;488
8;Barcelona;13;Barcelonès;08101;Hospitalet de Llobregat, l';6;15;A;;837;488;349;5;5;478;483
8;Barcelona;13;Barcelonès;08101;Hospitalet de Llobregat, l';6;16;A;;264;264;0;0;2;262;264
8;Barcelona;13;Barcelonès;08101;Hospitalet de Llobregat, l';6;16;B;;716;328;388;0;3;325;328
8;Barcelona;13;Barcelonès;08101;Hospitalet de Llobregat, l';6;17;A;;400;208;192;2;1;205;206
8;Barcelona;13;Barcelonès;08101;Hospitalet de Llobregat, l';6;18;A;;557;312;245;0;2;310;312
8;Barcelona;13;Barcelonès;08101;Hospitalet de Llobregat, l';6;19;A;;1204;592;612;0;5;587;592
8;Barcelona;13;Barcelonès;08101;Hospitalet de Llobregat, l';6;2;A;;525;330;195;1;3;326;329
8;Barcelona;13;Barcelonès;08101;Hospitalet de Llobregat, l';6;20;A;;535;291;244;0;1;290;291
8;Barcelona;13;Barcelonès;08101;Hospitalet de Llobregat, l';6;21;A;;1227;652;575;1;9;642;651
8;Barcelona;13;Barcelonès;08101;Hospitalet de Llobregat, l';6;22;A;;764;372;392;0;2;370;372
8;Barcelona;13;Barcelonès;08101;Hospitalet de Llobregat, l';6;23;A;;597;354;243;0;0;354;354
8;Barcelona;13;Barcelonès;08101;Hospitalet de Llobregat, l';6;23;B;;705;424;281;0;1;423;424
8;Barcelona;13;Barcelonès;08101;Hospitalet de Llobregat, l';6;24;A;;1018;508;510;5;1;502;503
8;Barcelona;13;Barcelonès;08101;Hospitalet de Llobregat, l';6;25;A;;962;500;462;4;5;491;496
8;Barcelona;13;Barcelonès;08101;Hospitalet de Llobregat, l';6;26;A;;1052;465;587;13;1;451;452
8;Barcelona;13;Barcelonès;08101;Hospitalet de Llobregat, l';6;27;A;;863;449;414;1;0;448;448
8;Barcelona;13;Barcelonès;08101;Hospitalet de Llobregat, l';6;28;A;;911;414;497;0;2;412;414
8;Barcelona;13;Barcelonès;08101;Hospitalet de Llobregat, l';6;29;A;;630;273;357;2;1;270;271
8;Barcelona;13;Barcelonès;08101;Hospitalet de Llobregat, l';6;3;A;;530;236;294;3;0;233;233
8;Barcelona;13;Barcelonès;08101;Hospitalet de Llobregat, l';6;30;A;;739;380;359;1;1;378;379
8;Barcelona;13;Barcelonès;08101;Hospitalet de Llobregat, l';6;31;A;;969;502;467;3;2;497;499
8;Barcelona;13;Barcelonès;08101;Hospitalet de Llobregat, l';6;32;A;;902;349;553;5;1;343;344
8;Barcelona;13;Barcelonès;08101;Hospitalet de Llobregat, l';6;33;A;;1081;462;619;12;3;447;450
8;Barcelona;13;Barcelonès;08101;Hospitalet de Llobregat, l';6;4;A;;584;312;272;2;2;308;310
8;Barcelona;13;Barcelonès;08101;Hospitalet de Llobregat, l';6;5;A;;646;389;257;0;5;384;389
8;Barcelona;13;Barcelonès;08101;Hospitalet de Llobregat, l';6;6;A;;995;482;513;5;3;474;477
8;Barcelona;13;Barcelonès;08101;Hospitalet de Llobregat, l';6;7;A;;924;459;465;2;5;452;457
8;Barcelona;13;Barcelonès;08101;Hospitalet de Llobregat, l';6;8;A;;893;404;489;5;1;398;399
8;Barcelona;13;Barcelonès;08101;Hospitalet de Llobregat, l';6;9;A;;809;431;378;3;1;427;428
8;Barcelona;6;Anoia;08162;Hostalets de Pierola, els;1;1;A;;675;515;160;5;3;507;510
17;Girona;34;Selva;17083;Hostalric;1;1;A;;1052;756;296;1;2;753;755
17;Girona;34;Selva;17083;Hostalric;1;2;A;;944;622;322;0;4;618;622
8;Barcelona;6;Anoia;08102;Igualada;1;1;A;;614;438;176;0;4;434;438
8;Barcelona;6;Anoia;08102;Igualada;1;2;A;;665;459;206;2;1;456;457
8;Barcelona;6;Anoia;08102;Igualada;1;3;A;;570;371;199;0;0;371;371
8;Barcelona;6;Anoia;08102;Igualada;2;1;A;;645;466;179;6;0;460;460
8;Barcelona;6;Anoia;08102;Igualada;2;2;A;;919;627;292;6;4;617;621
8;Barcelona;6;Anoia;08102;Igualada;2;3;A;;1438;1004;434;3;14;987;1001
8;Barcelona;6;Anoia;08102;Igualada;3;1;A;;942;630;312;4;1;625;626
8;Barcelona;6;Anoia;08102;Igualada;3;2;A;;669;423;246;1;3;419;422
8;Barcelona;6;Anoia;08102;Igualada;3;3;A;;913;641;272;2;4;635;639
8;Barcelona;6;Anoia;08102;Igualada;3;3;B;;1149;794;355;2;2;790;792
8;Barcelona;6;Anoia;08102;Igualada;3;4;A;;908;606;302;7;4;595;599
8;Barcelona;6;Anoia;08102;Igualada;3;4;B;;1074;712;362;3;6;703;709
8;Barcelona;6;Anoia;08102;Igualada;3;5;A;;1061;700;361;1;5;694;699
8;Barcelona;6;Anoia;08102;Igualada;4;1;A;;889;586;303;1;0;585;585
8;Barcelona;6;Anoia;08102;Igualada;4;2;A;;899;601;298;0;3;598;601
8;Barcelona;6;Anoia;08102;Igualada;4;3;A;;635;428;207;1;2;425;427
8;Barcelona;6;Anoia;08102;Igualada;4;4;A;;987;689;298;2;7;680;687
8;Barcelona;6;Anoia;08102;Igualada;4;5;A;;1328;930;398;1;3;926;929
8;Barcelona;6;Anoia;08102;Igualada;5;1;A;;1145;792;353;0;5;787;792
8;Barcelona;6;Anoia;08102;Igualada;5;2;A;;1009;667;342;0;11;656;667
8;Barcelona;6;Anoia;08102;Igualada;5;3;A;;784;546;238;0;3;543;546
8;Barcelona;6;Anoia;08102;Igualada;5;3;B;;980;685;295;6;2;677;679
8;Barcelona;6;Anoia;08102;Igualada;5;4;A;;790;505;285;1;4;500;504
8;Barcelona;6;Anoia;08102;Igualada;5;4;B;;928;650;278;4;2;644;646
8;Barcelona;6;Anoia;08102;Igualada;5;5;A;;665;402;263;0;1;401;402
8;Barcelona;6;Anoia;08102;Igualada;5;6;A;;1221;714;507;18;1;695;696
25;Lleida;25;Pallars Jussà;25115;Isona i Conca Dellà;1;1;A;;727;439;288;3;4;432;436
25;Lleida;25;Pallars Jussà;25115;Isona i Conca Dellà;1;1;B;;282;166;116;8;0;158;158
25;Lleida;25;Pallars Jussà;25115;Isona i Conca Dellà;1;1;C;;229;171;58;0;0;171;171
17;Girona;15;Cerdanya;17084;Isòvol;1;1;A;;160;116;44;3;0;113;113
25;Lleida;27;Pla d'Urgell;25113;Ivars d'Urgell;1;1;A;;651;484;167;4;1;479;480
25;Lleida;27;Pla d'Urgell;25113;Ivars d'Urgell;1;2;A;;785;580;205;1;6;573;579
25;Lleida;23;Noguera;25112;Ivars de Noguera;1;1;A;;297;220;77;0;3;217;220
25;Lleida;32;Segarra;25114;Ivorra;1;1;A;;154;135;19;0;0;135;135
17;Girona;10;Baix Empordà;17085;Jafre;1;1;A;;294;237;57;1;3;233;236
17;Girona;2;Alt Empordà;17086;Jonquera, la;1;1;A;;621;395;226;2;2;391;393
17;Girona;2;Alt Empordà;17086;Jonquera, la;1;1;B;;584;356;228;3;3;350;353
17;Girona;2;Alt Empordà;17086;Jonquera, la;1;1;C;;711;448;263;0;3;445;448
8;Barcelona;6;Anoia;08103;Jorba;1;1;A;;430;287;143;1;2;284;286
25;Lleida;4;Alt Urgell;25910;Josa i Tuixén;1;1;A;;117;78;39;0;0;78;78
17;Girona;20;Gironès;17087;Juià;1;1;A;;217;159;58;0;0;159;159
25;Lleida;18;Garrigues;25118;Juncosa;1;1;A;;496;330;166;0;0;330;330
25;Lleida;18;Garrigues;25119;Juneda;1;1;A;;768;523;245;1;7;515;522
25;Lleida;18;Garrigues;25119;Juneda;1;1;B;;746;490;256;3;7;480;487
25;Lleida;18;Garrigues;25119;Juneda;1;2;A;;882;628;254;2;6;620;626
25;Lleida;39;Consell General d'Aran;25121;Les;1;1;A;;490;340;150;2;0;338;338
25;Lleida;27;Pla d'Urgell;25122;Linyola;1;1;A;;957;648;309;2;7;639;646
25;Lleida;27;Pla d'Urgell;25122;Linyola;1;2;A;;918;636;282;4;12;620;632
8;Barcelona;6;Anoia;08104;Llacuna, la;1;1;A;;582;354;228;1;4;349;353
17;Girona;2;Alt Empordà;17088;Lladó;1;1;A;;413;280;133;3;3;274;277
25;Lleida;26;Pallars Sobirà;25123;Lladorre;1;1;A;;185;134;51;0;1;133;134
25;Lleida;35;Solsonès;25124;Lladurs;1;1;A;;221;112;109;0;3;109;112
8;Barcelona;41;Vallès Oriental;08105;Llagosta, la;1;1;A;;437;248;189;0;1;247;248
8;Barcelona;41;Vallès Oriental;08105;Llagosta, la;1;1;B;;655;374;281;1;2;371;373
8;Barcelona;41;Vallès Oriental;08105;Llagosta, la;1;2;A;;600;312;288;0;2;310;312
8;Barcelona;41;Vallès Oriental;08105;Llagosta, la;1;2;B;;656;366;290;7;5;354;359
8;Barcelona;41;Vallès Oriental;08105;Llagosta, la;1;3;A;;625;316;309;3;1;312;313
8;Barcelona;41;Vallès Oriental;08105;Llagosta, la;1;3;B;;713;401;312;1;1;399;400
8;Barcelona;41;Vallès Oriental;08105;Llagosta, la;1;4;A;;575;354;221;1;1;352;353
8;Barcelona;41;Vallès Oriental;08105;Llagosta, la;1;4;B;;685;435;250;1;2;432;434
8;Barcelona;41;Vallès Oriental;08105;Llagosta, la;1;5;A;;496;218;278;1;2;215;217
8;Barcelona;41;Vallès Oriental;08105;Llagosta, la;1;5;B;;612;303;309;0;2;301;303
8;Barcelona;41;Vallès Oriental;08105;Llagosta, la;1;6;A;;514;264;250;3;0;261;261
8;Barcelona;41;Vallès Oriental;08105;Llagosta, la;1;6;B;;707;412;295;0;0;412;412
8;Barcelona;41;Vallès Oriental;08105;Llagosta, la;1;7;A;;603;326;277;1;0;325;325
8;Barcelona;41;Vallès Oriental;08105;Llagosta, la;1;7;B;;715;378;337;1;2;375;377
17;Girona;20;Gironès;17089;Llagostera;1;1;A;;544;345;199;1;3;341;344
17;Girona;20;Gironès;17089;Llagostera;1;1;B;;771;511;260;4;4;503;507
17;Girona;20;Gironès;17089;Llagostera;1;2;A;;698;500;198;8;2;490;492
17;Girona;20;Gironès;17089;Llagostera;1;2;B;;1051;747;304;16;4;727;731
17;Girona;20;Gironès;17089;Llagostera;1;3;A;;791;468;323;34;3;431;434
17;Girona;20;Gironès;17090;Llambilles;1;1;A;;343;256;87;3;0;253;253
17;Girona;31;Ripollès;17091;Llanars;1;1;A;;316;253;63;1;5;247;252
17;Girona;2;Alt Empordà;17092;Llançà;1;1;A;;536;387;149;0;2;385;387
17;Girona;2;Alt Empordà;17092;Llançà;1;2;A;;509;376;133;3;2;371;373
17;Girona;2;Alt Empordà;17092;Llançà;1;2;B;;468;324;144;0;1;323;324
17;Girona;2;Alt Empordà;17092;Llançà;1;3;A;;404;276;128;0;1;275;276
17;Girona;2;Alt Empordà;17092;Llançà;1;3;B;;502;323;179;3;2;318;320
25;Lleida;33;Segrià;25125;Llardecans;1;1;A;;588;353;235;0;1;352;353
25;Lleida;26;Pallars Sobirà;25126;Llavorsí;1;1;A;;233;153;80;1;2;150;152
25;Lleida;33;Segrià;25120;Lleida;1;1;A;;835;529;306;2;8;519;527
25;Lleida;33;Segrià;25120;Lleida;1;1;B;;891;566;325;0;14;552;566
25;Lleida;33;Segrià;25120;Lleida;1;10;A;;1019;616;403;6;3;607;610
25;Lleida;33;Segrià;25120;Lleida;1;2;A;;743;480;263;0;6;474;480
25;Lleida;33;Segrià;25120;Lleida;1;3;A;;1048;607;441;2;9;596;605
25;Lleida;33;Segrià;25120;Lleida;1;4;A;;931;490;441;0;1;489;490
25;Lleida;33;Segrià;25120;Lleida;1;5;A;;1020;572;448;2;4;566;570
25;Lleida;33;Segrià;25120;Lleida;1;6;A;;1018;561;457;3;1;557;558
25;Lleida;33;Segrià;25120;Lleida;1;7;A;;808;391;417;0;3;388;391
25;Lleida;33;Segrià;25120;Lleida;1;7;B;;1007;461;546;0;2;459;461
25;Lleida;33;Segrià;25120;Lleida;1;8;A;;694;366;328;2;12;352;364
25;Lleida;33;Segrià;25120;Lleida;1;8;B;;797;458;339;1;3;454;457
25;Lleida;33;Segrià;25120;Lleida;1;9;A;;1041;614;427;4;3;607;610
25;Lleida;33;Segrià;25120;Lleida;2;1;A;;620;363;257;1;0;362;362
25;Lleida;33;Segrià;25120;Lleida;2;2;A;;491;293;198;1;0;292;292
25;Lleida;33;Segrià;25120;Lleida;2;3;A;;1102;555;547;3;7;545;552
25;Lleida;33;Segrià;25120;Lleida;2;4;A;;782;444;338;2;2;440;442
25;Lleida;33;Segrià;25120;Lleida;2;4;B;;897;513;384;0;4;509;513
25;Lleida;33;Segrià;25120;Lleida;2;5;A;;470;261;209;0;3;258;261
25;Lleida;33;Segrià;25120;Lleida;2;6;A;;563;309;254;0;3;306;309
25;Lleida;33;Segrià;25120;Lleida;2;6;B;;691;376;315;0;3;373;376
25;Lleida;33;Segrià;25120;Lleida;2;7;A;;1118;541;577;1;4;536;540
25;Lleida;33;Segrià;25120;Lleida;2;8;A;;624;369;255;2;6;361;367
25;Lleida;33;Segrià;25120;Lleida;2;8;B;;678;374;304;0;2;372;374
25;Lleida;33;Segrià;25120;Lleida;3;1;A;;655;339;316;2;0;337;337
25;Lleida;33;Segrià;25120;Lleida;3;2;A;;666;334;332;2;5;327;332
25;Lleida;33;Segrià;25120;Lleida;3;3;A;;773;514;259;5;2;507;509
25;Lleida;33;Segrià;25120;Lleida;3;4;A;;896;563;333;0;10;553;563
25;Lleida;33;Segrià;25120;Lleida;3;5;A;;662;301;361;0;4;297;301
25;Lleida;33;Segrià;25120;Lleida;3;6;A;;1186;735;451;2;10;723;733
25;Lleida;33;Segrià;25120;Lleida;3;7;A;;566;353;213;4;2;347;349
25;Lleida;33;Segrià;25120;Lleida;3;8;A;;1013;640;373;0;5;635;640
25;Lleida;33;Segrià;25120;Lleida;4;1;A;;1040;520;520;4;4;512;516
25;Lleida;33;Segrià;25120;Lleida;4;10;A;;688;323;365;3;3;317;320
25;Lleida;33;Segrià;25120;Lleida;4;10;B;;607;290;317;1;4;285;289
25;Lleida;33;Segrià;25120;Lleida;4;11;A;;1192;522;670;1;1;520;521
25;Lleida;33;Segrià;25120;Lleida;4;12;A;;954;548;406;8;6;534;540
25;Lleida;33;Segrià;25120;Lleida;4;13;A;;1176;591;585;0;7;584;591
25;Lleida;33;Segrià;25120;Lleida;4;14;A;;782;390;392;1;4;385;389
25;Lleida;33;Segrià;25120;Lleida;4;15;A;;1121;575;546;1;11;563;574
25;Lleida;33;Segrià;25120;Lleida;4;16;A;;599;308;291;2;5;301;306
25;Lleida;33;Segrià;25120;Lleida;4;16;B;;733;410;323;1;1;408;409
25;Lleida;33;Segrià;25120;Lleida;4;2;A;;935;520;415;5;5;510;515
25;Lleida;33;Segrià;25120;Lleida;4;3;A;;629;447;182;0;5;442;447
25;Lleida;33;Segrià;25120;Lleida;4;3;B;;750;507;243;4;2;501;503
25;Lleida;33;Segrià;25120;Lleida;4;4;A;;808;476;332;1;7;468;475
25;Lleida;33;Segrià;25120;Lleida;4;5;A;;876;540;336;2;4;534;538
25;Lleida;33;Segrià;25120;Lleida;4;6;A;;1033;588;445;1;9;578;587
25;Lleida;33;Segrià;25120;Lleida;4;7;A;;1016;535;481;2;5;528;533
25;Lleida;33;Segrià;25120;Lleida;4;8;A;;1047;539;508;7;4;528;532
25;Lleida;33;Segrià;25120;Lleida;4;9;A;;860;400;460;2;1;397;398
25;Lleida;33;Segrià;25120;Lleida;4;9;B;;841;401;440;0;3;398;401
25;Lleida;33;Segrià;25120;Lleida;5;1;A;;449;244;205;0;0;244;244
25;Lleida;33;Segrià;25120;Lleida;5;10;A;;979;585;394;3;5;577;582
25;Lleida;33;Segrià;25120;Lleida;5;2;A;;601;378;223;2;5;371;376
25;Lleida;33;Segrià;25120;Lleida;5;2;B;;679;400;279;3;1;396;397
25;Lleida;33;Segrià;25120;Lleida;5;3;A;;1179;700;479;0;7;693;700
25;Lleida;33;Segrià;25120;Lleida;5;4;A;;1038;636;402;3;4;629;633
25;Lleida;33;Segrià;25120;Lleida;5;5;A;;955;628;327;9;5;614;619
25;Lleida;33;Segrià;25120;Lleida;5;6;A;;912;574;338;0;5;569;574
25;Lleida;33;Segrià;25120;Lleida;5;7;A;;986;584;402;7;2;575;577
25;Lleida;33;Segrià;25120;Lleida;5;8;A;;689;395;294;1;6;388;394
25;Lleida;33;Segrià;25120;Lleida;5;8;B;;816;517;299;0;6;511;517
25;Lleida;33;Segrià;25120;Lleida;5;9;A;;855;543;312;4;15;524;539
25;Lleida;33;Segrià;25120;Lleida;6;1;A;;541;286;255;0;1;285;286
25;Lleida;33;Segrià;25120;Lleida;6;10;A;;1225;729;496;4;2;723;725
25;Lleida;33;Segrià;25120;Lleida;6;11;A;;711;413;298;3;2;408;410
25;Lleida;33;Segrià;25120;Lleida;6;11;B;;731;460;271;2;7;451;458
25;Lleida;33;Segrià;25120;Lleida;6;12;A;;1213;699;514;2;6;691;697
25;Lleida;33;Segrià;25120;Lleida;6;13;A;;1141;746;395;5;8;733;741
25;Lleida;33;Segrià;25120;Lleida;6;14;A;;626;315;311;0;3;312;315
25;Lleida;33;Segrià;25120;Lleida;6;2;A;;747;446;301;3;7;436;443
25;Lleida;33;Segrià;25120;Lleida;6;2;B;;767;464;303;0;6;458;464
25;Lleida;33;Segrià;25120;Lleida;6;3;A;;722;429;293;1;3;425;428
25;Lleida;33;Segrià;25120;Lleida;6;3;B;;791;450;341;1;5;444;449
25;Lleida;33;Segrià;25120;Lleida;6;4;A;;881;520;361;5;4;511;515
25;Lleida;33;Segrià;25120;Lleida;6;4;B;;1025;619;406;13;0;606;606
25;Lleida;33;Segrià;25120;Lleida;6;5;A;;918;615;303;4;6;605;611
25;Lleida;33;Segrià;25120;Lleida;6;6;A;;752;373;379;3;4;366;370
25;Lleida;33;Segrià;25120;Lleida;6;6;B;;868;426;442;1;4;421;425
25;Lleida;33;Segrià;25120;Lleida;6;7;A;;1209;627;582;3;9;615;624
25;Lleida;33;Segrià;25120;Lleida;6;8;A;;1033;646;387;2;2;642;644
25;Lleida;33;Segrià;25120;Lleida;6;9;A;;1048;514;534;3;0;511;511
25;Lleida;33;Segrià;25120;Lleida;7;1;A;;660;355;305;2;1;352;353
25;Lleida;33;Segrià;25120;Lleida;7;1;B;;779;400;379;3;1;396;397
25;Lleida;33;Segrià;25120;Lleida;7;2;A;;584;285;299;2;1;282;283
25;Lleida;33;Segrià;25120;Lleida;7;2;B;;691;351;340;0;3;348;351
25;Lleida;33;Segrià;25120;Lleida;7;3;A;;531;255;276;2;2;251;253
25;Lleida;33;Segrià;25120;Lleida;7;4;A;;664;433;231;0;3;430;433
25;Lleida;33;Segrià;25120;Lleida;7;4;B;;826;501;325;0;1;500;501
25;Lleida;33;Segrià;25120;Lleida;7;5;A;;862;445;417;0;0;445;445
25;Lleida;33;Segrià;25120;Lleida;7;6;A;;619;368;251;1;6;361;367
25;Lleida;33;Segrià;25120;Lleida;7;6;B;;694;399;295;0;8;391;399
25;Lleida;33;Segrià;25120;Lleida;8;1;A;;663;338;325;0;5;333;338
25;Lleida;33;Segrià;25120;Lleida;8;1;B;;781;417;364;1;2;414;416
25;Lleida;33;Segrià;25120;Lleida;8;2;A;;497;256;241;0;2;254;256
25;Lleida;33;Segrià;25120;Lleida;8;2;B;;289;136;153;3;0;133;133
25;Lleida;33;Segrià;25120;Lleida;8;3;A;;376;259;117;0;2;257;259
25;Lleida;33;Segrià;25120;Lleida;8;3;B;;497;291;206;2;3;286;289
25;Lleida;33;Segrià;25120;Lleida;9;1;A;;371;218;153;4;3;211;214
25;Lleida;33;Segrià;25120;Lleida;9;1;B;;615;304;311;0;7;297;304
25;Lleida;33;Segrià;25120;Lleida;9;2;A;;715;398;317;0;1;397;398
25;Lleida;33;Segrià;25120;Lleida;9;2;B;;413;243;170;0;0;243;243
17;Girona;2;Alt Empordà;17093;Llers;1;1;A;;526;347;179;2;2;343;345
25;Lleida;15;Cerdanya;25127;Lles de Cerdanya;1;1;A;;265;178;87;1;1;176;177
8;Barcelona;41;Vallès Oriental;08107;Lliçà d'Amunt;1;1;A;;692;404;288;9;1;394;395
8;Barcelona;41;Vallès Oriental;08107;Lliçà d'Amunt;1;1;B;;579;314;265;0;3;311;314
8;Barcelona;41;Vallès Oriental;08107;Lliçà d'Amunt;1;1;C;;910;514;396;3;3;508;511
8;Barcelona;41;Vallès Oriental;08107;Lliçà d'Amunt;1;1;D;;767;457;310;2;4;451;455
8;Barcelona;41;Vallès Oriental;08108;Lliçà de Vall;1;1;A;;763;489;274;5;1;483;484
8;Barcelona;41;Vallès Oriental;08108;Lliçà de Vall;1;1;B;;870;554;316;4;1;549;550
25;Lleida;25;Pallars Jussà;25128;Llimiana;1;1;A;;121;65;56;0;0;65;65
8;Barcelona;41;Vallès Oriental;08106;Llinars del Vallès;1;1;A;;624;408;216;1;3;404;407
8;Barcelona;41;Vallès Oriental;08106;Llinars del Vallès;1;1;B;;520;314;206;4;1;309;310
8;Barcelona;41;Vallès Oriental;08106;Llinars del Vallès;1;1;C;;668;413;255;3;4;406;410
8;Barcelona;41;Vallès Oriental;08106;Llinars del Vallès;2;1;A;;689;448;241;1;4;443;447
8;Barcelona;41;Vallès Oriental;08106;Llinars del Vallès;2;1;B;;468;286;182;9;2;275;277
8;Barcelona;41;Vallès Oriental;08106;Llinars del Vallès;2;1;C;;655;400;255;8;0;392;392
17;Girona;15;Cerdanya;17094;Llívia;1;1;A;;708;481;227;1;3;477;480
43;Tarragona;29;Priorat;43072;Lloar, el;1;1;A;;136;96;40;1;2;93;95
25;Lleida;35;Solsonès;25129;Llobera;1;1;A;;206;125;81;0;0;125;125
43;Tarragona;16;Conca de Barberà;43073;Llorac;1;1;A;;83;60;23;0;0;60;60
43;Tarragona;12;Baix Penedès;43074;Llorenç del Penedès;1;1;A;;948;728;220;13;13;702;715
17;Girona;34;Selva;17095;Lloret de Mar;1;1;A;;841;402;439;3;3;396;399
17;Girona;34;Selva;17095;Lloret de Mar;1;2;A;;1035;595;440;0;7;588;595
17;Girona;34;Selva;17095;Lloret de Mar;2;1;A;;788;455;333;0;7;448;455
17;Girona;34;Selva;17095;Lloret de Mar;2;1;B;;912;540;372;1;4;535;539
17;Girona;34;Selva;17095;Lloret de Mar;2;2;A;;551;312;239;2;2;308;310
17;Girona;34;Selva;17095;Lloret de Mar;2;2;B;;614;352;262;0;3;349;352
17;Girona;34;Selva;17095;Lloret de Mar;2;3;A;;880;447;433;2;1;444;445
17;Girona;34;Selva;17095;Lloret de Mar;3;1;A;;890;405;485;2;0;403;403
17;Girona;34;Selva;17095;Lloret de Mar;3;2;A;;836;397;439;1;2;394;396
17;Girona;34;Selva;17095;Lloret de Mar;3;2;B;;922;424;498;3;0;421;421
17;Girona;34;Selva;17095;Lloret de Mar;4;1;A;;706;339;367;2;1;336;337
17;Girona;34;Selva;17095;Lloret de Mar;4;1;B;;828;381;447;2;2;377;379
17;Girona;31;Ripollès;17096;Llosses, les;1;1;A;;326;149;177;8;0;141;141
8;Barcelona;24;Osona;08109;Lluçà;1;1;A;;230;163;67;0;1;162;163
17;Girona;2;Alt Empordà;17102;Maçanet de Cabrenys;1;1;A;;608;447;161;3;2;442;444
17;Girona;34;Selva;17103;Maçanet de la Selva;1;1;A;;1039;668;371;2;0;666;666
17;Girona;34;Selva;17103;Maçanet de la Selva;1;1;B;;779;469;310;9;3;457;460
17;Girona;20;Gironès;17097;Madremanya;1;1;A;;169;109;60;0;0;109;109
17;Girona;19;Garrotxa;17098;Maià de Montcal;1;1;A;;309;199;110;2;1;196;197
25;Lleida;33;Segrià;25133;Maials;1;1;A;;1008;612;396;1;6;605;611
25;Lleida;38;Urgell;25130;Maldà;1;1;A;;294;199;95;0;0;199;199
8;Barcelona;21;Maresme;08110;Malgrat de Mar;1;1;A;;695;413;282;0;2;411;413
8;Barcelona;21;Maresme;08110;Malgrat de Mar;1;1;B;;809;494;315;1;6;487;493
8;Barcelona;21;Maresme;08110;Malgrat de Mar;1;2;A;;528;339;189;0;2;337;339
8;Barcelona;21;Maresme;08110;Malgrat de Mar;1;2;B;;668;412;256;0;2;410;412
8;Barcelona;21;Maresme;08110;Malgrat de Mar;1;2;C;;706;464;242;0;2;462;464
8;Barcelona;21;Maresme;08110;Malgrat de Mar;1;3;A;;649;403;246;1;2;400;402
8;Barcelona;21;Maresme;08110;Malgrat de Mar;1;3;B;;672;441;231;1;1;439;440
8;Barcelona;21;Maresme;08110;Malgrat de Mar;1;3;C;;686;403;283;0;2;401;403
8;Barcelona;21;Maresme;08110;Malgrat de Mar;2;1;A;;1404;915;489;2;5;908;913
8;Barcelona;21;Maresme;08110;Malgrat de Mar;2;2;A;;451;313;138;0;0;313;313
8;Barcelona;21;Maresme;08110;Malgrat de Mar;2;2;B;;413;274;139;4;0;270;270
8;Barcelona;21;Maresme;08110;Malgrat de Mar;2;2;C;;550;366;184;1;1;364;365
8;Barcelona;24;Osona;08111;Malla;1;1;A;;201;162;39;0;3;159;162
8;Barcelona;24;Osona;08112;Manlleu;1;1;A;;561;398;163;2;0;396;396
8;Barcelona;24;Osona;08112;Manlleu;1;1;B;;660;435;225;1;5;429;434
8;Barcelona;24;Osona;08112;Manlleu;1;2;A;;822;629;193;0;2;627;629
8;Barcelona;24;Osona;08112;Manlleu;2;1;A;;531;371;160;4;2;365;367
8;Barcelona;24;Osona;08112;Manlleu;2;1;B;;722;534;188;2;7;525;532
8;Barcelona;24;Osona;08112;Manlleu;2;2;A;;1012;622;390;1;4;617;621
8;Barcelona;24;Osona;08112;Manlleu;2;3;A;;567;395;172;2;0;393;393
8;Barcelona;24;Osona;08112;Manlleu;2;3;B;;608;423;185;3;3;417;420
8;Barcelona;24;Osona;08112;Manlleu;2;4;A;;1094;671;423;1;2;668;670
8;Barcelona;24;Osona;08112;Manlleu;3;1;A;;711;425;286;2;1;422;423
8;Barcelona;24;Osona;08112;Manlleu;3;1;B;;789;472;317;3;2;467;469
8;Barcelona;24;Osona;08112;Manlleu;3;2;A;;1154;766;388;7;3;756;759
8;Barcelona;24;Osona;08112;Manlleu;3;3;A;;588;379;209;3;1;375;376
8;Barcelona;24;Osona;08112;Manlleu;3;3;B;;715;458;257;6;1;451;452
8;Barcelona;24;Osona;08112;Manlleu;4;1;A;;658;477;181;0;5;472;477
8;Barcelona;24;Osona;08112;Manlleu;4;2;A;;1127;773;354;13;7;753;760
8;Barcelona;7;Bages;08113;Manresa;1;1;A;;682;436;246;9;4;423;427
8;Barcelona;7;Bages;08113;Manresa;1;2;A;;433;270;163;0;1;269;270
8;Barcelona;7;Bages;08113;Manresa;1;3;A;;502;337;165;0;1;336;337
8;Barcelona;7;Bages;08113;Manresa;1;4;A;;482;317;165;2;1;314;315
8;Barcelona;7;Bages;08113;Manresa;2;1;A;;882;662;220;3;3;656;659
8;Barcelona;7;Bages;08113;Manresa;2;10;A;;624;436;188;6;0;430;430
8;Barcelona;7;Bages;08113;Manresa;2;10;B;;720;499;221;3;1;495;496
8;Barcelona;7;Bages;08113;Manresa;2;11;A;;564;360;204;0;4;356;360
8;Barcelona;7;Bages;08113;Manresa;2;11;B;;661;432;229;1;3;428;431
8;Barcelona;7;Bages;08113;Manresa;2;12;A;;752;485;267;0;2;483;485
8;Barcelona;7;Bages;08113;Manresa;2;13;A;;482;335;147;1;2;332;334
8;Barcelona;7;Bages;08113;Manresa;2;13;B;;600;417;183;2;0;415;415
8;Barcelona;7;Bages;08113;Manresa;2;14;A;;500;223;277;4;0;219;219
8;Barcelona;7;Bages;08113;Manresa;2;2;A;;531;386;145;0;0;386;386
8;Barcelona;7;Bages;08113;Manresa;2;2;B;;814;570;244;2;0;568;568
8;Barcelona;7;Bages;08113;Manresa;2;3;A;;612;436;176;2;2;432;434
8;Barcelona;7;Bages;08113;Manresa;2;3;B;;783;551;232;0;4;547;551
8;Barcelona;7;Bages;08113;Manresa;2;4;A;;648;449;199;5;4;440;444
8;Barcelona;7;Bages;08113;Manresa;2;4;B;;823;565;258;7;1;557;558
8;Barcelona;7;Bages;08113;Manresa;2;5;A;;681;479;202;0;3;476;479
8;Barcelona;7;Bages;08113;Manresa;2;5;B;;795;571;224;7;3;561;564
8;Barcelona;7;Bages;08113;Manresa;2;6;A;;746;430;316;4;1;425;426
8;Barcelona;7;Bages;08113;Manresa;2;7;A;;1021;600;421;6;3;591;594
8;Barcelona;7;Bages;08113;Manresa;2;8;A;;664;407;257;2;2;403;405
8;Barcelona;7;Bages;08113;Manresa;2;9;A;;549;324;225;0;0;324;324
8;Barcelona;7;Bages;08113;Manresa;2;9;B;;717;466;251;2;3;461;464
8;Barcelona;7;Bages;08113;Manresa;3;1;A;;564;351;213;3;1;347;348
8;Barcelona;7;Bages;08113;Manresa;3;2;A;;744;489;255;1;1;487;488
8;Barcelona;7;Bages;08113;Manresa;3;3;A;;612;405;207;10;2;393;395
8;Barcelona;7;Bages;08113;Manresa;3;4;A;;473;350;123;0;0;350;350
8;Barcelona;7;Bages;08113;Manresa;3;4;B;;632;450;182;4;2;444;446
8;Barcelona;7;Bages;08113;Manresa;3;5;A;;358;234;124;0;2;232;234
8;Barcelona;7;Bages;08113;Manresa;3;6;A;;474;312;162;4;3;305;308
8;Barcelona;7;Bages;08113;Manresa;3;6;B;;685;491;194;1;2;488;490
8;Barcelona;7;Bages;08113;Manresa;3;7;A;;667;399;268;3;1;395;396
8;Barcelona;7;Bages;08113;Manresa;4;1;A;;601;408;193;7;4;397;401
8;Barcelona;7;Bages;08113;Manresa;4;10;A;;1002;640;362;2;2;636;638
8;Barcelona;7;Bages;08113;Manresa;4;11;A;;867;557;310;0;2;555;557
8;Barcelona;7;Bages;08113;Manresa;4;12;A;;569;380;189;0;1;379;380
8;Barcelona;7;Bages;08113;Manresa;4;2;A;;546;366;180;1;3;362;365
8;Barcelona;7;Bages;08113;Manresa;4;2;B;;561;414;147;0;1;413;414
8;Barcelona;7;Bages;08113;Manresa;4;3;A;;948;655;293;2;2;651;653
8;Barcelona;7;Bages;08113;Manresa;4;4;A;;633;450;183;3;3;444;447
8;Barcelona;7;Bages;08113;Manresa;4;4;B;;872;639;233;0;5;634;639
8;Barcelona;7;Bages;08113;Manresa;4;5;A;;431;316;115;3;1;312;313
8;Barcelona;7;Bages;08113;Manresa;4;6;A;;531;391;140;2;3;386;389
8;Barcelona;7;Bages;08113;Manresa;4;6;B;;719;529;190;3;1;525;526
8;Barcelona;7;Bages;08113;Manresa;4;7;A;;522;342;180;0;2;340;342
8;Barcelona;7;Bages;08113;Manresa;4;7;B;;682;432;250;0;4;428;432
8;Barcelona;7;Bages;08113;Manresa;4;8;A;;1051;703;348;7;3;693;696
8;Barcelona;7;Bages;08113;Manresa;4;9;A;;733;466;267;2;1;463;464
8;Barcelona;7;Bages;08113;Manresa;4;9;B;;983;616;367;5;4;607;611
8;Barcelona;7;Bages;08113;Manresa;5;1;A;;936;566;370;1;2;563;565
8;Barcelona;7;Bages;08113;Manresa;5;10;A;;557;308;249;5;1;302;303
8;Barcelona;7;Bages;08113;Manresa;5;10;B;;641;339;302;0;2;337;339
8;Barcelona;7;Bages;08113;Manresa;5;11;A;;1053;662;391;15;4;643;647
8;Barcelona;7;Bages;08113;Manresa;5;12;A;;788;503;285;7;1;495;496
8;Barcelona;7;Bages;08113;Manresa;5;13;A;;524;326;198;0;1;325;326
8;Barcelona;7;Bages;08113;Manresa;5;13;B;;597;361;236;0;4;357;361
8;Barcelona;7;Bages;08113;Manresa;5;14;A;;1017;726;291;8;2;716;718
8;Barcelona;7;Bages;08113;Manresa;5;15;A;;576;321;255;0;2;319;321
8;Barcelona;7;Bages;08113;Manresa;5;15;B;;703;381;322;0;2;379;381
8;Barcelona;7;Bages;08113;Manresa;5;16;A;;599;329;270;2;5;322;327
8;Barcelona;7;Bages;08113;Manresa;5;2;A;;397;256;141;3;3;250;253
8;Barcelona;7;Bages;08113;Manresa;5;3;A;;851;514;337;4;4;506;510
8;Barcelona;7;Bages;08113;Manresa;5;4;A;;649;472;177;0;0;472;472
8;Barcelona;7;Bages;08113;Manresa;5;5;A;;550;366;184;3;2;361;363
8;Barcelona;7;Bages;08113;Manresa;5;5;B;;587;383;204;4;6;373;379
8;Barcelona;7;Bages;08113;Manresa;5;6;A;;588;369;219;0;2;367;369
8;Barcelona;7;Bages;08113;Manresa;5;6;B;;783;508;275;0;2;506;508
8;Barcelona;7;Bages;08113;Manresa;5;7;A;;476;324;152;0;9;315;324
8;Barcelona;7;Bages;08113;Manresa;5;8;A;;644;450;194;0;1;449;450
8;Barcelona;7;Bages;08113;Manresa;5;9;A;;931;612;319;1;2;609;611
8;Barcelona;7;Bages;08113;Manresa;6;1;A;;581;365;216;3;1;361;362
8;Barcelona;7;Bages;08113;Manresa;6;1;B;;761;469;292;4;1;464;465
8;Barcelona;7;Bages;08113;Manresa;6;2;A;;511;326;185;8;3;315;318
8;Barcelona;7;Bages;08113;Manresa;6;3;A;;462;290;172;0;2;288;290
43;Tarragona;29;Priorat;43076;Marçà;1;1;A;;488;387;101;1;2;384;386
43;Tarragona;29;Priorat;43075;Margalef;1;1;A;;141;93;48;0;0;93;93
8;Barcelona;7;Bages;08242;Marganell;1;1;A;;185;137;48;0;0;137;137
8;Barcelona;11;Baix Llobregat;08114;Martorell;1;1;A;;462;321;141;1;1;319;320
8;Barcelona;11;Baix Llobregat;08114;Martorell;1;1;B;;446;309;137;0;0;309;309
8;Barcelona;11;Baix Llobregat;08114;Martorell;2;1;A;;717;473;244;0;0;473;473
8;Barcelona;11;Baix Llobregat;08114;Martorell;2;2;A;;527;351;176;2;2;347;349
8;Barcelona;11;Baix Llobregat;08114;Martorell;2;2;B;;504;357;147;4;1;352;353
8;Barcelona;11;Baix Llobregat;08114;Martorell;3;1;A;;773;467;306;0;0;467;467
8;Barcelona;11;Baix Llobregat;08114;Martorell;3;1;B;;881;533;348;0;3;530;533
8;Barcelona;11;Baix Llobregat;08114;Martorell;3;2;A;;474;272;202;0;2;270;272
8;Barcelona;11;Baix Llobregat;08114;Martorell;3;2;B;;490;295;195;1;0;294;294
8;Barcelona;11;Baix Llobregat;08114;Martorell;3;3;A;;445;237;208;1;0;236;236
8;Barcelona;11;Baix Llobregat;08114;Martorell;3;3;B;;554;335;219;11;3;321;324
8;Barcelona;11;Baix Llobregat;08114;Martorell;3;4;A;;803;387;416;1;3;383;386
8;Barcelona;11;Baix Llobregat;08114;Martorell;3;4;B;;953;497;456;4;5;488;493
8;Barcelona;11;Baix Llobregat;08114;Martorell;3;5;A;;649;392;257;5;5;382;387
8;Barcelona;11;Baix Llobregat;08114;Martorell;3;5;B;;648;392;256;6;2;384;386
8;Barcelona;11;Baix Llobregat;08114;Martorell;3;6;A;;798;527;271;0;6;521;527
8;Barcelona;11;Baix Llobregat;08114;Martorell;3;6;B;;841;543;298;1;5;537;542
8;Barcelona;11;Baix Llobregat;08114;Martorell;3;7;A;;571;339;232;0;1;338;339
8;Barcelona;11;Baix Llobregat;08114;Martorell;3;7;B;;648;385;263;2;2;381;383
8;Barcelona;41;Vallès Oriental;08115;Martorelles;1;1;A;;641;364;277;1;2;361;363
8;Barcelona;41;Vallès Oriental;08115;Martorelles;1;1;B;;876;493;383;0;2;491;493
8;Barcelona;41;Vallès Oriental;08115;Martorelles;1;2;A;;709;466;243;8;2;456;458
8;Barcelona;41;Vallès Oriental;08115;Martorelles;1;2;B;;1078;691;387;3;9;679;688
17;Girona;2;Alt Empordà;17100;Masarac;1;1;A;;224;143;81;0;3;140;143
43;Tarragona;22;Montsià;43077;Mas de Barberans;1;1;A;;623;429;194;0;2;427;429
43;Tarragona;22;Montsià;43078;Masdenverge;1;1;A;;732;367;365;2;4;361;365
8;Barcelona;24;Osona;08116;Masies de Roda, les;1;1;A;;466;335;131;0;2;333;335
8;Barcelona;24;Osona;08117;Masies de Voltregà, les;1;1;A;;1211;867;344;7;6;854;860
8;Barcelona;24;Osona;08117;Masies de Voltregà, les;2;1;A;;668;409;259;4;2;403;405
43;Tarragona;12;Baix Penedès;43079;Masllorenç;1;1;A;;328;252;76;1;7;244;251
8;Barcelona;21;Maresme;08118;Masnou, el;1;1;A;;744;422;322;2;1;419;420
8;Barcelona;21;Maresme;08118;Masnou, el;1;2;A;;753;454;299;0;2;452;454
8;Barcelona;21;Maresme;08118;Masnou, el;1;2;B;;889;522;367;0;3;519;522
8;Barcelona;21;Maresme;08118;Masnou, el;1;3;A;;611;361;250;0;2;359;361
8;Barcelona;21;Maresme;08118;Masnou, el;1;3;B;;683;399;284;2;4;393;397
8;Barcelona;21;Maresme;08118;Masnou, el;1;4;A;;760;474;286;1;4;469;473
8;Barcelona;21;Maresme;08118;Masnou, el;1;5;A;;644;379;265;1;1;377;378
8;Barcelona;21;Maresme;08118;Masnou, el;1;5;B;;727;444;283;0;0;444;444
8;Barcelona;21;Maresme;08118;Masnou, el;1;6;A;;907;526;381;3;3;520;523
8;Barcelona;21;Maresme;08118;Masnou, el;1;6;B;;965;549;416;0;1;548;549
8;Barcelona;21;Maresme;08118;Masnou, el;1;7;A;;859;466;393;0;1;465;466
8;Barcelona;21;Maresme;08118;Masnou, el;2;1;A;;833;473;360;7;0;466;466
8;Barcelona;21;Maresme;08118;Masnou, el;2;1;B;;917;548;369;2;4;542;546
8;Barcelona;21;Maresme;08118;Masnou, el;2;2;A;;754;461;293;0;6;455;461
8;Barcelona;21;Maresme;08118;Masnou, el;2;2;B;;814;505;309;1;7;497;504
43;Tarragona;1;Alt Camp;43080;Masó, la;1;1;A;;223;145;78;6;2;137;139
43;Tarragona;8;Baix Camp;43081;Maspujols;1;1;A;;315;228;87;0;3;225;228
8;Barcelona;6;Anoia;08119;Masquefa;1;1;A;;613;397;216;1;1;395;396
8;Barcelona;6;Anoia;08119;Masquefa;1;1;B;;609;383;226;3;1;379;380
8;Barcelona;6;Anoia;08119;Masquefa;1;1;C;;628;409;219;2;2;405;407
43;Tarragona;29;Priorat;43082;Masroig, el;1;1;A;;483;409;74;2;1;406;407
25;Lleida;33;Segrià;25131;Massalcoreig;1;1;A;;572;377;195;0;3;374;377
17;Girona;34;Selva;17101;Massanes;1;1;A;;371;234;137;0;0;234;234
25;Lleida;32;Segarra;25132;Massoteres;1;1;A;;144;98;46;0;2;96;98
8;Barcelona;40;Vallès Occidental;08120;Matadepera;1;1;A;;963;789;174;2;7;780;787
8;Barcelona;40;Vallès Occidental;08120;Matadepera;1;1;B;;716;517;199;2;3;512;515
8;Barcelona;40;Vallès Occidental;08120;Matadepera;1;1;C;;962;748;214;4;4;740;744
8;Barcelona;21;Maresme;08121;Mataró;1;1;A;;729;540;189;2;0;538;538
8;Barcelona;21;Maresme;08121;Mataró;1;2;A;;974;696;278;1;2;693;695
8;Barcelona;21;Maresme;08121;Mataró;1;3;A;;535;383;152;1;4;378;382
8;Barcelona;21;Maresme;08121;Mataró;1;3;B;;560;393;167;0;2;391;393
8;Barcelona;21;Maresme;08121;Mataró;1;4;A;;487;375;112;2;0;373;373
8;Barcelona;21;Maresme;08121;Mataró;1;4;B;;509;402;107;0;3;399;402
8;Barcelona;21;Maresme;08121;Mataró;1;5;A;;517;385;132;0;3;382;385
8;Barcelona;21;Maresme;08121;Mataró;1;5;B;;656;479;177;6;3;470;473
8;Barcelona;21;Maresme;08121;Mataró;1;6;A;;718;522;196;1;6;515;521
8;Barcelona;21;Maresme;08121;Mataró;1;6;B;;789;569;220;0;0;569;569
8;Barcelona;21;Maresme;08121;Mataró;1;7;A;;1083;779;304;1;2;776;778
8;Barcelona;21;Maresme;08121;Mataró;1;8;A;;606;434;172;2;1;431;432
8;Barcelona;21;Maresme;08121;Mataró;2;1;A;;1008;736;272;1;2;733;735
8;Barcelona;21;Maresme;08121;Mataró;2;10;A;;927;623;304;1;7;615;622
8;Barcelona;21;Maresme;08121;Mataró;2;11;A;;538;384;154;2;1;381;382
8;Barcelona;21;Maresme;08121;Mataró;2;11;B;;549;336;213;3;0;333;333
8;Barcelona;21;Maresme;08121;Mataró;2;2;A;;801;517;284;9;6;502;508
8;Barcelona;21;Maresme;08121;Mataró;2;3;A;;600;300;300;2;1;297;298
8;Barcelona;21;Maresme;08121;Mataró;2;4;A;;891;481;410;2;0;479;479
8;Barcelona;21;Maresme;08121;Mataró;2;5;A;;594;388;206;1;0;387;387
8;Barcelona;21;Maresme;08121;Mataró;2;5;B;;703;442;261;1;1;440;441
8;Barcelona;21;Maresme;08121;Mataró;2;6;A;;1056;647;409;1;8;638;646
8;Barcelona;21;Maresme;08121;Mataró;2;7;A;;498;328;170;0;0;328;328
8;Barcelona;21;Maresme;08121;Mataró;2;8;A;;924;640;284;0;3;637;640
8;Barcelona;21;Maresme;08121;Mataró;2;8;B;;1038;725;313;5;4;716;720
8;Barcelona;21;Maresme;08121;Mataró;2;9;A;;875;633;242;2;5;626;631
8;Barcelona;21;Maresme;08121;Mataró;3;1;A;;589;346;243;2;2;342;344
8;Barcelona;21;Maresme;08121;Mataró;3;1;B;;721;456;265;0;2;454;456
8;Barcelona;21;Maresme;08121;Mataró;3;10;A;;603;437;166;1;0;436;436
8;Barcelona;21;Maresme;08121;Mataró;3;11;A;;565;366;199;0;1;365;366
8;Barcelona;21;Maresme;08121;Mataró;3;11;B;;672;408;264;2;1;405;406
8;Barcelona;21;Maresme;08121;Mataró;3;2;A;;671;395;276;3;0;392;392
8;Barcelona;21;Maresme;08121;Mataró;3;2;B;;711;407;304;0;2;405;407
8;Barcelona;21;Maresme;08121;Mataró;3;3;A;;545;307;238;0;4;303;307
8;Barcelona;21;Maresme;08121;Mataró;3;3;B;;414;414;0;2;1;411;412
8;Barcelona;21;Maresme;08121;Mataró;3;4;A;;742;376;366;1;2;373;375
8;Barcelona;21;Maresme;08121;Mataró;3;4;B;;971;462;509;1;1;460;461
8;Barcelona;21;Maresme;08121;Mataró;3;5;A;;572;303;269;1;2;300;302
8;Barcelona;21;Maresme;08121;Mataró;3;5;B;;701;371;330;6;1;364;365
8;Barcelona;21;Maresme;08121;Mataró;3;6;A;;969;620;349;0;2;618;620
8;Barcelona;21;Maresme;08121;Mataró;3;7;A;;489;286;203;0;0;286;286
8;Barcelona;21;Maresme;08121;Mataró;3;7;B;;607;348;259;0;2;346;348
8;Barcelona;21;Maresme;08121;Mataró;3;8;A;;1066;588;478;3;5;580;585
8;Barcelona;21;Maresme;08121;Mataró;3;9;A;;570;313;257;0;2;311;313
8;Barcelona;21;Maresme;08121;Mataró;3;9;B;;667;367;300;1;1;365;366
8;Barcelona;21;Maresme;08121;Mataró;4;1;A;;999;643;356;1;2;640;642
8;Barcelona;21;Maresme;08121;Mataró;4;2;A;;580;302;278;0;2;300;302
8;Barcelona;21;Maresme;08121;Mataró;4;2;B;;680;412;268;2;2;408;410
8;Barcelona;21;Maresme;08121;Mataró;4;3;A;;855;480;375;1;2;477;479
8;Barcelona;21;Maresme;08121;Mataró;4;4;A;;812;449;363;1;1;447;448
8;Barcelona;21;Maresme;08121;Mataró;4;5;A;;745;345;400;0;1;344;345
8;Barcelona;21;Maresme;08121;Mataró;4;5;B;;963;514;449;0;6;508;514
8;Barcelona;21;Maresme;08121;Mataró;4;6;A;;1121;679;442;6;1;672;673
8;Barcelona;21;Maresme;08121;Mataró;5;1;A;;872;491;381;2;1;488;489
8;Barcelona;21;Maresme;08121;Mataró;5;10;A;;499;301;198;1;1;299;300
8;Barcelona;21;Maresme;08121;Mataró;5;11;A;;1163;677;486;0;2;675;677
8;Barcelona;21;Maresme;08121;Mataró;5;12;A;;1027;593;434;2;3;588;591
8;Barcelona;21;Maresme;08121;Mataró;5;13;A;;781;457;324;1;2;454;456
8;Barcelona;21;Maresme;08121;Mataró;5;13;B;;976;543;433;1;1;541;542
8;Barcelona;21;Maresme;08121;Mataró;5;14;A;;730;426;304;0;3;423;426
8;Barcelona;21;Maresme;08121;Mataró;5;15;A;;557;289;268;0;0;289;289
8;Barcelona;21;Maresme;08121;Mataró;5;15;B;;719;341;378;0;1;340;341
8;Barcelona;21;Maresme;08121;Mataró;5;15;C;;607;302;305;0;8;294;302
8;Barcelona;21;Maresme;08121;Mataró;5;16;A;;1009;595;414;3;3;589;592
8;Barcelona;21;Maresme;08121;Mataró;5;17;A;;744;428;316;0;1;427;428
8;Barcelona;21;Maresme;08121;Mataró;5;18;A;;544;292;252;1;0;291;291
8;Barcelona;21;Maresme;08121;Mataró;5;19;A;;665;411;254;0;2;409;411
8;Barcelona;21;Maresme;08121;Mataró;5;2;A;;584;318;266;1;4;313;317
8;Barcelona;21;Maresme;08121;Mataró;5;2;B;;604;330;274;1;3;326;329
8;Barcelona;21;Maresme;08121;Mataró;5;3;A;;593;323;270;0;2;321;323
8;Barcelona;21;Maresme;08121;Mataró;5;3;B;;701;409;292;0;1;408;409
8;Barcelona;21;Maresme;08121;Mataró;5;4;A;;700;410;290;0;1;409;410
8;Barcelona;21;Maresme;08121;Mataró;5;5;A;;588;321;267;0;1;320;321
8;Barcelona;21;Maresme;08121;Mataró;5;6;A;;597;293;304;1;1;291;292
8;Barcelona;21;Maresme;08121;Mataró;5;6;B;;619;299;320;2;0;297;297
8;Barcelona;21;Maresme;08121;Mataró;5;7;A;;1073;646;427;0;0;646;646
8;Barcelona;21;Maresme;08121;Mataró;5;8;A;;843;480;363;0;4;476;480
8;Barcelona;21;Maresme;08121;Mataró;5;9;A;;973;575;398;1;0;574;574
8;Barcelona;21;Maresme;08121;Mataró;6;1;A;;653;391;262;2;1;388;389
8;Barcelona;21;Maresme;08121;Mataró;6;1;B;;708;421;287;0;0;421;421
8;Barcelona;21;Maresme;08121;Mataró;6;10;A;;766;445;321;1;1;443;444
8;Barcelona;21;Maresme;08121;Mataró;6;10;B;;812;478;334;1;1;476;477
8;Barcelona;21;Maresme;08121;Mataró;6;11;A;;660;407;253;1;3;403;406
8;Barcelona;21;Maresme;08121;Mataró;6;11;B;;786;490;296;3;1;486;487
8;Barcelona;21;Maresme;08121;Mataró;6;12;A;;720;376;344;0;3;373;376
8;Barcelona;21;Maresme;08121;Mataró;6;12;B;;830;437;393;1;4;432;436
8;Barcelona;21;Maresme;08121;Mataró;6;2;A;;602;413;189;0;0;413;413
8;Barcelona;21;Maresme;08121;Mataró;6;3;A;;915;660;255;3;2;655;657
8;Barcelona;21;Maresme;08121;Mataró;6;4;A;;475;321;154;0;1;320;321
8;Barcelona;21;Maresme;08121;Mataró;6;4;B;;547;367;180;0;1;366;367
8;Barcelona;21;Maresme;08121;Mataró;6;5;A;;755;447;308;1;1;445;446
8;Barcelona;21;Maresme;08121;Mataró;6;5;B;;834;489;345;2;2;485;487
8;Barcelona;21;Maresme;08121;Mataró;6;6;A;;589;426;163;1;0;425;425
8;Barcelona;21;Maresme;08121;Mataró;6;6;B;;635;454;181;0;0;454;454
8;Barcelona;21;Maresme;08121;Mataró;6;7;A;;523;302;221;1;2;299;301
8;Barcelona;21;Maresme;08121;Mataró;6;7;B;;563;369;194;0;6;363;369
8;Barcelona;21;Maresme;08121;Mataró;6;8;A;;725;512;213;0;1;511;512
8;Barcelona;21;Maresme;08121;Mataró;6;8;B;;668;399;269;0;4;395;399
8;Barcelona;21;Maresme;08121;Mataró;6;8;C;;757;472;285;0;0;472;472
8;Barcelona;21;Maresme;08121;Mataró;6;9;A;;1045;475;570;0;5;470;475
8;Barcelona;3;Alt Penedès;08122;Mediona;1;1;A;;797;566;231;3;3;560;563
25;Lleida;23;Noguera;25134;Menàrguens;1;1;A;;769;424;345;0;3;421;424
17;Girona;15;Cerdanya;17099;Meranges;1;1;A;;53;41;12;0;0;41;41
17;Girona;19;Garrotxa;17105;Mieres;1;1;A;;304;181;123;0;1;180;181
43;Tarragona;1;Alt Camp;43083;Milà, el;1;1;A;;122;101;21;1;1;99;100
25;Lleida;27;Pla d'Urgell;25135;Miralcamp;1;1;A;;914;595;319;7;4;584;588
43;Tarragona;30;Ribera d'Ebre;43084;Miravet;1;1;A;;684;370;314;3;2;365;367
8;Barcelona;;;08138;Moià;1;1;A;;1019;768;251;4;5;759;764
8;Barcelona;;;08138;Moià;1;2;A;;1470;1060;410;7;6;1047;1053
43;Tarragona;29;Priorat;43085;Molar, el;1;1;A;;299;202;97;1;1;200;201
8;Barcelona;11;Baix Llobregat;08123;Molins de Rei;1;1;A;;531;372;159;0;3;369;372
8;Barcelona;11;Baix Llobregat;08123;Molins de Rei;1;1;B;;673;436;237;2;2;432;434
8;Barcelona;11;Baix Llobregat;08123;Molins de Rei;1;2;A;;1064;664;400;2;4;658;662
8;Barcelona;11;Baix Llobregat;08123;Molins de Rei;1;3;A;;747;489;258;2;7;480;487
8;Barcelona;11;Baix Llobregat;08123;Molins de Rei;1;3;B;;752;483;269;4;2;477;479
8;Barcelona;11;Baix Llobregat;08123;Molins de Rei;2;1;A;;861;530;331;3;2;525;527
8;Barcelona;11;Baix Llobregat;08123;Molins de Rei;2;2;A;;976;650;326;2;1;647;648
8;Barcelona;11;Baix Llobregat;08123;Molins de Rei;2;3;A;;847;538;309;0;9;529;538
8;Barcelona;11;Baix Llobregat;08123;Molins de Rei;2;3;B;;1016;669;347;1;8;660;668
8;Barcelona;11;Baix Llobregat;08123;Molins de Rei;2;4;A;;865;518;347;0;4;514;518
8;Barcelona;11;Baix Llobregat;08123;Molins de Rei;3;1;A;;506;346;160;0;2;344;346
8;Barcelona;11;Baix Llobregat;08123;Molins de Rei;3;1;B;;631;432;199;2;4;426;430
8;Barcelona;11;Baix Llobregat;08123;Molins de Rei;3;2;A;;829;590;239;1;2;587;589
8;Barcelona;11;Baix Llobregat;08123;Molins de Rei;3;2;B;;935;646;289;1;3;642;645
8;Barcelona;11;Baix Llobregat;08123;Molins de Rei;3;3;A;;836;487;349;4;2;481;483
8;Barcelona;11;Baix Llobregat;08123;Molins de Rei;3;3;B;;998;589;409;5;0;584;584
8;Barcelona;11;Baix Llobregat;08123;Molins de Rei;4;1;A;;706;449;257;0;0;449;449
25;Lleida;27;Pla d'Urgell;25137;Mollerussa;1;1;A;;741;485;256;2;2;481;483
25;Lleida;27;Pla d'Urgell;25137;Mollerussa;1;1;B;;795;548;247;3;3;542;545
25;Lleida;27;Pla d'Urgell;25137;Mollerussa;1;2;A;;686;460;226;1;5;454;459
25;Lleida;27;Pla d'Urgell;25137;Mollerussa;1;2;B;;759;512;247;2;8;502;510
25;Lleida;27;Pla d'Urgell;25137;Mollerussa;1;3;A;;761;487;274;1;3;483;486
25;Lleida;27;Pla d'Urgell;25137;Mollerussa;1;3;B;;898;575;323;4;0;571;571
25;Lleida;27;Pla d'Urgell;25137;Mollerussa;1;4;A;;748;466;282;2;2;462;464
25;Lleida;27;Pla d'Urgell;25137;Mollerussa;1;4;B;;946;581;365;4;4;573;577
8;Barcelona;41;Vallès Oriental;08124;Mollet del Vallès;1;1;A;;701;369;332;2;1;366;367
8;Barcelona;41;Vallès Oriental;08124;Mollet del Vallès;1;2;A;;631;353;278;0;3;350;353
8;Barcelona;41;Vallès Oriental;08124;Mollet del Vallès;1;2;B;;809;421;388;2;1;418;419
8;Barcelona;41;Vallès Oriental;08124;Mollet del Vallès;1;3;A;;548;309;239;0;4;305;309
8;Barcelona;41;Vallès Oriental;08124;Mollet del Vallès;1;3;B;;525;246;279;2;2;242;244
8;Barcelona;41;Vallès Oriental;08124;Mollet del Vallès;1;3;C;;593;307;286;0;0;307;307
8;Barcelona;41;Vallès Oriental;08124;Mollet del Vallès;1;4;A;;530;325;205;0;5;320;325
8;Barcelona;41;Vallès Oriental;08124;Mollet del Vallès;1;4;B;;665;394;271;0;3;391;394
8;Barcelona;41;Vallès Oriental;08124;Mollet del Vallès;1;5;A;;574;269;305;0;2;267;269
8;Barcelona;41;Vallès Oriental;08124;Mollet del Vallès;1;5;B;;667;306;361;1;0;305;305
8;Barcelona;41;Vallès Oriental;08124;Mollet del Vallès;1;6;A;;596;361;235;0;3;358;361
8;Barcelona;41;Vallès Oriental;08124;Mollet del Vallès;1;6;B;;554;297;257;0;1;296;297
8;Barcelona;41;Vallès Oriental;08124;Mollet del Vallès;1;6;C;;658;356;302;0;2;354;356
8;Barcelona;41;Vallès Oriental;08124;Mollet del Vallès;1;7;A;;421;207;214;0;1;206;207
8;Barcelona;41;Vallès Oriental;08124;Mollet del Vallès;1;7;B;;512;238;274;0;2;236;238
8;Barcelona;41;Vallès Oriental;08124;Mollet del Vallès;2;1;A;;557;282;275;0;1;281;282
8;Barcelona;41;Vallès Oriental;08124;Mollet del Vallès;2;1;B;;528;259;269;0;0;259;259
8;Barcelona;41;Vallès Oriental;08124;Mollet del Vallès;2;1;C;;641;346;295;1;0;345;345
8;Barcelona;41;Vallès Oriental;08124;Mollet del Vallès;2;2;A;;740;426;314;4;2;420;422
8;Barcelona;41;Vallès Oriental;08124;Mollet del Vallès;2;3;A;;420;221;199;1;0;220;220
8;Barcelona;41;Vallès Oriental;08124;Mollet del Vallès;2;3;B;;519;248;271;5;2;241;243
8;Barcelona;41;Vallès Oriental;08124;Mollet del Vallès;2;3;C;;505;248;257;0;2;246;248
8;Barcelona;41;Vallès Oriental;08124;Mollet del Vallès;2;4;A;;398;196;202;0;0;196;196
8;Barcelona;41;Vallès Oriental;08124;Mollet del Vallès;2;4;B;;534;264;270;3;0;261;261
8;Barcelona;41;Vallès Oriental;08124;Mollet del Vallès;2;4;C;;479;238;241;0;2;236;238
8;Barcelona;41;Vallès Oriental;08124;Mollet del Vallès;2;5;A;;822;292;530;0;1;291;292
8;Barcelona;41;Vallès Oriental;08124;Mollet del Vallès;3;1;A;;571;312;259;2;0;310;310
8;Barcelona;41;Vallès Oriental;08124;Mollet del Vallès;3;1;B;;606;307;299;2;1;304;305
8;Barcelona;41;Vallès Oriental;08124;Mollet del Vallès;3;1;C;;662;370;292;0;1;369;370
8;Barcelona;41;Vallès Oriental;08124;Mollet del Vallès;3;2;A;;639;334;305;3;1;330;331
8;Barcelona;41;Vallès Oriental;08124;Mollet del Vallès;3;2;B;;722;367;355;0;2;365;367
8;Barcelona;41;Vallès Oriental;08124;Mollet del Vallès;3;3;A;;629;339;290;0;3;336;339
8;Barcelona;41;Vallès Oriental;08124;Mollet del Vallès;3;3;B;;656;338;318;0;4;334;338
8;Barcelona;41;Vallès Oriental;08124;Mollet del Vallès;3;3;C;;715;404;311;3;7;394;401
8;Barcelona;41;Vallès Oriental;08124;Mollet del Vallès;3;4;A;;658;353;305;0;1;352;353
8;Barcelona;41;Vallès Oriental;08124;Mollet del Vallès;3;4;B;;814;455;359;0;2;453;455
8;Barcelona;41;Vallès Oriental;08124;Mollet del Vallès;3;5;A;;467;255;212;3;2;250;252
8;Barcelona;41;Vallès Oriental;08124;Mollet del Vallès;3;5;B;;504;271;233;1;2;268;270
8;Barcelona;41;Vallès Oriental;08124;Mollet del Vallès;3;6;A;;467;261;206;2;2;257;259
8;Barcelona;41;Vallès Oriental;08124;Mollet del Vallès;3;6;B;;485;261;224;0;2;259;261
8;Barcelona;41;Vallès Oriental;08124;Mollet del Vallès;3;6;C;;522;275;247;4;2;269;271
8;Barcelona;41;Vallès Oriental;08124;Mollet del Vallès;3;7;A;;543;251;292;0;2;249;251
8;Barcelona;41;Vallès Oriental;08124;Mollet del Vallès;3;7;B;;586;262;324;0;0;262;262
8;Barcelona;41;Vallès Oriental;08124;Mollet del Vallès;3;7;C;;705;332;373;0;2;330;332
8;Barcelona;41;Vallès Oriental;08124;Mollet del Vallès;3;8;A;;634;345;289;0;2;343;345
17;Girona;2;Alt Empordà;17106;Mollet de Peralada;1;1;A;;161;115;46;0;0;115;115
17;Girona;31;Ripollès;17107;Molló;1;1;A;;311;226;85;0;1;225;226
25;Lleida;35;Solsonès;25136;Molsosa, la;1;1;A;;108;96;12;2;1;93;94
8;Barcelona;;;08128;Monistrol de Calders;1;1;A;;495;376;119;1;2;373;375
8;Barcelona;7;Bages;08127;Monistrol de Montserrat;1;1;A;;790;488;302;3;0;485;485
8;Barcelona;7;Bages;08127;Monistrol de Montserrat;1;2;A;;672;522;150;9;3;510;513
8;Barcelona;7;Bages;08127;Monistrol de Montserrat;2;1;A;;595;411;184;2;2;407;409
17;Girona;19;Garrotxa;17109;Montagut i Oix;1;1;A;;682;356;326;4;5;347;352
43;Tarragona;16;Conca de Barberà;43086;Montblanc;1;1;A;;743;483;260;3;3;477;480
43;Tarragona;16;Conca de Barberà;43086;Montblanc;1;2;A;;665;444;221;3;9;432;441
43;Tarragona;16;Conca de Barberà;43086;Montblanc;2;1;A;;729;511;218;5;6;500;506
43;Tarragona;16;Conca de Barberà;43086;Montblanc;2;1;B;;889;584;305;4;6;574;580
43;Tarragona;16;Conca de Barberà;43086;Montblanc;2;2;A;;580;380;200;5;3;372;375
43;Tarragona;16;Conca de Barberà;43086;Montblanc;2;2;B;;708;461;247;3;8;450;458
43;Tarragona;8;Baix Camp;43088;Montbrió del Camp;1;1;A;;612;481;131;2;4;475;479
43;Tarragona;8;Baix Camp;43088;Montbrió del Camp;1;1;B;;551;440;111;4;7;429;436
8;Barcelona;40;Vallès Occidental;08125;Montcada i Reixac;1;1;A;;891;517;374;1;3;513;516
8;Barcelona;40;Vallès Occidental;08125;Montcada i Reixac;1;1;B;;1142;653;489;7;4;642;646
8;Barcelona;40;Vallès Occidental;08125;Montcada i Reixac;1;2;A;;688;479;209;1;2;476;478
8;Barcelona;40;Vallès Occidental;08125;Montcada i Reixac;1;3;A;;548;362;186;6;0;356;356
8;Barcelona;40;Vallès Occidental;08125;Montcada i Reixac;1;4;A;;1251;689;562;1;6;682;688
8;Barcelona;40;Vallès Occidental;08125;Montcada i Reixac;2;1;A;;775;388;387;7;5;376;381
8;Barcelona;40;Vallès Occidental;08125;Montcada i Reixac;2;1;B;;858;429;429;5;3;421;424
8;Barcelona;40;Vallès Occidental;08125;Montcada i Reixac;2;2;A;;1242;680;562;3;4;673;677
8;Barcelona;40;Vallès Occidental;08125;Montcada i Reixac;2;3;A;;708;449;259;2;3;444;447
8;Barcelona;40;Vallès Occidental;08125;Montcada i Reixac;2;3;B;;842;516;326;2;5;509;514
8;Barcelona;40;Vallès Occidental;08125;Montcada i Reixac;2;4;A;;191;120;71;0;1;119;120
8;Barcelona;40;Vallès Occidental;08125;Montcada i Reixac;3;1;A;;1463;885;578;1;4;880;884
8;Barcelona;40;Vallès Occidental;08125;Montcada i Reixac;3;2;A;;1015;559;456;0;1;558;559
8;Barcelona;40;Vallès Occidental;08125;Montcada i Reixac;3;3;A;;711;376;335;1;2;373;375
8;Barcelona;40;Vallès Occidental;08125;Montcada i Reixac;3;3;B;;921;525;396;0;5;520;525
8;Barcelona;40;Vallès Occidental;08125;Montcada i Reixac;4;1;A;;1384;682;702;7;10;665;675
8;Barcelona;40;Vallès Occidental;08125;Montcada i Reixac;5;1;A;;847;396;451;6;4;386;390
8;Barcelona;40;Vallès Occidental;08125;Montcada i Reixac;5;1;B;;950;486;464;0;3;483;486
8;Barcelona;40;Vallès Occidental;08125;Montcada i Reixac;5;2;A;;1109;508;601;4;1;503;504
8;Barcelona;40;Vallès Occidental;08125;Montcada i Reixac;5;3;A;;1211;537;674;8;1;528;529
8;Barcelona;40;Vallès Occidental;08125;Montcada i Reixac;6;1;A;;769;297;472;0;1;296;297
8;Barcelona;14;Berguedà;08130;Montclar;1;1;A;;134;84;50;0;0;84;84
25;Lleida;15;Cerdanya;25139;Montellà i Martinet;1;1;A;;472;323;149;3;3;317;320
8;Barcelona;24;Osona;08131;Montesquiu;1;1;A;;741;489;252;4;5;480;485
25;Lleida;4;Alt Urgell;25140;Montferrer i Castellbò;1;1;A;;522;306;216;1;1;304;305
43;Tarragona;1;Alt Camp;43089;Montferri;1;1;A;;141;99;42;0;0;99;99
25;Lleida;23;Noguera;25138;Montgai;1;1;A;;504;330;174;2;5;323;328
25;Lleida;23;Noguera;25138;Montgai;1;1;B;;234;163;71;0;0;163;163
8;Barcelona;21;Maresme;08126;Montgat;1;1;A;;888;501;387;0;4;497;501
8;Barcelona;21;Maresme;08126;Montgat;1;1;B;;1058;597;461;4;5;588;593
8;Barcelona;21;Maresme;08126;Montgat;1;2;A;;822;427;395;0;4;423;427
8;Barcelona;21;Maresme;08126;Montgat;1;2;B;;1004;565;439;2;0;563;563
8;Barcelona;21;Maresme;08126;Montgat;1;3;A;;722;458;264;1;1;456;457
8;Barcelona;21;Maresme;08126;Montgat;1;3;B;;890;565;325;2;3;560;563
8;Barcelona;14;Berguedà;08132;Montmajor;1;1;A;;434;313;121;0;1;312;313
8;Barcelona;6;Anoia;08133;Montmaneu;1;1;A;;223;134;89;0;0;134;134
43;Tarragona;12;Baix Penedès;43090;Montmell, el;1;1;A;;179;116;63;0;0;116;116
8;Barcelona;41;Vallès Oriental;08135;Montmeló;1;1;A;;870;519;351;2;4;513;517
8;Barcelona;41;Vallès Oriental;08135;Montmeló;1;2;A;;484;315;169;1;2;312;314
8;Barcelona;41;Vallès Oriental;08135;Montmeló;1;2;B;;692;448;244;6;4;438;442
8;Barcelona;41;Vallès Oriental;08135;Montmeló;1;3;A;;769;489;280;3;4;482;486
8;Barcelona;41;Vallès Oriental;08135;Montmeló;1;3;B;;895;583;312;2;3;578;581
8;Barcelona;41;Vallès Oriental;08135;Montmeló;1;4;A;;762;479;283;2;2;475;477
8;Barcelona;41;Vallès Oriental;08135;Montmeló;1;5;A;;513;345;168;2;0;343;343
25;Lleida;33;Segrià;25142;Montoliu de Lleida;1;1;A;;348;237;111;0;0;237;237
25;Lleida;32;Segarra;25141;Montoliu de Segarra;1;1;A;;174;115;59;1;0;114;114
8;Barcelona;41;Vallès Oriental;08136;Montornès del Vallès;1;1;A;;736;440;296;0;2;438;440
8;Barcelona;41;Vallès Oriental;08136;Montornès del Vallès;1;1;B;;819;517;302;1;2;514;516
8;Barcelona;41;Vallès Oriental;08136;Montornès del Vallès;1;2;A;;640;387;253;1;3;383;386
8;Barcelona;41;Vallès Oriental;08136;Montornès del Vallès;1;2;B;;731;429;302;3;7;419;426
8;Barcelona;41;Vallès Oriental;08136;Montornès del Vallès;1;2;C;;721;437;284;1;2;434;436
8;Barcelona;41;Vallès Oriental;08136;Montornès del Vallès;1;3;A;;505;291;214;0;2;289;291
8;Barcelona;41;Vallès Oriental;08136;Montornès del Vallès;1;3;B;;585;353;232;1;2;350;352
8;Barcelona;41;Vallès Oriental;08136;Montornès del Vallès;2;1;A;;444;244;200;2;1;241;242
8;Barcelona;41;Vallès Oriental;08136;Montornès del Vallès;2;1;B;;511;289;222;4;1;284;285
8;Barcelona;41;Vallès Oriental;08136;Montornès del Vallès;2;2;A;;383;230;153;1;2;227;229
8;Barcelona;41;Vallès Oriental;08136;Montornès del Vallès;2;2;B;;371;233;138;1;1;231;232
8;Barcelona;41;Vallès Oriental;08136;Montornès del Vallès;2;3;A;;411;266;145;2;1;263;264
8;Barcelona;41;Vallès Oriental;08136;Montornès del Vallès;2;3;B;;483;287;196;0;0;287;287
25;Lleida;32;Segarra;25143;Montornès de Segarra;1;1;A;;113;65;48;1;1;63;64
43;Tarragona;1;Alt Camp;43091;Mont-ral;1;1;A;;157;72;85;1;1;70;71
17;Girona;10;Baix Empordà;17110;Mont-ras;1;1;A;;832;568;264;0;0;568;568
43;Tarragona;8;Baix Camp;43092;Mont-roig del Camp;1;1;A;;912;605;307;4;3;598;601
43;Tarragona;8;Baix Camp;43092;Mont-roig del Camp;1;1;B;;972;681;291;6;5;670;675
43;Tarragona;8;Baix Camp;43092;Mont-roig del Camp;1;2;A;;1102;447;655;10;2;435;437
43;Tarragona;8;Baix Camp;43092;Mont-roig del Camp;1;2;B;;209;85;124;1;1;83;84
8;Barcelona;41;Vallès Oriental;08137;Montseny;1;1;A;;216;164;52;0;0;164;164
43;Tarragona;30;Ribera d'Ebre;43093;Móra d'Ebre;1;1;A;;700;436;264;4;5;427;432
43;Tarragona;30;Ribera d'Ebre;43093;Móra d'Ebre;1;1;B;;678;395;283;1;5;389;394
43;Tarragona;30;Ribera d'Ebre;43093;Móra d'Ebre;1;2;A;;833;494;339;3;6;485;491
43;Tarragona;30;Ribera d'Ebre;43093;Móra d'Ebre;2;1;A;;658;425;233;4;0;421;421
43;Tarragona;30;Ribera d'Ebre;43093;Móra d'Ebre;2;2;A;;434;278;156;2;3;273;276
43;Tarragona;30;Ribera d'Ebre;43094;Móra la Nova;1;1;A;;585;386;199;6;3;377;380
43;Tarragona;30;Ribera d'Ebre;43094;Móra la Nova;1;1;B;;621;413;208;10;1;402;403
43;Tarragona;30;Ribera d'Ebre;43094;Móra la Nova;2;1;A;;1004;651;353;9;6;636;642
43;Tarragona;36;Tarragonès;43095;Morell, el;1;1;A;;803;567;236;2;7;558;565
43;Tarragona;36;Tarragonès;43095;Morell, el;1;1;B;;858;605;253;2;5;598;603
43;Tarragona;29;Priorat;43096;Morera de Montsant, la;1;1;A;;112;91;21;0;0;91;91
8;Barcelona;24;Osona;08129;Muntanyola;1;1;A;;133;86;47;0;2;84;86
8;Barcelona;7;Bages;08139;Mura;1;1;A;;159;93;66;0;0;93;93
25;Lleida;38;Urgell;25145;Nalec;1;1;A;;92;71;21;0;0;71;71
25;Lleida;39;Consell General d'Aran;25025;Naut Aran;1;1;A;;389;259;130;0;3;256;259
25;Lleida;39;Consell General d'Aran;25025;Naut Aran;1;1;B;;591;296;295;0;2;294;296
8;Barcelona;7;Bages;08140;Navarcles;1;1;A;;875;620;255;4;1;615;616
8;Barcelona;7;Bages;08140;Navarcles;1;1;B;;1105;722;383;13;2;707;709
8;Barcelona;7;Bages;08140;Navarcles;1;2;A;;816;571;245;2;1;568;569
8;Barcelona;7;Bages;08140;Navarcles;1;2;B;;955;646;309;3;0;643;643
8;Barcelona;7;Bages;08141;Navàs;1;1;A;;986;764;222;3;7;754;761
8;Barcelona;7;Bages;08141;Navàs;1;2;A;;657;475;182;1;6;468;474
8;Barcelona;7;Bages;08141;Navàs;1;3;A;;1056;658;398;7;1;650;651
8;Barcelona;7;Bages;08141;Navàs;1;4;A;;953;700;253;4;0;696;696
8;Barcelona;7;Bages;08141;Navàs;2;1;A;;539;404;135;2;3;399;402
17;Girona;2;Alt Empordà;17111;Navata;1;1;A;;511;333;178;1;1;331;332
25;Lleida;35;Solsonès;25146;Navès;1;1;A;;262;182;80;2;2;178;180
8;Barcelona;14;Berguedà;08142;Nou de Berguedà, la;1;1;A;;117;91;26;0;0;91;91
43;Tarragona;36;Tarragonès;43097;Nou de Gaià, la;1;1;A;;298;231;67;0;0;231;231
43;Tarragona;1;Alt Camp;43098;Nulles;1;1;A;;298;207;91;0;0;207;207
25;Lleida;35;Solsonès;25148;Odèn;1;1;A;;269;133;136;0;0;133;133
8;Barcelona;6;Anoia;08143;Òdena;1;1;A;;580;364;216;5;0;359;359
8;Barcelona;6;Anoia;08143;Òdena;1;1;B;;742;482;260;2;2;478;480
8;Barcelona;6;Anoia;08143;Òdena;1;2;A;;583;389;194;2;2;385;387
17;Girona;31;Ripollès;17112;Ogassa;1;1;A;;234;169;65;1;0;168;168
8;Barcelona;3;Alt Penedès;08145;Olèrdola;1;1;A;;495;324;171;0;1;323;324
8;Barcelona;3;Alt Penedès;08145;Olèrdola;1;2;A;;695;528;167;3;5;520;525
8;Barcelona;3;Alt Penedès;08146;Olesa de Bonesvalls;1;1;A;;271;202;69;3;0;199;199
8;Barcelona;11;Baix Llobregat;08147;Olesa de Montserrat;1;1;A;;656;373;283;0;3;370;373
8;Barcelona;11;Baix Llobregat;08147;Olesa de Montserrat;1;1;B;;852;498;354;0;2;496;498
8;Barcelona;11;Baix Llobregat;08147;Olesa de Montserrat;1;2;A;;672;392;280;1;3;388;391
8;Barcelona;11;Baix Llobregat;08147;Olesa de Montserrat;1;2;B;;635;372;263;0;1;371;372
8;Barcelona;11;Baix Llobregat;08147;Olesa de Montserrat;1;2;C;;706;415;291;0;2;413;415
8;Barcelona;11;Baix Llobregat;08147;Olesa de Montserrat;1;3;A;;453;314;139;0;1;313;314
8;Barcelona;11;Baix Llobregat;08147;Olesa de Montserrat;1;3;B;;506;332;174;0;2;330;332
8;Barcelona;11;Baix Llobregat;08147;Olesa de Montserrat;1;4;A;;673;441;232;2;4;435;439
8;Barcelona;11;Baix Llobregat;08147;Olesa de Montserrat;1;4;B;;693;458;235;0;2;456;458
8;Barcelona;11;Baix Llobregat;08147;Olesa de Montserrat;1;5;A;;612;418;194;2;5;411;416
8;Barcelona;11;Baix Llobregat;08147;Olesa de Montserrat;1;5;B;;558;337;221;0;3;334;337
8;Barcelona;11;Baix Llobregat;08147;Olesa de Montserrat;1;6;A;;571;362;209;0;0;362;362
8;Barcelona;11;Baix Llobregat;08147;Olesa de Montserrat;1;6;B;;560;344;216;1;0;343;343
8;Barcelona;11;Baix Llobregat;08147;Olesa de Montserrat;1;7;A;;549;370;179;0;4;366;370
8;Barcelona;11;Baix Llobregat;08147;Olesa de Montserrat;1;7;B;;683;483;200;1;4;478;482
8;Barcelona;11;Baix Llobregat;08147;Olesa de Montserrat;1;8;A;;665;452;213;1;4;447;451
8;Barcelona;11;Baix Llobregat;08147;Olesa de Montserrat;1;8;B;;718;463;255;3;0;460;460
25;Lleida;4;Alt Urgell;25149;Oliana;1;1;A;;743;559;184;2;1;556;557
25;Lleida;4;Alt Urgell;25149;Oliana;1;1;B;;860;634;226;5;5;624;629
25;Lleida;23;Noguera;25150;Oliola;1;1;A;;208;128;80;0;0;128;128
25;Lleida;35;Solsonès;25151;Olius;1;1;A;;372;248;124;0;7;241;248
8;Barcelona;17;Garraf;08148;Olivella;1;1;A;;168;97;71;0;2;95;97
8;Barcelona;24;Osona;08149;Olost;1;1;A;;774;585;189;0;4;581;585
17;Girona;19;Garrotxa;17114;Olot;1;1;A;;768;502;266;6;2;494;496
17;Girona;19;Garrotxa;17114;Olot;1;2;A;;525;355;170;1;6;348;354
17;Girona;19;Garrotxa;17114;Olot;1;2;B;;552;383;169;3;3;377;380
17;Girona;19;Garrotxa;17114;Olot;1;3;A;;890;588;302;5;6;577;583
17;Girona;19;Garrotxa;17114;Olot;1;4;A;;529;367;162;0;1;366;367
17;Girona;19;Garrotxa;17114;Olot;1;4;B;;505;332;173;2;1;329;330
17;Girona;19;Garrotxa;17114;Olot;2;1;A;;610;352;258;2;2;348;350
17;Girona;19;Garrotxa;17114;Olot;2;1;B;;503;345;158;2;1;342;343
17;Girona;19;Garrotxa;17114;Olot;2;2;A;;761;545;216;1;4;540;544
17;Girona;19;Garrotxa;17114;Olot;2;3;A;;622;423;199;7;1;415;416
17;Girona;19;Garrotxa;17114;Olot;2;3;B;;335;223;112;4;0;219;219
17;Girona;19;Garrotxa;17114;Olot;2;3;C;;622;422;200;3;2;417;419
17;Girona;19;Garrotxa;17114;Olot;2;4;A;;503;359;144;4;2;353;355
17;Girona;19;Garrotxa;17114;Olot;2;4;B;;555;392;163;5;9;378;387
17;Girona;19;Garrotxa;17114;Olot;3;1;A;;589;418;171;4;4;410;414
17;Girona;19;Garrotxa;17114;Olot;3;1;B;;340;227;113;2;4;221;225
17;Girona;19;Garrotxa;17114;Olot;3;1;C;;600;423;177;6;1;416;417
17;Girona;19;Garrotxa;17114;Olot;3;2;A;;545;378;167;1;3;374;377
17;Girona;19;Garrotxa;17114;Olot;3;2;B;;584;416;168;2;1;413;414
17;Girona;19;Garrotxa;17114;Olot;4;1;A;;857;469;388;7;8;454;462
17;Girona;19;Garrotxa;17114;Olot;4;2;A;;697;451;246;0;2;449;451
17;Girona;19;Garrotxa;17114;Olot;4;2;B;;638;430;208;4;1;425;426
17;Girona;19;Garrotxa;17114;Olot;4;3;A;;507;349;158;3;2;344;346
17;Girona;19;Garrotxa;17114;Olot;4;3;B;;590;383;207;0;4;379;383
17;Girona;19;Garrotxa;17114;Olot;4;4;A;;494;341;153;1;4;336;340
17;Girona;19;Garrotxa;17114;Olot;4;4;B;;517;377;140;3;9;365;374
17;Girona;19;Garrotxa;17114;Olot;5;1;A;;607;418;189;2;5;411;416
17;Girona;19;Garrotxa;17114;Olot;5;1;B;;622;410;212;0;3;407;410
17;Girona;19;Garrotxa;17114;Olot;5;2;A;;611;448;163;0;4;444;448
17;Girona;19;Garrotxa;17114;Olot;5;2;B;;330;237;93;2;1;234;235
17;Girona;19;Garrotxa;17114;Olot;5;2;C;;579;402;177;3;3;396;399
17;Girona;19;Garrotxa;17114;Olot;5;3;A;;592;387;205;1;3;383;386
17;Girona;19;Garrotxa;17114;Olot;5;4;A;;634;424;210;1;2;421;423
17;Girona;19;Garrotxa;17114;Olot;5;4;B;;468;278;190;0;1;277;278
17;Girona;19;Garrotxa;17114;Olot;5;4;C;;698;472;226;3;1;468;469
25;Lleida;32;Segarra;25152;Oluges, les;1;1;A;;194;100;94;0;0;100;100
8;Barcelona;14;Berguedà;08144;Olvan;1;1;A;;400;257;143;3;3;251;254
8;Barcelona;14;Berguedà;08144;Olvan;1;2;A;;499;378;121;1;1;376;377
25;Lleida;18;Garrigues;25153;Omellons, els;1;1;A;;225;132;93;0;1;131;132
25;Lleida;38;Urgell;25154;Omells de na Gaia, els;1;1;A;;145;98;47;0;0;98;98
17;Girona;2;Alt Empordà;17115;Ordis;1;1;A;;232;155;77;1;1;153;154
25;Lleida;4;Alt Urgell;25155;Organyà;1;1;A;;878;621;257;0;1;620;621
8;Barcelona;24;Osona;08150;Orís;1;1;A;;186;126;60;0;0;126;126
8;Barcelona;24;Osona;08151;Oristà;1;1;A;;739;448;291;0;3;445;448
8;Barcelona;6;Anoia;08152;Orpí;1;1;A;;123;89;34;1;0;88;88
8;Barcelona;21;Maresme;08153;Òrrius;1;1;A;;254;195;59;0;3;192;195
25;Lleida;23;Noguera;25156;Os de Balaguer;1;1;A;;447;267;180;0;1;266;267
25;Lleida;23;Noguera;25156;Os de Balaguer;1;1;B;;244;167;77;0;5;162;167
17;Girona;34;Selva;17116;Osor;1;1;A;;416;318;98;0;1;317;318
25;Lleida;38;Urgell;25157;Ossó de Sió;1;1;A;;222;135;87;0;1;134;135
8;Barcelona;3;Alt Penedès;08154;Pacs del Penedès;1;1;A;;298;192;106;0;1;191;192
8;Barcelona;21;Maresme;08155;Palafolls;1;1;A;;966;608;358;1;5;602;607
8;Barcelona;21;Maresme;08155;Palafolls;1;1;B;;1229;764;465;8;1;755;756
17;Girona;10;Baix Empordà;17117;Palafrugell;1;1;A;;557;378;179;0;3;375;378
17;Girona;10;Baix Empordà;17117;Palafrugell;1;1;B;;457;280;177;2;0;278;278
17;Girona;10;Baix Empordà;17117;Palafrugell;1;1;C;;587;356;231;2;0;354;354
17;Girona;10;Baix Empordà;17117;Palafrugell;1;2;A;;515;339;176;1;3;335;338
17;Girona;10;Baix Empordà;17117;Palafrugell;1;2;B;;489;277;212;4;1;272;273
17;Girona;10;Baix Empordà;17117;Palafrugell;1;2;C;;642;448;194;2;1;445;446
17;Girona;10;Baix Empordà;17117;Palafrugell;1;3;A;;617;399;218;1;1;397;398
17;Girona;10;Baix Empordà;17117;Palafrugell;1;3;B;;539;353;186;1;1;351;352
17;Girona;10;Baix Empordà;17117;Palafrugell;1;3;C;;646;413;233;1;3;409;412
17;Girona;10;Baix Empordà;17117;Palafrugell;2;1;A;;537;415;122;0;3;412;415
17;Girona;10;Baix Empordà;17117;Palafrugell;2;1;B;;721;461;260;3;3;455;458
17;Girona;10;Baix Empordà;17117;Palafrugell;2;2;A;;650;411;239;2;3;406;409
17;Girona;10;Baix Empordà;17117;Palafrugell;2;2;B;;618;370;248;3;3;364;367
17;Girona;10;Baix Empordà;17117;Palafrugell;2;2;C;;798;494;304;2;3;489;492
17;Girona;10;Baix Empordà;17117;Palafrugell;2;3;A;;580;402;178;2;4;396;400
17;Girona;10;Baix Empordà;17117;Palafrugell;3;1;A;;737;472;265;2;2;468;470
17;Girona;10;Baix Empordà;17117;Palafrugell;3;1;B;;804;487;317;4;5;478;483
17;Girona;10;Baix Empordà;17117;Palafrugell;3;2;A;;550;381;169;0;4;377;381
17;Girona;10;Baix Empordà;17117;Palafrugell;3;2;B;;539;372;167;0;1;371;372
17;Girona;10;Baix Empordà;17117;Palafrugell;3;2;C;;271;178;93;0;5;173;178
17;Girona;10;Baix Empordà;17118;Palamós;1;1;A;;576;404;172;2;5;397;402
17;Girona;10;Baix Empordà;17118;Palamós;1;1;B;;657;447;210;0;6;441;447
17;Girona;10;Baix Empordà;17118;Palamós;1;2;A;;565;352;213;0;4;348;352
17;Girona;10;Baix Empordà;17118;Palamós;1;2;B;;666;424;242;3;4;417;421
17;Girona;10;Baix Empordà;17118;Palamós;1;3;A;;654;367;287;2;2;363;365
17;Girona;10;Baix Empordà;17118;Palamós;1;3;B;;718;446;272;1;5;440;445
17;Girona;10;Baix Empordà;17118;Palamós;1;4;A;;645;398;247;3;2;393;395
17;Girona;10;Baix Empordà;17118;Palamós;2;1;A;;652;427;225;3;8;416;424
17;Girona;10;Baix Empordà;17118;Palamós;2;1;B;;742;458;284;4;5;449;454
17;Girona;10;Baix Empordà;17118;Palamós;3;1;A;;434;238;196;2;2;234;236
17;Girona;10;Baix Empordà;17118;Palamós;3;1;B;;460;284;176;5;0;279;279
17;Girona;10;Baix Empordà;17118;Palamós;3;1;C;;824;479;345;4;3;472;475
17;Girona;10;Baix Empordà;17118;Palamós;4;1;A;;805;499;306;7;4;488;492
17;Girona;10;Baix Empordà;17118;Palamós;4;1;B;;859;514;345;1;3;510;513
25;Lleida;27;Pla d'Urgell;25158;Palau d'Anglesola, el;1;1;A;;1297;845;452;1;5;839;844
17;Girona;2;Alt Empordà;17119;Palau de Santa Eulàlia;1;1;A;;70;48;22;0;0;48;48
17;Girona;10;Baix Empordà;17121;Palau-sator;1;1;A;;254;169;85;0;0;169;169
17;Girona;2;Alt Empordà;17120;Palau-saverdera;1;1;A;;558;488;70;6;4;478;482
8;Barcelona;40;Vallès Occidental;08156;Palau-solità i Plegamans;1;1;A;;1353;853;500;9;1;843;844
8;Barcelona;40;Vallès Occidental;08156;Palau-solità i Plegamans;1;2;A;;693;420;273;9;2;409;411
8;Barcelona;40;Vallès Occidental;08156;Palau-solità i Plegamans;1;2;B;;942;546;396;2;1;543;544
8;Barcelona;40;Vallès Occidental;08156;Palau-solità i Plegamans;1;3;A;;903;541;362;16;1;524;525
43;Tarragona;36;Tarragonès;43100;Pallaresos, els;1;1;A;;364;252;112;1;3;248;251
8;Barcelona;11;Baix Llobregat;08157;Pallejà;1;1;A;;706;424;282;0;2;422;424
8;Barcelona;11;Baix Llobregat;08157;Pallejà;1;1;B;;880;553;327;3;2;548;550
8;Barcelona;11;Baix Llobregat;08157;Pallejà;1;2;A;;633;399;234;0;0;399;399
8;Barcelona;11;Baix Llobregat;08157;Pallejà;1;2;B;;701;423;278;1;1;421;422
8;Barcelona;11;Baix Llobregat;08157;Pallejà;1;3;A;;610;384;226;1;2;381;383
8;Barcelona;11;Baix Llobregat;08157;Pallejà;1;3;B;;670;420;250;1;4;415;419
43;Tarragona;30;Ribera d'Ebre;43099;Palma d'Ebre, la;1;1;A;;412;240;172;2;1;237;238
17;Girona;;;17122;Palmerola;1;1;A;;19;13;6;0;0;13;13
17;Girona;28;Pla de l'Estany;17123;Palol de Revardit;1;1;A;;283;200;83;2;2;196;198
17;Girona;10;Baix Empordà;17124;Pals;1;1;A;;566;401;165;4;4;393;397
17;Girona;10;Baix Empordà;17124;Pals;1;1;B;;695;508;187;2;6;500;506
8;Barcelona;11;Baix Llobregat;08158;Papiol, el;1;1;A;;562;369;193;1;1;367;368
8;Barcelona;11;Baix Llobregat;08158;Papiol, el;1;1;B;;605;351;254;1;3;347;350
8;Barcelona;11;Baix Llobregat;08158;Papiol, el;1;2;A;;581;351;230;4;1;346;347
8;Barcelona;11;Baix Llobregat;08158;Papiol, el;1;2;B;;611;399;212;1;1;397;398
17;Girona;31;Ripollès;17125;Pardines;1;1;A;;100;68;32;0;0;68;68
8;Barcelona;41;Vallès Oriental;08159;Parets del Vallès;1;1;A;;767;461;306;1;1;459;460
8;Barcelona;41;Vallès Oriental;08159;Parets del Vallès;1;1;B;;948;586;362;2;2;582;584
8;Barcelona;41;Vallès Oriental;08159;Parets del Vallès;1;2;A;;562;379;183;2;1;376;377
8;Barcelona;41;Vallès Oriental;08159;Parets del Vallès;1;2;B;;716;496;220;1;2;493;495
8;Barcelona;41;Vallès Oriental;08159;Parets del Vallès;2;1;A;;1298;639;659;2;5;632;637
8;Barcelona;41;Vallès Oriental;08159;Parets del Vallès;2;2;A;;848;425;423;0;5;420;425
8;Barcelona;41;Vallès Oriental;08159;Parets del Vallès;2;2;B;;1025;548;477;0;2;546;548
8;Barcelona;41;Vallès Oriental;08159;Parets del Vallès;2;3;A;;1027;543;484;10;0;533;533
17;Girona;10;Baix Empordà;17126;Parlavà;1;1;A;;279;205;74;2;5;198;203
43;Tarragona;16;Conca de Barberà;43101;Passanant i Belltall;1;1;A;;183;137;46;2;2;133;135
17;Girona;2;Alt Empordà;17128;Pau;1;1;A;;232;157;75;0;0;157;157
43;Tarragona;9;Baix Ebre;43102;Paüls;1;1;A;;610;487;123;6;3;478;481
17;Girona;2;Alt Empordà;17129;Pedret i Marzà;1;1;A;;110;69;41;1;0;68;68
25;Lleida;23;Noguera;25164;Penelles;1;1;A;;512;332;180;2;2;328;330
17;Girona;10;Baix Empordà;17130;Pera, la;1;1;A;;299;209;90;1;2;206;208
8;Barcelona;24;Osona;08160;Perafita;1;1;A;;291;218;73;0;1;217;218
43;Tarragona;36;Tarragonès;43103;Perafort;1;1;A;;376;230;146;1;1;228;229
17;Girona;2;Alt Empordà;17132;Peralada;1;1;A;;768;584;184;0;13;571;584
17;Girona;2;Alt Empordà;17132;Peralada;1;1;B;;222;141;81;0;2;139;141
25;Lleida;4;Alt Urgell;25165;Peramola;1;1;A;;340;243;97;0;1;242;243
43;Tarragona;9;Baix Ebre;43104;Perelló, el;1;1;A;;519;303;216;3;3;297;300
43;Tarragona;9;Baix Ebre;43104;Perelló, el;1;2;A;;552;342;210;1;4;337;341
43;Tarragona;9;Baix Ebre;43104;Perelló, el;1;2;B;;710;443;267;5;5;433;438
43;Tarragona;9;Baix Ebre;43104;Perelló, el;2;1;A;;720;564;156;5;3;556;559
43;Tarragona;9;Baix Ebre;43104;Perelló, el;2;1;B;;412;287;125;5;2;280;282
8;Barcelona;6;Anoia;08161;Piera;1;1;A;;453;345;108;0;1;344;345
8;Barcelona;6;Anoia;08161;Piera;1;2;A;;651;460;191;1;1;458;459
8;Barcelona;6;Anoia;08161;Piera;1;2;B;;596;432;164;5;2;425;427
8;Barcelona;6;Anoia;08161;Piera;1;3;A;;902;564;338;6;2;556;558
8;Barcelona;6;Anoia;08161;Piera;1;3;B;;970;605;365;7;4;594;598
8;Barcelona;6;Anoia;08161;Piera;1;4;A;;440;309;131;2;0;307;307
43;Tarragona;16;Conca de Barberà;43105;Piles, les;1;1;A;;105;67;38;1;1;65;66
8;Barcelona;21;Maresme;08163;Pineda de Mar;1;1;A;;659;375;284;2;0;373;373
8;Barcelona;21;Maresme;08163;Pineda de Mar;1;1;B;;817;464;353;5;6;453;459
8;Barcelona;21;Maresme;08163;Pineda de Mar;1;2;A;;729;454;275;1;3;450;453
8;Barcelona;21;Maresme;08163;Pineda de Mar;1;2;B;;833;483;350;4;1;478;479
8;Barcelona;21;Maresme;08163;Pineda de Mar;1;3;A;;542;350;192;0;1;349;350
8;Barcelona;21;Maresme;08163;Pineda de Mar;1;3;B;;537;313;224;0;1;312;313
8;Barcelona;21;Maresme;08163;Pineda de Mar;1;3;C;;719;452;267;2;1;449;450
8;Barcelona;21;Maresme;08163;Pineda de Mar;1;4;A;;858;474;384;2;6;466;472
8;Barcelona;21;Maresme;08163;Pineda de Mar;1;5;A;;978;527;451;0;4;523;527
8;Barcelona;21;Maresme;08163;Pineda de Mar;1;6;A;;658;341;317;14;1;326;327
8;Barcelona;21;Maresme;08163;Pineda de Mar;1;7;A;;572;337;235;0;0;337;337
8;Barcelona;21;Maresme;08163;Pineda de Mar;1;7;B;;747;470;277;4;1;465;466
8;Barcelona;21;Maresme;08163;Pineda de Mar;1;8;A;;596;315;281;3;1;311;312
8;Barcelona;21;Maresme;08163;Pineda de Mar;1;8;B;;717;405;312;0;3;402;405
43;Tarragona;37;Terra Alta;43106;Pinell de Brai, el;1;1;A;;990;590;400;0;5;585;590
25;Lleida;35;Solsonès;25166;Pinell de Solsonès;1;1;A;;220;155;65;0;0;155;155
25;Lleida;35;Solsonès;25167;Pinós;1;1;A;;339;213;126;0;2;211;213
43;Tarragona;16;Conca de Barberà;43107;Pira;1;1;A;;290;195;95;0;2;193;195
8;Barcelona;3;Alt Penedès;08164;Pla del Penedès, el;1;1;A;;787;555;232;3;7;545;552
43;Tarragona;1;Alt Camp;43108;Pla de Santa Maria, el;1;1;A;;620;444;176;1;1;442;443
43;Tarragona;1;Alt Camp;43108;Pla de Santa Maria, el;1;1;B;;596;418;178;0;5;413;418
17;Girona;19;Garrotxa;17133;Planes d'Hostoles, les;1;1;A;;755;571;184;10;1;560;561
17;Girona;19;Garrotxa;17133;Planes d'Hostoles, les;1;1;B;;717;532;185;3;7;522;529
17;Girona;31;Ripollès;17134;Planoles;1;1;A;;250;178;72;3;0;175;175
25;Lleida;32;Segarra;25911;Plans de Sió, els;1;1;A;;603;415;188;0;0;415;415
25;Lleida;27;Pla d'Urgell;25168;Poal, el;1;1;A;;574;413;161;2;3;408;411
25;Lleida;18;Garrigues;25169;Pobla de Cérvoles, la;1;1;A;;171;130;41;0;0;130;130
8;Barcelona;6;Anoia;08165;Pobla de Claramunt, la;1;1;A;;1310;991;319;4;8;979;987
8;Barcelona;14;Berguedà;08166;Pobla de Lillet, la;1;1;A;;549;388;161;0;5;383;388
8;Barcelona;14;Berguedà;08166;Pobla de Lillet, la;1;2;A;;543;362;181;0;5;357;362
8;Barcelona;14;Berguedà;08166;Pobla de Lillet, la;1;2;B;;459;326;133;4;5;317;322
43;Tarragona;36;Tarragonès;43109;Pobla de Mafumet, la;1;1;A;;603;419;184;4;2;413;415
43;Tarragona;37;Terra Alta;43110;Pobla de Massaluca, la;1;1;A;;414;223;191;2;2;219;221
43;Tarragona;36;Tarragonès;43111;Pobla de Montornès, la;1;1;A;;601;410;191;8;1;401;402
25;Lleida;25;Pallars Jussà;25171;Pobla de Segur, la;1;1;A;;1179;733;446;2;9;722;731
25;Lleida;25;Pallars Jussà;25171;Pobla de Segur, la;1;2;A;;714;472;242;1;3;468;471
25;Lleida;25;Pallars Jussà;25171;Pobla de Segur, la;1;2;B;;800;488;312;1;1;486;487
43;Tarragona;29;Priorat;43112;Poboleda;1;1;A;;315;201;114;0;4;197;201
8;Barcelona;40;Vallès Occidental;08167;Polinyà;1;1;A;;863;500;363;10;1;489;490
8;Barcelona;40;Vallès Occidental;08167;Polinyà;1;1;B;;1050;632;418;8;3;621;624
43;Tarragona;1;Alt Camp;43113;Pont d'Armentera, el;1;1;A;;466;392;74;8;2;382;384
25;Lleida;4;Alt Urgell;25030;Pont de Bar, el;1;1;A;;156;89;67;0;0;89;89
17;Girona;2;Alt Empordà;17135;Pont de Molins;1;1;A;;282;172;110;2;1;169;170
25;Lleida;5;Alta Ribagorça;25173;Pont de Suert, el;1;1;A;;967;585;382;2;6;577;583
25;Lleida;5;Alta Ribagorça;25173;Pont de Suert, el;1;2;A;;963;529;434;1;6;522;528
8;Barcelona;7;Bages;08182;Pont de Vilomara i Rocafort, el;1;1;A;;669;455;214;3;4;448;452
8;Barcelona;7;Bages;08182;Pont de Vilomara i Rocafort, el;1;1;B;;931;637;294;4;1;632;633
43;Tarragona;16;Conca de Barberà;43141;Pontils;1;1;A;;94;62;32;0;0;62;62
8;Barcelona;3;Alt Penedès;08168;Pontons;1;1;A;;184;136;48;0;3;133;136
17;Girona;2;Alt Empordà;17136;Pontós;1;1;A;;175;122;53;1;0;121;121
25;Lleida;23;Noguera;25172;Ponts;1;1;A;;918;614;304;6;5;603;608
25;Lleida;23;Noguera;25172;Ponts;1;2;A;;867;571;296;3;3;565;568
17;Girona;28;Pla de l'Estany;17137;Porqueres;1;1;A;;676;466;210;2;6;458;464
17;Girona;28;Pla de l'Estany;17137;Porqueres;1;2;A;;650;488;162;4;6;478;484
17;Girona;28;Pla de l'Estany;17137;Porqueres;1;2;B;;746;548;198;2;5;541;546
43;Tarragona;29;Priorat;43114;Porrera;1;1;A;;402;223;179;0;1;222;223
17;Girona;2;Alt Empordà;17138;Portbou;1;1;A;;754;487;267;6;4;477;481
17;Girona;2;Alt Empordà;17138;Portbou;1;1;B;;830;532;298;7;11;514;525
17;Girona;2;Alt Empordà;17140;Port de la Selva, el;1;1;A;;612;461;151;3;7;451;458
25;Lleida;33;Segrià;25174;Portella, la;1;1;A;;469;335;134;0;6;329;335
43;Tarragona;29;Priorat;43115;Pradell de la Teixeta;1;1;A;;225;118;107;2;3;113;116
43;Tarragona;8;Baix Camp;43116;Prades;1;1;A;;446;257;189;3;3;251;254
43;Tarragona;37;Terra Alta;43117;Prat de Comte;1;1;A;;203;153;50;2;0;151;151
8;Barcelona;11;Baix Llobregat;08169;Prat de Llobregat, el;1;1;A;;637;342;295;4;4;334;338
8;Barcelona;11;Baix Llobregat;08169;Prat de Llobregat, el;1;1;B;;726;422;304;0;3;419;422
8;Barcelona;11;Baix Llobregat;08169;Prat de Llobregat, el;1;2;A;;677;382;295;0;1;381;382
8;Barcelona;11;Baix Llobregat;08169;Prat de Llobregat, el;1;2;B;;739;439;300;3;1;435;436
8;Barcelona;11;Baix Llobregat;08169;Prat de Llobregat, el;1;3;A;;916;563;353;0;4;559;563
8;Barcelona;11;Baix Llobregat;08169;Prat de Llobregat, el;1;4;A;;783;422;361;4;0;418;418
8;Barcelona;11;Baix Llobregat;08169;Prat de Llobregat, el;1;4;B;;860;475;385;1;4;470;474
8;Barcelona;11;Baix Llobregat;08169;Prat de Llobregat, el;1;5;A;;570;301;269;1;1;299;300
8;Barcelona;11;Baix Llobregat;08169;Prat de Llobregat, el;1;5;B;;626;320;306;0;0;320;320
8;Barcelona;11;Baix Llobregat;08169;Prat de Llobregat, el;2;1;A;;742;425;317;0;5;420;425
8;Barcelona;11;Baix Llobregat;08169;Prat de Llobregat, el;2;1;B;;858;504;354;1;5;498;503
8;Barcelona;11;Baix Llobregat;08169;Prat de Llobregat, el;2;2;A;;686;400;286;1;2;397;399
8;Barcelona;11;Baix Llobregat;08169;Prat de Llobregat, el;2;2;B;;749;406;343;0;0;406;406
8;Barcelona;11;Baix Llobregat;08169;Prat de Llobregat, el;2;3;A;;601;293;308;0;0;293;293
8;Barcelona;11;Baix Llobregat;08169;Prat de Llobregat, el;2;3;B;;606;315;291;0;5;310;315
8;Barcelona;11;Baix Llobregat;08169;Prat de Llobregat, el;2;4;A;;681;313;368;2;0;311;311
8;Barcelona;11;Baix Llobregat;08169;Prat de Llobregat, el;2;4;B;;815;373;442;3;1;369;370
8;Barcelona;11;Baix Llobregat;08169;Prat de Llobregat, el;2;5;A;;652;302;350;0;0;302;302
8;Barcelona;11;Baix Llobregat;08169;Prat de Llobregat, el;2;5;B;;709;362;347;2;2;358;360
8;Barcelona;11;Baix Llobregat;08169;Prat de Llobregat, el;2;6;A;;990;491;499;0;0;491;491
8;Barcelona;11;Baix Llobregat;08169;Prat de Llobregat, el;2;7;A;;937;462;475;3;3;456;459
8;Barcelona;11;Baix Llobregat;08169;Prat de Llobregat, el;3;1;A;;596;366;230;2;5;359;364
8;Barcelona;11;Baix Llobregat;08169;Prat de Llobregat, el;3;1;B;;654;375;279;2;2;371;373
8;Barcelona;11;Baix Llobregat;08169;Prat de Llobregat, el;3;10;A;;944;358;586;1;1;356;357
8;Barcelona;11;Baix Llobregat;08169;Prat de Llobregat, el;3;2;A;;832;329;503;2;0;327;327
8;Barcelona;11;Baix Llobregat;08169;Prat de Llobregat, el;3;3;A;;603;305;298;7;7;291;298
8;Barcelona;11;Baix Llobregat;08169;Prat de Llobregat, el;3;3;B;;649;318;331;4;0;314;314
8;Barcelona;11;Baix Llobregat;08169;Prat de Llobregat, el;3;4;A;;605;302;303;0;4;298;302
8;Barcelona;11;Baix Llobregat;08169;Prat de Llobregat, el;3;4;B;;775;385;390;6;2;377;379
8;Barcelona;11;Baix Llobregat;08169;Prat de Llobregat, el;3;5;A;;852;449;403;4;0;445;445
8;Barcelona;11;Baix Llobregat;08169;Prat de Llobregat, el;3;5;B;;917;484;433;2;4;478;482
8;Barcelona;11;Baix Llobregat;08169;Prat de Llobregat, el;3;6;A;;860;375;485;1;5;369;374
8;Barcelona;11;Baix Llobregat;08169;Prat de Llobregat, el;3;7;A;;652;298;354;0;1;297;298
8;Barcelona;11;Baix Llobregat;08169;Prat de Llobregat, el;3;7;B;;762;339;423;0;3;336;339
8;Barcelona;11;Baix Llobregat;08169;Prat de Llobregat, el;3;8;A;;574;256;318;0;2;254;256
8;Barcelona;11;Baix Llobregat;08169;Prat de Llobregat, el;3;8;B;;692;277;415;2;2;273;275
8;Barcelona;11;Baix Llobregat;08169;Prat de Llobregat, el;3;9;A;;681;275;406;0;3;272;275
8;Barcelona;11;Baix Llobregat;08169;Prat de Llobregat, el;3;9;B;;770;284;486;5;1;278;279
8;Barcelona;11;Baix Llobregat;08169;Prat de Llobregat, el;4;1;A;;832;442;390;2;1;439;440
8;Barcelona;11;Baix Llobregat;08169;Prat de Llobregat, el;4;2;A;;797;274;523;0;1;273;274
8;Barcelona;11;Baix Llobregat;08169;Prat de Llobregat, el;4;3;A;;791;351;440;8;6;337;343
8;Barcelona;11;Baix Llobregat;08169;Prat de Llobregat, el;4;3;B;;894;405;489;10;0;395;395
8;Barcelona;11;Baix Llobregat;08169;Prat de Llobregat, el;4;4;A;;330;151;179;1;1;149;150
8;Barcelona;11;Baix Llobregat;08169;Prat de Llobregat, el;4;5;A;;775;354;421;0;1;353;354
8;Barcelona;11;Baix Llobregat;08169;Prat de Llobregat, el;4;5;B;;937;409;528;1;2;406;408
8;Barcelona;11;Baix Llobregat;08169;Prat de Llobregat, el;4;6;A;;731;200;531;1;5;194;199
8;Barcelona;11;Baix Llobregat;08169;Prat de Llobregat, el;4;7;A;;820;154;666;2;0;152;152
8;Barcelona;11;Baix Llobregat;08169;Prat de Llobregat, el;5;1;A;;594;313;281;1;1;311;312
8;Barcelona;11;Baix Llobregat;08169;Prat de Llobregat, el;5;1;B;;571;306;265;0;3;303;306
8;Barcelona;11;Baix Llobregat;08169;Prat de Llobregat, el;5;2;A;;512;263;249;0;0;263;263
8;Barcelona;11;Baix Llobregat;08169;Prat de Llobregat, el;5;2;B;;537;268;269;0;1;267;268
8;Barcelona;11;Baix Llobregat;08169;Prat de Llobregat, el;5;3;A;;461;210;251;0;1;209;210
8;Barcelona;11;Baix Llobregat;08169;Prat de Llobregat, el;5;3;B;;562;234;328;0;2;232;234
8;Barcelona;11;Baix Llobregat;08169;Prat de Llobregat, el;5;4;A;;806;397;409;0;4;393;397
8;Barcelona;11;Baix Llobregat;08169;Prat de Llobregat, el;5;5;A;;663;307;356;0;3;304;307
8;Barcelona;11;Baix Llobregat;08169;Prat de Llobregat, el;5;5;B;;749;384;365;2;2;380;382
8;Barcelona;11;Baix Llobregat;08169;Prat de Llobregat, el;5;6;A;;627;300;327;1;1;298;299
8;Barcelona;11;Baix Llobregat;08169;Prat de Llobregat, el;5;6;B;;704;324;380;0;1;323;324
8;Barcelona;11;Baix Llobregat;08169;Prat de Llobregat, el;5;7;A;;680;347;333;2;0;345;345
8;Barcelona;11;Baix Llobregat;08169;Prat de Llobregat, el;5;7;B;;860;409;451;1;0;408;408
8;Barcelona;11;Baix Llobregat;08169;Prat de Llobregat, el;5;8;A;;446;216;230;1;1;214;215
8;Barcelona;11;Baix Llobregat;08169;Prat de Llobregat, el;5;8;B;;595;275;320;5;0;270;270
43;Tarragona;8;Baix Camp;43118;Pratdip;1;1;A;;363;241;122;1;1;239;240
8;Barcelona;24;Osona;08171;Prats de Lluçanès;1;1;A;;978;672;306;5;3;664;667
8;Barcelona;24;Osona;08171;Prats de Lluçanès;1;1;B;;975;620;355;0;4;616;620
8;Barcelona;6;Anoia;08170;Prats de Rei, els;1;1;A;;469;369;100;1;1;367;368
25;Lleida;15;Cerdanya;25175;Prats i Sansor;1;1;A;;84;60;24;0;1;59;60
25;Lleida;38;Urgell;25176;Preixana;1;1;A;;399;267;132;1;3;263;266
25;Lleida;23;Noguera;25177;Preixens;1;1;A;;502;309;193;0;4;305;309
8;Barcelona;21;Maresme;08230;Premià de Dalt;1;1;A;;774;551;223;0;1;550;551
8;Barcelona;21;Maresme;08230;Premià de Dalt;1;1;B;;823;598;225;3;3;592;595
8;Barcelona;21;Maresme;08230;Premià de Dalt;1;2;A;;1372;829;543;13;4;812;816
8;Barcelona;21;Maresme;08230;Premià de Dalt;1;3;A;;1109;601;508;0;0;601;601
8;Barcelona;21;Maresme;08172;Premià de Mar;1;1;A;;1057;658;399;2;3;653;656
8;Barcelona;21;Maresme;08172;Premià de Mar;1;2;A;;696;439;257;0;2;437;439
8;Barcelona;21;Maresme;08172;Premià de Mar;1;2;B;;719;446;273;2;1;443;444
8;Barcelona;21;Maresme;08172;Premià de Mar;1;3;A;;712;444;268;0;3;441;444
8;Barcelona;21;Maresme;08172;Premià de Mar;1;3;B;;764;430;334;0;1;429;430
8;Barcelona;21;Maresme;08172;Premià de Mar;2;1;A;;613;418;195;1;2;415;417
8;Barcelona;21;Maresme;08172;Premià de Mar;2;1;B;;787;489;298;1;1;487;488
8;Barcelona;21;Maresme;08172;Premià de Mar;2;2;A;;744;424;320;0;1;423;424
8;Barcelona;21;Maresme;08172;Premià de Mar;2;2;B;;925;520;405;1;0;519;519
8;Barcelona;21;Maresme;08172;Premià de Mar;2;3;A;;1252;744;508;7;5;732;737
8;Barcelona;21;Maresme;08172;Premià de Mar;2;4;A;;512;277;235;0;0;277;277
8;Barcelona;21;Maresme;08172;Premià de Mar;2;4;B;;625;334;291;0;2;332;334
8;Barcelona;21;Maresme;08172;Premià de Mar;3;1;A;;516;308;208;2;3;303;306
8;Barcelona;21;Maresme;08172;Premià de Mar;3;1;B;;785;449;336;6;0;443;443
8;Barcelona;21;Maresme;08172;Premià de Mar;3;2;A;;639;344;295;1;1;342;343
8;Barcelona;21;Maresme;08172;Premià de Mar;3;2;B;;645;338;307;0;3;335;338
8;Barcelona;21;Maresme;08172;Premià de Mar;3;3;A;;596;334;262;1;2;331;333
8;Barcelona;21;Maresme;08172;Premià de Mar;3;3;B;;686;365;321;0;1;364;365
8;Barcelona;21;Maresme;08172;Premià de Mar;3;4;A;;739;471;268;2;3;466;469
8;Barcelona;21;Maresme;08172;Premià de Mar;3;5;A;;513;280;233;1;1;278;279
8;Barcelona;21;Maresme;08172;Premià de Mar;3;5;B;;646;374;272;1;2;371;373
17;Girona;19;Garrotxa;17139;Preses, les;1;1;A;;566;433;133;5;9;419;428
17;Girona;19;Garrotxa;17139;Preses, les;1;1;B;;454;311;143;1;1;309;310
25;Lleida;15;Cerdanya;25179;Prullans;1;1;A;;153;106;47;0;1;105;106
17;Girona;15;Cerdanya;17141;Puigcerdà;1;1;A;;499;345;154;2;4;339;343
17;Girona;15;Cerdanya;17141;Puigcerdà;1;1;B;;509;343;166;0;0;343;343
17;Girona;15;Cerdanya;17141;Puigcerdà;1;2;A;;561;402;159;1;1;400;401
17;Girona;15;Cerdanya;17141;Puigcerdà;1;2;B;;629;443;186;3;6;434;440
17;Girona;15;Cerdanya;17141;Puigcerdà;1;3;A;;552;323;229;2;1;320;321
17;Girona;15;Cerdanya;17141;Puigcerdà;1;3;B;;649;360;289;2;4;354;358
17;Girona;15;Cerdanya;17141;Puigcerdà;1;4;A;;611;373;238;2;2;369;371
17;Girona;15;Cerdanya;17141;Puigcerdà;1;4;B;;601;401;200;4;3;394;397
8;Barcelona;3;Alt Penedès;08174;Puigdàlber;1;1;A;;229;184;45;2;3;179;182
25;Lleida;18;Garrigues;25180;Puiggròs;1;1;A;;237;184;53;1;5;178;183
43;Tarragona;1;Alt Camp;43119;Puigpelat;1;1;A;;353;219;134;3;0;216;216
8;Barcelona;14;Berguedà;08175;Puig-reig;1;1;A;;873;641;232;1;2;638;640
8;Barcelona;14;Berguedà;08175;Puig-reig;1;1;B;;928;686;242;3;4;679;683
8;Barcelona;14;Berguedà;08175;Puig-reig;1;2;A;;586;428;158;2;0;426;426
8;Barcelona;14;Berguedà;08175;Puig-reig;1;2;B;;734;517;217;5;1;511;512
8;Barcelona;14;Berguedà;08175;Puig-reig;2;1;A;;303;253;50;2;4;247;251
8;Barcelona;14;Berguedà;08175;Puig-reig;2;2;A;;327;205;122;1;1;203;204
8;Barcelona;14;Berguedà;08175;Puig-reig;2;3;A;;376;324;52;4;3;317;320
25;Lleida;38;Urgell;25181;Puigverd d'Agramunt;1;1;A;;215;132;83;1;0;131;131
25;Lleida;33;Segrià;25182;Puigverd de Lleida;1;1;A;;784;503;281;0;1;502;503
8;Barcelona;6;Anoia;08176;Pujalt;1;1;A;;153;105;48;0;1;104;105
8;Barcelona;14;Berguedà;08177;Quar, la;1;1;A;;29;20;9;0;0;20;20
17;Girona;20;Gironès;17142;Quart;1;1;A;;506;350;156;1;2;347;349
17;Girona;20;Gironès;17142;Quart;1;1;B;;660;469;191;0;7;462;469
17;Girona;31;Ripollès;17043;Queralbs;1;1;A;;181;138;43;0;0;138;138
43;Tarragona;1;Alt Camp;43120;Querol;1;1;A;;143;89;54;0;1;88;89
17;Girona;2;Alt Empordà;17143;Rabós;1;1;A;;125;81;44;0;0;81;81
8;Barcelona;7;Bages;08178;Rajadell;1;1;A;;226;155;71;1;0;154;154
43;Tarragona;30;Ribera d'Ebre;43121;Rasquera;1;1;A;;755;346;409;2;2;342;344
17;Girona;10;Baix Empordà;17144;Regencós;1;1;A;;197;163;34;3;2;158;160
8;Barcelona;40;Vallès Occidental;08179;Rellinars;1;1;A;;156;127;29;0;0;127;127
43;Tarragona;36;Tarragonès;43122;Renau;1;1;A;;44;34;10;0;0;34;34
43;Tarragona;8;Baix Camp;43123;Reus;1;1;A;;695;413;282;3;2;408;410
43;Tarragona;8;Baix Camp;43123;Reus;1;2;A;;590;346;244;2;3;341;344
43;Tarragona;8;Baix Camp;43123;Reus;1;3;A;;660;408;252;0;0;408;408
43;Tarragona;8;Baix Camp;43123;Reus;1;3;B;;703;422;281;4;5;413;418
43;Tarragona;8;Baix Camp;43123;Reus;1;4;A;;776;487;289;2;3;482;485
43;Tarragona;8;Baix Camp;43123;Reus;1;4;B;;794;525;269;1;8;516;524
43;Tarragona;8;Baix Camp;43123;Reus;10;1;A;;548;273;275;4;4;265;269
43;Tarragona;8;Baix Camp;43123;Reus;2;1;A;;762;433;329;1;2;430;432
43;Tarragona;8;Baix Camp;43123;Reus;2;2;A;;759;433;326;4;1;428;429
43;Tarragona;8;Baix Camp;43123;Reus;2;2;B;;841;501;340;3;3;495;498
43;Tarragona;8;Baix Camp;43123;Reus;2;3;A;;849;519;330;2;10;507;517
43;Tarragona;8;Baix Camp;43123;Reus;2;3;B;;620;378;242;0;4;374;378
43;Tarragona;8;Baix Camp;43123;Reus;2;3;C;;851;532;319;2;3;527;530
43;Tarragona;8;Baix Camp;43123;Reus;2;3;D;;765;461;304;1;4;456;460
43;Tarragona;8;Baix Camp;43123;Reus;2;4;A;;581;336;245;0;2;334;336
43;Tarragona;8;Baix Camp;43123;Reus;2;4;B;;550;297;253;0;3;294;297
43;Tarragona;8;Baix Camp;43123;Reus;2;4;C;;689;360;329;3;1;356;357
43;Tarragona;8;Baix Camp;43123;Reus;2;5;A;;793;479;314;0;1;478;479
43;Tarragona;8;Baix Camp;43123;Reus;2;6;A;;660;386;274;1;2;383;385
43;Tarragona;8;Baix Camp;43123;Reus;2;6;B;;716;362;354;0;0;362;362
43;Tarragona;8;Baix Camp;43123;Reus;2;6;C;;759;414;345;3;4;407;411
43;Tarragona;8;Baix Camp;43123;Reus;2;7;A;;1007;595;412;1;8;586;594
43;Tarragona;8;Baix Camp;43123;Reus;2;8;A;;643;312;331;3;1;308;309
43;Tarragona;8;Baix Camp;43123;Reus;2;8;B;;725;351;374;3;0;348;348
43;Tarragona;8;Baix Camp;43123;Reus;3;1;A;;989;559;430;0;7;552;559
43;Tarragona;8;Baix Camp;43123;Reus;3;10;A;;711;339;372;0;1;338;339
43;Tarragona;8;Baix Camp;43123;Reus;3;10;B;;825;347;478;1;1;345;346
43;Tarragona;8;Baix Camp;43123;Reus;3;10;C;;765;368;397;0;3;365;368
43;Tarragona;8;Baix Camp;43123;Reus;3;2;A;;609;333;276;0;1;332;333
43;Tarragona;8;Baix Camp;43123;Reus;3;3;A;;960;565;395;0;6;559;565
43;Tarragona;8;Baix Camp;43123;Reus;3;4;A;;846;435;411;5;2;428;430
43;Tarragona;8;Baix Camp;43123;Reus;3;5;A;;974;590;384;3;1;586;587
43;Tarragona;8;Baix Camp;43123;Reus;3;6;A;;791;413;378;2;3;408;411
43;Tarragona;8;Baix Camp;43123;Reus;3;6;B;;896;480;416;9;5;466;471
43;Tarragona;8;Baix Camp;43123;Reus;3;7;A;;521;248;273;2;3;243;246
43;Tarragona;8;Baix Camp;43123;Reus;3;8;A;;707;392;315;0;4;388;392
43;Tarragona;8;Baix Camp;43123;Reus;3;8;B;;869;441;428;0;6;435;441
43;Tarragona;8;Baix Camp;43123;Reus;3;9;A;;1184;627;557;9;3;615;618
43;Tarragona;8;Baix Camp;43123;Reus;4;1;A;;836;439;397;1;2;436;438
43;Tarragona;8;Baix Camp;43123;Reus;4;2;A;;652;357;295;5;0;352;352
43;Tarragona;8;Baix Camp;43123;Reus;4;2;B;;646;337;309;7;0;330;330
43;Tarragona;8;Baix Camp;43123;Reus;4;3;A;;685;373;312;0;2;371;373
43;Tarragona;8;Baix Camp;43123;Reus;4;4;A;;1014;547;467;5;3;539;542
43;Tarragona;8;Baix Camp;43123;Reus;4;5;A;;1033;522;511;1;2;519;521
43;Tarragona;8;Baix Camp;43123;Reus;4;6;A;;1098;583;515;0;1;582;583
43;Tarragona;8;Baix Camp;43123;Reus;5;1;A;;873;455;418;5;3;447;450
43;Tarragona;8;Baix Camp;43123;Reus;5;1;B;;890;487;403;4;2;481;483
43;Tarragona;8;Baix Camp;43123;Reus;5;2;A;;565;296;269;0;2;294;296
43;Tarragona;8;Baix Camp;43123;Reus;5;2;B;;714;374;340;3;5;366;371
43;Tarragona;8;Baix Camp;43123;Reus;5;3;A;;558;324;234;1;0;323;323
43;Tarragona;8;Baix Camp;43123;Reus;5;3;B;;604;310;294;3;2;305;307
43;Tarragona;8;Baix Camp;43123;Reus;5;4;A;;902;472;430;3;3;466;469
43;Tarragona;8;Baix Camp;43123;Reus;5;5;A;;697;418;279;10;0;408;408
43;Tarragona;8;Baix Camp;43123;Reus;5;5;B;;868;503;365;6;2;495;497
43;Tarragona;8;Baix Camp;43123;Reus;6;1;A;;817;493;324;0;2;491;493
43;Tarragona;8;Baix Camp;43123;Reus;6;1;B;;858;546;312;6;2;538;540
43;Tarragona;8;Baix Camp;43123;Reus;6;2;A;;714;477;237;0;5;472;477
43;Tarragona;8;Baix Camp;43123;Reus;6;2;B;;739;481;258;5;2;474;476
43;Tarragona;8;Baix Camp;43123;Reus;6;3;A;;641;393;248;3;5;385;390
43;Tarragona;8;Baix Camp;43123;Reus;6;3;B;;630;390;240;1;0;389;389
43;Tarragona;8;Baix Camp;43123;Reus;6;4;A;;673;421;252;1;5;415;420
43;Tarragona;8;Baix Camp;43123;Reus;6;4;B;;711;442;269;3;6;433;439
43;Tarragona;8;Baix Camp;43123;Reus;6;5;A;;791;441;350;2;5;434;439
43;Tarragona;8;Baix Camp;43123;Reus;6;5;B;;946;548;398;2;2;544;546
43;Tarragona;8;Baix Camp;43123;Reus;6;6;A;;1149;760;389;8;4;748;752
43;Tarragona;8;Baix Camp;43123;Reus;6;7;A;;522;346;176;1;3;342;345
43;Tarragona;8;Baix Camp;43123;Reus;6;7;B;;661;441;220;0;2;439;441
43;Tarragona;8;Baix Camp;43123;Reus;6;8;A;;888;456;432;0;2;454;456
43;Tarragona;8;Baix Camp;43123;Reus;7;1;A;;581;226;355;0;0;226;226
43;Tarragona;8;Baix Camp;43123;Reus;7;1;B;;668;242;426;2;1;239;240
43;Tarragona;8;Baix Camp;43123;Reus;7;1;C;;636;264;372;0;1;263;264
43;Tarragona;8;Baix Camp;43123;Reus;7;2;A;;738;360;378;0;0;360;360
43;Tarragona;8;Baix Camp;43123;Reus;8;1;A;;670;348;322;1;1;346;347
43;Tarragona;8;Baix Camp;43123;Reus;8;1;B;;747;365;382;2;1;362;363
43;Tarragona;8;Baix Camp;43123;Reus;8;2;A;;837;375;462;8;0;367;367
43;Tarragona;8;Baix Camp;43123;Reus;8;3;A;;819;418;401;7;3;408;411
43;Tarragona;8;Baix Camp;43123;Reus;8;3;B;;968;444;524;2;0;442;442
43;Tarragona;8;Baix Camp;43123;Reus;8;4;A;;903;425;478;3;3;419;422
43;Tarragona;8;Baix Camp;43123;Reus;9;1;A;;1027;522;505;0;3;519;522
25;Lleida;26;Pallars Sobirà;25183;Rialp;1;1;A;;356;236;120;1;0;235;235
43;Tarragona;1;Alt Camp;43124;Riba, la;1;1;A;;762;556;206;4;2;550;552
43;Tarragona;30;Ribera d'Ebre;43125;Riba-roja d'Ebre;1;1;A;;816;492;324;7;4;481;485
43;Tarragona;30;Ribera d'Ebre;43125;Riba-roja d'Ebre;1;1;B;;574;314;260;1;1;312;313
25;Lleida;32;Segarra;25905;Ribera d'Ondara;1;1;A;;423;268;155;0;0;268;268
25;Lleida;4;Alt Urgell;25185;Ribera d'Urgellet;1;1;A;;693;354;339;0;1;353;354
17;Girona;31;Ripollès;17145;Ribes de Freser;1;1;A;;407;311;96;0;1;310;311
17;Girona;31;Ripollès;17145;Ribes de Freser;1;1;B;;612;454;158;1;2;451;453
17;Girona;31;Ripollès;17145;Ribes de Freser;1;2;A;;421;293;128;1;0;292;292
17;Girona;31;Ripollès;17145;Ribes de Freser;1;2;B;;594;419;175;4;3;412;415
17;Girona;34;Selva;17146;Riells i Viabrea;1;1;A;;573;412;161;0;0;412;412
43;Tarragona;36;Tarragonès;43126;Riera de Gaià, la;1;1;A;;731;557;174;1;2;554;556
25;Lleida;35;Solsonès;25186;Riner;1;1;A;;223;168;55;0;0;168;168
17;Girona;31;Ripollès;17147;Ripoll;1;1;A;;613;434;179;2;5;427;432
17;Girona;31;Ripollès;17147;Ripoll;1;2;A;;949;611;338;1;2;608;610
17;Girona;31;Ripollès;17147;Ripoll;2;1;A;;948;683;265;3;10;670;680
17;Girona;31;Ripollès;17147;Ripoll;2;2;A;;612;383;229;1;2;380;382
17;Girona;31;Ripollès;17147;Ripoll;2;2;B;;727;490;237;3;2;485;487
17;Girona;31;Ripollès;17147;Ripoll;3;1;A;;875;580;295;1;4;575;579
17;Girona;31;Ripollès;17147;Ripoll;3;2;A;;774;546;228;3;3;540;543
17;Girona;31;Ripollès;17147;Ripoll;3;3;A;;641;459;182;2;0;457;457
17;Girona;31;Ripollès;17147;Ripoll;3;3;B;;785;582;203;1;3;578;581
17;Girona;31;Ripollès;17147;Ripoll;3;4;A;;625;423;202;1;4;418;422
17;Girona;31;Ripollès;17147;Ripoll;3;4;B;;731;454;277;0;8;446;454
17;Girona;31;Ripollès;17147;Ripoll;4;1;A;;887;599;288;4;3;592;595
8;Barcelona;40;Vallès Occidental;08180;Ripollet;1;1;A;;1198;615;583;0;4;611;615
8;Barcelona;40;Vallès Occidental;08180;Ripollet;1;2;A;;583;373;210;0;1;372;373
8;Barcelona;40;Vallès Occidental;08180;Ripollet;1;2;B;;728;448;280;0;8;440;448
8;Barcelona;40;Vallès Occidental;08180;Ripollet;1;3;A;;562;329;233;1;5;323;328
8;Barcelona;40;Vallès Occidental;08180;Ripollet;1;3;B;;777;445;332;0;0;445;445
8;Barcelona;40;Vallès Occidental;08180;Ripollet;1;4;A;;1054;679;375;0;5;674;679
8;Barcelona;40;Vallès Occidental;08180;Ripollet;1;5;A;;952;471;481;0;3;468;471
8;Barcelona;40;Vallès Occidental;08180;Ripollet;1;6;A;;616;347;269;1;4;342;346
8;Barcelona;40;Vallès Occidental;08180;Ripollet;1;6;B;;783;423;360;1;4;418;422
8;Barcelona;40;Vallès Occidental;08180;Ripollet;1;7;A;;703;342;361;0;2;340;342
8;Barcelona;40;Vallès Occidental;08180;Ripollet;1;7;B;;798;388;410;0;6;382;388
8;Barcelona;40;Vallès Occidental;08180;Ripollet;1;8;A;;1222;600;622;1;3;596;599
8;Barcelona;40;Vallès Occidental;08180;Ripollet;2;1;A;;1251;578;673;1;6;571;577
8;Barcelona;40;Vallès Occidental;08180;Ripollet;2;2;A;;1116;586;530;7;3;576;579
8;Barcelona;40;Vallès Occidental;08180;Ripollet;2;3;A;;627;330;297;1;0;329;329
8;Barcelona;40;Vallès Occidental;08180;Ripollet;2;3;B;;776;395;381;2;0;393;393
8;Barcelona;40;Vallès Occidental;08180;Ripollet;2;4;A;;1261;686;575;3;3;680;683
8;Barcelona;40;Vallès Occidental;08180;Ripollet;2;5;A;;1179;576;603;0;0;576;576
8;Barcelona;40;Vallès Occidental;08180;Ripollet;2;6;A;;562;281;281;1;0;280;280
8;Barcelona;40;Vallès Occidental;08180;Ripollet;2;6;B;;760;385;375;6;0;379;379
8;Barcelona;40;Vallès Occidental;08180;Ripollet;2;7;A;;1133;555;578;4;3;548;551
17;Girona;34;Selva;17148;Riudarenes;1;1;A;;894;604;290;2;11;591;602
17;Girona;19;Garrotxa;17149;Riudaura;1;1;A;;299;199;100;1;0;198;198
43;Tarragona;8;Baix Camp;43127;Riudecanyes;1;1;A;;498;352;146;0;3;349;352
43;Tarragona;8;Baix Camp;43128;Riudecols;1;1;A;;730;529;201;2;3;524;527
17;Girona;34;Selva;17150;Riudellots de la Selva;1;1;A;;907;663;244;9;4;650;654
43;Tarragona;8;Baix Camp;43129;Riudoms;1;1;A;;557;316;241;13;5;298;303
43;Tarragona;8;Baix Camp;43129;Riudoms;1;1;B;;524;295;229;8;3;284;287
43;Tarragona;8;Baix Camp;43129;Riudoms;2;1;A;;1005;637;368;5;16;616;632
43;Tarragona;8;Baix Camp;43129;Riudoms;2;2;A;;790;423;367;6;6;411;417
43;Tarragona;8;Baix Camp;43129;Riudoms;2;2;B;;738;400;338;11;10;379;389
17;Girona;2;Alt Empordà;17151;Riumors;1;1;A;;163;105;58;0;0;105;105
8;Barcelona;41;Vallès Oriental;08181;Roca del Vallès, la;1;1;A;;473;276;197;2;0;274;274
8;Barcelona;41;Vallès Oriental;08181;Roca del Vallès, la;1;1;B;;505;295;210;2;0;293;293
8;Barcelona;41;Vallès Oriental;08181;Roca del Vallès, la;1;2;A;;668;405;263;9;5;391;396
8;Barcelona;41;Vallès Oriental;08181;Roca del Vallès, la;1;2;B;;693;402;291;3;2;397;399
8;Barcelona;41;Vallès Oriental;08181;Roca del Vallès, la;1;3;A;;512;280;232;1;1;278;279
8;Barcelona;41;Vallès Oriental;08181;Roca del Vallès, la;1;3;B;;627;352;275;0;2;350;352
8;Barcelona;41;Vallès Oriental;08181;Roca del Vallès, la;2;1;A;;360;241;119;0;2;239;241
43;Tarragona;16;Conca de Barberà;43130;Rocafort de Queralt;1;1;A;;237;165;72;0;2;163;165
43;Tarragona;36;Tarragonès;43131;Roda de Berà;1;1;A;;1219;848;371;3;1;844;845
8;Barcelona;24;Osona;08183;Roda de Ter;1;1;A;;629;428;201;9;5;414;419
8;Barcelona;24;Osona;08183;Roda de Ter;1;1;B;;680;450;230;0;2;448;450
8;Barcelona;24;Osona;08183;Roda de Ter;1;2;A;;582;433;149;0;0;433;433
8;Barcelona;24;Osona;08183;Roda de Ter;1;3;A;;899;606;293;2;3;601;604
8;Barcelona;24;Osona;08183;Roda de Ter;2;1;A;;815;574;241;0;5;569;574
43;Tarragona;1;Alt Camp;43132;Rodonyà;1;1;A;;317;201;116;1;1;199;200
43;Tarragona;9;Baix Ebre;43133;Roquetes;1;1;A;;724;419;305;7;3;409;412
43;Tarragona;9;Baix Ebre;43133;Roquetes;1;1;B;;529;295;234;2;3;290;293
43;Tarragona;9;Baix Ebre;43133;Roquetes;1;2;A;;882;458;424;2;6;450;456
43;Tarragona;9;Baix Ebre;43133;Roquetes;2;1;A;;898;492;406;2;7;483;490
43;Tarragona;9;Baix Ebre;43133;Roquetes;2;1;B;;720;403;317;0;0;403;403
43;Tarragona;9;Baix Ebre;43133;Roquetes;2;2;A;;748;355;393;2;2;351;353
17;Girona;2;Alt Empordà;17152;Roses;1;1;A;;723;470;253;4;2;464;466
17;Girona;2;Alt Empordà;17152;Roses;1;2;A;;686;393;293;1;3;389;392
17;Girona;2;Alt Empordà;17152;Roses;1;2;B;;737;402;335;0;0;402;402
17;Girona;2;Alt Empordà;17152;Roses;1;2;C;;693;384;309;1;2;381;383
17;Girona;2;Alt Empordà;17152;Roses;2;1;A;;759;486;273;0;5;481;486
17;Girona;2;Alt Empordà;17152;Roses;2;2;A;;756;467;289;2;6;459;465
17;Girona;2;Alt Empordà;17152;Roses;2;2;B;;913;562;351;1;3;558;561
17;Girona;2;Alt Empordà;17152;Roses;2;3;A;;1140;702;438;1;6;695;701
25;Lleida;33;Segrià;25189;Rosselló;1;1;A;;1174;743;431;0;6;737;743
43;Tarragona;1;Alt Camp;43134;Rourell, el;1;1;A;;244;190;54;0;2;188;190
8;Barcelona;40;Vallès Occidental;08184;Rubí;1;1;A;;362;157;205;1;1;155;156
8;Barcelona;40;Vallès Occidental;08184;Rubí;1;1;B;;487;199;288;2;2;195;197
8;Barcelona;40;Vallès Occidental;08184;Rubí;1;2;A;;676;329;347;4;2;323;325
8;Barcelona;40;Vallès Occidental;08184;Rubí;1;2;B;;804;409;395;2;1;406;407
8;Barcelona;40;Vallès Occidental;08184;Rubí;2;1;A;;449;211;238;0;1;210;211
8;Barcelona;40;Vallès Occidental;08184;Rubí;2;1;B;;551;270;281;6;0;264;264
8;Barcelona;40;Vallès Occidental;08184;Rubí;3;1;A;;387;188;199;0;0;188;188
8;Barcelona;40;Vallès Occidental;08184;Rubí;3;1;B;;458;246;212;1;1;244;245
8;Barcelona;40;Vallès Occidental;08184;Rubí;3;2;A;;625;279;346;6;0;273;273
8;Barcelona;40;Vallès Occidental;08184;Rubí;3;3;A;;452;222;230;4;4;214;218
8;Barcelona;40;Vallès Occidental;08184;Rubí;3;3;B;;584;255;329;2;2;251;253
8;Barcelona;40;Vallès Occidental;08184;Rubí;3;4;A;;649;284;365;0;3;281;284
8;Barcelona;40;Vallès Occidental;08184;Rubí;3;4;B;;689;286;403;2;4;280;284
8;Barcelona;40;Vallès Occidental;08184;Rubí;3;5;A;;626;329;297;0;4;325;329
8;Barcelona;40;Vallès Occidental;08184;Rubí;3;5;B;;838;412;426;1;1;410;411
8;Barcelona;40;Vallès Occidental;08184;Rubí;3;6;A;;533;271;262;0;0;271;271
8;Barcelona;40;Vallès Occidental;08184;Rubí;3;6;B;;575;294;281;1;2;291;293
8;Barcelona;40;Vallès Occidental;08184;Rubí;3;7;A;;396;193;203;0;3;190;193
8;Barcelona;40;Vallès Occidental;08184;Rubí;3;7;B;;488;256;232;0;6;250;256
8;Barcelona;40;Vallès Occidental;08184;Rubí;3;8;A;;744;395;349;11;2;382;384
8;Barcelona;40;Vallès Occidental;08184;Rubí;3;8;B;;854;488;366;1;5;482;487
8;Barcelona;40;Vallès Occidental;08184;Rubí;4;1;A;;543;333;210;2;4;327;331
8;Barcelona;40;Vallès Occidental;08184;Rubí;4;1;B;;618;358;260;1;2;355;357
8;Barcelona;40;Vallès Occidental;08184;Rubí;4;10;A;;589;263;326;0;0;263;263
8;Barcelona;40;Vallès Occidental;08184;Rubí;4;10;B;;725;301;424;8;0;293;293
8;Barcelona;40;Vallès Occidental;08184;Rubí;4;11;A;;442;230;212;6;3;221;224
8;Barcelona;40;Vallès Occidental;08184;Rubí;4;11;B;;509;279;230;4;3;272;275
8;Barcelona;40;Vallès Occidental;08184;Rubí;4;11;C;;571;301;270;3;1;297;298
8;Barcelona;40;Vallès Occidental;08184;Rubí;4;12;A;;490;215;275;2;1;212;213
8;Barcelona;40;Vallès Occidental;08184;Rubí;4;12;B;;578;243;335;0;0;243;243
8;Barcelona;40;Vallès Occidental;08184;Rubí;4;12;C;;539;226;313;1;4;221;225
8;Barcelona;40;Vallès Occidental;08184;Rubí;4;13;A;;532;271;261;1;1;269;270
8;Barcelona;40;Vallès Occidental;08184;Rubí;4;13;B;;553;279;274;3;3;273;276
8;Barcelona;40;Vallès Occidental;08184;Rubí;4;13;C;;552;291;261;2;1;288;289
8;Barcelona;40;Vallès Occidental;08184;Rubí;4;14;A;;446;214;232;9;0;205;205
8;Barcelona;40;Vallès Occidental;08184;Rubí;4;14;B;;510;218;292;4;1;213;214
8;Barcelona;40;Vallès Occidental;08184;Rubí;4;15;A;;382;178;204;0;0;178;178
8;Barcelona;40;Vallès Occidental;08184;Rubí;4;15;B;;630;324;306;0;1;323;324
8;Barcelona;40;Vallès Occidental;08184;Rubí;4;15;C;;547;294;253;3;2;289;291
8;Barcelona;40;Vallès Occidental;08184;Rubí;4;16;A;;471;232;239;4;1;227;228
8;Barcelona;40;Vallès Occidental;08184;Rubí;4;16;B;;634;279;355;12;2;265;267
8;Barcelona;40;Vallès Occidental;08184;Rubí;4;17;A;;343;172;171;5;3;164;167
8;Barcelona;40;Vallès Occidental;08184;Rubí;4;2;A;;417;263;154;1;0;262;262
8;Barcelona;40;Vallès Occidental;08184;Rubí;4;2;B;;543;330;213;2;4;324;328
8;Barcelona;40;Vallès Occidental;08184;Rubí;4;3;A;;708;289;419;0;1;288;289
8;Barcelona;40;Vallès Occidental;08184;Rubí;4;4;A;;610;311;299;0;1;310;311
8;Barcelona;40;Vallès Occidental;08184;Rubí;4;4;B;;692;355;337;4;0;351;351
8;Barcelona;40;Vallès Occidental;08184;Rubí;4;5;A;;589;384;205;1;4;379;383
8;Barcelona;40;Vallès Occidental;08184;Rubí;4;5;B;;670;418;252;3;2;413;415
8;Barcelona;40;Vallès Occidental;08184;Rubí;4;6;A;;508;268;240;1;0;267;267
8;Barcelona;40;Vallès Occidental;08184;Rubí;4;6;B;;572;310;262;1;2;307;309
8;Barcelona;40;Vallès Occidental;08184;Rubí;4;7;A;;622;345;277;0;1;344;345
8;Barcelona;40;Vallès Occidental;08184;Rubí;4;7;B;;607;329;278;1;4;324;328
8;Barcelona;40;Vallès Occidental;08184;Rubí;4;7;C;;703;353;350;2;2;349;351
8;Barcelona;40;Vallès Occidental;08184;Rubí;4;8;A;;727;312;415;0;2;310;312
8;Barcelona;40;Vallès Occidental;08184;Rubí;4;8;B;;846;376;470;0;2;374;376
8;Barcelona;40;Vallès Occidental;08184;Rubí;4;9;A;;374;177;197;3;4;170;174
8;Barcelona;40;Vallès Occidental;08184;Rubí;4;9;B;;507;245;262;0;2;243;245
8;Barcelona;6;Anoia;08185;Rubió;1;1;A;;109;53;56;0;0;53;53
17;Girona;10;Baix Empordà;17153;Rupià;1;1;A;;174;113;61;0;0;113;113
8;Barcelona;24;Osona;08901;Rupit i Pruit;1;1;A;;284;201;83;0;0;201;201
8;Barcelona;40;Vallès Occidental;08187;Sabadell;1;1;A;;762;601;161;0;0;601;601
8;Barcelona;40;Vallès Occidental;08187;Sabadell;1;10;A;;734;511;223;0;3;508;511
8;Barcelona;40;Vallès Occidental;08187;Sabadell;1;11;A;;892;632;260;2;4;626;630
8;Barcelona;40;Vallès Occidental;08187;Sabadell;1;12;A;;1531;1067;464;3;12;1052;1064
8;Barcelona;40;Vallès Occidental;08187;Sabadell;1;13;A;;791;546;245;0;3;543;546
8;Barcelona;40;Vallès Occidental;08187;Sabadell;1;14;A;;1304;971;333;4;5;962;967
8;Barcelona;40;Vallès Occidental;08187;Sabadell;1;15;A;;1191;882;309;0;4;878;882
8;Barcelona;40;Vallès Occidental;08187;Sabadell;1;16;A;;1121;798;323;1;7;790;797
8;Barcelona;40;Vallès Occidental;08187;Sabadell;1;17;A;;1329;889;440;4;3;882;885
8;Barcelona;40;Vallès Occidental;08187;Sabadell;1;18;A;;820;517;303;1;0;516;516
8;Barcelona;40;Vallès Occidental;08187;Sabadell;1;19;A;;1233;898;335;2;9;887;896
8;Barcelona;40;Vallès Occidental;08187;Sabadell;1;2;A;;1429;1102;327;1;6;1095;1101
8;Barcelona;40;Vallès Occidental;08187;Sabadell;1;20;A;;1378;841;537;5;5;831;836
8;Barcelona;40;Vallès Occidental;08187;Sabadell;1;21;A;;896;593;303;0;1;592;593
8;Barcelona;40;Vallès Occidental;08187;Sabadell;1;22;A;;1146;726;420;8;2;716;718
8;Barcelona;40;Vallès Occidental;08187;Sabadell;1;23;A;;1174;697;477;1;0;696;696
8;Barcelona;40;Vallès Occidental;08187;Sabadell;1;24;A;;1046;577;469;1;3;573;576
8;Barcelona;40;Vallès Occidental;08187;Sabadell;1;25;A;;1148;679;469;2;2;675;677
8;Barcelona;40;Vallès Occidental;08187;Sabadell;1;26;A;;875;583;292;5;0;578;578
8;Barcelona;40;Vallès Occidental;08187;Sabadell;1;27;A;;731;483;248;1;0;482;482
8;Barcelona;40;Vallès Occidental;08187;Sabadell;1;28;A;;982;613;369;1;3;609;612
8;Barcelona;40;Vallès Occidental;08187;Sabadell;1;29;A;;1318;842;476;7;10;825;835
8;Barcelona;40;Vallès Occidental;08187;Sabadell;1;3;A;;828;587;241;0;4;583;587
8;Barcelona;40;Vallès Occidental;08187;Sabadell;1;4;A;;1090;769;321;0;7;762;769
8;Barcelona;40;Vallès Occidental;08187;Sabadell;1;5;A;;1385;1004;381;0;3;1001;1004
8;Barcelona;40;Vallès Occidental;08187;Sabadell;1;6;A;;1073;824;249;0;7;817;824
8;Barcelona;40;Vallès Occidental;08187;Sabadell;1;7;A;;778;580;198;1;4;575;579
8;Barcelona;40;Vallès Occidental;08187;Sabadell;1;8;A;;920;666;254;3;1;662;663
8;Barcelona;40;Vallès Occidental;08187;Sabadell;1;9;A;;1221;927;294;2;6;919;925
8;Barcelona;40;Vallès Occidental;08187;Sabadell;2;1;A;;1118;818;300;2;11;805;816
8;Barcelona;40;Vallès Occidental;08187;Sabadell;2;10;A;;328;154;174;0;0;154;154
8;Barcelona;40;Vallès Occidental;08187;Sabadell;2;11;A;;733;323;410;2;0;321;321
8;Barcelona;40;Vallès Occidental;08187;Sabadell;2;12;A;;1367;652;715;3;6;643;649
8;Barcelona;40;Vallès Occidental;08187;Sabadell;2;13;A;;958;563;395;2;1;560;561
8;Barcelona;40;Vallès Occidental;08187;Sabadell;2;14;A;;691;390;301;2;0;388;388
8;Barcelona;40;Vallès Occidental;08187;Sabadell;2;14;B;;805;460;345;0;1;459;460
8;Barcelona;40;Vallès Occidental;08187;Sabadell;2;15;A;;970;553;417;0;5;548;553
8;Barcelona;40;Vallès Occidental;08187;Sabadell;2;16;A;;1312;899;413;9;1;889;890
8;Barcelona;40;Vallès Occidental;08187;Sabadell;2;2;A;;909;680;229;1;4;675;679
8;Barcelona;40;Vallès Occidental;08187;Sabadell;2;3;A;;1243;702;541;3;5;694;699
8;Barcelona;40;Vallès Occidental;08187;Sabadell;2;4;A;;1404;950;454;3;7;940;947
8;Barcelona;40;Vallès Occidental;08187;Sabadell;2;5;A;;1277;916;361;1;3;912;915
8;Barcelona;40;Vallès Occidental;08187;Sabadell;2;6;A;;1291;906;385;12;5;889;894
8;Barcelona;40;Vallès Occidental;08187;Sabadell;2;7;A;;1217;812;405;1;7;804;811
8;Barcelona;40;Vallès Occidental;08187;Sabadell;2;8;A;;1076;702;374;1;2;699;701
8;Barcelona;40;Vallès Occidental;08187;Sabadell;2;9;A;;1210;774;436;2;1;771;772
8;Barcelona;40;Vallès Occidental;08187;Sabadell;3;1;A;;1078;609;469;3;2;604;606
8;Barcelona;40;Vallès Occidental;08187;Sabadell;3;10;A;;623;370;253;2;2;366;368
8;Barcelona;40;Vallès Occidental;08187;Sabadell;3;11;A;;996;562;434;0;2;560;562
8;Barcelona;40;Vallès Occidental;08187;Sabadell;3;12;A;;830;520;310;0;1;519;520
8;Barcelona;40;Vallès Occidental;08187;Sabadell;3;13;A;;1054;622;432;1;3;618;621
8;Barcelona;40;Vallès Occidental;08187;Sabadell;3;14;A;;695;449;246;4;0;445;445
8;Barcelona;40;Vallès Occidental;08187;Sabadell;3;14;B;;836;492;344;0;1;491;492
8;Barcelona;40;Vallès Occidental;08187;Sabadell;3;15;A;;1259;716;543;0;4;712;716
8;Barcelona;40;Vallès Occidental;08187;Sabadell;3;16;A;;1184;734;450;12;2;720;722
8;Barcelona;40;Vallès Occidental;08187;Sabadell;3;17;A;;1395;785;610;0;3;782;785
8;Barcelona;40;Vallès Occidental;08187;Sabadell;3;18;A;;894;524;370;1;0;523;523
8;Barcelona;40;Vallès Occidental;08187;Sabadell;3;19;A;;886;472;414;0;0;472;472
8;Barcelona;40;Vallès Occidental;08187;Sabadell;3;2;A;;1032;508;524;2;0;506;506
8;Barcelona;40;Vallès Occidental;08187;Sabadell;3;20;A;;736;375;361;1;0;374;374
8;Barcelona;40;Vallès Occidental;08187;Sabadell;3;21;A;;1186;689;497;2;2;685;687
8;Barcelona;40;Vallès Occidental;08187;Sabadell;3;22;A;;760;436;324;0;0;436;436
8;Barcelona;40;Vallès Occidental;08187;Sabadell;3;23;A;;630;406;224;0;0;406;406
8;Barcelona;40;Vallès Occidental;08187;Sabadell;3;3;A;;1325;668;657;3;3;662;665
8;Barcelona;40;Vallès Occidental;08187;Sabadell;3;4;A;;1344;779;565;0;1;778;779
8;Barcelona;40;Vallès Occidental;08187;Sabadell;3;5;A;;1434;817;617;0;8;809;817
8;Barcelona;40;Vallès Occidental;08187;Sabadell;3;6;A;;837;502;335;4;2;496;498
8;Barcelona;40;Vallès Occidental;08187;Sabadell;3;7;A;;792;498;294;0;2;496;498
8;Barcelona;40;Vallès Occidental;08187;Sabadell;3;8;A;;853;447;406;0;0;447;447
8;Barcelona;40;Vallès Occidental;08187;Sabadell;3;9;A;;784;443;341;0;2;441;443
8;Barcelona;40;Vallès Occidental;08187;Sabadell;4;1;A;;977;499;478;1;1;497;498
8;Barcelona;40;Vallès Occidental;08187;Sabadell;4;10;A;;1283;641;642;0;3;638;641
8;Barcelona;40;Vallès Occidental;08187;Sabadell;4;11;A;;689;359;330;0;0;359;359
8;Barcelona;40;Vallès Occidental;08187;Sabadell;4;11;B;;785;382;403;3;3;376;379
8;Barcelona;40;Vallès Occidental;08187;Sabadell;4;12;A;;725;399;326;3;0;396;396
8;Barcelona;40;Vallès Occidental;08187;Sabadell;4;12;B;;867;455;412;2;4;449;453
8;Barcelona;40;Vallès Occidental;08187;Sabadell;4;13;A;;961;497;464;4;0;493;493
8;Barcelona;40;Vallès Occidental;08187;Sabadell;4;14;A;;945;578;367;0;2;576;578
8;Barcelona;40;Vallès Occidental;08187;Sabadell;4;15;A;;888;483;405;10;1;472;473
8;Barcelona;40;Vallès Occidental;08187;Sabadell;4;16;A;;1050;576;474;0;0;576;576
8;Barcelona;40;Vallès Occidental;08187;Sabadell;4;17;A;;624;303;321;0;3;300;303
8;Barcelona;40;Vallès Occidental;08187;Sabadell;4;17;B;;798;423;375;5;4;414;418
8;Barcelona;40;Vallès Occidental;08187;Sabadell;4;18;A;;619;343;276;1;3;339;342
8;Barcelona;40;Vallès Occidental;08187;Sabadell;4;19;A;;1303;682;621;2;2;678;680
8;Barcelona;40;Vallès Occidental;08187;Sabadell;4;2;A;;993;566;427;2;2;562;564
8;Barcelona;40;Vallès Occidental;08187;Sabadell;4;20;A;;998;529;469;1;4;524;528
8;Barcelona;40;Vallès Occidental;08187;Sabadell;4;3;A;;902;504;398;2;1;501;502
8;Barcelona;40;Vallès Occidental;08187;Sabadell;4;4;A;;1242;719;523;2;7;710;717
8;Barcelona;40;Vallès Occidental;08187;Sabadell;4;5;A;;1403;802;601;12;10;780;790
8;Barcelona;40;Vallès Occidental;08187;Sabadell;4;6;A;;1007;550;457;2;2;546;548
8;Barcelona;40;Vallès Occidental;08187;Sabadell;4;7;A;;755;392;363;1;4;387;391
8;Barcelona;40;Vallès Occidental;08187;Sabadell;4;8;A;;1210;723;487;4;2;717;719
8;Barcelona;40;Vallès Occidental;08187;Sabadell;4;9;A;;579;357;222;3;0;354;354
8;Barcelona;40;Vallès Occidental;08187;Sabadell;5;1;A;;1076;708;368;2;0;706;706
8;Barcelona;40;Vallès Occidental;08187;Sabadell;5;10;A;;842;490;352;20;8;462;470
8;Barcelona;40;Vallès Occidental;08187;Sabadell;5;11;A;;750;390;360;5;0;385;385
8;Barcelona;40;Vallès Occidental;08187;Sabadell;5;12;A;;935;510;425;3;7;500;507
8;Barcelona;40;Vallès Occidental;08187;Sabadell;5;13;A;;914;498;416;3;2;493;495
8;Barcelona;40;Vallès Occidental;08187;Sabadell;5;2;A;;749;518;231;1;0;517;517
8;Barcelona;40;Vallès Occidental;08187;Sabadell;5;3;A;;1263;905;358;3;6;896;902
8;Barcelona;40;Vallès Occidental;08187;Sabadell;5;4;A;;651;416;235;4;1;411;412
8;Barcelona;40;Vallès Occidental;08187;Sabadell;5;5;A;;1007;638;369;2;3;633;636
8;Barcelona;40;Vallès Occidental;08187;Sabadell;5;6;A;;957;675;282;3;3;669;672
8;Barcelona;40;Vallès Occidental;08187;Sabadell;5;7;A;;997;532;465;0;1;531;532
8;Barcelona;40;Vallès Occidental;08187;Sabadell;5;8;A;;916;570;346;5;5;560;565
8;Barcelona;40;Vallès Occidental;08187;Sabadell;5;9;A;;974;574;400;4;5;565;570
8;Barcelona;40;Vallès Occidental;08187;Sabadell;6;1;A;;536;336;200;0;4;332;336
8;Barcelona;40;Vallès Occidental;08187;Sabadell;6;10;A;;1021;502;519;0;1;501;502
8;Barcelona;40;Vallès Occidental;08187;Sabadell;6;11;A;;1223;559;664;1;2;556;558
8;Barcelona;40;Vallès Occidental;08187;Sabadell;6;12;A;;1210;640;570;0;2;638;640
8;Barcelona;40;Vallès Occidental;08187;Sabadell;6;13;A;;1068;504;564;0;7;497;504
8;Barcelona;40;Vallès Occidental;08187;Sabadell;6;14;A;;544;303;241;2;3;298;301
8;Barcelona;40;Vallès Occidental;08187;Sabadell;6;15;A;;1077;585;492;15;0;570;570
8;Barcelona;40;Vallès Occidental;08187;Sabadell;6;16;A;;1404;831;573;4;9;818;827
8;Barcelona;40;Vallès Occidental;08187;Sabadell;6;17;A;;1467;852;615;2;4;846;850
8;Barcelona;40;Vallès Occidental;08187;Sabadell;6;18;A;;1089;629;460;4;5;620;625
8;Barcelona;40;Vallès Occidental;08187;Sabadell;6;19;A;;727;494;233;0;3;491;494
8;Barcelona;40;Vallès Occidental;08187;Sabadell;6;2;A;;1247;744;503;0;3;741;744
8;Barcelona;40;Vallès Occidental;08187;Sabadell;6;20;A;;992;568;424;0;6;562;568
8;Barcelona;40;Vallès Occidental;08187;Sabadell;6;21;A;;875;509;366;4;4;501;505
8;Barcelona;40;Vallès Occidental;08187;Sabadell;6;22;A;;1252;629;623;1;7;621;628
8;Barcelona;40;Vallès Occidental;08187;Sabadell;6;23;A;;1354;739;615;2;3;734;737
8;Barcelona;40;Vallès Occidental;08187;Sabadell;6;3;A;;461;267;194;0;0;267;267
8;Barcelona;40;Vallès Occidental;08187;Sabadell;6;4;A;;809;488;321;2;0;486;486
8;Barcelona;40;Vallès Occidental;08187;Sabadell;6;5;A;;1041;538;503;3;1;534;535
8;Barcelona;40;Vallès Occidental;08187;Sabadell;6;6;A;;792;452;340;3;0;449;449
8;Barcelona;40;Vallès Occidental;08187;Sabadell;6;7;A;;931;508;423;4;0;504;504
8;Barcelona;40;Vallès Occidental;08187;Sabadell;6;8;A;;726;441;285;0;4;437;441
8;Barcelona;40;Vallès Occidental;08187;Sabadell;6;8;B;;846;519;327;2;1;516;517
8;Barcelona;40;Vallès Occidental;08187;Sabadell;6;9;A;;736;419;317;1;2;416;418
8;Barcelona;40;Vallès Occidental;08187;Sabadell;6;9;B;;876;465;411;0;1;464;465
8;Barcelona;40;Vallès Occidental;08187;Sabadell;7;1;A;;888;568;320;0;0;568;568
8;Barcelona;40;Vallès Occidental;08187;Sabadell;7;2;A;;1041;717;324;2;2;713;715
8;Barcelona;40;Vallès Occidental;08187;Sabadell;7;3;A;;1324;801;523;0;1;800;801
8;Barcelona;40;Vallès Occidental;08187;Sabadell;7;4;A;;733;468;265;1;3;464;467
8;Barcelona;40;Vallès Occidental;08187;Sabadell;7;5;A;;615;417;198;0;1;416;417
8;Barcelona;40;Vallès Occidental;08187;Sabadell;7;6;A;;609;400;209;0;4;396;400
8;Barcelona;14;Berguedà;08188;Sagàs;1;1;A;;171;114;57;2;2;110;112
25;Lleida;25;Pallars Jussà;25190;Salàs de Pallars;1;1;A;;329;225;104;0;1;224;225
8;Barcelona;14;Berguedà;08190;Saldes;1;1;A;;252;162;90;0;0;162;162
17;Girona;19;Garrotxa;17154;Sales de Llierca;1;1;A;;44;25;19;0;0;25;25
8;Barcelona;7;Bages;08191;Sallent;1;1;A;;636;472;164;2;2;468;470
8;Barcelona;7;Bages;08191;Sallent;1;2;A;;761;533;228;3;3;527;530
8;Barcelona;7;Bages;08191;Sallent;1;3;A;;507;363;144;1;2;360;362
8;Barcelona;7;Bages;08191;Sallent;1;3;B;;575;420;155;1;1;418;419
8;Barcelona;7;Bages;08191;Sallent;1;4;A;;452;274;178;5;1;268;269
8;Barcelona;7;Bages;08191;Sallent;1;4;B;;511;314;197;0;0;314;314
8;Barcelona;7;Bages;08191;Sallent;1;5;A;;690;432;258;0;2;430;432
8;Barcelona;7;Bages;08191;Sallent;1;6;A;;759;517;242;11;1;505;506
8;Barcelona;7;Bages;08191;Sallent;1;7;A;;614;322;292;3;2;317;319
8;Barcelona;7;Bages;08191;Sallent;2;1;A;;735;429;306;3;1;425;426
43;Tarragona;36;Tarragonès;43135;Salomó;1;1;A;;392;332;60;2;3;327;330
17;Girona;20;Gironès;17155;Salt;1;1;A;;1126;757;369;2;8;747;755
17;Girona;20;Gironès;17155;Salt;1;2;A;;895;587;308;5;0;582;582
17;Girona;20;Gironès;17155;Salt;1;3;A;;1072;679;393;1;4;674;678
17;Girona;20;Gironès;17155;Salt;1;4;A;;630;429;201;4;2;423;425
17;Girona;20;Gironès;17155;Salt;1;4;B;;749;516;233;4;6;506;512
17;Girona;20;Gironès;17155;Salt;1;5;A;;639;348;291;3;0;345;345
17;Girona;20;Gironès;17155;Salt;1;5;B;;756;423;333;1;2;420;422
17;Girona;20;Gironès;17155;Salt;1;6;A;;574;365;209;0;2;363;365
17;Girona;20;Gironès;17155;Salt;1;6;B;;730;464;266;3;7;454;461
17;Girona;20;Gironès;17155;Salt;1;7;A;;1009;632;377;5;11;616;627
17;Girona;20;Gironès;17155;Salt;1;8;A;;745;497;248;2;3;492;495
17;Girona;20;Gironès;17155;Salt;2;1;A;;569;355;214;0;3;352;355
17;Girona;20;Gironès;17155;Salt;2;1;B;;622;410;212;1;4;405;409
17;Girona;20;Gironès;17155;Salt;2;2;A;;933;567;366;3;2;562;564
17;Girona;20;Gironès;17155;Salt;2;3;A;;1110;661;449;4;4;653;657
17;Girona;20;Gironès;17155;Salt;2;4;A;;1204;452;752;4;3;445;448
17;Girona;20;Gironès;17155;Salt;2;5;A;;728;524;204;3;6;515;521
17;Girona;20;Gironès;17155;Salt;2;6;A;;877;495;382;1;7;487;494
25;Lleida;32;Segarra;25191;Sanaüja;1;1;A;;411;263;148;1;3;259;262
43;Tarragona;22;Montsià;43138;Santa Bàrbara;1;1;A;;825;555;270;8;5;542;547
43;Tarragona;22;Montsià;43138;Santa Bàrbara;1;1;B;;727;503;224;3;2;498;500
43;Tarragona;22;Montsià;43138;Santa Bàrbara;2;1;A;;545;335;210;3;1;331;332
43;Tarragona;22;Montsià;43138;Santa Bàrbara;2;1;B;;527;310;217;3;1;306;307
8;Barcelona;24;Osona;08243;Santa Cecília de Voltregà;1;1;A;;144;115;29;0;0;115;115
8;Barcelona;11;Baix Llobregat;08244;Santa Coloma de Cervelló;1;1;A;;1325;805;520;5;6;794;800
8;Barcelona;11;Baix Llobregat;08244;Santa Coloma de Cervelló;1;2;A;;688;480;208;4;2;474;476
17;Girona;34;Selva;17180;Santa Coloma de Farners;1;1;A;;671;420;251;0;0;420;420
17;Girona;34;Selva;17180;Santa Coloma de Farners;1;1;B;;651;413;238;3;3;407;410
17;Girona;34;Selva;17180;Santa Coloma de Farners;1;2;A;;517;356;161;3;1;352;353
17;Girona;34;Selva;17180;Santa Coloma de Farners;1;2;B;;498;338;160;1;0;337;337
17;Girona;34;Selva;17180;Santa Coloma de Farners;1;3;A;;622;421;201;1;5;415;420
17;Girona;34;Selva;17180;Santa Coloma de Farners;1;3;B;;585;384;201;2;6;376;382
17;Girona;34;Selva;17180;Santa Coloma de Farners;1;4;A;;559;342;217;1;1;340;341
17;Girona;34;Selva;17180;Santa Coloma de Farners;1;4;B;;637;377;260;1;1;375;376
17;Girona;34;Selva;17180;Santa Coloma de Farners;1;5;A;;460;260;200;0;1;259;260
17;Girona;34;Selva;17180;Santa Coloma de Farners;1;5;B;;558;348;210;5;0;343;343
8;Barcelona;13;Barcelonès;08245;Santa Coloma de Gramenet;1;1;A;;1004;615;389;0;3;612;615
8;Barcelona;13;Barcelonès;08245;Santa Coloma de Gramenet;1;10;A;;619;278;341;1;1;276;277
8;Barcelona;13;Barcelonès;08245;Santa Coloma de Gramenet;1;10;B;;679;306;373;0;2;304;306
8;Barcelona;13;Barcelonès;08245;Santa Coloma de Gramenet;1;11;A;;480;233;247;0;2;231;233
8;Barcelona;13;Barcelonès;08245;Santa Coloma de Gramenet;1;11;B;;562;273;289;0;2;271;273
8;Barcelona;13;Barcelonès;08245;Santa Coloma de Gramenet;1;12;A;;816;379;437;0;2;377;379
8;Barcelona;13;Barcelonès;08245;Santa Coloma de Gramenet;1;13;A;;511;250;261;0;1;249;250
8;Barcelona;13;Barcelonès;08245;Santa Coloma de Gramenet;1;13;B;;514;259;255;0;1;258;259
8;Barcelona;13;Barcelonès;08245;Santa Coloma de Gramenet;1;13;C;;477;244;233;1;0;243;243
8;Barcelona;13;Barcelonès;08245;Santa Coloma de Gramenet;1;14;A;;812;423;389;1;0;422;422
8;Barcelona;13;Barcelonès;08245;Santa Coloma de Gramenet;1;15;A;;749;369;380;6;1;362;363
8;Barcelona;13;Barcelonès;08245;Santa Coloma de Gramenet;1;16;A;;756;388;368;0;4;384;388
8;Barcelona;13;Barcelonès;08245;Santa Coloma de Gramenet;1;17;A;;649;304;345;1;0;303;303
8;Barcelona;13;Barcelonès;08245;Santa Coloma de Gramenet;1;17;B;;731;347;384;2;0;345;345
8;Barcelona;13;Barcelonès;08245;Santa Coloma de Gramenet;1;18;A;;541;292;249;1;1;290;291
8;Barcelona;13;Barcelonès;08245;Santa Coloma de Gramenet;1;18;B;;643;334;309;0;4;330;334
8;Barcelona;13;Barcelonès;08245;Santa Coloma de Gramenet;1;19;A;;588;255;333;0;1;254;255
8;Barcelona;13;Barcelonès;08245;Santa Coloma de Gramenet;1;19;B;;646;315;331;0;0;315;315
8;Barcelona;13;Barcelonès;08245;Santa Coloma de Gramenet;1;2;A;;695;367;328;1;1;365;366
8;Barcelona;13;Barcelonès;08245;Santa Coloma de Gramenet;1;3;A;;561;266;295;0;2;264;266
8;Barcelona;13;Barcelonès;08245;Santa Coloma de Gramenet;1;3;B;;663;328;335;0;1;327;328
8;Barcelona;13;Barcelonès;08245;Santa Coloma de Gramenet;1;4;A;;797;370;427;0;2;368;370
8;Barcelona;13;Barcelonès;08245;Santa Coloma de Gramenet;1;5;A;;778;410;368;0;1;409;410
8;Barcelona;13;Barcelonès;08245;Santa Coloma de Gramenet;1;6;A;;803;388;415;0;2;386;388
8;Barcelona;13;Barcelonès;08245;Santa Coloma de Gramenet;1;7;A;;686;321;365;5;2;314;316
8;Barcelona;13;Barcelonès;08245;Santa Coloma de Gramenet;1;8;A;;672;314;358;0;2;312;314
8;Barcelona;13;Barcelonès;08245;Santa Coloma de Gramenet;1;9;A;;558;273;285;1;4;268;272
8;Barcelona;13;Barcelonès;08245;Santa Coloma de Gramenet;1;9;B;;634;329;305;0;3;326;329
8;Barcelona;13;Barcelonès;08245;Santa Coloma de Gramenet;2;1;A;;885;443;442;0;1;442;443
8;Barcelona;13;Barcelonès;08245;Santa Coloma de Gramenet;2;10;A;;726;357;369;2;2;353;355
8;Barcelona;13;Barcelonès;08245;Santa Coloma de Gramenet;2;11;A;;572;240;332;1;0;239;239
8;Barcelona;13;Barcelonès;08245;Santa Coloma de Gramenet;2;11;B;;641;283;358;1;0;282;282
8;Barcelona;13;Barcelonès;08245;Santa Coloma de Gramenet;2;2;A;;443;228;215;1;1;226;227
8;Barcelona;13;Barcelonès;08245;Santa Coloma de Gramenet;2;2;B;;529;279;250;2;0;277;277
8;Barcelona;13;Barcelonès;08245;Santa Coloma de Gramenet;2;2;C;;440;214;226;0;0;214;214
8;Barcelona;13;Barcelonès;08245;Santa Coloma de Gramenet;2;3;A;;605;288;317;1;2;285;287
8;Barcelona;13;Barcelonès;08245;Santa Coloma de Gramenet;2;3;B;;762;337;425;0;0;337;337
8;Barcelona;13;Barcelonès;08245;Santa Coloma de Gramenet;2;4;A;;515;223;292;0;1;222;223
8;Barcelona;13;Barcelonès;08245;Santa Coloma de Gramenet;2;4;B;;633;282;351;0;0;282;282
8;Barcelona;13;Barcelonès;08245;Santa Coloma de Gramenet;2;5;A;;552;288;264;0;3;285;288
8;Barcelona;13;Barcelonès;08245;Santa Coloma de Gramenet;2;5;B;;644;344;300;1;2;341;343
8;Barcelona;13;Barcelonès;08245;Santa Coloma de Gramenet;2;6;A;;563;297;266;0;3;294;297
8;Barcelona;13;Barcelonès;08245;Santa Coloma de Gramenet;2;6;B;;659;312;347;0;1;311;312
8;Barcelona;13;Barcelonès;08245;Santa Coloma de Gramenet;2;7;A;;488;209;279;0;2;207;209
8;Barcelona;13;Barcelonès;08245;Santa Coloma de Gramenet;2;7;B;;518;217;301;0;0;217;217
8;Barcelona;13;Barcelonès;08245;Santa Coloma de Gramenet;2;7;C;;541;214;327;0;2;212;214
8;Barcelona;13;Barcelonès;08245;Santa Coloma de Gramenet;2;8;A;;505;247;258;0;0;247;247
8;Barcelona;13;Barcelonès;08245;Santa Coloma de Gramenet;2;8;B;;654;311;343;1;1;309;310
8;Barcelona;13;Barcelonès;08245;Santa Coloma de Gramenet;2;9;A;;1042;542;500;8;5;529;534
8;Barcelona;13;Barcelonès;08245;Santa Coloma de Gramenet;3;1;A;;849;390;459;5;1;384;385
8;Barcelona;13;Barcelonès;08245;Santa Coloma de Gramenet;3;10;A;;546;247;299;1;3;243;246
8;Barcelona;13;Barcelonès;08245;Santa Coloma de Gramenet;3;11;A;;780;371;409;1;4;366;370
8;Barcelona;13;Barcelonès;08245;Santa Coloma de Gramenet;3;12;A;;551;253;298;0;2;251;253
8;Barcelona;13;Barcelonès;08245;Santa Coloma de Gramenet;3;12;B;;748;356;392;1;1;354;355
8;Barcelona;13;Barcelonès;08245;Santa Coloma de Gramenet;3;13;A;;450;213;237;1;1;211;212
8;Barcelona;13;Barcelonès;08245;Santa Coloma de Gramenet;3;13;B;;543;251;292;0;1;250;251
8;Barcelona;13;Barcelonès;08245;Santa Coloma de Gramenet;3;13;C;;551;277;274;2;1;274;275
8;Barcelona;13;Barcelonès;08245;Santa Coloma de Gramenet;3;14;A;;971;496;475;0;3;493;496
8;Barcelona;13;Barcelonès;08245;Santa Coloma de Gramenet;3;15;A;;452;201;251;0;3;198;201
8;Barcelona;13;Barcelonès;08245;Santa Coloma de Gramenet;3;15;B;;472;227;245;0;0;227;227
8;Barcelona;13;Barcelonès;08245;Santa Coloma de Gramenet;3;16;A;;964;483;481;0;7;476;483
8;Barcelona;13;Barcelonès;08245;Santa Coloma de Gramenet;3;17;A;;957;300;657;2;5;293;298
8;Barcelona;13;Barcelonès;08245;Santa Coloma de Gramenet;3;2;A;;590;273;317;4;2;267;269
8;Barcelona;13;Barcelonès;08245;Santa Coloma de Gramenet;3;3;A;;897;468;429;3;0;465;465
8;Barcelona;13;Barcelonès;08245;Santa Coloma de Gramenet;3;4;A;;540;242;298;3;1;238;239
8;Barcelona;13;Barcelonès;08245;Santa Coloma de Gramenet;3;4;B;;672;318;354;2;2;314;316
8;Barcelona;13;Barcelonès;08245;Santa Coloma de Gramenet;3;5;A;;545;243;302;0;3;240;243
8;Barcelona;13;Barcelonès;08245;Santa Coloma de Gramenet;3;5;B;;679;298;381;0;2;296;298
8;Barcelona;13;Barcelonès;08245;Santa Coloma de Gramenet;3;6;A;;933;439;494;6;1;432;433
8;Barcelona;13;Barcelonès;08245;Santa Coloma de Gramenet;3;7;A;;479;229;250;2;1;226;227
8;Barcelona;13;Barcelonès;08245;Santa Coloma de Gramenet;3;7;B;;619;276;343;1;0;275;275
8;Barcelona;13;Barcelonès;08245;Santa Coloma de Gramenet;3;7;C;;501;213;288;0;0;213;213
8;Barcelona;13;Barcelonès;08245;Santa Coloma de Gramenet;3;8;A;;703;354;349;5;2;347;349
8;Barcelona;13;Barcelonès;08245;Santa Coloma de Gramenet;3;9;A;;901;426;475;1;0;425;425
8;Barcelona;13;Barcelonès;08245;Santa Coloma de Gramenet;4;1;A;;911;465;446;0;2;463;465
8;Barcelona;13;Barcelonès;08245;Santa Coloma de Gramenet;4;10;A;;522;243;279;0;2;241;243
8;Barcelona;13;Barcelonès;08245;Santa Coloma de Gramenet;4;10;B;;652;310;342;0;3;307;310
8;Barcelona;13;Barcelonès;08245;Santa Coloma de Gramenet;4;11;A;;1041;533;508;3;10;520;530
8;Barcelona;13;Barcelonès;08245;Santa Coloma de Gramenet;4;12;A;;925;466;459;1;4;461;465
8;Barcelona;13;Barcelonès;08245;Santa Coloma de Gramenet;4;13;A;;424;201;223;0;0;201;201
8;Barcelona;13;Barcelonès;08245;Santa Coloma de Gramenet;4;13;B;;459;215;244;0;1;214;215
8;Barcelona;13;Barcelonès;08245;Santa Coloma de Gramenet;4;14;A;;508;250;258;1;2;247;249
8;Barcelona;13;Barcelonès;08245;Santa Coloma de Gramenet;4;14;B;;575;278;297;0;0;278;278
8;Barcelona;13;Barcelonès;08245;Santa Coloma de Gramenet;4;14;C;;577;315;262;1;0;314;314
8;Barcelona;13;Barcelonès;08245;Santa Coloma de Gramenet;4;15;A;;572;259;313;1;2;256;258
8;Barcelona;13;Barcelonès;08245;Santa Coloma de Gramenet;4;15;B;;699;347;352;1;1;345;346
8;Barcelona;13;Barcelonès;08245;Santa Coloma de Gramenet;4;16;A;;677;313;364;0;0;313;313
8;Barcelona;13;Barcelonès;08245;Santa Coloma de Gramenet;4;16;B;;802;398;404;0;2;396;398
8;Barcelona;13;Barcelonès;08245;Santa Coloma de Gramenet;4;2;A;;510;320;190;0;0;320;320
8;Barcelona;13;Barcelonès;08245;Santa Coloma de Gramenet;4;2;B;;546;306;240;0;3;303;306
8;Barcelona;13;Barcelonès;08245;Santa Coloma de Gramenet;4;3;A;;946;424;522;2;4;418;422
8;Barcelona;13;Barcelonès;08245;Santa Coloma de Gramenet;4;4;A;;494;229;265;1;1;227;228
8;Barcelona;13;Barcelonès;08245;Santa Coloma de Gramenet;4;4;B;;602;286;316;0;1;285;286
8;Barcelona;13;Barcelonès;08245;Santa Coloma de Gramenet;4;5;A;;889;368;521;0;1;367;368
8;Barcelona;13;Barcelonès;08245;Santa Coloma de Gramenet;4;6;A;;522;246;276;0;1;245;246
8;Barcelona;13;Barcelonès;08245;Santa Coloma de Gramenet;4;6;B;;635;316;319;3;2;311;313
8;Barcelona;13;Barcelonès;08245;Santa Coloma de Gramenet;4;7;A;;615;299;316;0;3;296;299
8;Barcelona;13;Barcelonès;08245;Santa Coloma de Gramenet;4;7;B;;749;369;380;1;4;364;368
8;Barcelona;13;Barcelonès;08245;Santa Coloma de Gramenet;4;8;A;;438;218;220;1;0;217;217
8;Barcelona;13;Barcelonès;08245;Santa Coloma de Gramenet;4;8;B;;507;259;248;2;1;256;257
8;Barcelona;13;Barcelonès;08245;Santa Coloma de Gramenet;4;8;C;;536;287;249;1;1;285;286
8;Barcelona;13;Barcelonès;08245;Santa Coloma de Gramenet;4;9;A;;648;272;376;0;2;270;272
8;Barcelona;13;Barcelonès;08245;Santa Coloma de Gramenet;4;9;B;;758;354;404;1;6;347;353
8;Barcelona;13;Barcelonès;08245;Santa Coloma de Gramenet;5;1;A;;867;409;458;3;2;404;406
8;Barcelona;13;Barcelonès;08245;Santa Coloma de Gramenet;5;10;A;;661;326;335;1;1;324;325
8;Barcelona;13;Barcelonès;08245;Santa Coloma de Gramenet;5;11;A;;550;269;281;2;2;265;267
8;Barcelona;13;Barcelonès;08245;Santa Coloma de Gramenet;5;11;B;;605;255;350;0;0;255;255
8;Barcelona;13;Barcelonès;08245;Santa Coloma de Gramenet;5;12;A;;805;383;422;1;1;381;382
8;Barcelona;13;Barcelonès;08245;Santa Coloma de Gramenet;5;13;A;;547;258;289;1;0;257;257
8;Barcelona;13;Barcelonès;08245;Santa Coloma de Gramenet;5;13;B;;551;252;299;4;2;246;248
8;Barcelona;13;Barcelonès;08245;Santa Coloma de Gramenet;5;14;A;;554;228;326;0;3;225;228
8;Barcelona;13;Barcelonès;08245;Santa Coloma de Gramenet;5;14;B;;649;272;377;0;1;271;272
8;Barcelona;13;Barcelonès;08245;Santa Coloma de Gramenet;5;15;A;;513;243;270;5;0;238;238
8;Barcelona;13;Barcelonès;08245;Santa Coloma de Gramenet;5;15;B;;638;300;338;4;0;296;296
8;Barcelona;13;Barcelonès;08245;Santa Coloma de Gramenet;5;16;A;;854;370;484;3;2;365;367
8;Barcelona;13;Barcelonès;08245;Santa Coloma de Gramenet;5;17;A;;716;270;446;0;0;270;270
8;Barcelona;13;Barcelonès;08245;Santa Coloma de Gramenet;5;18;A;;463;153;310;2;0;151;151
8;Barcelona;13;Barcelonès;08245;Santa Coloma de Gramenet;5;18;B;;401;198;203;2;1;195;196
8;Barcelona;13;Barcelonès;08245;Santa Coloma de Gramenet;5;19;A;;890;416;474;0;2;414;416
8;Barcelona;13;Barcelonès;08245;Santa Coloma de Gramenet;5;2;A;;603;290;313;1;0;289;289
8;Barcelona;13;Barcelonès;08245;Santa Coloma de Gramenet;5;2;B;;747;356;391;0;2;354;356
8;Barcelona;13;Barcelonès;08245;Santa Coloma de Gramenet;5;3;A;;798;365;433;1;1;363;364
8;Barcelona;13;Barcelonès;08245;Santa Coloma de Gramenet;5;4;A;;725;347;378;0;2;345;347
8;Barcelona;13;Barcelonès;08245;Santa Coloma de Gramenet;5;5;A;;534;238;296;0;2;236;238
8;Barcelona;13;Barcelonès;08245;Santa Coloma de Gramenet;5;5;B;;530;208;322;3;2;203;205
8;Barcelona;13;Barcelonès;08245;Santa Coloma de Gramenet;5;6;A;;905;417;488;2;0;415;415
8;Barcelona;13;Barcelonès;08245;Santa Coloma de Gramenet;5;7;A;;1007;464;543;0;2;462;464
8;Barcelona;13;Barcelonès;08245;Santa Coloma de Gramenet;5;8;A;;797;330;467;1;1;328;329
8;Barcelona;13;Barcelonès;08245;Santa Coloma de Gramenet;5;9;A;;869;396;473;5;3;388;391
8;Barcelona;13;Barcelonès;08245;Santa Coloma de Gramenet;6;1;A;;582;318;264;0;0;318;318
8;Barcelona;13;Barcelonès;08245;Santa Coloma de Gramenet;6;10;A;;828;345;483;3;0;342;342
8;Barcelona;13;Barcelonès;08245;Santa Coloma de Gramenet;6;11;A;;799;336;463;0;2;334;336
8;Barcelona;13;Barcelonès;08245;Santa Coloma de Gramenet;6;12;A;;727;373;354;6;1;366;367
8;Barcelona;13;Barcelonès;08245;Santa Coloma de Gramenet;6;13;A;;542;261;281;4;2;255;257
8;Barcelona;13;Barcelonès;08245;Santa Coloma de Gramenet;6;14;A;;486;206;280;0;0;206;206
8;Barcelona;13;Barcelonès;08245;Santa Coloma de Gramenet;6;14;B;;582;268;314;2;0;266;266
8;Barcelona;13;Barcelonès;08245;Santa Coloma de Gramenet;6;15;A;;646;283;363;2;1;280;281
8;Barcelona;13;Barcelonès;08245;Santa Coloma de Gramenet;6;16;A;;646;240;406;0;1;239;240
8;Barcelona;13;Barcelonès;08245;Santa Coloma de Gramenet;6;17;A;;764;317;447;0;3;314;317
8;Barcelona;13;Barcelonès;08245;Santa Coloma de Gramenet;6;2;A;;811;388;423;2;3;383;386
8;Barcelona;13;Barcelonès;08245;Santa Coloma de Gramenet;6;3;A;;498;258;240;1;0;257;257
8;Barcelona;13;Barcelonès;08245;Santa Coloma de Gramenet;6;3;B;;575;295;280;0;0;295;295
8;Barcelona;13;Barcelonès;08245;Santa Coloma de Gramenet;6;4;A;;961;509;452;8;8;493;501
8;Barcelona;13;Barcelonès;08245;Santa Coloma de Gramenet;6;5;A;;833;435;398;2;0;433;433
8;Barcelona;13;Barcelonès;08245;Santa Coloma de Gramenet;6;6;A;;692;366;326;0;0;366;366
8;Barcelona;13;Barcelonès;08245;Santa Coloma de Gramenet;6;7;A;;487;233;254;0;0;233;233
8;Barcelona;13;Barcelonès;08245;Santa Coloma de Gramenet;6;8;A;;1032;438;594;4;2;432;434
8;Barcelona;13;Barcelonès;08245;Santa Coloma de Gramenet;6;9;A;;548;294;254;2;0;292;292
43;Tarragona;16;Conca de Barberà;43139;Santa Coloma de Queralt;1;1;A;;728;481;247;1;5;475;480
43;Tarragona;16;Conca de Barberà;43139;Santa Coloma de Queralt;1;1;B;;809;533;276;6;5;522;527
43;Tarragona;16;Conca de Barberà;43139;Santa Coloma de Queralt;2;1;A;;544;352;192;1;3;348;351
17;Girona;10;Baix Empordà;17181;Santa Cristina d'Aro;1;1;A;;1026;724;302;2;2;720;722
8;Barcelona;13;Barcelonès;08194;Sant Adrià de Besòs;1;1;A;;471;251;220;1;2;248;250
8;Barcelona;13;Barcelonès;08194;Sant Adrià de Besòs;1;1;B;;525;299;226;0;3;296;299
8;Barcelona;13;Barcelonès;08194;Sant Adrià de Besòs;1;2;A;;515;289;226;0;0;289;289
8;Barcelona;13;Barcelonès;08194;Sant Adrià de Besòs;1;2;B;;539;326;213;0;2;324;326
8;Barcelona;13;Barcelonès;08194;Sant Adrià de Besòs;1;3;A;;518;255;263;0;0;255;255
8;Barcelona;13;Barcelonès;08194;Sant Adrià de Besòs;1;3;B;;686;292;394;0;1;291;292
8;Barcelona;13;Barcelonès;08194;Sant Adrià de Besòs;1;4;A;;597;310;287;1;1;308;309
8;Barcelona;13;Barcelonès;08194;Sant Adrià de Besòs;1;4;B;;733;495;238;0;3;492;495
8;Barcelona;13;Barcelonès;08194;Sant Adrià de Besòs;1;5;A;;699;364;335;0;4;360;364
8;Barcelona;13;Barcelonès;08194;Sant Adrià de Besòs;1;5;B;;790;455;335;1;1;453;454
8;Barcelona;13;Barcelonès;08194;Sant Adrià de Besòs;1;6;A;;667;358;309;1;0;357;357
8;Barcelona;13;Barcelonès;08194;Sant Adrià de Besòs;1;6;B;;724;362;362;1;0;361;361
8;Barcelona;13;Barcelonès;08194;Sant Adrià de Besòs;1;6;C;;737;408;329;1;6;401;407
8;Barcelona;13;Barcelonès;08194;Sant Adrià de Besòs;2;1;A;;583;312;271;6;3;303;306
8;Barcelona;13;Barcelonès;08194;Sant Adrià de Besòs;2;1;B;;678;374;304;7;2;365;367
8;Barcelona;13;Barcelonès;08194;Sant Adrià de Besòs;2;2;A;;615;275;340;0;0;275;275
8;Barcelona;13;Barcelonès;08194;Sant Adrià de Besòs;2;2;B;;687;301;386;2;1;298;299
8;Barcelona;13;Barcelonès;08194;Sant Adrià de Besòs;2;3;A;;247;136;111;0;0;136;136
8;Barcelona;13;Barcelonès;08194;Sant Adrià de Besòs;3;1;A;;628;377;251;6;3;368;371
8;Barcelona;13;Barcelonès;08194;Sant Adrià de Besòs;4;1;A;;821;322;499;0;0;322;322
8;Barcelona;13;Barcelonès;08194;Sant Adrià de Besòs;5;1;A;;668;289;379;2;7;280;287
8;Barcelona;13;Barcelonès;08194;Sant Adrià de Besòs;5;1;B;;732;308;424;3;3;302;305
8;Barcelona;13;Barcelonès;08194;Sant Adrià de Besòs;5;10;A;;1047;440;607;3;2;435;437
8;Barcelona;13;Barcelonès;08194;Sant Adrià de Besòs;5;11;A;;585;186;399;0;1;185;186
8;Barcelona;13;Barcelonès;08194;Sant Adrià de Besòs;5;2;A;;731;334;397;3;1;330;331
8;Barcelona;13;Barcelonès;08194;Sant Adrià de Besòs;5;2;B;;777;346;431;9;1;336;337
8;Barcelona;13;Barcelonès;08194;Sant Adrià de Besòs;5;3;A;;892;450;442;6;1;443;444
8;Barcelona;13;Barcelonès;08194;Sant Adrià de Besòs;5;4;A;;616;313;303;0;0;313;313
8;Barcelona;13;Barcelonès;08194;Sant Adrià de Besòs;5;4;B;;660;336;324;4;2;330;332
8;Barcelona;13;Barcelonès;08194;Sant Adrià de Besòs;5;5;A;;753;231;522;1;1;229;230
8;Barcelona;13;Barcelonès;08194;Sant Adrià de Besòs;5;5;B;;522;194;328;0;0;194;194
8;Barcelona;13;Barcelonès;08194;Sant Adrià de Besòs;5;6;A;;684;274;410;3;0;271;271
8;Barcelona;13;Barcelonès;08194;Sant Adrià de Besòs;5;6;B;;660;247;413;0;3;244;247
8;Barcelona;13;Barcelonès;08194;Sant Adrià de Besòs;5;7;A;;434;186;248;1;1;184;185
8;Barcelona;13;Barcelonès;08194;Sant Adrià de Besòs;5;8;A;;738;268;470;3;0;265;265
8;Barcelona;13;Barcelonès;08194;Sant Adrià de Besòs;5;8;B;;622;238;384;5;1;232;233
8;Barcelona;13;Barcelonès;08194;Sant Adrià de Besòs;5;9;A;;627;304;323;0;2;302;304
8;Barcelona;13;Barcelonès;08194;Sant Adrià de Besòs;5;9;B;;730;366;364;2;4;360;364
8;Barcelona;24;Osona;08246;Santa Eugènia de Berga;1;1;A;;998;767;231;9;3;755;758
8;Barcelona;24;Osona;08247;Santa Eulàlia de Riuprimer;1;1;A;;628;457;171;4;1;452;453
8;Barcelona;41;Vallès Oriental;08248;Santa Eulàlia de Ronçana;1;1;A;;984;677;307;1;2;674;676
8;Barcelona;41;Vallès Oriental;08248;Santa Eulàlia de Ronçana;1;1;B;;929;612;317;0;1;611;612
8;Barcelona;3;Alt Penedès;08249;Santa Fe del Penedès;1;1;A;;153;120;33;1;1;118;119
8;Barcelona;24;Osona;08195;Sant Agustí de Lluçanès;1;1;A;;103;70;33;0;1;69;70
17;Girona;2;Alt Empordà;17182;Santa Llogaia d'Àlguema;1;1;A;;225;143;82;0;1;142;143
8;Barcelona;6;Anoia;08250;Santa Margarida de Montbui;1;1;A;;563;374;189;0;1;373;374
8;Barcelona;6;Anoia;08250;Santa Margarida de Montbui;1;2;A;;681;347;334;0;2;345;347
8;Barcelona;6;Anoia;08250;Santa Margarida de Montbui;1;2;B;;745;371;374;1;2;368;370
8;Barcelona;6;Anoia;08250;Santa Margarida de Montbui;1;3;A;;768;455;313;1;3;451;454
8;Barcelona;6;Anoia;08250;Santa Margarida de Montbui;1;4;A;;1106;597;509;0;1;596;597
8;Barcelona;6;Anoia;08250;Santa Margarida de Montbui;1;5;A;;833;424;409;3;2;419;421
8;Barcelona;6;Anoia;08250;Santa Margarida de Montbui;1;5;B;;877;433;444;4;0;429;429
8;Barcelona;6;Anoia;08250;Santa Margarida de Montbui;1;6;A;;868;432;436;2;1;429;430
8;Barcelona;3;Alt Penedès;08251;Santa Margarida i els Monjos;1;1;A;;814;534;280;3;3;528;531
8;Barcelona;3;Alt Penedès;08251;Santa Margarida i els Monjos;1;1;B;;990;618;372;3;3;612;615
8;Barcelona;3;Alt Penedès;08251;Santa Margarida i els Monjos;1;2;A;;769;517;252;0;3;514;517
8;Barcelona;;;08258;Santa Maria d'Oló;1;1;A;;805;582;223;0;5;577;582
8;Barcelona;24;Osona;08253;Santa Maria de Besora;1;1;A;;165;122;43;0;0;122;122
8;Barcelona;41;Vallès Oriental;08256;Santa Maria de Martorelles;1;1;A;;322;210;112;1;0;209;209
8;Barcelona;14;Berguedà;08255;Santa Maria de Merlès;1;1;A;;154;99;55;0;0;99;99
8;Barcelona;6;Anoia;08257;Santa Maria de Miralles;1;1;A;;84;58;26;0;1;57;58
8;Barcelona;41;Vallès Oriental;08259;Santa Maria de Palautordera;1;1;A;;699;522;177;0;2;520;522
8;Barcelona;41;Vallès Oriental;08259;Santa Maria de Palautordera;1;1;B;;688;553;135;3;1;549;550
8;Barcelona;41;Vallès Oriental;08259;Santa Maria de Palautordera;1;2;A;;978;734;244;3;2;729;731
8;Barcelona;41;Vallès Oriental;08259;Santa Maria de Palautordera;1;3;A;;433;290;143;0;0;290;290
8;Barcelona;41;Vallès Oriental;08259;Santa Maria de Palautordera;1;4;A;;537;374;163;1;2;371;373
8;Barcelona;11;Baix Llobregat;08196;Sant Andreu de la Barca;1;1;A;;823;440;383;1;3;436;439
8;Barcelona;11;Baix Llobregat;08196;Sant Andreu de la Barca;1;1;B;;957;536;421;2;2;532;534
8;Barcelona;11;Baix Llobregat;08196;Sant Andreu de la Barca;1;2;A;;568;276;292;0;0;276;276
8;Barcelona;11;Baix Llobregat;08196;Sant Andreu de la Barca;1;2;B;;719;344;375;2;1;341;342
8;Barcelona;11;Baix Llobregat;08196;Sant Andreu de la Barca;1;3;A;;732;361;371;0;2;359;361
8;Barcelona;11;Baix Llobregat;08196;Sant Andreu de la Barca;1;3;B;;883;469;414;2;1;466;467
8;Barcelona;11;Baix Llobregat;08196;Sant Andreu de la Barca;1;4;A;;803;444;359;4;2;438;440
8;Barcelona;11;Baix Llobregat;08196;Sant Andreu de la Barca;1;4;B;;955;553;402;1;1;551;552
8;Barcelona;11;Baix Llobregat;08196;Sant Andreu de la Barca;1;4;C;;930;537;393;1;2;534;536
8;Barcelona;11;Baix Llobregat;08196;Sant Andreu de la Barca;1;5;A;;668;357;311;5;1;351;352
8;Barcelona;11;Baix Llobregat;08196;Sant Andreu de la Barca;1;5;B;;745;408;337;1;1;406;407
8;Barcelona;11;Baix Llobregat;08196;Sant Andreu de la Barca;1;6;A;;377;209;168;0;5;204;209
8;Barcelona;11;Baix Llobregat;08196;Sant Andreu de la Barca;1;6;B;;536;308;228;0;5;303;308
8;Barcelona;21;Maresme;08197;Sant Andreu de Llavaneres;1;1;A;;651;486;165;4;1;481;482
8;Barcelona;21;Maresme;08197;Sant Andreu de Llavaneres;1;1;B;;600;415;185;1;3;411;414
8;Barcelona;21;Maresme;08197;Sant Andreu de Llavaneres;1;1;C;;668;479;189;5;2;472;474
8;Barcelona;21;Maresme;08197;Sant Andreu de Llavaneres;2;1;A;;703;476;227;0;4;472;476
17;Girona;20;Gironès;17157;Sant Andreu Salou;1;1;A;;124;88;36;0;1;87;88
17;Girona;19;Garrotxa;17183;Sant Aniol de Finestres;1;1;A;;215;136;79;0;1;135;136
8;Barcelona;41;Vallès Oriental;08198;Sant Antoni de Vilamajor;1;1;A;;668;465;203;1;4;460;464
8;Barcelona;41;Vallès Oriental;08198;Sant Antoni de Vilamajor;1;1;B;;755;517;238;4;3;510;513
43;Tarragona;12;Baix Penedès;43140;Santa Oliva;1;1;A;;697;416;281;6;0;410;410
43;Tarragona;12;Baix Penedès;43140;Santa Oliva;1;1;B;;298;184;114;0;1;183;184
17;Girona;19;Garrotxa;17184;Santa Pau;1;1;A;;530;310;220;2;1;307;308
17;Girona;19;Garrotxa;17184;Santa Pau;1;1;B;;522;297;225;6;2;289;291
8;Barcelona;40;Vallès Occidental;08260;Santa Perpètua de Mogoda;1;1;A;;1635;921;714;2;4;915;919
8;Barcelona;40;Vallès Occidental;08260;Santa Perpètua de Mogoda;1;2;A;;1588;871;717;4;6;861;867
8;Barcelona;40;Vallès Occidental;08260;Santa Perpètua de Mogoda;1;3;A;;1018;617;401;2;6;609;615
8;Barcelona;40;Vallès Occidental;08260;Santa Perpètua de Mogoda;1;4;A;;1495;587;908;6;3;578;581
8;Barcelona;40;Vallès Occidental;08260;Santa Perpètua de Mogoda;1;5;A;;565;232;333;0;0;232;232
8;Barcelona;40;Vallès Occidental;08260;Santa Perpètua de Mogoda;1;6;A;;796;448;348;1;1;446;447
8;Barcelona;40;Vallès Occidental;08260;Santa Perpètua de Mogoda;1;7;A;;751;369;382;2;1;366;367
8;Barcelona;40;Vallès Occidental;08260;Santa Perpètua de Mogoda;1;8;A;;1466;674;792;1;4;669;673
8;Barcelona;40;Vallès Occidental;08260;Santa Perpètua de Mogoda;1;9;A;;993;508;485;2;2;504;506
8;Barcelona;21;Maresme;08261;Santa Susanna;1;1;A;;505;354;151;0;1;353;354
8;Barcelona;24;Osona;08199;Sant Bartomeu del Grau;1;1;A;;813;513;300;4;0;509;509
8;Barcelona;11;Baix Llobregat;08200;Sant Boi de Llobregat;1;1;A;;533;297;236;4;1;292;293
8;Barcelona;11;Baix Llobregat;08200;Sant Boi de Llobregat;1;1;B;;601;346;255;1;4;341;345
8;Barcelona;11;Baix Llobregat;08200;Sant Boi de Llobregat;1;2;A;;743;399;344;1;3;395;398
8;Barcelona;11;Baix Llobregat;08200;Sant Boi de Llobregat;1;2;B;;840;441;399;1;2;438;440
8;Barcelona;11;Baix Llobregat;08200;Sant Boi de Llobregat;1;3;A;;490;273;217;2;0;271;271
8;Barcelona;11;Baix Llobregat;08200;Sant Boi de Llobregat;1;3;B;;577;302;275;1;0;301;301
8;Barcelona;11;Baix Llobregat;08200;Sant Boi de Llobregat;1;4;A;;586;292;294;1;3;288;291
8;Barcelona;11;Baix Llobregat;08200;Sant Boi de Llobregat;1;4;B;;763;396;367;0;2;394;396
8;Barcelona;11;Baix Llobregat;08200;Sant Boi de Llobregat;1;5;A;;615;226;389;0;1;225;226
8;Barcelona;11;Baix Llobregat;08200;Sant Boi de Llobregat;1;5;B;;666;238;428;2;0;236;236
8;Barcelona;11;Baix Llobregat;08200;Sant Boi de Llobregat;1;6;A;;1087;624;463;3;1;620;621
8;Barcelona;11;Baix Llobregat;08200;Sant Boi de Llobregat;1;7;A;;495;291;204;4;3;284;287
8;Barcelona;11;Baix Llobregat;08200;Sant Boi de Llobregat;1;7;B;;620;354;266;2;3;349;352
8;Barcelona;11;Baix Llobregat;08200;Sant Boi de Llobregat;2;1;A;;489;177;312;1;0;176;176
8;Barcelona;11;Baix Llobregat;08200;Sant Boi de Llobregat;2;1;B;;583;213;370;0;0;213;213
8;Barcelona;11;Baix Llobregat;08200;Sant Boi de Llobregat;2;1;C;;581;222;359;1;0;221;221
8;Barcelona;11;Baix Llobregat;08200;Sant Boi de Llobregat;2;10;A;;592;310;282;0;1;309;310
8;Barcelona;11;Baix Llobregat;08200;Sant Boi de Llobregat;2;10;B;;737;401;336;3;3;395;398
8;Barcelona;11;Baix Llobregat;08200;Sant Boi de Llobregat;2;11;A;;750;365;385;1;1;363;364
8;Barcelona;11;Baix Llobregat;08200;Sant Boi de Llobregat;2;11;B;;910;411;499;4;1;406;407
8;Barcelona;11;Baix Llobregat;08200;Sant Boi de Llobregat;2;12;A;;564;251;313;0;0;251;251
8;Barcelona;11;Baix Llobregat;08200;Sant Boi de Llobregat;2;12;B;;690;283;407;3;3;277;280
8;Barcelona;11;Baix Llobregat;08200;Sant Boi de Llobregat;2;12;C;;602;255;347;1;1;253;254
8;Barcelona;11;Baix Llobregat;08200;Sant Boi de Llobregat;2;13;A;;785;375;410;3;2;370;372
8;Barcelona;11;Baix Llobregat;08200;Sant Boi de Llobregat;2;13;B;;892;412;480;1;0;411;411
8;Barcelona;11;Baix Llobregat;08200;Sant Boi de Llobregat;2;2;A;;662;339;323;3;2;334;336
8;Barcelona;11;Baix Llobregat;08200;Sant Boi de Llobregat;2;2;B;;805;402;403;0;1;401;402
8;Barcelona;11;Baix Llobregat;08200;Sant Boi de Llobregat;2;3;A;;663;324;339;4;0;320;320
8;Barcelona;11;Baix Llobregat;08200;Sant Boi de Llobregat;2;3;B;;892;392;500;1;6;385;391
8;Barcelona;11;Baix Llobregat;08200;Sant Boi de Llobregat;2;4;A;;934;439;495;0;4;435;439
8;Barcelona;11;Baix Llobregat;08200;Sant Boi de Llobregat;2;5;A;;495;292;203;4;4;284;288
8;Barcelona;11;Baix Llobregat;08200;Sant Boi de Llobregat;2;5;B;;591;318;273;5;2;311;313
8;Barcelona;11;Baix Llobregat;08200;Sant Boi de Llobregat;2;6;A;;657;343;314;0;0;343;343
8;Barcelona;11;Baix Llobregat;08200;Sant Boi de Llobregat;2;6;B;;872;422;450;3;0;419;419
8;Barcelona;11;Baix Llobregat;08200;Sant Boi de Llobregat;2;7;A;;968;542;426;2;0;540;540
8;Barcelona;11;Baix Llobregat;08200;Sant Boi de Llobregat;2;8;A;;1018;599;419;0;4;595;599
8;Barcelona;11;Baix Llobregat;08200;Sant Boi de Llobregat;2;9;A;;687;381;306;0;3;378;381
8;Barcelona;11;Baix Llobregat;08200;Sant Boi de Llobregat;2;9;B;;696;384;312;0;4;380;384
8;Barcelona;11;Baix Llobregat;08200;Sant Boi de Llobregat;3;1;A;;549;329;220;2;0;327;327
8;Barcelona;11;Baix Llobregat;08200;Sant Boi de Llobregat;3;1;B;;562;346;216;1;2;343;345
8;Barcelona;11;Baix Llobregat;08200;Sant Boi de Llobregat;3;2;A;;641;293;348;0;2;291;293
8;Barcelona;11;Baix Llobregat;08200;Sant Boi de Llobregat;3;2;B;;748;353;395;1;1;351;352
8;Barcelona;11;Baix Llobregat;08200;Sant Boi de Llobregat;3;3;A;;678;375;303;2;1;372;373
8;Barcelona;11;Baix Llobregat;08200;Sant Boi de Llobregat;3;3;B;;847;493;354;0;4;489;493
8;Barcelona;11;Baix Llobregat;08200;Sant Boi de Llobregat;3;4;A;;634;390;244;1;4;385;389
8;Barcelona;11;Baix Llobregat;08200;Sant Boi de Llobregat;3;5;A;;730;417;313;1;3;413;416
8;Barcelona;11;Baix Llobregat;08200;Sant Boi de Llobregat;3;5;B;;959;529;430;0;4;525;529
8;Barcelona;11;Baix Llobregat;08200;Sant Boi de Llobregat;3;6;A;;924;571;353;1;1;569;570
8;Barcelona;11;Baix Llobregat;08200;Sant Boi de Llobregat;3;7;A;;749;410;339;5;5;400;405
8;Barcelona;11;Baix Llobregat;08200;Sant Boi de Llobregat;3;7;B;;853;494;359;5;1;488;489
8;Barcelona;11;Baix Llobregat;08200;Sant Boi de Llobregat;3;8;A;;553;301;252;1;1;299;300
8;Barcelona;11;Baix Llobregat;08200;Sant Boi de Llobregat;3;9;A;;525;317;208;4;1;312;313
8;Barcelona;11;Baix Llobregat;08200;Sant Boi de Llobregat;3;9;B;;665;399;266;0;2;397;399
8;Barcelona;11;Baix Llobregat;08200;Sant Boi de Llobregat;4;1;A;;1112;490;622;1;0;489;489
8;Barcelona;11;Baix Llobregat;08200;Sant Boi de Llobregat;4;2;A;;718;340;378;7;0;333;333
8;Barcelona;11;Baix Llobregat;08200;Sant Boi de Llobregat;4;2;B;;811;435;376;5;2;428;430
8;Barcelona;11;Baix Llobregat;08200;Sant Boi de Llobregat;4;3;A;;644;338;306;2;3;333;336
8;Barcelona;11;Baix Llobregat;08200;Sant Boi de Llobregat;4;3;B;;852;430;422;0;6;424;430
8;Barcelona;11;Baix Llobregat;08200;Sant Boi de Llobregat;4;4;A;;1054;545;509;0;4;541;545
8;Barcelona;11;Baix Llobregat;08200;Sant Boi de Llobregat;4;5;A;;577;320;257;2;2;316;318
8;Barcelona;11;Baix Llobregat;08200;Sant Boi de Llobregat;4;5;B;;673;344;329;8;3;333;336
8;Barcelona;11;Baix Llobregat;08200;Sant Boi de Llobregat;4;6;A;;834;414;420;11;2;401;403
8;Barcelona;11;Baix Llobregat;08200;Sant Boi de Llobregat;4;6;B;;940;443;497;4;4;435;439
8;Barcelona;11;Baix Llobregat;08200;Sant Boi de Llobregat;4;7;A;;750;371;379;4;3;364;367
8;Barcelona;11;Baix Llobregat;08200;Sant Boi de Llobregat;4;7;B;;854;456;398;5;2;449;451
8;Barcelona;11;Baix Llobregat;08200;Sant Boi de Llobregat;4;8;A;;783;351;432;2;1;348;349
8;Barcelona;11;Baix Llobregat;08200;Sant Boi de Llobregat;5;1;A;;724;336;388;5;0;331;331
8;Barcelona;11;Baix Llobregat;08200;Sant Boi de Llobregat;5;1;B;;920;431;489;3;0;428;428
8;Barcelona;11;Baix Llobregat;08200;Sant Boi de Llobregat;5;2;A;;600;247;353;0;1;246;247
8;Barcelona;11;Baix Llobregat;08200;Sant Boi de Llobregat;5;2;B;;698;340;358;1;0;339;339
8;Barcelona;11;Baix Llobregat;08200;Sant Boi de Llobregat;5;3;A;;792;307;485;0;1;306;307
8;Barcelona;11;Baix Llobregat;08200;Sant Boi de Llobregat;5;4;A;;1061;579;482;9;4;566;570
8;Barcelona;11;Baix Llobregat;08200;Sant Boi de Llobregat;6;1;A;;604;325;279;2;3;320;323
8;Barcelona;11;Baix Llobregat;08200;Sant Boi de Llobregat;6;2;A;;598;297;301;0;2;295;297
8;Barcelona;11;Baix Llobregat;08200;Sant Boi de Llobregat;6;2;B;;759;358;401;3;1;354;355
8;Barcelona;11;Baix Llobregat;08200;Sant Boi de Llobregat;6;3;A;;1052;504;548;4;1;499;500
8;Barcelona;24;Osona;08201;Sant Boi de Lluçanès;1;1;A;;398;278;120;2;2;274;276
43;Tarragona;22;Montsià;43136;Sant Carles de la Ràpita;1;1;A;;636;360;276;3;6;351;357
43;Tarragona;22;Montsià;43136;Sant Carles de la Ràpita;1;1;B;;718;391;327;4;0;387;387
43;Tarragona;22;Montsià;43136;Sant Carles de la Ràpita;1;2;A;;1073;577;496;5;7;565;572
43;Tarragona;22;Montsià;43136;Sant Carles de la Ràpita;1;3;A;;1055;641;414;2;5;634;639
43;Tarragona;22;Montsià;43136;Sant Carles de la Ràpita;1;4;A;;1116;633;483;1;10;622;632
43;Tarragona;22;Montsià;43136;Sant Carles de la Ràpita;1;5;A;;679;378;301;0;7;371;378
43;Tarragona;22;Montsià;43136;Sant Carles de la Ràpita;2;1;A;;754;424;330;6;1;417;418
43;Tarragona;22;Montsià;43136;Sant Carles de la Ràpita;2;2;A;;790;513;277;1;1;511;512
43;Tarragona;22;Montsià;43136;Sant Carles de la Ràpita;2;3;A;;1001;592;409;6;3;583;586
8;Barcelona;21;Maresme;08203;Sant Cebrià de Vallalta;1;1;A;;530;370;160;0;1;369;370
8;Barcelona;41;Vallès Oriental;08202;Sant Celoni;1;1;A;;822;630;192;0;3;627;630
8;Barcelona;41;Vallès Oriental;08202;Sant Celoni;1;1;B;;999;733;266;0;4;729;733
8;Barcelona;41;Vallès Oriental;08202;Sant Celoni;1;2;A;;394;294;100;0;2;292;294
8;Barcelona;41;Vallès Oriental;08202;Sant Celoni;1;2;B;;526;381;145;2;3;376;379
8;Barcelona;41;Vallès Oriental;08202;Sant Celoni;1;3;A;;545;383;162;0;1;382;383
8;Barcelona;41;Vallès Oriental;08202;Sant Celoni;1;3;B;;814;554;260;0;4;550;554
8;Barcelona;41;Vallès Oriental;08202;Sant Celoni;1;4;A;;592;396;196;0;3;393;396
8;Barcelona;41;Vallès Oriental;08202;Sant Celoni;1;4;B;;762;482;280;0;2;480;482
8;Barcelona;41;Vallès Oriental;08202;Sant Celoni;1;5;A;;776;503;273;0;2;501;503
8;Barcelona;41;Vallès Oriental;08202;Sant Celoni;1;5;B;;1109;686;423;1;1;684;685
8;Barcelona;41;Vallès Oriental;08202;Sant Celoni;1;6;A;;517;353;164;1;0;352;352
8;Barcelona;41;Vallès Oriental;08202;Sant Celoni;1;6;B;;657;407;250;1;3;403;406
8;Barcelona;41;Vallès Oriental;08202;Sant Celoni;2;1;A;;360;257;103;0;0;257;257
8;Barcelona;41;Vallès Oriental;08202;Sant Celoni;2;1;B;;267;144;123;0;1;143;144
8;Barcelona;11;Baix Llobregat;08204;Sant Climent de Llobregat;1;1;A;;627;397;230;0;2;395;397
8;Barcelona;11;Baix Llobregat;08204;Sant Climent de Llobregat;1;1;B;;949;618;331;2;2;614;616
17;Girona;2;Alt Empordà;17158;Sant Climent Sescebes;1;1;A;;380;267;113;0;4;263;267
8;Barcelona;40;Vallès Occidental;08205;Sant Cugat del Vallès;1;1;A;;705;435;270;0;3;432;435
8;Barcelona;40;Vallès Occidental;08205;Sant Cugat del Vallès;1;1;B;;728;452;276;0;3;449;452
8;Barcelona;40;Vallès Occidental;08205;Sant Cugat del Vallès;1;2;A;;606;363;243;2;0;361;361
8;Barcelona;40;Vallès Occidental;08205;Sant Cugat del Vallès;1;2;B;;606;354;252;0;3;351;354
8;Barcelona;40;Vallès Occidental;08205;Sant Cugat del Vallès;1;2;C;;622;365;257;5;5;355;360
8;Barcelona;40;Vallès Occidental;08205;Sant Cugat del Vallès;1;3;A;;677;421;256;0;5;416;421
8;Barcelona;40;Vallès Occidental;08205;Sant Cugat del Vallès;1;3;B;;674;410;264;0;4;406;410
8;Barcelona;40;Vallès Occidental;08205;Sant Cugat del Vallès;1;4;A;;644;427;217;1;6;420;426
8;Barcelona;40;Vallès Occidental;08205;Sant Cugat del Vallès;1;4;B;;723;451;272;1;6;444;450
8;Barcelona;40;Vallès Occidental;08205;Sant Cugat del Vallès;1;5;A;;305;169;136;0;2;167;169
8;Barcelona;40;Vallès Occidental;08205;Sant Cugat del Vallès;1;6;A;;461;279;182;1;1;277;278
8;Barcelona;40;Vallès Occidental;08205;Sant Cugat del Vallès;1;6;B;;600;388;212;3;3;382;385
8;Barcelona;40;Vallès Occidental;08205;Sant Cugat del Vallès;1;6;C;;568;362;206;0;4;358;362
8;Barcelona;40;Vallès Occidental;08205;Sant Cugat del Vallès;1;7;A;;576;356;220;3;0;353;353
8;Barcelona;40;Vallès Occidental;08205;Sant Cugat del Vallès;1;7;B;;733;440;293;1;1;438;439
8;Barcelona;40;Vallès Occidental;08205;Sant Cugat del Vallès;1;8;A;;506;297;209;3;2;292;294
8;Barcelona;40;Vallès Occidental;08205;Sant Cugat del Vallès;1;8;B;;528;328;200;0;0;328;328
8;Barcelona;40;Vallès Occidental;08205;Sant Cugat del Vallès;1;8;C;;581;335;246;0;2;333;335
8;Barcelona;40;Vallès Occidental;08205;Sant Cugat del Vallès;1;9;A;;708;472;236;0;5;467;472
8;Barcelona;40;Vallès Occidental;08205;Sant Cugat del Vallès;1;9;B;;858;548;310;0;7;541;548
8;Barcelona;40;Vallès Occidental;08205;Sant Cugat del Vallès;2;1;A;;503;371;132;1;1;369;370
8;Barcelona;40;Vallès Occidental;08205;Sant Cugat del Vallès;2;1;B;;473;342;131;1;4;337;341
8;Barcelona;40;Vallès Occidental;08205;Sant Cugat del Vallès;2;2;A;;556;388;168;0;5;383;388
8;Barcelona;40;Vallès Occidental;08205;Sant Cugat del Vallès;2;2;B;;526;418;108;7;4;407;411
8;Barcelona;40;Vallès Occidental;08205;Sant Cugat del Vallès;2;3;A;;660;446;214;0;3;443;446
8;Barcelona;40;Vallès Occidental;08205;Sant Cugat del Vallès;2;3;B;;638;404;234;0;0;404;404
8;Barcelona;40;Vallès Occidental;08205;Sant Cugat del Vallès;2;3;C;;736;518;218;4;4;510;514
8;Barcelona;40;Vallès Occidental;08205;Sant Cugat del Vallès;2;4;A;;609;399;210;2;4;393;397
8;Barcelona;40;Vallès Occidental;08205;Sant Cugat del Vallès;2;4;B;;469;309;160;0;2;307;309
8;Barcelona;40;Vallès Occidental;08205;Sant Cugat del Vallès;2;4;C;;636;434;202;0;4;430;434
8;Barcelona;40;Vallès Occidental;08205;Sant Cugat del Vallès;2;5;A;;549;342;207;1;1;340;341
8;Barcelona;40;Vallès Occidental;08205;Sant Cugat del Vallès;2;5;B;;517;323;194;1;1;321;322
8;Barcelona;40;Vallès Occidental;08205;Sant Cugat del Vallès;2;6;A;;238;146;92;0;2;144;146
8;Barcelona;40;Vallès Occidental;08205;Sant Cugat del Vallès;3;1;A;;438;263;175;2;5;256;261
8;Barcelona;40;Vallès Occidental;08205;Sant Cugat del Vallès;3;1;B;;476;278;198;1;2;275;277
8;Barcelona;40;Vallès Occidental;08205;Sant Cugat del Vallès;3;2;A;;711;448;263;0;4;444;448
8;Barcelona;40;Vallès Occidental;08205;Sant Cugat del Vallès;3;2;B;;682;433;249;0;1;432;433
8;Barcelona;40;Vallès Occidental;08205;Sant Cugat del Vallès;4;1;A;;643;389;254;0;4;385;389
8;Barcelona;40;Vallès Occidental;08205;Sant Cugat del Vallès;4;2;A;;619;311;308;0;0;311;311
8;Barcelona;40;Vallès Occidental;08205;Sant Cugat del Vallès;4;2;B;;580;297;283;0;5;292;297
8;Barcelona;40;Vallès Occidental;08205;Sant Cugat del Vallès;5;1;A;;850;504;346;0;3;501;504
8;Barcelona;40;Vallès Occidental;08205;Sant Cugat del Vallès;5;2;A;;414;224;190;0;1;223;224
8;Barcelona;40;Vallès Occidental;08205;Sant Cugat del Vallès;5;2;B;;473;259;214;0;0;259;259
8;Barcelona;40;Vallès Occidental;08205;Sant Cugat del Vallès;6;1;A;;636;285;351;8;1;276;277
8;Barcelona;3;Alt Penedès;08206;Sant Cugat Sesgarrigues;1;1;A;;571;425;146;5;2;418;420
25;Lleida;25;Pallars Jussà;25196;Sant Esteve de la Sarga;1;1;A;;129;52;77;0;0;52;52
8;Barcelona;41;Vallès Oriental;08207;Sant Esteve de Palautordera;1;1;A;;790;592;198;0;0;592;592
8;Barcelona;11;Baix Llobregat;08208;Sant Esteve Sesrovires;1;1;A;;624;457;167;4;1;452;453
8;Barcelona;11;Baix Llobregat;08208;Sant Esteve Sesrovires;1;1;B;;663;480;183;4;0;476;476
17;Girona;34;Selva;17159;Sant Feliu de Buixalleu;1;1;A;;490;330;160;2;0;328;328
8;Barcelona;41;Vallès Oriental;08210;Sant Feliu de Codines;1;1;A;;493;345;148;0;2;343;345
8;Barcelona;41;Vallès Oriental;08210;Sant Feliu de Codines;1;2;A;;753;544;209;3;1;540;541
8;Barcelona;41;Vallès Oriental;08210;Sant Feliu de Codines;2;1;A;;725;482;243;6;1;475;476
8;Barcelona;41;Vallès Oriental;08210;Sant Feliu de Codines;2;2;A;;662;489;173;2;8;479;487
17;Girona;10;Baix Empordà;17160;Sant Feliu de Guíxols;1;1;A;;494;332;162;2;0;330;330
17;Girona;10;Baix Empordà;17160;Sant Feliu de Guíxols;1;1;B;;578;398;180;1;1;396;397
17;Girona;10;Baix Empordà;17160;Sant Feliu de Guíxols;1;2;A;;440;295;145;0;7;288;295
17;Girona;10;Baix Empordà;17160;Sant Feliu de Guíxols;1;2;B;;560;382;178;0;6;376;382
17;Girona;10;Baix Empordà;17160;Sant Feliu de Guíxols;2;1;A;;505;332;173;1;0;331;331
17;Girona;10;Baix Empordà;17160;Sant Feliu de Guíxols;2;1;B;;553;375;178;0;3;372;375
17;Girona;10;Baix Empordà;17160;Sant Feliu de Guíxols;2;2;A;;718;481;237;2;2;477;479
17;Girona;10;Baix Empordà;17160;Sant Feliu de Guíxols;2;2;B;;900;591;309;0;4;587;591
17;Girona;10;Baix Empordà;17160;Sant Feliu de Guíxols;2;3;A;;579;344;235;2;2;340;342
17;Girona;10;Baix Empordà;17160;Sant Feliu de Guíxols;2;3;B;;670;425;245;5;1;419;420
17;Girona;10;Baix Empordà;17160;Sant Feliu de Guíxols;2;4;A;;542;325;217;4;1;320;321
17;Girona;10;Baix Empordà;17160;Sant Feliu de Guíxols;2;4;B;;782;487;295;7;2;478;480
17;Girona;10;Baix Empordà;17160;Sant Feliu de Guíxols;3;1;A;;680;477;203;0;8;469;477
17;Girona;10;Baix Empordà;17160;Sant Feliu de Guíxols;3;1;B;;796;522;274;1;3;518;521
17;Girona;10;Baix Empordà;17160;Sant Feliu de Guíxols;3;2;A;;764;519;245;4;0;515;515
17;Girona;10;Baix Empordà;17160;Sant Feliu de Guíxols;3;2;B;;937;640;297;3;0;637;637
17;Girona;10;Baix Empordà;17160;Sant Feliu de Guíxols;4;1;A;;494;322;172;1;0;321;321
17;Girona;10;Baix Empordà;17160;Sant Feliu de Guíxols;4;1;B;;484;317;167;0;3;314;317
8;Barcelona;11;Baix Llobregat;08211;Sant Feliu de Llobregat;1;1;A;;675;483;192;0;4;479;483
8;Barcelona;11;Baix Llobregat;08211;Sant Feliu de Llobregat;1;1;B;;734;491;243;1;2;488;490
8;Barcelona;11;Baix Llobregat;08211;Sant Feliu de Llobregat;1;2;A;;496;353;143;0;4;349;353
8;Barcelona;11;Baix Llobregat;08211;Sant Feliu de Llobregat;1;2;B;;602;419;183;0;5;414;419
8;Barcelona;11;Baix Llobregat;08211;Sant Feliu de Llobregat;1;3;A;;432;271;161;0;3;268;271
8;Barcelona;11;Baix Llobregat;08211;Sant Feliu de Llobregat;1;3;B;;541;345;196;0;1;344;345
8;Barcelona;11;Baix Llobregat;08211;Sant Feliu de Llobregat;1;4;A;;641;347;294;0;1;346;347
8;Barcelona;11;Baix Llobregat;08211;Sant Feliu de Llobregat;2;1;A;;507;301;206;0;0;301;301
8;Barcelona;11;Baix Llobregat;08211;Sant Feliu de Llobregat;2;1;B;;548;353;195;0;2;351;353
8;Barcelona;11;Baix Llobregat;08211;Sant Feliu de Llobregat;2;2;A;;675;341;334;0;2;339;341
8;Barcelona;11;Baix Llobregat;08211;Sant Feliu de Llobregat;2;3;A;;495;488;7;1;1;486;487
8;Barcelona;11;Baix Llobregat;08211;Sant Feliu de Llobregat;2;3;B;;546;307;239;0;3;304;307
8;Barcelona;11;Baix Llobregat;08211;Sant Feliu de Llobregat;2;4;A;;702;399;303;2;1;396;397
8;Barcelona;11;Baix Llobregat;08211;Sant Feliu de Llobregat;2;5;A;;740;467;273;0;1;466;467
8;Barcelona;11;Baix Llobregat;08211;Sant Feliu de Llobregat;2;6;A;;628;302;326;2;0;300;300
8;Barcelona;11;Baix Llobregat;08211;Sant Feliu de Llobregat;2;6;B;;732;402;330;0;1;401;402
8;Barcelona;11;Baix Llobregat;08211;Sant Feliu de Llobregat;2;7;A;;560;352;208;1;1;350;351
8;Barcelona;11;Baix Llobregat;08211;Sant Feliu de Llobregat;2;7;B;;557;345;212;1;2;342;344
8;Barcelona;11;Baix Llobregat;08211;Sant Feliu de Llobregat;3;1;A;;545;308;237;0;3;305;308
8;Barcelona;11;Baix Llobregat;08211;Sant Feliu de Llobregat;3;1;B;;618;360;258;0;5;355;360
8;Barcelona;11;Baix Llobregat;08211;Sant Feliu de Llobregat;3;1;C;;556;311;245;1;2;308;310
8;Barcelona;11;Baix Llobregat;08211;Sant Feliu de Llobregat;3;2;A;;530;314;216;2;2;310;312
8;Barcelona;11;Baix Llobregat;08211;Sant Feliu de Llobregat;3;2;B;;548;334;214;2;4;328;332
8;Barcelona;11;Baix Llobregat;08211;Sant Feliu de Llobregat;3;2;C;;679;424;255;0;0;424;424
8;Barcelona;11;Baix Llobregat;08211;Sant Feliu de Llobregat;3;3;A;;479;290;189;1;1;288;289
8;Barcelona;11;Baix Llobregat;08211;Sant Feliu de Llobregat;3;3;B;;542;335;207;0;2;333;335
8;Barcelona;11;Baix Llobregat;08211;Sant Feliu de Llobregat;3;4;A;;465;323;142;1;1;321;322
8;Barcelona;11;Baix Llobregat;08211;Sant Feliu de Llobregat;3;5;A;;595;359;236;2;2;355;357
8;Barcelona;11;Baix Llobregat;08211;Sant Feliu de Llobregat;3;5;B;;709;433;276;1;0;432;432
8;Barcelona;11;Baix Llobregat;08211;Sant Feliu de Llobregat;4;1;A;;877;489;388;2;3;484;487
8;Barcelona;11;Baix Llobregat;08211;Sant Feliu de Llobregat;4;2;A;;463;232;231;0;2;230;232
8;Barcelona;11;Baix Llobregat;08211;Sant Feliu de Llobregat;4;2;B;;620;352;268;1;1;350;351
8;Barcelona;11;Baix Llobregat;08211;Sant Feliu de Llobregat;4;3;A;;882;458;424;1;1;456;457
8;Barcelona;11;Baix Llobregat;08211;Sant Feliu de Llobregat;4;4;A;;531;255;276;2;3;250;253
8;Barcelona;11;Baix Llobregat;08211;Sant Feliu de Llobregat;4;4;B;;628;301;327;0;4;297;301
8;Barcelona;11;Baix Llobregat;08211;Sant Feliu de Llobregat;4;5;A;;541;277;264;0;2;275;277
8;Barcelona;11;Baix Llobregat;08211;Sant Feliu de Llobregat;5;1;A;;473;221;252;0;2;219;221
8;Barcelona;11;Baix Llobregat;08211;Sant Feliu de Llobregat;5;1;B;;571;264;307;0;2;262;264
8;Barcelona;11;Baix Llobregat;08211;Sant Feliu de Llobregat;5;2;A;;765;340;425;0;0;340;340
8;Barcelona;11;Baix Llobregat;08211;Sant Feliu de Llobregat;6;1;A;;423;203;220;2;2;199;201
8;Barcelona;11;Baix Llobregat;08211;Sant Feliu de Llobregat;6;1;B;;639;306;333;1;0;305;305
8;Barcelona;11;Baix Llobregat;08211;Sant Feliu de Llobregat;6;1;C;;620;288;332;1;0;287;287
8;Barcelona;11;Baix Llobregat;08211;Sant Feliu de Llobregat;6;2;A;;714;400;314;1;1;398;399
8;Barcelona;11;Baix Llobregat;08211;Sant Feliu de Llobregat;6;3;A;;717;352;365;2;3;347;350
17;Girona;19;Garrotxa;17161;Sant Feliu de Pallerols;1;1;A;;420;303;117;0;3;300;303
17;Girona;19;Garrotxa;17161;Sant Feliu de Pallerols;1;1;B;;448;331;117;3;5;323;328
8;Barcelona;7;Bages;08212;Sant Feliu Sasserra;1;1;A;;519;360;159;1;7;352;359
17;Girona;19;Garrotxa;17162;Sant Ferriol;1;1;A;;143;80;63;3;0;77;77
8;Barcelona;41;Vallès Oriental;08209;Sant Fost de Campsentelles;1;1;A;;559;349;210;0;0;349;349
8;Barcelona;41;Vallès Oriental;08209;Sant Fost de Campsentelles;1;1;B;;582;316;266;0;0;316;316
8;Barcelona;41;Vallès Oriental;08209;Sant Fost de Campsentelles;1;1;C;;654;379;275;1;0;378;378
8;Barcelona;41;Vallès Oriental;08209;Sant Fost de Campsentelles;1;2;A;;456;291;165;1;0;290;290
8;Barcelona;41;Vallès Oriental;08209;Sant Fost de Campsentelles;1;2;B;;606;373;233;1;4;368;372
8;Barcelona;7;Bages;08213;Sant Fruitós de Bages;1;1;A;;1477;1020;457;8;4;1008;1012
8;Barcelona;7;Bages;08213;Sant Fruitós de Bages;1;2;A;;1527;967;560;3;8;956;964
8;Barcelona;7;Bages;08213;Sant Fruitós de Bages;1;3;A;;391;215;176;0;0;215;215
17;Girona;20;Gironès;17163;Sant Gregori;1;1;A;;1053;770;283;3;5;762;767
17;Girona;20;Gironès;17163;Sant Gregori;1;1;B;;267;187;80;0;0;187;187
25;Lleida;32;Segarra;25192;Sant Guim de Freixenet;1;1;A;;861;616;245;2;4;610;614
25;Lleida;32;Segarra;25197;Sant Guim de la Plana;1;1;A;;171;102;69;0;0;102;102
17;Girona;34;Selva;17164;Sant Hilari Sacalm;1;1;A;;730;499;231;2;1;496;497
17;Girona;34;Selva;17164;Sant Hilari Sacalm;1;1;B;;940;661;279;3;2;656;658
17;Girona;34;Selva;17164;Sant Hilari Sacalm;1;2;A;;803;501;302;0;5;496;501
17;Girona;34;Selva;17164;Sant Hilari Sacalm;1;2;B;;973;630;343;1;6;623;629
8;Barcelona;24;Osona;08215;Sant Hipòlit de Voltregà;1;1;A;;716;517;199;10;6;501;507
8;Barcelona;24;Osona;08215;Sant Hipòlit de Voltregà;1;2;A;;867;638;229;10;5;623;628
8;Barcelona;24;Osona;08215;Sant Hipòlit de Voltregà;1;3;A;;790;549;241;3;4;542;546
8;Barcelona;21;Maresme;08193;Sant Iscle de Vallalta;1;1;A;;405;304;101;1;2;301;303
43;Tarragona;22;Montsià;43902;Sant Jaume d'Enveja;1;1;A;;739;411;328;0;5;406;411
43;Tarragona;22;Montsià;43902;Sant Jaume d'Enveja;1;1;B;;379;272;107;2;4;266;270
43;Tarragona;22;Montsià;43902;Sant Jaume d'Enveja;1;2;A;;762;449;313;4;2;443;445
43;Tarragona;22;Montsià;43902;Sant Jaume d'Enveja;1;2;B;;743;455;288;8;0;447;447
8;Barcelona;14;Berguedà;08216;Sant Jaume de Frontanyà;1;1;A;;15;15;0;0;1;14;15
17;Girona;19;Garrotxa;17165;Sant Jaume de Llierca;1;1;A;;659;480;179;10;0;470;470
43;Tarragona;12;Baix Penedès;43137;Sant Jaume dels Domenys;1;1;A;;901;585;316;10;2;573;575
17;Girona;31;Ripollès;17167;Sant Joan de les Abadesses;1;1;A;;385;289;96;1;1;287;288
17;Girona;31;Ripollès;17167;Sant Joan de les Abadesses;1;1;B;;464;355;109;0;0;355;355
17;Girona;31;Ripollès;17167;Sant Joan de les Abadesses;1;2;A;;733;544;189;7;2;535;537
17;Girona;31;Ripollès;17167;Sant Joan de les Abadesses;1;2;B;;742;556;186;8;0;548;548
17;Girona;31;Ripollès;17167;Sant Joan de les Abadesses;1;3;A;;442;310;132;5;1;304;305
17;Girona;31;Ripollès;17167;Sant Joan de les Abadesses;1;3;B;;487;339;148;13;0;326;326
17;Girona;20;Gironès;17168;Sant Joan de Mollet;1;1;A;;253;203;50;5;0;198;198
8;Barcelona;11;Baix Llobregat;08217;Sant Joan Despí;1;1;A;;470;290;180;0;1;289;290
8;Barcelona;11;Baix Llobregat;08217;Sant Joan Despí;1;2;A;;626;376;250;7;1;368;369
8;Barcelona;11;Baix Llobregat;08217;Sant Joan Despí;1;2;B;;625;354;271;6;2;346;348
8;Barcelona;11;Baix Llobregat;08217;Sant Joan Despí;1;2;C;;714;408;306;0;3;405;408
8;Barcelona;11;Baix Llobregat;08217;Sant Joan Despí;1;3;A;;673;396;277;1;1;394;395
8;Barcelona;11;Baix Llobregat;08217;Sant Joan Despí;1;3;B;;709;403;306;0;1;402;403
8;Barcelona;11;Baix Llobregat;08217;Sant Joan Despí;1;3;C;;783;459;324;0;1;458;459
8;Barcelona;11;Baix Llobregat;08217;Sant Joan Despí;1;4;A;;694;463;231;1;5;457;462
8;Barcelona;11;Baix Llobregat;08217;Sant Joan Despí;1;4;B;;627;382;245;4;2;376;378
8;Barcelona;11;Baix Llobregat;08217;Sant Joan Despí;1;4;C;;682;454;228;3;4;447;451
8;Barcelona;11;Baix Llobregat;08217;Sant Joan Despí;1;5;A;;381;252;129;2;0;250;250
8;Barcelona;11;Baix Llobregat;08217;Sant Joan Despí;1;5;B;;400;273;127;0;1;272;273
8;Barcelona;11;Baix Llobregat;08217;Sant Joan Despí;1;5;C;;483;331;152;5;3;323;326
8;Barcelona;11;Baix Llobregat;08217;Sant Joan Despí;2;1;A;;458;305;153;0;6;299;305
8;Barcelona;11;Baix Llobregat;08217;Sant Joan Despí;2;2;A;;525;335;190;0;1;334;335
8;Barcelona;11;Baix Llobregat;08217;Sant Joan Despí;2;2;B;;573;332;241;2;1;329;330
8;Barcelona;11;Baix Llobregat;08217;Sant Joan Despí;2;3;A;;687;397;290;0;1;396;397
8;Barcelona;11;Baix Llobregat;08217;Sant Joan Despí;2;4;A;;549;309;240;1;2;306;308
8;Barcelona;11;Baix Llobregat;08217;Sant Joan Despí;2;4;B;;663;369;294;1;4;364;368
8;Barcelona;11;Baix Llobregat;08217;Sant Joan Despí;3;1;A;;399;256;143;2;2;252;254
8;Barcelona;11;Baix Llobregat;08217;Sant Joan Despí;3;1;B;;542;317;225;1;2;314;316
8;Barcelona;11;Baix Llobregat;08217;Sant Joan Despí;3;1;C;;399;244;155;0;2;242;244
8;Barcelona;11;Baix Llobregat;08217;Sant Joan Despí;3;2;A;;659;398;261;1;1;396;397
8;Barcelona;11;Baix Llobregat;08217;Sant Joan Despí;3;2;B;;684;430;254;0;9;421;430
8;Barcelona;11;Baix Llobregat;08217;Sant Joan Despí;3;3;A;;571;378;193;0;3;375;378
8;Barcelona;11;Baix Llobregat;08217;Sant Joan Despí;3;3;B;;711;436;275;3;0;433;433
8;Barcelona;11;Baix Llobregat;08217;Sant Joan Despí;3;3;C;;681;448;233;0;4;444;448
8;Barcelona;11;Baix Llobregat;08217;Sant Joan Despí;3;4;A;;753;442;311;1;2;439;441
8;Barcelona;11;Baix Llobregat;08217;Sant Joan Despí;3;4;B;;884;504;380;0;4;500;504
8;Barcelona;7;Bages;08218;Sant Joan de Vilatorrada;1;1;A;;737;522;215;1;2;519;521
8;Barcelona;7;Bages;08218;Sant Joan de Vilatorrada;1;1;B;;773;513;260;7;0;506;506
8;Barcelona;7;Bages;08218;Sant Joan de Vilatorrada;1;1;C;;923;643;280;12;3;628;631
8;Barcelona;7;Bages;08218;Sant Joan de Vilatorrada;1;2;A;;567;358;209;3;0;355;355
8;Barcelona;7;Bages;08218;Sant Joan de Vilatorrada;1;2;B;;689;389;300;6;1;382;383
8;Barcelona;7;Bages;08218;Sant Joan de Vilatorrada;1;2;C;;724;429;295;0;2;427;429
8;Barcelona;7;Bages;08218;Sant Joan de Vilatorrada;1;3;A;;1012;712;300;13;1;698;699
8;Barcelona;7;Bages;08218;Sant Joan de Vilatorrada;1;4;A;;195;144;51;0;2;142;144
17;Girona;19;Garrotxa;17185;Sant Joan les Fonts;1;1;A;;469;351;118;2;3;346;349
17;Girona;19;Garrotxa;17185;Sant Joan les Fonts;1;1;B;;524;374;150;8;1;365;366
17;Girona;19;Garrotxa;17185;Sant Joan les Fonts;1;2;A;;610;449;161;10;0;439;439
17;Girona;19;Garrotxa;17185;Sant Joan les Fonts;1;3;A;;467;345;122;3;2;340;342
17;Girona;19;Garrotxa;17185;Sant Joan les Fonts;1;3;B;;200;134;66;0;1;133;134
17;Girona;20;Gironès;17166;Sant Jordi Desvalls;1;1;A;;472;315;157;2;0;313;313
17;Girona;34;Selva;17903;Sant Julià del Llor i Bonmatí;1;1;A;;685;505;180;1;5;499;504
17;Girona;20;Gironès;17169;Sant Julià de Ramis;1;1;A;;726;503;223;5;6;492;498
17;Girona;20;Gironès;17169;Sant Julià de Ramis;1;1;B;;474;319;155;0;0;319;319
8;Barcelona;24;Osona;08220;Sant Julià de Vilatorta;1;1;A;;1284;995;289;0;6;989;995
8;Barcelona;11;Baix Llobregat;08221;Sant Just Desvern;1;1;A;;915;578;337;0;5;573;578
8;Barcelona;11;Baix Llobregat;08221;Sant Just Desvern;1;1;B;;1081;670;411;0;4;666;670
8;Barcelona;11;Baix Llobregat;08221;Sant Just Desvern;1;2;A;;485;300;185;0;1;299;300
8;Barcelona;11;Baix Llobregat;08221;Sant Just Desvern;1;2;B;;527;306;221;1;1;304;305
8;Barcelona;11;Baix Llobregat;08221;Sant Just Desvern;1;3;A;;749;492;257;0;3;489;492
8;Barcelona;11;Baix Llobregat;08221;Sant Just Desvern;1;3;B;;800;517;283;1;3;513;516
8;Barcelona;11;Baix Llobregat;08221;Sant Just Desvern;1;4;A;;772;429;343;1;0;428;428
8;Barcelona;11;Baix Llobregat;08221;Sant Just Desvern;1;4;B;;899;534;365;1;3;530;533
8;Barcelona;11;Baix Llobregat;08221;Sant Just Desvern;1;5;A;;803;510;293;3;1;506;507
8;Barcelona;11;Baix Llobregat;08221;Sant Just Desvern;1;5;B;;948;569;379;4;3;562;565
8;Barcelona;11;Baix Llobregat;08221;Sant Just Desvern;1;6;A;;722;461;261;0;5;456;461
8;Barcelona;11;Baix Llobregat;08221;Sant Just Desvern;1;6;B;;816;535;281;3;5;527;532
8;Barcelona;3;Alt Penedès;08222;Sant Llorenç d'Hortons;1;1;A;;757;517;240;0;3;514;517
17;Girona;2;Alt Empordà;17171;Sant Llorenç de la Muga;1;1;A;;129;87;42;0;1;86;87
25;Lleida;35;Solsonès;25193;Sant Llorenç de Morunys;1;1;A;;714;509;205;13;11;485;496
8;Barcelona;40;Vallès Occidental;08223;Sant Llorenç Savall;1;1;A;;641;450;191;3;0;447;447
8;Barcelona;40;Vallès Occidental;08223;Sant Llorenç Savall;1;1;B;;825;571;254;4;2;565;567
8;Barcelona;24;Osona;08225;Sant Martí d'Albars;1;1;A;;105;65;40;1;0;64;64
8;Barcelona;24;Osona;08224;Sant Martí de Centelles;1;1;A;;549;360;189;2;0;358;358
17;Girona;20;Gironès;17172;Sant Martí de Llémena;1;1;A;;279;172;107;0;0;172;172
25;Lleida;38;Urgell;25902;Sant Martí de Riucorb;1;1;A;;688;441;247;2;3;436;439
8;Barcelona;6;Anoia;08226;Sant Martí de Tous;1;1;A;;796;599;197;0;3;596;599
8;Barcelona;3;Alt Penedès;08227;Sant Martí Sarroca;1;1;A;;574;356;218;11;4;341;345
8;Barcelona;3;Alt Penedès;08227;Sant Martí Sarroca;1;1;B;;710;441;269;3;0;438;438
8;Barcelona;3;Alt Penedès;08227;Sant Martí Sarroca;1;2;A;;544;351;193;0;2;349;351
8;Barcelona;6;Anoia;08228;Sant Martí Sesgueioles;1;1;A;;323;233;90;2;4;227;231
17;Girona;20;Gironès;17173;Sant Martí Vell;1;1;A;;164;124;40;2;0;122;122
8;Barcelona;7;Bages;08229;Sant Mateu de Bages;1;1;A;;199;117;82;0;0;117;117
8;Barcelona;7;Bages;08229;Sant Mateu de Bages;1;1;B;;285;237;48;0;0;237;237
17;Girona;28;Pla de l'Estany;17174;Sant Miquel de Campmajor;1;1;A;;184;121;63;0;0;121;121
17;Girona;2;Alt Empordà;17175;Sant Miquel de Fluvià;1;1;A;;411;276;135;0;0;276;276
17;Girona;2;Alt Empordà;17176;Sant Mori;1;1;A;;96;67;29;0;1;66;67
17;Girona;31;Ripollès;17177;Sant Pau de Segúries;1;1;A;;496;373;123;2;10;361;371
8;Barcelona;7;Bages;08192;Santpedor;1;1;A;;864;627;237;7;4;616;620
8;Barcelona;7;Bages;08192;Santpedor;1;1;B;;973;686;287;3;1;682;683
8;Barcelona;7;Bages;08192;Santpedor;1;2;A;;1134;809;325;8;2;799;801
8;Barcelona;17;Garraf;08231;Sant Pere de Ribes;1;1;A;;553;317;236;3;0;314;314
8;Barcelona;17;Garraf;08231;Sant Pere de Ribes;1;1;B;;642;373;269;2;0;371;371
8;Barcelona;17;Garraf;08231;Sant Pere de Ribes;1;2;A;;586;293;293;1;0;292;292
8;Barcelona;17;Garraf;08231;Sant Pere de Ribes;1;2;B;;747;372;375;0;0;372;372
8;Barcelona;17;Garraf;08231;Sant Pere de Ribes;1;3;A;;539;337;202;1;3;333;336
8;Barcelona;17;Garraf;08231;Sant Pere de Ribes;1;3;B;;654;388;266;0;1;387;388
8;Barcelona;17;Garraf;08231;Sant Pere de Ribes;1;4;A;;612;282;330;2;0;280;280
8;Barcelona;17;Garraf;08231;Sant Pere de Ribes;1;4;B;;704;308;396;5;1;302;303
8;Barcelona;17;Garraf;08231;Sant Pere de Ribes;1;5;A;;464;250;214;3;1;246;247
8;Barcelona;17;Garraf;08231;Sant Pere de Ribes;1;5;B;;656;345;311;2;0;343;343
8;Barcelona;17;Garraf;08231;Sant Pere de Ribes;1;6;A;;498;263;235;1;1;261;262
8;Barcelona;17;Garraf;08231;Sant Pere de Ribes;1;6;B;;668;325;343;3;0;322;322
8;Barcelona;17;Garraf;08231;Sant Pere de Ribes;1;7;A;;546;252;294;1;0;251;251
8;Barcelona;17;Garraf;08231;Sant Pere de Ribes;1;7;B;;665;303;362;4;0;299;299
8;Barcelona;3;Alt Penedès;08232;Sant Pere de Riudebitlles;1;1;A;;791;600;191;7;2;591;593
8;Barcelona;3;Alt Penedès;08232;Sant Pere de Riudebitlles;1;1;B;;872;610;262;3;7;600;607
8;Barcelona;24;Osona;08233;Sant Pere de Torelló;1;1;A;;681;492;189;1;2;489;491
8;Barcelona;24;Osona;08233;Sant Pere de Torelló;1;2;A;;933;633;300;4;3;626;629
8;Barcelona;41;Vallès Oriental;08234;Sant Pere de Vilamajor;1;1;A;;701;463;238;0;5;458;463
17;Girona;2;Alt Empordà;17178;Sant Pere Pescador;1;1;A;;856;623;233;1;3;619;622
8;Barcelona;6;Anoia;08189;Sant Pere Sallavinera;1;1;A;;151;121;30;0;0;121;121
8;Barcelona;21;Maresme;08235;Sant Pol de Mar;1;1;A;;889;651;238;5;5;641;646
8;Barcelona;21;Maresme;08235;Sant Pol de Mar;1;2;A;;943;713;230;1;1;711;712
8;Barcelona;3;Alt Penedès;08236;Sant Quintí de Mediona;1;1;A;;552;358;194;4;5;349;354
8;Barcelona;3;Alt Penedès;08236;Sant Quintí de Mediona;1;1;B;;627;440;187;0;0;440;440
8;Barcelona;24;Osona;08237;Sant Quirze de Besora;1;1;A;;974;736;238;3;3;730;733
8;Barcelona;24;Osona;08237;Sant Quirze de Besora;1;2;A;;645;485;160;7;2;476;478
8;Barcelona;40;Vallès Occidental;08238;Sant Quirze del Vallès;1;1;A;;725;467;258;1;1;465;466
8;Barcelona;40;Vallès Occidental;08238;Sant Quirze del Vallès;1;1;B;;847;545;302;0;2;543;545
8;Barcelona;40;Vallès Occidental;08238;Sant Quirze del Vallès;1;2;A;;771;546;225;2;1;543;544
8;Barcelona;40;Vallès Occidental;08238;Sant Quirze del Vallès;1;3;A;;774;455;319;0;1;454;455
8;Barcelona;40;Vallès Occidental;08238;Sant Quirze del Vallès;1;4;A;;775;498;277;3;4;491;495
8;Barcelona;40;Vallès Occidental;08238;Sant Quirze del Vallès;1;4;B;;931;550;381;4;2;544;546
8;Barcelona;;;08239;Sant Quirze Safaja;1;1;A;;180;134;46;1;1;132;133
25;Lleida;32;Segarra;25194;Sant Ramon;1;1;A;;506;302;204;0;2;300;302
8;Barcelona;3;Alt Penedès;08240;Sant Sadurní d'Anoia;1;1;A;;769;571;198;2;0;569;569
8;Barcelona;3;Alt Penedès;08240;Sant Sadurní d'Anoia;1;1;B;;929;726;203;1;1;724;725
8;Barcelona;3;Alt Penedès;08240;Sant Sadurní d'Anoia;1;2;A;;707;514;193;1;1;512;513
8;Barcelona;3;Alt Penedès;08240;Sant Sadurní d'Anoia;1;2;B;;620;439;181;1;3;435;438
8;Barcelona;3;Alt Penedès;08240;Sant Sadurní d'Anoia;1;2;C;;737;575;162;2;2;571;573
8;Barcelona;3;Alt Penedès;08240;Sant Sadurní d'Anoia;1;3;A;;862;643;219;3;5;635;640
8;Barcelona;3;Alt Penedès;08240;Sant Sadurní d'Anoia;2;1;A;;517;399;118;1;0;398;398
8;Barcelona;3;Alt Penedès;08240;Sant Sadurní d'Anoia;2;1;B;;552;426;126;0;1;425;426
8;Barcelona;3;Alt Penedès;08240;Sant Sadurní d'Anoia;2;2;A;;484;347;137;1;2;344;346
8;Barcelona;3;Alt Penedès;08240;Sant Sadurní d'Anoia;2;2;B;;513;364;149;1;2;361;363
8;Barcelona;24;Osona;08241;Sant Sadurní d'Osormort;1;1;A;;61;57;4;0;0;57;57
8;Barcelona;7;Bages;08098;Sant Salvador de Guardiola;1;1;A;;673;448;225;0;2;446;448
8;Barcelona;7;Bages;08262;Sant Vicenç de Castellet;1;1;A;;742;491;251;3;1;487;488
8;Barcelona;7;Bages;08262;Sant Vicenç de Castellet;1;1;B;;1018;664;354;1;1;662;663
8;Barcelona;7;Bages;08262;Sant Vicenç de Castellet;1;2;A;;1199;873;326;7;11;855;866
8;Barcelona;7;Bages;08262;Sant Vicenç de Castellet;2;1;A;;760;498;262;4;2;492;494
8;Barcelona;7;Bages;08262;Sant Vicenç de Castellet;2;1;B;;975;598;377;1;1;596;597
8;Barcelona;7;Bages;08262;Sant Vicenç de Castellet;2;2;A;;1187;784;403;1;5;778;783
8;Barcelona;11;Baix Llobregat;08263;Sant Vicenç dels Horts;1;1;A;;707;394;313;0;5;389;394
8;Barcelona;11;Baix Llobregat;08263;Sant Vicenç dels Horts;1;1;B;;910;498;412;1;1;496;497
8;Barcelona;11;Baix Llobregat;08263;Sant Vicenç dels Horts;1;2;A;;492;346;146;0;3;343;346
8;Barcelona;11;Baix Llobregat;08263;Sant Vicenç dels Horts;1;2;B;;637;394;243;0;2;392;394
8;Barcelona;11;Baix Llobregat;08263;Sant Vicenç dels Horts;1;3;A;;770;453;317;0;0;453;453
8;Barcelona;11;Baix Llobregat;08263;Sant Vicenç dels Horts;1;3;B;;902;535;367;0;1;534;535
8;Barcelona;11;Baix Llobregat;08263;Sant Vicenç dels Horts;1;4;A;;947;577;370;1;3;573;576
8;Barcelona;11;Baix Llobregat;08263;Sant Vicenç dels Horts;1;5;A;;604;371;233;5;3;363;366
8;Barcelona;11;Baix Llobregat;08263;Sant Vicenç dels Horts;1;5;B;;763;461;302;12;0;449;449
8;Barcelona;11;Baix Llobregat;08263;Sant Vicenç dels Horts;1;6;A;;688;364;324;0;3;361;364
8;Barcelona;11;Baix Llobregat;08263;Sant Vicenç dels Horts;1;6;B;;791;410;381;2;0;408;408
8;Barcelona;11;Baix Llobregat;08263;Sant Vicenç dels Horts;1;7;A;;841;501;340;1;3;497;500
8;Barcelona;11;Baix Llobregat;08263;Sant Vicenç dels Horts;2;1;A;;812;345;467;1;2;342;344
8;Barcelona;11;Baix Llobregat;08263;Sant Vicenç dels Horts;2;2;A;;957;506;451;1;1;504;505
8;Barcelona;11;Baix Llobregat;08263;Sant Vicenç dels Horts;2;3;A;;658;279;379;0;3;276;279
8;Barcelona;11;Baix Llobregat;08263;Sant Vicenç dels Horts;3;1;A;;493;268;225;0;2;266;268
8;Barcelona;11;Baix Llobregat;08263;Sant Vicenç dels Horts;3;1;B;;610;342;268;3;0;339;339
8;Barcelona;11;Baix Llobregat;08263;Sant Vicenç dels Horts;3;2;A;;730;354;376;1;1;352;353
8;Barcelona;11;Baix Llobregat;08263;Sant Vicenç dels Horts;4;1;A;;899;414;485;3;0;411;411
8;Barcelona;21;Maresme;08264;Sant Vicenç de Montalt;1;1;A;;1145;859;286;0;8;851;859
8;Barcelona;24;Osona;08265;Sant Vicenç de Torelló;1;1;A;;938;644;294;0;5;639;644
8;Barcelona;24;Osona;08265;Sant Vicenç de Torelló;1;2;A;;488;364;124;0;3;361;364
43;Tarragona;16;Conca de Barberà;43142;Sarral;1;1;A;;1117;670;447;9;9;652;661
17;Girona;20;Gironès;17186;Sarrià de Ter;1;1;A;;707;506;201;2;2;502;504
17;Girona;20;Gironès;17186;Sarrià de Ter;1;1;B;;876;636;240;3;4;629;633
17;Girona;20;Gironès;17186;Sarrià de Ter;1;2;A;;441;306;135;1;3;302;305
17;Girona;20;Gironès;17186;Sarrià de Ter;1;2;B;;595;428;167;2;4;422;426
25;Lleida;25;Pallars Jussà;25201;Sarroca de Bellera;1;1;A;;111;68;43;0;1;67;68
25;Lleida;33;Segrià;25200;Sarroca de Lleida;1;1;A;;429;240;189;2;1;237;238
17;Girona;2;Alt Empordà;17187;Saus, Camallera i Llampaies;1;1;A;;550;370;180;1;3;366;369
43;Tarragona;16;Conca de Barberà;43143;Savallà del Comtat;1;1;A;;52;44;8;0;0;44;44
43;Tarragona;36;Tarragonès;43144;Secuita, la;1;1;A;;721;498;223;0;2;496;498
43;Tarragona;8;Baix Camp;43145;Selva del Camp, la;1;1;A;;866;626;240;3;8;615;623
43;Tarragona;8;Baix Camp;43145;Selva del Camp, la;2;1;A;;820;610;210;8;1;601;602
43;Tarragona;8;Baix Camp;43145;Selva del Camp, la;2;1;B;;925;717;208;9;3;705;708
17;Girona;2;Alt Empordà;17188;Selva de Mar, la;1;1;A;;133;103;30;0;2;101;103
43;Tarragona;16;Conca de Barberà;43146;Senan;1;1;A;;24;20;4;0;0;20;20
43;Tarragona;22;Montsià;43044;Sénia, la;1;1;A;;719;446;273;6;1;439;440
43;Tarragona;22;Montsià;43044;Sénia, la;1;1;B;;771;498;273;2;3;493;496
43;Tarragona;22;Montsià;43044;Sénia, la;2;1;A;;678;432;246;3;3;426;429
43;Tarragona;22;Montsià;43044;Sénia, la;2;1;B;;730;473;257;7;8;458;466
43;Tarragona;22;Montsià;43044;Sénia, la;2;2;A;;718;403;315;7;4;392;396
25;Lleida;25;Pallars Jussà;25202;Senterada;1;1;A;;102;59;43;0;2;57;59
25;Lleida;23;Noguera;25035;Sentiu de Sió, la;1;1;A;;412;292;120;1;5;286;291
8;Barcelona;40;Vallès Occidental;08267;Sentmenat;1;1;A;;730;514;216;0;3;511;514
8;Barcelona;40;Vallès Occidental;08267;Sentmenat;1;1;B;;871;588;283;2;2;584;586
8;Barcelona;40;Vallès Occidental;08267;Sentmenat;1;2;A;;604;409;195;2;3;404;407
8;Barcelona;40;Vallès Occidental;08267;Sentmenat;1;2;B;;801;548;253;1;1;546;547
17;Girona;28;Pla de l'Estany;17190;Serinyà;1;1;A;;545;387;158;1;5;381;386
25;Lleida;33;Segrià;25204;Seròs;1;1;A;;629;396;233;8;4;384;388
25;Lleida;33;Segrià;25204;Seròs;1;2;A;;936;591;345;9;4;578;582
17;Girona;10;Baix Empordà;17191;Serra de Daró;1;1;A;;161;116;45;1;0;115;115
17;Girona;31;Ripollès;17192;Setcases;1;1;A;;127;85;42;1;0;84;84
25;Lleida;4;Alt Urgell;25203;Seu d'Urgell, la;1;1;A;;1048;607;441;4;1;602;603
25;Lleida;4;Alt Urgell;25203;Seu d'Urgell, la;1;2;A;;1193;691;502;8;5;678;683
25;Lleida;4;Alt Urgell;25203;Seu d'Urgell, la;1;3;A;;896;457;439;0;2;455;457
25;Lleida;4;Alt Urgell;25203;Seu d'Urgell, la;1;4;A;;1416;858;558;1;2;855;857
25;Lleida;4;Alt Urgell;25203;Seu d'Urgell, la;1;5;A;;1112;672;440;0;5;667;672
25;Lleida;4;Alt Urgell;25203;Seu d'Urgell, la;1;6;A;;800;488;312;1;4;483;487
25;Lleida;4;Alt Urgell;25203;Seu d'Urgell, la;1;7;A;;986;545;441;3;4;538;542
25;Lleida;4;Alt Urgell;25203;Seu d'Urgell, la;1;8;A;;475;283;192;0;1;282;283
8;Barcelona;24;Osona;08269;Seva;1;1;A;;662;562;100;0;1;561;562
8;Barcelona;24;Osona;08269;Seva;1;2;A;;582;443;139;7;0;436;436
25;Lleida;27;Pla d'Urgell;25205;Sidamon;1;1;A;;373;282;91;2;1;279;280
17;Girona;34;Selva;17193;Sils;1;1;A;;725;472;253;3;2;467;469
17;Girona;34;Selva;17193;Sils;1;1;B;;877;580;297;2;5;573;578
8;Barcelona;17;Garraf;08270;Sitges;1;1;A;;816;527;289;0;4;523;527
8;Barcelona;17;Garraf;08270;Sitges;1;2;A;;768;474;294;1;0;473;473
8;Barcelona;17;Garraf;08270;Sitges;1;2;B;;863;541;322;0;1;540;541
8;Barcelona;17;Garraf;08270;Sitges;1;3;A;;605;345;260;0;1;344;345
8;Barcelona;17;Garraf;08270;Sitges;2;1;A;;583;374;209;0;1;373;374
8;Barcelona;17;Garraf;08270;Sitges;2;1;B;;798;534;264;1;5;528;533
8;Barcelona;17;Garraf;08270;Sitges;2;2;A;;590;358;232;1;1;356;357
8;Barcelona;17;Garraf;08270;Sitges;2;2;B;;746;461;285;6;2;453;455
8;Barcelona;17;Garraf;08270;Sitges;2;3;A;;626;386;240;1;2;383;385
8;Barcelona;17;Garraf;08270;Sitges;2;3;B;;820;506;314;2;1;503;504
8;Barcelona;17;Garraf;08270;Sitges;2;4;A;;727;430;297;2;2;426;428
8;Barcelona;17;Garraf;08270;Sitges;2;4;B;;898;473;425;6;1;466;467
8;Barcelona;17;Garraf;08270;Sitges;2;5;A;;825;529;296;0;1;528;529
8;Barcelona;17;Garraf;08270;Sitges;3;1;A;;316;153;163;0;0;153;153
17;Girona;2;Alt Empordà;17052;Siurana;1;1;A;;147;80;67;0;0;80;80
8;Barcelona;24;Osona;08271;Sobremunt;1;1;A;;65;38;27;0;0;38;38
25;Lleida;18;Garrigues;25206;Soleràs, el;1;1;A;;404;249;155;2;0;247;247
43;Tarragona;16;Conca de Barberà;43147;Solivella;1;1;A;;627;434;193;2;5;427;432
25;Lleida;35;Solsonès;25207;Solsona;1;1;A;;660;412;248;4;3;405;408
25;Lleida;35;Solsonès;25207;Solsona;1;1;B;;850;508;342;10;5;493;498
25;Lleida;35;Solsonès;25207;Solsona;1;2;A;;803;464;339;3;2;459;461
25;Lleida;35;Solsonès;25207;Solsona;1;2;B;;957;523;434;9;2;512;514
25;Lleida;35;Solsonès;25207;Solsona;2;1;A;;769;513;256;1;1;511;512
25;Lleida;35;Solsonès;25207;Solsona;2;2;A;;1053;674;379;12;10;652;662
8;Barcelona;24;Osona;08272;Sora;1;1;A;;181;131;50;0;0;131;131
25;Lleida;26;Pallars Sobirà;25208;Soriguera;1;1;A;;253;114;139;0;0;114;114
25;Lleida;26;Pallars Sobirà;25209;Sort;1;1;A;;1239;739;500;1;3;735;738
25;Lleida;33;Segrià;25210;Soses;1;1;A;;1137;743;394;3;1;739;740
8;Barcelona;3;Alt Penedès;08273;Subirats;1;1;A;;579;381;198;3;2;376;378
8;Barcelona;3;Alt Penedès;08273;Subirats;1;2;A;;367;285;82;1;3;281;284
8;Barcelona;3;Alt Penedès;08273;Subirats;1;2;B;;243;156;87;0;1;155;156
8;Barcelona;3;Alt Penedès;08273;Subirats;1;3;A;;569;417;152;0;0;417;417
25;Lleida;33;Segrià;25211;Sudanell;1;1;A;;655;273;382;3;1;269;270
25;Lleida;33;Segrià;25212;Sunyer;1;1;A;;249;148;101;0;1;147;148
8;Barcelona;7;Bages;08274;Súria;1;1;A;;1539;1144;395;2;5;1137;1142
8;Barcelona;7;Bages;08274;Súria;1;2;A;;611;446;165;0;1;445;446
8;Barcelona;7;Bages;08274;Súria;1;3;A;;488;310;178;3;1;306;307
8;Barcelona;7;Bages;08274;Súria;1;4;A;;1453;945;508;3;5;937;942
8;Barcelona;7;Bages;08274;Súria;1;5;A;;1156;836;320;1;5;830;835
17;Girona;34;Selva;17194;Susqueda;1;1;A;;97;77;20;0;0;77;77
8;Barcelona;41;Vallès Oriental;08276;Tagamanent;1;1;A;;120;88;32;0;1;87;88
8;Barcelona;7;Bages;08277;Talamanca;1;1;A;;62;52;10;0;0;52;52
25;Lleida;25;Pallars Jussà;25215;Talarn;1;1;A;;306;188;118;5;1;182;183
25;Lleida;32;Segarra;25216;Talavera;1;1;A;;249;180;69;0;1;179;180
17;Girona;10;Baix Empordà;17195;Tallada d'Empordà, la;1;1;A;;299;161;138;1;2;158;160
8;Barcelona;24;Osona;08278;Taradell;1;1;A;;700;522;178;0;2;520;522
8;Barcelona;24;Osona;08278;Taradell;1;1;B;;798;595;203;4;0;591;591
8;Barcelona;24;Osona;08278;Taradell;1;2;A;;721;553;168;3;2;548;550
8;Barcelona;24;Osona;08278;Taradell;1;2;B;;973;682;291;2;6;674;680
43;Tarragona;36;Tarragonès;43148;Tarragona;1;1;A;;670;361;309;1;0;360;360
43;Tarragona;36;Tarragonès;43148;Tarragona;1;2;A;;531;326;205;3;1;322;323
43;Tarragona;36;Tarragonès;43148;Tarragona;1;2;B;;550;325;225;8;2;315;317
43;Tarragona;36;Tarragonès;43148;Tarragona;2;1;A;;626;329;297;4;2;323;325
43;Tarragona;36;Tarragonès;43148;Tarragona;2;2;A;;795;459;336;2;4;453;457
43;Tarragona;36;Tarragonès;43148;Tarragona;3;1;A;;556;348;208;3;0;345;345
43;Tarragona;36;Tarragonès;43148;Tarragona;3;2;A;;601;311;290;2;1;308;309
43;Tarragona;36;Tarragonès;43148;Tarragona;3;3;A;;587;364;223;3;0;361;361
43;Tarragona;36;Tarragonès;43148;Tarragona;3;4;A;;1026;587;439;0;3;584;587
43;Tarragona;36;Tarragonès;43148;Tarragona;4;1;A;;710;447;263;0;4;443;447
43;Tarragona;36;Tarragonès;43148;Tarragona;4;10;A;;658;382;276;2;0;380;380
43;Tarragona;36;Tarragonès;43148;Tarragona;4;10;B;;752;446;306;5;2;439;441
43;Tarragona;36;Tarragonès;43148;Tarragona;4;11;A;;707;441;266;1;4;436;440
43;Tarragona;36;Tarragonès;43148;Tarragona;4;12;A;;941;559;382;0;4;555;559
43;Tarragona;36;Tarragonès;43148;Tarragona;4;13;A;;652;347;305;2;4;341;345
43;Tarragona;36;Tarragonès;43148;Tarragona;4;14;A;;705;396;309;2;1;393;394
43;Tarragona;36;Tarragonès;43148;Tarragona;4;14;B;;825;449;376;5;7;437;444
43;Tarragona;36;Tarragonès;43148;Tarragona;4;15;A;;620;346;274;0;0;346;346
43;Tarragona;36;Tarragonès;43148;Tarragona;4;2;A;;795;513;282;2;1;510;511
43;Tarragona;36;Tarragonès;43148;Tarragona;4;3;A;;900;532;368;0;5;527;532
43;Tarragona;36;Tarragonès;43148;Tarragona;4;4;A;;571;365;206;0;2;363;365
43;Tarragona;36;Tarragonès;43148;Tarragona;4;4;B;;679;419;260;4;8;407;415
43;Tarragona;36;Tarragonès;43148;Tarragona;4;5;A;;935;550;385;1;4;545;549
43;Tarragona;36;Tarragonès;43148;Tarragona;4;6;A;;514;324;190;0;5;319;324
43;Tarragona;36;Tarragonès;43148;Tarragona;4;6;B;;602;344;258;0;5;339;344
43;Tarragona;36;Tarragonès;43148;Tarragona;4;7;A;;798;498;300;1;3;494;497
43;Tarragona;36;Tarragonès;43148;Tarragona;4;8;A;;752;441;311;2;11;428;439
43;Tarragona;36;Tarragonès;43148;Tarragona;4;8;B;;715;457;258;0;2;455;457
43;Tarragona;36;Tarragonès;43148;Tarragona;4;9;A;;527;327;200;1;3;323;326
43;Tarragona;36;Tarragonès;43148;Tarragona;4;9;B;;615;378;237;1;1;376;377
43;Tarragona;36;Tarragonès;43148;Tarragona;5;1;A;;525;372;153;0;3;369;372
43;Tarragona;36;Tarragonès;43148;Tarragona;5;1;B;;568;388;180;2;4;382;386
43;Tarragona;36;Tarragonès;43148;Tarragona;5;2;A;;615;387;228;4;1;382;383
43;Tarragona;36;Tarragonès;43148;Tarragona;5;2;B;;642;402;240;0;0;402;402
43;Tarragona;36;Tarragonès;43148;Tarragona;5;3;A;;630;382;248;2;2;378;380
43;Tarragona;36;Tarragonès;43148;Tarragona;5;3;B;;817;471;346;4;5;462;467
43;Tarragona;36;Tarragonès;43148;Tarragona;5;4;A;;943;531;412;0;4;527;531
43;Tarragona;36;Tarragonès;43148;Tarragona;5;5;A;;520;256;264;3;1;252;253
43;Tarragona;36;Tarragonès;43148;Tarragona;5;5;B;;588;334;254;3;2;329;331
43;Tarragona;36;Tarragonès;43148;Tarragona;5;6;A;;707;363;344;1;1;361;362
43;Tarragona;36;Tarragonès;43148;Tarragona;5;7;A;;922;530;392;0;5;525;530
43;Tarragona;36;Tarragonès;43148;Tarragona;5;8;A;;644;397;247;1;2;394;396
43;Tarragona;36;Tarragonès;43148;Tarragona;5;8;B;;811;468;343;3;1;464;465
43;Tarragona;36;Tarragonès;43148;Tarragona;5;9;A;;607;421;186;6;1;414;415
43;Tarragona;36;Tarragonès;43148;Tarragona;6;1;A;;614;368;246;2;4;362;366
43;Tarragona;36;Tarragonès;43148;Tarragona;6;1;B;;727;424;303;4;7;413;420
43;Tarragona;36;Tarragonès;43148;Tarragona;6;10;A;;586;352;234;2;2;348;350
43;Tarragona;36;Tarragonès;43148;Tarragona;6;10;B;;507;299;208;3;2;294;296
43;Tarragona;36;Tarragonès;43148;Tarragona;6;10;C;;552;336;216;2;2;332;334
43;Tarragona;36;Tarragonès;43148;Tarragona;6;11;A;;527;335;192;1;4;330;334
43;Tarragona;36;Tarragonès;43148;Tarragona;6;11;B;;470;283;187;1;0;282;282
43;Tarragona;36;Tarragonès;43148;Tarragona;6;11;C;;612;370;242;0;2;368;370
43;Tarragona;36;Tarragonès;43148;Tarragona;6;12;A;;525;366;159;2;5;359;364
43;Tarragona;36;Tarragonès;43148;Tarragona;6;13;A;;575;329;246;2;2;325;327
43;Tarragona;36;Tarragonès;43148;Tarragona;6;13;B;;483;265;218;1;2;262;264
43;Tarragona;36;Tarragonès;43148;Tarragona;6;13;C;;567;331;236;0;2;329;331
43;Tarragona;36;Tarragonès;43148;Tarragona;6;14;A;;778;458;320;1;6;451;457
43;Tarragona;36;Tarragonès;43148;Tarragona;6;15;A;;976;498;478;4;0;494;494
43;Tarragona;36;Tarragonès;43148;Tarragona;6;2;A;;718;393;325;1;3;389;392
43;Tarragona;36;Tarragonès;43148;Tarragona;6;3;A;;610;324;286;0;1;323;324
43;Tarragona;36;Tarragonès;43148;Tarragona;6;3;B;;540;271;269;1;2;268;270
43;Tarragona;36;Tarragonès;43148;Tarragona;6;3;C;;537;293;244;3;2;288;290
43;Tarragona;36;Tarragonès;43148;Tarragona;6;4;A;;809;520;289;3;3;514;517
43;Tarragona;36;Tarragonès;43148;Tarragona;6;5;A;;501;277;224;3;3;271;274
43;Tarragona;36;Tarragonès;43148;Tarragona;6;6;A;;832;465;367;0;6;459;465
43;Tarragona;36;Tarragonès;43148;Tarragona;6;7;A;;583;277;306;3;1;273;274
43;Tarragona;36;Tarragonès;43148;Tarragona;6;8;A;;1002;674;328;1;6;667;673
43;Tarragona;36;Tarragonès;43148;Tarragona;6;9;A;;617;366;251;0;2;364;366
43;Tarragona;36;Tarragonès;43148;Tarragona;6;9;B;;694;429;265;1;3;425;428
43;Tarragona;36;Tarragonès;43148;Tarragona;7;1;A;;659;363;296;0;7;356;363
43;Tarragona;36;Tarragonès;43148;Tarragona;7;10;A;;602;324;278;1;2;321;323
43;Tarragona;36;Tarragonès;43148;Tarragona;7;10;B;;708;402;306;1;0;401;401
43;Tarragona;36;Tarragonès;43148;Tarragona;7;11;A;;690;364;326;0;1;363;364
43;Tarragona;36;Tarragonès;43148;Tarragona;7;11;B;;766;416;350;3;2;411;413
43;Tarragona;36;Tarragonès;43148;Tarragona;7;12;A;;839;426;413;2;5;419;424
43;Tarragona;36;Tarragonès;43148;Tarragona;7;2;A;;889;501;388;1;1;499;500
43;Tarragona;36;Tarragonès;43148;Tarragona;7;3;A;;641;290;351;1;2;287;289
43;Tarragona;36;Tarragonès;43148;Tarragona;7;3;B;;740;367;373;1;0;366;366
43;Tarragona;36;Tarragonès;43148;Tarragona;7;4;A;;641;356;285;1;2;353;355
43;Tarragona;36;Tarragonès;43148;Tarragona;7;4;B;;730;398;332;3;4;391;395
43;Tarragona;36;Tarragonès;43148;Tarragona;7;5;A;;986;537;449;4;11;522;533
43;Tarragona;36;Tarragonès;43148;Tarragona;7;6;A;;895;505;390;4;9;492;501
43;Tarragona;36;Tarragonès;43148;Tarragona;7;7;A;;1251;718;533;1;9;708;717
43;Tarragona;36;Tarragonès;43148;Tarragona;7;7;B;;440;179;261;1;0;178;178
43;Tarragona;36;Tarragonès;43148;Tarragona;7;8;A;;656;382;274;0;3;379;382
43;Tarragona;36;Tarragonès;43148;Tarragona;7;8;B;;731;396;335;0;2;394;396
43;Tarragona;36;Tarragonès;43148;Tarragona;7;9;A;;878;419;459;0;0;419;419
43;Tarragona;36;Tarragonès;43148;Tarragona;8;1;A;;569;290;279;2;0;288;288
43;Tarragona;36;Tarragonès;43148;Tarragona;8;1;B;;691;335;356;2;0;333;333
43;Tarragona;36;Tarragonès;43148;Tarragona;8;10;A;;622;208;414;1;3;204;207
43;Tarragona;36;Tarragonès;43148;Tarragona;8;10;B;;624;209;415;2;0;207;207
43;Tarragona;36;Tarragonès;43148;Tarragona;8;2;A;;556;279;277;0;2;277;279
43;Tarragona;36;Tarragonès;43148;Tarragona;8;2;B;;624;352;272;3;2;347;349
43;Tarragona;36;Tarragonès;43148;Tarragona;8;3;A;;623;301;322;0;3;298;301
43;Tarragona;36;Tarragonès;43148;Tarragona;8;3;B;;746;346;400;0;3;343;346
43;Tarragona;36;Tarragonès;43148;Tarragona;8;4;A;;553;284;269;5;1;278;279
43;Tarragona;36;Tarragonès;43148;Tarragona;8;4;B;;559;318;241;5;0;313;313
43;Tarragona;36;Tarragonès;43148;Tarragona;8;5;A;;740;377;363;4;4;369;373
43;Tarragona;36;Tarragonès;43148;Tarragona;8;6;A;;1000;576;424;0;6;570;576
43;Tarragona;36;Tarragonès;43148;Tarragona;8;7;A;;734;348;386;0;2;346;348
43;Tarragona;36;Tarragonès;43148;Tarragona;8;7;B;;794;363;431;0;1;362;363
43;Tarragona;36;Tarragonès;43148;Tarragona;8;8;A;;632;168;464;1;0;167;167
43;Tarragona;36;Tarragonès;43148;Tarragona;8;8;B;;720;226;494;1;3;222;225
43;Tarragona;36;Tarragonès;43148;Tarragona;8;9;A;;806;352;454;3;1;348;349
43;Tarragona;36;Tarragonès;43148;Tarragona;9;1;A;;826;428;398;2;1;425;426
43;Tarragona;36;Tarragonès;43148;Tarragona;9;10;A;;829;417;412;2;2;413;415
43;Tarragona;36;Tarragonès;43148;Tarragona;9;2;A;;921;519;402;0;1;518;519
43;Tarragona;36;Tarragonès;43148;Tarragona;9;3;A;;907;497;410;9;2;486;488
43;Tarragona;36;Tarragonès;43148;Tarragona;9;4;A;;893;487;406;3;3;481;484
43;Tarragona;36;Tarragonès;43148;Tarragona;9;5;A;;942;569;373;2;1;566;567
43;Tarragona;36;Tarragonès;43148;Tarragona;9;6;A;;667;358;309;1;0;357;357
43;Tarragona;36;Tarragonès;43148;Tarragona;9;6;B;;801;489;312;0;1;488;489
43;Tarragona;36;Tarragonès;43148;Tarragona;9;7;A;;703;447;256;0;0;447;447
43;Tarragona;36;Tarragonès;43148;Tarragona;9;8;A;;761;420;341;1;2;417;419
43;Tarragona;36;Tarragonès;43148;Tarragona;9;9;A;;524;299;225;0;0;299;299
25;Lleida;38;Urgell;25217;Tàrrega;1;1;A;;1019;640;379;3;8;629;637
25;Lleida;38;Urgell;25217;Tàrrega;1;2;A;;820;522;298;2;2;518;520
25;Lleida;38;Urgell;25217;Tàrrega;2;1;A;;688;422;266;1;6;415;421
25;Lleida;38;Urgell;25217;Tàrrega;2;2;A;;626;419;207;2;2;415;417
25;Lleida;38;Urgell;25217;Tàrrega;2;2;B;;701;502;199;1;1;500;501
25;Lleida;38;Urgell;25217;Tàrrega;3;1;A;;570;392;178;0;5;387;392
25;Lleida;38;Urgell;25217;Tàrrega;3;1;B;;733;469;264;1;7;461;468
25;Lleida;38;Urgell;25217;Tàrrega;3;2;A;;820;574;246;5;3;566;569
25;Lleida;38;Urgell;25217;Tàrrega;4;1;A;;570;361;209;0;1;360;361
25;Lleida;38;Urgell;25217;Tàrrega;4;2;A;;612;413;199;3;5;405;410
25;Lleida;38;Urgell;25217;Tàrrega;4;2;B;;746;509;237;2;8;499;507
25;Lleida;38;Urgell;25217;Tàrrega;5;1;A;;249;175;74;0;0;175;175
25;Lleida;38;Urgell;25217;Tàrrega;5;1;B;;201;127;74;2;1;124;125
25;Lleida;38;Urgell;25217;Tàrrega;5;1;C;;229;156;73;0;2;154;156
25;Lleida;18;Garrigues;25218;Tarrés;1;1;A;;73;57;16;0;0;57;57
25;Lleida;32;Segarra;25219;Tarroja de Segarra;1;1;A;;189;133;56;0;1;132;133
8;Barcelona;24;Osona;08275;Tavèrnoles;1;1;A;;150;118;32;0;1;117;118
8;Barcelona;24;Osona;08280;Tavertet;1;1;A;;96;62;34;0;0;62;62
8;Barcelona;21;Maresme;08281;Teià;1;1;A;;618;376;242;3;2;371;373
8;Barcelona;21;Maresme;08281;Teià;1;1;B;;713;444;269;4;1;439;440
8;Barcelona;21;Maresme;08281;Teià;1;2;A;;829;569;260;5;4;560;564
25;Lleida;23;Noguera;25220;Térmens;1;1;A;;468;287;181;1;2;284;286
25;Lleida;23;Noguera;25220;Térmens;1;1;B;;644;388;256;1;1;386;387
17;Girona;2;Alt Empordà;17196;Terrades;1;1;A;;157;106;51;0;1;105;106
8;Barcelona;40;Vallès Occidental;08279;Terrassa;1;1;A;;1349;1067;282;2;5;1060;1065
8;Barcelona;40;Vallès Occidental;08279;Terrassa;1;2;A;;711;520;191;2;2;516;518
8;Barcelona;40;Vallès Occidental;08279;Terrassa;1;3;A;;410;318;92;0;0;318;318
8;Barcelona;40;Vallès Occidental;08279;Terrassa;1;4;A;;480;335;145;0;1;334;335
8;Barcelona;40;Vallès Occidental;08279;Terrassa;1;4;B;;485;360;125;1;2;357;359
8;Barcelona;40;Vallès Occidental;08279;Terrassa;1;5;A;;626;413;213;2;2;409;411
8;Barcelona;40;Vallès Occidental;08279;Terrassa;1;5;B;;678;458;220;1;1;456;457
8;Barcelona;40;Vallès Occidental;08279;Terrassa;1;6;A;;727;528;199;1;8;519;527
8;Barcelona;40;Vallès Occidental;08279;Terrassa;1;6;B;;782;565;217;3;7;555;562
8;Barcelona;40;Vallès Occidental;08279;Terrassa;2;1;A;;403;264;139;3;0;261;261
8;Barcelona;40;Vallès Occidental;08279;Terrassa;2;10;A;;469;289;180;3;2;284;286
8;Barcelona;40;Vallès Occidental;08279;Terrassa;2;11;A;;480;251;229;4;0;247;247
8;Barcelona;40;Vallès Occidental;08279;Terrassa;2;11;B;;626;331;295;0;0;331;331
8;Barcelona;40;Vallès Occidental;08279;Terrassa;2;12;A;;678;438;240;0;2;436;438
8;Barcelona;40;Vallès Occidental;08279;Terrassa;2;12;B;;775;488;287;0;1;487;488
8;Barcelona;40;Vallès Occidental;08279;Terrassa;2;13;A;;521;272;249;3;1;268;269
8;Barcelona;40;Vallès Occidental;08279;Terrassa;2;13;B;;533;279;254;0;1;278;279
8;Barcelona;40;Vallès Occidental;08279;Terrassa;2;13;C;;568;300;268;0;0;300;300
8;Barcelona;40;Vallès Occidental;08279;Terrassa;2;14;A;;777;412;365;2;4;406;410
8;Barcelona;40;Vallès Occidental;08279;Terrassa;2;15;A;;458;222;236;0;1;221;222
8;Barcelona;40;Vallès Occidental;08279;Terrassa;2;15;B;;569;278;291;0;2;276;278
8;Barcelona;40;Vallès Occidental;08279;Terrassa;2;16;A;;463;246;217;0;3;243;246
8;Barcelona;40;Vallès Occidental;08279;Terrassa;2;16;B;;598;275;323;0;1;274;275
8;Barcelona;40;Vallès Occidental;08279;Terrassa;2;17;A;;550;313;237;1;0;312;312
8;Barcelona;40;Vallès Occidental;08279;Terrassa;2;18;A;;686;370;316;11;0;359;359
8;Barcelona;40;Vallès Occidental;08279;Terrassa;2;19;A;;592;322;270;0;1;321;322
8;Barcelona;40;Vallès Occidental;08279;Terrassa;2;19;B;;715;395;320;1;3;391;394
8;Barcelona;40;Vallès Occidental;08279;Terrassa;2;2;A;;790;540;250;0;3;537;540
8;Barcelona;40;Vallès Occidental;08279;Terrassa;2;2;B;;910;659;251;4;9;646;655
8;Barcelona;40;Vallès Occidental;08279;Terrassa;2;20;A;;874;520;354;12;4;504;508
8;Barcelona;40;Vallès Occidental;08279;Terrassa;2;21;A;;556;291;265;0;3;288;291
8;Barcelona;40;Vallès Occidental;08279;Terrassa;2;21;B;;796;410;386;1;0;409;409
8;Barcelona;40;Vallès Occidental;08279;Terrassa;2;22;A;;932;554;378;0;5;549;554
8;Barcelona;40;Vallès Occidental;08279;Terrassa;2;23;A;;772;378;394;6;1;371;372
8;Barcelona;40;Vallès Occidental;08279;Terrassa;2;23;B;;835;436;399;0;4;432;436
8;Barcelona;40;Vallès Occidental;08279;Terrassa;2;24;A;;723;394;329;0;4;390;394
8;Barcelona;40;Vallès Occidental;08279;Terrassa;2;24;B;;987;530;457;3;0;527;527
8;Barcelona;40;Vallès Occidental;08279;Terrassa;2;25;A;;723;436;287;6;6;424;430
8;Barcelona;40;Vallès Occidental;08279;Terrassa;2;25;B;;848;523;325;0;2;521;523
8;Barcelona;40;Vallès Occidental;08279;Terrassa;2;26;A;;865;455;410;0;5;450;455
8;Barcelona;40;Vallès Occidental;08279;Terrassa;2;26;B;;1133;607;526;0;1;606;607
8;Barcelona;40;Vallès Occidental;08279;Terrassa;2;27;A;;507;240;267;0;5;235;240
8;Barcelona;40;Vallès Occidental;08279;Terrassa;2;27;B;;716;325;391;0;1;324;325
8;Barcelona;40;Vallès Occidental;08279;Terrassa;2;28;A;;889;452;437;0;5;447;452
8;Barcelona;40;Vallès Occidental;08279;Terrassa;2;29;A;;655;278;377;0;4;274;278
8;Barcelona;40;Vallès Occidental;08279;Terrassa;2;3;A;;572;379;193;3;4;372;376
8;Barcelona;40;Vallès Occidental;08279;Terrassa;2;3;B;;619;430;189;0;3;427;430
8;Barcelona;40;Vallès Occidental;08279;Terrassa;2;4;A;;720;437;283;3;1;433;434
8;Barcelona;40;Vallès Occidental;08279;Terrassa;2;4;B;;935;547;388;2;5;540;545
8;Barcelona;40;Vallès Occidental;08279;Terrassa;2;5;A;;498;277;221;1;2;274;276
8;Barcelona;40;Vallès Occidental;08279;Terrassa;2;5;B;;574;320;254;6;2;312;314
8;Barcelona;40;Vallès Occidental;08279;Terrassa;2;6;A;;496;276;220;2;2;272;274
8;Barcelona;40;Vallès Occidental;08279;Terrassa;2;6;B;;645;375;270;7;5;363;368
8;Barcelona;40;Vallès Occidental;08279;Terrassa;2;7;A;;600;332;268;0;0;332;332
8;Barcelona;40;Vallès Occidental;08279;Terrassa;2;8;A;;871;510;361;0;0;510;510
8;Barcelona;40;Vallès Occidental;08279;Terrassa;2;9;A;;865;502;363;0;2;500;502
8;Barcelona;40;Vallès Occidental;08279;Terrassa;3;1;A;;516;365;151;0;1;364;365
8;Barcelona;40;Vallès Occidental;08279;Terrassa;3;1;B;;559;381;178;0;1;380;381
8;Barcelona;40;Vallès Occidental;08279;Terrassa;3;10;A;;565;250;315;1;3;246;249
8;Barcelona;40;Vallès Occidental;08279;Terrassa;3;10;B;;708;295;413;0;4;291;295
8;Barcelona;40;Vallès Occidental;08279;Terrassa;3;11;A;;969;427;542;1;5;421;426
8;Barcelona;40;Vallès Occidental;08279;Terrassa;3;12;A;;1081;439;642;6;2;431;433
8;Barcelona;40;Vallès Occidental;08279;Terrassa;3;13;A;;324;134;190;4;1;129;130
8;Barcelona;40;Vallès Occidental;08279;Terrassa;3;2;A;;765;565;200;7;3;555;558
8;Barcelona;40;Vallès Occidental;08279;Terrassa;3;3;A;;770;551;219;0;4;547;551
8;Barcelona;40;Vallès Occidental;08279;Terrassa;3;4;A;;442;303;139;0;3;300;303
8;Barcelona;40;Vallès Occidental;08279;Terrassa;3;5;A;;694;361;333;3;0;358;358
8;Barcelona;40;Vallès Occidental;08279;Terrassa;3;5;B;;834;439;395;2;7;430;437
8;Barcelona;40;Vallès Occidental;08279;Terrassa;3;6;A;;762;497;265;8;2;487;489
8;Barcelona;40;Vallès Occidental;08279;Terrassa;3;7;A;;570;375;195;1;4;370;374
8;Barcelona;40;Vallès Occidental;08279;Terrassa;3;8;A;;643;320;323;3;0;317;317
8;Barcelona;40;Vallès Occidental;08279;Terrassa;3;8;B;;852;426;426;3;0;423;423
8;Barcelona;40;Vallès Occidental;08279;Terrassa;3;9;A;;820;400;420;1;0;399;399
8;Barcelona;40;Vallès Occidental;08279;Terrassa;4;1;A;;1118;748;370;6;2;740;742
8;Barcelona;40;Vallès Occidental;08279;Terrassa;4;2;A;;1112;753;359;2;3;748;751
8;Barcelona;40;Vallès Occidental;08279;Terrassa;4;3;A;;473;306;167;4;2;300;302
8;Barcelona;40;Vallès Occidental;08279;Terrassa;4;3;B;;631;399;232;0;3;396;399
8;Barcelona;40;Vallès Occidental;08279;Terrassa;4;4;A;;483;287;196;2;1;284;285
8;Barcelona;40;Vallès Occidental;08279;Terrassa;4;4;B;;572;346;226;7;2;337;339
8;Barcelona;40;Vallès Occidental;08279;Terrassa;4;5;A;;754;424;330;12;4;408;412
8;Barcelona;40;Vallès Occidental;08279;Terrassa;4;5;B;;893;510;383;2;7;501;508
8;Barcelona;40;Vallès Occidental;08279;Terrassa;4;6;A;;1001;581;420;1;4;576;580
8;Barcelona;40;Vallès Occidental;08279;Terrassa;4;7;A;;674;339;335;2;3;334;337
8;Barcelona;40;Vallès Occidental;08279;Terrassa;4;7;B;;857;444;413;1;1;442;443
8;Barcelona;40;Vallès Occidental;08279;Terrassa;4;8;A;;465;250;215;2;3;245;248
8;Barcelona;40;Vallès Occidental;08279;Terrassa;4;8;B;;719;403;316;5;4;394;398
8;Barcelona;40;Vallès Occidental;08279;Terrassa;5;1;A;;974;696;278;2;2;692;694
8;Barcelona;40;Vallès Occidental;08279;Terrassa;5;10;A;;644;387;257;1;4;382;386
8;Barcelona;40;Vallès Occidental;08279;Terrassa;5;10;B;;648;392;256;3;2;387;389
8;Barcelona;40;Vallès Occidental;08279;Terrassa;5;11;A;;731;430;301;0;1;429;430
8;Barcelona;40;Vallès Occidental;08279;Terrassa;5;11;B;;888;526;362;2;3;521;524
8;Barcelona;40;Vallès Occidental;08279;Terrassa;5;12;A;;643;364;279;0;2;362;364
8;Barcelona;40;Vallès Occidental;08279;Terrassa;5;13;A;;392;207;185;0;1;206;207
8;Barcelona;40;Vallès Occidental;08279;Terrassa;5;13;B;;460;221;239;0;0;221;221
8;Barcelona;40;Vallès Occidental;08279;Terrassa;5;14;A;;521;331;190;0;1;330;331
8;Barcelona;40;Vallès Occidental;08279;Terrassa;5;14;B;;672;392;280;0;0;392;392
8;Barcelona;40;Vallès Occidental;08279;Terrassa;5;14;C;;654;397;257;0;5;392;397
8;Barcelona;40;Vallès Occidental;08279;Terrassa;5;15;A;;566;266;300;0;1;265;266
8;Barcelona;40;Vallès Occidental;08279;Terrassa;5;15;B;;654;343;311;2;2;339;341
8;Barcelona;40;Vallès Occidental;08279;Terrassa;5;16;A;;600;404;196;0;1;403;404
8;Barcelona;40;Vallès Occidental;08279;Terrassa;5;17;A;;480;290;190;1;4;285;289
8;Barcelona;40;Vallès Occidental;08279;Terrassa;5;17;B;;569;337;232;2;1;334;335
8;Barcelona;40;Vallès Occidental;08279;Terrassa;5;18;A;;744;447;297;0;2;445;447
8;Barcelona;40;Vallès Occidental;08279;Terrassa;5;19;A;;637;326;311;0;1;325;326
8;Barcelona;40;Vallès Occidental;08279;Terrassa;5;2;A;;786;544;242;2;3;539;542
8;Barcelona;40;Vallès Occidental;08279;Terrassa;5;2;B;;789;546;243;5;5;536;541
8;Barcelona;40;Vallès Occidental;08279;Terrassa;5;20;A;;795;462;333;0;5;457;462
8;Barcelona;40;Vallès Occidental;08279;Terrassa;5;20;B;;1072;643;429;0;6;637;643
8;Barcelona;40;Vallès Occidental;08279;Terrassa;5;3;A;;547;398;149;0;2;396;398
8;Barcelona;40;Vallès Occidental;08279;Terrassa;5;3;B;;577;415;162;2;4;409;413
8;Barcelona;40;Vallès Occidental;08279;Terrassa;5;4;A;;972;574;398;0;4;570;574
8;Barcelona;40;Vallès Occidental;08279;Terrassa;5;5;A;;566;373;193;1;1;371;372
8;Barcelona;40;Vallès Occidental;08279;Terrassa;5;5;B;;743;486;257;1;3;482;485
8;Barcelona;40;Vallès Occidental;08279;Terrassa;5;6;A;;583;358;225;4;0;354;354
8;Barcelona;40;Vallès Occidental;08279;Terrassa;5;7;A;;513;302;211;0;3;299;302
8;Barcelona;40;Vallès Occidental;08279;Terrassa;5;7;B;;703;400;303;2;6;392;398
8;Barcelona;40;Vallès Occidental;08279;Terrassa;5;7;C;;620;335;285;2;1;332;333
8;Barcelona;40;Vallès Occidental;08279;Terrassa;5;8;A;;826;430;396;2;5;423;428
8;Barcelona;40;Vallès Occidental;08279;Terrassa;5;9;A;;502;339;163;0;1;338;339
8;Barcelona;40;Vallès Occidental;08279;Terrassa;5;9;B;;602;385;217;0;6;379;385
8;Barcelona;40;Vallès Occidental;08279;Terrassa;6;1;A;;538;370;168;3;2;365;367
8;Barcelona;40;Vallès Occidental;08279;Terrassa;6;1;B;;587;384;203;1;3;380;383
8;Barcelona;40;Vallès Occidental;08279;Terrassa;6;10;A;;588;270;318;2;2;266;268
8;Barcelona;40;Vallès Occidental;08279;Terrassa;6;10;B;;784;377;407;2;3;372;375
8;Barcelona;40;Vallès Occidental;08279;Terrassa;6;11;A;;1003;453;550;9;5;439;444
8;Barcelona;40;Vallès Occidental;08279;Terrassa;6;11;B;;1366;586;780;2;2;582;584
8;Barcelona;40;Vallès Occidental;08279;Terrassa;6;12;A;;446;231;215;0;0;231;231
8;Barcelona;40;Vallès Occidental;08279;Terrassa;6;12;B;;652;353;299;2;3;348;351
8;Barcelona;40;Vallès Occidental;08279;Terrassa;6;13;A;;829;439;390;2;3;434;437
8;Barcelona;40;Vallès Occidental;08279;Terrassa;6;14;A;;398;190;208;0;2;188;190
8;Barcelona;40;Vallès Occidental;08279;Terrassa;6;14;B;;433;228;205;0;0;228;228
8;Barcelona;40;Vallès Occidental;08279;Terrassa;6;15;A;;472;292;180;0;0;292;292
8;Barcelona;40;Vallès Occidental;08279;Terrassa;6;16;A;;502;265;237;0;0;265;265
8;Barcelona;40;Vallès Occidental;08279;Terrassa;6;17;A;;532;262;270;0;4;258;262
8;Barcelona;40;Vallès Occidental;08279;Terrassa;6;18;A;;763;394;369;1;2;391;393
8;Barcelona;40;Vallès Occidental;08279;Terrassa;6;19;A;;727;400;327;2;4;394;398
8;Barcelona;40;Vallès Occidental;08279;Terrassa;6;2;A;;783;514;269;2;2;510;512
8;Barcelona;40;Vallès Occidental;08279;Terrassa;6;2;B;;856;564;292;0;5;559;564
8;Barcelona;40;Vallès Occidental;08279;Terrassa;6;20;A;;786;378;408;0;0;378;378
8;Barcelona;40;Vallès Occidental;08279;Terrassa;6;21;A;;610;339;271;1;0;338;338
8;Barcelona;40;Vallès Occidental;08279;Terrassa;6;22;A;;692;357;335;0;0;357;357
8;Barcelona;40;Vallès Occidental;08279;Terrassa;6;22;B;;903;463;440;0;1;462;463
8;Barcelona;40;Vallès Occidental;08279;Terrassa;6;23;A;;388;199;189;0;4;195;199
8;Barcelona;40;Vallès Occidental;08279;Terrassa;6;23;B;;544;283;261;0;0;283;283
8;Barcelona;40;Vallès Occidental;08279;Terrassa;6;24;A;;654;342;312;0;2;340;342
8;Barcelona;40;Vallès Occidental;08279;Terrassa;6;24;B;;902;434;468;1;0;433;433
8;Barcelona;40;Vallès Occidental;08279;Terrassa;6;25;A;;556;320;236;0;3;317;320
8;Barcelona;40;Vallès Occidental;08279;Terrassa;6;26;A;;687;319;368;0;1;318;319
8;Barcelona;40;Vallès Occidental;08279;Terrassa;6;27;A;;642;418;224;0;7;411;418
8;Barcelona;40;Vallès Occidental;08279;Terrassa;6;28;A;;320;122;198;0;0;122;122
8;Barcelona;40;Vallès Occidental;08279;Terrassa;6;29;A;;833;462;371;0;5;457;462
8;Barcelona;40;Vallès Occidental;08279;Terrassa;6;3;A;;598;379;219;0;0;379;379
8;Barcelona;40;Vallès Occidental;08279;Terrassa;6;3;B;;738;474;264;1;1;472;473
8;Barcelona;40;Vallès Occidental;08279;Terrassa;6;30;A;;601;307;294;4;3;300;303
8;Barcelona;40;Vallès Occidental;08279;Terrassa;6;30;B;;857;374;483;1;1;372;373
8;Barcelona;40;Vallès Occidental;08279;Terrassa;6;31;A;;338;184;154;0;1;183;184
8;Barcelona;40;Vallès Occidental;08279;Terrassa;6;31;B;;456;234;222;0;1;233;234
8;Barcelona;40;Vallès Occidental;08279;Terrassa;6;32;A;;508;285;223;0;2;283;285
8;Barcelona;40;Vallès Occidental;08279;Terrassa;6;32;B;;751;419;332;1;1;417;418
8;Barcelona;40;Vallès Occidental;08279;Terrassa;6;33;A;;459;254;205;0;1;253;254
8;Barcelona;40;Vallès Occidental;08279;Terrassa;6;33;B;;639;346;293;2;3;341;344
8;Barcelona;40;Vallès Occidental;08279;Terrassa;6;34;A;;964;624;340;1;3;620;623
8;Barcelona;40;Vallès Occidental;08279;Terrassa;6;4;A;;633;401;232;8;3;390;393
8;Barcelona;40;Vallès Occidental;08279;Terrassa;6;4;B;;728;438;290;2;2;434;436
8;Barcelona;40;Vallès Occidental;08279;Terrassa;6;5;A;;659;357;302;1;6;350;356
8;Barcelona;40;Vallès Occidental;08279;Terrassa;6;5;B;;951;517;434;0;6;511;517
8;Barcelona;40;Vallès Occidental;08279;Terrassa;6;6;A;;720;393;327;0;4;389;393
8;Barcelona;40;Vallès Occidental;08279;Terrassa;6;7;A;;550;335;215;2;2;331;333
8;Barcelona;40;Vallès Occidental;08279;Terrassa;6;8;A;;582;326;256;1;0;325;325
8;Barcelona;40;Vallès Occidental;08279;Terrassa;6;8;B;;795;424;371;0;6;418;424
8;Barcelona;40;Vallès Occidental;08279;Terrassa;6;9;A;;842;393;449;0;2;391;393
8;Barcelona;40;Vallès Occidental;08279;Terrassa;6;9;B;;1093;567;526;7;7;553;560
8;Barcelona;21;Maresme;08282;Tiana;1;1;A;;880;583;297;5;1;577;578
8;Barcelona;21;Maresme;08282;Tiana;1;1;B;;944;683;261;2;4;677;681
8;Barcelona;21;Maresme;08282;Tiana;1;2;A;;453;330;123;1;1;328;329
8;Barcelona;21;Maresme;08282;Tiana;1;2;B;;628;430;198;2;5;423;428
25;Lleida;26;Pallars Sobirà;25221;Tírvia;1;1;A;;91;59;32;1;1;57;58
25;Lleida;23;Noguera;25222;Tiurana;1;1;A;;185;131;54;0;0;131;131
43;Tarragona;9;Baix Ebre;43149;Tivenys;1;1;A;;899;557;342;3;0;554;554
43;Tarragona;30;Ribera d'Ebre;43150;Tivissa;1;1;A;;1169;728;441;9;2;717;719
43;Tarragona;30;Ribera d'Ebre;43150;Tivissa;1;1;B;;283;232;51;0;2;230;232
8;Barcelona;24;Osona;08283;Tona;1;1;A;;441;298;143;2;2;294;296
8;Barcelona;24;Osona;08283;Tona;1;1;B;;510;362;148;2;1;359;360
8;Barcelona;24;Osona;08283;Tona;1;2;A;;814;570;244;0;7;563;570
8;Barcelona;24;Osona;08283;Tona;1;2;B;;990;679;311;8;5;666;671
8;Barcelona;24;Osona;08283;Tona;1;3;A;;555;368;187;5;3;360;363
8;Barcelona;24;Osona;08283;Tona;1;3;B;;584;420;164;1;5;414;419
25;Lleida;32;Segarra;25223;Torà;1;1;A;;982;605;377;4;3;598;601
8;Barcelona;21;Maresme;08284;Tordera;1;1;A;;639;455;184;4;2;449;451
8;Barcelona;21;Maresme;08284;Tordera;1;1;B;;867;626;241;0;0;626;626
8;Barcelona;21;Maresme;08284;Tordera;1;2;A;;546;344;202;1;1;342;343
8;Barcelona;21;Maresme;08284;Tordera;1;2;B;;725;451;274;2;0;449;449
8;Barcelona;21;Maresme;08284;Tordera;1;2;C;;823;506;317;0;1;505;506
8;Barcelona;21;Maresme;08284;Tordera;2;1;A;;632;424;208;1;5;418;423
8;Barcelona;21;Maresme;08284;Tordera;2;1;B;;755;496;259;0;3;493;496
8;Barcelona;21;Maresme;08284;Tordera;2;2;A;;355;238;117;2;1;235;236
8;Barcelona;21;Maresme;08284;Tordera;2;2;B;;507;315;192;1;1;313;314
8;Barcelona;24;Osona;08285;Torelló;1;1;A;;473;303;170;12;0;291;291
8;Barcelona;24;Osona;08285;Torelló;1;1;B;;571;347;224;9;0;338;338
8;Barcelona;24;Osona;08285;Torelló;1;2;A;;1237;806;431;7;5;794;799
8;Barcelona;24;Osona;08285;Torelló;1;3;A;;851;615;236;4;2;609;611
8;Barcelona;24;Osona;08285;Torelló;1;4;A;;900;539;361;13;5;521;526
8;Barcelona;24;Osona;08285;Torelló;2;1;A;;834;530;304;1;2;527;529
8;Barcelona;24;Osona;08285;Torelló;2;2;A;;863;563;300;0;3;560;563
8;Barcelona;24;Osona;08285;Torelló;2;3;A;;1023;667;356;3;3;661;664
8;Barcelona;24;Osona;08285;Torelló;2;4;A;;874;523;351;7;2;514;516
8;Barcelona;24;Osona;08285;Torelló;2;5;A;;981;642;339;7;1;634;635
25;Lleida;18;Garrigues;25224;Torms, els;1;1;A;;189;119;70;0;0;119;119
25;Lleida;38;Urgell;25225;Tornabous;1;1;A;;800;505;295;2;3;500;503
25;Lleida;33;Segrià;25226;Torrebesses;1;1;A;;313;164;149;2;0;162;162
25;Lleida;25;Pallars Jussà;25227;Torre de Cabdella, la;1;1;A;;633;343;290;0;6;337;343
8;Barcelona;6;Anoia;08286;Torre de Claramunt, la;1;1;A;;1038;660;378;2;2;656;658
43;Tarragona;29;Priorat;43151;Torre de Fontaubella, la;1;1;A;;62;34;28;0;0;34;34
43;Tarragona;30;Ribera d'Ebre;43152;Torre de l'Espanyol, la;1;1;A;;621;446;175;1;3;442;445
43;Tarragona;36;Tarragonès;43153;Torredembarra;1;1;A;;758;470;288;1;5;464;469
43;Tarragona;36;Tarragonès;43153;Torredembarra;1;1;B;;1011;635;376;8;5;622;627
43;Tarragona;36;Tarragonès;43153;Torredembarra;1;2;A;;896;540;356;4;5;531;536
43;Tarragona;36;Tarragonès;43153;Torredembarra;1;2;B;;1127;684;443;5;4;675;679
43;Tarragona;36;Tarragonès;43153;Torredembarra;1;3;A;;630;372;258;1;4;367;371
25;Lleida;33;Segrià;25228;Torrefarrera;1;1;A;;1135;803;332;0;3;800;803
25;Lleida;32;Segarra;25907;Torrefeta i Florejacs;1;1;A;;631;367;264;4;4;359;363
25;Lleida;27;Pla d'Urgell;25230;Torregrossa;1;1;A;;662;529;133;1;2;526;528
25;Lleida;27;Pla d'Urgell;25230;Torregrossa;1;2;A;;1204;863;341;5;10;848;858
25;Lleida;23;Noguera;25231;Torrelameu;1;1;A;;488;289;199;0;0;289;289
8;Barcelona;3;Alt Penedès;08287;Torrelavit;1;1;A;;913;604;309;5;4;595;599
8;Barcelona;3;Alt Penedès;08288;Torrelles de Foix;1;1;A;;889;527;362;0;1;526;527
8;Barcelona;11;Baix Llobregat;08289;Torrelles de Llobregat;1;1;A;;587;356;231;0;1;355;356
8;Barcelona;11;Baix Llobregat;08289;Torrelles de Llobregat;1;1;B;;760;512;248;3;1;508;509
17;Girona;10;Baix Empordà;17197;Torrent;1;1;A;;149;86;63;0;0;86;86
25;Lleida;33;Segrià;25232;Torres de Segre;1;1;A;;730;496;234;1;1;494;495
25;Lleida;33;Segrià;25232;Torres de Segre;1;1;B;;771;543;228;1;5;537;542
25;Lleida;33;Segrià;25233;Torre-serona;1;1;A;;247;148;99;1;0;147;147
17;Girona;2;Alt Empordà;17198;Torroella de Fluvià;1;1;A;;232;158;74;0;1;157;158
17;Girona;10;Baix Empordà;17199;Torroella de Montgrí;1;1;A;;740;499;241;1;3;495;498
17;Girona;10;Baix Empordà;17199;Torroella de Montgrí;1;1;B;;521;305;216;3;3;299;302
17;Girona;10;Baix Empordà;17199;Torroella de Montgrí;1;1;C;;742;475;267;4;7;464;471
17;Girona;10;Baix Empordà;17199;Torroella de Montgrí;1;2;A;;721;459;262;7;4;448;452
17;Girona;10;Baix Empordà;17199;Torroella de Montgrí;1;2;B;;475;292;183;6;2;284;286
17;Girona;10;Baix Empordà;17199;Torroella de Montgrí;1;2;C;;709;459;250;5;1;453;454
17;Girona;10;Baix Empordà;17199;Torroella de Montgrí;1;3;A;;782;497;285;2;5;490;495
43;Tarragona;29;Priorat;43154;Torroja del Priorat;1;1;A;;118;81;37;1;0;80;80
17;Girona;19;Garrotxa;17200;Tortellà;1;1;A;;610;438;172;6;4;428;432
43;Tarragona;9;Baix Ebre;43155;Tortosa;1;1;A;;998;573;425;4;2;567;569
43;Tarragona;9;Baix Ebre;43155;Tortosa;1;2;A;;574;324;250;2;1;321;322
43;Tarragona;9;Baix Ebre;43155;Tortosa;1;3;A;;634;372;262;7;6;359;365
43;Tarragona;9;Baix Ebre;43155;Tortosa;1;3;B;;596;371;225;1;2;368;370
43;Tarragona;9;Baix Ebre;43155;Tortosa;1;4;A;;830;472;358;1;2;469;471
43;Tarragona;9;Baix Ebre;43155;Tortosa;1;4;B;;436;239;197;0;2;237;239
43;Tarragona;9;Baix Ebre;43155;Tortosa;1;4;C;;635;380;255;3;0;377;377
43;Tarragona;9;Baix Ebre;43155;Tortosa;1;5;A;;691;339;352;5;0;334;334
43;Tarragona;9;Baix Ebre;43155;Tortosa;1;6;A;;1020;605;415;3;5;597;602
43;Tarragona;9;Baix Ebre;43155;Tortosa;2;1;A;;489;257;232;1;4;252;256
43;Tarragona;9;Baix Ebre;43155;Tortosa;2;2;A;;455;232;223;2;3;227;230
43;Tarragona;9;Baix Ebre;43155;Tortosa;2;3;A;;786;386;400;4;2;380;382
43;Tarragona;9;Baix Ebre;43155;Tortosa;2;3;B;;444;240;204;1;2;237;239
43;Tarragona;9;Baix Ebre;43155;Tortosa;2;3;C;;597;320;277;2;6;312;318
43;Tarragona;9;Baix Ebre;43155;Tortosa;2;4;A;;825;381;444;6;6;369;375
43;Tarragona;9;Baix Ebre;43155;Tortosa;2;5;A;;820;403;417;8;7;388;395
43;Tarragona;9;Baix Ebre;43155;Tortosa;3;1;A;;780;314;466;2;0;312;312
43;Tarragona;9;Baix Ebre;43155;Tortosa;3;2;A;;491;269;222;2;3;264;267
43;Tarragona;9;Baix Ebre;43155;Tortosa;3;3;A;;555;246;309;2;3;241;244
43;Tarragona;9;Baix Ebre;43155;Tortosa;3;3;B;;516;245;271;8;2;235;237
43;Tarragona;9;Baix Ebre;43155;Tortosa;3;4;A;;994;474;520;3;7;464;471
43;Tarragona;9;Baix Ebre;43155;Tortosa;3;5;A;;975;454;521;9;3;442;445
43;Tarragona;9;Baix Ebre;43155;Tortosa;4;1;A;;688;346;342;3;4;339;343
43;Tarragona;9;Baix Ebre;43155;Tortosa;4;1;B;;602;327;275;0;4;323;327
43;Tarragona;9;Baix Ebre;43155;Tortosa;4;2;A;;466;255;211;1;0;254;254
43;Tarragona;9;Baix Ebre;43155;Tortosa;4;2;B;;369;176;193;2;4;170;174
43;Tarragona;9;Baix Ebre;43155;Tortosa;4;2;C;;441;224;217;0;0;224;224
43;Tarragona;9;Baix Ebre;43155;Tortosa;4;3;A;;1363;560;803;2;3;555;558
43;Tarragona;9;Baix Ebre;43155;Tortosa;4;4;A;;600;301;299;1;1;299;300
43;Tarragona;9;Baix Ebre;43155;Tortosa;4;4;B;;533;276;257;3;3;270;273
43;Tarragona;9;Baix Ebre;43155;Tortosa;4;5;A;;777;386;391;3;4;379;383
43;Tarragona;9;Baix Ebre;43155;Tortosa;4;6;A;;726;373;353;3;10;360;370
43;Tarragona;9;Baix Ebre;43155;Tortosa;4;7;A;;502;263;239;0;3;260;263
43;Tarragona;9;Baix Ebre;43155;Tortosa;4;7;B;;256;128;128;0;0;128;128
17;Girona;31;Ripollès;17201;Toses;1;1;A;;128;83;45;0;0;83;83
17;Girona;34;Selva;17202;Tossa de Mar;1;1;A;;780;530;250;2;2;526;528
17;Girona;34;Selva;17202;Tossa de Mar;1;2;A;;654;447;207;0;4;443;447
17;Girona;34;Selva;17202;Tossa de Mar;1;3;A;;1041;750;291;4;4;742;746
25;Lleida;25;Pallars Jussà;25234;Tremp;1;1;A;;955;581;374;1;7;573;580
25;Lleida;25;Pallars Jussà;25234;Tremp;1;2;A;;945;573;372;4;4;565;569
25;Lleida;25;Pallars Jussà;25234;Tremp;2;1;A;;1123;731;392;9;7;715;722
25;Lleida;25;Pallars Jussà;25234;Tremp;2;2;A;;1009;594;415;4;8;582;590
25;Lleida;25;Pallars Jussà;25234;Tremp;3;1;A;;554;286;268;3;1;282;283
17;Girona;10;Baix Empordà;17204;Ullà;1;1;A;;587;345;242;4;2;339;341
8;Barcelona;40;Vallès Occidental;08290;Ullastrell;1;1;A;;661;546;115;7;2;537;539
17;Girona;10;Baix Empordà;17205;Ullastret;1;1;A;;229;139;90;1;0;138;138
43;Tarragona;22;Montsià;43156;Ulldecona;1;1;A;;822;572;250;5;19;548;567
43;Tarragona;22;Montsià;43156;Ulldecona;1;2;A;;732;512;220;5;5;502;507
43;Tarragona;22;Montsià;43156;Ulldecona;1;2;B;;824;599;225;3;8;588;596
43;Tarragona;22;Montsià;43156;Ulldecona;2;1;A;;600;456;144;6;5;445;450
43;Tarragona;22;Montsià;43156;Ulldecona;2;2;A;;689;506;183;1;3;502;505
43;Tarragona;22;Montsià;43156;Ulldecona;3;1;A;;506;247;259;7;3;237;240
43;Tarragona;29;Priorat;43157;Ulldemolins;1;1;A;;479;320;159;5;2;313;315
17;Girona;10;Baix Empordà;17203;Ultramort;1;1;A;;174;116;58;5;0;111;111
17;Girona;15;Cerdanya;17206;Urús;1;1;A;;76;66;10;0;0;66;66
8;Barcelona;40;Vallès Occidental;08291;Vacarisses;1;1;A;;544;365;179;0;1;364;365
17;Girona;2;Alt Empordà;17014;Vajol, la;1;1;A;;61;44;17;0;0;44;44
8;Barcelona;6;Anoia;08292;Vallbona d'Anoia;1;1;A;;808;627;181;9;2;616;618
25;Lleida;38;Urgell;25238;Vallbona de les Monges;1;1;A;;266;179;87;2;0;177;177
8;Barcelona;14;Berguedà;08293;Vallcebre;1;1;A;;285;170;115;0;1;169;170
43;Tarragona;16;Conca de Barberà;43158;Vallclara;1;1;A;;91;52;39;0;1;51;52
17;Girona;19;Garrotxa;17207;Vall d'en Bas, la;1;1;A;;814;575;239;2;8;565;573
17;Girona;19;Garrotxa;17207;Vall d'en Bas, la;1;1;B;;252;195;57;2;6;187;193
17;Girona;19;Garrotxa;17207;Vall d'en Bas, la;1;2;A;;790;506;284;3;6;497;503
17;Girona;19;Garrotxa;17207;Vall d'en Bas, la;1;2;B;;244;154;90;1;2;151;153
17;Girona;19;Garrotxa;17208;Vall de Bianya, la;1;1;A;;456;279;177;3;0;276;276
17;Girona;19;Garrotxa;17208;Vall de Bianya, la;1;1;B;;419;301;118;12;0;289;289
25;Lleida;5;Alta Ribagorça;25043;Vall de Boí, la;1;1;A;;477;243;234;0;1;242;243
25;Lleida;26;Pallars Sobirà;25901;Vall de Cardós;1;1;A;;287;198;89;0;0;198;198
25;Lleida;23;Noguera;25240;Vallfogona de Balaguer;1;1;A;;1087;674;413;2;8;664;672
17;Girona;31;Ripollès;17170;Vallfogona de Ripollès;1;1;A;;207;143;64;0;2;141;143
43;Tarragona;16;Conca de Barberà;43159;Vallfogona de Riucorb;1;1;A;;111;83;28;0;1;82;83
8;Barcelona;41;Vallès Oriental;08294;Vallgorguina;1;1;A;;543;390;153;0;2;388;390
8;Barcelona;11;Baix Llobregat;08295;Vallirana;1;1;A;;643;449;194;1;4;444;448
8;Barcelona;11;Baix Llobregat;08295;Vallirana;1;1;B;;434;287;147;3;0;284;284
8;Barcelona;11;Baix Llobregat;08295;Vallirana;1;1;C;;640;434;206;3;0;431;431
8;Barcelona;11;Baix Llobregat;08295;Vallirana;1;2;A;;666;424;242;5;2;417;419
8;Barcelona;11;Baix Llobregat;08295;Vallirana;1;2;B;;547;299;248;0;1;298;299
8;Barcelona;11;Baix Llobregat;08295;Vallirana;1;2;C;;727;461;266;0;2;459;461
17;Girona;10;Baix Empordà;17209;Vall-llobrega;1;1;A;;157;110;47;2;1;107;108
43;Tarragona;1;Alt Camp;43160;Vallmoll;1;1;A;;697;499;198;6;3;490;493
8;Barcelona;41;Vallès Oriental;08296;Vallromanes;1;1;A;;357;268;89;0;1;267;268
43;Tarragona;1;Alt Camp;43161;Valls;1;1;A;;560;372;188;7;6;359;365
43;Tarragona;1;Alt Camp;43161;Valls;1;1;B;;606;386;220;1;1;384;385
43;Tarragona;1;Alt Camp;43161;Valls;2;1;A;;444;264;180;1;1;262;263
43;Tarragona;1;Alt Camp;43161;Valls;2;1;B;;591;358;233;0;1;357;358
43;Tarragona;1;Alt Camp;43161;Valls;3;1;A;;803;508;295;6;1;501;502
43;Tarragona;1;Alt Camp;43161;Valls;3;1;B;;929;602;327;8;1;593;594
43;Tarragona;1;Alt Camp;43161;Valls;4;1;A;;861;619;242;2;1;616;617
43;Tarragona;1;Alt Camp;43161;Valls;4;2;A;;1492;808;684;0;1;807;808
43;Tarragona;1;Alt Camp;43161;Valls;4;2;B;;418;323;95;0;1;322;323
43;Tarragona;1;Alt Camp;43161;Valls;5;1;A;;855;610;245;1;1;608;609
43;Tarragona;1;Alt Camp;43161;Valls;5;1;B;;1016;692;324;6;8;678;686
43;Tarragona;1;Alt Camp;43161;Valls;5;2;A;;731;472;259;3;3;466;469
43;Tarragona;1;Alt Camp;43161;Valls;5;2;B;;739;435;304;3;0;432;432
43;Tarragona;1;Alt Camp;43161;Valls;5;2;C;;840;528;312;4;2;522;524
43;Tarragona;1;Alt Camp;43161;Valls;6;1;A;;798;519;279;2;2;515;517
43;Tarragona;1;Alt Camp;43161;Valls;6;1;B;;865;586;279;4;4;578;582
43;Tarragona;1;Alt Camp;43161;Valls;6;2;A;;780;485;295;0;3;482;485
43;Tarragona;1;Alt Camp;43161;Valls;6;3;A;;867;531;336;4;0;527;527
43;Tarragona;1;Alt Camp;43161;Valls;6;3;B;;956;585;371;1;4;580;584
25;Lleida;4;Alt Urgell;25906;Valls d'Aguilar, les;1;1;A;;214;105;109;0;0;105;105
25;Lleida;4;Alt Urgell;25239;Valls de Valira, les;1;1;A;;613;272;341;0;2;270;272
43;Tarragona;8;Baix Camp;43162;Vandellòs i l'Hospitalet de l'Infant;1;1;A;;952;606;346;2;2;602;604
43;Tarragona;8;Baix Camp;43162;Vandellòs i l'Hospitalet de l'Infant;1;2;A;;1453;679;774;4;9;666;675
43;Tarragona;8;Baix Camp;43162;Vandellòs i l'Hospitalet de l'Infant;1;3;A;;795;476;319;6;6;464;470
25;Lleida;4;Alt Urgell;25909;Vansa i Fórnols, la;1;1;A;;135;65;70;0;2;63;65
8;Barcelona;6;Anoia;08297;Veciana;1;1;A;;156;89;67;0;1;88;89
43;Tarragona;12;Baix Penedès;43163;Vendrell, el;1;1;A;;482;330;152;2;0;328;328
43;Tarragona;12;Baix Penedès;43163;Vendrell, el;1;1;B;;528;380;148;2;1;377;378
43;Tarragona;12;Baix Penedès;43163;Vendrell, el;1;2;A;;924;607;317;7;3;597;600
43;Tarragona;12;Baix Penedès;43163;Vendrell, el;2;1;A;;863;592;271;4;2;586;588
43;Tarragona;12;Baix Penedès;43163;Vendrell, el;2;2;A;;447;304;143;2;3;299;302
43;Tarragona;12;Baix Penedès;43163;Vendrell, el;2;2;B;;697;448;249;5;2;441;443
43;Tarragona;12;Baix Penedès;43163;Vendrell, el;2;3;A;;623;344;279;1;2;341;343
43;Tarragona;12;Baix Penedès;43163;Vendrell, el;2;3;B;;807;445;362;5;1;439;440
43;Tarragona;12;Baix Penedès;43163;Vendrell, el;3;1;A;;635;421;214;9;2;410;412
43;Tarragona;12;Baix Penedès;43163;Vendrell, el;3;1;B;;614;387;227;1;3;383;386
43;Tarragona;12;Baix Penedès;43163;Vendrell, el;3;1;C;;850;565;285;6;4;555;559
43;Tarragona;12;Baix Penedès;43163;Vendrell, el;3;2;A;;662;370;292;6;4;360;364
43;Tarragona;12;Baix Penedès;43163;Vendrell, el;3;2;B;;743;436;307;1;0;435;435
43;Tarragona;12;Baix Penedès;43163;Vendrell, el;3;3;A;;971;519;452;5;2;512;514
17;Girona;2;Alt Empordà;17210;Ventalló;1;1;A;;426;274;152;3;5;266;271
25;Lleida;38;Urgell;25242;Verdú;1;1;A;;785;525;260;1;1;523;524
17;Girona;10;Baix Empordà;17211;Verges;1;1;A;;919;612;307;10;4;598;602
43;Tarragona;36;Tarragonès;43164;Vespella de Gaià;1;1;A;;57;47;10;0;0;47;47
8;Barcelona;24;Osona;08298;Vic;1;1;A;;744;486;258;0;2;484;486
8;Barcelona;24;Osona;08298;Vic;1;2;A;;854;529;325;0;7;522;529
8;Barcelona;24;Osona;08298;Vic;1;3;A;;734;503;231;5;3;495;498
8;Barcelona;24;Osona;08298;Vic;2;1;A;;858;559;299;2;3;554;557
8;Barcelona;24;Osona;08298;Vic;2;2;A;;544;399;145;0;0;399;399
8;Barcelona;24;Osona;08298;Vic;2;2;B;;640;469;171;0;2;467;469
8;Barcelona;24;Osona;08298;Vic;2;3;A;;639;437;202;0;3;434;437
8;Barcelona;24;Osona;08298;Vic;2;3;B;;848;595;253;2;5;588;593
8;Barcelona;24;Osona;08298;Vic;2;4;A;;603;437;166;0;1;436;437
8;Barcelona;24;Osona;08298;Vic;2;4;B;;765;565;200;1;1;563;564
8;Barcelona;24;Osona;08298;Vic;3;1;A;;623;448;175;0;3;445;448
8;Barcelona;24;Osona;08298;Vic;3;1;B;;644;469;175;3;3;463;466
8;Barcelona;24;Osona;08298;Vic;3;10;A;;481;316;165;1;3;312;315
8;Barcelona;24;Osona;08298;Vic;3;11;A;;909;511;398;1;5;505;510
8;Barcelona;24;Osona;08298;Vic;3;2;A;;1001;730;271;2;11;717;728
8;Barcelona;24;Osona;08298;Vic;3;3;A;;581;376;205;0;1;375;376
8;Barcelona;24;Osona;08298;Vic;3;3;B;;704;442;262;0;1;441;442
8;Barcelona;24;Osona;08298;Vic;3;4;A;;948;639;309;1;3;635;638
8;Barcelona;24;Osona;08298;Vic;3;5;A;;1138;675;463;2;2;671;673
8;Barcelona;24;Osona;08298;Vic;3;6;A;;1055;657;398;0;3;654;657
8;Barcelona;24;Osona;08298;Vic;3;7;A;;1025;692;333;10;9;673;682
8;Barcelona;24;Osona;08298;Vic;3;8;A;;996;631;365;0;9;622;631
8;Barcelona;24;Osona;08298;Vic;3;9;A;;611;435;176;2;5;428;433
8;Barcelona;24;Osona;08298;Vic;4;1;A;;668;427;241;1;4;422;426
8;Barcelona;24;Osona;08298;Vic;4;1;B;;753;527;226;0;4;523;527
8;Barcelona;24;Osona;08298;Vic;4;2;A;;695;445;250;10;3;432;435
8;Barcelona;24;Osona;08298;Vic;4;2;B;;924;613;311;0;1;612;613
8;Barcelona;24;Osona;08298;Vic;4;3;A;;485;313;172;0;0;313;313
8;Barcelona;24;Osona;08298;Vic;4;3;B;;713;439;274;1;2;436;438
8;Barcelona;24;Osona;08298;Vic;5;1;A;;447;336;111;0;1;335;336
17;Girona;24;Osona;17212;Vidrà;1;1;A;;154;97;57;0;2;95;97
17;Girona;34;Selva;17213;Vidreres;1;1;A;;627;459;168;2;2;455;457
17;Girona;34;Selva;17213;Vidreres;1;1;B;;615;452;163;0;0;452;452
17;Girona;34;Selva;17213;Vidreres;1;2;A;;710;481;229;0;1;480;481
17;Girona;34;Selva;17213;Vidreres;1;3;A;;733;498;235;3;5;490;495
25;Lleida;39;Consell General d'Aran;25243;Vielha e Mijaran;1;1;A;;733;435;298;1;3;431;434
25;Lleida;39;Consell General d'Aran;25243;Vielha e Mijaran;1;1;B;;806;477;329;3;2;472;474
25;Lleida;39;Consell General d'Aran;25243;Vielha e Mijaran;1;2;A;;255;173;82;0;1;172;173
25;Lleida;39;Consell General d'Aran;25243;Vielha e Mijaran;1;2;B;;283;182;101;0;0;182;182
25;Lleida;39;Consell General d'Aran;25243;Vielha e Mijaran;1;2;C;;221;114;107;0;0;114;114
43;Tarragona;1;Alt Camp;43165;Vilabella;1;1;A;;648;507;141;3;7;497;504
17;Girona;2;Alt Empordà;17214;Vilabertran;1;1;A;;613;383;230;1;2;380;382
17;Girona;20;Gironès;17215;Vilablareix;1;1;A;;670;478;192;2;7;469;476
8;Barcelona;14;Berguedà;08299;Vilada;1;1;A;;491;312;179;0;3;309;312
17;Girona;2;Alt Empordà;17217;Viladamat;1;1;A;;289;216;73;2;0;214;214
17;Girona;20;Gironès;17216;Viladasens;1;1;A;;157;99;58;0;2;97;99
8;Barcelona;11;Baix Llobregat;08301;Viladecans;1;1;A;;735;384;351;4;2;378;380
8;Barcelona;11;Baix Llobregat;08301;Viladecans;1;1;B;;875;440;435;4;1;435;436
8;Barcelona;11;Baix Llobregat;08301;Viladecans;1;10;A;;565;329;236;1;2;326;328
8;Barcelona;11;Baix Llobregat;08301;Viladecans;1;10;B;;660;374;286;0;8;366;374
8;Barcelona;11;Baix Llobregat;08301;Viladecans;1;11;A;;955;538;417;0;1;537;538
8;Barcelona;11;Baix Llobregat;08301;Viladecans;1;2;A;;534;256;278;4;0;252;252
8;Barcelona;11;Baix Llobregat;08301;Viladecans;1;2;B;;691;336;355;4;2;330;332
8;Barcelona;11;Baix Llobregat;08301;Viladecans;1;3;A;;1188;639;549;1;6;632;638
8;Barcelona;11;Baix Llobregat;08301;Viladecans;1;4;A;;1065;557;508;2;2;553;555
8;Barcelona;11;Baix Llobregat;08301;Viladecans;1;5;A;;495;310;185;0;0;310;310
8;Barcelona;11;Baix Llobregat;08301;Viladecans;1;6;A;;1321;646;675;1;0;645;645
8;Barcelona;11;Baix Llobregat;08301;Viladecans;1;7;A;;1074;621;453;1;0;620;620
8;Barcelona;11;Baix Llobregat;08301;Viladecans;1;8;A;;704;407;297;0;1;406;407
8;Barcelona;11;Baix Llobregat;08301;Viladecans;1;8;B;;899;486;413;3;0;483;483
8;Barcelona;11;Baix Llobregat;08301;Viladecans;1;9;A;;858;469;389;0;2;467;469
8;Barcelona;11;Baix Llobregat;08301;Viladecans;2;1;A;;959;397;562;1;3;393;396
8;Barcelona;11;Baix Llobregat;08301;Viladecans;2;1;B;;1239;544;695;1;3;540;543
8;Barcelona;11;Baix Llobregat;08301;Viladecans;2;10;A;;862;413;449;0;3;410;413
8;Barcelona;11;Baix Llobregat;08301;Viladecans;2;11;A;;842;302;540;1;2;299;301
8;Barcelona;11;Baix Llobregat;08301;Viladecans;2;11;B;;976;369;607;2;0;367;367
8;Barcelona;11;Baix Llobregat;08301;Viladecans;2;12;A;;1036;481;555;1;0;480;480
8;Barcelona;11;Baix Llobregat;08301;Viladecans;2;13;A;;1196;540;656;0;2;538;540
8;Barcelona;11;Baix Llobregat;08301;Viladecans;2;2;A;;981;450;531;8;4;438;442
8;Barcelona;11;Baix Llobregat;08301;Viladecans;2;2;B;;1132;498;634;1;2;495;497
8;Barcelona;11;Baix Llobregat;08301;Viladecans;2;3;A;;1256;653;603;1;6;646;652
8;Barcelona;11;Baix Llobregat;08301;Viladecans;2;4;A;;817;371;446;0;5;366;371
8;Barcelona;11;Baix Llobregat;08301;Viladecans;2;4;B;;955;432;523;1;2;429;431
8;Barcelona;11;Baix Llobregat;08301;Viladecans;2;5;A;;948;521;427;2;5;514;519
8;Barcelona;11;Baix Llobregat;08301;Viladecans;2;5;B;;1176;666;510;1;0;665;665
8;Barcelona;11;Baix Llobregat;08301;Viladecans;2;6;A;;444;226;218;0;5;221;226
8;Barcelona;11;Baix Llobregat;08301;Viladecans;2;6;B;;637;349;288;0;3;346;349
8;Barcelona;11;Baix Llobregat;08301;Viladecans;2;6;C;;594;291;303;1;1;289;290
8;Barcelona;11;Baix Llobregat;08301;Viladecans;2;7;A;;501;274;227;0;4;270;274
8;Barcelona;11;Baix Llobregat;08301;Viladecans;2;7;B;;643;327;316;1;0;326;326
8;Barcelona;11;Baix Llobregat;08301;Viladecans;2;8;A;;1039;528;511;10;3;515;518
8;Barcelona;11;Baix Llobregat;08301;Viladecans;2;9;A;;1059;503;556;5;2;496;498
8;Barcelona;40;Vallès Occidental;08300;Viladecavalls;1;1;A;;794;477;317;3;1;473;474
8;Barcelona;40;Vallès Occidental;08300;Viladecavalls;1;1;B;;953;549;404;5;2;542;544
17;Girona;28;Pla de l'Estany;17218;Vilademuls;1;1;A;;301;197;104;0;3;194;197
17;Girona;28;Pla de l'Estany;17218;Vilademuls;1;1;B;;337;260;77;1;2;257;259
17;Girona;24;Osona;17220;Viladrau;1;1;A;;615;522;93;1;2;519;521
17;Girona;2;Alt Empordà;17221;Vilafant;1;1;A;;554;374;180;3;2;369;371
17;Girona;2;Alt Empordà;17221;Vilafant;1;1;B;;422;248;174;0;3;245;248
17;Girona;2;Alt Empordà;17221;Vilafant;1;1;C;;611;403;208;2;10;391;401
8;Barcelona;3;Alt Penedès;08305;Vilafranca del Penedès;1;1;A;;640;388;252;1;4;383;387
8;Barcelona;3;Alt Penedès;08305;Vilafranca del Penedès;1;1;B;;872;534;338;10;3;521;524
8;Barcelona;3;Alt Penedès;08305;Vilafranca del Penedès;1;2;A;;689;459;230;6;4;449;453
8;Barcelona;3;Alt Penedès;08305;Vilafranca del Penedès;1;2;B;;794;517;277;5;3;509;512
8;Barcelona;3;Alt Penedès;08305;Vilafranca del Penedès;2;1;A;;633;364;269;0;0;364;364
8;Barcelona;3;Alt Penedès;08305;Vilafranca del Penedès;2;1;B;;797;435;362;2;3;430;433
8;Barcelona;3;Alt Penedès;08305;Vilafranca del Penedès;2;2;A;;974;576;398;2;3;571;574
8;Barcelona;3;Alt Penedès;08305;Vilafranca del Penedès;2;3;A;;918;548;370;1;6;541;547
8;Barcelona;3;Alt Penedès;08305;Vilafranca del Penedès;2;3;B;;1072;654;418;0;3;651;654
8;Barcelona;3;Alt Penedès;08305;Vilafranca del Penedès;2;4;A;;681;411;270;1;4;406;410
8;Barcelona;3;Alt Penedès;08305;Vilafranca del Penedès;2;4;B;;769;479;290;5;1;473;474
8;Barcelona;3;Alt Penedès;08305;Vilafranca del Penedès;2;5;A;;1288;889;399;4;9;876;885
8;Barcelona;3;Alt Penedès;08305;Vilafranca del Penedès;3;1;A;;745;456;289;2;1;453;454
8;Barcelona;3;Alt Penedès;08305;Vilafranca del Penedès;3;1;B;;829;516;313;1;4;511;515
8;Barcelona;3;Alt Penedès;08305;Vilafranca del Penedès;3;2;A;;890;640;250;1;5;634;639
8;Barcelona;3;Alt Penedès;08305;Vilafranca del Penedès;3;3;A;;795;447;348;0;2;445;447
8;Barcelona;3;Alt Penedès;08305;Vilafranca del Penedès;3;3;B;;916;558;358;3;2;553;555
8;Barcelona;3;Alt Penedès;08305;Vilafranca del Penedès;4;1;A;;859;608;251;2;3;603;606
8;Barcelona;3;Alt Penedès;08305;Vilafranca del Penedès;4;1;B;;997;708;289;2;2;704;706
8;Barcelona;3;Alt Penedès;08305;Vilafranca del Penedès;4;2;A;;869;580;289;1;1;578;579
8;Barcelona;3;Alt Penedès;08305;Vilafranca del Penedès;4;2;B;;1063;719;344;4;2;713;715
8;Barcelona;3;Alt Penedès;08305;Vilafranca del Penedès;4;3;A;;670;433;237;4;1;428;429
8;Barcelona;3;Alt Penedès;08305;Vilafranca del Penedès;4;3;B;;726;470;256;2;1;467;468
8;Barcelona;3;Alt Penedès;08305;Vilafranca del Penedès;4;4;A;;1154;793;361;0;5;788;793
25;Lleida;38;Urgell;25244;Vilagrassa;1;1;A;;352;258;94;1;1;256;257
17;Girona;2;Alt Empordà;17223;Vilajuïga;1;1;A;;528;388;140;1;3;384;387
43;Tarragona;37;Terra Alta;43175;Vilalba dels Arcs;1;1;A;;665;461;204;1;2;458;460
8;Barcelona;41;Vallès Oriental;08306;Vilalba Sasserra;1;1;A;;221;137;84;0;0;137;137
25;Lleida;5;Alta Ribagorça;25245;Vilaller;1;1;A;;485;278;207;0;1;277;278
43;Tarragona;36;Tarragonès;43166;Vilallonga del Camp;1;1;A;;876;621;255;3;2;616;618
17;Girona;31;Ripollès;17224;Vilallonga de Ter;1;1;A;;376;314;62;1;2;311;313
17;Girona;2;Alt Empordà;17225;Vilamacolum;1;1;A;;209;111;98;0;0;111;111
17;Girona;2;Alt Empordà;17226;Vilamalla;1;1;A;;370;223;147;1;4;218;222
17;Girona;2;Alt Empordà;17227;Vilamaniscle;1;1;A;;98;66;32;0;1;65;66
25;Lleida;39;Consell General d'Aran;25247;Vilamòs;1;1;A;;69;45;24;0;0;45;45
17;Girona;2;Alt Empordà;17228;Vilanant;1;1;A;;226;126;100;1;1;124;125
43;Tarragona;8;Baix Camp;43167;Vilanova d'Escornalbou;1;1;A;;343;251;92;1;1;249;250
25;Lleida;27;Pla d'Urgell;25248;Vilanova de Bellpuig;1;1;A;;1026;742;284;2;0;740;740
25;Lleida;23;Noguera;25249;Vilanova de l'Aguda;1;1;A;;249;140;109;0;0;140;140
25;Lleida;33;Segrià;25254;Vilanova de la Barca;1;1;A;;720;514;206;3;8;503;511
8;Barcelona;6;Anoia;08302;Vilanova del Camí;1;1;A;;595;344;251;0;2;342;344
8;Barcelona;6;Anoia;08302;Vilanova del Camí;1;1;B;;660;403;257;0;2;401;403
8;Barcelona;6;Anoia;08302;Vilanova del Camí;1;2;A;;626;347;279;2;1;344;345
8;Barcelona;6;Anoia;08302;Vilanova del Camí;1;2;B;;641;347;294;1;2;344;346
8;Barcelona;6;Anoia;08302;Vilanova del Camí;1;3;A;;504;292;212;0;3;289;292
8;Barcelona;6;Anoia;08302;Vilanova del Camí;1;3;B;;546;328;218;1;1;326;327
8;Barcelona;6;Anoia;08302;Vilanova del Camí;1;4;A;;580;336;244;0;3;333;336
8;Barcelona;6;Anoia;08302;Vilanova del Camí;1;4;B;;643;356;287;1;2;353;355
8;Barcelona;6;Anoia;08302;Vilanova del Camí;1;5;A;;637;350;287;0;2;348;350
8;Barcelona;6;Anoia;08302;Vilanova del Camí;1;5;B;;643;332;311;2;2;328;330
8;Barcelona;41;Vallès Oriental;08902;Vilanova del Vallès;1;1;A;;1002;623;379;1;3;619;622
25;Lleida;23;Noguera;25250;Vilanova de Meià;1;1;A;;439;267;172;3;1;263;264
43;Tarragona;16;Conca de Barberà;43168;Vilanova de Prades;1;1;A;;146;100;46;2;0;98;98
8;Barcelona;24;Osona;08303;Vilanova de Sau;1;1;A;;255;185;70;0;1;184;185
25;Lleida;33;Segrià;25251;Vilanova de Segrià;1;1;A;;560;365;195;2;0;363;363
8;Barcelona;17;Garraf;08307;Vilanova i la Geltrú;1;1;A;;1175;675;500;0;6;669;675
8;Barcelona;17;Garraf;08307;Vilanova i la Geltrú;1;2;A;;1374;807;567;1;2;804;806
8;Barcelona;17;Garraf;08307;Vilanova i la Geltrú;1;3;A;;803;502;301;4;1;497;498
8;Barcelona;17;Garraf;08307;Vilanova i la Geltrú;1;3;B;;927;606;321;6;2;598;600
8;Barcelona;17;Garraf;08307;Vilanova i la Geltrú;1;4;A;;868;605;263;1;1;603;604
8;Barcelona;17;Garraf;08307;Vilanova i la Geltrú;1;5;A;;903;581;322;0;8;573;581
8;Barcelona;17;Garraf;08307;Vilanova i la Geltrú;1;6;A;;1216;689;527;5;6;678;684
8;Barcelona;17;Garraf;08307;Vilanova i la Geltrú;1;7;A;;620;382;238;1;1;380;381
8;Barcelona;17;Garraf;08307;Vilanova i la Geltrú;1;7;B;;729;439;290;0;4;435;439
8;Barcelona;17;Garraf;08307;Vilanova i la Geltrú;1;8;A;;1469;836;633;5;5;826;831
8;Barcelona;17;Garraf;08307;Vilanova i la Geltrú;1;9;A;;1390;708;682;2;2;704;706
8;Barcelona;17;Garraf;08307;Vilanova i la Geltrú;2;1;A;;895;599;296;1;2;596;598
8;Barcelona;17;Garraf;08307;Vilanova i la Geltrú;2;2;A;;723;444;279;1;0;443;443
8;Barcelona;17;Garraf;08307;Vilanova i la Geltrú;2;2;B;;794;459;335;1;1;457;458
8;Barcelona;17;Garraf;08307;Vilanova i la Geltrú;2;3;A;;797;523;274;1;10;512;522
8;Barcelona;17;Garraf;08307;Vilanova i la Geltrú;2;4;A;;731;443;288;0;0;443;443
8;Barcelona;17;Garraf;08307;Vilanova i la Geltrú;2;4;B;;910;572;338;0;4;568;572
8;Barcelona;17;Garraf;08307;Vilanova i la Geltrú;2;5;A;;1364;768;596;3;7;758;765
8;Barcelona;17;Garraf;08307;Vilanova i la Geltrú;2;6;A;;1065;606;459;2;1;603;604
8;Barcelona;17;Garraf;08307;Vilanova i la Geltrú;3;1;A;;651;425;226;2;1;422;423
8;Barcelona;17;Garraf;08307;Vilanova i la Geltrú;3;2;A;;922;583;339;1;2;580;582
8;Barcelona;17;Garraf;08307;Vilanova i la Geltrú;3;3;A;;823;440;383;2;6;432;438
8;Barcelona;17;Garraf;08307;Vilanova i la Geltrú;3;4;A;;696;378;318;0;2;376;378
8;Barcelona;17;Garraf;08307;Vilanova i la Geltrú;3;4;B;;724;390;334;1;1;388;389
8;Barcelona;17;Garraf;08307;Vilanova i la Geltrú;3;5;A;;934;452;482;7;0;445;445
8;Barcelona;17;Garraf;08307;Vilanova i la Geltrú;4;1;A;;1018;673;345;0;4;669;673
8;Barcelona;17;Garraf;08307;Vilanova i la Geltrú;4;10;A;;875;484;391;0;1;483;484
8;Barcelona;17;Garraf;08307;Vilanova i la Geltrú;4;2;A;;733;436;297;5;3;428;431
8;Barcelona;17;Garraf;08307;Vilanova i la Geltrú;4;3;A;;1104;535;569;5;1;529;530
8;Barcelona;17;Garraf;08307;Vilanova i la Geltrú;4;4;A;;737;433;304;2;1;430;431
8;Barcelona;17;Garraf;08307;Vilanova i la Geltrú;4;4;B;;913;562;351;4;0;558;558
8;Barcelona;17;Garraf;08307;Vilanova i la Geltrú;4;5;A;;824;437;387;6;2;429;431
8;Barcelona;17;Garraf;08307;Vilanova i la Geltrú;4;5;B;;981;516;465;3;2;511;513
8;Barcelona;17;Garraf;08307;Vilanova i la Geltrú;4;6;A;;694;412;282;1;1;410;411
8;Barcelona;17;Garraf;08307;Vilanova i la Geltrú;4;6;B;;921;549;372;3;1;545;546
8;Barcelona;17;Garraf;08307;Vilanova i la Geltrú;4;7;A;;577;275;302;1;0;274;274
8;Barcelona;17;Garraf;08307;Vilanova i la Geltrú;4;8;A;;1229;721;508;1;3;717;720
8;Barcelona;17;Garraf;08307;Vilanova i la Geltrú;4;9;A;;639;403;236;6;4;393;397
43;Tarragona;8;Baix Camp;43169;Vilaplana;1;1;A;;437;341;96;8;10;323;333
43;Tarragona;1;Alt Camp;43170;Vila-rodona;1;1;A;;844;554;290;4;6;544;550
17;Girona;2;Alt Empordà;17230;Vila-sacra;1;1;A;;312;218;94;0;2;216;218
25;Lleida;27;Pla d'Urgell;25252;Vila-sana;1;1;A;;429;251;178;0;0;251;251
43;Tarragona;36;Tarragonès;43171;Vila-seca;1;1;A;;748;499;249;0;3;496;499
43;Tarragona;36;Tarragonès;43171;Vila-seca;1;1;B;;392;243;149;2;2;239;241
43;Tarragona;36;Tarragonès;43171;Vila-seca;1;10;A;;568;284;284;4;1;279;280
43;Tarragona;36;Tarragonès;43171;Vila-seca;1;10;B;;552;232;320;2;2;228;230
43;Tarragona;36;Tarragonès;43171;Vila-seca;1;10;C;;588;284;304;1;3;280;283
43;Tarragona;36;Tarragonès;43171;Vila-seca;1;11;A;;689;360;329;0;3;357;360
43;Tarragona;36;Tarragonès;43171;Vila-seca;1;11;B;;749;372;377;2;2;368;370
43;Tarragona;36;Tarragonès;43171;Vila-seca;1;2;A;;417;242;175;0;2;240;242
43;Tarragona;36;Tarragonès;43171;Vila-seca;1;2;B;;565;325;240;2;2;321;323
43;Tarragona;36;Tarragonès;43171;Vila-seca;1;2;C;;585;347;238;3;3;341;344
43;Tarragona;36;Tarragonès;43171;Vila-seca;1;3;A;;380;218;162;3;1;214;215
43;Tarragona;36;Tarragonès;43171;Vila-seca;1;3;B;;515;302;213;4;1;297;298
43;Tarragona;36;Tarragonès;43171;Vila-seca;1;4;A;;409;279;130;1;1;277;278
43;Tarragona;36;Tarragonès;43171;Vila-seca;1;4;B;;516;349;167;0;2;347;349
43;Tarragona;36;Tarragonès;43171;Vila-seca;1;5;A;;549;323;226;0;2;321;323
43;Tarragona;36;Tarragonès;43171;Vila-seca;1;5;B;;635;385;250;2;8;375;383
43;Tarragona;36;Tarragonès;43171;Vila-seca;1;6;A;;474;261;213;1;0;260;260
43;Tarragona;36;Tarragonès;43171;Vila-seca;1;6;B;;477;254;223;3;1;250;251
43;Tarragona;36;Tarragonès;43171;Vila-seca;1;7;A;;579;357;222;3;0;354;354
43;Tarragona;36;Tarragonès;43171;Vila-seca;1;8;A;;459;176;283;1;0;175;175
43;Tarragona;36;Tarragonès;43171;Vila-seca;1;8;B;;421;199;222;1;1;197;198
43;Tarragona;36;Tarragonès;43171;Vila-seca;1;9;A;;587;260;327;3;0;257;257
43;Tarragona;36;Tarragonès;43171;Vila-seca;1;9;B;;671;298;373;2;1;295;296
8;Barcelona;21;Maresme;08214;Vilassar de Dalt;1;1;A;;715;473;242;1;1;471;472
8;Barcelona;21;Maresme;08214;Vilassar de Dalt;1;1;B;;668;425;243;0;1;424;425
8;Barcelona;21;Maresme;08214;Vilassar de Dalt;1;1;C;;735;509;226;0;3;506;509
8;Barcelona;21;Maresme;08214;Vilassar de Dalt;1;2;A;;990;651;339;1;3;647;650
8;Barcelona;21;Maresme;08214;Vilassar de Dalt;2;1;A;;519;365;154;1;1;363;364
8;Barcelona;21;Maresme;08214;Vilassar de Dalt;2;2;A;;508;338;170;0;0;338;338
8;Barcelona;21;Maresme;08214;Vilassar de Dalt;2;2;B;;584;420;164;0;0;420;420
8;Barcelona;21;Maresme;08219;Vilassar de Mar;1;1;A;;506;344;162;1;0;343;343
8;Barcelona;21;Maresme;08219;Vilassar de Mar;1;1;B;;660;425;235;6;3;416;419
8;Barcelona;21;Maresme;08219;Vilassar de Mar;1;2;A;;561;360;201;1;1;358;359
8;Barcelona;21;Maresme;08219;Vilassar de Mar;1;2;B;;753;508;245;1;2;505;507
8;Barcelona;21;Maresme;08219;Vilassar de Mar;1;3;A;;407;245;162;0;2;243;245
8;Barcelona;21;Maresme;08219;Vilassar de Mar;1;3;B;;439;283;156;0;1;282;283
8;Barcelona;21;Maresme;08219;Vilassar de Mar;2;1;A;;593;393;200;3;1;389;390
8;Barcelona;21;Maresme;08219;Vilassar de Mar;2;1;B;;586;400;186;1;3;396;399
8;Barcelona;21;Maresme;08219;Vilassar de Mar;2;2;A;;482;331;151;0;3;328;331
8;Barcelona;21;Maresme;08219;Vilassar de Mar;2;2;B;;554;373;181;2;1;370;371
8;Barcelona;21;Maresme;08219;Vilassar de Mar;3;1;A;;403;303;100;0;0;303;303
8;Barcelona;21;Maresme;08219;Vilassar de Mar;3;1;B;;489;337;152;2;0;335;335
8;Barcelona;21;Maresme;08219;Vilassar de Mar;3;2;A;;640;384;256;4;2;378;380
8;Barcelona;21;Maresme;08219;Vilassar de Mar;3;2;B;;634;379;255;2;1;376;377
17;Girona;2;Alt Empordà;17222;Vilaür;1;1;A;;74;61;13;0;0;61;61
43;Tarragona;16;Conca de Barberà;43172;Vilaverd;1;1;A;;327;262;65;4;0;258;258
43;Tarragona;29;Priorat;43173;Vilella Alta, la;1;1;A;;119;91;28;0;0;91;91
43;Tarragona;29;Priorat;43174;Vilella Baixa, la;1;1;A;;158;87;71;1;0;86;86
17;Girona;34;Selva;17233;Vilobí d'Onyar;1;1;A;;631;415;216;0;2;413;415
17;Girona;34;Selva;17233;Vilobí d'Onyar;1;1;B;;789;517;272;2;3;512;515
8;Barcelona;3;Alt Penedès;08304;Vilobí del Penedès;1;1;A;;614;408;206;5;6;397;403
17;Girona;10;Baix Empordà;17232;Vilopriu;1;1;A;;154;91;63;0;0;91;91
25;Lleida;18;Garrigues;25253;Vilosell, el;1;1;A;;188;135;53;1;0;134;134
43;Tarragona;16;Conca de Barberà;43176;Vimbodí i Poblet;1;1;A;;934;602;332;8;6;588;594
25;Lleida;18;Garrigues;25255;Vinaixa;1;1;A;;587;413;174;2;2;409;411
43;Tarragona;30;Ribera d'Ebre;43177;Vinebre;1;1;A;;384;249;135;16;2;231;233
43;Tarragona;8;Baix Camp;43178;Vinyols i els Arcs;1;1;A;;607;418;189;0;1;417;418
8;Barcelona;14;Berguedà;08308;Viver i Serrateix;1;1;A;;171;126;45;0;1;125;126
43;Tarragona;9;Baix Ebre;43052;Xerta;1;1;A;;1045;731;314;6;4;721;725
8;Barcelona;98;Residents Absents;08998;Residents Absents;1;1;U;;9669;4125;5544;6;15;4104;4119
17;Girona;98;Residents Absents;17998;Residents Absents;1;1;U;;953;450;503;2;1;447;448
25;Lleida;98;Residents Absents;25998;Residents Absents;1;1;U;;1810;976;834;83;5;888;893
43;Tarragona;98;Residents Absents;43998;Residents Absents;1;1;U;;988;434;554;4;3;427;430
