﻿Codi Província;Nom Província;Codi Comarca;Nom Comarca;Codi Municipi;Nom Municipi;Districte;Secció;Mesa;Població;Cens;Participació 20:00;Abstenció;Vots nuls;Vots en blanc;Vots a candidatures;Vots vàlids
25;Lleida;25;Pallars Jussà;25001;Abella de la Conca;1;1;1;;149;69;80;0;0;69;69
8;Barcelona;11;Baix Llobregat;08001;Abrera;1;1;1;;810;555;255;0;3;552;555
8;Barcelona;11;Baix Llobregat;08001;Abrera;1;1;2;;690;487;203;0;4;483;487
8;Barcelona;11;Baix Llobregat;08001;Abrera;1;2;1;;683;425;258;4;0;421;421
8;Barcelona;11;Baix Llobregat;08001;Abrera;1;2;2;;613;414;199;0;0;414;414
25;Lleida;23;Noguera;25002;Àger;1;1;1;;562;374;188;1;2;371;373
25;Lleida;38;Urgell;25003;Agramunt;1;1;1;;897;575;322;0;2;573;575
25;Lleida;38;Urgell;25003;Agramunt;1;1;2;;807;600;207;2;3;595;598
25;Lleida;38;Urgell;25003;Agramunt;1;2;1;;979;612;367;1;3;608;611
25;Lleida;38;Urgell;25003;Agramunt;1;2;2;;1016;696;320;3;1;692;693
8;Barcelona;7;Bages;08002;Aguilar de Segarra;1;1;1;;183;142;41;0;0;142;142
17;Girona;2;Alt Empordà;17001;Agullana;1;1;1;;511;343;168;6;6;331;337
8;Barcelona;41;Vallès Oriental;08014;Aiguafreda;1;1;1;;658;520;138;0;4;516;520
8;Barcelona;41;Vallès Oriental;08014;Aiguafreda;1;1;2;;832;682;150;2;1;679;680
43;Tarragona;1;Alt Camp;43001;Aiguamúrcia;1;1;1;;395;295;100;2;6;287;293
43;Tarragona;1;Alt Camp;43001;Aiguamúrcia;1;2;1;;98;64;34;0;0;64;64
17;Girona;20;Gironès;17002;Aiguaviva;1;1;1;;259;183;76;6;0;177;177
25;Lleida;33;Segrià;25038;Aitona;1;1;1;;647;395;252;4;0;391;391
25;Lleida;33;Segrià;25038;Aitona;1;2;1;;1136;791;345;8;0;783;783
25;Lleida;33;Segrià;25004;Alamús, els;1;1;1;;524;348;176;5;2;341;343
25;Lleida;4;Alt Urgell;25005;Alàs i Cerc;1;1;1;;426;257;169;0;0;257;257
25;Lleida;18;Garrigues;25006;Albagés, l';1;1;1;;477;358;119;3;1;354;355
17;Girona;2;Alt Empordà;17003;Albanyà;1;1;1;;86;60;26;0;1;59;60
25;Lleida;33;Segrià;25007;Albatàrrec;1;1;1;;826;558;268;3;4;551;555
25;Lleida;23;Noguera;25008;Albesa;1;1;1;;1162;764;398;8;8;748;756
25;Lleida;18;Garrigues;25009;Albi, l';1;1;1;;657;509;148;4;2;503;505
43;Tarragona;12;Baix Penedès;43002;Albinyana;1;1;1;;424;328;96;4;1;323;324
43;Tarragona;8;Baix Camp;43003;Albiol, l';1;1;1;;57;31;26;2;0;29;29
17;Girona;10;Baix Empordà;17004;Albons;1;1;1;;397;322;75;3;0;319;319
43;Tarragona;22;Montsià;43004;Alcanar;1;1;1;;777;455;322;1;5;449;454
43;Tarragona;22;Montsià;43004;Alcanar;1;2;1;;812;463;349;9;2;452;454
43;Tarragona;22;Montsià;43004;Alcanar;1;2;2;;778;471;307;10;3;458;461
43;Tarragona;22;Montsià;43004;Alcanar;1;3;1;;756;471;285;2;0;469;469
43;Tarragona;22;Montsià;43004;Alcanar;2;1;1;;1067;576;491;9;6;561;567
43;Tarragona;22;Montsià;43004;Alcanar;2;2;1;;741;369;372;1;2;366;368
43;Tarragona;22;Montsià;43004;Alcanar;2;3;1;;610;319;291;4;5;310;315
25;Lleida;33;Segrià;25010;Alcanó;1;1;1;;245;175;70;0;0;175;175
25;Lleida;33;Segrià;25011;Alcarràs;1;1;1;;1029;515;514;4;2;509;511
25;Lleida;33;Segrià;25011;Alcarràs;1;1;2;;1017;485;532;0;2;483;485
25;Lleida;33;Segrià;25011;Alcarràs;1;2;1;;635;299;336;3;1;295;296
25;Lleida;33;Segrià;25011;Alcarràs;1;2;2;;627;286;341;3;0;283;283
25;Lleida;33;Segrià;25012;Alcoletge;1;1;1;;1053;694;359;2;9;683;692
43;Tarragona;1;Alt Camp;43005;Alcover;1;1;1;;769;513;256;1;6;506;512
43;Tarragona;1;Alt Camp;43005;Alcover;1;1;2;;729;501;228;5;1;495;496
43;Tarragona;1;Alt Camp;43005;Alcover;2;1;1;;573;388;185;4;4;380;384
43;Tarragona;1;Alt Camp;43005;Alcover;2;1;2;;580;379;201;4;2;373;375
43;Tarragona;9;Baix Ebre;43904;Aldea, l';1;1;1;;1442;756;686;16;6;734;740
43;Tarragona;9;Baix Ebre;43904;Aldea, l';1;2;1;;1143;567;576;11;2;554;556
43;Tarragona;9;Baix Ebre;43006;Aldover;1;1;1;;700;467;233;2;2;463;465
43;Tarragona;8;Baix Camp;43007;Aleixar, l';1;1;1;;514;393;121;8;1;384;385
8;Barcelona;21;Maresme;08003;Alella;1;1;1;;1019;793;226;0;1;792;793
8;Barcelona;21;Maresme;08003;Alella;1;1;2;;899;692;207;1;1;690;691
8;Barcelona;21;Maresme;08003;Alella;1;2;1;;713;505;208;0;3;502;505
43;Tarragona;9;Baix Ebre;43008;Alfara de Carles;1;1;1;;354;193;161;0;1;192;193
25;Lleida;33;Segrià;25013;Alfarràs;1;1;1;;1330;895;435;24;5;866;871
25;Lleida;33;Segrià;25013;Alfarràs;1;2;1;;1136;761;375;62;7;692;699
25;Lleida;33;Segrià;25014;Alfés;1;1;1;;297;163;134;0;2;161;163
43;Tarragona;8;Baix Camp;43009;Alforja;1;1;1;;922;786;136;4;10;772;782
25;Lleida;23;Noguera;25015;Algerri;1;1;1;;512;360;152;1;3;356;359
25;Lleida;33;Segrià;25016;Alguaire;1;1;1;;736;449;287;0;3;446;449
25;Lleida;33;Segrià;25016;Alguaire;1;1;2;;702;442;260;1;1;440;441
25;Lleida;33;Segrià;25016;Alguaire;1;2;2;;767;490;277;1;1;488;489
25;Lleida;26;Pallars Sobirà;25017;Alins;1;1;1;;300;209;91;2;0;207;207
43;Tarragona;1;Alt Camp;43010;Alió;1;1;1;;295;214;81;3;2;209;211
25;Lleida;33;Segrià;25019;Almacelles;1;1;1;;721;393;328;0;5;388;393
25;Lleida;33;Segrià;25019;Almacelles;1;2;1;;984;595;389;0;4;591;595
25;Lleida;33;Segrià;25019;Almacelles;2;1;1;;736;444;292;7;0;437;437
25;Lleida;33;Segrià;25019;Almacelles;2;1;2;;668;429;239;1;4;424;428
25;Lleida;33;Segrià;25019;Almacelles;2;2;1;;946;511;435;1;2;508;510
25;Lleida;33;Segrià;25020;Almatret;1;1;1;;554;315;239;1;2;312;314
25;Lleida;33;Segrià;25021;Almenar;1;1;1;;966;495;471;4;4;487;491
25;Lleida;33;Segrià;25021;Almenar;2;1;1;;981;603;378;2;0;601;601
25;Lleida;33;Segrià;25021;Almenar;2;1;2;;910;565;345;0;0;565;565
43;Tarragona;8;Baix Camp;43011;Almoster;1;1;1;;298;238;60;0;1;237;238
25;Lleida;23;Noguera;25022;Alòs de Balaguer;1;1;1;;143;116;27;0;0;116;116
17;Girona;15;Cerdanya;17006;Alp;1;1;1;;657;428;229;0;2;426;428
8;Barcelona;24;Osona;08004;Alpens;1;1;1;;198;153;45;0;0;153;153
25;Lleida;33;Segrià;25023;Alpicat;1;1;1;;1405;854;551;2;14;838;852
25;Lleida;33;Segrià;25023;Alpicat;1;2;1;;622;329;293;2;0;327;327
25;Lleida;33;Segrià;25023;Alpicat;1;3;1;;368;186;182;0;5;181;186
43;Tarragona;36;Tarragonès;43012;Altafulla;1;1;1;;858;618;240;10;3;605;608
25;Lleida;26;Pallars Sobirà;25024;Alt Àneu;1;1;1;;299;166;133;0;0;166;166
17;Girona;34;Selva;17007;Amer;1;1;1;;784;595;189;5;1;589;590
17;Girona;34;Selva;17007;Amer;1;1;2;;807;605;202;1;3;601;604
17;Girona;34;Selva;17007;Amer;1;2;1;;349;212;137;0;0;212;212
8;Barcelona;41;Vallès Oriental;08005;Ametlla del Vallès, l';1;1;1;;797;605;192;3;4;598;602
8;Barcelona;41;Vallès Oriental;08005;Ametlla del Vallès, l';1;1;2;;712;553;159;4;4;545;549
43;Tarragona;9;Baix Ebre;43013;Ametlla de Mar, l';1;1;1;;1114;830;284;9;0;821;821
43;Tarragona;9;Baix Ebre;43013;Ametlla de Mar, l';1;2;1;;1056;765;291;0;4;761;765
43;Tarragona;9;Baix Ebre;43013;Ametlla de Mar, l';1;2;2;;761;538;223;2;2;534;536
43;Tarragona;22;Montsià;43014;Amposta;1;1;1;;642;382;260;5;5;372;377
43;Tarragona;22;Montsià;43014;Amposta;1;2;1;;886;555;331;5;9;541;550
43;Tarragona;22;Montsià;43014;Amposta;1;3;1;;634;342;292;3;1;338;339
43;Tarragona;22;Montsià;43014;Amposta;1;4;1;;122;90;32;0;0;90;90
43;Tarragona;22;Montsià;43014;Amposta;2;1;1;;781;517;264;1;11;505;516
43;Tarragona;22;Montsià;43014;Amposta;2;2;1;;962;569;393;5;10;554;564
43;Tarragona;22;Montsià;43014;Amposta;3;1;1;;908;555;353;3;12;540;552
43;Tarragona;22;Montsià;43014;Amposta;3;2;1;;1140;642;498;3;1;638;639
43;Tarragona;22;Montsià;43014;Amposta;4;1;1;;1323;799;524;1;5;793;798
43;Tarragona;22;Montsià;43014;Amposta;4;2;1;;1288;711;577;9;6;696;702
43;Tarragona;22;Montsià;43014;Amposta;4;3;1;;1353;779;574;6;6;767;773
43;Tarragona;22;Montsià;43014;Amposta;4;4;1;;1053;576;477;6;4;566;570
17;Girona;34;Selva;17008;Anglès;1;1;1;;531;357;174;2;0;355;355
17;Girona;34;Selva;17008;Anglès;1;1;2;;603;420;183;0;5;415;420
17;Girona;34;Selva;17008;Anglès;1;2;1;;812;583;229;1;6;576;582
17;Girona;34;Selva;17008;Anglès;1;2;2;;758;579;179;0;5;574;579
17;Girona;34;Selva;17008;Anglès;1;3;1;;965;692;273;2;9;681;690
17;Girona;34;Selva;17008;Anglès;1;4;1;;230;140;90;0;0;140;140
25;Lleida;38;Urgell;25027;Anglesola;1;1;1;;1065;711;354;0;2;709;711
25;Lleida;18;Garrigues;25029;Arbeca;1;1;1;;993;697;296;3;0;694;694
25;Lleida;18;Garrigues;25029;Arbeca;1;2;1;;952;636;316;0;2;634;636
43;Tarragona;12;Baix Penedès;43016;Arboç, l';1;1;1;;695;466;229;4;2;460;462
43;Tarragona;12;Baix Penedès;43016;Arboç, l';1;1;2;;782;566;216;1;3;562;565
43;Tarragona;12;Baix Penedès;43016;Arboç, l';1;2;1;;659;434;225;5;5;424;429
43;Tarragona;12;Baix Penedès;43016;Arboç, l';1;2;2;;592;416;176;2;2;412;414
43;Tarragona;8;Baix Camp;43015;Arbolí;1;1;1;;73;44;29;0;0;44;44
17;Girona;34;Selva;17009;Arbúcies;1;1;1;;683;516;167;3;3;510;513
17;Girona;34;Selva;17009;Arbúcies;1;1;2;;743;542;201;1;0;541;541
17;Girona;34;Selva;17009;Arbúcies;1;2;1;;706;512;194;5;1;506;507
17;Girona;34;Selva;17009;Arbúcies;1;2;2;;657;495;162;2;1;492;493
17;Girona;34;Selva;17009;Arbúcies;2;1;1;;492;346;146;3;3;340;343
8;Barcelona;21;Maresme;08006;Arenys de Mar;1;1;1;;642;456;186;6;1;449;450
8;Barcelona;21;Maresme;08006;Arenys de Mar;1;1;2;;634;472;162;7;3;462;465
8;Barcelona;21;Maresme;08006;Arenys de Mar;1;2;1;;676;501;175;0;0;501;501
8;Barcelona;21;Maresme;08006;Arenys de Mar;1;2;2;;681;502;179;1;3;498;501
8;Barcelona;21;Maresme;08006;Arenys de Mar;1;2;3;;640;480;160;1;2;477;479
8;Barcelona;21;Maresme;08006;Arenys de Mar;2;1;1;;1276;848;428;0;9;839;848
8;Barcelona;21;Maresme;08006;Arenys de Mar;2;2;1;;795;576;219;0;1;575;576
8;Barcelona;21;Maresme;08006;Arenys de Mar;2;3;1;;482;388;94;1;1;386;387
8;Barcelona;21;Maresme;08006;Arenys de Mar;2;4;1;;637;404;233;13;0;391;391
8;Barcelona;21;Maresme;08006;Arenys de Mar;2;4;2;;582;389;193;1;5;383;388
8;Barcelona;21;Maresme;08006;Arenys de Mar;2;4;3;;628;440;188;0;2;438;440
8;Barcelona;21;Maresme;08007;Arenys de Munt;1;1;1;;583;474;109;3;2;469;471
8;Barcelona;21;Maresme;08007;Arenys de Munt;1;2;1;;589;426;163;0;1;425;426
8;Barcelona;21;Maresme;08007;Arenys de Munt;1;2;2;;562;428;134;1;0;427;427
8;Barcelona;21;Maresme;08007;Arenys de Munt;2;1;1;;775;605;170;2;3;600;603
8;Barcelona;21;Maresme;08007;Arenys de Munt;2;2;1;;419;303;116;0;1;302;303
8;Barcelona;21;Maresme;08007;Arenys de Munt;2;2;2;;483;329;154;0;2;327;329
17;Girona;19;Garrotxa;17010;Argelaguer;1;1;1;;310;213;97;8;2;203;205
8;Barcelona;6;Anoia;08008;Argençola;1;1;1;;143;75;68;1;0;74;74
43;Tarragona;8;Baix Camp;43017;Argentera, l';1;1;1;;113;92;21;0;0;92;92
8;Barcelona;21;Maresme;08009;Argentona;1;1;1;;1003;737;266;2;0;735;735
8;Barcelona;21;Maresme;08009;Argentona;1;2;1;;1328;996;332;1;11;984;995
8;Barcelona;21;Maresme;08009;Argentona;1;3;1;;816;539;277;1;1;537;538
8;Barcelona;21;Maresme;08009;Argentona;2;1;1;;1008;715;293;2;4;709;713
8;Barcelona;21;Maresme;08009;Argentona;2;1;2;;813;571;242;2;3;566;569
17;Girona;2;Alt Empordà;17011;Armentera, l';1;1;1;;614;476;138;3;3;470;473
43;Tarragona;37;Terra Alta;43018;Arnes;1;1;1;;484;309;175;0;3;306;309
25;Lleida;39;Consell General d'Aran;25031;Arres;1;1;1;;47;34;13;0;0;34;34
25;Lleida;4;Alt Urgell;25032;Arsèguel;1;1;1;;76;53;23;0;0;53;53
8;Barcelona;7;Bages;08010;Artés;1;1;1;;932;645;287;2;1;642;643
8;Barcelona;7;Bages;08010;Artés;2;1;1;;1477;1129;348;2;8;1119;1127
8;Barcelona;7;Bages;08010;Artés;2;2;1;;631;470;161;4;2;464;466
25;Lleida;33;Segrià;25033;Artesa de Lleida;1;1;1;;904;627;277;7;1;619;620
25;Lleida;23;Noguera;25034;Artesa de Segre;1;1;1;;1083;843;240;1;3;839;842
25;Lleida;23;Noguera;25034;Artesa de Segre;1;2;1;;639;491;148;1;1;489;490
25;Lleida;23;Noguera;25034;Artesa de Segre;2;1;1;;208;147;61;0;3;144;147
25;Lleida;23;Noguera;25034;Artesa de Segre;2;2;1;;157;102;55;0;0;102;102
25;Lleida;23;Noguera;25034;Artesa de Segre;3;1;1;;351;230;121;0;1;229;230
25;Lleida;23;Noguera;25034;Artesa de Segre;3;2;1;;245;155;90;1;1;153;154
43;Tarragona;30;Ribera d'Ebre;43019;Ascó;1;1;1;;1021;588;433;8;5;575;580
43;Tarragona;30;Ribera d'Ebre;43019;Ascó;1;2;1;;557;321;236;4;0;317;317
25;Lleida;33;Segrià;25036;Aspa;1;1;1;;250;173;77;0;4;169;173
25;Lleida;23;Noguera;25037;Avellanes i Santa Linya, les;1;1;1;;464;305;159;1;0;304;304
8;Barcelona;14;Berguedà;08011;Avià;1;1;1;;740;491;249;3;5;483;488
8;Barcelona;14;Berguedà;08011;Avià;1;1;2;;714;482;232;5;1;476;477
8;Barcelona;7;Bages;08012;Avinyó;1;1;1;;782;617;165;2;1;614;615
8;Barcelona;7;Bages;08012;Avinyó;1;1;2;;744;561;183;0;0;561;561
8;Barcelona;3;Alt Penedès;08013;Avinyonet del Penedès;1;1;1;;904;659;245;9;1;649;650
17;Girona;2;Alt Empordà;17012;Avinyonet de Puigventós;1;1;1;;268;126;142;5;0;121;121
8;Barcelona;13;Barcelonès;08015;Badalona;1;1;1;;964;653;311;2;0;651;651
8;Barcelona;13;Barcelonès;08015;Badalona;1;2;1;;554;380;174;1;0;379;379
8;Barcelona;13;Barcelonès;08015;Badalona;1;3;1;;1032;762;270;0;3;759;762
8;Barcelona;13;Barcelonès;08015;Badalona;1;4;1;;794;625;169;1;1;623;624
8;Barcelona;13;Barcelonès;08015;Badalona;1;5;1;;1086;810;276;0;1;809;810
8;Barcelona;13;Barcelonès;08015;Badalona;1;6;1;;750;557;193;1;2;554;556
8;Barcelona;13;Barcelonès;08015;Badalona;1;7;1;;1108;843;265;0;0;843;843
8;Barcelona;13;Barcelonès;08015;Badalona;1;8;1;;687;531;156;0;0;531;531
8;Barcelona;13;Barcelonès;08015;Badalona;1;9;1;;551;426;125;1;2;423;425
8;Barcelona;13;Barcelonès;08015;Badalona;2;1;1;;669;426;243;0;3;423;426
8;Barcelona;13;Barcelonès;08015;Badalona;2;1;2;;645;408;237;0;2;406;408
8;Barcelona;13;Barcelonès;08015;Badalona;2;10;1;;418;240;178;0;0;240;240
8;Barcelona;13;Barcelonès;08015;Badalona;2;11;1;;654;341;313;0;1;340;341
8;Barcelona;13;Barcelonès;08015;Badalona;2;11;2;;598;341;257;0;4;337;341
8;Barcelona;13;Barcelonès;08015;Badalona;2;12;1;;1029;562;467;0;2;560;562
8;Barcelona;13;Barcelonès;08015;Badalona;2;13;1;;733;394;339;1;2;391;393
8;Barcelona;13;Barcelonès;08015;Badalona;2;14;1;;545;300;245;3;0;297;297
8;Barcelona;13;Barcelonès;08015;Badalona;2;15;1;;320;196;124;6;1;189;190
8;Barcelona;13;Barcelonès;08015;Badalona;2;16;1;;933;542;391;2;0;540;540
8;Barcelona;13;Barcelonès;08015;Badalona;2;17;1;;1195;668;527;1;13;654;667
8;Barcelona;13;Barcelonès;08015;Badalona;2;2;1;;1041;705;336;2;4;699;703
8;Barcelona;13;Barcelonès;08015;Badalona;2;3;1;;874;588;286;1;0;587;587
8;Barcelona;13;Barcelonès;08015;Badalona;2;4;1;;687;549;138;1;3;545;548
8;Barcelona;13;Barcelonès;08015;Badalona;2;4;2;;689;535;154;2;0;533;533
8;Barcelona;13;Barcelonès;08015;Badalona;2;5;1;;615;380;235;1;2;377;379
8;Barcelona;13;Barcelonès;08015;Badalona;2;6;1;;676;384;292;0;1;383;384
8;Barcelona;13;Barcelonès;08015;Badalona;2;7;1;;791;452;339;0;0;452;452
8;Barcelona;13;Barcelonès;08015;Badalona;2;8;1;;800;538;262;1;3;534;537
8;Barcelona;13;Barcelonès;08015;Badalona;2;8;2;;884;592;292;2;1;589;590
8;Barcelona;13;Barcelonès;08015;Badalona;2;9;1;;567;335;232;0;2;333;335
8;Barcelona;13;Barcelonès;08015;Badalona;2;9;2;;561;327;234;1;0;326;326
8;Barcelona;13;Barcelonès;08015;Badalona;3;1;1;;478;265;213;0;4;261;265
8;Barcelona;13;Barcelonès;08015;Badalona;3;10;1;;1198;733;465;0;7;726;733
8;Barcelona;13;Barcelonès;08015;Badalona;3;11;1;;722;465;257;0;1;464;465
8;Barcelona;13;Barcelonès;08015;Badalona;3;12;1;;1152;796;356;1;5;790;795
8;Barcelona;13;Barcelonès;08015;Badalona;3;2;1;;709;427;282;8;0;419;419
8;Barcelona;13;Barcelonès;08015;Badalona;3;2;2;;684;359;325;1;2;356;358
8;Barcelona;13;Barcelonès;08015;Badalona;3;3;1;;650;369;281;1;1;367;368
8;Barcelona;13;Barcelonès;08015;Badalona;3;3;2;;673;429;244;0;1;428;429
8;Barcelona;13;Barcelonès;08015;Badalona;3;4;1;;781;533;248;2;1;530;531
8;Barcelona;13;Barcelonès;08015;Badalona;3;5;1;;700;394;306;0;2;392;394
8;Barcelona;13;Barcelonès;08015;Badalona;3;5;2;;643;352;291;0;0;352;352
8;Barcelona;13;Barcelonès;08015;Badalona;3;6;1;;822;560;262;3;1;556;557
8;Barcelona;13;Barcelonès;08015;Badalona;3;7;1;;717;503;214;2;2;499;501
8;Barcelona;13;Barcelonès;08015;Badalona;3;8;1;;702;490;212;8;2;480;482
8;Barcelona;13;Barcelonès;08015;Badalona;3;9;1;;555;395;160;2;2;391;393
8;Barcelona;13;Barcelonès;08015;Badalona;4;1;1;;735;493;242;1;3;489;492
8;Barcelona;13;Barcelonès;08015;Badalona;4;10;1;;991;586;405;3;0;583;583
8;Barcelona;13;Barcelonès;08015;Badalona;4;11;1;;902;532;370;4;1;527;528
8;Barcelona;13;Barcelonès;08015;Badalona;4;2;1;;986;680;306;2;3;675;678
8;Barcelona;13;Barcelonès;08015;Badalona;4;3;1;;957;623;334;1;1;621;622
8;Barcelona;13;Barcelonès;08015;Badalona;4;4;1;;974;597;377;2;2;593;595
8;Barcelona;13;Barcelonès;08015;Badalona;4;5;1;;816;516;300;26;2;488;490
8;Barcelona;13;Barcelonès;08015;Badalona;4;6;1;;648;400;248;8;6;386;392
8;Barcelona;13;Barcelonès;08015;Badalona;4;6;2;;662;400;262;7;1;392;393
8;Barcelona;13;Barcelonès;08015;Badalona;4;7;1;;676;454;222;0;3;451;454
8;Barcelona;13;Barcelonès;08015;Badalona;4;7;2;;603;409;194;2;0;407;407
8;Barcelona;13;Barcelonès;08015;Badalona;4;8;1;;676;377;299;2;1;374;375
8;Barcelona;13;Barcelonès;08015;Badalona;4;8;2;;714;426;288;0;3;423;426
8;Barcelona;13;Barcelonès;08015;Badalona;4;9;1;;597;388;209;1;4;383;387
8;Barcelona;13;Barcelonès;08015;Badalona;5;1;1;;794;575;219;2;0;573;573
8;Barcelona;13;Barcelonès;08015;Badalona;5;1;2;;763;579;184;0;0;579;579
8;Barcelona;13;Barcelonès;08015;Badalona;5;2;1;;806;632;174;4;4;624;628
8;Barcelona;13;Barcelonès;08015;Badalona;5;3;1;;1354;706;648;2;3;701;704
8;Barcelona;13;Barcelonès;08015;Badalona;5;4;1;;848;539;309;1;3;535;538
8;Barcelona;13;Barcelonès;08015;Badalona;5;4;2;;740;447;293;1;3;443;446
8;Barcelona;13;Barcelonès;08015;Badalona;5;5;1;;310;211;99;3;4;204;208
8;Barcelona;13;Barcelonès;08015;Badalona;5;6;1;;648;423;225;1;1;421;422
8;Barcelona;13;Barcelonès;08015;Badalona;5;6;2;;654;381;273;0;3;378;381
8;Barcelona;13;Barcelonès;08015;Badalona;5;7;1;;1062;830;232;2;1;827;828
8;Barcelona;13;Barcelonès;08015;Badalona;6;1;1;;864;553;311;2;2;549;551
8;Barcelona;13;Barcelonès;08015;Badalona;6;2;1;;551;369;182;0;1;368;369
8;Barcelona;13;Barcelonès;08015;Badalona;6;3;1;;698;379;319;4;1;374;375
8;Barcelona;13;Barcelonès;08015;Badalona;6;3;2;;675;392;283;0;1;391;392
8;Barcelona;13;Barcelonès;08015;Badalona;6;4;1;;635;346;289;0;0;346;346
8;Barcelona;13;Barcelonès;08015;Badalona;6;4;2;;737;413;324;0;1;412;413
8;Barcelona;13;Barcelonès;08015;Badalona;6;5;1;;759;404;355;9;7;388;395
8;Barcelona;13;Barcelonès;08015;Badalona;6;5;2;;819;411;408;1;1;409;410
8;Barcelona;13;Barcelonès;08015;Badalona;6;6;1;;561;327;234;0;1;326;327
8;Barcelona;13;Barcelonès;08015;Badalona;6;6;2;;707;333;374;0;3;330;333
8;Barcelona;13;Barcelonès;08015;Badalona;7;1;1;;861;456;405;0;0;456;456
8;Barcelona;13;Barcelonès;08015;Badalona;7;10;1;;505;241;264;0;1;240;241
8;Barcelona;13;Barcelonès;08015;Badalona;7;11;1;;619;359;260;1;2;356;358
8;Barcelona;13;Barcelonès;08015;Badalona;7;11;2;;651;347;304;0;4;343;347
8;Barcelona;13;Barcelonès;08015;Badalona;7;12;1;;1188;689;499;1;1;687;688
8;Barcelona;13;Barcelonès;08015;Badalona;7;13;1;;1129;490;639;0;2;488;490
8;Barcelona;13;Barcelonès;08015;Badalona;7;14;1;;650;352;298;3;1;348;349
8;Barcelona;13;Barcelonès;08015;Badalona;7;14;2;;567;326;241;0;0;326;326
8;Barcelona;13;Barcelonès;08015;Badalona;7;15;1;;854;516;338;2;0;514;514
8;Barcelona;13;Barcelonès;08015;Badalona;7;16;1;;1007;528;479;2;0;526;526
8;Barcelona;13;Barcelonès;08015;Badalona;7;16;2;;1059;527;532;0;2;525;527
8;Barcelona;13;Barcelonès;08015;Badalona;7;17;1;;655;375;280;0;0;375;375
8;Barcelona;13;Barcelonès;08015;Badalona;7;18;1;;1106;355;751;2;0;353;353
8;Barcelona;13;Barcelonès;08015;Badalona;7;19;1;;984;548;436;0;0;548;548
8;Barcelona;13;Barcelonès;08015;Badalona;7;19;2;;920;458;462;1;0;457;457
8;Barcelona;13;Barcelonès;08015;Badalona;7;2;1;;1192;635;557;0;3;632;635
8;Barcelona;13;Barcelonès;08015;Badalona;7;20;1;;638;375;263;0;2;373;375
8;Barcelona;13;Barcelonès;08015;Badalona;7;20;2;;643;413;230;1;2;410;412
8;Barcelona;13;Barcelonès;08015;Badalona;7;21;1;;876;477;399;1;4;472;476
8;Barcelona;13;Barcelonès;08015;Badalona;7;22;1;;727;441;286;2;4;435;439
8;Barcelona;13;Barcelonès;08015;Badalona;7;23;1;;697;469;228;3;4;462;466
8;Barcelona;13;Barcelonès;08015;Badalona;7;23;2;;567;419;148;1;1;417;418
8;Barcelona;13;Barcelonès;08015;Badalona;7;24;1;;1141;680;461;13;0;667;667
8;Barcelona;13;Barcelonès;08015;Badalona;7;25;1;;605;317;288;1;0;316;316
8;Barcelona;13;Barcelonès;08015;Badalona;7;26;1;;695;360;335;1;0;359;359
8;Barcelona;13;Barcelonès;08015;Badalona;7;27;1;;650;325;325;7;0;318;318
8;Barcelona;13;Barcelonès;08015;Badalona;7;27;2;;663;344;319;1;0;343;343
8;Barcelona;13;Barcelonès;08015;Badalona;7;28;1;;903;476;427;2;4;470;474
8;Barcelona;13;Barcelonès;08015;Badalona;7;28;2;;822;449;373;0;4;445;449
8;Barcelona;13;Barcelonès;08015;Badalona;7;29;1;;418;201;217;0;0;201;201
8;Barcelona;13;Barcelonès;08015;Badalona;7;3;1;;790;412;378;2;0;410;410
8;Barcelona;13;Barcelonès;08015;Badalona;7;3;2;;709;414;295;3;2;409;411
8;Barcelona;13;Barcelonès;08015;Badalona;7;4;1;;933;558;375;1;2;555;557
8;Barcelona;13;Barcelonès;08015;Badalona;7;5;1;;892;458;434;2;2;454;456
8;Barcelona;13;Barcelonès;08015;Badalona;7;6;1;;665;370;295;3;4;363;367
8;Barcelona;13;Barcelonès;08015;Badalona;7;7;1;;865;434;431;3;0;431;431
8;Barcelona;13;Barcelonès;08015;Badalona;7;8;1;;593;283;310;0;3;280;283
8;Barcelona;13;Barcelonès;08015;Badalona;7;8;2;;631;314;317;0;1;313;314
8;Barcelona;13;Barcelonès;08015;Badalona;7;9;1;;641;358;283;1;0;357;357
8;Barcelona;13;Barcelonès;08015;Badalona;8;1;1;;758;404;354;0;0;404;404
8;Barcelona;13;Barcelonès;08015;Badalona;8;10;1;;653;357;296;1;0;356;356
8;Barcelona;13;Barcelonès;08015;Badalona;8;10;2;;765;413;352;1;2;410;412
8;Barcelona;13;Barcelonès;08015;Badalona;8;11;1;;509;273;236;0;0;273;273
8;Barcelona;13;Barcelonès;08015;Badalona;8;2;1;;709;420;289;0;0;420;420
8;Barcelona;13;Barcelonès;08015;Badalona;8;2;2;;683;391;292;0;2;389;391
8;Barcelona;13;Barcelonès;08015;Badalona;8;3;1;;767;341;426;0;0;341;341
8;Barcelona;13;Barcelonès;08015;Badalona;8;3;2;;676;325;351;0;2;323;325
8;Barcelona;13;Barcelonès;08015;Badalona;8;4;1;;581;319;262;0;3;316;319
8;Barcelona;13;Barcelonès;08015;Badalona;8;5;1;;1001;640;361;1;1;638;639
8;Barcelona;13;Barcelonès;08015;Badalona;8;6;1;;1214;655;559;1;3;651;654
8;Barcelona;13;Barcelonès;08015;Badalona;8;7;1;;539;336;203;1;0;335;335
8;Barcelona;13;Barcelonès;08015;Badalona;8;7;2;;623;368;255;1;1;366;367
8;Barcelona;13;Barcelonès;08015;Badalona;8;8;1;;667;342;325;2;0;340;340
8;Barcelona;13;Barcelonès;08015;Badalona;8;8;2;;595;312;283;0;0;312;312
8;Barcelona;13;Barcelonès;08015;Badalona;8;9;1;;1091;600;491;3;2;595;597
8;Barcelona;13;Barcelonès;08015;Badalona;9;1;1;;646;394;252;1;1;392;393
8;Barcelona;13;Barcelonès;08015;Badalona;9;10;1;;983;602;381;1;1;600;601
8;Barcelona;13;Barcelonès;08015;Badalona;9;11;1;;639;374;265;1;2;371;373
8;Barcelona;13;Barcelonès;08015;Badalona;9;11;2;;614;345;269;0;0;345;345
8;Barcelona;13;Barcelonès;08015;Badalona;9;12;1;;760;483;277;0;0;483;483
8;Barcelona;13;Barcelonès;08015;Badalona;9;13;1;;775;398;377;0;2;396;398
8;Barcelona;13;Barcelonès;08015;Badalona;9;14;1;;701;433;268;2;0;431;431
8;Barcelona;13;Barcelonès;08015;Badalona;9;14;2;;664;385;279;5;0;380;380
8;Barcelona;13;Barcelonès;08015;Badalona;9;15;1;;903;457;446;0;1;456;457
8;Barcelona;13;Barcelonès;08015;Badalona;9;16;1;;649;355;294;3;4;348;352
8;Barcelona;13;Barcelonès;08015;Badalona;9;16;2;;728;399;329;2;2;395;397
8;Barcelona;13;Barcelonès;08015;Badalona;9;17;1;;710;364;346;3;1;360;361
8;Barcelona;13;Barcelonès;08015;Badalona;9;18;1;;556;328;228;0;6;322;328
8;Barcelona;13;Barcelonès;08015;Badalona;9;19;1;;1080;580;500;0;1;579;580
8;Barcelona;13;Barcelonès;08015;Badalona;9;2;1;;968;503;465;1;5;497;502
8;Barcelona;13;Barcelonès;08015;Badalona;9;20;1;;694;390;304;0;4;386;390
8;Barcelona;13;Barcelonès;08015;Badalona;9;20;2;;748;410;338;0;2;408;410
8;Barcelona;13;Barcelonès;08015;Badalona;9;21;1;;1057;544;513;0;9;535;544
8;Barcelona;13;Barcelonès;08015;Badalona;9;22;1;;920;515;405;2;1;512;513
8;Barcelona;13;Barcelonès;08015;Badalona;9;23;1;;610;371;239;2;0;369;369
8;Barcelona;13;Barcelonès;08015;Badalona;9;24;1;;755;405;350;1;2;402;404
8;Barcelona;13;Barcelonès;08015;Badalona;9;24;2;;819;439;380;1;3;435;438
8;Barcelona;13;Barcelonès;08015;Badalona;9;25;1;;1126;631;495;28;7;596;603
8;Barcelona;13;Barcelonès;08015;Badalona;9;26;1;;1009;555;454;1;4;550;554
8;Barcelona;13;Barcelonès;08015;Badalona;9;27;1;;801;467;334;0;1;466;467
8;Barcelona;13;Barcelonès;08015;Badalona;9;28;1;;618;260;358;0;0;260;260
8;Barcelona;13;Barcelonès;08015;Badalona;9;28;2;;598;239;359;0;0;239;239
8;Barcelona;13;Barcelonès;08015;Badalona;9;29;1;;800;418;382;0;3;415;418
8;Barcelona;13;Barcelonès;08015;Badalona;9;29;2;;710;411;299;0;0;411;411
8;Barcelona;13;Barcelonès;08015;Badalona;9;3;1;;712;324;388;1;2;321;323
8;Barcelona;13;Barcelonès;08015;Badalona;9;30;1;;925;457;468;0;1;456;457
8;Barcelona;13;Barcelonès;08015;Badalona;9;31;1;;983;558;425;0;2;556;558
8;Barcelona;13;Barcelonès;08015;Badalona;9;32;1;;887;441;446;3;3;435;438
8;Barcelona;13;Barcelonès;08015;Badalona;9;33;1;;713;412;301;0;2;410;412
8;Barcelona;13;Barcelonès;08015;Badalona;9;33;2;;663;395;268;0;2;393;395
8;Barcelona;13;Barcelonès;08015;Badalona;9;34;1;;966;541;425;0;2;539;541
8;Barcelona;13;Barcelonès;08015;Badalona;9;34;2;;1174;646;528;1;0;645;645
8;Barcelona;13;Barcelonès;08015;Badalona;9;35;1;;1048;542;506;1;0;541;541
8;Barcelona;13;Barcelonès;08015;Badalona;9;35;2;;1215;614;601;0;3;611;614
8;Barcelona;13;Barcelonès;08015;Badalona;9;36;1;;1105;624;481;4;11;609;620
8;Barcelona;13;Barcelonès;08015;Badalona;9;37;1;;1084;520;564;0;5;515;520
8;Barcelona;13;Barcelonès;08015;Badalona;9;38;1;;543;313;230;1;0;312;312
8;Barcelona;13;Barcelonès;08015;Badalona;9;39;1;;624;336;288;1;0;335;335
8;Barcelona;13;Barcelonès;08015;Badalona;9;4;1;;483;273;210;0;1;272;273
8;Barcelona;13;Barcelonès;08015;Badalona;9;40;1;;516;283;233;0;0;283;283
8;Barcelona;13;Barcelonès;08015;Badalona;9;41;1;;1152;596;556;6;0;590;590
8;Barcelona;13;Barcelonès;08015;Badalona;9;42;1;;700;326;374;2;2;322;324
8;Barcelona;13;Barcelonès;08015;Badalona;9;42;2;;519;337;182;1;1;335;336
8;Barcelona;13;Barcelonès;08015;Badalona;9;43;1;;412;240;172;0;0;240;240
8;Barcelona;13;Barcelonès;08015;Badalona;9;44;1;;912;498;414;2;2;494;496
8;Barcelona;13;Barcelonès;08015;Badalona;9;45;1;;579;278;301;1;2;275;277
8;Barcelona;13;Barcelonès;08015;Badalona;9;45;2;;641;332;309;0;2;330;332
8;Barcelona;13;Barcelonès;08015;Badalona;9;46;1;;774;415;359;0;2;413;415
8;Barcelona;13;Barcelonès;08015;Badalona;9;47;1;;770;407;363;0;0;407;407
8;Barcelona;13;Barcelonès;08015;Badalona;9;48;1;;829;482;347;0;1;481;482
8;Barcelona;13;Barcelonès;08015;Badalona;9;49;1;;1131;633;498;0;1;632;633
8;Barcelona;13;Barcelonès;08015;Badalona;9;5;1;;695;362;333;0;2;360;362
8;Barcelona;13;Barcelonès;08015;Badalona;9;5;2;;654;363;291;1;0;362;362
8;Barcelona;13;Barcelonès;08015;Badalona;9;50;1;;758;316;442;1;0;315;315
8;Barcelona;13;Barcelonès;08015;Badalona;9;51;1;;481;264;217;0;3;261;264
8;Barcelona;13;Barcelonès;08015;Badalona;9;52;1;;887;435;452;5;3;427;430
8;Barcelona;13;Barcelonès;08015;Badalona;9;53;1;;1055;572;483;1;3;568;571
8;Barcelona;13;Barcelonès;08015;Badalona;9;54;1;;1025;560;465;1;5;554;559
8;Barcelona;13;Barcelonès;08015;Badalona;9;55;1;;891;535;356;0;0;535;535
8;Barcelona;13;Barcelonès;08015;Badalona;9;56;1;;651;359;292;2;0;357;357
8;Barcelona;13;Barcelonès;08015;Badalona;9;6;1;;1039;592;447;0;1;591;592
8;Barcelona;13;Barcelonès;08015;Badalona;9;7;1;;580;316;264;0;5;311;316
8;Barcelona;13;Barcelonès;08015;Badalona;9;8;1;;766;425;341;1;2;422;424
8;Barcelona;13;Barcelonès;08015;Badalona;9;8;2;;838;401;437;1;2;398;400
8;Barcelona;13;Barcelonès;08015;Badalona;9;9;1;;674;381;293;4;0;377;377
8;Barcelona;13;Barcelonès;08015;Badalona;9;9;2;;572;373;199;2;2;369;371
8;Barcelona;14;Berguedà;08016;Bagà;1;1;1;;1646;1101;545;8;5;1088;1093
25;Lleida;26;Pallars Sobirà;25039;Baix Pallars;1;1;1;;201;116;85;3;0;113;113
25;Lleida;26;Pallars Sobirà;25039;Baix Pallars;1;2;1;;103;62;41;0;0;62;62
25;Lleida;26;Pallars Sobirà;25039;Baix Pallars;1;3;1;;114;71;43;0;1;70;71
25;Lleida;23;Noguera;25040;Balaguer;1;1;1;;408;314;94;0;1;313;314
25;Lleida;23;Noguera;25040;Balaguer;1;2;1;;543;378;165;0;4;374;378
25;Lleida;23;Noguera;25040;Balaguer;1;3;1;;529;372;157;5;1;366;367
25;Lleida;23;Noguera;25040;Balaguer;1;4;1;;848;532;316;1;8;523;531
25;Lleida;23;Noguera;25040;Balaguer;2;1;1;;578;373;205;1;2;370;372
25;Lleida;23;Noguera;25040;Balaguer;2;2;1;;650;430;220;2;2;426;428
25;Lleida;23;Noguera;25040;Balaguer;2;3;1;;325;189;136;0;0;189;189
25;Lleida;23;Noguera;25040;Balaguer;3;1;1;;864;598;266;0;6;592;598
25;Lleida;23;Noguera;25040;Balaguer;3;2;1;;670;440;230;1;3;436;439
25;Lleida;23;Noguera;25040;Balaguer;3;3;1;;463;286;177;0;5;281;286
25;Lleida;23;Noguera;25040;Balaguer;4;1;1;;1353;1003;350;2;6;995;1001
25;Lleida;23;Noguera;25040;Balaguer;4;2;1;;1337;928;409;2;3;923;926
25;Lleida;23;Noguera;25040;Balaguer;4;3;1;;405;324;81;2;1;321;322
25;Lleida;23;Noguera;25040;Balaguer;4;4;1;;729;563;166;0;0;563;563
8;Barcelona;24;Osona;08017;Balenyà;1;1;1;;1757;1288;469;1;4;1283;1287
8;Barcelona;24;Osona;08017;Balenyà;1;2;1;;404;277;127;1;0;276;276
8;Barcelona;7;Bages;08018;Balsareny;1;1;1;;1208;818;390;3;2;813;815
8;Barcelona;7;Bages;08018;Balsareny;1;2;1;;944;611;333;3;0;608;608
8;Barcelona;7;Bages;08018;Balsareny;1;3;1;;367;268;99;0;5;263;268
8;Barcelona;7;Bages;08018;Balsareny;1;3;2;;313;193;120;0;0;193;193
43;Tarragona;12;Baix Penedès;43020;Banyeres del Penedès;1;1;1;;950;725;225;4;7;714;721
17;Girona;28;Pla de l'Estany;17015;Banyoles;1;1;1;;550;392;158;2;1;389;390
17;Girona;28;Pla de l'Estany;17015;Banyoles;1;1;2;;521;400;121;0;5;395;400
17;Girona;28;Pla de l'Estany;17015;Banyoles;1;2;1;;660;501;159;0;3;498;501
17;Girona;28;Pla de l'Estany;17015;Banyoles;1;3;1;;550;401;149;5;1;395;396
17;Girona;28;Pla de l'Estany;17015;Banyoles;1;3;2;;609;431;178;0;2;429;431
17;Girona;28;Pla de l'Estany;17015;Banyoles;1;4;1;;600;424;176;2;2;420;422
17;Girona;28;Pla de l'Estany;17015;Banyoles;1;4;2;;748;539;209;11;10;518;528
17;Girona;28;Pla de l'Estany;17015;Banyoles;2;1;1;;650;435;215;2;1;432;433
17;Girona;28;Pla de l'Estany;17015;Banyoles;2;1;2;;731;572;159;2;5;565;570
17;Girona;28;Pla de l'Estany;17015;Banyoles;2;2;1;;726;550;176;6;6;538;544
17;Girona;28;Pla de l'Estany;17015;Banyoles;2;3;1;;636;470;166;9;4;457;461
17;Girona;28;Pla de l'Estany;17015;Banyoles;2;3;2;;765;529;236;1;4;524;528
17;Girona;28;Pla de l'Estany;17015;Banyoles;3;1;1;;588;459;129;5;2;452;454
17;Girona;28;Pla de l'Estany;17015;Banyoles;3;1;2;;621;482;139;7;3;472;475
17;Girona;28;Pla de l'Estany;17015;Banyoles;3;2;1;;549;280;269;1;3;276;279
25;Lleida;27;Pla d'Urgell;25041;Barbens;1;1;1;;615;432;183;1;7;424;431
43;Tarragona;16;Conca de Barberà;43021;Barberà de la Conca;1;1;1;;362;227;135;1;4;222;226
8;Barcelona;40;Vallès Occidental;08252;Barberà del Vallès;1;1;1;;1075;594;481;0;2;592;594
8;Barcelona;40;Vallès Occidental;08252;Barberà del Vallès;1;10;1;;1126;611;515;1;1;609;610
8;Barcelona;40;Vallès Occidental;08252;Barberà del Vallès;1;11;1;;1102;645;457;1;1;643;644
8;Barcelona;40;Vallès Occidental;08252;Barberà del Vallès;1;12;1;;1032;482;550;0;4;478;482
8;Barcelona;40;Vallès Occidental;08252;Barberà del Vallès;1;13;1;;1314;645;669;0;2;643;645
8;Barcelona;40;Vallès Occidental;08252;Barberà del Vallès;1;14;1;;1183;522;661;1;2;519;521
8;Barcelona;40;Vallès Occidental;08252;Barberà del Vallès;1;15;1;;1022;460;562;4;2;454;456
8;Barcelona;40;Vallès Occidental;08252;Barberà del Vallès;1;16;1;;1063;464;599;1;6;457;463
8;Barcelona;40;Vallès Occidental;08252;Barberà del Vallès;1;17;1;;1062;482;580;3;2;477;479
8;Barcelona;40;Vallès Occidental;08252;Barberà del Vallès;1;2;1;;857;507;350;0;1;506;507
8;Barcelona;40;Vallès Occidental;08252;Barberà del Vallès;1;3;1;;1186;617;569;1;3;613;616
8;Barcelona;40;Vallès Occidental;08252;Barberà del Vallès;1;4;1;;1026;627;399;1;2;624;626
8;Barcelona;40;Vallès Occidental;08252;Barberà del Vallès;1;5;1;;981;604;377;4;0;600;600
8;Barcelona;40;Vallès Occidental;08252;Barberà del Vallès;1;6;1;;1425;716;709;0;6;710;716
8;Barcelona;40;Vallès Occidental;08252;Barberà del Vallès;1;7;1;;1314;696;618;1;4;691;695
8;Barcelona;40;Vallès Occidental;08252;Barberà del Vallès;1;8;1;;1041;586;455;8;1;577;578
8;Barcelona;40;Vallès Occidental;08252;Barberà del Vallès;1;9;1;;1386;774;612;11;1;762;763
8;Barcelona;13;Barcelonès;08019;Barcelona;1;1;1;;691;395;296;1;3;391;394
8;Barcelona;13;Barcelonès;08019;Barcelona;1;1;2;;682;399;283;1;2;396;398
8;Barcelona;13;Barcelonès;08019;Barcelona;1;10;1;;587;367;220;3;0;364;364
8;Barcelona;13;Barcelonès;08019;Barcelona;1;10;2;;599;380;219;0;2;378;380
8;Barcelona;13;Barcelonès;08019;Barcelona;1;11;1;;417;259;158;0;2;257;259
8;Barcelona;13;Barcelonès;08019;Barcelona;1;11;2;;439;245;194;6;0;239;239
8;Barcelona;13;Barcelonès;08019;Barcelona;1;12;1;;593;376;217;0;3;373;376
8;Barcelona;13;Barcelonès;08019;Barcelona;1;12;2;;696;352;344;1;1;350;351
8;Barcelona;13;Barcelonès;08019;Barcelona;1;13;1;;550;314;236;1;2;311;313
8;Barcelona;13;Barcelonès;08019;Barcelona;1;13;2;;552;289;263;0;0;289;289
8;Barcelona;13;Barcelonès;08019;Barcelona;1;14;1;;562;332;230;2;0;330;330
8;Barcelona;13;Barcelonès;08019;Barcelona;1;14;2;;572;300;272;2;1;297;298
8;Barcelona;13;Barcelonès;08019;Barcelona;1;15;1;;761;434;327;0;3;431;434
8;Barcelona;13;Barcelonès;08019;Barcelona;1;16;1;;850;403;447;0;2;401;403
8;Barcelona;13;Barcelonès;08019;Barcelona;1;17;1;;661;375;286;0;1;374;375
8;Barcelona;13;Barcelonès;08019;Barcelona;1;18;1;;392;162;230;0;0;162;162
8;Barcelona;13;Barcelonès;08019;Barcelona;1;19;1;;703;481;222;1;4;476;480
8;Barcelona;13;Barcelonès;08019;Barcelona;1;19;2;;746;456;290;1;5;450;455
8;Barcelona;13;Barcelonès;08019;Barcelona;1;19;3;;719;456;263;0;4;452;456
8;Barcelona;13;Barcelonès;08019;Barcelona;1;2;1;;528;259;269;0;1;258;259
8;Barcelona;13;Barcelonès;08019;Barcelona;1;2;2;;522;281;241;3;1;277;278
8;Barcelona;13;Barcelonès;08019;Barcelona;1;20;1;;478;304;174;0;0;304;304
8;Barcelona;13;Barcelonès;08019;Barcelona;1;20;2;;482;310;172;0;1;309;310
8;Barcelona;13;Barcelonès;08019;Barcelona;1;21;1;;640;373;267;0;0;373;373
8;Barcelona;13;Barcelonès;08019;Barcelona;1;22;1;;567;313;254;0;1;312;313
8;Barcelona;13;Barcelonès;08019;Barcelona;1;23;1;;460;287;173;2;1;284;285
8;Barcelona;13;Barcelonès;08019;Barcelona;1;23;2;;463;275;188;2;0;273;273
8;Barcelona;13;Barcelonès;08019;Barcelona;1;24;1;;488;295;193;0;2;293;295
8;Barcelona;13;Barcelonès;08019;Barcelona;1;24;2;;482;271;211;0;0;271;271
8;Barcelona;13;Barcelonès;08019;Barcelona;1;25;1;;755;468;287;0;0;468;468
8;Barcelona;13;Barcelonès;08019;Barcelona;1;26;1;;467;263;204;0;2;261;263
8;Barcelona;13;Barcelonès;08019;Barcelona;1;26;2;;449;258;191;2;2;254;256
8;Barcelona;13;Barcelonès;08019;Barcelona;1;27;1;;394;249;145;0;3;246;249
8;Barcelona;13;Barcelonès;08019;Barcelona;1;27;2;;429;242;187;1;0;241;241
8;Barcelona;13;Barcelonès;08019;Barcelona;1;28;1;;750;438;312;24;1;413;414
8;Barcelona;13;Barcelonès;08019;Barcelona;1;29;1;;418;251;167;0;1;250;251
8;Barcelona;13;Barcelonès;08019;Barcelona;1;29;2;;412;233;179;1;0;232;232
8;Barcelona;13;Barcelonès;08019;Barcelona;1;3;1;;801;388;413;2;0;386;386
8;Barcelona;13;Barcelonès;08019;Barcelona;1;30;1;;640;424;216;0;4;420;424
8;Barcelona;13;Barcelonès;08019;Barcelona;1;31;1;;647;383;264;1;2;380;382
8;Barcelona;13;Barcelonès;08019;Barcelona;1;32;1;;460;301;159;1;3;297;300
8;Barcelona;13;Barcelonès;08019;Barcelona;1;32;2;;442;304;138;0;3;301;304
8;Barcelona;13;Barcelonès;08019;Barcelona;1;33;1;;568;346;222;1;1;344;345
8;Barcelona;13;Barcelonès;08019;Barcelona;1;33;2;;566;360;206;2;1;357;358
8;Barcelona;13;Barcelonès;08019;Barcelona;1;34;1;;542;327;215;1;1;325;326
8;Barcelona;13;Barcelonès;08019;Barcelona;1;34;2;;521;333;188;1;1;331;332
8;Barcelona;13;Barcelonès;08019;Barcelona;1;35;1;;716;450;266;0;5;445;450
8;Barcelona;13;Barcelonès;08019;Barcelona;1;36;1;;463;318;145;0;2;316;318
8;Barcelona;13;Barcelonès;08019;Barcelona;1;36;2;;465;323;142;0;3;320;323
8;Barcelona;13;Barcelonès;08019;Barcelona;1;37;1;;589;370;219;0;1;369;370
8;Barcelona;13;Barcelonès;08019;Barcelona;1;38;1;;504;329;175;12;0;317;317
8;Barcelona;13;Barcelonès;08019;Barcelona;1;39;1;;538;341;197;4;1;336;337
8;Barcelona;13;Barcelonès;08019;Barcelona;1;39;2;;531;321;210;1;1;319;320
8;Barcelona;13;Barcelonès;08019;Barcelona;1;4;1;;450;258;192;0;0;258;258
8;Barcelona;13;Barcelonès;08019;Barcelona;1;4;2;;457;241;216;1;1;239;240
8;Barcelona;13;Barcelonès;08019;Barcelona;1;40;1;;472;265;207;0;0;265;265
8;Barcelona;13;Barcelonès;08019;Barcelona;1;40;2;;482;272;210;1;5;266;271
8;Barcelona;13;Barcelonès;08019;Barcelona;1;41;1;;691;358;333;0;1;357;358
8;Barcelona;13;Barcelonès;08019;Barcelona;1;42;1;;458;278;180;1;3;274;277
8;Barcelona;13;Barcelonès;08019;Barcelona;1;43;1;;639;373;266;0;0;373;373
8;Barcelona;13;Barcelonès;08019;Barcelona;1;44;1;;533;299;234;0;1;298;299
8;Barcelona;13;Barcelonès;08019;Barcelona;1;45;1;;463;242;221;0;0;242;242
8;Barcelona;13;Barcelonès;08019;Barcelona;1;45;2;;450;240;210;0;1;239;240
8;Barcelona;13;Barcelonès;08019;Barcelona;1;46;1;;519;241;278;0;1;240;241
8;Barcelona;13;Barcelonès;08019;Barcelona;1;47;1;;422;184;238;1;2;181;183
8;Barcelona;13;Barcelonès;08019;Barcelona;1;48;1;;677;392;285;2;5;385;390
8;Barcelona;13;Barcelonès;08019;Barcelona;1;49;1;;777;374;403;0;0;374;374
8;Barcelona;13;Barcelonès;08019;Barcelona;1;5;1;;477;259;218;0;0;259;259
8;Barcelona;13;Barcelonès;08019;Barcelona;1;5;2;;455;261;194;1;0;260;260
8;Barcelona;13;Barcelonès;08019;Barcelona;1;50;1;;523;323;200;15;2;306;308
8;Barcelona;13;Barcelonès;08019;Barcelona;1;50;2;;524;319;205;11;0;308;308
8;Barcelona;13;Barcelonès;08019;Barcelona;1;51;1;;376;217;159;2;3;212;215
8;Barcelona;13;Barcelonès;08019;Barcelona;1;52;1;;415;261;154;2;2;257;259
8;Barcelona;13;Barcelonès;08019;Barcelona;1;6;1;;458;271;187;3;3;265;268
8;Barcelona;13;Barcelonès;08019;Barcelona;1;6;2;;465;281;184;2;1;278;279
8;Barcelona;13;Barcelonès;08019;Barcelona;1;7;1;;801;482;319;0;0;482;482
8;Barcelona;13;Barcelonès;08019;Barcelona;1;8;1;;648;374;274;2;5;367;372
8;Barcelona;13;Barcelonès;08019;Barcelona;1;9;1;;488;312;176;2;3;307;310
8;Barcelona;13;Barcelonès;08019;Barcelona;1;9;2;;489;302;187;0;3;299;302
8;Barcelona;13;Barcelonès;08019;Barcelona;10;1;1;;502;321;181;1;1;319;320
8;Barcelona;13;Barcelonès;08019;Barcelona;10;1;2;;516;345;171;7;2;336;338
8;Barcelona;13;Barcelonès;08019;Barcelona;10;10;1;;667;442;225;2;2;438;440
8;Barcelona;13;Barcelonès;08019;Barcelona;10;11;1;;630;417;213;2;2;413;415
8;Barcelona;13;Barcelonès;08019;Barcelona;10;12;1;;559;365;194;0;7;358;365
8;Barcelona;13;Barcelonès;08019;Barcelona;10;13;1;;632;436;196;1;4;431;435
8;Barcelona;13;Barcelonès;08019;Barcelona;10;13;2;;650;445;205;4;0;441;441
8;Barcelona;13;Barcelonès;08019;Barcelona;10;14;1;;440;312;128;7;0;305;305
8;Barcelona;13;Barcelonès;08019;Barcelona;10;14;2;;449;302;147;11;2;289;291
8;Barcelona;13;Barcelonès;08019;Barcelona;10;15;1;;664;471;193;1;3;467;470
8;Barcelona;13;Barcelonès;08019;Barcelona;10;15;2;;686;461;225;2;2;457;459
8;Barcelona;13;Barcelonès;08019;Barcelona;10;15;3;;674;451;223;1;4;446;450
8;Barcelona;13;Barcelonès;08019;Barcelona;10;15;4;;679;435;244;10;6;419;425
8;Barcelona;13;Barcelonès;08019;Barcelona;10;16;1;;537;384;153;1;0;383;383
8;Barcelona;13;Barcelonès;08019;Barcelona;10;16;2;;532;353;179;0;3;350;353
8;Barcelona;13;Barcelonès;08019;Barcelona;10;17;1;;465;278;187;0;1;277;278
8;Barcelona;13;Barcelonès;08019;Barcelona;10;17;2;;463;269;194;0;0;269;269
8;Barcelona;13;Barcelonès;08019;Barcelona;10;18;1;;644;367;277;0;0;367;367
8;Barcelona;13;Barcelonès;08019;Barcelona;10;18;2;;667;375;292;1;2;372;374
8;Barcelona;13;Barcelonès;08019;Barcelona;10;19;1;;618;375;243;19;2;354;356
8;Barcelona;13;Barcelonès;08019;Barcelona;10;19;2;;626;368;258;1;1;366;367
8;Barcelona;13;Barcelonès;08019;Barcelona;10;2;1;;453;314;139;1;0;313;313
8;Barcelona;13;Barcelonès;08019;Barcelona;10;2;2;;444;304;140;2;0;302;302
8;Barcelona;13;Barcelonès;08019;Barcelona;10;20;1;;436;248;188;0;0;248;248
8;Barcelona;13;Barcelonès;08019;Barcelona;10;20;2;;435;259;176;3;1;255;256
8;Barcelona;13;Barcelonès;08019;Barcelona;10;21;1;;703;431;272;0;0;431;431
8;Barcelona;13;Barcelonès;08019;Barcelona;10;22;1;;712;446;266;0;5;441;446
8;Barcelona;13;Barcelonès;08019;Barcelona;10;23;1;;314;173;141;1;0;172;172
8;Barcelona;13;Barcelonès;08019;Barcelona;10;24;1;;789;491;298;3;3;485;488
8;Barcelona;13;Barcelonès;08019;Barcelona;10;24;2;;763;472;291;2;5;465;470
8;Barcelona;13;Barcelonès;08019;Barcelona;10;25;1;;538;340;198;2;0;338;338
8;Barcelona;13;Barcelonès;08019;Barcelona;10;25;2;;535;355;180;0;1;354;355
8;Barcelona;13;Barcelonès;08019;Barcelona;10;26;1;;523;342;181;0;2;340;342
8;Barcelona;13;Barcelonès;08019;Barcelona;10;26;2;;522;342;180;2;0;340;340
8;Barcelona;13;Barcelonès;08019;Barcelona;10;27;1;;576;374;202;0;3;371;374
8;Barcelona;13;Barcelonès;08019;Barcelona;10;27;2;;587;357;230;2;7;348;355
8;Barcelona;13;Barcelonès;08019;Barcelona;10;27;3;;565;365;200;0;4;361;365
8;Barcelona;13;Barcelonès;08019;Barcelona;10;28;1;;528;352;176;2;1;349;350
8;Barcelona;13;Barcelonès;08019;Barcelona;10;28;2;;530;336;194;0;4;332;336
8;Barcelona;13;Barcelonès;08019;Barcelona;10;29;1;;744;469;275;0;1;468;469
8;Barcelona;13;Barcelonès;08019;Barcelona;10;29;2;;756;448;308;0;1;447;448
8;Barcelona;13;Barcelonès;08019;Barcelona;10;29;3;;755;439;316;0;3;436;439
8;Barcelona;13;Barcelonès;08019;Barcelona;10;3;1;;700;468;232;4;6;458;464
8;Barcelona;13;Barcelonès;08019;Barcelona;10;3;2;;662;436;226;2;3;431;434
8;Barcelona;13;Barcelonès;08019;Barcelona;10;30;1;;664;371;293;0;9;362;371
8;Barcelona;13;Barcelonès;08019;Barcelona;10;30;2;;653;388;265;0;1;387;388
8;Barcelona;13;Barcelonès;08019;Barcelona;10;31;1;;287;166;121;2;0;164;164
8;Barcelona;13;Barcelonès;08019;Barcelona;10;32;1;;515;313;202;5;2;306;308
8;Barcelona;13;Barcelonès;08019;Barcelona;10;32;2;;518;322;196;1;2;319;321
8;Barcelona;13;Barcelonès;08019;Barcelona;10;33;1;;478;309;169;2;1;306;307
8;Barcelona;13;Barcelonès;08019;Barcelona;10;33;2;;490;326;164;1;1;324;325
8;Barcelona;13;Barcelonès;08019;Barcelona;10;34;1;;516;338;178;0;3;335;338
8;Barcelona;13;Barcelonès;08019;Barcelona;10;34;2;;498;313;185;1;1;311;312
8;Barcelona;13;Barcelonès;08019;Barcelona;10;35;1;;528;343;185;0;2;341;343
8;Barcelona;13;Barcelonès;08019;Barcelona;10;35;2;;523;337;186;2;1;334;335
8;Barcelona;13;Barcelonès;08019;Barcelona;10;36;1;;643;429;214;2;2;425;427
8;Barcelona;13;Barcelonès;08019;Barcelona;10;36;2;;629;455;174;1;0;454;454
8;Barcelona;13;Barcelonès;08019;Barcelona;10;37;1;;582;353;229;1;2;350;352
8;Barcelona;13;Barcelonès;08019;Barcelona;10;37;2;;590;345;245;0;0;345;345
8;Barcelona;13;Barcelonès;08019;Barcelona;10;38;1;;499;340;159;0;0;340;340
8;Barcelona;13;Barcelonès;08019;Barcelona;10;38;2;;501;333;168;0;1;332;333
8;Barcelona;13;Barcelonès;08019;Barcelona;10;39;1;;540;391;149;0;1;390;391
8;Barcelona;13;Barcelonès;08019;Barcelona;10;39;2;;540;347;193;0;0;347;347
8;Barcelona;13;Barcelonès;08019;Barcelona;10;4;1;;605;367;238;0;0;367;367
8;Barcelona;13;Barcelonès;08019;Barcelona;10;4;2;;592;407;185;0;4;403;407
8;Barcelona;13;Barcelonès;08019;Barcelona;10;4;3;;589;380;209;0;3;377;380
8;Barcelona;13;Barcelonès;08019;Barcelona;10;40;1;;435;245;190;1;1;243;244
8;Barcelona;13;Barcelonès;08019;Barcelona;10;40;2;;443;311;132;1;1;309;310
8;Barcelona;13;Barcelonès;08019;Barcelona;10;41;1;;720;431;289;0;1;430;431
8;Barcelona;13;Barcelonès;08019;Barcelona;10;42;1;;793;467;326;2;2;463;465
8;Barcelona;13;Barcelonès;08019;Barcelona;10;43;1;;760;508;252;4;6;498;504
8;Barcelona;13;Barcelonès;08019;Barcelona;10;43;2;;759;482;277;2;2;478;480
8;Barcelona;13;Barcelonès;08019;Barcelona;10;43;3;;763;468;295;0;5;463;468
8;Barcelona;13;Barcelonès;08019;Barcelona;10;44;1;;773;473;300;2;5;466;471
8;Barcelona;13;Barcelonès;08019;Barcelona;10;44;2;;763;453;310;2;5;446;451
8;Barcelona;13;Barcelonès;08019;Barcelona;10;44;3;;760;451;309;2;3;446;449
8;Barcelona;13;Barcelonès;08019;Barcelona;10;44;4;;756;451;305;2;0;449;449
8;Barcelona;13;Barcelonès;08019;Barcelona;10;45;1;;505;330;175;0;1;329;330
8;Barcelona;13;Barcelonès;08019;Barcelona;10;45;2;;512;336;176;0;0;336;336
8;Barcelona;13;Barcelonès;08019;Barcelona;10;46;1;;613;410;203;1;2;407;409
8;Barcelona;13;Barcelonès;08019;Barcelona;10;46;2;;617;410;207;0;0;410;410
8;Barcelona;13;Barcelonès;08019;Barcelona;10;47;1;;579;371;208;1;1;369;370
8;Barcelona;13;Barcelonès;08019;Barcelona;10;47;2;;580;371;209;0;1;370;371
8;Barcelona;13;Barcelonès;08019;Barcelona;10;47;3;;562;350;212;1;0;349;349
8;Barcelona;13;Barcelonès;08019;Barcelona;10;48;1;;624;370;254;1;2;367;369
8;Barcelona;13;Barcelonès;08019;Barcelona;10;48;2;;364;361;3;3;3;355;358
8;Barcelona;13;Barcelonès;08019;Barcelona;10;48;3;;644;391;253;0;3;388;391
8;Barcelona;13;Barcelonès;08019;Barcelona;10;49;1;;696;458;238;2;0;456;456
8;Barcelona;13;Barcelonès;08019;Barcelona;10;5;1;;594;402;192;9;1;392;393
8;Barcelona;13;Barcelonès;08019;Barcelona;10;5;2;;609;392;217;2;1;389;390
8;Barcelona;13;Barcelonès;08019;Barcelona;10;50;1;;604;335;269;1;0;334;334
8;Barcelona;13;Barcelonès;08019;Barcelona;10;50;2;;595;333;262;2;1;330;331
8;Barcelona;13;Barcelonès;08019;Barcelona;10;51;1;;611;325;286;0;2;323;325
8;Barcelona;13;Barcelonès;08019;Barcelona;10;52;1;;809;504;305;1;2;501;503
8;Barcelona;13;Barcelonès;08019;Barcelona;10;52;2;;797;521;276;1;2;518;520
8;Barcelona;13;Barcelonès;08019;Barcelona;10;52;3;;828;520;308;7;5;508;513
8;Barcelona;13;Barcelonès;08019;Barcelona;10;53;1;;736;456;280;4;1;451;452
8;Barcelona;13;Barcelonès;08019;Barcelona;10;53;2;;722;398;324;0;7;391;398
8;Barcelona;13;Barcelonès;08019;Barcelona;10;53;3;;736;409;327;1;0;408;408
8;Barcelona;13;Barcelonès;08019;Barcelona;10;53;4;;725;331;394;1;0;330;330
8;Barcelona;13;Barcelonès;08019;Barcelona;10;53;5;;734;424;310;1;1;422;423
8;Barcelona;13;Barcelonès;08019;Barcelona;10;53;6;;721;395;326;3;5;387;392
8;Barcelona;13;Barcelonès;08019;Barcelona;10;54;1;;539;320;219;0;1;319;320
8;Barcelona;13;Barcelonès;08019;Barcelona;10;54;2;;548;307;241;2;0;305;305
8;Barcelona;13;Barcelonès;08019;Barcelona;10;55;1;;744;487;257;3;2;482;484
8;Barcelona;13;Barcelonès;08019;Barcelona;10;55;2;;721;473;248;2;2;469;471
8;Barcelona;13;Barcelonès;08019;Barcelona;10;56;1;;678;401;277;7;1;393;394
8;Barcelona;13;Barcelonès;08019;Barcelona;10;56;2;;669;391;278;3;3;385;388
8;Barcelona;13;Barcelonès;08019;Barcelona;10;56;3;;658;378;280;11;2;365;367
8;Barcelona;13;Barcelonès;08019;Barcelona;10;57;1;;737;360;377;0;0;360;360
8;Barcelona;13;Barcelonès;08019;Barcelona;10;58;1;;504;328;176;7;0;321;321
8;Barcelona;13;Barcelonès;08019;Barcelona;10;58;2;;487;325;162;0;6;319;325
8;Barcelona;13;Barcelonès;08019;Barcelona;10;59;1;;614;399;215;0;1;398;399
8;Barcelona;13;Barcelonès;08019;Barcelona;10;6;1;;589;401;188;4;0;397;397
8;Barcelona;13;Barcelonès;08019;Barcelona;10;6;2;;604;371;233;6;4;361;365
8;Barcelona;13;Barcelonès;08019;Barcelona;10;6;3;;581;417;164;0;2;415;417
8;Barcelona;13;Barcelonès;08019;Barcelona;10;60;1;;826;490;336;0;5;485;490
8;Barcelona;13;Barcelonès;08019;Barcelona;10;60;2;;817;447;370;1;8;438;446
8;Barcelona;13;Barcelonès;08019;Barcelona;10;60;3;;806;468;338;1;1;466;467
8;Barcelona;13;Barcelonès;08019;Barcelona;10;60;4;;807;444;363;1;1;442;443
8;Barcelona;13;Barcelonès;08019;Barcelona;10;60;5;;828;477;351;10;2;465;467
8;Barcelona;13;Barcelonès;08019;Barcelona;10;60;6;;836;438;398;1;3;434;437
8;Barcelona;13;Barcelonès;08019;Barcelona;10;61;1;;532;342;190;7;2;333;335
8;Barcelona;13;Barcelonès;08019;Barcelona;10;61;2;;545;337;208;4;1;332;333
8;Barcelona;13;Barcelonès;08019;Barcelona;10;62;1;;662;417;245;3;2;412;414
8;Barcelona;13;Barcelonès;08019;Barcelona;10;62;2;;692;388;304;1;1;386;387
8;Barcelona;13;Barcelonès;08019;Barcelona;10;63;1;;792;410;382;2;3;405;408
8;Barcelona;13;Barcelonès;08019;Barcelona;10;64;1;;661;402;259;22;0;380;380
8;Barcelona;13;Barcelonès;08019;Barcelona;10;65;1;;510;302;208;12;5;285;290
8;Barcelona;13;Barcelonès;08019;Barcelona;10;65;2;;514;316;198;13;5;298;303
8;Barcelona;13;Barcelonès;08019;Barcelona;10;66;1;;578;339;239;0;1;338;339
8;Barcelona;13;Barcelonès;08019;Barcelona;10;66;2;;582;349;233;0;0;349;349
8;Barcelona;13;Barcelonès;08019;Barcelona;10;67;1;;718;455;263;2;6;447;453
8;Barcelona;13;Barcelonès;08019;Barcelona;10;67;2;;701;421;280;11;6;404;410
8;Barcelona;13;Barcelonès;08019;Barcelona;10;67;3;;692;457;235;0;1;456;457
8;Barcelona;13;Barcelonès;08019;Barcelona;10;67;4;;695;444;251;1;5;438;443
8;Barcelona;13;Barcelonès;08019;Barcelona;10;68;1;;672;418;254;2;1;415;416
8;Barcelona;13;Barcelonès;08019;Barcelona;10;68;2;;665;398;267;0;0;398;398
8;Barcelona;13;Barcelonès;08019;Barcelona;10;69;1;;440;225;215;3;0;222;222
8;Barcelona;13;Barcelonès;08019;Barcelona;10;69;2;;444;248;196;0;1;247;248
8;Barcelona;13;Barcelonès;08019;Barcelona;10;7;1;;553;356;197;14;0;342;342
8;Barcelona;13;Barcelonès;08019;Barcelona;10;7;2;;542;358;184;6;1;351;352
8;Barcelona;13;Barcelonès;08019;Barcelona;10;70;1;;515;330;185;1;1;328;329
8;Barcelona;13;Barcelonès;08019;Barcelona;10;70;2;;517;326;191;1;0;325;325
8;Barcelona;13;Barcelonès;08019;Barcelona;10;71;1;;403;281;122;0;0;281;281
8;Barcelona;13;Barcelonès;08019;Barcelona;10;71;2;;401;276;125;0;1;275;276
8;Barcelona;13;Barcelonès;08019;Barcelona;10;72;1;;446;293;153;2;1;290;291
8;Barcelona;13;Barcelonès;08019;Barcelona;10;72;2;;441;281;160;1;2;278;280
8;Barcelona;13;Barcelonès;08019;Barcelona;10;73;1;;767;442;325;0;0;442;442
8;Barcelona;13;Barcelonès;08019;Barcelona;10;74;1;;673;369;304;13;0;356;356
8;Barcelona;13;Barcelonès;08019;Barcelona;10;74;2;;663;383;280;1;0;382;382
8;Barcelona;13;Barcelonès;08019;Barcelona;10;74;3;;653;359;294;0;1;358;359
8;Barcelona;13;Barcelonès;08019;Barcelona;10;75;1;;560;348;212;0;3;345;348
8;Barcelona;13;Barcelonès;08019;Barcelona;10;75;2;;604;320;284;0;1;319;320
8;Barcelona;13;Barcelonès;08019;Barcelona;10;75;3;;564;331;233;0;2;329;331
8;Barcelona;13;Barcelonès;08019;Barcelona;10;76;1;;628;366;262;4;1;361;362
8;Barcelona;13;Barcelonès;08019;Barcelona;10;76;2;;603;357;246;0;1;356;357
8;Barcelona;13;Barcelonès;08019;Barcelona;10;76;3;;623;366;257;0;0;366;366
8;Barcelona;13;Barcelonès;08019;Barcelona;10;77;1;;705;404;301;1;2;401;403
8;Barcelona;13;Barcelonès;08019;Barcelona;10;78;1;;641;406;235;3;3;400;403
8;Barcelona;13;Barcelonès;08019;Barcelona;10;78;2;;636;428;208;2;1;425;426
8;Barcelona;13;Barcelonès;08019;Barcelona;10;79;1;;601;373;228;0;2;371;373
8;Barcelona;13;Barcelonès;08019;Barcelona;10;79;2;;601;356;245;0;2;354;356
8;Barcelona;13;Barcelonès;08019;Barcelona;10;8;1;;562;324;238;5;1;318;319
8;Barcelona;13;Barcelonès;08019;Barcelona;10;8;2;;564;353;211;1;0;352;352
8;Barcelona;13;Barcelonès;08019;Barcelona;10;8;3;;592;343;249;1;1;341;342
8;Barcelona;13;Barcelonès;08019;Barcelona;10;80;1;;516;297;219;0;2;295;297
8;Barcelona;13;Barcelonès;08019;Barcelona;10;80;2;;493;304;189;7;4;293;297
8;Barcelona;13;Barcelonès;08019;Barcelona;10;81;1;;738;384;354;5;0;379;379
8;Barcelona;13;Barcelonès;08019;Barcelona;10;82;1;;571;340;231;6;0;334;334
8;Barcelona;13;Barcelonès;08019;Barcelona;10;82;2;;574;317;257;2;2;313;315
8;Barcelona;13;Barcelonès;08019;Barcelona;10;83;1;;487;274;213;0;0;274;274
8;Barcelona;13;Barcelonès;08019;Barcelona;10;83;2;;483;276;207;0;0;276;276
8;Barcelona;13;Barcelonès;08019;Barcelona;10;84;1;;808;431;377;2;1;428;429
8;Barcelona;13;Barcelonès;08019;Barcelona;10;85;1;;843;429;414;0;0;429;429
8;Barcelona;13;Barcelonès;08019;Barcelona;10;86;1;;564;320;244;0;1;319;320
8;Barcelona;13;Barcelonès;08019;Barcelona;10;86;2;;566;321;245;0;2;319;321
8;Barcelona;13;Barcelonès;08019;Barcelona;10;86;3;;561;292;269;0;2;290;292
8;Barcelona;13;Barcelonès;08019;Barcelona;10;87;1;;281;74;207;1;0;73;73
8;Barcelona;13;Barcelonès;08019;Barcelona;10;88;1;;728;396;332;0;2;394;396
8;Barcelona;13;Barcelonès;08019;Barcelona;10;88;2;;717;432;285;2;2;428;430
8;Barcelona;13;Barcelonès;08019;Barcelona;10;89;1;;295;295;0;5;0;290;290
8;Barcelona;13;Barcelonès;08019;Barcelona;10;89;2;;519;308;211;10;2;296;298
8;Barcelona;13;Barcelonès;08019;Barcelona;10;9;1;;503;309;194;1;1;307;308
8;Barcelona;13;Barcelonès;08019;Barcelona;10;9;2;;478;305;173;1;0;304;304
8;Barcelona;13;Barcelonès;08019;Barcelona;10;90;1;;825;447;378;3;1;443;444
8;Barcelona;13;Barcelonès;08019;Barcelona;10;90;2;;778;475;303;3;5;467;472
8;Barcelona;13;Barcelonès;08019;Barcelona;10;90;3;;817;475;342;3;8;464;472
8;Barcelona;13;Barcelonès;08019;Barcelona;10;90;4;;806;436;370;1;3;432;435
8;Barcelona;13;Barcelonès;08019;Barcelona;10;90;5;;796;473;323;2;7;464;471
8;Barcelona;13;Barcelonès;08019;Barcelona;10;91;1;;560;283;277;2;1;280;281
8;Barcelona;13;Barcelonès;08019;Barcelona;10;91;2;;565;300;265;0;3;297;300
8;Barcelona;13;Barcelonès;08019;Barcelona;10;92;1;;545;383;162;0;4;379;383
8;Barcelona;13;Barcelonès;08019;Barcelona;10;92;2;;523;367;156;0;0;367;367
8;Barcelona;13;Barcelonès;08019;Barcelona;10;92;3;;618;374;244;0;0;374;374
8;Barcelona;13;Barcelonès;08019;Barcelona;10;93;1;;765;467;298;3;0;464;464
8;Barcelona;13;Barcelonès;08019;Barcelona;10;93;2;;804;470;334;4;0;466;466
8;Barcelona;13;Barcelonès;08019;Barcelona;10;94;1;;727;473;254;2;3;468;471
8;Barcelona;13;Barcelonès;08019;Barcelona;10;94;2;;730;472;258;3;4;465;469
8;Barcelona;13;Barcelonès;08019;Barcelona;10;94;3;;725;447;278;1;1;445;446
8;Barcelona;13;Barcelonès;08019;Barcelona;10;95;1;;525;298;227;0;0;298;298
8;Barcelona;13;Barcelonès;08019;Barcelona;10;95;2;;568;316;252;4;0;312;312
8;Barcelona;13;Barcelonès;08019;Barcelona;10;95;3;;584;306;278;1;3;302;305
8;Barcelona;13;Barcelonès;08019;Barcelona;10;96;1;;762;444;318;1;2;441;443
8;Barcelona;13;Barcelonès;08019;Barcelona;10;96;2;;771;426;345;2;4;420;424
8;Barcelona;13;Barcelonès;08019;Barcelona;10;96;3;;780;424;356;7;0;417;417
8;Barcelona;13;Barcelonès;08019;Barcelona;10;97;1;;649;427;222;1;7;419;426
8;Barcelona;13;Barcelonès;08019;Barcelona;10;97;2;;647;418;229;0;8;410;418
8;Barcelona;13;Barcelonès;08019;Barcelona;10;97;3;;681;416;265;3;3;410;413
8;Barcelona;13;Barcelonès;08019;Barcelona;10;97;4;;639;436;203;1;3;432;435
8;Barcelona;13;Barcelonès;08019;Barcelona;11;1;1;;498;354;144;1;0;353;353
8;Barcelona;13;Barcelonès;08019;Barcelona;11;1;2;;521;375;146;1;0;374;374
8;Barcelona;13;Barcelonès;08019;Barcelona;11;10;1;;746;545;201;0;4;541;545
8;Barcelona;13;Barcelonès;08019;Barcelona;11;11;1;;442;320;122;10;0;310;310
8;Barcelona;13;Barcelonès;08019;Barcelona;11;11;2;;481;338;143;0;1;337;338
8;Barcelona;13;Barcelonès;08019;Barcelona;11;12;1;;777;552;225;4;6;542;548
8;Barcelona;13;Barcelonès;08019;Barcelona;11;13;1;;664;507;157;1;2;504;506
8;Barcelona;13;Barcelonès;08019;Barcelona;11;13;2;;658;513;145;2;2;509;511
8;Barcelona;13;Barcelonès;08019;Barcelona;11;14;1;;777;453;324;2;1;450;451
8;Barcelona;13;Barcelonès;08019;Barcelona;11;15;1;;492;340;152;2;0;338;338
8;Barcelona;13;Barcelonès;08019;Barcelona;11;15;2;;479;334;145;0;3;331;334
8;Barcelona;13;Barcelonès;08019;Barcelona;11;16;1;;610;471;139;1;4;466;470
8;Barcelona;13;Barcelonès;08019;Barcelona;11;16;2;;606;444;162;3;11;430;441
8;Barcelona;13;Barcelonès;08019;Barcelona;11;16;3;;595;448;147;3;2;443;445
8;Barcelona;13;Barcelonès;08019;Barcelona;11;17;1;;628;452;176;0;3;449;452
8;Barcelona;13;Barcelonès;08019;Barcelona;11;17;2;;625;423;202;0;3;420;423
8;Barcelona;13;Barcelonès;08019;Barcelona;11;18;1;;439;278;161;1;4;273;277
8;Barcelona;13;Barcelonès;08019;Barcelona;11;18;2;;420;287;133;0;1;286;287
8;Barcelona;13;Barcelonès;08019;Barcelona;11;19;1;;577;425;152;2;2;421;423
8;Barcelona;13;Barcelonès;08019;Barcelona;11;2;1;;556;378;178;1;0;377;377
8;Barcelona;13;Barcelonès;08019;Barcelona;11;2;2;;529;392;137;0;0;392;392
8;Barcelona;13;Barcelonès;08019;Barcelona;11;20;1;;721;519;202;2;2;515;517
8;Barcelona;13;Barcelonès;08019;Barcelona;11;20;2;;706;534;172;0;2;532;534
8;Barcelona;13;Barcelonès;08019;Barcelona;11;21;1;;727;535;192;1;4;530;534
8;Barcelona;13;Barcelonès;08019;Barcelona;11;21;2;;741;515;226;0;6;509;515
8;Barcelona;13;Barcelonès;08019;Barcelona;11;22;1;;634;433;201;0;6;427;433
8;Barcelona;13;Barcelonès;08019;Barcelona;11;22;2;;591;425;166;1;2;422;424
8;Barcelona;13;Barcelonès;08019;Barcelona;11;22;3;;636;439;197;0;4;435;439
8;Barcelona;13;Barcelonès;08019;Barcelona;11;23;1;;723;474;249;0;0;474;474
8;Barcelona;13;Barcelonès;08019;Barcelona;11;24;1;;680;536;144;0;0;536;536
8;Barcelona;13;Barcelonès;08019;Barcelona;11;25;1;;535;405;130;0;5;400;405
8;Barcelona;13;Barcelonès;08019;Barcelona;11;25;2;;555;409;146;0;6;403;409
8;Barcelona;13;Barcelonès;08019;Barcelona;11;26;1;;762;539;223;1;5;533;538
8;Barcelona;13;Barcelonès;08019;Barcelona;11;26;2;;772;580;192;2;9;569;578
8;Barcelona;13;Barcelonès;08019;Barcelona;11;27;1;;576;411;165;0;3;408;411
8;Barcelona;13;Barcelonès;08019;Barcelona;11;27;2;;590;390;200;0;5;385;390
8;Barcelona;13;Barcelonès;08019;Barcelona;11;27;3;;568;382;186;1;9;372;381
8;Barcelona;13;Barcelonès;08019;Barcelona;11;28;1;;521;358;163;7;0;351;351
8;Barcelona;13;Barcelonès;08019;Barcelona;11;28;2;;515;337;178;0;5;332;337
8;Barcelona;13;Barcelonès;08019;Barcelona;11;29;1;;702;446;256;1;3;442;445
8;Barcelona;13;Barcelonès;08019;Barcelona;11;29;2;;702;476;226;1;3;472;475
8;Barcelona;13;Barcelonès;08019;Barcelona;11;3;1;;776;543;233;0;3;540;543
8;Barcelona;13;Barcelonès;08019;Barcelona;11;30;1;;643;447;196;1;1;445;446
8;Barcelona;13;Barcelonès;08019;Barcelona;11;30;2;;635;440;195;1;1;438;439
8;Barcelona;13;Barcelonès;08019;Barcelona;11;30;3;;636;436;200;2;1;433;434
8;Barcelona;13;Barcelonès;08019;Barcelona;11;31;1;;801;581;220;1;6;574;580
8;Barcelona;13;Barcelonès;08019;Barcelona;11;31;2;;771;565;206;2;3;560;563
8;Barcelona;13;Barcelonès;08019;Barcelona;11;32;1;;731;542;189;0;4;538;542
8;Barcelona;13;Barcelonès;08019;Barcelona;11;32;2;;717;539;178;0;2;537;539
8;Barcelona;13;Barcelonès;08019;Barcelona;11;32;3;;722;513;209;1;6;506;512
8;Barcelona;13;Barcelonès;08019;Barcelona;11;32;4;;733;521;212;0;5;516;521
8;Barcelona;13;Barcelonès;08019;Barcelona;11;32;5;;729;526;203;0;4;522;526
8;Barcelona;13;Barcelonès;08019;Barcelona;11;33;1;;583;418;165;1;3;414;417
8;Barcelona;13;Barcelonès;08019;Barcelona;11;33;2;;577;416;161;0;2;414;416
8;Barcelona;13;Barcelonès;08019;Barcelona;11;34;1;;552;393;159;0;3;390;393
8;Barcelona;13;Barcelonès;08019;Barcelona;11;34;2;;572;417;155;9;1;407;408
8;Barcelona;13;Barcelonès;08019;Barcelona;11;35;1;;760;504;256;0;6;498;504
8;Barcelona;13;Barcelonès;08019;Barcelona;11;35;2;;761;528;233;0;5;523;528
8;Barcelona;13;Barcelonès;08019;Barcelona;11;36;1;;796;579;217;0;6;573;579
8;Barcelona;13;Barcelonès;08019;Barcelona;11;36;2;;806;595;211;0;3;592;595
8;Barcelona;13;Barcelonès;08019;Barcelona;11;37;1;;584;447;137;0;1;446;447
8;Barcelona;13;Barcelonès;08019;Barcelona;11;37;2;;612;425;187;0;1;424;425
8;Barcelona;13;Barcelonès;08019;Barcelona;11;37;3;;577;420;157;1;1;418;419
8;Barcelona;13;Barcelonès;08019;Barcelona;11;38;1;;816;578;238;0;5;573;578
8;Barcelona;13;Barcelonès;08019;Barcelona;11;38;2;;821;568;253;8;5;555;560
8;Barcelona;13;Barcelonès;08019;Barcelona;11;38;3;;837;576;261;2;7;567;574
8;Barcelona;13;Barcelonès;08019;Barcelona;11;39;1;;658;467;191;2;3;462;465
8;Barcelona;13;Barcelonès;08019;Barcelona;11;39;2;;675;469;206;3;0;466;466
8;Barcelona;13;Barcelonès;08019;Barcelona;11;4;1;;593;405;188;0;0;405;405
8;Barcelona;13;Barcelonès;08019;Barcelona;11;40;1;;624;423;201;0;0;423;423
8;Barcelona;13;Barcelonès;08019;Barcelona;11;40;2;;646;414;232;0;1;413;414
8;Barcelona;13;Barcelonès;08019;Barcelona;11;41;1;;780;557;223;1;10;546;556
8;Barcelona;13;Barcelonès;08019;Barcelona;11;41;2;;789;569;220;2;3;564;567
8;Barcelona;13;Barcelonès;08019;Barcelona;11;41;3;;770;523;247;0;6;517;523
8;Barcelona;13;Barcelonès;08019;Barcelona;11;41;4;;765;525;240;0;8;517;525
8;Barcelona;13;Barcelonès;08019;Barcelona;11;41;5;;773;555;218;0;6;549;555
8;Barcelona;13;Barcelonès;08019;Barcelona;11;42;1;;810;559;251;3;2;554;556
8;Barcelona;13;Barcelonès;08019;Barcelona;11;42;2;;810;574;236;1;4;569;573
8;Barcelona;13;Barcelonès;08019;Barcelona;11;42;3;;813;575;238;1;1;573;574
8;Barcelona;13;Barcelonès;08019;Barcelona;11;43;1;;681;471;210;1;3;467;470
8;Barcelona;13;Barcelonès;08019;Barcelona;11;43;2;;675;499;176;6;0;493;493
8;Barcelona;13;Barcelonès;08019;Barcelona;11;44;1;;579;414;165;0;5;409;414
8;Barcelona;13;Barcelonès;08019;Barcelona;11;44;2;;581;406;175;2;4;400;404
8;Barcelona;13;Barcelonès;08019;Barcelona;11;44;3;;567;400;167;2;1;397;398
8;Barcelona;13;Barcelonès;08019;Barcelona;11;45;1;;640;453;187;0;5;448;453
8;Barcelona;13;Barcelonès;08019;Barcelona;11;45;2;;632;438;194;0;5;433;438
8;Barcelona;13;Barcelonès;08019;Barcelona;11;46;1;;639;485;154;0;4;481;485
8;Barcelona;13;Barcelonès;08019;Barcelona;11;46;2;;654;472;182;5;2;465;467
8;Barcelona;13;Barcelonès;08019;Barcelona;11;46;3;;653;489;164;5;0;484;484
8;Barcelona;13;Barcelonès;08019;Barcelona;11;46;4;;643;468;175;0;2;466;468
8;Barcelona;13;Barcelonès;08019;Barcelona;11;47;1;;690;509;181;0;4;505;509
8;Barcelona;13;Barcelonès;08019;Barcelona;11;47;2;;662;498;164;1;3;494;497
8;Barcelona;13;Barcelonès;08019;Barcelona;11;47;3;;693;487;206;1;3;483;486
8;Barcelona;13;Barcelonès;08019;Barcelona;11;48;1;;593;428;165;0;1;427;428
8;Barcelona;13;Barcelonès;08019;Barcelona;11;48;2;;610;444;166;0;0;444;444
8;Barcelona;13;Barcelonès;08019;Barcelona;11;49;1;;534;396;138;0;1;395;396
8;Barcelona;13;Barcelonès;08019;Barcelona;11;49;2;;530;385;145;0;2;383;385
8;Barcelona;13;Barcelonès;08019;Barcelona;11;5;1;;747;560;187;0;2;558;560
8;Barcelona;13;Barcelonès;08019;Barcelona;11;50;1;;660;481;179;0;1;480;481
8;Barcelona;13;Barcelonès;08019;Barcelona;11;50;2;;671;465;206;0;3;462;465
8;Barcelona;13;Barcelonès;08019;Barcelona;11;51;1;;853;595;258;0;6;589;595
8;Barcelona;13;Barcelonès;08019;Barcelona;11;51;2;;828;590;238;7;5;578;583
8;Barcelona;13;Barcelonès;08019;Barcelona;11;52;1;;812;594;218;2;4;588;592
8;Barcelona;13;Barcelonès;08019;Barcelona;11;52;2;;831;594;237;0;3;591;594
8;Barcelona;13;Barcelonès;08019;Barcelona;11;53;1;;774;520;254;1;3;516;519
8;Barcelona;13;Barcelonès;08019;Barcelona;11;53;2;;769;496;273;3;0;493;493
8;Barcelona;13;Barcelonès;08019;Barcelona;11;53;3;;742;512;230;1;4;507;511
8;Barcelona;13;Barcelonès;08019;Barcelona;11;53;4;;732;484;248;0;4;480;484
8;Barcelona;13;Barcelonès;08019;Barcelona;11;54;1;;724;501;223;1;4;496;500
8;Barcelona;13;Barcelonès;08019;Barcelona;11;54;2;;720;481;239;0;3;478;481
8;Barcelona;13;Barcelonès;08019;Barcelona;11;54;3;;730;490;240;0;3;487;490
8;Barcelona;13;Barcelonès;08019;Barcelona;11;54;4;;731;487;244;0;3;484;487
8;Barcelona;13;Barcelonès;08019;Barcelona;11;55;1;;553;383;170;0;5;378;383
8;Barcelona;13;Barcelonès;08019;Barcelona;11;55;2;;550;387;163;1;3;383;386
8;Barcelona;13;Barcelonès;08019;Barcelona;11;55;3;;590;415;175;2;2;411;413
8;Barcelona;13;Barcelonès;08019;Barcelona;11;56;1;;715;526;189;0;2;524;526
8;Barcelona;13;Barcelonès;08019;Barcelona;11;56;2;;700;513;187;4;4;505;509
8;Barcelona;13;Barcelonès;08019;Barcelona;11;56;3;;680;520;160;1;4;515;519
8;Barcelona;13;Barcelonès;08019;Barcelona;11;57;1;;755;576;179;0;6;570;576
8;Barcelona;13;Barcelonès;08019;Barcelona;11;57;2;;769;550;219;0;7;543;550
8;Barcelona;13;Barcelonès;08019;Barcelona;11;57;3;;763;549;214;1;2;546;548
8;Barcelona;13;Barcelonès;08019;Barcelona;11;58;1;;468;343;125;1;2;340;342
8;Barcelona;13;Barcelonès;08019;Barcelona;11;58;2;;485;326;159;0;0;326;326
8;Barcelona;13;Barcelonès;08019;Barcelona;11;6;1;;802;551;251;2;6;543;549
8;Barcelona;13;Barcelonès;08019;Barcelona;11;7;1;;474;315;159;0;4;311;315
8;Barcelona;13;Barcelonès;08019;Barcelona;11;7;2;;499;353;146;1;1;351;352
8;Barcelona;13;Barcelonès;08019;Barcelona;11;8;1;;486;341;145;0;1;340;341
8;Barcelona;13;Barcelonès;08019;Barcelona;11;8;2;;479;356;123;1;1;354;355
8;Barcelona;13;Barcelonès;08019;Barcelona;11;9;1;;758;540;218;1;3;536;539
8;Barcelona;13;Barcelonès;08019;Barcelona;12;1;1;;754;539;215;0;8;531;539
8;Barcelona;13;Barcelonès;08019;Barcelona;12;1;2;;731;497;234;0;2;495;497
8;Barcelona;13;Barcelonès;08019;Barcelona;12;10;1;;718;509;209;4;1;504;505
8;Barcelona;13;Barcelonès;08019;Barcelona;12;10;2;;725;479;246;17;0;462;462
8;Barcelona;13;Barcelonès;08019;Barcelona;12;10;3;;730;515;215;2;2;511;513
8;Barcelona;13;Barcelonès;08019;Barcelona;12;100;1;;505;359;146;0;3;356;359
8;Barcelona;13;Barcelonès;08019;Barcelona;12;100;2;;496;330;166;0;1;329;330
8;Barcelona;13;Barcelonès;08019;Barcelona;12;101;1;;568;381;187;0;2;379;381
8;Barcelona;13;Barcelonès;08019;Barcelona;12;101;2;;578;380;198;0;3;377;380
8;Barcelona;13;Barcelonès;08019;Barcelona;12;102;1;;733;460;273;5;0;455;455
8;Barcelona;13;Barcelonès;08019;Barcelona;12;102;2;;734;488;246;3;2;483;485
8;Barcelona;13;Barcelonès;08019;Barcelona;12;102;3;;752;482;270;5;0;477;477
8;Barcelona;13;Barcelonès;08019;Barcelona;12;103;1;;678;458;220;2;2;454;456
8;Barcelona;13;Barcelonès;08019;Barcelona;12;103;2;;676;444;232;0;5;439;444
8;Barcelona;13;Barcelonès;08019;Barcelona;12;103;3;;633;451;182;5;0;446;446
8;Barcelona;13;Barcelonès;08019;Barcelona;12;104;1;;715;385;330;1;0;384;384
8;Barcelona;13;Barcelonès;08019;Barcelona;12;104;2;;739;373;366;3;0;370;370
8;Barcelona;13;Barcelonès;08019;Barcelona;12;105;1;;814;539;275;0;4;535;539
8;Barcelona;13;Barcelonès;08019;Barcelona;12;105;2;;818;511;307;7;1;503;504
8;Barcelona;13;Barcelonès;08019;Barcelona;12;105;3;;817;576;241;0;1;575;576
8;Barcelona;13;Barcelonès;08019;Barcelona;12;106;1;;643;340;303;0;0;340;340
8;Barcelona;13;Barcelonès;08019;Barcelona;12;106;2;;641;356;285;0;0;356;356
8;Barcelona;13;Barcelonès;08019;Barcelona;12;107;1;;671;368;303;1;3;364;367
8;Barcelona;13;Barcelonès;08019;Barcelona;12;107;2;;655;348;307;0;3;345;348
8;Barcelona;13;Barcelonès;08019;Barcelona;12;107;3;;665;392;273;17;1;374;375
8;Barcelona;13;Barcelonès;08019;Barcelona;12;107;4;;647;391;256;1;2;388;390
8;Barcelona;13;Barcelonès;08019;Barcelona;12;108;1;;565;370;195;0;4;366;370
8;Barcelona;13;Barcelonès;08019;Barcelona;12;108;2;;340;340;0;0;2;338;340
8;Barcelona;13;Barcelonès;08019;Barcelona;12;108;3;;566;358;208;2;2;354;356
8;Barcelona;13;Barcelonès;08019;Barcelona;12;109;1;;743;488;255;1;6;481;487
8;Barcelona;13;Barcelonès;08019;Barcelona;12;109;2;;810;446;364;3;6;437;443
8;Barcelona;13;Barcelonès;08019;Barcelona;12;11;1;;729;501;228;0;4;497;501
8;Barcelona;13;Barcelonès;08019;Barcelona;12;11;2;;732;494;238;0;2;492;494
8;Barcelona;13;Barcelonès;08019;Barcelona;12;110;1;;790;417;373;1;4;412;416
8;Barcelona;13;Barcelonès;08019;Barcelona;12;110;2;;810;447;363;2;2;443;445
8;Barcelona;13;Barcelonès;08019;Barcelona;12;110;3;;673;454;219;0;0;454;454
8;Barcelona;13;Barcelonès;08019;Barcelona;12;111;1;;764;401;363;0;2;399;401
8;Barcelona;13;Barcelonès;08019;Barcelona;12;111;2;;758;414;344;1;2;411;413
8;Barcelona;13;Barcelonès;08019;Barcelona;12;111;3;;775;433;342;0;1;432;433
8;Barcelona;13;Barcelonès;08019;Barcelona;12;112;1;;637;408;229;0;1;407;408
8;Barcelona;13;Barcelonès;08019;Barcelona;12;112;2;;628;388;240;1;1;386;387
8;Barcelona;13;Barcelonès;08019;Barcelona;12;113;1;;496;307;189;0;2;305;307
8;Barcelona;13;Barcelonès;08019;Barcelona;12;113;2;;492;314;178;0;1;313;314
8;Barcelona;13;Barcelonès;08019;Barcelona;12;114;1;;576;350;226;0;1;349;350
8;Barcelona;13;Barcelonès;08019;Barcelona;12;114;2;;577;328;249;0;3;325;328
8;Barcelona;13;Barcelonès;08019;Barcelona;12;114;3;;588;357;231;0;1;356;357
8;Barcelona;13;Barcelonès;08019;Barcelona;12;115;1;;471;274;197;3;0;271;271
8;Barcelona;13;Barcelonès;08019;Barcelona;12;115;2;;453;304;149;1;1;302;303
8;Barcelona;13;Barcelonès;08019;Barcelona;12;116;1;;788;560;228;1;4;555;559
8;Barcelona;13;Barcelonès;08019;Barcelona;12;117;1;;544;360;184;1;4;355;359
8;Barcelona;13;Barcelonès;08019;Barcelona;12;117;2;;528;375;153;1;3;371;374
8;Barcelona;13;Barcelonès;08019;Barcelona;12;118;1;;539;356;183;3;4;349;353
8;Barcelona;13;Barcelonès;08019;Barcelona;12;118;2;;526;366;160;2;4;360;364
8;Barcelona;13;Barcelonès;08019;Barcelona;12;119;1;;569;243;326;3;1;239;240
8;Barcelona;13;Barcelonès;08019;Barcelona;12;119;2;;568;250;318;0;4;246;250
8;Barcelona;13;Barcelonès;08019;Barcelona;12;12;1;;453;309;144;1;1;307;308
8;Barcelona;13;Barcelonès;08019;Barcelona;12;12;2;;446;290;156;0;2;288;290
8;Barcelona;13;Barcelonès;08019;Barcelona;12;120;1;;702;425;277;0;2;423;425
8;Barcelona;13;Barcelonès;08019;Barcelona;12;120;2;;682;414;268;7;0;407;407
8;Barcelona;13;Barcelonès;08019;Barcelona;12;121;1;;758;510;248;2;3;505;508
8;Barcelona;13;Barcelonès;08019;Barcelona;12;121;2;;758;492;266;2;3;487;490
8;Barcelona;13;Barcelonès;08019;Barcelona;12;122;1;;841;540;301;7;0;533;533
8;Barcelona;13;Barcelonès;08019;Barcelona;12;122;2;;849;530;319;14;2;514;516
8;Barcelona;13;Barcelonès;08019;Barcelona;12;122;3;;841;481;360;21;2;458;460
8;Barcelona;13;Barcelonès;08019;Barcelona;12;122;4;;832;511;321;10;2;499;501
8;Barcelona;13;Barcelonès;08019;Barcelona;12;123;1;;712;468;244;10;1;457;458
8;Barcelona;13;Barcelonès;08019;Barcelona;12;123;2;;717;469;248;0;4;465;469
8;Barcelona;13;Barcelonès;08019;Barcelona;12;123;3;;730;465;265;5;0;460;460
8;Barcelona;13;Barcelonès;08019;Barcelona;12;123;4;;699;473;226;18;4;451;455
8;Barcelona;13;Barcelonès;08019;Barcelona;12;124;1;;600;381;219;4;3;374;377
8;Barcelona;13;Barcelonès;08019;Barcelona;12;124;2;;592;384;208;1;1;382;383
8;Barcelona;13;Barcelonès;08019;Barcelona;12;124;3;;602;396;206;3;1;392;393
8;Barcelona;13;Barcelonès;08019;Barcelona;12;125;1;;796;556;240;0;6;550;556
8;Barcelona;13;Barcelonès;08019;Barcelona;12;125;2;;782;538;244;1;3;534;537
8;Barcelona;13;Barcelonès;08019;Barcelona;12;125;3;;784;534;250;2;4;528;532
8;Barcelona;13;Barcelonès;08019;Barcelona;12;126;1;;720;430;290;0;1;429;430
8;Barcelona;13;Barcelonès;08019;Barcelona;12;126;2;;719;430;289;1;2;427;429
8;Barcelona;13;Barcelonès;08019;Barcelona;12;126;3;;717;454;263;0;3;451;454
8;Barcelona;13;Barcelonès;08019;Barcelona;12;127;1;;646;434;212;7;4;423;427
8;Barcelona;13;Barcelonès;08019;Barcelona;12;127;2;;619;403;216;3;3;397;400
8;Barcelona;13;Barcelonès;08019;Barcelona;12;127;3;;653;420;233;15;2;403;405
8;Barcelona;13;Barcelonès;08019;Barcelona;12;128;1;;709;526;183;0;4;522;526
8;Barcelona;13;Barcelonès;08019;Barcelona;12;129;1;;258;173;85;1;0;172;172
8;Barcelona;13;Barcelonès;08019;Barcelona;12;13;1;;602;429;173;10;3;416;419
8;Barcelona;13;Barcelonès;08019;Barcelona;12;13;2;;601;417;184;3;5;409;414
8;Barcelona;13;Barcelonès;08019;Barcelona;12;13;3;;621;416;205;1;2;413;415
8;Barcelona;13;Barcelonès;08019;Barcelona;12;130;1;;600;393;207;1;4;388;392
8;Barcelona;13;Barcelonès;08019;Barcelona;12;130;2;;598;369;229;0;4;365;369
8;Barcelona;13;Barcelonès;08019;Barcelona;12;130;3;;589;384;205;0;4;380;384
8;Barcelona;13;Barcelonès;08019;Barcelona;12;131;1;;816;453;363;0;2;451;453
8;Barcelona;13;Barcelonès;08019;Barcelona;12;131;2;;816;444;372;5;1;438;439
8;Barcelona;13;Barcelonès;08019;Barcelona;12;14;1;;458;309;149;1;1;307;308
8;Barcelona;13;Barcelonès;08019;Barcelona;12;14;2;;478;327;151;0;1;326;327
8;Barcelona;13;Barcelonès;08019;Barcelona;12;15;1;;473;325;148;0;2;323;325
8;Barcelona;13;Barcelonès;08019;Barcelona;12;15;2;;476;314;162;1;0;313;313
8;Barcelona;13;Barcelonès;08019;Barcelona;12;16;1;;631;454;177;1;1;452;453
8;Barcelona;13;Barcelonès;08019;Barcelona;12;16;2;;658;464;194;3;3;458;461
8;Barcelona;13;Barcelonès;08019;Barcelona;12;16;3;;633;458;175;0;5;453;458
8;Barcelona;13;Barcelonès;08019;Barcelona;12;17;1;;673;488;185;1;5;482;487
8;Barcelona;13;Barcelonès;08019;Barcelona;12;17;2;;651;472;179;4;5;463;468
8;Barcelona;13;Barcelonès;08019;Barcelona;12;18;1;;760;510;250;0;5;505;510
8;Barcelona;13;Barcelonès;08019;Barcelona;12;18;2;;730;498;232;2;3;493;496
8;Barcelona;13;Barcelonès;08019;Barcelona;12;19;1;;619;429;190;16;0;413;413
8;Barcelona;13;Barcelonès;08019;Barcelona;12;19;2;;627;400;227;7;3;390;393
8;Barcelona;13;Barcelonès;08019;Barcelona;12;2;1;;440;303;137;3;0;300;300
8;Barcelona;13;Barcelonès;08019;Barcelona;12;2;2;;455;300;155;4;0;296;296
8;Barcelona;13;Barcelonès;08019;Barcelona;12;20;1;;824;543;281;0;3;540;543
8;Barcelona;13;Barcelonès;08019;Barcelona;12;20;2;;840;536;304;0;4;532;536
8;Barcelona;13;Barcelonès;08019;Barcelona;12;20;3;;812;550;262;1;3;546;549
8;Barcelona;13;Barcelonès;08019;Barcelona;12;21;1;;782;543;239;3;1;539;540
8;Barcelona;13;Barcelonès;08019;Barcelona;12;21;2;;779;519;260;2;1;516;517
8;Barcelona;13;Barcelonès;08019;Barcelona;12;22;1;;688;450;238;0;5;445;450
8;Barcelona;13;Barcelonès;08019;Barcelona;12;22;2;;673;395;278;0;2;393;395
8;Barcelona;13;Barcelonès;08019;Barcelona;12;22;3;;673;428;245;3;2;423;425
8;Barcelona;13;Barcelonès;08019;Barcelona;12;23;1;;592;409;183;9;0;400;400
8;Barcelona;13;Barcelonès;08019;Barcelona;12;23;2;;593;389;204;1;2;386;388
8;Barcelona;13;Barcelonès;08019;Barcelona;12;23;3;;596;407;189;1;2;404;406
8;Barcelona;13;Barcelonès;08019;Barcelona;12;24;1;;610;437;173;0;3;434;437
8;Barcelona;13;Barcelonès;08019;Barcelona;12;24;2;;593;404;189;7;2;395;397
8;Barcelona;13;Barcelonès;08019;Barcelona;12;24;3;;599;419;180;0;2;417;419
8;Barcelona;13;Barcelonès;08019;Barcelona;12;25;1;;529;369;160;2;4;363;367
8;Barcelona;13;Barcelonès;08019;Barcelona;12;25;2;;528;373;155;1;3;369;372
8;Barcelona;13;Barcelonès;08019;Barcelona;12;26;1;;765;539;226;4;3;532;535
8;Barcelona;13;Barcelonès;08019;Barcelona;12;26;2;;778;530;248;1;1;528;529
8;Barcelona;13;Barcelonès;08019;Barcelona;12;26;3;;773;550;223;4;0;546;546
8;Barcelona;13;Barcelonès;08019;Barcelona;12;27;1;;453;301;152;1;1;299;300
8;Barcelona;13;Barcelonès;08019;Barcelona;12;27;2;;450;331;119;1;1;329;330
8;Barcelona;13;Barcelonès;08019;Barcelona;12;28;1;;455;331;124;1;0;330;330
8;Barcelona;13;Barcelonès;08019;Barcelona;12;28;2;;438;318;120;1;0;317;317
8;Barcelona;13;Barcelonès;08019;Barcelona;12;29;1;;616;423;193;0;2;421;423
8;Barcelona;13;Barcelonès;08019;Barcelona;12;29;2;;606;398;208;1;5;392;397
8;Barcelona;13;Barcelonès;08019;Barcelona;12;3;1;;560;401;159;2;2;397;399
8;Barcelona;13;Barcelonès;08019;Barcelona;12;3;2;;554;367;187;0;2;365;367
8;Barcelona;13;Barcelonès;08019;Barcelona;12;30;1;;563;383;180;0;6;377;383
8;Barcelona;13;Barcelonès;08019;Barcelona;12;30;2;;563;360;203;0;7;353;360
8;Barcelona;13;Barcelonès;08019;Barcelona;12;31;1;;577;382;195;0;0;382;382
8;Barcelona;13;Barcelonès;08019;Barcelona;12;31;2;;542;355;187;0;0;355;355
8;Barcelona;13;Barcelonès;08019;Barcelona;12;31;3;;573;373;200;0;2;371;373
8;Barcelona;13;Barcelonès;08019;Barcelona;12;32;1;;392;256;136;3;0;253;253
8;Barcelona;13;Barcelonès;08019;Barcelona;12;33;1;;630;410;220;6;5;399;404
8;Barcelona;13;Barcelonès;08019;Barcelona;12;33;2;;622;422;200;0;2;420;422
8;Barcelona;13;Barcelonès;08019;Barcelona;12;34;1;;730;504;226;1;9;494;503
8;Barcelona;13;Barcelonès;08019;Barcelona;12;34;2;;742;477;265;1;5;471;476
8;Barcelona;13;Barcelonès;08019;Barcelona;12;34;3;;760;495;265;2;2;491;493
8;Barcelona;13;Barcelonès;08019;Barcelona;12;34;4;;758;499;259;9;0;490;490
8;Barcelona;13;Barcelonès;08019;Barcelona;12;35;1;;599;340;259;0;2;338;340
8;Barcelona;13;Barcelonès;08019;Barcelona;12;35;2;;587;348;239;4;1;343;344
8;Barcelona;13;Barcelonès;08019;Barcelona;12;35;3;;577;330;247;7;1;322;323
8;Barcelona;13;Barcelonès;08019;Barcelona;12;36;1;;575;426;149;0;2;424;426
8;Barcelona;13;Barcelonès;08019;Barcelona;12;36;2;;563;419;144;0;0;419;419
8;Barcelona;13;Barcelonès;08019;Barcelona;12;37;1;;776;529;247;1;0;528;528
8;Barcelona;13;Barcelonès;08019;Barcelona;12;38;1;;812;506;306;1;8;497;505
8;Barcelona;13;Barcelonès;08019;Barcelona;12;39;1;;611;371;240;1;0;370;370
8;Barcelona;13;Barcelonès;08019;Barcelona;12;39;2;;609;373;236;3;0;370;370
8;Barcelona;13;Barcelonès;08019;Barcelona;12;4;1;;444;294;150;1;1;292;293
8;Barcelona;13;Barcelonès;08019;Barcelona;12;4;2;;459;303;156;0;2;301;303
8;Barcelona;13;Barcelonès;08019;Barcelona;12;40;1;;522;307;215;3;1;303;304
8;Barcelona;13;Barcelonès;08019;Barcelona;12;40;2;;524;333;191;3;1;329;330
8;Barcelona;13;Barcelonès;08019;Barcelona;12;41;1;;526;331;195;0;6;325;331
8;Barcelona;13;Barcelonès;08019;Barcelona;12;41;2;;534;328;206;2;2;324;326
8;Barcelona;13;Barcelonès;08019;Barcelona;12;42;1;;542;369;173;0;1;368;369
8;Barcelona;13;Barcelonès;08019;Barcelona;12;42;2;;561;369;192;2;1;366;367
8;Barcelona;13;Barcelonès;08019;Barcelona;12;42;3;;539;392;147;2;4;386;390
8;Barcelona;13;Barcelonès;08019;Barcelona;12;43;1;;457;285;172;0;1;284;285
8;Barcelona;13;Barcelonès;08019;Barcelona;12;43;2;;451;299;152;0;1;298;299
8;Barcelona;13;Barcelonès;08019;Barcelona;12;44;1;;599;422;177;0;1;421;422
8;Barcelona;13;Barcelonès;08019;Barcelona;12;44;2;;604;402;202;7;0;395;395
8;Barcelona;13;Barcelonès;08019;Barcelona;12;45;1;;774;570;204;0;5;565;570
8;Barcelona;13;Barcelonès;08019;Barcelona;12;45;2;;766;543;223;7;7;529;536
8;Barcelona;13;Barcelonès;08019;Barcelona;12;45;3;;753;537;216;1;4;532;536
8;Barcelona;13;Barcelonès;08019;Barcelona;12;45;4;;747;532;215;0;5;527;532
8;Barcelona;13;Barcelonès;08019;Barcelona;12;46;1;;549;406;143;0;2;404;406
8;Barcelona;13;Barcelonès;08019;Barcelona;12;46;2;;582;422;160;3;1;418;419
8;Barcelona;13;Barcelonès;08019;Barcelona;12;47;1;;615;401;214;1;2;398;400
8;Barcelona;13;Barcelonès;08019;Barcelona;12;47;2;;603;391;212;0;2;389;391
8;Barcelona;13;Barcelonès;08019;Barcelona;12;48;1;;657;426;231;10;2;414;416
8;Barcelona;13;Barcelonès;08019;Barcelona;12;48;2;;662;403;259;1;0;402;402
8;Barcelona;13;Barcelonès;08019;Barcelona;12;49;1;;619;392;227;7;4;381;385
8;Barcelona;13;Barcelonès;08019;Barcelona;12;49;2;;631;402;229;0;1;401;402
8;Barcelona;13;Barcelonès;08019;Barcelona;12;5;1;;485;309;176;0;1;308;309
8;Barcelona;13;Barcelonès;08019;Barcelona;12;5;2;;483;333;150;3;0;330;330
8;Barcelona;13;Barcelonès;08019;Barcelona;12;50;1;;695;438;257;2;7;429;436
8;Barcelona;13;Barcelonès;08019;Barcelona;12;51;1;;712;436;276;0;3;433;436
8;Barcelona;13;Barcelonès;08019;Barcelona;12;51;2;;677;430;247;0;4;426;430
8;Barcelona;13;Barcelonès;08019;Barcelona;12;51;3;;711;463;248;0;1;462;463
8;Barcelona;13;Barcelonès;08019;Barcelona;12;52;1;;512;336;176;0;2;334;336
8;Barcelona;13;Barcelonès;08019;Barcelona;12;52;2;;523;328;195;0;2;326;328
8;Barcelona;13;Barcelonès;08019;Barcelona;12;53;1;;574;368;206;0;1;367;368
8;Barcelona;13;Barcelonès;08019;Barcelona;12;53;2;;568;374;194;14;1;359;360
8;Barcelona;13;Barcelonès;08019;Barcelona;12;53;3;;587;366;221;11;0;355;355
8;Barcelona;13;Barcelonès;08019;Barcelona;12;54;1;;541;360;181;0;0;360;360
8;Barcelona;13;Barcelonès;08019;Barcelona;12;54;2;;542;348;194;8;1;339;340
8;Barcelona;13;Barcelonès;08019;Barcelona;12;55;1;;483;284;199;0;1;283;284
8;Barcelona;13;Barcelonès;08019;Barcelona;12;55;2;;498;290;208;3;4;283;287
8;Barcelona;13;Barcelonès;08019;Barcelona;12;56;1;;719;425;294;1;6;418;424
8;Barcelona;13;Barcelonès;08019;Barcelona;12;56;2;;723;473;250;0;7;466;473
8;Barcelona;13;Barcelonès;08019;Barcelona;12;57;1;;642;427;215;12;4;411;415
8;Barcelona;13;Barcelonès;08019;Barcelona;12;57;2;;684;426;258;1;5;420;425
8;Barcelona;13;Barcelonès;08019;Barcelona;12;57;3;;620;398;222;0;3;395;398
8;Barcelona;13;Barcelonès;08019;Barcelona;12;57;4;;645;404;241;1;2;401;403
8;Barcelona;13;Barcelonès;08019;Barcelona;12;58;1;;795;484;311;3;2;479;481
8;Barcelona;13;Barcelonès;08019;Barcelona;12;58;2;;775;480;295;0;3;477;480
8;Barcelona;13;Barcelonès;08019;Barcelona;12;58;3;;787;509;278;8;0;501;501
8;Barcelona;13;Barcelonès;08019;Barcelona;12;59;1;;681;443;238;1;0;442;442
8;Barcelona;13;Barcelonès;08019;Barcelona;12;59;2;;666;445;221;0;0;445;445
8;Barcelona;13;Barcelonès;08019;Barcelona;12;59;3;;663;479;184;2;1;476;477
8;Barcelona;13;Barcelonès;08019;Barcelona;12;6;1;;424;271;153;0;3;268;271
8;Barcelona;13;Barcelonès;08019;Barcelona;12;6;2;;438;289;149;0;4;285;289
8;Barcelona;13;Barcelonès;08019;Barcelona;12;60;1;;472;264;208;7;2;255;257
8;Barcelona;13;Barcelonès;08019;Barcelona;12;60;2;;485;276;209;2;0;274;274
8;Barcelona;13;Barcelonès;08019;Barcelona;12;61;1;;674;377;297;0;2;375;377
8;Barcelona;13;Barcelonès;08019;Barcelona;12;61;2;;666;344;322;0;0;344;344
8;Barcelona;13;Barcelonès;08019;Barcelona;12;62;1;;680;392;288;2;2;388;390
8;Barcelona;13;Barcelonès;08019;Barcelona;12;62;2;;678;401;277;1;4;396;400
8;Barcelona;13;Barcelonès;08019;Barcelona;12;62;3;;710;403;307;3;0;400;400
8;Barcelona;13;Barcelonès;08019;Barcelona;12;63;1;;684;338;346;1;3;334;337
8;Barcelona;13;Barcelonès;08019;Barcelona;12;63;2;;589;341;248;0;0;341;341
8;Barcelona;13;Barcelonès;08019;Barcelona;12;64;1;;608;339;269;0;0;339;339
8;Barcelona;13;Barcelonès;08019;Barcelona;12;64;2;;603;369;234;6;3;360;363
8;Barcelona;13;Barcelonès;08019;Barcelona;12;65;1;;641;384;257;8;3;373;376
8;Barcelona;13;Barcelonès;08019;Barcelona;12;65;2;;601;345;256;11;3;331;334
8;Barcelona;13;Barcelonès;08019;Barcelona;12;65;3;;628;386;242;12;1;373;374
8;Barcelona;13;Barcelonès;08019;Barcelona;12;66;1;;721;388;333;7;1;380;381
8;Barcelona;13;Barcelonès;08019;Barcelona;12;66;2;;723;396;327;4;2;390;392
8;Barcelona;13;Barcelonès;08019;Barcelona;12;66;3;;685;401;284;0;1;400;401
8;Barcelona;13;Barcelonès;08019;Barcelona;12;67;1;;571;308;263;0;0;308;308
8;Barcelona;13;Barcelonès;08019;Barcelona;12;67;2;;608;335;273;1;2;332;334
8;Barcelona;13;Barcelonès;08019;Barcelona;12;67;3;;597;343;254;5;3;335;338
8;Barcelona;13;Barcelonès;08019;Barcelona;12;68;1;;531;292;239;1;2;289;291
8;Barcelona;13;Barcelonès;08019;Barcelona;12;69;1;;547;386;161;0;2;384;386
8;Barcelona;13;Barcelonès;08019;Barcelona;12;69;2;;584;340;244;1;0;339;339
8;Barcelona;13;Barcelonès;08019;Barcelona;12;69;3;;569;359;210;0;4;355;359
8;Barcelona;13;Barcelonès;08019;Barcelona;12;7;1;;771;517;254;3;0;514;514
8;Barcelona;13;Barcelonès;08019;Barcelona;12;7;2;;788;528;260;0;4;524;528
8;Barcelona;13;Barcelonès;08019;Barcelona;12;70;1;;271;186;85;0;0;186;186
8;Barcelona;13;Barcelonès;08019;Barcelona;12;71;1;;577;336;241;1;4;331;335
8;Barcelona;13;Barcelonès;08019;Barcelona;12;71;2;;568;348;220;1;1;346;347
8;Barcelona;13;Barcelonès;08019;Barcelona;12;71;3;;603;339;264;0;5;334;339
8;Barcelona;13;Barcelonès;08019;Barcelona;12;72;1;;428;258;170;0;1;257;258
8;Barcelona;13;Barcelonès;08019;Barcelona;12;72;2;;422;269;153;1;2;266;268
8;Barcelona;13;Barcelonès;08019;Barcelona;12;73;1;;768;412;356;2;4;406;410
8;Barcelona;13;Barcelonès;08019;Barcelona;12;73;2;;769;416;353;16;3;397;400
8;Barcelona;13;Barcelonès;08019;Barcelona;12;74;1;;623;389;234;0;7;382;389
8;Barcelona;13;Barcelonès;08019;Barcelona;12;74;2;;627;380;247;1;7;372;379
8;Barcelona;13;Barcelonès;08019;Barcelona;12;74;3;;594;358;236;0;9;349;358
8;Barcelona;13;Barcelonès;08019;Barcelona;12;75;1;;793;521;272;4;5;512;517
8;Barcelona;13;Barcelonès;08019;Barcelona;12;75;2;;810;517;293;1;0;516;516
8;Barcelona;13;Barcelonès;08019;Barcelona;12;76;1;;846;521;325;4;3;514;517
8;Barcelona;13;Barcelonès;08019;Barcelona;12;77;1;;619;406;213;1;0;405;405
8;Barcelona;13;Barcelonès;08019;Barcelona;12;77;2;;599;402;197;0;5;397;402
8;Barcelona;13;Barcelonès;08019;Barcelona;12;78;1;;784;496;288;0;8;488;496
8;Barcelona;13;Barcelonès;08019;Barcelona;12;78;2;;778;454;324;0;5;449;454
8;Barcelona;13;Barcelonès;08019;Barcelona;12;79;1;;502;339;163;0;2;337;339
8;Barcelona;13;Barcelonès;08019;Barcelona;12;8;1;;787;511;276;0;1;510;511
8;Barcelona;13;Barcelonès;08019;Barcelona;12;8;2;;806;512;294;1;4;507;511
8;Barcelona;13;Barcelonès;08019;Barcelona;12;80;1;;731;489;242;0;2;487;489
8;Barcelona;13;Barcelonès;08019;Barcelona;12;80;2;;757;475;282;0;1;474;475
8;Barcelona;13;Barcelonès;08019;Barcelona;12;81;1;;608;370;238;1;3;366;369
8;Barcelona;13;Barcelonès;08019;Barcelona;12;81;2;;613;393;220;0;5;388;393
8;Barcelona;13;Barcelonès;08019;Barcelona;12;82;1;;547;507;40;6;1;500;501
8;Barcelona;13;Barcelonès;08019;Barcelona;12;82;2;;744;551;193;1;3;547;550
8;Barcelona;13;Barcelonès;08019;Barcelona;12;83;1;;577;365;212;0;3;362;365
8;Barcelona;13;Barcelonès;08019;Barcelona;12;84;1;;613;409;204;0;8;401;409
8;Barcelona;13;Barcelonès;08019;Barcelona;12;84;2;;650;411;239;3;4;404;408
8;Barcelona;13;Barcelonès;08019;Barcelona;12;85;1;;527;339;188;0;1;338;339
8;Barcelona;13;Barcelonès;08019;Barcelona;12;85;2;;528;330;198;0;3;327;330
8;Barcelona;13;Barcelonès;08019;Barcelona;12;86;1;;669;443;226;1;0;442;442
8;Barcelona;13;Barcelonès;08019;Barcelona;12;86;2;;644;414;230;1;1;412;413
8;Barcelona;13;Barcelonès;08019;Barcelona;12;86;3;;641;458;183;16;0;442;442
8;Barcelona;13;Barcelonès;08019;Barcelona;12;87;1;;699;466;233;0;2;464;466
8;Barcelona;13;Barcelonès;08019;Barcelona;12;87;2;;686;484;202;0;3;481;484
8;Barcelona;13;Barcelonès;08019;Barcelona;12;88;1;;760;488;272;5;3;480;483
8;Barcelona;13;Barcelonès;08019;Barcelona;12;88;2;;760;478;282;2;2;474;476
8;Barcelona;13;Barcelonès;08019;Barcelona;12;89;1;;691;452;239;1;1;450;451
8;Barcelona;13;Barcelonès;08019;Barcelona;12;89;2;;677;442;235;0;0;442;442
8;Barcelona;13;Barcelonès;08019;Barcelona;12;9;1;;516;360;156;0;3;357;360
8;Barcelona;13;Barcelonès;08019;Barcelona;12;9;2;;510;340;170;0;2;338;340
8;Barcelona;13;Barcelonès;08019;Barcelona;12;90;1;;659;435;224;4;0;431;431
8;Barcelona;13;Barcelonès;08019;Barcelona;12;90;2;;665;446;219;0;3;443;446
8;Barcelona;13;Barcelonès;08019;Barcelona;12;90;3;;665;445;220;0;1;444;445
8;Barcelona;13;Barcelonès;08019;Barcelona;12;90;4;;678;426;252;3;4;419;423
8;Barcelona;13;Barcelonès;08019;Barcelona;12;91;1;;606;390;216;0;0;390;390
8;Barcelona;13;Barcelonès;08019;Barcelona;12;91;2;;618;413;205;2;0;411;411
8;Barcelona;13;Barcelonès;08019;Barcelona;12;92;1;;799;521;278;1;3;517;520
8;Barcelona;13;Barcelonès;08019;Barcelona;12;92;2;;834;507;327;0;1;506;507
8;Barcelona;13;Barcelonès;08019;Barcelona;12;92;3;;796;529;267;1;1;527;528
8;Barcelona;13;Barcelonès;08019;Barcelona;12;93;1;;753;489;264;0;3;486;489
8;Barcelona;13;Barcelonès;08019;Barcelona;12;93;2;;782;492;290;2;5;485;490
8;Barcelona;13;Barcelonès;08019;Barcelona;12;93;3;;780;529;251;0;1;528;529
8;Barcelona;13;Barcelonès;08019;Barcelona;12;94;1;;618;422;196;1;7;414;421
8;Barcelona;13;Barcelonès;08019;Barcelona;12;94;2;;610;415;195;6;3;406;409
8;Barcelona;13;Barcelonès;08019;Barcelona;12;95;1;;551;405;146;1;7;397;404
8;Barcelona;13;Barcelonès;08019;Barcelona;12;95;2;;593;417;176;2;5;410;415
8;Barcelona;13;Barcelonès;08019;Barcelona;12;96;1;;803;516;287;1;3;512;515
8;Barcelona;13;Barcelonès;08019;Barcelona;12;96;2;;797;541;256;1;1;539;540
8;Barcelona;13;Barcelonès;08019;Barcelona;12;97;1;;493;323;170;0;1;322;323
8;Barcelona;13;Barcelonès;08019;Barcelona;12;97;2;;493;271;222;3;1;267;268
8;Barcelona;13;Barcelonès;08019;Barcelona;12;98;1;;649;432;217;2;2;428;430
8;Barcelona;13;Barcelonès;08019;Barcelona;12;98;2;;676;439;237;1;8;430;438
8;Barcelona;13;Barcelonès;08019;Barcelona;12;98;3;;662;442;220;1;1;440;441
8;Barcelona;13;Barcelonès;08019;Barcelona;12;99;1;;784;466;318;0;4;462;466
8;Barcelona;13;Barcelonès;08019;Barcelona;12;99;2;;788;433;355;1;5;427;432
8;Barcelona;13;Barcelonès;08019;Barcelona;12;99;3;;776;430;346;17;3;410;413
8;Barcelona;13;Barcelonès;08019;Barcelona;13;1;1;;1581;194;1387;4;0;190;190
8;Barcelona;13;Barcelonès;08019;Barcelona;13;2;1;;1544;181;1363;0;0;181;181
8;Barcelona;13;Barcelonès;08019;Barcelona;13;3;1;;2005;239;1766;0;1;238;239
8;Barcelona;13;Barcelonès;08019;Barcelona;13;4;1;;1884;230;1654;1;0;229;229
8;Barcelona;13;Barcelonès;08019;Barcelona;13;5;1;;1978;247;1731;1;0;246;246
8;Barcelona;13;Barcelonès;08019;Barcelona;13;6;1;;1920;244;1676;13;0;231;231
8;Barcelona;13;Barcelonès;08019;Barcelona;2;1;1;;691;367;324;0;3;364;367
8;Barcelona;13;Barcelonès;08019;Barcelona;2;1;2;;681;396;285;0;2;394;396
8;Barcelona;13;Barcelonès;08019;Barcelona;2;1;3;;684;379;305;0;6;373;379
8;Barcelona;13;Barcelonès;08019;Barcelona;2;10;1;;761;412;349;0;0;412;412
8;Barcelona;13;Barcelonès;08019;Barcelona;2;11;1;;791;495;296;2;8;485;493
8;Barcelona;13;Barcelonès;08019;Barcelona;2;12;1;;814;515;299;12;4;499;503
8;Barcelona;13;Barcelonès;08019;Barcelona;2;13;1;;559;343;216;13;0;330;330
8;Barcelona;13;Barcelonès;08019;Barcelona;2;14;1;;510;344;166;17;4;323;327
8;Barcelona;13;Barcelonès;08019;Barcelona;2;14;2;;508;317;191;2;0;315;315
8;Barcelona;13;Barcelonès;08019;Barcelona;2;15;1;;594;385;209;3;0;382;382
8;Barcelona;13;Barcelonès;08019;Barcelona;2;15;2;;603;403;200;4;0;399;399
8;Barcelona;13;Barcelonès;08019;Barcelona;2;15;3;;588;366;222;1;2;363;365
8;Barcelona;13;Barcelonès;08019;Barcelona;2;16;1;;561;334;227;0;4;330;334
8;Barcelona;13;Barcelonès;08019;Barcelona;2;16;2;;569;321;248;3;1;317;318
8;Barcelona;13;Barcelonès;08019;Barcelona;2;17;1;;582;352;230;0;9;343;352
8;Barcelona;13;Barcelonès;08019;Barcelona;2;18;1;;700;475;225;0;3;472;475
8;Barcelona;13;Barcelonès;08019;Barcelona;2;18;2;;693;436;257;1;4;431;435
8;Barcelona;13;Barcelonès;08019;Barcelona;2;19;1;;656;444;212;0;3;441;444
8;Barcelona;13;Barcelonès;08019;Barcelona;2;2;1;;739;422;317;0;0;422;422
8;Barcelona;13;Barcelonès;08019;Barcelona;2;2;2;;742;423;319;19;1;403;404
8;Barcelona;13;Barcelonès;08019;Barcelona;2;2;3;;734;377;357;1;0;376;376
8;Barcelona;13;Barcelonès;08019;Barcelona;2;20;1;;536;348;188;0;0;348;348
8;Barcelona;13;Barcelonès;08019;Barcelona;2;20;2;;564;340;224;1;2;337;339
8;Barcelona;13;Barcelonès;08019;Barcelona;2;21;1;;423;261;162;2;2;257;259
8;Barcelona;13;Barcelonès;08019;Barcelona;2;21;2;;422;274;148;2;1;271;272
8;Barcelona;13;Barcelonès;08019;Barcelona;2;22;1;;466;281;185;2;1;278;279
8;Barcelona;13;Barcelonès;08019;Barcelona;2;22;2;;476;278;198;3;1;274;275
8;Barcelona;13;Barcelonès;08019;Barcelona;2;23;1;;407;248;159;1;1;246;247
8;Barcelona;13;Barcelonès;08019;Barcelona;2;23;2;;408;261;147;0;0;261;261
8;Barcelona;13;Barcelonès;08019;Barcelona;2;24;1;;763;502;261;1;3;498;501
8;Barcelona;13;Barcelonès;08019;Barcelona;2;25;1;;477;252;225;6;0;246;246
8;Barcelona;13;Barcelonès;08019;Barcelona;2;26;1;;448;270;178;8;4;258;262
8;Barcelona;13;Barcelonès;08019;Barcelona;2;27;1;;492;320;172;1;1;318;319
8;Barcelona;13;Barcelonès;08019;Barcelona;2;27;2;;496;301;195;2;2;297;299
8;Barcelona;13;Barcelonès;08019;Barcelona;2;28;1;;658;449;209;2;0;447;447
8;Barcelona;13;Barcelonès;08019;Barcelona;2;29;1;;788;493;295;0;2;491;493
8;Barcelona;13;Barcelonès;08019;Barcelona;2;3;1;;704;378;326;3;3;372;375
8;Barcelona;13;Barcelonès;08019;Barcelona;2;3;2;;702;391;311;0;2;389;391
8;Barcelona;13;Barcelonès;08019;Barcelona;2;30;1;;671;417;254;2;0;415;415
8;Barcelona;13;Barcelonès;08019;Barcelona;2;31;1;;428;287;141;0;2;285;287
8;Barcelona;13;Barcelonès;08019;Barcelona;2;31;2;;446;288;158;0;2;286;288
8;Barcelona;13;Barcelonès;08019;Barcelona;2;32;1;;752;468;284;0;1;467;468
8;Barcelona;13;Barcelonès;08019;Barcelona;2;33;1;;581;380;201;0;2;378;380
8;Barcelona;13;Barcelonès;08019;Barcelona;2;33;2;;585;389;196;0;3;386;389
8;Barcelona;13;Barcelonès;08019;Barcelona;2;33;3;;592;374;218;1;1;372;373
8;Barcelona;13;Barcelonès;08019;Barcelona;2;34;1;;606;448;158;0;0;448;448
8;Barcelona;13;Barcelonès;08019;Barcelona;2;34;2;;615;444;171;0;1;443;444
8;Barcelona;13;Barcelonès;08019;Barcelona;2;34;3;;605;428;177;0;0;428;428
8;Barcelona;13;Barcelonès;08019;Barcelona;2;35;1;;435;297;138;0;0;297;297
8;Barcelona;13;Barcelonès;08019;Barcelona;2;35;2;;418;308;110;1;1;306;307
8;Barcelona;13;Barcelonès;08019;Barcelona;2;36;1;;669;428;241;1;3;424;427
8;Barcelona;13;Barcelonès;08019;Barcelona;2;36;2;;659;449;210;1;5;443;448
8;Barcelona;13;Barcelonès;08019;Barcelona;2;37;1;;636;451;185;1;2;448;450
8;Barcelona;13;Barcelonès;08019;Barcelona;2;37;2;;631;450;181;5;0;445;445
8;Barcelona;13;Barcelonès;08019;Barcelona;2;37;3;;636;466;170;4;4;458;462
8;Barcelona;13;Barcelonès;08019;Barcelona;2;38;1;;737;508;229;0;8;500;508
8;Barcelona;13;Barcelonès;08019;Barcelona;2;39;1;;478;340;138;0;0;340;340
8;Barcelona;13;Barcelonès;08019;Barcelona;2;39;2;;475;333;142;7;0;326;326
8;Barcelona;13;Barcelonès;08019;Barcelona;2;4;1;;464;269;195;1;1;267;268
8;Barcelona;13;Barcelonès;08019;Barcelona;2;4;2;;460;263;197;0;1;262;263
8;Barcelona;13;Barcelonès;08019;Barcelona;2;40;1;;791;477;314;2;5;470;475
8;Barcelona;13;Barcelonès;08019;Barcelona;2;41;1;;426;305;121;0;1;304;305
8;Barcelona;13;Barcelonès;08019;Barcelona;2;41;2;;439;325;114;0;0;325;325
8;Barcelona;13;Barcelonès;08019;Barcelona;2;42;1;;658;468;190;4;4;460;464
8;Barcelona;13;Barcelonès;08019;Barcelona;2;42;2;;652;473;179;7;4;462;466
8;Barcelona;13;Barcelonès;08019;Barcelona;2;42;3;;643;454;189;7;3;444;447
8;Barcelona;13;Barcelonès;08019;Barcelona;2;42;4;;629;462;167;8;4;450;454
8;Barcelona;13;Barcelonès;08019;Barcelona;2;43;1;;572;379;193;0;4;375;379
8;Barcelona;13;Barcelonès;08019;Barcelona;2;43;2;;600;396;204;0;3;393;396
8;Barcelona;13;Barcelonès;08019;Barcelona;2;43;3;;628;409;219;4;3;402;405
8;Barcelona;13;Barcelonès;08019;Barcelona;2;44;1;;503;307;196;5;5;297;302
8;Barcelona;13;Barcelonès;08019;Barcelona;2;44;2;;498;309;189;0;0;309;309
8;Barcelona;13;Barcelonès;08019;Barcelona;2;45;1;;540;343;197;6;1;336;337
8;Barcelona;13;Barcelonès;08019;Barcelona;2;45;2;;546;340;206;3;3;334;337
8;Barcelona;13;Barcelonès;08019;Barcelona;2;46;1;;448;299;149;3;0;296;296
8;Barcelona;13;Barcelonès;08019;Barcelona;2;46;2;;450;311;139;1;0;310;310
8;Barcelona;13;Barcelonès;08019;Barcelona;2;47;1;;703;491;212;0;3;488;491
8;Barcelona;13;Barcelonès;08019;Barcelona;2;47;2;;662;465;197;6;3;456;459
8;Barcelona;13;Barcelonès;08019;Barcelona;2;47;3;;693;471;222;1;2;468;470
8;Barcelona;13;Barcelonès;08019;Barcelona;2;47;4;;661;483;178;2;1;480;481
8;Barcelona;13;Barcelonès;08019;Barcelona;2;48;1;;675;493;182;0;3;490;493
8;Barcelona;13;Barcelonès;08019;Barcelona;2;48;2;;674;495;179;0;2;493;495
8;Barcelona;13;Barcelonès;08019;Barcelona;2;48;3;;683;480;203;1;5;474;479
8;Barcelona;13;Barcelonès;08019;Barcelona;2;49;1;;489;324;165;0;0;324;324
8;Barcelona;13;Barcelonès;08019;Barcelona;2;49;2;;469;316;153;10;0;306;306
8;Barcelona;13;Barcelonès;08019;Barcelona;2;5;1;;434;269;165;0;0;269;269
8;Barcelona;13;Barcelonès;08019;Barcelona;2;5;2;;430;258;172;0;1;257;258
8;Barcelona;13;Barcelonès;08019;Barcelona;2;50;1;;447;288;159;1;2;285;287
8;Barcelona;13;Barcelonès;08019;Barcelona;2;50;2;;451;274;177;1;1;272;273
8;Barcelona;13;Barcelonès;08019;Barcelona;2;51;1;;543;338;205;2;0;336;336
8;Barcelona;13;Barcelonès;08019;Barcelona;2;51;2;;539;350;189;0;3;347;350
8;Barcelona;13;Barcelonès;08019;Barcelona;2;52;1;;423;253;170;5;3;245;248
8;Barcelona;13;Barcelonès;08019;Barcelona;2;52;2;;413;226;187;3;0;223;223
8;Barcelona;13;Barcelonès;08019;Barcelona;2;53;1;;487;302;185;0;3;299;302
8;Barcelona;13;Barcelonès;08019;Barcelona;2;53;2;;497;296;201;9;2;285;287
8;Barcelona;13;Barcelonès;08019;Barcelona;2;54;1;;748;479;269;0;0;479;479
8;Barcelona;13;Barcelonès;08019;Barcelona;2;54;2;;730;481;249;2;0;479;479
8;Barcelona;13;Barcelonès;08019;Barcelona;2;55;1;;684;420;264;0;4;416;420
8;Barcelona;13;Barcelonès;08019;Barcelona;2;55;2;;677;436;241;1;0;435;435
8;Barcelona;13;Barcelonès;08019;Barcelona;2;55;3;;646;422;224;2;0;420;420
8;Barcelona;13;Barcelonès;08019;Barcelona;2;56;1;;449;251;198;3;0;248;248
8;Barcelona;13;Barcelonès;08019;Barcelona;2;56;2;;448;272;176;5;2;265;267
8;Barcelona;13;Barcelonès;08019;Barcelona;2;57;1;;456;308;148;0;0;308;308
8;Barcelona;13;Barcelonès;08019;Barcelona;2;57;2;;481;294;187;5;0;289;289
8;Barcelona;13;Barcelonès;08019;Barcelona;2;58;1;;615;391;224;0;1;390;391
8;Barcelona;13;Barcelonès;08019;Barcelona;2;59;1;;660;419;241;2;3;414;417
8;Barcelona;13;Barcelonès;08019;Barcelona;2;59;2;;655;446;209;2;3;441;444
8;Barcelona;13;Barcelonès;08019;Barcelona;2;6;1;;598;346;252;5;1;340;341
8;Barcelona;13;Barcelonès;08019;Barcelona;2;6;2;;600;346;254;2;4;340;344
8;Barcelona;13;Barcelonès;08019;Barcelona;2;60;1;;537;332;205;3;0;329;329
8;Barcelona;13;Barcelonès;08019;Barcelona;2;60;2;;544;354;190;1;5;348;353
8;Barcelona;13;Barcelonès;08019;Barcelona;2;61;1;;618;391;227;2;0;389;389
8;Barcelona;13;Barcelonès;08019;Barcelona;2;61;2;;620;395;225;0;3;392;395
8;Barcelona;13;Barcelonès;08019;Barcelona;2;62;1;;697;476;221;3;4;469;473
8;Barcelona;13;Barcelonès;08019;Barcelona;2;62;2;;702;456;246;1;2;453;455
8;Barcelona;13;Barcelonès;08019;Barcelona;2;63;1;;793;459;334;5;0;454;454
8;Barcelona;13;Barcelonès;08019;Barcelona;2;64;1;;474;290;184;6;3;281;284
8;Barcelona;13;Barcelonès;08019;Barcelona;2;64;2;;472;280;192;0;4;276;280
8;Barcelona;13;Barcelonès;08019;Barcelona;2;65;1;;709;437;272;4;2;431;433
8;Barcelona;13;Barcelonès;08019;Barcelona;2;65;2;;712;428;284;0;5;423;428
8;Barcelona;13;Barcelonès;08019;Barcelona;2;66;1;;745;392;353;8;3;381;384
8;Barcelona;13;Barcelonès;08019;Barcelona;2;67;1;;604;355;249;1;2;352;354
8;Barcelona;13;Barcelonès;08019;Barcelona;2;67;2;;621;368;253;1;0;367;367
8;Barcelona;13;Barcelonès;08019;Barcelona;2;68;1;;617;300;317;0;3;297;300
8;Barcelona;13;Barcelonès;08019;Barcelona;2;69;1;;608;342;266;0;3;339;342
8;Barcelona;13;Barcelonès;08019;Barcelona;2;7;1;;424;233;191;0;1;232;233
8;Barcelona;13;Barcelonès;08019;Barcelona;2;70;1;;692;385;307;10;0;375;375
8;Barcelona;13;Barcelonès;08019;Barcelona;2;70;2;;707;403;304;0;3;400;403
8;Barcelona;13;Barcelonès;08019;Barcelona;2;70;3;;699;403;296;3;1;399;400
8;Barcelona;13;Barcelonès;08019;Barcelona;2;71;1;;722;461;261;0;1;460;461
8;Barcelona;13;Barcelonès;08019;Barcelona;2;72;1;;721;424;297;13;0;411;411
8;Barcelona;13;Barcelonès;08019;Barcelona;2;72;2;;737;409;328;14;1;394;395
8;Barcelona;13;Barcelonès;08019;Barcelona;2;72;3;;730;368;362;4;0;364;364
8;Barcelona;13;Barcelonès;08019;Barcelona;2;72;4;;741;405;336;11;0;394;394
8;Barcelona;13;Barcelonès;08019;Barcelona;2;73;1;;753;480;273;2;5;473;478
8;Barcelona;13;Barcelonès;08019;Barcelona;2;73;2;;774;470;304;0;3;467;470
8;Barcelona;13;Barcelonès;08019;Barcelona;2;73;3;;779;449;330;2;3;444;447
8;Barcelona;13;Barcelonès;08019;Barcelona;2;73;4;;779;443;336;0;1;442;443
8;Barcelona;13;Barcelonès;08019;Barcelona;2;73;5;;790;462;328;1;3;458;461
8;Barcelona;13;Barcelonès;08019;Barcelona;2;73;6;;775;477;298;5;8;464;472
8;Barcelona;13;Barcelonès;08019;Barcelona;2;74;1;;790;451;339;0;2;449;451
8;Barcelona;13;Barcelonès;08019;Barcelona;2;75;1;;641;338;303;0;2;336;338
8;Barcelona;13;Barcelonès;08019;Barcelona;2;75;2;;649;372;277;5;1;366;367
8;Barcelona;13;Barcelonès;08019;Barcelona;2;75;3;;640;386;254;3;3;380;383
8;Barcelona;13;Barcelonès;08019;Barcelona;2;75;4;;643;387;256;0;1;386;387
8;Barcelona;13;Barcelonès;08019;Barcelona;2;76;1;;593;356;237;2;2;352;354
8;Barcelona;13;Barcelonès;08019;Barcelona;2;76;2;;595;364;231;2;8;354;362
8;Barcelona;13;Barcelonès;08019;Barcelona;2;76;3;;593;331;262;0;2;329;331
8;Barcelona;13;Barcelonès;08019;Barcelona;2;77;1;;573;241;332;2;2;237;239
8;Barcelona;13;Barcelonès;08019;Barcelona;2;78;1;;533;278;255;0;3;275;278
8;Barcelona;13;Barcelonès;08019;Barcelona;2;79;1;;653;371;282;0;0;371;371
8;Barcelona;13;Barcelonès;08019;Barcelona;2;8;1;;791;462;329;0;0;462;462
8;Barcelona;13;Barcelonès;08019;Barcelona;2;80;1;;186;31;155;1;0;30;30
8;Barcelona;13;Barcelonès;08019;Barcelona;2;81;1;;533;351;182;0;6;345;351
8;Barcelona;13;Barcelonès;08019;Barcelona;2;81;2;;545;361;184;1;2;358;360
8;Barcelona;13;Barcelonès;08019;Barcelona;2;82;1;;284;131;153;1;0;130;130
8;Barcelona;13;Barcelonès;08019;Barcelona;2;9;1;;408;242;166;0;2;240;242
8;Barcelona;13;Barcelonès;08019;Barcelona;2;9;2;;403;226;177;0;0;226;226
8;Barcelona;13;Barcelonès;08019;Barcelona;3;1;1;;593;417;176;0;2;415;417
8;Barcelona;13;Barcelonès;08019;Barcelona;3;1;2;;610;434;176;0;5;429;434
8;Barcelona;13;Barcelonès;08019;Barcelona;3;10;1;;622;461;161;0;7;454;461
8;Barcelona;13;Barcelonès;08019;Barcelona;3;10;2;;647;468;179;1;3;464;467
8;Barcelona;13;Barcelonès;08019;Barcelona;3;11;1;;757;543;214;1;5;537;542
8;Barcelona;13;Barcelonès;08019;Barcelona;3;11;2;;772;555;217;1;1;553;554
8;Barcelona;13;Barcelonès;08019;Barcelona;3;12;1;;771;539;232;0;4;535;539
8;Barcelona;13;Barcelonès;08019;Barcelona;3;12;2;;801;584;217;4;7;573;580
8;Barcelona;13;Barcelonès;08019;Barcelona;3;13;1;;776;570;206;0;5;565;570
8;Barcelona;13;Barcelonès;08019;Barcelona;3;13;2;;780;585;195;11;0;574;574
8;Barcelona;13;Barcelonès;08019;Barcelona;3;14;1;;630;468;162;4;0;464;464
8;Barcelona;13;Barcelonès;08019;Barcelona;3;14;2;;611;478;133;3;1;474;475
8;Barcelona;13;Barcelonès;08019;Barcelona;3;14;3;;644;493;151;0;3;490;493
8;Barcelona;13;Barcelonès;08019;Barcelona;3;15;1;;571;429;142;1;3;425;428
8;Barcelona;13;Barcelonès;08019;Barcelona;3;15;2;;580;430;150;0;4;426;430
8;Barcelona;13;Barcelonès;08019;Barcelona;3;15;3;;580;428;152;10;3;415;418
8;Barcelona;13;Barcelonès;08019;Barcelona;3;16;1;;580;430;150;1;7;422;429
8;Barcelona;13;Barcelonès;08019;Barcelona;3;16;2;;586;408;178;3;0;405;405
8;Barcelona;13;Barcelonès;08019;Barcelona;3;17;1;;635;477;158;3;1;473;474
8;Barcelona;13;Barcelonès;08019;Barcelona;3;17;2;;643;469;174;1;3;465;468
8;Barcelona;13;Barcelonès;08019;Barcelona;3;18;1;;782;581;201;1;2;578;580
8;Barcelona;13;Barcelonès;08019;Barcelona;3;18;2;;821;592;229;0;4;588;592
8;Barcelona;13;Barcelonès;08019;Barcelona;3;19;1;;730;516;214;1;5;510;515
8;Barcelona;13;Barcelonès;08019;Barcelona;3;19;2;;691;516;175;0;2;514;516
8;Barcelona;13;Barcelonès;08019;Barcelona;3;19;3;;713;516;197;0;2;514;516
8;Barcelona;13;Barcelonès;08019;Barcelona;3;2;1;;756;543;213;0;4;539;543
8;Barcelona;13;Barcelonès;08019;Barcelona;3;2;2;;751;588;163;0;5;583;588
8;Barcelona;13;Barcelonès;08019;Barcelona;3;20;1;;550;412;138;3;1;408;409
8;Barcelona;13;Barcelonès;08019;Barcelona;3;20;2;;542;386;156;1;3;382;385
8;Barcelona;13;Barcelonès;08019;Barcelona;3;20;3;;561;399;162;0;3;396;399
8;Barcelona;13;Barcelonès;08019;Barcelona;3;21;1;;570;444;126;3;3;438;441
8;Barcelona;13;Barcelonès;08019;Barcelona;3;21;2;;570;438;132;6;0;432;432
8;Barcelona;13;Barcelonès;08019;Barcelona;3;22;1;;710;535;175;1;5;529;534
8;Barcelona;13;Barcelonès;08019;Barcelona;3;22;2;;713;547;166;2;0;545;545
8;Barcelona;13;Barcelonès;08019;Barcelona;3;23;1;;757;567;190;0;4;563;567
8;Barcelona;13;Barcelonès;08019;Barcelona;3;23;2;;783;564;219;2;3;559;562
8;Barcelona;13;Barcelonès;08019;Barcelona;3;24;1;;423;285;138;2;2;281;283
8;Barcelona;13;Barcelonès;08019;Barcelona;3;24;2;;417;288;129;2;1;285;286
8;Barcelona;13;Barcelonès;08019;Barcelona;3;25;1;;470;383;87;0;5;378;383
8;Barcelona;13;Barcelonès;08019;Barcelona;3;25;2;;481;380;101;6;4;370;374
8;Barcelona;13;Barcelonès;08019;Barcelona;3;26;1;;579;442;137;0;3;439;442
8;Barcelona;13;Barcelonès;08019;Barcelona;3;26;2;;566;450;116;1;4;445;449
8;Barcelona;13;Barcelonès;08019;Barcelona;3;27;1;;645;466;179;5;4;457;461
8;Barcelona;13;Barcelonès;08019;Barcelona;3;27;2;;637;460;177;1;1;458;459
8;Barcelona;13;Barcelonès;08019;Barcelona;3;27;3;;626;480;146;0;6;474;480
8;Barcelona;13;Barcelonès;08019;Barcelona;3;28;1;;602;451;151;2;3;446;449
8;Barcelona;13;Barcelonès;08019;Barcelona;3;28;2;;552;472;80;3;9;460;469
8;Barcelona;13;Barcelonès;08019;Barcelona;3;28;3;;601;489;112;1;5;483;488
8;Barcelona;13;Barcelonès;08019;Barcelona;3;29;1;;682;483;199;0;1;482;483
8;Barcelona;13;Barcelonès;08019;Barcelona;3;29;2;;641;491;150;2;4;485;489
8;Barcelona;13;Barcelonès;08019;Barcelona;3;3;1;;691;498;193;1;7;490;497
8;Barcelona;13;Barcelonès;08019;Barcelona;3;3;2;;711;484;227;2;4;478;482
8;Barcelona;13;Barcelonès;08019;Barcelona;3;3;3;;728;523;205;1;7;515;522
8;Barcelona;13;Barcelonès;08019;Barcelona;3;30;1;;729;568;161;1;5;562;567
8;Barcelona;13;Barcelonès;08019;Barcelona;3;30;2;;717;576;141;3;2;571;573
8;Barcelona;13;Barcelonès;08019;Barcelona;3;31;1;;691;504;187;2;4;498;502
8;Barcelona;13;Barcelonès;08019;Barcelona;3;31;2;;705;524;181;1;4;519;523
8;Barcelona;13;Barcelonès;08019;Barcelona;3;32;1;;754;552;202;0;3;549;552
8;Barcelona;13;Barcelonès;08019;Barcelona;3;32;2;;735;522;213;4;10;508;518
8;Barcelona;13;Barcelonès;08019;Barcelona;3;33;1;;499;364;135;0;6;358;364
8;Barcelona;13;Barcelonès;08019;Barcelona;3;33;2;;494;373;121;3;10;360;370
8;Barcelona;13;Barcelonès;08019;Barcelona;3;34;1;;584;454;130;1;5;448;453
8;Barcelona;13;Barcelonès;08019;Barcelona;3;34;2;;591;476;115;0;3;473;476
8;Barcelona;13;Barcelonès;08019;Barcelona;3;35;1;;431;322;109;0;2;320;322
8;Barcelona;13;Barcelonès;08019;Barcelona;3;35;2;;456;337;119;4;2;331;333
8;Barcelona;13;Barcelonès;08019;Barcelona;3;36;1;;427;329;98;3;1;325;326
8;Barcelona;13;Barcelonès;08019;Barcelona;3;36;2;;450;339;111;0;1;338;339
8;Barcelona;13;Barcelonès;08019;Barcelona;3;37;1;;525;419;106;0;0;419;419
8;Barcelona;13;Barcelonès;08019;Barcelona;3;37;2;;559;419;140;0;1;418;419
8;Barcelona;13;Barcelonès;08019;Barcelona;3;38;1;;747;529;218;2;2;525;527
8;Barcelona;13;Barcelonès;08019;Barcelona;3;38;2;;704;532;172;0;3;529;532
8;Barcelona;13;Barcelonès;08019;Barcelona;3;39;1;;518;349;169;10;3;336;339
8;Barcelona;13;Barcelonès;08019;Barcelona;3;39;2;;517;377;140;2;0;375;375
8;Barcelona;13;Barcelonès;08019;Barcelona;3;4;1;;647;457;190;0;1;456;457
8;Barcelona;13;Barcelonès;08019;Barcelona;3;4;2;;674;474;200;3;4;467;471
8;Barcelona;13;Barcelonès;08019;Barcelona;3;40;1;;450;302;148;1;0;301;301
8;Barcelona;13;Barcelonès;08019;Barcelona;3;40;2;;454;323;131;0;1;322;323
8;Barcelona;13;Barcelonès;08019;Barcelona;3;41;1;;652;444;208;1;1;442;443
8;Barcelona;13;Barcelonès;08019;Barcelona;3;42;1;;757;584;173;4;0;580;580
8;Barcelona;13;Barcelonès;08019;Barcelona;3;42;2;;788;603;185;5;8;590;598
8;Barcelona;13;Barcelonès;08019;Barcelona;3;43;1;;688;545;143;0;2;543;545
8;Barcelona;13;Barcelonès;08019;Barcelona;3;43;2;;669;505;164;0;5;500;505
8;Barcelona;13;Barcelonès;08019;Barcelona;3;43;3;;674;497;177;0;3;494;497
8;Barcelona;13;Barcelonès;08019;Barcelona;3;44;1;;770;578;192;5;3;570;573
8;Barcelona;13;Barcelonès;08019;Barcelona;3;44;2;;737;589;148;6;3;580;583
8;Barcelona;13;Barcelonès;08019;Barcelona;3;45;1;;613;481;132;0;5;476;481
8;Barcelona;13;Barcelonès;08019;Barcelona;3;45;2;;580;461;119;3;1;457;458
8;Barcelona;13;Barcelonès;08019;Barcelona;3;45;3;;618;473;145;0;3;470;473
8;Barcelona;13;Barcelonès;08019;Barcelona;3;46;1;;600;455;145;0;3;452;455
8;Barcelona;13;Barcelonès;08019;Barcelona;3;46;2;;620;455;165;0;2;453;455
8;Barcelona;13;Barcelonès;08019;Barcelona;3;47;1;;721;539;182;5;4;530;534
8;Barcelona;13;Barcelonès;08019;Barcelona;3;47;2;;756;532;224;0;2;530;532
8;Barcelona;13;Barcelonès;08019;Barcelona;3;48;1;;611;489;122;1;5;483;488
8;Barcelona;13;Barcelonès;08019;Barcelona;3;48;2;;618;461;157;0;1;460;461
8;Barcelona;13;Barcelonès;08019;Barcelona;3;48;3;;612;501;111;2;0;499;499
8;Barcelona;13;Barcelonès;08019;Barcelona;3;49;1;;756;575;181;1;5;569;574
8;Barcelona;13;Barcelonès;08019;Barcelona;3;49;2;;777;592;185;0;4;588;592
8;Barcelona;13;Barcelonès;08019;Barcelona;3;49;3;;735;621;114;1;2;618;620
8;Barcelona;13;Barcelonès;08019;Barcelona;3;5;1;;749;559;190;2;4;553;557
8;Barcelona;13;Barcelonès;08019;Barcelona;3;5;2;;761;540;221;0;8;532;540
8;Barcelona;13;Barcelonès;08019;Barcelona;3;5;3;;753;560;193;0;7;553;560
8;Barcelona;13;Barcelonès;08019;Barcelona;3;50;1;;697;513;184;5;1;507;508
8;Barcelona;13;Barcelonès;08019;Barcelona;3;50;2;;681;446;235;1;3;442;445
8;Barcelona;13;Barcelonès;08019;Barcelona;3;50;3;;683;510;173;1;11;498;509
8;Barcelona;13;Barcelonès;08019;Barcelona;3;51;1;;612;466;146;4;2;460;462
8;Barcelona;13;Barcelonès;08019;Barcelona;3;51;2;;598;464;134;0;1;463;464
8;Barcelona;13;Barcelonès;08019;Barcelona;3;52;1;;731;587;144;0;3;584;587
8;Barcelona;13;Barcelonès;08019;Barcelona;3;52;2;;728;547;181;0;8;539;547
8;Barcelona;13;Barcelonès;08019;Barcelona;3;52;3;;729;590;139;0;10;580;590
8;Barcelona;13;Barcelonès;08019;Barcelona;3;52;4;;734;582;152;0;4;578;582
8;Barcelona;13;Barcelonès;08019;Barcelona;3;53;1;;727;533;194;0;9;524;533
8;Barcelona;13;Barcelonès;08019;Barcelona;3;53;2;;720;521;199;1;3;517;520
8;Barcelona;13;Barcelonès;08019;Barcelona;3;54;1;;708;542;166;2;6;534;540
8;Barcelona;13;Barcelonès;08019;Barcelona;3;54;2;;709;555;154;0;5;550;555
8;Barcelona;13;Barcelonès;08019;Barcelona;3;55;1;;586;458;128;4;0;454;454
8;Barcelona;13;Barcelonès;08019;Barcelona;3;56;1;;615;470;145;0;2;468;470
8;Barcelona;13;Barcelonès;08019;Barcelona;3;56;2;;623;446;177;2;5;439;444
8;Barcelona;13;Barcelonès;08019;Barcelona;3;57;1;;572;424;148;0;6;418;424
8;Barcelona;13;Barcelonès;08019;Barcelona;3;57;2;;573;412;161;0;4;408;412
8;Barcelona;13;Barcelonès;08019;Barcelona;3;58;1;;555;424;131;1;1;422;423
8;Barcelona;13;Barcelonès;08019;Barcelona;3;58;2;;565;445;120;1;3;441;444
8;Barcelona;13;Barcelonès;08019;Barcelona;3;59;1;;588;393;195;0;4;389;393
8;Barcelona;13;Barcelonès;08019;Barcelona;3;6;1;;625;422;203;0;1;421;422
8;Barcelona;13;Barcelonès;08019;Barcelona;3;6;2;;600;453;147;4;4;445;449
8;Barcelona;13;Barcelonès;08019;Barcelona;3;60;1;;632;505;127;1;4;500;504
8;Barcelona;13;Barcelonès;08019;Barcelona;3;60;2;;693;476;217;1;0;475;475
8;Barcelona;13;Barcelonès;08019;Barcelona;3;60;3;;638;489;149;1;2;486;488
8;Barcelona;13;Barcelonès;08019;Barcelona;3;60;4;;676;502;174;1;1;500;501
8;Barcelona;13;Barcelonès;08019;Barcelona;3;61;1;;568;424;144;1;2;421;423
8;Barcelona;13;Barcelonès;08019;Barcelona;3;61;2;;569;431;138;1;10;420;430
8;Barcelona;13;Barcelonès;08019;Barcelona;3;61;3;;564;407;157;1;0;406;406
8;Barcelona;13;Barcelonès;08019;Barcelona;3;62;1;;754;533;221;1;6;526;532
8;Barcelona;13;Barcelonès;08019;Barcelona;3;62;2;;722;511;211;5;0;506;506
8;Barcelona;13;Barcelonès;08019;Barcelona;3;63;1;;603;459;144;5;1;453;454
8;Barcelona;13;Barcelonès;08019;Barcelona;3;63;2;;625;424;201;3;6;415;421
8;Barcelona;13;Barcelonès;08019;Barcelona;3;63;3;;634;456;178;1;6;449;455
8;Barcelona;13;Barcelonès;08019;Barcelona;3;64;1;;775;634;141;2;6;626;632
8;Barcelona;13;Barcelonès;08019;Barcelona;3;64;2;;819;617;202;2;8;607;615
8;Barcelona;13;Barcelonès;08019;Barcelona;3;64;3;;837;621;216;1;9;611;620
8;Barcelona;13;Barcelonès;08019;Barcelona;3;65;1;;649;467;182;13;2;452;454
8;Barcelona;13;Barcelonès;08019;Barcelona;3;65;2;;644;456;188;2;2;452;454
8;Barcelona;13;Barcelonès;08019;Barcelona;3;66;1;;588;427;161;10;5;412;417
8;Barcelona;13;Barcelonès;08019;Barcelona;3;66;2;;622;436;186;0;12;424;436
8;Barcelona;13;Barcelonès;08019;Barcelona;3;67;1;;708;546;162;3;4;539;543
8;Barcelona;13;Barcelonès;08019;Barcelona;3;67;2;;718;512;206;2;3;507;510
8;Barcelona;13;Barcelonès;08019;Barcelona;3;68;1;;597;476;121;0;1;475;476
8;Barcelona;13;Barcelonès;08019;Barcelona;3;68;2;;602;442;160;0;2;440;442
8;Barcelona;13;Barcelonès;08019;Barcelona;3;68;3;;599;441;158;2;3;436;439
8;Barcelona;13;Barcelonès;08019;Barcelona;3;69;1;;572;436;136;4;3;429;432
8;Barcelona;13;Barcelonès;08019;Barcelona;3;69;2;;578;410;168;3;2;405;407
8;Barcelona;13;Barcelonès;08019;Barcelona;3;7;1;;872;663;209;2;3;658;661
8;Barcelona;13;Barcelonès;08019;Barcelona;3;7;2;;808;625;183;3;0;622;622
8;Barcelona;13;Barcelonès;08019;Barcelona;3;7;3;;843;629;214;2;3;624;627
8;Barcelona;13;Barcelonès;08019;Barcelona;3;70;1;;143;112;31;0;1;111;112
8;Barcelona;13;Barcelonès;08019;Barcelona;3;71;1;;512;325;187;1;2;322;324
8;Barcelona;13;Barcelonès;08019;Barcelona;3;72;1;;93;64;29;0;0;64;64
8;Barcelona;13;Barcelonès;08019;Barcelona;3;73;1;;702;537;165;4;0;533;533
8;Barcelona;13;Barcelonès;08019;Barcelona;3;73;2;;690;542;148;0;2;540;542
8;Barcelona;13;Barcelonès;08019;Barcelona;3;73;3;;703;530;173;0;4;526;530
8;Barcelona;13;Barcelonès;08019;Barcelona;3;74;1;;820;609;211;3;2;604;606
8;Barcelona;13;Barcelonès;08019;Barcelona;3;74;2;;814;618;196;6;5;607;612
8;Barcelona;13;Barcelonès;08019;Barcelona;3;75;1;;40;35;5;0;0;35;35
8;Barcelona;13;Barcelonès;08019;Barcelona;3;76;1;;292;177;115;1;1;175;176
8;Barcelona;13;Barcelonès;08019;Barcelona;3;77;1;;538;368;170;1;6;361;367
8;Barcelona;13;Barcelonès;08019;Barcelona;3;77;2;;545;392;153;0;4;388;392
8;Barcelona;13;Barcelonès;08019;Barcelona;3;78;1;;419;260;159;2;1;257;258
8;Barcelona;13;Barcelonès;08019;Barcelona;3;79;1;;421;295;126;1;4;290;294
8;Barcelona;13;Barcelonès;08019;Barcelona;3;79;2;;423;295;128;0;2;293;295
8;Barcelona;13;Barcelonès;08019;Barcelona;3;8;1;;502;357;145;0;2;355;357
8;Barcelona;13;Barcelonès;08019;Barcelona;3;8;2;;488;376;112;1;1;374;375
8;Barcelona;13;Barcelonès;08019;Barcelona;3;9;1;;664;489;175;1;6;482;488
8;Barcelona;13;Barcelonès;08019;Barcelona;3;9;2;;662;468;194;2;5;461;466
8;Barcelona;13;Barcelonès;08019;Barcelona;3;9;3;;668;491;177;0;2;489;491
8;Barcelona;13;Barcelonès;08019;Barcelona;4;1;1;;762;481;281;3;2;476;478
8;Barcelona;13;Barcelonès;08019;Barcelona;4;1;2;;760;459;301;1;2;456;458
8;Barcelona;13;Barcelonès;08019;Barcelona;4;1;3;;776;518;258;0;0;518;518
8;Barcelona;13;Barcelonès;08019;Barcelona;4;10;1;;348;261;87;5;1;255;256
8;Barcelona;13;Barcelonès;08019;Barcelona;4;11;1;;848;533;315;0;3;530;533
8;Barcelona;13;Barcelonès;08019;Barcelona;4;12;1;;626;426;200;1;3;422;425
8;Barcelona;13;Barcelonès;08019;Barcelona;4;12;2;;605;411;194;2;4;405;409
8;Barcelona;13;Barcelonès;08019;Barcelona;4;12;3;;633;429;204;0;1;428;429
8;Barcelona;13;Barcelonès;08019;Barcelona;4;13;1;;657;511;146;1;8;502;510
8;Barcelona;13;Barcelonès;08019;Barcelona;4;13;2;;657;495;162;6;1;488;489
8;Barcelona;13;Barcelonès;08019;Barcelona;4;13;3;;660;498;162;1;5;492;497
8;Barcelona;13;Barcelonès;08019;Barcelona;4;14;1;;789;570;219;4;2;564;566
8;Barcelona;13;Barcelonès;08019;Barcelona;4;15;1;;251;190;61;1;2;187;189
8;Barcelona;13;Barcelonès;08019;Barcelona;4;16;1;;727;539;188;0;7;532;539
8;Barcelona;13;Barcelonès;08019;Barcelona;4;16;2;;737;512;225;2;8;502;510
8;Barcelona;13;Barcelonès;08019;Barcelona;4;17;1;;788;556;232;1;2;553;555
8;Barcelona;13;Barcelonès;08019;Barcelona;4;18;1;;629;481;148;5;0;476;476
8;Barcelona;13;Barcelonès;08019;Barcelona;4;18;2;;630;424;206;0;4;420;424
8;Barcelona;13;Barcelonès;08019;Barcelona;4;18;3;;628;452;176;1;2;449;451
8;Barcelona;13;Barcelonès;08019;Barcelona;4;19;1;;703;491;212;9;3;479;482
8;Barcelona;13;Barcelonès;08019;Barcelona;4;19;2;;687;490;197;0;10;480;490
8;Barcelona;13;Barcelonès;08019;Barcelona;4;2;1;;753;493;260;0;3;490;493
8;Barcelona;13;Barcelonès;08019;Barcelona;4;2;2;;720;433;287;6;1;426;427
8;Barcelona;13;Barcelonès;08019;Barcelona;4;2;3;;733;462;271;0;3;459;462
8;Barcelona;13;Barcelonès;08019;Barcelona;4;2;4;;765;468;297;1;4;463;467
8;Barcelona;13;Barcelonès;08019;Barcelona;4;20;1;;510;342;168;2;4;336;340
8;Barcelona;13;Barcelonès;08019;Barcelona;4;20;2;;507;350;157;10;3;337;340
8;Barcelona;13;Barcelonès;08019;Barcelona;4;21;1;;499;380;119;0;2;378;380
8;Barcelona;13;Barcelonès;08019;Barcelona;4;21;2;;510;366;144;1;2;363;365
8;Barcelona;13;Barcelonès;08019;Barcelona;4;22;1;;468;338;130;1;3;334;337
8;Barcelona;13;Barcelonès;08019;Barcelona;4;22;2;;471;359;112;2;3;354;357
8;Barcelona;13;Barcelonès;08019;Barcelona;4;23;1;;709;502;207;1;2;499;501
8;Barcelona;13;Barcelonès;08019;Barcelona;4;23;2;;685;507;178;0;2;505;507
8;Barcelona;13;Barcelonès;08019;Barcelona;4;24;1;;618;459;159;9;0;450;450
8;Barcelona;13;Barcelonès;08019;Barcelona;4;24;2;;618;431;187;1;1;429;430
8;Barcelona;13;Barcelonès;08019;Barcelona;4;24;3;;623;434;189;1;2;431;433
8;Barcelona;13;Barcelonès;08019;Barcelona;4;24;4;;630;455;175;0;3;452;455
8;Barcelona;13;Barcelonès;08019;Barcelona;4;25;1;;543;369;174;5;1;363;364
8;Barcelona;13;Barcelonès;08019;Barcelona;4;25;2;;519;360;159;0;0;360;360
8;Barcelona;13;Barcelonès;08019;Barcelona;4;26;1;;560;402;158;0;6;396;402
8;Barcelona;13;Barcelonès;08019;Barcelona;4;26;2;;574;415;159;0;3;412;415
8;Barcelona;13;Barcelonès;08019;Barcelona;4;27;1;;459;333;126;0;1;332;333
8;Barcelona;13;Barcelonès;08019;Barcelona;4;27;2;;455;320;135;0;1;319;320
8;Barcelona;13;Barcelonès;08019;Barcelona;4;28;1;;572;437;135;6;0;431;431
8;Barcelona;13;Barcelonès;08019;Barcelona;4;28;2;;589;444;145;0;2;442;444
8;Barcelona;13;Barcelonès;08019;Barcelona;4;29;1;;514;371;143;0;1;370;371
8;Barcelona;13;Barcelonès;08019;Barcelona;4;29;2;;495;355;140;2;1;352;353
8;Barcelona;13;Barcelonès;08019;Barcelona;4;3;1;;715;498;217;1;2;495;497
8;Barcelona;13;Barcelonès;08019;Barcelona;4;3;2;;702;487;215;4;8;475;483
8;Barcelona;13;Barcelonès;08019;Barcelona;4;30;1;;572;413;159;2;2;409;411
8;Barcelona;13;Barcelonès;08019;Barcelona;4;30;2;;562;409;153;1;1;407;408
8;Barcelona;13;Barcelonès;08019;Barcelona;4;31;1;;719;503;216;3;5;495;500
8;Barcelona;13;Barcelonès;08019;Barcelona;4;32;1;;422;293;129;2;0;291;291
8;Barcelona;13;Barcelonès;08019;Barcelona;4;32;2;;420;296;124;0;4;292;296
8;Barcelona;13;Barcelonès;08019;Barcelona;4;33;1;;433;330;103;0;3;327;330
8;Barcelona;13;Barcelonès;08019;Barcelona;4;33;2;;438;325;113;3;4;318;322
8;Barcelona;13;Barcelonès;08019;Barcelona;4;34;1;;547;402;145;2;5;395;400
8;Barcelona;13;Barcelonès;08019;Barcelona;4;34;2;;544;401;143;1;4;396;400
8;Barcelona;13;Barcelonès;08019;Barcelona;4;35;1;;408;305;103;7;1;297;298
8;Barcelona;13;Barcelonès;08019;Barcelona;4;35;2;;408;295;113;3;2;290;292
8;Barcelona;13;Barcelonès;08019;Barcelona;4;36;1;;652;481;171;0;4;477;481
8;Barcelona;13;Barcelonès;08019;Barcelona;4;36;2;;681;516;165;1;4;511;515
8;Barcelona;13;Barcelonès;08019;Barcelona;4;37;1;;458;342;116;0;4;338;342
8;Barcelona;13;Barcelonès;08019;Barcelona;4;37;2;;464;333;131;1;1;331;332
8;Barcelona;13;Barcelonès;08019;Barcelona;4;38;1;;476;357;119;4;3;350;353
8;Barcelona;13;Barcelonès;08019;Barcelona;4;38;2;;444;323;121;2;0;321;321
8;Barcelona;13;Barcelonès;08019;Barcelona;4;39;1;;706;506;200;2;2;502;504
8;Barcelona;13;Barcelonès;08019;Barcelona;4;4;1;;570;383;187;0;0;383;383
8;Barcelona;13;Barcelonès;08019;Barcelona;4;40;1;;464;366;98;1;0;365;365
8;Barcelona;13;Barcelonès;08019;Barcelona;4;40;2;;500;348;152;0;5;343;348
8;Barcelona;13;Barcelonès;08019;Barcelona;4;41;1;;274;210;64;0;2;208;210
8;Barcelona;13;Barcelonès;08019;Barcelona;4;42;1;;781;483;298;19;4;460;464
8;Barcelona;13;Barcelonès;08019;Barcelona;4;43;1;;694;517;177;14;2;501;503
8;Barcelona;13;Barcelonès;08019;Barcelona;4;44;1;;591;397;194;4;0;393;393
8;Barcelona;13;Barcelonès;08019;Barcelona;4;44;2;;598;411;187;7;1;403;404
8;Barcelona;13;Barcelonès;08019;Barcelona;4;45;1;;474;323;151;1;1;321;322
8;Barcelona;13;Barcelonès;08019;Barcelona;4;45;2;;485;314;171;0;1;313;314
8;Barcelona;13;Barcelonès;08019;Barcelona;4;46;1;;324;202;122;0;0;202;202
8;Barcelona;13;Barcelonès;08019;Barcelona;4;47;1;;567;342;225;0;1;341;342
8;Barcelona;13;Barcelonès;08019;Barcelona;4;48;1;;615;422;193;0;3;419;422
8;Barcelona;13;Barcelonès;08019;Barcelona;4;48;2;;611;427;184;7;2;418;420
8;Barcelona;13;Barcelonès;08019;Barcelona;4;49;1;;496;364;132;0;3;361;364
8;Barcelona;13;Barcelonès;08019;Barcelona;4;49;2;;492;359;133;4;0;355;355
8;Barcelona;13;Barcelonès;08019;Barcelona;4;5;1;;575;383;192;2;2;379;381
8;Barcelona;13;Barcelonès;08019;Barcelona;4;5;2;;576;366;210;0;2;364;366
8;Barcelona;13;Barcelonès;08019;Barcelona;4;5;3;;584;408;176;2;1;405;406
8;Barcelona;13;Barcelonès;08019;Barcelona;4;50;1;;411;263;148;3;1;259;260
8;Barcelona;13;Barcelonès;08019;Barcelona;4;50;2;;415;257;158;7;2;248;250
8;Barcelona;13;Barcelonès;08019;Barcelona;4;51;1;;633;353;280;5;2;346;348
8;Barcelona;13;Barcelonès;08019;Barcelona;4;52;1;;745;455;290;1;7;447;454
8;Barcelona;13;Barcelonès;08019;Barcelona;4;53;1;;458;297;161;2;1;294;295
8;Barcelona;13;Barcelonès;08019;Barcelona;4;53;2;;442;283;159;6;1;276;277
8;Barcelona;13;Barcelonès;08019;Barcelona;4;54;1;;409;245;164;6;1;238;239
8;Barcelona;13;Barcelonès;08019;Barcelona;4;54;2;;415;251;164;1;0;250;250
8;Barcelona;13;Barcelonès;08019;Barcelona;4;55;1;;400;255;145;1;3;251;254
8;Barcelona;13;Barcelonès;08019;Barcelona;4;55;2;;423;241;182;0;4;237;241
8;Barcelona;13;Barcelonès;08019;Barcelona;4;56;1;;419;261;158;1;3;257;260
8;Barcelona;13;Barcelonès;08019;Barcelona;4;56;2;;428;277;151;0;1;276;277
8;Barcelona;13;Barcelonès;08019;Barcelona;4;57;1;;737;443;294;0;4;439;443
8;Barcelona;13;Barcelonès;08019;Barcelona;4;58;1;;440;226;214;1;4;221;225
8;Barcelona;13;Barcelonès;08019;Barcelona;4;58;2;;451;220;231;1;0;219;219
8;Barcelona;13;Barcelonès;08019;Barcelona;4;59;1;;720;414;306;4;9;401;410
8;Barcelona;13;Barcelonès;08019;Barcelona;4;6;1;;597;422;175;0;3;419;422
8;Barcelona;13;Barcelonès;08019;Barcelona;4;6;2;;627;421;206;1;4;416;420
8;Barcelona;13;Barcelonès;08019;Barcelona;4;60;1;;766;406;360;4;6;396;402
8;Barcelona;13;Barcelonès;08019;Barcelona;4;61;1;;569;390;179;0;4;386;390
8;Barcelona;13;Barcelonès;08019;Barcelona;4;61;2;;590;388;202;1;3;384;387
8;Barcelona;13;Barcelonès;08019;Barcelona;4;62;1;;746;404;342;1;2;401;403
8;Barcelona;13;Barcelonès;08019;Barcelona;4;63;1;;669;378;291;28;1;349;350
8;Barcelona;13;Barcelonès;08019;Barcelona;4;64;1;;465;259;206;8;1;250;251
8;Barcelona;13;Barcelonès;08019;Barcelona;4;7;1;;616;454;162;1;2;451;453
8;Barcelona;13;Barcelonès;08019;Barcelona;4;7;2;;619;450;169;2;3;445;448
8;Barcelona;13;Barcelonès;08019;Barcelona;4;7;3;;607;452;155;1;6;445;451
8;Barcelona;13;Barcelonès;08019;Barcelona;4;7;4;;635;454;181;1;3;450;453
8;Barcelona;13;Barcelonès;08019;Barcelona;4;8;1;;823;567;256;4;3;560;563
8;Barcelona;13;Barcelonès;08019;Barcelona;4;9;1;;417;272;145;0;2;270;272
8;Barcelona;13;Barcelonès;08019;Barcelona;4;9;2;;421;293;128;2;3;288;291
8;Barcelona;13;Barcelonès;08019;Barcelona;5;1;1;;663;372;291;0;4;368;372
8;Barcelona;13;Barcelonès;08019;Barcelona;5;10;1;;590;312;278;1;3;308;311
8;Barcelona;13;Barcelonès;08019;Barcelona;5;11;1;;603;349;254;0;1;348;349
8;Barcelona;13;Barcelonès;08019;Barcelona;5;12;1;;783;415;368;0;5;410;415
8;Barcelona;13;Barcelonès;08019;Barcelona;5;13;1;;508;281;227;1;0;280;280
8;Barcelona;13;Barcelonès;08019;Barcelona;5;13;2;;507;280;227;1;1;278;279
8;Barcelona;13;Barcelonès;08019;Barcelona;5;14;1;;450;250;200;2;2;246;248
8;Barcelona;13;Barcelonès;08019;Barcelona;5;14;2;;422;230;192;0;0;230;230
8;Barcelona;13;Barcelonès;08019;Barcelona;5;15;1;;717;393;324;25;3;365;368
8;Barcelona;13;Barcelonès;08019;Barcelona;5;16;1;;331;173;158;0;0;173;173
8;Barcelona;13;Barcelonès;08019;Barcelona;5;17;1;;451;289;162;19;1;269;270
8;Barcelona;13;Barcelonès;08019;Barcelona;5;17;2;;444;274;170;3;2;269;271
8;Barcelona;13;Barcelonès;08019;Barcelona;5;18;1;;491;276;215;4;1;271;272
8;Barcelona;13;Barcelonès;08019;Barcelona;5;19;1;;548;330;218;3;0;327;327
8;Barcelona;13;Barcelonès;08019;Barcelona;5;2;1;;632;320;312;2;1;317;318
8;Barcelona;13;Barcelonès;08019;Barcelona;5;20;1;;531;313;218;0;2;311;313
8;Barcelona;13;Barcelonès;08019;Barcelona;5;20;2;;533;340;193;0;1;339;340
8;Barcelona;13;Barcelonès;08019;Barcelona;5;21;1;;321;177;144;0;4;173;177
8;Barcelona;13;Barcelonès;08019;Barcelona;5;22;1;;462;321;141;1;1;319;320
8;Barcelona;13;Barcelonès;08019;Barcelona;5;22;2;;480;326;154;6;0;320;320
8;Barcelona;13;Barcelonès;08019;Barcelona;5;23;1;;680;451;229;8;3;440;443
8;Barcelona;13;Barcelonès;08019;Barcelona;5;24;1;;403;224;179;8;3;213;216
8;Barcelona;13;Barcelonès;08019;Barcelona;5;24;2;;403;255;148;1;2;252;254
8;Barcelona;13;Barcelonès;08019;Barcelona;5;25;1;;770;435;335;0;3;432;435
8;Barcelona;13;Barcelonès;08019;Barcelona;5;26;1;;476;303;173;1;2;300;302
8;Barcelona;13;Barcelonès;08019;Barcelona;5;26;2;;472;296;176;0;2;294;296
8;Barcelona;13;Barcelonès;08019;Barcelona;5;27;1;;596;373;223;2;1;370;371
8;Barcelona;13;Barcelonès;08019;Barcelona;5;27;2;;611;397;214;6;2;389;391
8;Barcelona;13;Barcelonès;08019;Barcelona;5;28;1;;477;278;199;14;3;261;264
8;Barcelona;13;Barcelonès;08019;Barcelona;5;28;2;;492;291;201;1;1;289;290
8;Barcelona;13;Barcelonès;08019;Barcelona;5;29;1;;487;298;189;0;0;298;298
8;Barcelona;13;Barcelonès;08019;Barcelona;5;29;2;;501;308;193;0;2;306;308
8;Barcelona;13;Barcelonès;08019;Barcelona;5;3;1;;735;362;373;0;4;358;362
8;Barcelona;13;Barcelonès;08019;Barcelona;5;30;1;;494;274;220;0;2;272;274
8;Barcelona;13;Barcelonès;08019;Barcelona;5;30;2;;495;284;211;2;0;282;282
8;Barcelona;13;Barcelonès;08019;Barcelona;5;31;1;;464;275;189;0;3;272;275
8;Barcelona;13;Barcelonès;08019;Barcelona;5;31;2;;465;289;176;0;1;288;289
8;Barcelona;13;Barcelonès;08019;Barcelona;5;32;1;;722;398;324;4;4;390;394
8;Barcelona;13;Barcelonès;08019;Barcelona;5;33;1;;764;489;275;1;2;486;488
8;Barcelona;13;Barcelonès;08019;Barcelona;5;34;1;;584;339;245;16;1;322;323
8;Barcelona;13;Barcelonès;08019;Barcelona;5;35;1;;424;239;185;4;1;234;235
8;Barcelona;13;Barcelonès;08019;Barcelona;5;35;2;;423;220;203;1;0;219;219
8;Barcelona;13;Barcelonès;08019;Barcelona;5;36;1;;419;254;165;1;0;253;253
8;Barcelona;13;Barcelonès;08019;Barcelona;5;36;2;;423;254;169;2;0;252;252
8;Barcelona;13;Barcelonès;08019;Barcelona;5;37;1;;409;251;158;1;0;250;250
8;Barcelona;13;Barcelonès;08019;Barcelona;5;37;2;;412;257;155;1;1;255;256
8;Barcelona;13;Barcelonès;08019;Barcelona;5;38;1;;498;280;218;0;1;279;280
8;Barcelona;13;Barcelonès;08019;Barcelona;5;38;2;;510;282;228;0;2;280;282
8;Barcelona;13;Barcelonès;08019;Barcelona;5;39;1;;415;254;161;3;0;251;251
8;Barcelona;13;Barcelonès;08019;Barcelona;5;39;2;;422;257;165;0;0;257;257
8;Barcelona;13;Barcelonès;08019;Barcelona;5;4;1;;625;298;327;0;3;295;298
8;Barcelona;13;Barcelonès;08019;Barcelona;5;40;1;;432;232;200;12;2;218;220
8;Barcelona;13;Barcelonès;08019;Barcelona;5;40;2;;415;250;165;12;1;237;238
8;Barcelona;13;Barcelonès;08019;Barcelona;5;41;1;;724;437;287;0;3;434;437
8;Barcelona;13;Barcelonès;08019;Barcelona;5;42;1;;490;303;187;2;3;298;301
8;Barcelona;13;Barcelonès;08019;Barcelona;5;43;1;;682;376;306;3;3;370;373
8;Barcelona;13;Barcelonès;08019;Barcelona;5;44;1;;460;257;203;3;0;254;254
8;Barcelona;13;Barcelonès;08019;Barcelona;5;45;1;;591;381;210;23;0;358;358
8;Barcelona;13;Barcelonès;08019;Barcelona;5;46;1;;413;219;194;0;5;214;219
8;Barcelona;13;Barcelonès;08019;Barcelona;5;46;2;;404;221;183;1;1;219;220
8;Barcelona;13;Barcelonès;08019;Barcelona;5;47;1;;424;243;181;9;1;233;234
8;Barcelona;13;Barcelonès;08019;Barcelona;5;47;2;;405;219;186;10;0;209;209
8;Barcelona;13;Barcelonès;08019;Barcelona;5;48;1;;418;228;190;4;4;220;224
8;Barcelona;13;Barcelonès;08019;Barcelona;5;48;2;;425;230;195;1;0;229;229
8;Barcelona;13;Barcelonès;08019;Barcelona;5;49;1;;728;381;347;5;4;372;376
8;Barcelona;13;Barcelonès;08019;Barcelona;5;5;1;;132;37;95;0;1;36;37
8;Barcelona;13;Barcelonès;08019;Barcelona;5;50;1;;535;260;275;4;1;255;256
8;Barcelona;13;Barcelonès;08019;Barcelona;5;50;2;;532;258;274;13;3;242;245
8;Barcelona;13;Barcelonès;08019;Barcelona;5;51;1;;461;220;241;0;1;219;220
8;Barcelona;13;Barcelonès;08019;Barcelona;5;51;2;;431;224;207;2;0;222;222
8;Barcelona;13;Barcelonès;08019;Barcelona;5;52;1;;470;270;200;0;3;267;270
8;Barcelona;13;Barcelonès;08019;Barcelona;5;52;2;;483;298;185;0;0;298;298
8;Barcelona;13;Barcelonès;08019;Barcelona;5;53;1;;689;357;332;5;0;352;352
8;Barcelona;13;Barcelonès;08019;Barcelona;5;54;1;;318;201;117;2;1;198;199
8;Barcelona;13;Barcelonès;08019;Barcelona;5;6;1;;230;128;102;0;0;128;128
8;Barcelona;13;Barcelonès;08019;Barcelona;5;7;1;;416;218;198;0;0;218;218
8;Barcelona;13;Barcelonès;08019;Barcelona;5;8;1;;507;282;225;0;4;278;282
8;Barcelona;13;Barcelonès;08019;Barcelona;5;8;2;;517;295;222;12;1;282;283
8;Barcelona;13;Barcelonès;08019;Barcelona;5;9;1;;347;171;176;2;0;169;169
8;Barcelona;13;Barcelonès;08019;Barcelona;6;1;1;;497;345;152;4;0;341;341
8;Barcelona;13;Barcelonès;08019;Barcelona;6;1;2;;513;345;168;0;2;343;345
8;Barcelona;13;Barcelonès;08019;Barcelona;6;10;1;;723;519;204;0;7;512;519
8;Barcelona;13;Barcelonès;08019;Barcelona;6;10;2;;703;523;180;2;3;518;521
8;Barcelona;13;Barcelonès;08019;Barcelona;6;11;1;;632;431;201;0;3;428;431
8;Barcelona;13;Barcelonès;08019;Barcelona;6;11;2;;660;456;204;0;1;455;456
8;Barcelona;13;Barcelonès;08019;Barcelona;6;12;1;;724;512;212;2;2;508;510
8;Barcelona;13;Barcelonès;08019;Barcelona;6;13;1;;711;479;232;1;0;478;478
8;Barcelona;13;Barcelonès;08019;Barcelona;6;14;1;;624;432;192;1;4;427;431
8;Barcelona;13;Barcelonès;08019;Barcelona;6;14;2;;651;431;220;1;2;428;430
8;Barcelona;13;Barcelonès;08019;Barcelona;6;15;1;;476;346;130;0;0;346;346
8;Barcelona;13;Barcelonès;08019;Barcelona;6;15;2;;462;333;129;1;1;331;332
8;Barcelona;13;Barcelonès;08019;Barcelona;6;16;1;;787;538;249;1;2;535;537
8;Barcelona;13;Barcelonès;08019;Barcelona;6;17;1;;652;472;180;0;6;466;472
8;Barcelona;13;Barcelonès;08019;Barcelona;6;17;2;;629;456;173;0;3;453;456
8;Barcelona;13;Barcelonès;08019;Barcelona;6;18;1;;488;320;168;0;5;315;320
8;Barcelona;13;Barcelonès;08019;Barcelona;6;18;2;;512;338;174;1;2;335;337
8;Barcelona;13;Barcelonès;08019;Barcelona;6;19;1;;780;524;256;0;3;521;524
8;Barcelona;13;Barcelonès;08019;Barcelona;6;2;1;;632;414;218;0;3;411;414
8;Barcelona;13;Barcelonès;08019;Barcelona;6;2;2;;634;444;190;1;3;440;443
8;Barcelona;13;Barcelonès;08019;Barcelona;6;20;1;;413;280;133;2;1;277;278
8;Barcelona;13;Barcelonès;08019;Barcelona;6;21;1;;675;475;200;0;2;473;475
8;Barcelona;13;Barcelonès;08019;Barcelona;6;22;1;;792;539;253;2;10;527;537
8;Barcelona;13;Barcelonès;08019;Barcelona;6;23;1;;417;275;142;0;2;273;275
8;Barcelona;13;Barcelonès;08019;Barcelona;6;23;2;;423;299;124;0;0;299;299
8;Barcelona;13;Barcelonès;08019;Barcelona;6;24;1;;413;286;127;0;2;284;286
8;Barcelona;13;Barcelonès;08019;Barcelona;6;24;2;;411;269;142;0;1;268;269
8;Barcelona;13;Barcelonès;08019;Barcelona;6;25;1;;510;365;145;0;5;360;365
8;Barcelona;13;Barcelonès;08019;Barcelona;6;25;2;;509;357;152;2;2;353;355
8;Barcelona;13;Barcelonès;08019;Barcelona;6;26;1;;809;560;249;1;2;557;559
8;Barcelona;13;Barcelonès;08019;Barcelona;6;26;2;;808;589;219;0;1;588;589
8;Barcelona;13;Barcelonès;08019;Barcelona;6;27;1;;428;302;126;0;3;299;302
8;Barcelona;13;Barcelonès;08019;Barcelona;6;27;2;;435;307;128;0;1;306;307
8;Barcelona;13;Barcelonès;08019;Barcelona;6;28;1;;546;402;144;0;0;402;402
8;Barcelona;13;Barcelonès;08019;Barcelona;6;29;1;;459;342;117;1;0;341;341
8;Barcelona;13;Barcelonès;08019;Barcelona;6;29;2;;458;328;130;0;0;328;328
8;Barcelona;13;Barcelonès;08019;Barcelona;6;3;1;;579;379;200;6;2;371;373
8;Barcelona;13;Barcelonès;08019;Barcelona;6;3;2;;572;394;178;1;3;390;393
8;Barcelona;13;Barcelonès;08019;Barcelona;6;3;3;;565;395;170;2;2;391;393
8;Barcelona;13;Barcelonès;08019;Barcelona;6;30;1;;538;357;181;1;1;355;356
8;Barcelona;13;Barcelonès;08019;Barcelona;6;30;2;;536;343;193;0;2;341;343
8;Barcelona;13;Barcelonès;08019;Barcelona;6;31;1;;638;462;176;0;1;461;462
8;Barcelona;13;Barcelonès;08019;Barcelona;6;32;1;;579;433;146;0;0;433;433
8;Barcelona;13;Barcelonès;08019;Barcelona;6;32;2;;575;424;151;2;2;420;422
8;Barcelona;13;Barcelonès;08019;Barcelona;6;33;1;;654;464;190;1;3;460;463
8;Barcelona;13;Barcelonès;08019;Barcelona;6;34;1;;529;402;127;1;3;398;401
8;Barcelona;13;Barcelonès;08019;Barcelona;6;34;2;;535;370;165;0;1;369;370
8;Barcelona;13;Barcelonès;08019;Barcelona;6;35;1;;556;401;155;0;2;399;401
8;Barcelona;13;Barcelonès;08019;Barcelona;6;36;1;;594;422;172;2;1;419;420
8;Barcelona;13;Barcelonès;08019;Barcelona;6;36;2;;585;404;181;1;4;399;403
8;Barcelona;13;Barcelonès;08019;Barcelona;6;36;3;;594;435;159;1;1;433;434
8;Barcelona;13;Barcelonès;08019;Barcelona;6;37;1;;588;402;186;2;4;396;400
8;Barcelona;13;Barcelonès;08019;Barcelona;6;37;2;;568;376;192;1;2;373;375
8;Barcelona;13;Barcelonès;08019;Barcelona;6;38;1;;525;349;176;3;0;346;346
8;Barcelona;13;Barcelonès;08019;Barcelona;6;38;2;;547;361;186;15;2;344;346
8;Barcelona;13;Barcelonès;08019;Barcelona;6;39;1;;430;270;160;0;0;270;270
8;Barcelona;13;Barcelonès;08019;Barcelona;6;39;2;;410;269;141;0;0;269;269
8;Barcelona;13;Barcelonès;08019;Barcelona;6;4;1;;770;573;197;0;1;572;573
8;Barcelona;13;Barcelonès;08019;Barcelona;6;40;1;;471;318;153;2;2;314;316
8;Barcelona;13;Barcelonès;08019;Barcelona;6;40;2;;476;338;138;1;3;334;337
8;Barcelona;13;Barcelonès;08019;Barcelona;6;41;1;;471;321;150;1;2;318;320
8;Barcelona;13;Barcelonès;08019;Barcelona;6;41;2;;494;341;153;1;1;339;340
8;Barcelona;13;Barcelonès;08019;Barcelona;6;42;1;;506;351;155;2;0;349;349
8;Barcelona;13;Barcelonès;08019;Barcelona;6;42;2;;506;357;149;0;3;354;357
8;Barcelona;13;Barcelonès;08019;Barcelona;6;43;1;;567;393;174;3;1;389;390
8;Barcelona;13;Barcelonès;08019;Barcelona;6;43;2;;542;361;181;2;0;359;359
8;Barcelona;13;Barcelonès;08019;Barcelona;6;44;1;;423;294;129;0;3;291;294
8;Barcelona;13;Barcelonès;08019;Barcelona;6;44;2;;417;290;127;0;2;288;290
8;Barcelona;13;Barcelonès;08019;Barcelona;6;45;1;;650;448;202;1;2;445;447
8;Barcelona;13;Barcelonès;08019;Barcelona;6;45;2;;662;476;186;0;3;473;476
8;Barcelona;13;Barcelonès;08019;Barcelona;6;46;1;;667;498;169;0;3;495;498
8;Barcelona;13;Barcelonès;08019;Barcelona;6;46;2;;664;480;184;6;0;474;474
8;Barcelona;13;Barcelonès;08019;Barcelona;6;46;3;;666;484;182;2;2;480;482
8;Barcelona;13;Barcelonès;08019;Barcelona;6;47;1;;568;388;180;1;4;383;387
8;Barcelona;13;Barcelonès;08019;Barcelona;6;47;2;;570;370;200;2;2;366;368
8;Barcelona;13;Barcelonès;08019;Barcelona;6;47;3;;576;383;193;1;5;377;382
8;Barcelona;13;Barcelonès;08019;Barcelona;6;48;1;;476;298;178;0;2;296;298
8;Barcelona;13;Barcelonès;08019;Barcelona;6;48;2;;459;317;142;1;3;313;316
8;Barcelona;13;Barcelonès;08019;Barcelona;6;49;1;;679;444;235;1;3;440;443
8;Barcelona;13;Barcelonès;08019;Barcelona;6;49;2;;679;473;206;1;4;468;472
8;Barcelona;13;Barcelonès;08019;Barcelona;6;5;1;;678;449;229;4;4;441;445
8;Barcelona;13;Barcelonès;08019;Barcelona;6;50;1;;411;247;164;0;0;247;247
8;Barcelona;13;Barcelonès;08019;Barcelona;6;50;2;;424;282;142;0;0;282;282
8;Barcelona;13;Barcelonès;08019;Barcelona;6;51;1;;538;380;158;1;0;379;379
8;Barcelona;13;Barcelonès;08019;Barcelona;6;51;2;;536;425;111;0;0;425;425
8;Barcelona;13;Barcelonès;08019;Barcelona;6;52;1;;562;403;159;2;1;400;401
8;Barcelona;13;Barcelonès;08019;Barcelona;6;52;2;;574;399;175;0;2;397;399
8;Barcelona;13;Barcelonès;08019;Barcelona;6;52;3;;570;378;192;1;1;376;377
8;Barcelona;13;Barcelonès;08019;Barcelona;6;53;1;;568;381;187;0;9;372;381
8;Barcelona;13;Barcelonès;08019;Barcelona;6;53;2;;557;370;187;1;1;368;369
8;Barcelona;13;Barcelonès;08019;Barcelona;6;53;3;;563;364;199;0;6;358;364
8;Barcelona;13;Barcelonès;08019;Barcelona;6;54;1;;624;418;206;0;1;417;418
8;Barcelona;13;Barcelonès;08019;Barcelona;6;55;1;;616;422;194;2;1;419;420
8;Barcelona;13;Barcelonès;08019;Barcelona;6;55;2;;609;406;203;1;1;404;405
8;Barcelona;13;Barcelonès;08019;Barcelona;6;56;1;;644;421;223;5;6;410;416
8;Barcelona;13;Barcelonès;08019;Barcelona;6;56;2;;646;424;222;0;0;424;424
8;Barcelona;13;Barcelonès;08019;Barcelona;6;56;3;;632;413;219;0;5;408;413
8;Barcelona;13;Barcelonès;08019;Barcelona;6;57;1;;630;419;211;1;3;415;418
8;Barcelona;13;Barcelonès;08019;Barcelona;6;57;2;;625;425;200;1;2;422;424
8;Barcelona;13;Barcelonès;08019;Barcelona;6;57;3;;620;425;195;0;4;421;425
8;Barcelona;13;Barcelonès;08019;Barcelona;6;57;4;;621;433;188;0;6;427;433
8;Barcelona;13;Barcelonès;08019;Barcelona;6;58;1;;684;447;237;1;2;444;446
8;Barcelona;13;Barcelonès;08019;Barcelona;6;58;2;;684;450;234;4;4;442;446
8;Barcelona;13;Barcelonès;08019;Barcelona;6;59;1;;596;410;186;2;5;403;408
8;Barcelona;13;Barcelonès;08019;Barcelona;6;59;2;;601;418;183;1;2;415;417
8;Barcelona;13;Barcelonès;08019;Barcelona;6;6;1;;443;337;106;0;3;334;337
8;Barcelona;13;Barcelonès;08019;Barcelona;6;6;2;;519;365;154;0;2;363;365
8;Barcelona;13;Barcelonès;08019;Barcelona;6;60;1;;694;418;276;1;2;415;417
8;Barcelona;13;Barcelonès;08019;Barcelona;6;61;1;;728;512;216;8;1;503;504
8;Barcelona;13;Barcelonès;08019;Barcelona;6;61;2;;760;490;270;5;6;479;485
8;Barcelona;13;Barcelonès;08019;Barcelona;6;61;3;;744;499;245;5;7;487;494
8;Barcelona;13;Barcelonès;08019;Barcelona;6;7;1;;416;260;156;3;1;256;257
8;Barcelona;13;Barcelonès;08019;Barcelona;6;7;2;;420;255;165;0;1;254;255
8;Barcelona;13;Barcelonès;08019;Barcelona;6;8;1;;675;437;238;0;0;437;437
8;Barcelona;13;Barcelonès;08019;Barcelona;6;9;1;;547;368;179;4;1;363;364
8;Barcelona;13;Barcelonès;08019;Barcelona;6;9;2;;563;396;167;3;4;389;393
8;Barcelona;13;Barcelonès;08019;Barcelona;7;1;1;;795;519;276;1;3;515;518
8;Barcelona;13;Barcelonès;08019;Barcelona;7;10;1;;782;491;291;1;0;490;490
8;Barcelona;13;Barcelonès;08019;Barcelona;7;11;1;;768;503;265;0;2;501;503
8;Barcelona;13;Barcelonès;08019;Barcelona;7;12;1;;504;387;117;1;1;385;386
8;Barcelona;13;Barcelonès;08019;Barcelona;7;13;1;;435;299;136;0;0;299;299
8;Barcelona;13;Barcelonès;08019;Barcelona;7;13;2;;429;306;123;3;0;303;303
8;Barcelona;13;Barcelonès;08019;Barcelona;7;14;1;;463;294;169;0;3;291;294
8;Barcelona;13;Barcelonès;08019;Barcelona;7;14;2;;458;302;156;1;2;299;301
8;Barcelona;13;Barcelonès;08019;Barcelona;7;15;1;;412;279;133;0;2;277;279
8;Barcelona;13;Barcelonès;08019;Barcelona;7;15;2;;416;286;130;2;1;283;284
8;Barcelona;13;Barcelonès;08019;Barcelona;7;16;1;;711;464;247;17;3;444;447
8;Barcelona;13;Barcelonès;08019;Barcelona;7;17;1;;458;297;161;0;2;295;297
8;Barcelona;13;Barcelonès;08019;Barcelona;7;17;2;;470;312;158;0;1;311;312
8;Barcelona;13;Barcelonès;08019;Barcelona;7;18;1;;553;378;175;0;1;377;378
8;Barcelona;13;Barcelonès;08019;Barcelona;7;18;2;;533;377;156;1;0;376;376
8;Barcelona;13;Barcelonès;08019;Barcelona;7;19;1;;527;388;139;2;2;384;386
8;Barcelona;13;Barcelonès;08019;Barcelona;7;19;2;;529;357;172;1;1;355;356
8;Barcelona;13;Barcelonès;08019;Barcelona;7;2;1;;435;264;171;1;0;263;263
8;Barcelona;13;Barcelonès;08019;Barcelona;7;2;2;;419;268;151;0;2;266;268
8;Barcelona;13;Barcelonès;08019;Barcelona;7;20;1;;536;371;165;0;0;371;371
8;Barcelona;13;Barcelonès;08019;Barcelona;7;20;2;;531;358;173;0;0;358;358
8;Barcelona;13;Barcelonès;08019;Barcelona;7;21;1;;637;433;204;0;3;430;433
8;Barcelona;13;Barcelonès;08019;Barcelona;7;21;2;;642;426;216;1;3;422;425
8;Barcelona;13;Barcelonès;08019;Barcelona;7;21;3;;627;437;190;2;1;434;435
8;Barcelona;13;Barcelonès;08019;Barcelona;7;22;1;;604;373;231;0;1;372;373
8;Barcelona;13;Barcelonès;08019;Barcelona;7;22;2;;612;365;247;3;3;359;362
8;Barcelona;13;Barcelonès;08019;Barcelona;7;23;1;;665;446;219;3;3;440;443
8;Barcelona;13;Barcelonès;08019;Barcelona;7;23;2;;645;457;188;3;0;454;454
8;Barcelona;13;Barcelonès;08019;Barcelona;7;24;1;;481;322;159;2;0;320;320
8;Barcelona;13;Barcelonès;08019;Barcelona;7;24;2;;477;307;170;0;0;307;307
8;Barcelona;13;Barcelonès;08019;Barcelona;7;25;1;;416;256;160;1;4;251;255
8;Barcelona;13;Barcelonès;08019;Barcelona;7;25;2;;416;253;163;2;4;247;251
8;Barcelona;13;Barcelonès;08019;Barcelona;7;26;1;;545;351;194;0;0;351;351
8;Barcelona;13;Barcelonès;08019;Barcelona;7;26;2;;551;373;178;0;3;370;373
8;Barcelona;13;Barcelonès;08019;Barcelona;7;27;1;;602;405;197;1;6;398;404
8;Barcelona;13;Barcelonès;08019;Barcelona;7;27;2;;573;388;185;4;4;380;384
8;Barcelona;13;Barcelonès;08019;Barcelona;7;27;3;;604;407;197;2;2;403;405
8;Barcelona;13;Barcelonès;08019;Barcelona;7;28;1;;763;493;270;1;0;492;492
8;Barcelona;13;Barcelonès;08019;Barcelona;7;29;1;;697;440;257;0;2;438;440
8;Barcelona;13;Barcelonès;08019;Barcelona;7;29;2;;661;426;235;0;4;422;426
8;Barcelona;13;Barcelonès;08019;Barcelona;7;29;3;;737;426;311;0;5;421;426
8;Barcelona;13;Barcelonès;08019;Barcelona;7;3;1;;540;356;184;0;5;351;356
8;Barcelona;13;Barcelonès;08019;Barcelona;7;3;2;;539;372;167;4;1;367;368
8;Barcelona;13;Barcelonès;08019;Barcelona;7;30;1;;613;382;231;2;4;376;380
8;Barcelona;13;Barcelonès;08019;Barcelona;7;30;2;;618;399;219;0;0;399;399
8;Barcelona;13;Barcelonès;08019;Barcelona;7;31;1;;569;400;169;0;1;399;400
8;Barcelona;13;Barcelonès;08019;Barcelona;7;31;2;;569;390;179;0;4;386;390
8;Barcelona;13;Barcelonès;08019;Barcelona;7;32;1;;427;279;148;0;1;278;279
8;Barcelona;13;Barcelonès;08019;Barcelona;7;32;2;;430;271;159;0;2;269;271
8;Barcelona;13;Barcelonès;08019;Barcelona;7;33;1;;652;463;189;0;4;459;463
8;Barcelona;13;Barcelonès;08019;Barcelona;7;33;2;;620;480;140;6;0;474;474
8;Barcelona;13;Barcelonès;08019;Barcelona;7;34;1;;564;387;177;0;0;387;387
8;Barcelona;13;Barcelonès;08019;Barcelona;7;34;2;;551;377;174;3;0;374;374
8;Barcelona;13;Barcelonès;08019;Barcelona;7;35;1;;419;270;149;2;4;264;268
8;Barcelona;13;Barcelonès;08019;Barcelona;7;36;1;;612;398;214;0;3;395;398
8;Barcelona;13;Barcelonès;08019;Barcelona;7;36;2;;621;428;193;0;5;423;428
8;Barcelona;13;Barcelonès;08019;Barcelona;7;36;3;;613;425;188;1;3;421;424
8;Barcelona;13;Barcelonès;08019;Barcelona;7;37;1;;616;382;234;0;2;380;382
8;Barcelona;13;Barcelonès;08019;Barcelona;7;37;2;;622;389;233;0;3;386;389
8;Barcelona;13;Barcelonès;08019;Barcelona;7;38;1;;610;404;206;0;0;404;404
8;Barcelona;13;Barcelonès;08019;Barcelona;7;38;2;;603;398;205;0;1;397;398
8;Barcelona;13;Barcelonès;08019;Barcelona;7;39;1;;499;318;181;2;0;316;316
8;Barcelona;13;Barcelonès;08019;Barcelona;7;39;2;;469;314;155;0;0;314;314
8;Barcelona;13;Barcelonès;08019;Barcelona;7;4;1;;675;436;239;3;4;429;433
8;Barcelona;13;Barcelonès;08019;Barcelona;7;40;1;;640;423;217;1;6;416;422
8;Barcelona;13;Barcelonès;08019;Barcelona;7;40;2;;621;364;257;0;3;361;364
8;Barcelona;13;Barcelonès;08019;Barcelona;7;40;3;;615;383;232;0;0;383;383
8;Barcelona;13;Barcelonès;08019;Barcelona;7;40;4;;621;380;241;0;2;378;380
8;Barcelona;13;Barcelonès;08019;Barcelona;7;41;1;;772;481;291;0;3;478;481
8;Barcelona;13;Barcelonès;08019;Barcelona;7;41;2;;763;490;273;0;0;490;490
8;Barcelona;13;Barcelonès;08019;Barcelona;7;42;1;;470;285;185;3;1;281;282
8;Barcelona;13;Barcelonès;08019;Barcelona;7;42;2;;452;270;182;2;3;265;268
8;Barcelona;13;Barcelonès;08019;Barcelona;7;43;1;;644;371;273;0;3;368;371
8;Barcelona;13;Barcelonès;08019;Barcelona;7;43;2;;654;419;235;0;1;418;419
8;Barcelona;13;Barcelonès;08019;Barcelona;7;43;3;;656;400;256;2;0;398;398
8;Barcelona;13;Barcelonès;08019;Barcelona;7;43;4;;651;391;260;0;3;388;391
8;Barcelona;13;Barcelonès;08019;Barcelona;7;43;5;;658;405;253;0;5;400;405
8;Barcelona;13;Barcelonès;08019;Barcelona;7;44;1;;639;360;279;1;1;358;359
8;Barcelona;13;Barcelonès;08019;Barcelona;7;44;2;;632;378;254;0;2;376;378
8;Barcelona;13;Barcelonès;08019;Barcelona;7;45;1;;592;348;244;0;0;348;348
8;Barcelona;13;Barcelonès;08019;Barcelona;7;45;2;;595;375;220;1;1;373;374
8;Barcelona;13;Barcelonès;08019;Barcelona;7;46;1;;834;572;262;0;3;569;572
8;Barcelona;13;Barcelonès;08019;Barcelona;7;46;2;;806;547;259;0;6;541;547
8;Barcelona;13;Barcelonès;08019;Barcelona;7;46;3;;814;534;280;0;6;528;534
8;Barcelona;13;Barcelonès;08019;Barcelona;7;46;4;;812;544;268;0;3;541;544
8;Barcelona;13;Barcelonès;08019;Barcelona;7;47;1;;707;490;217;0;4;486;490
8;Barcelona;13;Barcelonès;08019;Barcelona;7;47;2;;690;464;226;0;7;457;464
8;Barcelona;13;Barcelonès;08019;Barcelona;7;48;1;;769;465;304;1;5;459;464
8;Barcelona;13;Barcelonès;08019;Barcelona;7;49;1;;814;518;296;5;3;510;513
8;Barcelona;13;Barcelonès;08019;Barcelona;7;5;1;;532;345;187;0;2;343;345
8;Barcelona;13;Barcelonès;08019;Barcelona;7;5;2;;540;333;207;1;2;330;332
8;Barcelona;13;Barcelonès;08019;Barcelona;7;50;1;;721;471;250;0;9;462;471
8;Barcelona;13;Barcelonès;08019;Barcelona;7;50;2;;717;473;244;0;2;471;473
8;Barcelona;13;Barcelonès;08019;Barcelona;7;50;3;;719;481;238;0;1;480;481
8;Barcelona;13;Barcelonès;08019;Barcelona;7;51;1;;706;500;206;0;3;497;500
8;Barcelona;13;Barcelonès;08019;Barcelona;7;51;2;;702;502;200;0;5;497;502
8;Barcelona;13;Barcelonès;08019;Barcelona;7;51;3;;720;499;221;2;2;495;497
8;Barcelona;13;Barcelonès;08019;Barcelona;7;51;4;;726;527;199;1;2;524;526
8;Barcelona;13;Barcelonès;08019;Barcelona;7;51;5;;714;523;191;0;2;521;523
8;Barcelona;13;Barcelonès;08019;Barcelona;7;52;1;;665;412;253;0;2;410;412
8;Barcelona;13;Barcelonès;08019;Barcelona;7;52;2;;692;421;271;1;3;417;420
8;Barcelona;13;Barcelonès;08019;Barcelona;7;52;3;;677;393;284;3;2;388;390
8;Barcelona;13;Barcelonès;08019;Barcelona;7;52;4;;684;404;280;2;0;402;402
8;Barcelona;13;Barcelonès;08019;Barcelona;7;52;5;;684;375;309;6;0;369;369
8;Barcelona;13;Barcelonès;08019;Barcelona;7;53;1;;544;306;238;0;2;304;306
8;Barcelona;13;Barcelonès;08019;Barcelona;7;53;2;;564;323;241;0;1;322;323
8;Barcelona;13;Barcelonès;08019;Barcelona;7;54;1;;695;505;190;0;3;502;505
8;Barcelona;13;Barcelonès;08019;Barcelona;7;55;1;;813;578;235;1;6;571;577
8;Barcelona;13;Barcelonès;08019;Barcelona;7;55;2;;771;579;192;14;0;565;565
8;Barcelona;13;Barcelonès;08019;Barcelona;7;56;1;;780;487;293;1;3;483;486
8;Barcelona;13;Barcelonès;08019;Barcelona;7;56;2;;762;478;284;0;1;477;478
8;Barcelona;13;Barcelonès;08019;Barcelona;7;56;3;;762;472;290;1;2;469;471
8;Barcelona;13;Barcelonès;08019;Barcelona;7;57;1;;541;329;212;0;1;328;329
8;Barcelona;13;Barcelonès;08019;Barcelona;7;57;2;;550;348;202;0;3;345;348
8;Barcelona;13;Barcelonès;08019;Barcelona;7;58;1;;795;563;232;3;5;555;560
8;Barcelona;13;Barcelonès;08019;Barcelona;7;59;1;;614;425;189;4;4;417;421
8;Barcelona;13;Barcelonès;08019;Barcelona;7;59;2;;617;455;162;0;1;454;455
8;Barcelona;13;Barcelonès;08019;Barcelona;7;6;1;;807;499;308;0;0;499;499
8;Barcelona;13;Barcelonès;08019;Barcelona;7;6;2;;785;515;270;0;4;511;515
8;Barcelona;13;Barcelonès;08019;Barcelona;7;6;3;;785;515;270;1;3;511;514
8;Barcelona;13;Barcelonès;08019;Barcelona;7;60;1;;603;418;185;4;0;414;414
8;Barcelona;13;Barcelonès;08019;Barcelona;7;60;2;;611;426;185;0;6;420;426
8;Barcelona;13;Barcelonès;08019;Barcelona;7;61;1;;634;408;226;9;1;398;399
8;Barcelona;13;Barcelonès;08019;Barcelona;7;61;2;;640;423;217;0;1;422;423
8;Barcelona;13;Barcelonès;08019;Barcelona;7;62;1;;483;290;193;0;0;290;290
8;Barcelona;13;Barcelonès;08019;Barcelona;7;62;2;;484;270;214;0;1;269;270
8;Barcelona;13;Barcelonès;08019;Barcelona;7;63;1;;440;258;182;0;3;255;258
8;Barcelona;13;Barcelonès;08019;Barcelona;7;63;2;;431;274;157;1;8;265;273
8;Barcelona;13;Barcelonès;08019;Barcelona;7;64;1;;614;382;232;0;2;380;382
8;Barcelona;13;Barcelonès;08019;Barcelona;7;65;1;;649;428;221;1;0;427;427
8;Barcelona;13;Barcelonès;08019;Barcelona;7;65;2;;656;446;210;0;3;443;446
8;Barcelona;13;Barcelonès;08019;Barcelona;7;66;1;;672;422;250;1;2;419;421
8;Barcelona;13;Barcelonès;08019;Barcelona;7;66;2;;671;401;270;0;0;401;401
8;Barcelona;13;Barcelonès;08019;Barcelona;7;66;3;;674;449;225;0;1;448;449
8;Barcelona;13;Barcelonès;08019;Barcelona;7;67;1;;626;389;237;0;0;389;389
8;Barcelona;13;Barcelonès;08019;Barcelona;7;67;2;;652;367;285;0;0;367;367
8;Barcelona;13;Barcelonès;08019;Barcelona;7;67;3;;631;347;284;0;0;347;347
8;Barcelona;13;Barcelonès;08019;Barcelona;7;68;1;;703;442;261;1;2;439;441
8;Barcelona;13;Barcelonès;08019;Barcelona;7;68;2;;710;440;270;0;1;439;440
8;Barcelona;13;Barcelonès;08019;Barcelona;7;68;3;;698;426;272;0;2;424;426
8;Barcelona;13;Barcelonès;08019;Barcelona;7;68;4;;706;442;264;1;1;440;441
8;Barcelona;13;Barcelonès;08019;Barcelona;7;69;1;;615;392;223;0;1;391;392
8;Barcelona;13;Barcelonès;08019;Barcelona;7;69;2;;633;395;238;1;1;393;394
8;Barcelona;13;Barcelonès;08019;Barcelona;7;69;3;;627;369;258;0;0;369;369
8;Barcelona;13;Barcelonès;08019;Barcelona;7;7;1;;742;462;280;2;3;457;460
8;Barcelona;13;Barcelonès;08019;Barcelona;7;70;1;;504;312;192;0;1;311;312
8;Barcelona;13;Barcelonès;08019;Barcelona;7;70;2;;505;323;182;0;1;322;323
8;Barcelona;13;Barcelonès;08019;Barcelona;7;71;1;;709;439;270;0;2;437;439
8;Barcelona;13;Barcelonès;08019;Barcelona;7;71;2;;742;426;316;0;1;425;426
8;Barcelona;13;Barcelonès;08019;Barcelona;7;71;3;;743;437;306;1;5;431;436
8;Barcelona;13;Barcelonès;08019;Barcelona;7;72;1;;726;475;251;0;3;472;475
8;Barcelona;13;Barcelonès;08019;Barcelona;7;72;2;;719;457;262;0;1;456;457
8;Barcelona;13;Barcelonès;08019;Barcelona;7;72;3;;717;441;276;0;0;441;441
8;Barcelona;13;Barcelonès;08019;Barcelona;7;73;1;;747;522;225;0;5;517;522
8;Barcelona;13;Barcelonès;08019;Barcelona;7;73;2;;757;465;292;2;1;462;463
8;Barcelona;13;Barcelonès;08019;Barcelona;7;73;3;;758;456;302;2;4;450;454
8;Barcelona;13;Barcelonès;08019;Barcelona;7;74;1;;587;387;200;5;1;381;382
8;Barcelona;13;Barcelonès;08019;Barcelona;7;74;2;;592;367;225;2;4;361;365
8;Barcelona;13;Barcelonès;08019;Barcelona;7;74;3;;600;372;228;2;4;366;370
8;Barcelona;13;Barcelonès;08019;Barcelona;7;75;1;;713;449;264;1;1;447;448
8;Barcelona;13;Barcelonès;08019;Barcelona;7;75;2;;718;474;244;1;1;472;473
8;Barcelona;13;Barcelonès;08019;Barcelona;7;76;1;;463;318;145;2;0;316;316
8;Barcelona;13;Barcelonès;08019;Barcelona;7;76;2;;458;305;153;0;1;304;305
8;Barcelona;13;Barcelonès;08019;Barcelona;7;77;1;;410;282;128;1;1;280;281
8;Barcelona;13;Barcelonès;08019;Barcelona;7;77;2;;409;301;108;0;0;301;301
8;Barcelona;13;Barcelonès;08019;Barcelona;7;78;1;;822;539;283;1;6;532;538
8;Barcelona;13;Barcelonès;08019;Barcelona;7;78;2;;801;520;281;0;3;517;520
8;Barcelona;13;Barcelonès;08019;Barcelona;7;78;3;;893;559;334;1;3;555;558
8;Barcelona;13;Barcelonès;08019;Barcelona;7;8;1;;423;265;158;4;1;260;261
8;Barcelona;13;Barcelonès;08019;Barcelona;7;8;2;;425;277;148;6;0;271;271
8;Barcelona;13;Barcelonès;08019;Barcelona;7;9;1;;719;435;284;3;6;426;432
8;Barcelona;13;Barcelonès;08019;Barcelona;8;1;1;;673;475;198;1;4;470;474
8;Barcelona;13;Barcelonès;08019;Barcelona;8;1;2;;662;456;206;0;2;454;456
8;Barcelona;13;Barcelonès;08019;Barcelona;8;10;1;;611;429;182;0;2;427;429
8;Barcelona;13;Barcelonès;08019;Barcelona;8;11;1;;600;397;203;0;4;393;397
8;Barcelona;13;Barcelonès;08019;Barcelona;8;12;1;;436;307;129;0;2;305;307
8;Barcelona;13;Barcelonès;08019;Barcelona;8;12;2;;433;296;137;0;4;292;296
8;Barcelona;13;Barcelonès;08019;Barcelona;8;13;1;;400;276;124;0;0;276;276
8;Barcelona;13;Barcelonès;08019;Barcelona;8;13;2;;418;265;153;16;3;246;249
8;Barcelona;13;Barcelonès;08019;Barcelona;8;14;1;;778;568;210;0;3;565;568
8;Barcelona;13;Barcelonès;08019;Barcelona;8;15;1;;549;387;162;1;2;384;386
8;Barcelona;13;Barcelonès;08019;Barcelona;8;15;2;;532;377;155;0;4;373;377
8;Barcelona;13;Barcelonès;08019;Barcelona;8;16;1;;655;441;214;0;4;437;441
8;Barcelona;13;Barcelonès;08019;Barcelona;8;16;2;;647;466;181;0;2;464;466
8;Barcelona;13;Barcelonès;08019;Barcelona;8;17;1;;622;426;196;1;3;422;425
8;Barcelona;13;Barcelonès;08019;Barcelona;8;17;2;;612;410;202;3;3;404;407
8;Barcelona;13;Barcelonès;08019;Barcelona;8;18;1;;456;321;135;0;3;318;321
8;Barcelona;13;Barcelonès;08019;Barcelona;8;18;2;;451;335;116;2;1;332;333
8;Barcelona;13;Barcelonès;08019;Barcelona;8;19;1;;569;408;161;0;1;407;408
8;Barcelona;13;Barcelonès;08019;Barcelona;8;19;2;;585;421;164;4;3;414;417
8;Barcelona;13;Barcelonès;08019;Barcelona;8;2;1;;755;511;244;12;1;498;499
8;Barcelona;13;Barcelonès;08019;Barcelona;8;20;1;;579;396;183;1;5;390;395
8;Barcelona;13;Barcelonès;08019;Barcelona;8;20;2;;585;444;141;1;6;437;443
8;Barcelona;13;Barcelonès;08019;Barcelona;8;21;1;;721;534;187;8;5;521;526
8;Barcelona;13;Barcelonès;08019;Barcelona;8;21;2;;723;518;205;1;1;516;517
8;Barcelona;13;Barcelonès;08019;Barcelona;8;21;3;;722;524;198;1;7;516;523
8;Barcelona;13;Barcelonès;08019;Barcelona;8;22;1;;687;480;207;0;8;472;480
8;Barcelona;13;Barcelonès;08019;Barcelona;8;22;2;;671;467;204;2;4;461;465
8;Barcelona;13;Barcelonès;08019;Barcelona;8;23;1;;544;414;130;1;1;412;413
8;Barcelona;13;Barcelonès;08019;Barcelona;8;23;2;;546;413;133;0;2;411;413
8;Barcelona;13;Barcelonès;08019;Barcelona;8;24;1;;644;455;189;4;3;448;451
8;Barcelona;13;Barcelonès;08019;Barcelona;8;24;2;;616;398;218;0;2;396;398
8;Barcelona;13;Barcelonès;08019;Barcelona;8;24;3;;635;452;183;5;0;447;447
8;Barcelona;13;Barcelonès;08019;Barcelona;8;25;1;;662;457;205;3;3;451;454
8;Barcelona;13;Barcelonès;08019;Barcelona;8;25;2;;671;443;228;0;5;438;443
8;Barcelona;13;Barcelonès;08019;Barcelona;8;25;3;;695;495;200;0;2;493;495
8;Barcelona;13;Barcelonès;08019;Barcelona;8;26;1;;537;385;152;0;2;383;385
8;Barcelona;13;Barcelonès;08019;Barcelona;8;26;2;;557;409;148;0;1;408;409
8;Barcelona;13;Barcelonès;08019;Barcelona;8;27;1;;747;555;192;0;9;546;555
8;Barcelona;13;Barcelonès;08019;Barcelona;8;27;2;;779;565;214;1;4;560;564
8;Barcelona;13;Barcelonès;08019;Barcelona;8;28;1;;640;466;174;0;1;465;466
8;Barcelona;13;Barcelonès;08019;Barcelona;8;28;2;;643;475;168;0;5;470;475
8;Barcelona;13;Barcelonès;08019;Barcelona;8;29;1;;719;472;247;1;2;469;471
8;Barcelona;13;Barcelonès;08019;Barcelona;8;29;2;;683;460;223;4;2;454;456
8;Barcelona;13;Barcelonès;08019;Barcelona;8;29;3;;713;464;249;1;7;456;463
8;Barcelona;13;Barcelonès;08019;Barcelona;8;3;1;;548;387;161;1;4;382;386
8;Barcelona;13;Barcelonès;08019;Barcelona;8;30;1;;566;417;149;3;3;411;414
8;Barcelona;13;Barcelonès;08019;Barcelona;8;30;2;;562;406;156;0;1;405;406
8;Barcelona;13;Barcelonès;08019;Barcelona;8;31;1;;720;499;221;2;3;494;497
8;Barcelona;13;Barcelonès;08019;Barcelona;8;32;1;;808;548;260;1;5;542;547
8;Barcelona;13;Barcelonès;08019;Barcelona;8;32;2;;817;555;262;3;5;547;552
8;Barcelona;13;Barcelonès;08019;Barcelona;8;32;3;;819;553;266;4;4;545;549
8;Barcelona;13;Barcelonès;08019;Barcelona;8;33;1;;635;418;217;12;2;404;406
8;Barcelona;13;Barcelonès;08019;Barcelona;8;34;1;;444;268;176;0;2;266;268
8;Barcelona;13;Barcelonès;08019;Barcelona;8;34;2;;452;260;192;1;3;256;259
8;Barcelona;13;Barcelonès;08019;Barcelona;8;35;1;;501;365;136;2;2;361;363
8;Barcelona;13;Barcelonès;08019;Barcelona;8;35;2;;526;393;133;9;4;380;384
8;Barcelona;13;Barcelonès;08019;Barcelona;8;36;1;;824;565;259;0;2;563;565
8;Barcelona;13;Barcelonès;08019;Barcelona;8;36;2;;823;563;260;7;6;550;556
8;Barcelona;13;Barcelonès;08019;Barcelona;8;36;3;;792;542;250;0;0;542;542
8;Barcelona;13;Barcelonès;08019;Barcelona;8;36;4;;817;569;248;2;2;565;567
8;Barcelona;13;Barcelonès;08019;Barcelona;8;37;1;;761;505;256;1;7;497;504
8;Barcelona;13;Barcelonès;08019;Barcelona;8;37;2;;750;509;241;0;7;502;509
8;Barcelona;13;Barcelonès;08019;Barcelona;8;38;1;;689;510;179;1;3;506;509
8;Barcelona;13;Barcelonès;08019;Barcelona;8;38;2;;683;490;193;0;4;486;490
8;Barcelona;13;Barcelonès;08019;Barcelona;8;38;3;;684;509;175;1;3;505;508
8;Barcelona;13;Barcelonès;08019;Barcelona;8;39;1;;822;622;200;0;8;614;622
8;Barcelona;13;Barcelonès;08019;Barcelona;8;39;2;;797;571;226;7;0;564;564
8;Barcelona;13;Barcelonès;08019;Barcelona;8;39;3;;804;577;227;0;5;572;577
8;Barcelona;13;Barcelonès;08019;Barcelona;8;4;1;;504;362;142;0;0;362;362
8;Barcelona;13;Barcelonès;08019;Barcelona;8;4;2;;504;359;145;0;1;358;359
8;Barcelona;13;Barcelonès;08019;Barcelona;8;40;1;;422;274;148;0;1;273;274
8;Barcelona;13;Barcelonès;08019;Barcelona;8;40;2;;425;287;138;0;6;281;287
8;Barcelona;13;Barcelonès;08019;Barcelona;8;41;1;;645;445;200;1;2;442;444
8;Barcelona;13;Barcelonès;08019;Barcelona;8;41;2;;660;404;256;0;4;400;404
8;Barcelona;13;Barcelonès;08019;Barcelona;8;41;3;;634;439;195;0;0;439;439
8;Barcelona;13;Barcelonès;08019;Barcelona;8;42;1;;572;425;147;1;2;422;424
8;Barcelona;13;Barcelonès;08019;Barcelona;8;42;2;;555;387;168;3;2;382;384
8;Barcelona;13;Barcelonès;08019;Barcelona;8;42;3;;568;417;151;1;0;416;416
8;Barcelona;13;Barcelonès;08019;Barcelona;8;43;1;;519;374;145;1;0;373;373
8;Barcelona;13;Barcelonès;08019;Barcelona;8;43;2;;504;345;159;1;0;344;344
8;Barcelona;13;Barcelonès;08019;Barcelona;8;44;1;;540;396;144;2;0;394;394
8;Barcelona;13;Barcelonès;08019;Barcelona;8;44;2;;569;402;167;4;4;394;398
8;Barcelona;13;Barcelonès;08019;Barcelona;8;45;1;;669;484;185;2;4;478;482
8;Barcelona;13;Barcelonès;08019;Barcelona;8;45;2;;680;439;241;2;4;433;437
8;Barcelona;13;Barcelonès;08019;Barcelona;8;46;1;;538;387;151;0;3;384;387
8;Barcelona;13;Barcelonès;08019;Barcelona;8;46;2;;538;404;134;5;0;399;399
8;Barcelona;13;Barcelonès;08019;Barcelona;8;47;1;;538;318;220;1;2;315;317
8;Barcelona;13;Barcelonès;08019;Barcelona;8;47;2;;519;355;164;1;0;354;354
8;Barcelona;13;Barcelonès;08019;Barcelona;8;48;1;;687;455;232;0;1;454;455
8;Barcelona;13;Barcelonès;08019;Barcelona;8;48;2;;686;466;220;0;7;459;466
8;Barcelona;13;Barcelonès;08019;Barcelona;8;49;1;;565;403;162;1;0;402;402
8;Barcelona;13;Barcelonès;08019;Barcelona;8;49;2;;539;375;164;0;1;374;375
8;Barcelona;13;Barcelonès;08019;Barcelona;8;5;1;;572;396;176;2;3;391;394
8;Barcelona;13;Barcelonès;08019;Barcelona;8;5;2;;556;408;148;0;0;408;408
8;Barcelona;13;Barcelonès;08019;Barcelona;8;50;1;;601;366;235;9;2;355;357
8;Barcelona;13;Barcelonès;08019;Barcelona;8;50;2;;592;412;180;14;1;397;398
8;Barcelona;13;Barcelonès;08019;Barcelona;8;51;1;;638;204;434;4;5;195;200
8;Barcelona;13;Barcelonès;08019;Barcelona;8;51;2;;624;179;445;0;4;175;179
8;Barcelona;13;Barcelonès;08019;Barcelona;8;51;3;;615;206;409;0;3;203;206
8;Barcelona;13;Barcelonès;08019;Barcelona;8;52;1;;817;563;254;0;1;562;563
8;Barcelona;13;Barcelonès;08019;Barcelona;8;52;2;;808;542;266;0;3;539;542
8;Barcelona;13;Barcelonès;08019;Barcelona;8;52;3;;821;551;270;1;1;549;550
8;Barcelona;13;Barcelonès;08019;Barcelona;8;53;1;;542;378;164;2;3;373;376
8;Barcelona;13;Barcelonès;08019;Barcelona;8;53;2;;537;397;140;0;6;391;397
8;Barcelona;13;Barcelonès;08019;Barcelona;8;54;1;;599;427;172;1;6;420;426
8;Barcelona;13;Barcelonès;08019;Barcelona;8;54;2;;595;443;152;1;2;440;442
8;Barcelona;13;Barcelonès;08019;Barcelona;8;54;3;;600;433;167;1;4;428;432
8;Barcelona;13;Barcelonès;08019;Barcelona;8;55;1;;837;607;230;0;4;603;607
8;Barcelona;13;Barcelonès;08019;Barcelona;8;55;2;;792;614;178;5;4;605;609
8;Barcelona;13;Barcelonès;08019;Barcelona;8;56;1;;673;490;183;1;6;483;489
8;Barcelona;13;Barcelonès;08019;Barcelona;8;56;2;;680;487;193;4;7;476;483
8;Barcelona;13;Barcelonès;08019;Barcelona;8;57;1;;814;570;244;2;0;568;568
8;Barcelona;13;Barcelonès;08019;Barcelona;8;58;1;;437;311;126;4;0;307;307
8;Barcelona;13;Barcelonès;08019;Barcelona;8;58;2;;450;317;133;1;0;316;316
8;Barcelona;13;Barcelonès;08019;Barcelona;8;59;1;;535;358;177;0;5;353;358
8;Barcelona;13;Barcelonès;08019;Barcelona;8;59;2;;532;370;162;0;6;364;370
8;Barcelona;13;Barcelonès;08019;Barcelona;8;6;1;;562;382;180;0;6;376;382
8;Barcelona;13;Barcelonès;08019;Barcelona;8;6;2;;560;350;210;0;4;346;350
8;Barcelona;13;Barcelonès;08019;Barcelona;8;60;1;;473;314;159;1;0;313;313
8;Barcelona;13;Barcelonès;08019;Barcelona;8;60;2;;463;332;131;2;1;329;330
8;Barcelona;13;Barcelonès;08019;Barcelona;8;61;1;;703;464;239;0;4;460;464
8;Barcelona;13;Barcelonès;08019;Barcelona;8;61;2;;710;496;214;3;2;491;493
8;Barcelona;13;Barcelonès;08019;Barcelona;8;62;1;;633;452;181;1;0;451;451
8;Barcelona;13;Barcelonès;08019;Barcelona;8;62;2;;650;458;192;0;9;449;458
8;Barcelona;13;Barcelonès;08019;Barcelona;8;62;3;;647;453;194;0;2;451;453
8;Barcelona;13;Barcelonès;08019;Barcelona;8;63;1;;449;316;133;1;5;310;315
8;Barcelona;13;Barcelonès;08019;Barcelona;8;63;2;;442;317;125;2;3;312;315
8;Barcelona;13;Barcelonès;08019;Barcelona;8;64;1;;711;548;163;1;5;542;547
8;Barcelona;13;Barcelonès;08019;Barcelona;8;65;1;;673;425;248;0;4;421;425
8;Barcelona;13;Barcelonès;08019;Barcelona;8;65;2;;656;404;252;0;2;402;404
8;Barcelona;13;Barcelonès;08019;Barcelona;8;66;1;;527;408;119;0;2;406;408
8;Barcelona;13;Barcelonès;08019;Barcelona;8;66;2;;522;398;124;1;1;396;397
8;Barcelona;13;Barcelonès;08019;Barcelona;8;67;1;;851;647;204;2;6;639;645
8;Barcelona;13;Barcelonès;08019;Barcelona;8;68;1;;673;448;225;2;1;445;446
8;Barcelona;13;Barcelonès;08019;Barcelona;8;68;2;;667;452;215;1;1;450;451
8;Barcelona;13;Barcelonès;08019;Barcelona;8;69;1;;600;429;171;0;2;427;429
8;Barcelona;13;Barcelonès;08019;Barcelona;8;69;2;;619;468;151;1;6;461;467
8;Barcelona;13;Barcelonès;08019;Barcelona;8;7;1;;521;346;175;0;1;345;346
8;Barcelona;13;Barcelonès;08019;Barcelona;8;7;2;;524;358;166;0;1;357;358
8;Barcelona;13;Barcelonès;08019;Barcelona;8;70;1;;742;514;228;3;3;508;511
8;Barcelona;13;Barcelonès;08019;Barcelona;8;70;2;;731;532;199;7;2;523;525
8;Barcelona;13;Barcelonès;08019;Barcelona;8;71;1;;526;336;190;1;2;333;335
8;Barcelona;13;Barcelonès;08019;Barcelona;8;72;1;;803;554;249;0;3;551;554
8;Barcelona;13;Barcelonès;08019;Barcelona;8;72;2;;814;528;286;0;3;525;528
8;Barcelona;13;Barcelonès;08019;Barcelona;8;73;1;;695;518;177;2;4;512;516
8;Barcelona;13;Barcelonès;08019;Barcelona;8;74;1;;528;338;190;3;5;330;335
8;Barcelona;13;Barcelonès;08019;Barcelona;8;75;1;;597;423;174;1;3;419;422
8;Barcelona;13;Barcelonès;08019;Barcelona;8;75;2;;598;450;148;1;1;448;449
8;Barcelona;13;Barcelonès;08019;Barcelona;8;76;1;;484;301;183;1;0;300;300
8;Barcelona;13;Barcelonès;08019;Barcelona;8;76;2;;499;305;194;2;2;301;303
8;Barcelona;13;Barcelonès;08019;Barcelona;8;77;1;;562;401;161;0;1;400;401
8;Barcelona;13;Barcelonès;08019;Barcelona;8;77;2;;556;414;142;0;3;411;414
8;Barcelona;13;Barcelonès;08019;Barcelona;8;78;1;;556;350;206;1;2;347;349
8;Barcelona;13;Barcelonès;08019;Barcelona;8;78;2;;564;366;198;3;2;361;363
8;Barcelona;13;Barcelonès;08019;Barcelona;8;79;1;;462;288;174;1;3;284;287
8;Barcelona;13;Barcelonès;08019;Barcelona;8;79;2;;465;285;180;0;1;284;285
8;Barcelona;13;Barcelonès;08019;Barcelona;8;8;1;;526;397;129;6;0;391;391
8;Barcelona;13;Barcelonès;08019;Barcelona;8;8;2;;534;381;153;1;3;377;380
8;Barcelona;13;Barcelonès;08019;Barcelona;8;80;1;;787;485;302;3;1;481;482
8;Barcelona;13;Barcelonès;08019;Barcelona;8;81;1;;457;300;157;1;2;297;299
8;Barcelona;13;Barcelonès;08019;Barcelona;8;81;2;;464;296;168;1;1;294;295
8;Barcelona;13;Barcelonès;08019;Barcelona;8;82;1;;784;544;240;3;1;540;541
8;Barcelona;13;Barcelonès;08019;Barcelona;8;83;1;;604;366;238;1;2;363;365
8;Barcelona;13;Barcelonès;08019;Barcelona;8;83;2;;611;331;280;1;2;328;330
8;Barcelona;13;Barcelonès;08019;Barcelona;8;83;3;;598;386;212;0;7;379;386
8;Barcelona;13;Barcelonès;08019;Barcelona;8;84;1;;782;513;269;3;1;509;510
8;Barcelona;13;Barcelonès;08019;Barcelona;8;84;2;;791;487;304;2;2;483;485
8;Barcelona;13;Barcelonès;08019;Barcelona;8;85;1;;660;396;264;3;1;392;393
8;Barcelona;13;Barcelonès;08019;Barcelona;8;85;2;;640;395;245;2;3;390;393
8;Barcelona;13;Barcelonès;08019;Barcelona;8;85;3;;634;374;260;3;6;365;371
8;Barcelona;13;Barcelonès;08019;Barcelona;8;85;4;;647;407;240;0;3;404;407
8;Barcelona;13;Barcelonès;08019;Barcelona;8;86;1;;666;432;234;2;0;430;430
8;Barcelona;13;Barcelonès;08019;Barcelona;8;86;2;;641;438;203;3;0;435;435
8;Barcelona;13;Barcelonès;08019;Barcelona;8;86;3;;675;429;246;1;2;426;428
8;Barcelona;13;Barcelonès;08019;Barcelona;8;86;4;;669;437;232;1;4;432;436
8;Barcelona;13;Barcelonès;08019;Barcelona;8;87;1;;568;400;168;2;4;394;398
8;Barcelona;13;Barcelonès;08019;Barcelona;8;87;2;;582;393;189;1;4;388;392
8;Barcelona;13;Barcelonès;08019;Barcelona;8;87;3;;552;380;172;5;2;373;375
8;Barcelona;13;Barcelonès;08019;Barcelona;8;88;1;;579;420;159;0;7;413;420
8;Barcelona;13;Barcelonès;08019;Barcelona;8;88;2;;577;399;178;0;3;396;399
8;Barcelona;13;Barcelonès;08019;Barcelona;8;88;3;;563;432;131;0;2;430;432
8;Barcelona;13;Barcelonès;08019;Barcelona;8;89;1;;727;532;195;1;4;527;531
8;Barcelona;13;Barcelonès;08019;Barcelona;8;89;2;;715;502;213;3;6;493;499
8;Barcelona;13;Barcelonès;08019;Barcelona;8;89;3;;715;504;211;2;4;498;502
8;Barcelona;13;Barcelonès;08019;Barcelona;8;9;1;;701;458;243;4;1;453;454
8;Barcelona;13;Barcelonès;08019;Barcelona;8;90;1;;760;405;355;0;0;405;405
8;Barcelona;13;Barcelonès;08019;Barcelona;8;90;2;;782;413;369;1;3;409;412
8;Barcelona;13;Barcelonès;08019;Barcelona;8;90;3;;780;397;383;0;2;395;397
8;Barcelona;13;Barcelonès;08019;Barcelona;8;91;1;;747;437;310;0;3;434;437
8;Barcelona;13;Barcelonès;08019;Barcelona;8;91;2;;736;450;286;1;2;447;449
8;Barcelona;13;Barcelonès;08019;Barcelona;8;92;1;;557;339;218;1;2;336;338
8;Barcelona;13;Barcelonès;08019;Barcelona;8;92;2;;563;342;221;1;5;336;341
8;Barcelona;13;Barcelonès;08019;Barcelona;8;92;3;;545;303;242;0;3;300;303
8;Barcelona;13;Barcelonès;08019;Barcelona;8;93;1;;577;365;212;2;5;358;363
8;Barcelona;13;Barcelonès;08019;Barcelona;8;93;2;;564;352;212;1;0;351;351
8;Barcelona;13;Barcelonès;08019;Barcelona;8;93;3;;559;363;196;5;1;357;358
8;Barcelona;13;Barcelonès;08019;Barcelona;8;94;1;;588;377;211;2;5;370;375
8;Barcelona;13;Barcelonès;08019;Barcelona;8;94;2;;578;350;228;1;4;345;349
8;Barcelona;13;Barcelonès;08019;Barcelona;8;95;1;;454;278;176;1;2;275;277
8;Barcelona;13;Barcelonès;08019;Barcelona;8;95;2;;454;278;176;0;0;278;278
8;Barcelona;13;Barcelonès;08019;Barcelona;8;96;1;;695;421;274;1;3;417;420
8;Barcelona;13;Barcelonès;08019;Barcelona;9;1;1;;802;532;270;2;2;528;530
8;Barcelona;13;Barcelonès;08019;Barcelona;9;1;2;;815;556;259;0;1;555;556
8;Barcelona;13;Barcelonès;08019;Barcelona;9;10;1;;493;323;170;0;2;321;323
8;Barcelona;13;Barcelonès;08019;Barcelona;9;10;2;;504;354;150;0;3;351;354
8;Barcelona;13;Barcelonès;08019;Barcelona;9;100;1;;514;325;189;1;5;319;324
8;Barcelona;13;Barcelonès;08019;Barcelona;9;100;2;;516;325;191;2;3;320;323
8;Barcelona;13;Barcelonès;08019;Barcelona;9;101;1;;665;370;295;2;3;365;368
8;Barcelona;13;Barcelonès;08019;Barcelona;9;101;2;;670;390;280;0;7;383;390
8;Barcelona;13;Barcelonès;08019;Barcelona;9;102;1;;503;275;228;1;0;274;274
8;Barcelona;13;Barcelonès;08019;Barcelona;9;102;2;;496;306;190;1;4;301;305
8;Barcelona;13;Barcelonès;08019;Barcelona;9;103;1;;559;308;251;0;2;306;308
8;Barcelona;13;Barcelonès;08019;Barcelona;9;103;2;;577;323;254;0;3;320;323
8;Barcelona;13;Barcelonès;08019;Barcelona;9;103;3;;519;322;197;2;6;314;320
8;Barcelona;13;Barcelonès;08019;Barcelona;9;104;1;;508;271;237;0;0;271;271
8;Barcelona;13;Barcelonès;08019;Barcelona;9;104;2;;519;324;195;1;0;323;323
8;Barcelona;13;Barcelonès;08019;Barcelona;9;105;1;;438;243;195;2;2;239;241
8;Barcelona;13;Barcelonès;08019;Barcelona;9;105;2;;457;241;216;2;3;236;239
8;Barcelona;13;Barcelonès;08019;Barcelona;9;106;1;;622;351;271;0;2;349;351
8;Barcelona;13;Barcelonès;08019;Barcelona;9;107;1;;819;471;348;3;1;467;468
8;Barcelona;13;Barcelonès;08019;Barcelona;9;108;1;;678;399;279;0;0;399;399
8;Barcelona;13;Barcelonès;08019;Barcelona;9;108;2;;678;402;276;0;0;402;402
8;Barcelona;13;Barcelonès;08019;Barcelona;9;108;3;;678;408;270;1;4;403;407
8;Barcelona;13;Barcelonès;08019;Barcelona;9;109;1;;674;392;282;0;4;388;392
8;Barcelona;13;Barcelonès;08019;Barcelona;9;109;2;;679;397;282;1;4;392;396
8;Barcelona;13;Barcelonès;08019;Barcelona;9;11;1;;631;430;201;1;2;427;429
8;Barcelona;13;Barcelonès;08019;Barcelona;9;11;2;;639;419;220;0;3;416;419
8;Barcelona;13;Barcelonès;08019;Barcelona;9;110;1;;774;430;344;0;1;429;430
8;Barcelona;13;Barcelonès;08019;Barcelona;9;111;1;;559;352;207;5;0;347;347
8;Barcelona;13;Barcelonès;08019;Barcelona;9;111;2;;588;363;225;13;0;350;350
8;Barcelona;13;Barcelonès;08019;Barcelona;9;111;3;;576;359;217;0;1;358;359
8;Barcelona;13;Barcelonès;08019;Barcelona;9;112;1;;624;385;239;1;1;383;384
8;Barcelona;13;Barcelonès;08019;Barcelona;9;112;2;;613;382;231;0;2;380;382
8;Barcelona;13;Barcelonès;08019;Barcelona;9;112;3;;629;382;247;4;1;377;378
8;Barcelona;13;Barcelonès;08019;Barcelona;9;113;1;;631;396;235;0;2;394;396
8;Barcelona;13;Barcelonès;08019;Barcelona;9;113;2;;629;382;247;4;1;377;378
8;Barcelona;13;Barcelonès;08019;Barcelona;9;114;1;;727;506;221;2;3;501;504
8;Barcelona;13;Barcelonès;08019;Barcelona;9;114;2;;721;477;244;1;0;476;476
8;Barcelona;13;Barcelonès;08019;Barcelona;9;115;1;;754;483;271;1;3;479;482
8;Barcelona;13;Barcelonès;08019;Barcelona;9;115;2;;757;459;298;4;0;455;455
8;Barcelona;13;Barcelonès;08019;Barcelona;9;115;3;;749;448;301;1;1;446;447
8;Barcelona;13;Barcelonès;08019;Barcelona;9;116;1;;678;435;243;6;5;424;429
8;Barcelona;13;Barcelonès;08019;Barcelona;9;116;2;;678;409;269;0;0;409;409
8;Barcelona;13;Barcelonès;08019;Barcelona;9;117;1;;422;238;184;0;3;235;238
8;Barcelona;13;Barcelonès;08019;Barcelona;9;117;2;;417;245;172;0;2;243;245
8;Barcelona;13;Barcelonès;08019;Barcelona;9;118;1;;683;418;265;2;1;415;416
8;Barcelona;13;Barcelonès;08019;Barcelona;9;118;2;;705;420;285;3;0;417;417
8;Barcelona;13;Barcelonès;08019;Barcelona;9;118;3;;702;413;289;1;5;407;412
8;Barcelona;13;Barcelonès;08019;Barcelona;9;118;4;;694;443;251;1;2;440;442
8;Barcelona;13;Barcelonès;08019;Barcelona;9;119;1;;757;415;342;0;3;412;415
8;Barcelona;13;Barcelonès;08019;Barcelona;9;119;2;;761;415;346;4;4;407;411
8;Barcelona;13;Barcelonès;08019;Barcelona;9;119;3;;762;445;317;0;2;443;445
8;Barcelona;13;Barcelonès;08019;Barcelona;9;119;4;;796;432;364;0;2;430;432
8;Barcelona;13;Barcelonès;08019;Barcelona;9;12;1;;675;437;238;1;1;435;436
8;Barcelona;13;Barcelonès;08019;Barcelona;9;12;2;;647;405;242;0;0;405;405
8;Barcelona;13;Barcelonès;08019;Barcelona;9;12;3;;677;407;270;2;2;403;405
8;Barcelona;13;Barcelonès;08019;Barcelona;9;120;1;;738;406;332;0;1;405;406
8;Barcelona;13;Barcelonès;08019;Barcelona;9;120;2;;717;399;318;0;2;397;399
8;Barcelona;13;Barcelonès;08019;Barcelona;9;120;3;;709;410;299;6;4;400;404
8;Barcelona;13;Barcelonès;08019;Barcelona;9;120;4;;745;393;352;0;3;390;393
8;Barcelona;13;Barcelonès;08019;Barcelona;9;120;5;;724;396;328;0;0;396;396
8;Barcelona;13;Barcelonès;08019;Barcelona;9;121;1;;642;396;246;0;3;393;396
8;Barcelona;13;Barcelonès;08019;Barcelona;9;121;2;;661;388;273;1;2;385;387
8;Barcelona;13;Barcelonès;08019;Barcelona;9;121;3;;666;391;275;8;1;382;383
8;Barcelona;13;Barcelonès;08019;Barcelona;9;121;4;;650;403;247;2;4;397;401
8;Barcelona;13;Barcelonès;08019;Barcelona;9;122;1;;614;356;258;8;3;345;348
8;Barcelona;13;Barcelonès;08019;Barcelona;9;122;2;;615;346;269;8;2;336;338
8;Barcelona;13;Barcelonès;08019;Barcelona;9;122;3;;613;338;275;17;0;321;321
8;Barcelona;13;Barcelonès;08019;Barcelona;9;123;1;;664;382;282;1;2;379;381
8;Barcelona;13;Barcelonès;08019;Barcelona;9;123;2;;681;431;250;1;6;424;430
8;Barcelona;13;Barcelonès;08019;Barcelona;9;123;3;;672;421;251;1;5;415;420
8;Barcelona;13;Barcelonès;08019;Barcelona;9;124;1;;710;383;327;3;2;378;380
8;Barcelona;13;Barcelonès;08019;Barcelona;9;124;2;;704;422;282;0;1;421;422
8;Barcelona;13;Barcelonès;08019;Barcelona;9;125;1;;676;405;271;2;0;403;403
8;Barcelona;13;Barcelonès;08019;Barcelona;9;125;2;;686;401;285;0;1;400;401
8;Barcelona;13;Barcelonès;08019;Barcelona;9;126;1;;571;341;230;0;3;338;341
8;Barcelona;13;Barcelonès;08019;Barcelona;9;126;2;;580;322;258;1;3;318;321
8;Barcelona;13;Barcelonès;08019;Barcelona;9;126;3;;561;321;240;0;4;317;321
8;Barcelona;13;Barcelonès;08019;Barcelona;9;127;1;;511;312;199;0;2;310;312
8;Barcelona;13;Barcelonès;08019;Barcelona;9;127;2;;522;309;213;2;4;303;307
8;Barcelona;13;Barcelonès;08019;Barcelona;9;128;1;;786;448;338;3;3;442;445
8;Barcelona;13;Barcelonès;08019;Barcelona;9;128;2;;761;430;331;3;0;427;427
8;Barcelona;13;Barcelonès;08019;Barcelona;9;128;3;;738;463;275;0;7;456;463
8;Barcelona;13;Barcelonès;08019;Barcelona;9;129;1;;670;369;301;4;0;365;365
8;Barcelona;13;Barcelonès;08019;Barcelona;9;129;2;;664;380;284;1;1;378;379
8;Barcelona;13;Barcelonès;08019;Barcelona;9;129;3;;637;388;249;1;1;386;387
8;Barcelona;13;Barcelonès;08019;Barcelona;9;13;1;;556;388;168;0;2;386;388
8;Barcelona;13;Barcelonès;08019;Barcelona;9;13;2;;599;412;187;2;2;408;410
8;Barcelona;13;Barcelonès;08019;Barcelona;9;130;1;;469;266;203;0;0;266;266
8;Barcelona;13;Barcelonès;08019;Barcelona;9;130;2;;465;284;181;1;4;279;283
8;Barcelona;13;Barcelonès;08019;Barcelona;9;131;1;;591;384;207;1;3;380;383
8;Barcelona;13;Barcelonès;08019;Barcelona;9;131;2;;597;363;234;0;0;363;363
8;Barcelona;13;Barcelonès;08019;Barcelona;9;132;1;;661;324;337;2;1;321;322
8;Barcelona;13;Barcelonès;08019;Barcelona;9;132;2;;538;331;207;4;0;327;327
8;Barcelona;13;Barcelonès;08019;Barcelona;9;133;1;;609;356;253;2;0;354;354
8;Barcelona;13;Barcelonès;08019;Barcelona;9;133;2;;617;374;243;6;2;366;368
8;Barcelona;13;Barcelonès;08019;Barcelona;9;133;3;;619;370;249;2;3;365;368
8;Barcelona;13;Barcelonès;08019;Barcelona;9;134;1;;542;319;223;2;3;314;317
8;Barcelona;13;Barcelonès;08019;Barcelona;9;134;2;;548;289;259;0;0;289;289
8;Barcelona;13;Barcelonès;08019;Barcelona;9;135;1;;601;341;260;0;2;339;341
8;Barcelona;13;Barcelonès;08019;Barcelona;9;136;1;;431;224;207;0;4;220;224
8;Barcelona;13;Barcelonès;08019;Barcelona;9;136;2;;436;261;175;0;1;260;261
8;Barcelona;13;Barcelonès;08019;Barcelona;9;137;1;;589;362;227;1;1;360;361
8;Barcelona;13;Barcelonès;08019;Barcelona;9;137;2;;589;322;267;1;0;321;321
8;Barcelona;13;Barcelonès;08019;Barcelona;9;138;1;;708;428;280;2;1;425;426
8;Barcelona;13;Barcelonès;08019;Barcelona;9;138;2;;703;407;296;0;12;395;407
8;Barcelona;13;Barcelonès;08019;Barcelona;9;138;3;;702;408;294;4;3;401;404
8;Barcelona;13;Barcelonès;08019;Barcelona;9;139;1;;760;459;301;4;0;455;455
8;Barcelona;13;Barcelonès;08019;Barcelona;9;139;2;;778;466;312;3;0;463;463
8;Barcelona;13;Barcelonès;08019;Barcelona;9;14;1;;669;434;235;0;5;429;434
8;Barcelona;13;Barcelonès;08019;Barcelona;9;14;2;;661;401;260;1;5;395;400
8;Barcelona;13;Barcelonès;08019;Barcelona;9;14;3;;662;427;235;3;3;421;424
8;Barcelona;13;Barcelonès;08019;Barcelona;9;140;1;;548;339;209;1;0;338;338
8;Barcelona;13;Barcelonès;08019;Barcelona;9;140;2;;554;350;204;3;2;345;347
8;Barcelona;13;Barcelonès;08019;Barcelona;9;140;3;;552;364;188;2;3;359;362
8;Barcelona;13;Barcelonès;08019;Barcelona;9;141;1;;763;476;287;1;2;473;475
8;Barcelona;13;Barcelonès;08019;Barcelona;9;141;2;;770;500;270;0;3;497;500
8;Barcelona;13;Barcelonès;08019;Barcelona;9;142;1;;434;319;115;1;0;318;318
8;Barcelona;13;Barcelonès;08019;Barcelona;9;142;2;;460;317;143;7;0;310;310
8;Barcelona;13;Barcelonès;08019;Barcelona;9;143;1;;606;361;245;0;4;357;361
8;Barcelona;13;Barcelonès;08019;Barcelona;9;143;2;;632;365;267;4;0;361;361
8;Barcelona;13;Barcelonès;08019;Barcelona;9;144;1;;523;315;208;1;1;313;314
8;Barcelona;13;Barcelonès;08019;Barcelona;9;144;2;;536;329;207;2;1;326;327
8;Barcelona;13;Barcelonès;08019;Barcelona;9;145;1;;453;281;172;0;1;280;281
8;Barcelona;13;Barcelonès;08019;Barcelona;9;145;2;;477;271;206;10;0;261;261
8;Barcelona;13;Barcelonès;08019;Barcelona;9;146;1;;609;341;268;18;3;320;323
8;Barcelona;13;Barcelonès;08019;Barcelona;9;146;2;;604;370;234;14;2;354;356
8;Barcelona;13;Barcelonès;08019;Barcelona;9;147;1;;717;410;307;4;1;405;406
8;Barcelona;13;Barcelonès;08019;Barcelona;9;147;2;;701;391;310;1;6;384;390
8;Barcelona;13;Barcelonès;08019;Barcelona;9;148;1;;763;462;301;1;1;460;461
8;Barcelona;13;Barcelonès;08019;Barcelona;9;148;2;;760;460;300;1;0;459;459
8;Barcelona;13;Barcelonès;08019;Barcelona;9;148;3;;769;464;305;1;0;463;463
8;Barcelona;13;Barcelonès;08019;Barcelona;9;148;4;;773;469;304;1;3;465;468
8;Barcelona;13;Barcelonès;08019;Barcelona;9;148;5;;816;454;362;0;1;453;454
8;Barcelona;13;Barcelonès;08019;Barcelona;9;148;6;;781;480;301;0;3;477;480
8;Barcelona;13;Barcelonès;08019;Barcelona;9;148;7;;812;459;353;1;0;458;458
8;Barcelona;13;Barcelonès;08019;Barcelona;9;148;8;;781;463;318;1;3;459;462
8;Barcelona;13;Barcelonès;08019;Barcelona;9;149;1;;257;111;146;0;0;111;111
8;Barcelona;13;Barcelonès;08019;Barcelona;9;15;1;;673;453;220;5;2;446;448
8;Barcelona;13;Barcelonès;08019;Barcelona;9;15;2;;676;422;254;1;1;420;421
8;Barcelona;13;Barcelonès;08019;Barcelona;9;15;3;;669;431;238;0;3;428;431
8;Barcelona;13;Barcelonès;08019;Barcelona;9;15;4;;667;445;222;0;2;443;445
8;Barcelona;13;Barcelonès;08019;Barcelona;9;15;5;;674;454;220;3;1;450;451
8;Barcelona;13;Barcelonès;08019;Barcelona;9;150;1;;657;379;278;2;0;377;377
8;Barcelona;13;Barcelonès;08019;Barcelona;9;150;2;;649;396;253;2;0;394;394
8;Barcelona;13;Barcelonès;08019;Barcelona;9;150;3;;644;360;284;2;1;357;358
8;Barcelona;13;Barcelonès;08019;Barcelona;9;151;1;;557;339;218;2;0;337;337
8;Barcelona;13;Barcelonès;08019;Barcelona;9;151;2;;572;330;242;0;2;328;330
8;Barcelona;13;Barcelonès;08019;Barcelona;9;152;1;;426;245;181;0;1;244;245
8;Barcelona;13;Barcelonès;08019;Barcelona;9;152;2;;435;251;184;0;3;248;251
8;Barcelona;13;Barcelonès;08019;Barcelona;9;153;1;;675;369;306;0;4;365;369
8;Barcelona;13;Barcelonès;08019;Barcelona;9;153;2;;687;397;290;9;3;385;388
8;Barcelona;13;Barcelonès;08019;Barcelona;9;153;3;;691;411;280;0;4;407;411
8;Barcelona;13;Barcelonès;08019;Barcelona;9;154;1;;598;352;246;1;4;347;351
8;Barcelona;13;Barcelonès;08019;Barcelona;9;154;2;;585;343;242;0;3;340;343
8;Barcelona;13;Barcelonès;08019;Barcelona;9;154;3;;588;340;248;9;1;330;331
8;Barcelona;13;Barcelonès;08019;Barcelona;9;155;1;;481;250;231;0;1;249;250
8;Barcelona;13;Barcelonès;08019;Barcelona;9;155;2;;469;233;236;0;1;232;233
8;Barcelona;13;Barcelonès;08019;Barcelona;9;156;1;;646;387;259;0;1;386;387
8;Barcelona;13;Barcelonès;08019;Barcelona;9;156;2;;649;388;261;0;3;385;388
8;Barcelona;13;Barcelonès;08019;Barcelona;9;157;1;;777;490;287;0;5;485;490
8;Barcelona;13;Barcelonès;08019;Barcelona;9;157;2;;798;473;325;2;1;470;471
8;Barcelona;13;Barcelonès;08019;Barcelona;9;158;1;;815;417;398;0;1;416;417
8;Barcelona;13;Barcelonès;08019;Barcelona;9;159;1;;563;309;254;4;1;304;305
8;Barcelona;13;Barcelonès;08019;Barcelona;9;159;2;;565;329;236;0;5;324;329
8;Barcelona;13;Barcelonès;08019;Barcelona;9;16;1;;508;311;197;1;2;308;310
8;Barcelona;13;Barcelonès;08019;Barcelona;9;16;2;;525;299;226;1;3;295;298
8;Barcelona;13;Barcelonès;08019;Barcelona;9;160;1;;494;246;248;0;1;245;246
8;Barcelona;13;Barcelonès;08019;Barcelona;9;160;2;;486;254;232;1;0;253;253
8;Barcelona;13;Barcelonès;08019;Barcelona;9;161;1;;481;256;225;0;0;256;256
8;Barcelona;13;Barcelonès;08019;Barcelona;9;162;1;;698;382;316;2;2;378;380
8;Barcelona;13;Barcelonès;08019;Barcelona;9;163;1;;464;255;209;0;0;255;255
8;Barcelona;13;Barcelonès;08019;Barcelona;9;163;2;;467;279;188;0;0;279;279
8;Barcelona;13;Barcelonès;08019;Barcelona;9;164;1;;712;363;349;3;1;359;360
8;Barcelona;13;Barcelonès;08019;Barcelona;9;165;1;;488;267;221;2;0;265;265
8;Barcelona;13;Barcelonès;08019;Barcelona;9;165;2;;471;243;228;0;0;243;243
8;Barcelona;13;Barcelonès;08019;Barcelona;9;166;1;;455;254;201;3;1;250;251
8;Barcelona;13;Barcelonès;08019;Barcelona;9;166;2;;481;279;202;0;2;277;279
8;Barcelona;13;Barcelonès;08019;Barcelona;9;167;1;;591;327;264;1;5;321;326
8;Barcelona;13;Barcelonès;08019;Barcelona;9;168;1;;440;247;193;0;0;247;247
8;Barcelona;13;Barcelonès;08019;Barcelona;9;169;1;;521;289;232;1;0;288;288
8;Barcelona;13;Barcelonès;08019;Barcelona;9;169;2;;545;309;236;1;0;308;308
8;Barcelona;13;Barcelonès;08019;Barcelona;9;17;1;;555;381;174;4;2;375;377
8;Barcelona;13;Barcelonès;08019;Barcelona;9;17;2;;573;349;224;2;2;345;347
8;Barcelona;13;Barcelonès;08019;Barcelona;9;17;3;;566;379;187;1;0;378;378
8;Barcelona;13;Barcelonès;08019;Barcelona;9;170;1;;223;109;114;3;0;106;106
8;Barcelona;13;Barcelonès;08019;Barcelona;9;171;1;;631;332;299;11;1;320;321
8;Barcelona;13;Barcelonès;08019;Barcelona;9;171;2;;629;353;276;11;2;340;342
8;Barcelona;13;Barcelonès;08019;Barcelona;9;172;1;;681;415;266;3;1;411;412
8;Barcelona;13;Barcelonès;08019;Barcelona;9;172;2;;671;404;267;1;1;402;403
8;Barcelona;13;Barcelonès;08019;Barcelona;9;172;3;;656;383;273;5;2;376;378
8;Barcelona;13;Barcelonès;08019;Barcelona;9;172;4;;651;402;249;1;5;396;401
8;Barcelona;13;Barcelonès;08019;Barcelona;9;172;5;;671;409;262;1;2;406;408
8;Barcelona;13;Barcelonès;08019;Barcelona;9;173;1;;657;407;250;0;2;405;407
8;Barcelona;13;Barcelonès;08019;Barcelona;9;173;2;;660;419;241;3;4;412;416
8;Barcelona;13;Barcelonès;08019;Barcelona;9;173;3;;667;402;265;0;3;399;402
8;Barcelona;13;Barcelonès;08019;Barcelona;9;173;4;;654;437;217;0;1;436;437
8;Barcelona;13;Barcelonès;08019;Barcelona;9;173;5;;659;420;239;4;2;414;416
8;Barcelona;13;Barcelonès;08019;Barcelona;9;174;1;;557;414;143;2;2;410;412
8;Barcelona;13;Barcelonès;08019;Barcelona;9;174;2;;553;387;166;1;1;385;386
8;Barcelona;13;Barcelonès;08019;Barcelona;9;175;1;;611;369;242;1;1;367;368
8;Barcelona;13;Barcelonès;08019;Barcelona;9;175;2;;644;404;240;1;1;402;403
8;Barcelona;13;Barcelonès;08019;Barcelona;9;175;3;;610;398;212;0;2;396;398
8;Barcelona;13;Barcelonès;08019;Barcelona;9;175;4;;623;378;245;0;2;376;378
8;Barcelona;13;Barcelonès;08019;Barcelona;9;176;1;;699;385;314;0;5;380;385
8;Barcelona;13;Barcelonès;08019;Barcelona;9;176;2;;693;409;284;3;0;406;406
8;Barcelona;13;Barcelonès;08019;Barcelona;9;177;1;;715;428;287;0;3;425;428
8;Barcelona;13;Barcelonès;08019;Barcelona;9;177;2;;719;390;329;1;13;376;389
8;Barcelona;13;Barcelonès;08019;Barcelona;9;177;3;;721;409;312;0;1;408;409
8;Barcelona;13;Barcelonès;08019;Barcelona;9;178;1;;719;443;276;0;9;434;443
8;Barcelona;13;Barcelonès;08019;Barcelona;9;179;1;;690;375;315;1;0;374;374
8;Barcelona;13;Barcelonès;08019;Barcelona;9;179;2;;712;401;311;3;0;398;398
8;Barcelona;13;Barcelonès;08019;Barcelona;9;18;1;;709;470;239;2;2;466;468
8;Barcelona;13;Barcelonès;08019;Barcelona;9;18;2;;727;465;262;3;1;461;462
8;Barcelona;13;Barcelonès;08019;Barcelona;9;18;3;;730;438;292;0;3;435;438
8;Barcelona;13;Barcelonès;08019;Barcelona;9;18;4;;734;452;282;0;2;450;452
8;Barcelona;13;Barcelonès;08019;Barcelona;9;180;1;;649;362;287;2;1;359;360
8;Barcelona;13;Barcelonès;08019;Barcelona;9;180;2;;639;375;264;12;0;363;363
8;Barcelona;13;Barcelonès;08019;Barcelona;9;180;3;;642;390;252;3;0;387;387
8;Barcelona;13;Barcelonès;08019;Barcelona;9;181;1;;417;193;224;1;0;192;192
8;Barcelona;13;Barcelonès;08019;Barcelona;9;181;2;;447;228;219;2;0;226;226
8;Barcelona;13;Barcelonès;08019;Barcelona;9;182;1;;636;376;260;1;1;374;375
8;Barcelona;13;Barcelonès;08019;Barcelona;9;182;2;;661;367;294;2;1;364;365
8;Barcelona;13;Barcelonès;08019;Barcelona;9;182;3;;653;357;296;18;0;339;339
8;Barcelona;13;Barcelonès;08019;Barcelona;9;183;1;;474;289;185;0;23;266;289
8;Barcelona;13;Barcelonès;08019;Barcelona;9;183;2;;485;300;185;1;5;294;299
8;Barcelona;13;Barcelonès;08019;Barcelona;9;184;1;;623;391;232;2;0;389;389
8;Barcelona;13;Barcelonès;08019;Barcelona;9;184;2;;623;387;236;1;0;386;386
8;Barcelona;13;Barcelonès;08019;Barcelona;9;185;1;;562;318;244;2;2;314;316
8;Barcelona;13;Barcelonès;08019;Barcelona;9;185;2;;524;325;199;4;2;319;321
8;Barcelona;13;Barcelonès;08019;Barcelona;9;186;1;;850;473;377;0;0;473;473
8;Barcelona;13;Barcelonès;08019;Barcelona;9;186;2;;815;485;330;17;2;466;468
8;Barcelona;13;Barcelonès;08019;Barcelona;9;187;1;;515;266;249;0;0;266;266
8;Barcelona;13;Barcelonès;08019;Barcelona;9;187;2;;518;257;261;0;1;256;257
8;Barcelona;13;Barcelonès;08019;Barcelona;9;188;1;;835;471;364;6;1;464;465
8;Barcelona;13;Barcelonès;08019;Barcelona;9;189;1;;753;428;325;1;0;427;427
8;Barcelona;13;Barcelonès;08019;Barcelona;9;19;1;;721;479;242;0;6;473;479
8;Barcelona;13;Barcelonès;08019;Barcelona;9;19;2;;750;481;269;6;0;475;475
8;Barcelona;13;Barcelonès;08019;Barcelona;9;190;1;;698;381;317;0;0;381;381
8;Barcelona;13;Barcelonès;08019;Barcelona;9;190;2;;683;401;282;2;1;398;399
8;Barcelona;13;Barcelonès;08019;Barcelona;9;191;1;;535;323;212;1;3;319;322
8;Barcelona;13;Barcelonès;08019;Barcelona;9;191;2;;536;313;223;2;0;311;311
8;Barcelona;13;Barcelonès;08019;Barcelona;9;192;1;;461;257;204;0;1;256;257
8;Barcelona;13;Barcelonès;08019;Barcelona;9;192;2;;481;262;219;0;1;261;262
8;Barcelona;13;Barcelonès;08019;Barcelona;9;193;1;;802;416;386;1;0;415;415
8;Barcelona;13;Barcelonès;08019;Barcelona;9;193;2;;831;433;398;1;4;428;432
8;Barcelona;13;Barcelonès;08019;Barcelona;9;194;1;;454;263;191;3;3;257;260
8;Barcelona;13;Barcelonès;08019;Barcelona;9;194;2;;463;270;193;10;0;260;260
8;Barcelona;13;Barcelonès;08019;Barcelona;9;195;1;;665;358;307;0;3;355;358
8;Barcelona;13;Barcelonès;08019;Barcelona;9;195;2;;652;379;273;2;4;373;377
8;Barcelona;13;Barcelonès;08019;Barcelona;9;196;1;;689;388;301;0;1;387;388
8;Barcelona;13;Barcelonès;08019;Barcelona;9;196;2;;694;453;241;2;2;449;451
8;Barcelona;13;Barcelonès;08019;Barcelona;9;197;1;;437;295;142;0;0;295;295
8;Barcelona;13;Barcelonès;08019;Barcelona;9;198;1;;618;330;288;1;2;327;329
8;Barcelona;13;Barcelonès;08019;Barcelona;9;198;2;;620;374;246;1;1;372;373
8;Barcelona;13;Barcelonès;08019;Barcelona;9;198;3;;642;320;322;0;1;319;320
8;Barcelona;13;Barcelonès;08019;Barcelona;9;199;1;;668;408;260;0;0;408;408
8;Barcelona;13;Barcelonès;08019;Barcelona;9;199;2;;664;396;268;1;0;395;395
8;Barcelona;13;Barcelonès;08019;Barcelona;9;2;1;;662;451;211;0;6;445;451
8;Barcelona;13;Barcelonès;08019;Barcelona;9;2;2;;666;433;233;0;2;431;433
8;Barcelona;13;Barcelonès;08019;Barcelona;9;2;3;;655;421;234;1;4;416;420
8;Barcelona;13;Barcelonès;08019;Barcelona;9;2;4;;697;456;241;0;4;452;456
8;Barcelona;13;Barcelonès;08019;Barcelona;9;20;1;;580;327;253;7;1;319;320
8;Barcelona;13;Barcelonès;08019;Barcelona;9;20;2;;567;343;224;3;2;338;340
8;Barcelona;13;Barcelonès;08019;Barcelona;9;200;1;;705;418;287;1;1;416;417
8;Barcelona;13;Barcelonès;08019;Barcelona;9;200;2;;736;443;293;5;3;435;438
8;Barcelona;13;Barcelonès;08019;Barcelona;9;201;1;;674;452;222;1;5;446;451
8;Barcelona;13;Barcelonès;08019;Barcelona;9;201;2;;704;450;254;0;4;446;450
8;Barcelona;13;Barcelonès;08019;Barcelona;9;201;3;;688;467;221;4;0;463;463
8;Barcelona;13;Barcelonès;08019;Barcelona;9;202;1;;638;396;242;0;1;395;396
8;Barcelona;13;Barcelonès;08019;Barcelona;9;202;2;;630;407;223;2;4;401;405
8;Barcelona;13;Barcelonès;08019;Barcelona;9;202;3;;637;409;228;1;3;405;408
8;Barcelona;13;Barcelonès;08019;Barcelona;9;202;4;;630;392;238;2;0;390;390
8;Barcelona;13;Barcelonès;08019;Barcelona;9;203;1;;733;422;311;0;0;422;422
8;Barcelona;13;Barcelonès;08019;Barcelona;9;203;2;;761;419;342;0;4;415;419
8;Barcelona;13;Barcelonès;08019;Barcelona;9;203;3;;746;418;328;2;4;412;416
8;Barcelona;13;Barcelonès;08019;Barcelona;9;203;4;;746;441;305;0;1;440;441
8;Barcelona;13;Barcelonès;08019;Barcelona;9;203;5;;729;406;323;0;2;404;406
8;Barcelona;13;Barcelonès;08019;Barcelona;9;203;6;;728;468;260;37;0;431;431
8;Barcelona;13;Barcelonès;08019;Barcelona;9;203;7;;733;421;312;0;4;417;421
8;Barcelona;13;Barcelonès;08019;Barcelona;9;203;8;;722;421;301;3;0;418;418
8;Barcelona;13;Barcelonès;08019;Barcelona;9;204;1;;724;392;332;0;4;388;392
8;Barcelona;13;Barcelonès;08019;Barcelona;9;204;2;;759;402;357;1;0;401;401
8;Barcelona;13;Barcelonès;08019;Barcelona;9;205;1;;518;208;310;1;1;206;207
8;Barcelona;13;Barcelonès;08019;Barcelona;9;205;2;;498;226;272;1;0;225;225
8;Barcelona;13;Barcelonès;08019;Barcelona;9;206;1;;581;349;232;0;2;347;349
8;Barcelona;13;Barcelonès;08019;Barcelona;9;206;2;;606;356;250;0;2;354;356
8;Barcelona;13;Barcelonès;08019;Barcelona;9;207;1;;725;437;288;1;1;435;436
8;Barcelona;13;Barcelonès;08019;Barcelona;9;207;2;;702;405;297;16;2;387;389
8;Barcelona;13;Barcelonès;08019;Barcelona;9;21;1;;645;384;261;1;0;383;383
8;Barcelona;13;Barcelonès;08019;Barcelona;9;21;2;;665;384;281;0;3;381;384
8;Barcelona;13;Barcelonès;08019;Barcelona;9;21;3;;629;349;280;0;2;347;349
8;Barcelona;13;Barcelonès;08019;Barcelona;9;21;4;;637;373;264;1;3;369;372
8;Barcelona;13;Barcelonès;08019;Barcelona;9;22;1;;499;84;415;0;1;83;84
8;Barcelona;13;Barcelonès;08019;Barcelona;9;22;2;;524;132;392;0;0;132;132
8;Barcelona;13;Barcelonès;08019;Barcelona;9;23;1;;580;355;225;0;0;355;355
8;Barcelona;13;Barcelonès;08019;Barcelona;9;23;2;;581;375;206;1;1;373;374
8;Barcelona;13;Barcelonès;08019;Barcelona;9;24;1;;646;446;200;0;3;443;446
8;Barcelona;13;Barcelonès;08019;Barcelona;9;25;1;;487;318;169;1;1;316;317
8;Barcelona;13;Barcelonès;08019;Barcelona;9;25;2;;487;328;159;10;3;315;318
8;Barcelona;13;Barcelonès;08019;Barcelona;9;26;1;;768;453;315;11;4;438;442
8;Barcelona;13;Barcelonès;08019;Barcelona;9;26;2;;775;454;321;0;3;451;454
8;Barcelona;13;Barcelonès;08019;Barcelona;9;27;1;;603;347;256;0;3;344;347
8;Barcelona;13;Barcelonès;08019;Barcelona;9;27;2;;609;373;236;2;0;371;371
8;Barcelona;13;Barcelonès;08019;Barcelona;9;27;3;;618;355;263;2;0;353;353
8;Barcelona;13;Barcelonès;08019;Barcelona;9;28;1;;711;369;342;0;0;369;369
8;Barcelona;13;Barcelonès;08019;Barcelona;9;29;1;;576;289;287;0;0;289;289
8;Barcelona;13;Barcelonès;08019;Barcelona;9;3;1;;431;272;159;0;0;272;272
8;Barcelona;13;Barcelonès;08019;Barcelona;9;3;2;;424;281;143;2;2;277;279
8;Barcelona;13;Barcelonès;08019;Barcelona;9;30;1;;562;347;215;1;4;342;346
8;Barcelona;13;Barcelonès;08019;Barcelona;9;31;1;;527;337;190;0;1;336;337
8;Barcelona;13;Barcelonès;08019;Barcelona;9;32;1;;590;357;233;0;2;355;357
8;Barcelona;13;Barcelonès;08019;Barcelona;9;33;1;;555;353;202;0;4;349;353
8;Barcelona;13;Barcelonès;08019;Barcelona;9;33;2;;541;370;171;7;2;361;363
8;Barcelona;13;Barcelonès;08019;Barcelona;9;34;1;;570;399;171;0;5;394;399
8;Barcelona;13;Barcelonès;08019;Barcelona;9;34;2;;548;384;164;2;0;382;382
8;Barcelona;13;Barcelonès;08019;Barcelona;9;35;1;;533;363;170;2;0;361;361
8;Barcelona;13;Barcelonès;08019;Barcelona;9;35;2;;535;357;178;0;4;353;357
8;Barcelona;13;Barcelonès;08019;Barcelona;9;36;1;;791;541;250;0;5;536;541
8;Barcelona;13;Barcelonès;08019;Barcelona;9;36;2;;786;516;270;1;1;514;515
8;Barcelona;13;Barcelonès;08019;Barcelona;9;37;1;;688;436;252;3;0;433;433
8;Barcelona;13;Barcelonès;08019;Barcelona;9;37;2;;708;455;253;2;4;449;453
8;Barcelona;13;Barcelonès;08019;Barcelona;9;38;1;;624;408;216;2;0;406;406
8;Barcelona;13;Barcelonès;08019;Barcelona;9;38;2;;627;421;206;1;0;420;420
8;Barcelona;13;Barcelonès;08019;Barcelona;9;39;1;;676;416;260;0;4;412;416
8;Barcelona;13;Barcelonès;08019;Barcelona;9;39;2;;643;408;235;0;1;407;408
8;Barcelona;13;Barcelonès;08019;Barcelona;9;4;1;;628;395;233;1;1;393;394
8;Barcelona;13;Barcelonès;08019;Barcelona;9;4;2;;607;415;192;2;3;410;413
8;Barcelona;13;Barcelonès;08019;Barcelona;9;40;1;;630;449;181;0;0;449;449
8;Barcelona;13;Barcelonès;08019;Barcelona;9;40;2;;637;434;203;2;0;432;432
8;Barcelona;13;Barcelonès;08019;Barcelona;9;41;1;;775;497;278;2;2;493;495
8;Barcelona;13;Barcelonès;08019;Barcelona;9;41;2;;762;512;250;0;2;510;512
8;Barcelona;13;Barcelonès;08019;Barcelona;9;42;1;;569;393;176;1;3;389;392
8;Barcelona;13;Barcelonès;08019;Barcelona;9;42;2;;557;358;199;1;1;356;357
8;Barcelona;13;Barcelonès;08019;Barcelona;9;42;3;;559;426;133;5;3;418;421
8;Barcelona;13;Barcelonès;08019;Barcelona;9;43;1;;516;280;236;0;4;276;280
8;Barcelona;13;Barcelonès;08019;Barcelona;9;44;1;;685;502;183;3;8;491;499
8;Barcelona;13;Barcelonès;08019;Barcelona;9;44;2;;689;516;173;1;7;508;515
8;Barcelona;13;Barcelonès;08019;Barcelona;9;45;1;;476;320;156;0;4;316;320
8;Barcelona;13;Barcelonès;08019;Barcelona;9;45;2;;472;310;162;0;1;309;310
8;Barcelona;13;Barcelonès;08019;Barcelona;9;46;1;;594;379;215;0;1;378;379
8;Barcelona;13;Barcelonès;08019;Barcelona;9;46;2;;590;398;192;1;5;392;397
8;Barcelona;13;Barcelonès;08019;Barcelona;9;47;1;;510;370;140;0;4;366;370
8;Barcelona;13;Barcelonès;08019;Barcelona;9;47;2;;513;360;153;2;0;358;358
8;Barcelona;13;Barcelonès;08019;Barcelona;9;48;1;;530;357;173;0;7;350;357
8;Barcelona;13;Barcelonès;08019;Barcelona;9;48;2;;515;344;171;5;1;338;339
8;Barcelona;13;Barcelonès;08019;Barcelona;9;49;1;;766;536;230;3;3;530;533
8;Barcelona;13;Barcelonès;08019;Barcelona;9;49;2;;769;538;231;0;4;534;538
8;Barcelona;13;Barcelonès;08019;Barcelona;9;5;1;;686;465;221;3;4;458;462
8;Barcelona;13;Barcelonès;08019;Barcelona;9;50;1;;711;418;293;7;5;406;411
8;Barcelona;13;Barcelonès;08019;Barcelona;9;50;2;;686;407;279;15;3;389;392
8;Barcelona;13;Barcelonès;08019;Barcelona;9;50;3;;683;401;282;1;1;399;400
8;Barcelona;13;Barcelonès;08019;Barcelona;9;50;4;;711;424;287;6;1;417;418
8;Barcelona;13;Barcelonès;08019;Barcelona;9;51;1;;407;283;124;0;0;283;283
8;Barcelona;13;Barcelonès;08019;Barcelona;9;51;2;;400;269;131;3;0;266;266
8;Barcelona;13;Barcelonès;08019;Barcelona;9;52;1;;585;372;213;0;3;369;372
8;Barcelona;13;Barcelonès;08019;Barcelona;9;52;2;;566;385;181;0;2;383;385
8;Barcelona;13;Barcelonès;08019;Barcelona;9;53;1;;831;500;331;1;1;498;499
8;Barcelona;13;Barcelonès;08019;Barcelona;9;53;2;;840;497;343;0;4;493;497
8;Barcelona;13;Barcelonès;08019;Barcelona;9;54;1;;755;412;343;0;2;410;412
8;Barcelona;13;Barcelonès;08019;Barcelona;9;54;2;;757;386;371;0;7;379;386
8;Barcelona;13;Barcelonès;08019;Barcelona;9;55;1;;571;352;219;1;3;348;351
8;Barcelona;13;Barcelonès;08019;Barcelona;9;55;2;;571;357;214;1;2;354;356
8;Barcelona;13;Barcelonès;08019;Barcelona;9;56;1;;574;371;203;2;3;366;369
8;Barcelona;13;Barcelonès;08019;Barcelona;9;56;2;;567;368;199;1;6;361;367
8;Barcelona;13;Barcelonès;08019;Barcelona;9;56;3;;563;363;200;0;0;363;363
8;Barcelona;13;Barcelonès;08019;Barcelona;9;57;1;;784;508;276;2;7;499;506
8;Barcelona;13;Barcelonès;08019;Barcelona;9;57;2;;792;488;304;5;3;480;483
8;Barcelona;13;Barcelonès;08019;Barcelona;9;57;3;;793;509;284;1;5;503;508
8;Barcelona;13;Barcelonès;08019;Barcelona;9;57;4;;788;511;277;1;2;508;510
8;Barcelona;13;Barcelonès;08019;Barcelona;9;57;5;;788;493;295;4;1;488;489
8;Barcelona;13;Barcelonès;08019;Barcelona;9;57;6;;800;517;283;0;3;514;517
8;Barcelona;13;Barcelonès;08019;Barcelona;9;57;7;;787;522;265;1;5;516;521
8;Barcelona;13;Barcelonès;08019;Barcelona;9;58;1;;457;334;123;5;1;328;329
8;Barcelona;13;Barcelonès;08019;Barcelona;9;58;2;;465;314;151;0;0;314;314
8;Barcelona;13;Barcelonès;08019;Barcelona;9;59;1;;769;493;276;1;2;490;492
8;Barcelona;13;Barcelonès;08019;Barcelona;9;59;2;;777;485;292;0;0;485;485
8;Barcelona;13;Barcelonès;08019;Barcelona;9;6;1;;642;410;232;2;1;407;408
8;Barcelona;13;Barcelonès;08019;Barcelona;9;6;2;;622;408;214;1;3;404;407
8;Barcelona;13;Barcelonès;08019;Barcelona;9;60;1;;561;372;189;0;1;371;372
8;Barcelona;13;Barcelonès;08019;Barcelona;9;60;2;;556;386;170;1;3;382;385
8;Barcelona;13;Barcelonès;08019;Barcelona;9;60;3;;562;380;182;10;5;365;370
8;Barcelona;13;Barcelonès;08019;Barcelona;9;61;1;;739;433;306;0;1;432;433
8;Barcelona;13;Barcelonès;08019;Barcelona;9;61;2;;739;451;288;0;2;449;451
8;Barcelona;13;Barcelonès;08019;Barcelona;9;61;3;;726;462;264;9;0;453;453
8;Barcelona;13;Barcelonès;08019;Barcelona;9;61;4;;760;456;304;1;6;449;455
8;Barcelona;13;Barcelonès;08019;Barcelona;9;62;1;;618;410;208;0;4;406;410
8;Barcelona;13;Barcelonès;08019;Barcelona;9;62;2;;620;414;206;1;1;412;413
8;Barcelona;13;Barcelonès;08019;Barcelona;9;63;1;;580;401;179;3;4;394;398
8;Barcelona;13;Barcelonès;08019;Barcelona;9;64;1;;796;491;305;0;2;489;491
8;Barcelona;13;Barcelonès;08019;Barcelona;9;64;2;;765;500;265;0;8;492;500
8;Barcelona;13;Barcelonès;08019;Barcelona;9;64;3;;787;498;289;1;4;493;497
8;Barcelona;13;Barcelonès;08019;Barcelona;9;64;4;;774;495;279;0;4;491;495
8;Barcelona;13;Barcelonès;08019;Barcelona;9;64;5;;781;496;285;2;3;491;494
8;Barcelona;13;Barcelonès;08019;Barcelona;9;65;1;;579;386;193;1;3;382;385
8;Barcelona;13;Barcelonès;08019;Barcelona;9;65;2;;548;350;198;0;1;349;350
8;Barcelona;13;Barcelonès;08019;Barcelona;9;65;3;;552;390;162;0;3;387;390
8;Barcelona;13;Barcelonès;08019;Barcelona;9;66;1;;423;239;184;0;2;237;239
8;Barcelona;13;Barcelonès;08019;Barcelona;9;66;2;;422;250;172;1;3;246;249
8;Barcelona;13;Barcelonès;08019;Barcelona;9;67;1;;664;413;251;4;3;406;409
8;Barcelona;13;Barcelonès;08019;Barcelona;9;67;2;;688;395;293;1;1;393;394
8;Barcelona;13;Barcelonès;08019;Barcelona;9;68;1;;505;331;174;3;2;326;328
8;Barcelona;13;Barcelonès;08019;Barcelona;9;69;1;;517;277;240;0;1;276;277
8;Barcelona;13;Barcelonès;08019;Barcelona;9;69;2;;523;280;243;3;3;274;277
8;Barcelona;13;Barcelonès;08019;Barcelona;9;7;1;;658;456;202;1;3;452;455
8;Barcelona;13;Barcelonès;08019;Barcelona;9;7;2;;656;401;255;0;3;398;401
8;Barcelona;13;Barcelonès;08019;Barcelona;9;70;1;;483;290;193;5;2;283;285
8;Barcelona;13;Barcelonès;08019;Barcelona;9;70;2;;476;292;184;0;0;292;292
8;Barcelona;13;Barcelonès;08019;Barcelona;9;71;1;;802;438;364;2;6;430;436
8;Barcelona;13;Barcelonès;08019;Barcelona;9;71;2;;788;444;344;5;1;438;439
8;Barcelona;13;Barcelonès;08019;Barcelona;9;71;3;;795;485;310;3;5;477;482
8;Barcelona;13;Barcelonès;08019;Barcelona;9;71;4;;790;445;345;2;3;440;443
8;Barcelona;13;Barcelonès;08019;Barcelona;9;71;5;;823;456;367;1;2;453;455
8;Barcelona;13;Barcelonès;08019;Barcelona;9;72;1;;636;424;212;0;3;421;424
8;Barcelona;13;Barcelonès;08019;Barcelona;9;72;2;;640;430;210;2;5;423;428
8;Barcelona;13;Barcelonès;08019;Barcelona;9;72;3;;641;458;183;1;3;454;457
8;Barcelona;13;Barcelonès;08019;Barcelona;9;73;1;;528;365;163;1;1;363;364
8;Barcelona;13;Barcelonès;08019;Barcelona;9;73;2;;529;376;153;0;0;376;376
8;Barcelona;13;Barcelonès;08019;Barcelona;9;74;1;;605;420;185;1;2;417;419
8;Barcelona;13;Barcelonès;08019;Barcelona;9;74;2;;633;431;202;0;2;429;431
8;Barcelona;13;Barcelonès;08019;Barcelona;9;74;3;;602;446;156;2;2;442;444
8;Barcelona;13;Barcelonès;08019;Barcelona;9;74;4;;620;433;187;0;5;428;433
8;Barcelona;13;Barcelonès;08019;Barcelona;9;75;1;;633;431;202;0;2;429;431
8;Barcelona;13;Barcelonès;08019;Barcelona;9;75;2;;582;364;218;6;2;356;358
8;Barcelona;13;Barcelonès;08019;Barcelona;9;75;3;;592;390;202;1;0;389;389
8;Barcelona;13;Barcelonès;08019;Barcelona;9;76;1;;774;538;236;4;0;534;534
8;Barcelona;13;Barcelonès;08019;Barcelona;9;76;2;;766;525;241;2;2;521;523
8;Barcelona;13;Barcelonès;08019;Barcelona;9;76;3;;763;516;247;0;5;511;516
8;Barcelona;13;Barcelonès;08019;Barcelona;9;77;1;;719;521;198;0;2;519;521
8;Barcelona;13;Barcelonès;08019;Barcelona;9;77;2;;707;462;245;0;3;459;462
8;Barcelona;13;Barcelonès;08019;Barcelona;9;77;3;;732;499;233;0;3;496;499
8;Barcelona;13;Barcelonès;08019;Barcelona;9;78;1;;745;544;201;15;6;523;529
8;Barcelona;13;Barcelonès;08019;Barcelona;9;78;2;;720;516;204;4;0;512;512
8;Barcelona;13;Barcelonès;08019;Barcelona;9;79;1;;776;562;214;14;3;545;548
8;Barcelona;13;Barcelonès;08019;Barcelona;9;79;2;;762;499;263;0;1;498;499
8;Barcelona;13;Barcelonès;08019;Barcelona;9;79;3;;768;520;248;0;2;518;520
8;Barcelona;13;Barcelonès;08019;Barcelona;9;8;1;;718;491;227;0;7;484;491
8;Barcelona;13;Barcelonès;08019;Barcelona;9;8;2;;711;491;220;4;2;485;487
8;Barcelona;13;Barcelonès;08019;Barcelona;9;80;1;;572;375;197;0;0;375;375
8;Barcelona;13;Barcelonès;08019;Barcelona;9;80;2;;600;374;226;0;6;368;374
8;Barcelona;13;Barcelonès;08019;Barcelona;9;80;3;;584;372;212;8;4;360;364
8;Barcelona;13;Barcelonès;08019;Barcelona;9;81;1;;683;460;223;0;4;456;460
8;Barcelona;13;Barcelonès;08019;Barcelona;9;81;2;;687;428;259;1;5;422;427
8;Barcelona;13;Barcelonès;08019;Barcelona;9;81;3;;692;446;246;0;1;445;446
8;Barcelona;13;Barcelonès;08019;Barcelona;9;82;1;;704;470;234;1;6;463;469
8;Barcelona;13;Barcelonès;08019;Barcelona;9;82;2;;712;456;256;12;2;442;444
8;Barcelona;13;Barcelonès;08019;Barcelona;9;82;3;;716;484;232;18;1;465;466
8;Barcelona;13;Barcelonès;08019;Barcelona;9;83;1;;558;346;212;1;0;345;345
8;Barcelona;13;Barcelonès;08019;Barcelona;9;83;2;;564;347;217;0;0;347;347
8;Barcelona;13;Barcelonès;08019;Barcelona;9;84;1;;739;482;257;3;5;474;479
8;Barcelona;13;Barcelonès;08019;Barcelona;9;84;2;;737;484;253;0;2;482;484
8;Barcelona;13;Barcelonès;08019;Barcelona;9;84;3;;733;473;260;0;3;470;473
8;Barcelona;13;Barcelonès;08019;Barcelona;9;85;1;;480;273;207;3;0;270;270
8;Barcelona;13;Barcelonès;08019;Barcelona;9;85;2;;484;311;173;0;2;309;311
8;Barcelona;13;Barcelonès;08019;Barcelona;9;86;1;;735;444;291;0;3;441;444
8;Barcelona;13;Barcelonès;08019;Barcelona;9;86;2;;730;455;275;0;2;453;455
8;Barcelona;13;Barcelonès;08019;Barcelona;9;87;1;;574;323;251;0;4;319;323
8;Barcelona;13;Barcelonès;08019;Barcelona;9;87;2;;565;298;267;2;1;295;296
8;Barcelona;13;Barcelonès;08019;Barcelona;9;87;3;;552;323;229;0;1;322;323
8;Barcelona;13;Barcelonès;08019;Barcelona;9;88;1;;446;275;171;0;1;274;275
8;Barcelona;13;Barcelonès;08019;Barcelona;9;88;2;;453;277;176;0;3;274;277
8;Barcelona;13;Barcelonès;08019;Barcelona;9;89;1;;643;397;246;1;2;394;396
8;Barcelona;13;Barcelonès;08019;Barcelona;9;89;2;;634;383;251;2;1;380;381
8;Barcelona;13;Barcelonès;08019;Barcelona;9;9;1;;598;372;226;2;5;365;370
8;Barcelona;13;Barcelonès;08019;Barcelona;9;9;2;;597;354;243;6;3;345;348
8;Barcelona;13;Barcelonès;08019;Barcelona;9;9;3;;595;386;209;1;0;385;385
8;Barcelona;13;Barcelonès;08019;Barcelona;9;90;1;;780;455;325;6;0;449;449
8;Barcelona;13;Barcelonès;08019;Barcelona;9;90;2;;762;490;272;0;6;484;490
8;Barcelona;13;Barcelonès;08019;Barcelona;9;90;3;;775;496;279;5;9;482;491
8;Barcelona;13;Barcelonès;08019;Barcelona;9;91;1;;576;365;211;0;4;361;365
8;Barcelona;13;Barcelonès;08019;Barcelona;9;91;2;;563;367;196;0;1;366;367
8;Barcelona;13;Barcelonès;08019;Barcelona;9;91;3;;562;359;203;1;0;358;358
8;Barcelona;13;Barcelonès;08019;Barcelona;9;92;1;;717;438;279;0;5;433;438
8;Barcelona;13;Barcelonès;08019;Barcelona;9;92;2;;707;417;290;1;2;414;416
8;Barcelona;13;Barcelonès;08019;Barcelona;9;93;1;;271;178;93;0;3;175;178
8;Barcelona;13;Barcelonès;08019;Barcelona;9;94;1;;637;407;230;2;3;402;405
8;Barcelona;13;Barcelonès;08019;Barcelona;9;94;2;;663;381;282;3;3;375;378
8;Barcelona;13;Barcelonès;08019;Barcelona;9;95;1;;739;462;277;14;3;445;448
8;Barcelona;13;Barcelonès;08019;Barcelona;9;95;2;;735;433;302;0;4;429;433
8;Barcelona;13;Barcelonès;08019;Barcelona;9;96;1;;770;448;322;0;2;446;448
8;Barcelona;13;Barcelonès;08019;Barcelona;9;96;2;;774;482;292;1;6;475;481
8;Barcelona;13;Barcelonès;08019;Barcelona;9;97;1;;610;348;262;1;0;347;347
8;Barcelona;13;Barcelonès;08019;Barcelona;9;97;2;;612;381;231;0;1;380;381
8;Barcelona;13;Barcelonès;08019;Barcelona;9;98;1;;646;386;260;0;4;382;386
8;Barcelona;13;Barcelonès;08019;Barcelona;9;98;2;;643;393;250;0;3;390;393
8;Barcelona;13;Barcelonès;08019;Barcelona;9;99;1;;655;444;211;2;13;429;442
8;Barcelona;13;Barcelonès;08019;Barcelona;9;99;2;;655;381;274;4;3;374;377
8;Barcelona;13;Barcelonès;08019;Barcelona;9;99;3;;684;440;244;4;8;428;436
25;Lleida;23;Noguera;25042;Baronia de Rialb, la;1;1;1;;252;162;90;2;1;159;160
17;Girona;2;Alt Empordà;17016;Bàscara;1;1;1;;562;414;148;3;1;410;411
25;Lleida;4;Alt Urgell;25044;Bassella;1;1;1;;347;262;85;0;1;261;262
43;Tarragona;37;Terra Alta;43022;Batea;1;1;1;;973;808;165;0;5;803;808
43;Tarragona;37;Terra Alta;43022;Batea;1;2;1;;671;520;151;6;0;514;514
25;Lleida;39;Consell General d'Aran;25045;Bausen;1;1;1;;72;64;8;0;0;64;64
8;Barcelona;11;Baix Llobregat;08020;Begues;1;1;1;;1040;802;238;3;2;797;799
17;Girona;10;Baix Empordà;17013;Begur;1;1;1;;590;451;139;1;3;447;450
17;Girona;10;Baix Empordà;17013;Begur;1;1;2;;634;492;142;3;4;485;489
17;Girona;10;Baix Empordà;17013;Begur;1;1;3;;405;292;113;0;0;292;292
25;Lleida;38;Urgell;25046;Belianes;1;1;1;;540;397;143;0;3;394;397
25;Lleida;18;Garrigues;25170;Bellaguarda;1;1;1;;356;178;178;2;0;176;176
17;Girona;10;Baix Empordà;17018;Bellcaire d'Empordà;1;1;1;;358;285;73;2;2;281;283
25;Lleida;23;Noguera;25047;Bellcaire d'Urgell;1;1;1;;642;482;160;0;1;481;482
25;Lleida;23;Noguera;25047;Bellcaire d'Urgell;1;1;2;;654;490;164;1;1;488;489
25;Lleida;27;Pla d'Urgell;25048;Bell-lloc d'Urgell;1;1;1;;754;546;208;4;3;539;542
25;Lleida;27;Pla d'Urgell;25048;Bell-lloc d'Urgell;1;2;1;;950;725;225;0;7;718;725
25;Lleida;23;Noguera;25049;Bellmunt d'Urgell;1;1;1;;197;133;64;0;1;132;133
43;Tarragona;29;Priorat;43023;Bellmunt del Priorat;1;1;1;;306;238;68;1;0;237;237
8;Barcelona;6;Anoia;08021;Bellprat;1;1;1;;86;56;30;0;0;56;56
25;Lleida;38;Urgell;25050;Bellpuig;1;1;1;;945;639;306;17;2;620;622
25;Lleida;38;Urgell;25050;Bellpuig;1;2;1;;965;729;236;3;1;725;726
25;Lleida;38;Urgell;25050;Bellpuig;1;3;1;;981;694;287;2;7;685;692
43;Tarragona;12;Baix Penedès;43024;Bellvei;1;1;1;;653;552;101;1;2;549;551
25;Lleida;15;Cerdanya;25051;Bellver de Cerdanya;1;1;1;;861;650;211;0;0;650;650
25;Lleida;15;Cerdanya;25051;Bellver de Cerdanya;1;2;1;;483;301;182;0;0;301;301
25;Lleida;27;Pla d'Urgell;25052;Bellvís;1;1;1;;832;545;287;2;2;541;543
25;Lleida;27;Pla d'Urgell;25052;Bellvís;1;1;2;;829;546;283;1;1;544;545
25;Lleida;27;Pla d'Urgell;25052;Bellvís;1;2;1;;147;90;57;0;1;89;90
25;Lleida;27;Pla d'Urgell;25052;Bellvís;2;1;1;;143;59;84;0;1;58;59
25;Lleida;33;Segrià;25053;Benavent de Segrià;1;1;1;;574;351;223;1;1;349;350
43;Tarragona;9;Baix Ebre;43025;Benifallet;1;1;1;;876;537;339;3;1;533;534
43;Tarragona;30;Ribera d'Ebre;43026;Benissanet;1;1;1;;865;570;295;9;1;560;561
8;Barcelona;14;Berguedà;08022;Berga;1;1;1;;955;662;293;2;3;657;660
8;Barcelona;14;Berguedà;08022;Berga;1;1;2;;1057;717;340;0;2;715;717
8;Barcelona;14;Berguedà;08022;Berga;1;2;1;;1036;741;295;1;1;739;740
8;Barcelona;14;Berguedà;08022;Berga;1;2;2;;1148;795;353;2;2;791;793
8;Barcelona;14;Berguedà;08022;Berga;1;3;1;;749;551;198;12;0;539;539
8;Barcelona;14;Berguedà;08022;Berga;2;1;1;;752;475;277;2;1;472;473
8;Barcelona;14;Berguedà;08022;Berga;2;1;2;;682;424;258;2;2;420;422
8;Barcelona;14;Berguedà;08022;Berga;2;2;1;;943;664;279;0;3;661;664
8;Barcelona;14;Berguedà;08022;Berga;2;2;2;;1027;696;331;4;0;692;692
8;Barcelona;14;Berguedà;08022;Berga;2;3;1;;803;507;296;0;7;500;507
8;Barcelona;14;Berguedà;08022;Berga;2;3;2;;779;491;288;6;1;484;485
8;Barcelona;14;Berguedà;08022;Berga;3;1;1;;541;382;159;1;1;380;381
8;Barcelona;14;Berguedà;08022;Berga;4;1;1;;420;286;134;0;1;285;286
17;Girona;19;Garrotxa;17019;Besalú;1;1;1;;536;425;111;8;3;414;417
17;Girona;19;Garrotxa;17019;Besalú;1;1;2;;535;428;107;6;2;420;422
17;Girona;19;Garrotxa;17019;Besalú;1;1;3;;582;482;100;6;1;475;476
17;Girona;20;Gironès;17020;Bescanó;1;1;1;;830;609;221;2;9;598;607
17;Girona;20;Gironès;17020;Bescanó;1;1;2;;811;605;206;3;3;599;602
17;Girona;20;Gironès;17020;Bescanó;1;2;1;;259;178;81;2;0;176;176
17;Girona;20;Gironès;17020;Bescanó;1;3;1;;169;115;54;0;2;113;115
17;Girona;19;Garrotxa;17021;Beuda;1;1;1;;84;62;22;1;2;59;61
8;Barcelona;41;Vallès Oriental;08023;Bigues i Riells;1;1;1;;985;676;309;15;4;657;661
8;Barcelona;41;Vallès Oriental;08023;Bigues i Riells;1;2;1;;257;204;53;2;0;202;202
25;Lleida;32;Segarra;25055;Biosca;1;1;1;;252;189;63;2;0;187;187
17;Girona;10;Baix Empordà;17022;Bisbal d'Empordà, la;1;1;1;;701;494;207;1;2;491;493
17;Girona;10;Baix Empordà;17022;Bisbal d'Empordà, la;1;2;1;;784;584;200;5;2;577;579
17;Girona;10;Baix Empordà;17022;Bisbal d'Empordà, la;1;2;2;;778;582;196;4;5;573;578
17;Girona;10;Baix Empordà;17022;Bisbal d'Empordà, la;1;3;1;;726;530;196;0;0;530;530
17;Girona;10;Baix Empordà;17022;Bisbal d'Empordà, la;2;1;1;;548;424;124;2;1;421;422
17;Girona;10;Baix Empordà;17022;Bisbal d'Empordà, la;2;2;1;;682;477;205;0;4;473;477
17;Girona;10;Baix Empordà;17022;Bisbal d'Empordà, la;2;2;2;;629;474;155;2;1;471;472
17;Girona;10;Baix Empordà;17022;Bisbal d'Empordà, la;2;3;1;;833;600;233;2;2;596;598
43;Tarragona;29;Priorat;43027;Bisbal de Falset, la;1;1;1;;272;165;107;2;1;162;163
43;Tarragona;12;Baix Penedès;43028;Bisbal del Penedès, la;1;1;1;;946;675;271;0;1;674;675
17;Girona;2;Alt Empordà;17234;Biure;1;1;1;;232;130;102;16;0;114;114
43;Tarragona;16;Conca de Barberà;43029;Blancafort;1;1;1;;359;261;98;1;0;260;260
17;Girona;34;Selva;17023;Blanes;1;1;1;;1022;682;340;9;2;671;673
17;Girona;34;Selva;17023;Blanes;1;2;1;;1022;802;220;1;2;799;801
17;Girona;34;Selva;17023;Blanes;2;1;1;;1000;674;326;3;1;670;671
17;Girona;34;Selva;17023;Blanes;2;2;1;;815;568;247;3;0;565;565
17;Girona;34;Selva;17023;Blanes;2;2;2;;855;535;320;5;4;526;530
17;Girona;34;Selva;17023;Blanes;2;2;3;;874;580;294;3;2;575;577
17;Girona;34;Selva;17023;Blanes;2;3;1;;720;482;238;4;1;477;478
17;Girona;34;Selva;17023;Blanes;2;3;2;;755;537;218;2;1;534;535
17;Girona;34;Selva;17023;Blanes;2;4;1;;836;522;314;5;2;515;517
17;Girona;34;Selva;17023;Blanes;2;5;1;;629;395;234;0;0;395;395
17;Girona;34;Selva;17023;Blanes;2;5;2;;607;404;203;0;0;404;404
17;Girona;34;Selva;17023;Blanes;3;1;1;;851;575;276;7;3;565;568
17;Girona;34;Selva;17023;Blanes;3;1;2;;979;605;374;4;2;599;601
17;Girona;34;Selva;17023;Blanes;3;2;1;;750;389;361;3;1;385;386
17;Girona;34;Selva;17023;Blanes;3;2;2;;742;430;312;3;3;424;427
17;Girona;34;Selva;17023;Blanes;3;3;1;;969;599;370;2;2;595;597
17;Girona;34;Selva;17023;Blanes;3;3;2;;937;644;293;0;3;641;644
17;Girona;34;Selva;17023;Blanes;3;4;1;;333;208;125;3;0;205;205
17;Girona;34;Selva;17023;Blanes;3;5;1;;383;291;92;3;1;287;288
17;Girona;34;Selva;17023;Blanes;3;6;1;;84;46;38;0;0;46;46
17;Girona;34;Selva;17023;Blanes;3;7;1;;24;18;6;2;0;16;16
17;Girona;34;Selva;17023;Blanes;4;1;1;;130;81;49;0;1;80;81
17;Girona;2;Alt Empordà;17029;Boadella i les Escaules;1;1;1;;181;127;54;0;1;126;127
17;Girona;15;Cerdanya;17024;Bolvir;1;1;1;;161;136;25;0;1;135;136
43;Tarragona;12;Baix Penedès;43030;Bonastre;1;1;1;;238;221;17;1;1;219;220
25;Lleida;39;Consell General d'Aran;25057;Bòrdes, es;1;1;1;;141;102;39;0;1;101;102
17;Girona;20;Gironès;17025;Bordils;1;1;1;;953;720;233;11;4;705;709
25;Lleida;18;Garrigues;25058;Borges Blanques, les;1;1;1;;840;603;237;2;5;596;601
25;Lleida;18;Garrigues;25058;Borges Blanques, les;1;2;1;;940;665;275;0;4;661;665
25;Lleida;18;Garrigues;25058;Borges Blanques, les;2;1;1;;1012;687;325;0;5;682;687
25;Lleida;18;Garrigues;25058;Borges Blanques, les;2;2;1;;1230;819;411;3;0;816;816
43;Tarragona;8;Baix Camp;43031;Borges del Camp, les;1;1;1;;1049;858;191;8;3;847;850
17;Girona;2;Alt Empordà;17026;Borrassà;1;1;1;;408;299;109;2;1;296;297
8;Barcelona;14;Berguedà;08024;Borredà;1;1;1;;398;320;78;2;0;318;318
25;Lleida;39;Consell General d'Aran;25059;Bossòst;1;1;1;;581;429;152;0;0;429;429
43;Tarragona;37;Terra Alta;43032;Bot;1;1;1;;827;667;160;3;3;661;664
43;Tarragona;8;Baix Camp;43033;Botarell;1;1;1;;309;259;50;0;4;255;259
25;Lleida;18;Garrigues;25056;Bovera;1;1;1;;451;282;169;2;2;278;280
43;Tarragona;1;Alt Camp;43034;Bràfim;1;1;1;;464;381;83;2;0;379;379
17;Girona;34;Selva;17027;Breda;1;1;1;;1416;1143;273;5;6;1132;1138
17;Girona;34;Selva;17027;Breda;1;2;1;;914;701;213;3;4;694;698
8;Barcelona;6;Anoia;08025;Bruc, el;1;1;1;;570;409;161;3;0;406;406
8;Barcelona;24;Osona;08026;Brull, el;1;1;1;;152;112;40;0;0;112;112
17;Girona;34;Selva;17028;Brunyola i Sant Martí Sapresa;1;1;1;;383;228;155;6;0;222;222
43;Tarragona;29;Priorat;43035;Cabacés;1;1;1;;302;202;100;3;0;199;199
25;Lleida;23;Noguera;25060;Cabanabona;1;1;1;;110;86;24;0;0;86;86
17;Girona;2;Alt Empordà;17031;Cabanelles;1;1;1;;202;113;89;1;0;112;112
17;Girona;2;Alt Empordà;17030;Cabanes;1;1;1;;641;382;259;3;0;379;379
8;Barcelona;3;Alt Penedès;08027;Cabanyes, les;1;1;1;;231;182;49;0;1;181;182
25;Lleida;4;Alt Urgell;25061;Cabó;1;1;1;;144;92;52;0;0;92;92
43;Tarragona;1;Alt Camp;43036;Cabra del Camp;1;1;1;;336;273;63;0;2;271;273
8;Barcelona;6;Anoia;08028;Cabrera d'Anoia;1;1;1;;121;83;38;1;0;82;82
8;Barcelona;21;Maresme;08029;Cabrera de Mar;1;1;1;;693;479;214;1;1;477;478
8;Barcelona;21;Maresme;08029;Cabrera de Mar;1;1;2;;801;587;214;3;0;584;584
8;Barcelona;21;Maresme;08030;Cabrils;1;1;1;;1090;894;196;3;1;890;891
17;Girona;2;Alt Empordà;17032;Cadaqués;1;1;1;;1213;896;317;4;11;881;892
8;Barcelona;6;Anoia;08031;Calaf;1;1;1;;864;611;253;19;3;589;592
8;Barcelona;6;Anoia;08031;Calaf;1;2;1;;729;527;202;14;3;510;513
8;Barcelona;6;Anoia;08031;Calaf;1;2;2;;835;656;179;14;0;642;642
43;Tarragona;12;Baix Penedès;43037;Calafell;1;1;1;;692;458;234;3;0;455;455
43;Tarragona;12;Baix Penedès;43037;Calafell;1;1;2;;1019;732;287;6;3;723;726
43;Tarragona;12;Baix Penedès;43037;Calafell;2;1;1;;1004;746;258;0;3;743;746
43;Tarragona;12;Baix Penedès;43037;Calafell;2;2;1;;383;209;174;2;0;207;207
43;Tarragona;12;Baix Penedès;43037;Calafell;2;3;1;;667;278;389;0;0;278;278
8;Barcelona;;;08034;Calders;1;1;1;;402;321;81;4;0;317;317
8;Barcelona;21;Maresme;08032;Caldes d'Estrac;1;1;1;;929;750;179;3;3;744;747
17;Girona;34;Selva;17033;Caldes de Malavella;1;1;1;;867;608;259;4;2;602;604
17;Girona;34;Selva;17033;Caldes de Malavella;1;1;2;;731;545;186;6;0;539;539
17;Girona;34;Selva;17033;Caldes de Malavella;1;2;1;;505;291;214;0;1;290;291
8;Barcelona;41;Vallès Oriental;08033;Caldes de Montbui;1;1;1;;752;536;216;2;1;533;534
8;Barcelona;41;Vallès Oriental;08033;Caldes de Montbui;1;1;2;;509;400;109;1;0;399;399
8;Barcelona;41;Vallès Oriental;08033;Caldes de Montbui;1;2;1;;871;560;311;1;2;557;559
8;Barcelona;41;Vallès Oriental;08033;Caldes de Montbui;1;2;2;;524;360;164;0;1;359;360
8;Barcelona;41;Vallès Oriental;08033;Caldes de Montbui;1;3;1;;677;489;188;0;1;488;489
8;Barcelona;41;Vallès Oriental;08033;Caldes de Montbui;2;1;1;;1010;743;267;1;6;736;742
8;Barcelona;41;Vallès Oriental;08033;Caldes de Montbui;2;1;2;;558;473;85;2;1;470;471
8;Barcelona;41;Vallès Oriental;08033;Caldes de Montbui;3;1;1;;1060;769;291;1;7;761;768
8;Barcelona;41;Vallès Oriental;08033;Caldes de Montbui;3;1;2;;558;492;66;2;2;488;490
8;Barcelona;41;Vallès Oriental;08033;Caldes de Montbui;3;2;1;;216;134;82;0;0;134;134
8;Barcelona;41;Vallès Oriental;08033;Caldes de Montbui;3;3;1;;848;593;255;2;5;586;591
8;Barcelona;21;Maresme;08035;Calella;1;1;1;;1172;794;378;0;1;793;794
8;Barcelona;21;Maresme;08035;Calella;1;2;1;;631;451;180;0;2;449;451
8;Barcelona;21;Maresme;08035;Calella;1;3;1;;642;363;279;0;0;363;363
8;Barcelona;21;Maresme;08035;Calella;2;1;1;;518;369;149;0;4;365;369
8;Barcelona;21;Maresme;08035;Calella;2;2;1;;695;492;203;11;1;480;481
8;Barcelona;21;Maresme;08035;Calella;2;2;2;;767;532;235;0;0;532;532
8;Barcelona;21;Maresme;08035;Calella;3;1;1;;710;488;222;0;1;487;488
8;Barcelona;21;Maresme;08035;Calella;3;1;2;;735;501;234;0;2;499;501
8;Barcelona;21;Maresme;08035;Calella;3;2;1;;615;396;219;2;3;391;394
8;Barcelona;21;Maresme;08035;Calella;3;2;2;;631;399;232;2;1;396;397
8;Barcelona;21;Maresme;08035;Calella;3;3;1;;1059;686;373;0;2;684;686
8;Barcelona;24;Osona;08037;Calldetenes;1;1;1;;945;723;222;2;6;715;721
8;Barcelona;7;Bages;08038;Callús;1;1;1;;1283;874;409;0;1;873;874
17;Girona;10;Baix Empordà;17034;Calonge i Sant Antoni;1;1;1;;653;458;195;2;3;453;456
17;Girona;10;Baix Empordà;17034;Calonge i Sant Antoni;1;1;2;;770;548;222;0;5;543;548
17;Girona;10;Baix Empordà;17034;Calonge i Sant Antoni;1;2;1;;616;483;133;1;1;481;482
17;Girona;10;Baix Empordà;17034;Calonge i Sant Antoni;1;3;1;;527;384;143;2;0;382;382
17;Girona;10;Baix Empordà;17034;Calonge i Sant Antoni;1;4;1;;610;415;195;3;1;411;412
8;Barcelona;6;Anoia;08036;Calonge de Segarra;1;1;1;;165;140;25;2;0;138;138
25;Lleida;23;Noguera;25062;Camarasa;1;1;1;;858;580;278;2;1;577;578
43;Tarragona;9;Baix Ebre;43903;Camarles;1;1;1;;817;613;204;0;1;612;613
43;Tarragona;9;Baix Ebre;43903;Camarles;1;1;2;;601;450;151;0;5;445;450
43;Tarragona;9;Baix Ebre;43903;Camarles;1;2;1;;715;395;320;2;3;390;393
43;Tarragona;8;Baix Camp;43038;Cambrils;1;1;1;;1127;608;519;18;0;590;590
43;Tarragona;8;Baix Camp;43038;Cambrils;1;1;2;;1047;706;341;10;0;696;696
43;Tarragona;8;Baix Camp;43038;Cambrils;1;2;1;;964;604;360;10;0;594;594
43;Tarragona;8;Baix Camp;43038;Cambrils;1;2;2;;971;620;351;1;5;614;619
43;Tarragona;8;Baix Camp;43038;Cambrils;2;1;1;;782;534;248;2;0;532;532
43;Tarragona;8;Baix Camp;43038;Cambrils;2;1;2;;639;439;200;2;0;437;437
43;Tarragona;8;Baix Camp;43038;Cambrils;2;2;1;;1059;541;518;2;0;539;539
43;Tarragona;8;Baix Camp;43038;Cambrils;2;2;2;;900;520;380;1;4;515;519
43;Tarragona;8;Baix Camp;43038;Cambrils;2;3;1;;850;367;483;7;1;359;360
17;Girona;28;Pla de l'Estany;17035;Camós;1;1;1;;473;332;141;10;1;321;322
17;Girona;31;Ripollès;17036;Campdevànol;1;1;1;;883;684;199;8;4;672;676
17;Girona;31;Ripollès;17036;Campdevànol;1;2;1;;540;413;127;2;0;411;411
17;Girona;31;Ripollès;17036;Campdevànol;1;2;2;;600;464;136;3;5;456;461
17;Girona;31;Ripollès;17036;Campdevànol;1;3;1;;766;549;217;2;2;545;547
17;Girona;31;Ripollès;17037;Campelles;1;1;1;;143;98;45;0;0;98;98
8;Barcelona;41;Vallès Oriental;08039;Campins;1;1;1;;130;103;27;0;3;100;103
17;Girona;20;Gironès;17038;Campllong;1;1;1;;251;172;79;5;1;166;167
17;Girona;31;Ripollès;17039;Camprodon;1;1;1;;742;635;107;4;2;629;631
17;Girona;31;Ripollès;17039;Camprodon;1;1;2;;756;658;98;1;0;657;657
17;Girona;31;Ripollès;17039;Camprodon;1;2;1;;262;228;34;0;0;228;228
17;Girona;31;Ripollès;17039;Camprodon;1;3;1;;88;74;14;0;0;74;74
25;Lleida;39;Consell General d'Aran;25063;Canejan;1;1;1;;120;65;55;0;0;65;65
17;Girona;20;Gironès;17040;Canet d'Adri;1;1;1;;345;201;144;0;3;198;201
8;Barcelona;21;Maresme;08040;Canet de Mar;1;1;1;;1298;923;375;1;5;917;922
8;Barcelona;21;Maresme;08040;Canet de Mar;1;2;1;;1448;980;468;3;2;975;977
8;Barcelona;21;Maresme;08040;Canet de Mar;1;3;1;;1888;1322;566;1;7;1314;1321
8;Barcelona;21;Maresme;08040;Canet de Mar;1;4;1;;1473;1069;404;2;3;1064;1067
8;Barcelona;41;Vallès Oriental;08041;Canovelles;1;1;1;;1007;656;351;0;1;655;656
8;Barcelona;41;Vallès Oriental;08041;Canovelles;1;2;1;;802;538;264;0;1;537;538
8;Barcelona;41;Vallès Oriental;08041;Canovelles;1;2;2;;823;577;246;1;1;575;576
8;Barcelona;41;Vallès Oriental;08041;Canovelles;1;3;1;;723;461;262;0;0;461;461
8;Barcelona;41;Vallès Oriental;08041;Canovelles;1;3;2;;652;477;175;2;2;473;475
8;Barcelona;41;Vallès Oriental;08041;Canovelles;1;4;1;;1011;632;379;0;1;631;632
8;Barcelona;41;Vallès Oriental;08041;Canovelles;1;5;1;;677;467;210;2;8;457;465
8;Barcelona;41;Vallès Oriental;08041;Canovelles;1;5;2;;549;424;125;1;3;420;423
8;Barcelona;41;Vallès Oriental;08041;Canovelles;1;6;1;;903;595;308;0;4;591;595
8;Barcelona;41;Vallès Oriental;08041;Canovelles;1;7;1;;764;594;170;0;2;592;594
8;Barcelona;41;Vallès Oriental;08041;Canovelles;1;8;1;;393;274;119;0;0;274;274
8;Barcelona;41;Vallès Oriental;08042;Cànoves i Samalús;1;1;1;;454;349;105;0;2;347;349
17;Girona;2;Alt Empordà;17041;Cantallops;1;1;1;;242;189;53;1;0;188;188
8;Barcelona;17;Garraf;08043;Canyelles;1;1;1;;424;298;126;1;0;297;297
43;Tarragona;8;Baix Camp;43039;Capafonts;1;1;1;;82;71;11;0;0;71;71
43;Tarragona;29;Priorat;43040;Capçanes;1;1;1;;363;294;69;3;5;286;291
8;Barcelona;6;Anoia;08044;Capellades;1;1;1;;898;640;258;0;2;638;640
8;Barcelona;6;Anoia;08044;Capellades;1;1;2;;802;584;218;0;1;583;584
8;Barcelona;6;Anoia;08044;Capellades;2;1;1;;887;690;197;7;0;683;683
8;Barcelona;6;Anoia;08044;Capellades;2;1;2;;930;714;216;3;2;709;711
17;Girona;2;Alt Empordà;17042;Capmany;1;1;1;;413;279;134;1;0;278;278
8;Barcelona;14;Berguedà;08045;Capolat;1;1;1;;87;36;51;0;0;36;36
8;Barcelona;41;Vallès Oriental;08046;Cardedeu;1;1;1;;1007;700;307;0;3;697;700
8;Barcelona;41;Vallès Oriental;08046;Cardedeu;1;1;2;;994;649;345;3;3;643;646
8;Barcelona;41;Vallès Oriental;08046;Cardedeu;1;2;1;;203;125;78;0;0;125;125
8;Barcelona;41;Vallès Oriental;08046;Cardedeu;2;1;1;;881;622;259;3;1;618;619
8;Barcelona;41;Vallès Oriental;08046;Cardedeu;2;1;2;;854;634;220;2;4;628;632
8;Barcelona;41;Vallès Oriental;08046;Cardedeu;2;2;1;;698;498;200;3;2;493;495
8;Barcelona;41;Vallès Oriental;08046;Cardedeu;2;2;2;;736;505;231;3;0;502;502
8;Barcelona;7;Bages;08047;Cardona;1;1;1;;909;647;262;1;2;644;646
8;Barcelona;7;Bages;08047;Cardona;1;1;2;;905;656;249;1;5;650;655
8;Barcelona;7;Bages;08047;Cardona;1;2;1;;1481;1021;460;2;6;1013;1019
8;Barcelona;7;Bages;08047;Cardona;2;1;1;;607;403;204;1;1;401;402
8;Barcelona;7;Bages;08047;Cardona;2;2;1;;888;590;298;3;4;583;587
8;Barcelona;7;Bages;08047;Cardona;2;3;1;;610;428;182;0;5;423;428
8;Barcelona;6;Anoia;08048;Carme;1;1;1;;564;449;115;2;2;445;447
43;Tarragona;37;Terra Alta;43041;Caseres;1;1;1;;288;222;66;2;0;220;220
17;Girona;20;Gironès;17044;Cassà de la Selva;1;1;1;;734;521;213;7;4;510;514
17;Girona;20;Gironès;17044;Cassà de la Selva;1;2;1;;1033;705;328;4;4;697;701
17;Girona;20;Gironès;17044;Cassà de la Selva;2;1;1;;706;510;196;7;1;502;503
17;Girona;20;Gironès;17044;Cassà de la Selva;2;1;2;;672;527;145;7;3;517;520
17;Girona;20;Gironès;17044;Cassà de la Selva;2;2;1;;708;516;192;4;3;509;512
17;Girona;20;Gironès;17044;Cassà de la Selva;2;2;2;;706;518;188;9;1;508;509
17;Girona;20;Gironès;17044;Cassà de la Selva;2;3;1;;652;453;199;6;6;441;447
8;Barcelona;14;Berguedà;08049;Casserres;1;1;1;;1040;745;295;7;4;734;738
8;Barcelona;14;Berguedà;08049;Casserres;1;2;1;;412;317;95;1;1;315;316
25;Lleida;35;Solsonès;25064;Castellar de la Ribera;1;1;1;;141;105;36;0;0;105;105
8;Barcelona;14;Berguedà;08050;Castellar del Riu;1;1;1;;47;18;29;0;0;18;18
8;Barcelona;40;Vallès Occidental;08051;Castellar del Vallès;1;1;1;;1053;744;309;0;0;744;744
8;Barcelona;40;Vallès Occidental;08051;Castellar del Vallès;1;2;1;;849;611;238;0;2;609;611
8;Barcelona;40;Vallès Occidental;08051;Castellar del Vallès;1;2;2;;918;640;278;2;2;636;638
8;Barcelona;40;Vallès Occidental;08051;Castellar del Vallès;1;3;1;;967;722;245;1;6;715;721
8;Barcelona;40;Vallès Occidental;08051;Castellar del Vallès;1;4;1;;737;539;198;0;0;539;539
8;Barcelona;40;Vallès Occidental;08051;Castellar del Vallès;1;4;2;;710;492;218;0;1;491;492
8;Barcelona;40;Vallès Occidental;08051;Castellar del Vallès;1;5;1;;1176;880;296;2;4;874;878
8;Barcelona;40;Vallès Occidental;08051;Castellar del Vallès;1;5;2;;1266;887;379;1;4;882;886
8;Barcelona;40;Vallès Occidental;08051;Castellar del Vallès;1;6;1;;605;436;169;2;0;434;434
8;Barcelona;14;Berguedà;08052;Castellar de n'Hug;1;1;1;;150;121;29;2;0;119;119
8;Barcelona;7;Bages;08053;Castellbell i el Vilar;1;1;1;;988;616;372;3;0;613;613
8;Barcelona;7;Bages;08053;Castellbell i el Vilar;1;1;2;;1248;848;400;2;1;845;846
8;Barcelona;7;Bages;08053;Castellbell i el Vilar;1;2;1;;379;159;220;0;0;159;159
8;Barcelona;40;Vallès Occidental;08054;Castellbisbal;1;1;1;;585;459;126;3;2;454;456
8;Barcelona;40;Vallès Occidental;08054;Castellbisbal;1;1;2;;604;476;128;1;1;474;475
8;Barcelona;40;Vallès Occidental;08054;Castellbisbal;1;2;1;;583;431;152;2;2;427;429
8;Barcelona;40;Vallès Occidental;08054;Castellbisbal;1;2;2;;612;459;153;1;1;457;458
8;Barcelona;;;08055;Castellcir;1;1;1;;161;130;31;2;0;128;128
25;Lleida;18;Garrigues;25067;Castelldans;1;1;1;;890;561;329;0;3;558;561
8;Barcelona;11;Baix Llobregat;08056;Castelldefels;1;1;1;;735;443;292;4;0;439;439
8;Barcelona;11;Baix Llobregat;08056;Castelldefels;1;2;1;;1238;759;479;1;0;758;758
8;Barcelona;11;Baix Llobregat;08056;Castelldefels;1;3;1;;1029;628;401;9;7;612;619
8;Barcelona;11;Baix Llobregat;08056;Castelldefels;1;4;1;;1100;526;574;2;8;516;524
8;Barcelona;11;Baix Llobregat;08056;Castelldefels;1;4;2;;1191;600;591;3;6;591;597
8;Barcelona;11;Baix Llobregat;08056;Castelldefels;1;4;3;;1167;578;589;2;2;574;576
8;Barcelona;11;Baix Llobregat;08056;Castelldefels;2;1;1;;1050;604;446;2;3;599;602
8;Barcelona;11;Baix Llobregat;08056;Castelldefels;2;2;1;;828;502;326;5;3;494;497
8;Barcelona;11;Baix Llobregat;08056;Castelldefels;2;2;2;;782;498;284;1;3;494;497
8;Barcelona;11;Baix Llobregat;08056;Castelldefels;2;3;1;;1069;654;415;0;5;649;654
8;Barcelona;11;Baix Llobregat;08056;Castelldefels;2;4;1;;996;583;413;1;3;579;582
8;Barcelona;11;Baix Llobregat;08056;Castelldefels;2;4;2;;876;521;355;2;3;516;519
8;Barcelona;11;Baix Llobregat;08056;Castelldefels;3;1;1;;761;439;322;5;1;433;434
8;Barcelona;11;Baix Llobregat;08056;Castelldefels;3;1;2;;876;547;329;2;3;542;545
8;Barcelona;11;Baix Llobregat;08056;Castelldefels;3;1;3;;860;492;368;1;2;489;491
8;Barcelona;11;Baix Llobregat;08056;Castelldefels;4;1;1;;1020;549;471;3;4;542;546
8;Barcelona;11;Baix Llobregat;08056;Castelldefels;4;1;2;;920;544;376;2;1;541;542
8;Barcelona;11;Baix Llobregat;08056;Castelldefels;5;1;1;;1421;660;761;0;5;655;660
8;Barcelona;14;Berguedà;08057;Castell de l'Areny;1;1;1;;35;26;9;0;1;25;26
25;Lleida;25;Pallars Jussà;25904;Castell de Mur;1;1;1;;170;103;67;0;0;103;103
8;Barcelona;3;Alt Penedès;08058;Castellet i la Gornal;1;1;1;;421;236;185;6;2;228;230
8;Barcelona;3;Alt Penedès;08058;Castellet i la Gornal;1;2;1;;416;307;109;6;6;295;301
17;Girona;19;Garrotxa;17046;Castellfollit de la Roca;1;1;1;;491;405;86;3;8;394;402
17;Girona;19;Garrotxa;17046;Castellfollit de la Roca;1;1;2;;431;363;68;0;4;359;363
8;Barcelona;7;Bages;08059;Castellfollit del Boix;1;1;1;;259;164;95;0;1;163;164
8;Barcelona;6;Anoia;08060;Castellfollit de Riubregós;1;1;1;;227;204;23;0;0;204;204
8;Barcelona;7;Bages;08061;Castellgalí;1;1;1;;535;438;97;1;2;435;437
8;Barcelona;7;Bages;08062;Castellnou de Bages;1;1;1;;63;53;10;0;0;53;53
25;Lleida;27;Pla d'Urgell;25068;Castellnou de Seana;1;1;1;;633;404;229;2;3;399;402
17;Girona;2;Alt Empordà;17047;Castelló d'Empúries;1;1;1;;747;571;176;5;1;565;566
17;Girona;2;Alt Empordà;17047;Castelló d'Empúries;1;2;1;;951;719;232;3;2;714;716
17;Girona;2;Alt Empordà;17047;Castelló d'Empúries;1;3;1;;340;182;158;0;0;182;182
25;Lleida;23;Noguera;25069;Castelló de Farfanya;1;1;1;;577;416;161;0;0;416;416
8;Barcelona;6;Anoia;08063;Castellolí;1;1;1;;336;244;92;0;0;244;244
17;Girona;10;Baix Empordà;17048;Castell-Platja d'Aro;1;1;1;;610;446;164;1;0;445;445
17;Girona;10;Baix Empordà;17048;Castell-Platja d'Aro;1;2;1;;1095;719;376;0;5;714;719
17;Girona;10;Baix Empordà;17048;Castell-Platja d'Aro;1;2;2;;1022;699;323;8;4;687;691
25;Lleida;38;Urgell;25070;Castellserà;1;1;1;;992;659;333;3;3;653;656
8;Barcelona;;;08064;Castellterçol;1;1;1;;829;664;165;9;4;651;655
8;Barcelona;;;08064;Castellterçol;1;1;2;;712;589;123;4;1;584;585
43;Tarragona;8;Baix Camp;43042;Castellvell del Camp;1;1;1;;494;363;131;1;3;359;362
8;Barcelona;3;Alt Penedès;08065;Castellví de la Marca;1;1;1;;1066;649;417;4;3;642;645
8;Barcelona;11;Baix Llobregat;08066;Castellví de Rosanes;1;1;1;;285;209;76;1;0;208;208
43;Tarragona;36;Tarragonès;43043;Catllar, el;1;1;1;;621;517;104;5;1;511;512
25;Lleida;4;Alt Urgell;25071;Cava;1;1;1;;66;33;33;0;0;33;33
17;Girona;34;Selva;17189;Cellera de Ter, la;1;1;1;;833;653;180;2;4;647;651
17;Girona;34;Selva;17189;Cellera de Ter, la;1;2;1;;711;547;164;9;1;537;538
17;Girona;20;Gironès;17049;Celrà;1;1;1;;1626;1112;514;10;0;1102;1102
8;Barcelona;24;Osona;08067;Centelles;1;1;1;;1033;758;275;2;2;754;756
8;Barcelona;24;Osona;08067;Centelles;1;2;1;;1040;745;295;2;6;737;743
8;Barcelona;24;Osona;08067;Centelles;1;3;1;;987;682;305;1;3;678;681
8;Barcelona;24;Osona;08067;Centelles;1;4;1;;1285;876;409;2;4;870;874
8;Barcelona;14;Berguedà;08268;Cercs;1;1;1;;440;294;146;0;0;294;294
8;Barcelona;14;Berguedà;08268;Cercs;1;2;1;;685;526;159;3;1;522;523
8;Barcelona;14;Berguedà;08268;Cercs;1;2;2;;200;142;58;7;0;135;135
8;Barcelona;14;Berguedà;08268;Cercs;2;1;1;;213;142;71;0;0;142;142
8;Barcelona;40;Vallès Occidental;08266;Cerdanyola del Vallès;1;1;1;;1405;829;576;19;4;806;810
8;Barcelona;40;Vallès Occidental;08266;Cerdanyola del Vallès;1;10;1;;739;429;310;0;3;426;429
8;Barcelona;40;Vallès Occidental;08266;Cerdanyola del Vallès;1;10;2;;867;527;340;3;1;523;524
8;Barcelona;40;Vallès Occidental;08266;Cerdanyola del Vallès;1;11;1;;653;276;377;1;2;273;275
8;Barcelona;40;Vallès Occidental;08266;Cerdanyola del Vallès;1;12;1;;854;537;317;1;1;535;536
8;Barcelona;40;Vallès Occidental;08266;Cerdanyola del Vallès;1;12;2;;844;545;299;2;0;543;543
8;Barcelona;40;Vallès Occidental;08266;Cerdanyola del Vallès;1;13;1;;822;473;349;0;2;471;473
8;Barcelona;40;Vallès Occidental;08266;Cerdanyola del Vallès;1;13;2;;766;429;337;1;2;426;428
8;Barcelona;40;Vallès Occidental;08266;Cerdanyola del Vallès;1;14;1;;1491;883;608;0;14;869;883
8;Barcelona;40;Vallès Occidental;08266;Cerdanyola del Vallès;1;15;1;;817;427;390;0;1;426;427
8;Barcelona;40;Vallès Occidental;08266;Cerdanyola del Vallès;1;15;2;;757;410;347;0;5;405;410
8;Barcelona;40;Vallès Occidental;08266;Cerdanyola del Vallès;1;16;1;;1333;791;542;3;3;785;788
8;Barcelona;40;Vallès Occidental;08266;Cerdanyola del Vallès;1;17;1;;683;376;307;3;0;373;373
8;Barcelona;40;Vallès Occidental;08266;Cerdanyola del Vallès;1;17;2;;747;380;367;1;5;374;379
8;Barcelona;40;Vallès Occidental;08266;Cerdanyola del Vallès;1;17;3;;786;419;367;1;0;418;418
8;Barcelona;40;Vallès Occidental;08266;Cerdanyola del Vallès;1;17;4;;802;429;373;1;0;428;428
8;Barcelona;40;Vallès Occidental;08266;Cerdanyola del Vallès;1;18;1;;1046;607;439;0;5;602;607
8;Barcelona;40;Vallès Occidental;08266;Cerdanyola del Vallès;1;19;1;;811;589;222;5;2;582;584
8;Barcelona;40;Vallès Occidental;08266;Cerdanyola del Vallès;1;2;1;;1252;673;579;1;2;670;672
8;Barcelona;40;Vallès Occidental;08266;Cerdanyola del Vallès;1;20;1;;1049;451;598;2;3;446;449
8;Barcelona;40;Vallès Occidental;08266;Cerdanyola del Vallès;1;21;1;;833;391;442;1;0;390;390
8;Barcelona;40;Vallès Occidental;08266;Cerdanyola del Vallès;1;22;1;;1134;537;597;0;1;536;537
8;Barcelona;40;Vallès Occidental;08266;Cerdanyola del Vallès;1;23;1;;1112;489;623;3;4;482;486
8;Barcelona;40;Vallès Occidental;08266;Cerdanyola del Vallès;1;24;1;;1046;452;594;1;0;451;451
8;Barcelona;40;Vallès Occidental;08266;Cerdanyola del Vallès;1;25;1;;1470;534;936;2;1;531;532
8;Barcelona;40;Vallès Occidental;08266;Cerdanyola del Vallès;1;3;1;;1374;777;597;6;4;767;771
8;Barcelona;40;Vallès Occidental;08266;Cerdanyola del Vallès;1;4;1;;930;485;445;1;4;480;484
8;Barcelona;40;Vallès Occidental;08266;Cerdanyola del Vallès;1;4;2;;871;485;386;4;2;479;481
8;Barcelona;40;Vallès Occidental;08266;Cerdanyola del Vallès;1;5;1;;947;517;430;2;3;512;515
8;Barcelona;40;Vallès Occidental;08266;Cerdanyola del Vallès;1;5;2;;869;433;436;0;5;428;433
8;Barcelona;40;Vallès Occidental;08266;Cerdanyola del Vallès;1;6;1;;763;390;373;8;3;379;382
8;Barcelona;40;Vallès Occidental;08266;Cerdanyola del Vallès;1;7;1;;945;540;405;14;1;525;526
8;Barcelona;40;Vallès Occidental;08266;Cerdanyola del Vallès;1;7;2;;882;465;417;3;3;459;462
8;Barcelona;40;Vallès Occidental;08266;Cerdanyola del Vallès;1;8;1;;755;418;337;2;1;415;416
8;Barcelona;40;Vallès Occidental;08266;Cerdanyola del Vallès;1;8;2;;840;491;349;1;3;487;490
8;Barcelona;40;Vallès Occidental;08266;Cerdanyola del Vallès;1;9;1;;1374;804;570;14;0;790;790
8;Barcelona;11;Baix Llobregat;08068;Cervelló;1;1;1;;1061;627;434;2;4;621;625
8;Barcelona;11;Baix Llobregat;08068;Cervelló;1;1;2;;1051;630;421;1;1;628;629
8;Barcelona;11;Baix Llobregat;08068;Cervelló;1;2;1;;839;566;273;3;0;563;563
25;Lleida;32;Segarra;25072;Cervera;1;1;1;;757;511;246;7;1;503;504
25;Lleida;32;Segarra;25072;Cervera;1;2;1;;713;455;258;1;2;452;454
25;Lleida;32;Segarra;25072;Cervera;2;1;1;;738;468;270;0;0;468;468
25;Lleida;32;Segarra;25072;Cervera;2;1;2;;657;524;133;2;2;520;522
25;Lleida;32;Segarra;25072;Cervera;2;2;1;;1079;716;363;3;5;708;713
25;Lleida;32;Segarra;25072;Cervera;2;2;2;;1030;693;337;2;7;684;691
25;Lleida;32;Segarra;25072;Cervera;3;1;1;;133;91;42;0;1;90;91
25;Lleida;18;Garrigues;25073;Cervià de les Garrigues;1;1;1;;771;538;233;1;2;535;537
17;Girona;20;Gironès;17050;Cervià de Ter;1;1;1;;504;395;109;1;2;392;394
17;Girona;2;Alt Empordà;17051;Cistella;1;1;1;;176;124;52;1;0;123;123
25;Lleida;38;Urgell;25074;Ciutadilla;1;1;1;;233;149;84;0;0;149;149
25;Lleida;35;Solsonès;25075;Clariana de Cardener;1;1;1;;155;112;43;0;0;112;112
25;Lleida;18;Garrigues;25076;Cogul, el;1;1;1;;228;117;111;0;0;117;117
17;Girona;2;Alt Empordà;17054;Colera;1;1;1;;368;259;109;6;2;251;253
8;Barcelona;11;Baix Llobregat;08069;Collbató;1;1;1;;459;337;122;3;3;331;334
43;Tarragona;8;Baix Camp;43045;Colldejou;1;1;1;;131;74;57;1;1;72;73
25;Lleida;4;Alt Urgell;25077;Coll de Nargó;1;1;1;;671;373;298;0;0;373;373
8;Barcelona;;;08070;Collsuspina;1;1;1;;250;134;116;1;1;132;133
17;Girona;10;Baix Empordà;17055;Colomers;1;1;1;;187;143;44;1;0;142;142
25;Lleida;35;Solsonès;25163;Coma i la Pedra, la;1;1;1;;210;123;87;0;1;122;123
25;Lleida;25;Pallars Jussà;25161;Conca de Dalt;1;1;1;;461;208;253;0;0;208;208
43;Tarragona;16;Conca de Barberà;43046;Conesa;1;1;1;;123;68;55;0;1;67;68
43;Tarragona;36;Tarragonès;43047;Constantí;1;1;1;;489;370;119;4;4;362;366
43;Tarragona;36;Tarragonès;43047;Constantí;1;2;1;;971;559;412;5;5;549;554
43;Tarragona;36;Tarragonès;43047;Constantí;1;2;2;;978;590;388;6;2;582;584
43;Tarragona;36;Tarragonès;43047;Constantí;2;1;1;;592;391;201;2;2;387;389
43;Tarragona;36;Tarragonès;43047;Constantí;2;1;2;;764;517;247;9;1;507;508
8;Barcelona;6;Anoia;08071;Copons;1;1;1;;271;190;81;0;0;190;190
43;Tarragona;37;Terra Alta;43048;Corbera d'Ebre;1;1;1;;981;625;356;1;2;622;624
8;Barcelona;11;Baix Llobregat;08072;Corbera de Llobregat;1;1;1;;942;671;271;1;2;668;670
8;Barcelona;11;Baix Llobregat;08072;Corbera de Llobregat;1;1;2;;496;332;164;0;1;331;332
8;Barcelona;11;Baix Llobregat;08072;Corbera de Llobregat;1;1;3;;792;538;254;2;1;535;536
25;Lleida;33;Segrià;25078;Corbins;1;1;1;;817;490;327;0;4;486;490
17;Girona;10;Baix Empordà;17057;Corçà;1;1;1;;858;580;278;1;4;575;579
8;Barcelona;11;Baix Llobregat;08073;Cornellà de Llobregat;1;1;1;;696;364;332;1;1;362;363
8;Barcelona;11;Baix Llobregat;08073;Cornellà de Llobregat;1;1;2;;598;402;196;5;3;394;397
8;Barcelona;11;Baix Llobregat;08073;Cornellà de Llobregat;1;10;1;;997;634;363;1;5;628;633
8;Barcelona;11;Baix Llobregat;08073;Cornellà de Llobregat;1;11;1;;866;442;424;1;4;437;441
8;Barcelona;11;Baix Llobregat;08073;Cornellà de Llobregat;1;12;1;;850;436;414;0;2;434;436
8;Barcelona;11;Baix Llobregat;08073;Cornellà de Llobregat;1;13;1;;948;589;359;4;3;582;585
8;Barcelona;11;Baix Llobregat;08073;Cornellà de Llobregat;1;14;1;;681;453;228;0;3;450;453
8;Barcelona;11;Baix Llobregat;08073;Cornellà de Llobregat;1;15;1;;544;345;199;0;1;344;345
8;Barcelona;11;Baix Llobregat;08073;Cornellà de Llobregat;1;15;2;;567;343;224;3;0;340;340
8;Barcelona;11;Baix Llobregat;08073;Cornellà de Llobregat;1;2;1;;247;169;78;3;2;164;166
8;Barcelona;11;Baix Llobregat;08073;Cornellà de Llobregat;1;3;1;;601;322;279;5;0;317;317
8;Barcelona;11;Baix Llobregat;08073;Cornellà de Llobregat;1;3;2;;555;294;261;0;1;293;294
8;Barcelona;11;Baix Llobregat;08073;Cornellà de Llobregat;1;4;1;;941;573;368;0;14;559;573
8;Barcelona;11;Baix Llobregat;08073;Cornellà de Llobregat;1;5;1;;731;450;281;0;1;449;450
8;Barcelona;11;Baix Llobregat;08073;Cornellà de Llobregat;1;6;1;;507;336;171;2;1;333;334
8;Barcelona;11;Baix Llobregat;08073;Cornellà de Llobregat;1;7;1;;574;374;200;1;2;371;373
8;Barcelona;11;Baix Llobregat;08073;Cornellà de Llobregat;1;7;2;;580;389;191;1;3;385;388
8;Barcelona;11;Baix Llobregat;08073;Cornellà de Llobregat;1;8;1;;947;583;364;2;1;580;581
8;Barcelona;11;Baix Llobregat;08073;Cornellà de Llobregat;1;9;1;;938;631;307;2;0;629;629
8;Barcelona;11;Baix Llobregat;08073;Cornellà de Llobregat;2;1;1;;282;161;121;5;0;156;156
8;Barcelona;11;Baix Llobregat;08073;Cornellà de Llobregat;2;2;1;;762;439;323;16;2;421;423
8;Barcelona;11;Baix Llobregat;08073;Cornellà de Llobregat;2;2;2;;689;396;293;16;0;380;380
8;Barcelona;11;Baix Llobregat;08073;Cornellà de Llobregat;2;3;1;;247;180;67;6;0;174;174
8;Barcelona;11;Baix Llobregat;08073;Cornellà de Llobregat;3;1;1;;956;612;344;0;3;609;612
8;Barcelona;11;Baix Llobregat;08073;Cornellà de Llobregat;3;2;1;;578;409;169;6;0;403;403
8;Barcelona;11;Baix Llobregat;08073;Cornellà de Llobregat;3;2;2;;519;306;213;0;0;306;306
8;Barcelona;11;Baix Llobregat;08073;Cornellà de Llobregat;3;3;1;;639;367;272;3;0;364;364
8;Barcelona;11;Baix Llobregat;08073;Cornellà de Llobregat;3;4;1;;434;270;164;17;0;253;253
8;Barcelona;11;Baix Llobregat;08073;Cornellà de Llobregat;3;5;1;;603;357;246;4;5;348;353
8;Barcelona;11;Baix Llobregat;08073;Cornellà de Llobregat;3;6;1;;724;466;258;2;1;463;464
8;Barcelona;11;Baix Llobregat;08073;Cornellà de Llobregat;3;7;1;;998;627;371;1;0;626;626
8;Barcelona;11;Baix Llobregat;08073;Cornellà de Llobregat;3;8;1;;795;458;337;2;2;454;456
8;Barcelona;11;Baix Llobregat;08073;Cornellà de Llobregat;3;9;1;;438;281;157;6;1;274;275
8;Barcelona;11;Baix Llobregat;08073;Cornellà de Llobregat;4;1;1;;573;375;198;2;0;373;373
8;Barcelona;11;Baix Llobregat;08073;Cornellà de Llobregat;4;1;2;;553;351;202;1;2;348;350
8;Barcelona;11;Baix Llobregat;08073;Cornellà de Llobregat;4;10;1;;522;343;179;0;0;343;343
8;Barcelona;11;Baix Llobregat;08073;Cornellà de Llobregat;4;10;2;;498;346;152;0;1;345;346
8;Barcelona;11;Baix Llobregat;08073;Cornellà de Llobregat;4;11;1;;1010;599;411;1;4;594;598
8;Barcelona;11;Baix Llobregat;08073;Cornellà de Llobregat;4;12;1;;757;491;266;0;2;489;491
8;Barcelona;11;Baix Llobregat;08073;Cornellà de Llobregat;4;12;2;;742;468;274;0;1;467;468
8;Barcelona;11;Baix Llobregat;08073;Cornellà de Llobregat;4;13;1;;685;435;250;2;4;429;433
8;Barcelona;11;Baix Llobregat;08073;Cornellà de Llobregat;4;13;2;;656;439;217;2;0;437;437
8;Barcelona;11;Baix Llobregat;08073;Cornellà de Llobregat;4;14;1;;984;574;410;3;2;569;571
8;Barcelona;11;Baix Llobregat;08073;Cornellà de Llobregat;4;15;1;;906;582;324;2;1;579;580
8;Barcelona;11;Baix Llobregat;08073;Cornellà de Llobregat;4;16;1;;640;410;230;6;3;401;404
8;Barcelona;11;Baix Llobregat;08073;Cornellà de Llobregat;4;16;2;;539;345;194;6;0;339;339
8;Barcelona;11;Baix Llobregat;08073;Cornellà de Llobregat;4;17;1;;581;351;230;0;0;351;351
8;Barcelona;11;Baix Llobregat;08073;Cornellà de Llobregat;4;17;2;;507;296;211;0;0;296;296
8;Barcelona;11;Baix Llobregat;08073;Cornellà de Llobregat;4;18;1;;794;438;356;1;0;437;437
8;Barcelona;11;Baix Llobregat;08073;Cornellà de Llobregat;4;19;1;;856;554;302;1;4;549;553
8;Barcelona;11;Baix Llobregat;08073;Cornellà de Llobregat;4;2;1;;654;394;260;3;1;390;391
8;Barcelona;11;Baix Llobregat;08073;Cornellà de Llobregat;4;3;1;;686;385;301;1;5;379;384
8;Barcelona;11;Baix Llobregat;08073;Cornellà de Llobregat;4;3;2;;663;376;287;2;2;372;374
8;Barcelona;11;Baix Llobregat;08073;Cornellà de Llobregat;4;4;1;;623;394;229;2;6;386;392
8;Barcelona;11;Baix Llobregat;08073;Cornellà de Llobregat;4;4;2;;589;358;231;1;3;354;357
8;Barcelona;11;Baix Llobregat;08073;Cornellà de Llobregat;4;5;1;;916;591;325;2;0;589;589
8;Barcelona;11;Baix Llobregat;08073;Cornellà de Llobregat;4;6;1;;727;446;281;6;2;438;440
8;Barcelona;11;Baix Llobregat;08073;Cornellà de Llobregat;4;6;2;;566;380;186;0;0;380;380
8;Barcelona;11;Baix Llobregat;08073;Cornellà de Llobregat;4;7;1;;951;596;355;1;6;589;595
8;Barcelona;11;Baix Llobregat;08073;Cornellà de Llobregat;4;8;1;;699;413;286;0;0;413;413
8;Barcelona;11;Baix Llobregat;08073;Cornellà de Llobregat;4;8;2;;599;350;249;0;0;350;350
8;Barcelona;11;Baix Llobregat;08073;Cornellà de Llobregat;4;9;1;;795;501;294;9;0;492;492
8;Barcelona;11;Baix Llobregat;08073;Cornellà de Llobregat;5;1;1;;783;461;322;0;1;460;461
8;Barcelona;11;Baix Llobregat;08073;Cornellà de Llobregat;5;10;1;;341;194;147;0;0;194;194
8;Barcelona;11;Baix Llobregat;08073;Cornellà de Llobregat;5;11;1;;818;508;310;2;2;504;506
8;Barcelona;11;Baix Llobregat;08073;Cornellà de Llobregat;5;2;1;;816;385;431;2;0;383;383
8;Barcelona;11;Baix Llobregat;08073;Cornellà de Llobregat;5;3;1;;621;342;279;2;0;340;340
8;Barcelona;11;Baix Llobregat;08073;Cornellà de Llobregat;5;3;2;;439;223;216;1;0;222;222
8;Barcelona;11;Baix Llobregat;08073;Cornellà de Llobregat;5;4;1;;867;510;357;13;1;496;497
8;Barcelona;11;Baix Llobregat;08073;Cornellà de Llobregat;5;5;1;;922;542;380;0;3;539;542
8;Barcelona;11;Baix Llobregat;08073;Cornellà de Llobregat;5;6;1;;570;334;236;0;1;333;334
8;Barcelona;11;Baix Llobregat;08073;Cornellà de Llobregat;5;6;2;;497;290;207;3;1;286;287
8;Barcelona;11;Baix Llobregat;08073;Cornellà de Llobregat;5;7;1;;613;365;248;0;3;362;365
8;Barcelona;11;Baix Llobregat;08073;Cornellà de Llobregat;5;7;2;;542;306;236;0;5;301;306
8;Barcelona;11;Baix Llobregat;08073;Cornellà de Llobregat;5;8;1;;943;561;382;3;3;555;558
8;Barcelona;11;Baix Llobregat;08073;Cornellà de Llobregat;5;9;1;;830;485;345;1;0;484;484
8;Barcelona;11;Baix Llobregat;08073;Cornellà de Llobregat;6;1;1;;628;303;325;3;4;296;300
8;Barcelona;11;Baix Llobregat;08073;Cornellà de Llobregat;6;10;1;;857;553;304;0;0;553;553
8;Barcelona;11;Baix Llobregat;08073;Cornellà de Llobregat;6;11;1;;593;336;257;0;0;336;336
8;Barcelona;11;Baix Llobregat;08073;Cornellà de Llobregat;6;12;1;;670;350;320;0;0;350;350
8;Barcelona;11;Baix Llobregat;08073;Cornellà de Llobregat;6;13;1;;735;435;300;6;5;424;429
8;Barcelona;11;Baix Llobregat;08073;Cornellà de Llobregat;6;14;1;;853;497;356;2;0;495;495
8;Barcelona;11;Baix Llobregat;08073;Cornellà de Llobregat;6;15;1;;691;380;311;4;2;374;376
8;Barcelona;11;Baix Llobregat;08073;Cornellà de Llobregat;6;16;1;;669;361;308;0;0;361;361
8;Barcelona;11;Baix Llobregat;08073;Cornellà de Llobregat;6;2;1;;596;316;280;7;2;307;309
8;Barcelona;11;Baix Llobregat;08073;Cornellà de Llobregat;6;2;2;;537;351;186;2;1;348;349
8;Barcelona;11;Baix Llobregat;08073;Cornellà de Llobregat;6;3;1;;589;361;228;0;0;361;361
8;Barcelona;11;Baix Llobregat;08073;Cornellà de Llobregat;6;4;1;;658;376;282;8;1;367;368
8;Barcelona;11;Baix Llobregat;08073;Cornellà de Llobregat;6;5;1;;816;481;335;16;3;462;465
8;Barcelona;11;Baix Llobregat;08073;Cornellà de Llobregat;6;6;1;;645;388;257;11;0;377;377
8;Barcelona;11;Baix Llobregat;08073;Cornellà de Llobregat;6;7;1;;962;601;361;0;2;599;601
8;Barcelona;11;Baix Llobregat;08073;Cornellà de Llobregat;6;8;1;;706;395;311;1;0;394;394
8;Barcelona;11;Baix Llobregat;08073;Cornellà de Llobregat;6;9;1;;871;542;329;3;1;538;539
8;Barcelona;11;Baix Llobregat;08073;Cornellà de Llobregat;6;9;2;;859;522;337;2;0;520;520
17;Girona;28;Pla de l'Estany;17056;Cornellà del Terri;1;1;1;;755;534;221;12;0;522;522
17;Girona;28;Pla de l'Estany;17056;Cornellà del Terri;1;1;2;;589;410;179;11;0;399;399
43;Tarragona;29;Priorat;43049;Cornudella de Montsant;1;1;1;;785;617;168;12;3;602;605
43;Tarragona;36;Tarragonès;43050;Creixell;1;1;1;;435;315;120;4;0;311;311
17;Girona;28;Pla de l'Estany;17058;Crespià;1;1;1;;180;113;67;1;1;111;112
17;Girona;10;Baix Empordà;17901;Cruïlles, Monells i Sant Sadurní;1;1;1;;219;164;55;0;0;164;164
17;Girona;10;Baix Empordà;17901;Cruïlles, Monells i Sant Sadurní;1;2;1;;367;234;133;0;1;233;234
17;Girona;10;Baix Empordà;17901;Cruïlles, Monells i Sant Sadurní;1;3;1;;220;161;59;0;0;161;161
8;Barcelona;17;Garraf;08074;Cubelles;1;1;1;;839;567;272;2;3;562;565
8;Barcelona;17;Garraf;08074;Cubelles;1;1;2;;851;588;263;3;4;581;585
25;Lleida;23;Noguera;25079;Cubells;1;1;1;;388;276;112;0;0;276;276
43;Tarragona;12;Baix Penedès;43051;Cunit;1;1;1;;666;406;260;9;2;395;397
17;Girona;2;Alt Empordà;17060;Darnius;1;1;1;;364;270;94;4;0;266;266
17;Girona;15;Cerdanya;17061;Das;1;1;1;;100;79;21;0;0;79;79
43;Tarragona;9;Baix Ebre;43901;Deltebre;1;1;1;;710;387;323;0;11;376;387
43;Tarragona;9;Baix Ebre;43901;Deltebre;1;1;2;;573;296;277;4;6;286;292
43;Tarragona;9;Baix Ebre;43901;Deltebre;1;2;1;;887;444;443;4;5;435;440
43;Tarragona;9;Baix Ebre;43901;Deltebre;1;2;2;;656;319;337;2;3;314;317
43;Tarragona;9;Baix Ebre;43901;Deltebre;1;3;1;;959;525;434;1;3;521;524
43;Tarragona;9;Baix Ebre;43901;Deltebre;1;4;1;;1080;565;515;0;8;557;565
43;Tarragona;9;Baix Ebre;43901;Deltebre;1;5;1;;1059;594;465;6;6;582;588
43;Tarragona;9;Baix Ebre;43901;Deltebre;1;6;1;;769;411;358;2;7;402;409
43;Tarragona;9;Baix Ebre;43901;Deltebre;1;6;2;;514;260;254;2;0;258;258
8;Barcelona;21;Maresme;08075;Dosrius;1;1;1;;403;305;98;1;1;303;304
8;Barcelona;21;Maresme;08075;Dosrius;1;1;2;;230;173;57;0;0;173;173
43;Tarragona;8;Baix Camp;43053;Duesaigües;1;1;1;;156;130;26;1;2;127;129
17;Girona;2;Alt Empordà;17062;Escala, l';1;1;1;;1021;760;261;9;2;749;751
17;Girona;2;Alt Empordà;17062;Escala, l';1;2;1;;1237;879;358;6;9;864;873
17;Girona;2;Alt Empordà;17062;Escala, l';1;3;1;;811;594;217;8;7;579;586
8;Barcelona;11;Baix Llobregat;08076;Esparreguera;1;1;1;;565;377;188;4;3;370;373
8;Barcelona;11;Baix Llobregat;08076;Esparreguera;1;1;2;;502;353;149;0;2;351;353
8;Barcelona;11;Baix Llobregat;08076;Esparreguera;1;2;1;;507;347;160;2;2;343;345
8;Barcelona;11;Baix Llobregat;08076;Esparreguera;1;2;2;;508;363;145;3;2;358;360
8;Barcelona;11;Baix Llobregat;08076;Esparreguera;1;3;1;;652;474;178;2;1;471;472
8;Barcelona;11;Baix Llobregat;08076;Esparreguera;1;3;2;;691;533;158;2;2;529;531
8;Barcelona;11;Baix Llobregat;08076;Esparreguera;1;4;1;;721;512;209;2;4;506;510
8;Barcelona;11;Baix Llobregat;08076;Esparreguera;1;4;2;;748;507;241;5;3;499;502
8;Barcelona;11;Baix Llobregat;08076;Esparreguera;1;5;1;;228;135;93;0;0;135;135
8;Barcelona;11;Baix Llobregat;08076;Esparreguera;2;1;1;;537;367;170;0;3;364;367
8;Barcelona;11;Baix Llobregat;08076;Esparreguera;2;1;2;;504;354;150;0;1;353;354
8;Barcelona;11;Baix Llobregat;08076;Esparreguera;2;2;1;;827;505;322;2;5;498;503
8;Barcelona;11;Baix Llobregat;08076;Esparreguera;2;3;1;;697;461;236;4;0;457;457
8;Barcelona;11;Baix Llobregat;08076;Esparreguera;2;4;1;;371;257;114;1;0;256;256
17;Girona;24;Osona;17063;Espinelves;1;1;1;;217;179;38;2;1;176;177
25;Lleida;18;Garrigues;25081;Espluga Calba, l';1;1;1;;393;235;158;0;2;233;235
43;Tarragona;16;Conca de Barberà;43054;Espluga de Francolí, l';1;1;1;;736;546;190;3;5;538;543
43;Tarragona;16;Conca de Barberà;43054;Espluga de Francolí, l';1;1;2;;877;637;240;4;5;628;633
43;Tarragona;16;Conca de Barberà;43054;Espluga de Francolí, l';2;1;1;;1093;769;324;8;2;759;761
8;Barcelona;11;Baix Llobregat;08077;Esplugues de Llobregat;1;1;1;;913;515;398;1;6;508;514
8;Barcelona;11;Baix Llobregat;08077;Esplugues de Llobregat;1;1;2;;876;531;345;2;3;526;529
8;Barcelona;11;Baix Llobregat;08077;Esplugues de Llobregat;1;2;1;;839;547;292;0;2;545;547
8;Barcelona;11;Baix Llobregat;08077;Esplugues de Llobregat;1;2;2;;768;513;255;1;2;510;512
8;Barcelona;11;Baix Llobregat;08077;Esplugues de Llobregat;1;3;1;;842;522;320;5;4;513;517
8;Barcelona;11;Baix Llobregat;08077;Esplugues de Llobregat;1;4;1;;1084;700;384;0;1;699;700
8;Barcelona;11;Baix Llobregat;08077;Esplugues de Llobregat;1;5;1;;694;474;220;0;4;470;474
8;Barcelona;11;Baix Llobregat;08077;Esplugues de Llobregat;1;6;1;;1083;671;412;0;4;667;671
8;Barcelona;11;Baix Llobregat;08077;Esplugues de Llobregat;1;7;1;;974;636;338;0;6;630;636
8;Barcelona;11;Baix Llobregat;08077;Esplugues de Llobregat;2;1;1;;587;367;220;0;0;367;367
8;Barcelona;11;Baix Llobregat;08077;Esplugues de Llobregat;2;2;1;;563;335;228;2;0;333;333
8;Barcelona;11;Baix Llobregat;08077;Esplugues de Llobregat;3;1;1;;879;529;350;3;1;525;526
8;Barcelona;11;Baix Llobregat;08077;Esplugues de Llobregat;3;1;2;;794;481;313;0;0;481;481
8;Barcelona;11;Baix Llobregat;08077;Esplugues de Llobregat;3;2;1;;636;331;305;1;1;329;330
8;Barcelona;11;Baix Llobregat;08077;Esplugues de Llobregat;3;2;2;;620;351;269;0;1;350;351
8;Barcelona;11;Baix Llobregat;08077;Esplugues de Llobregat;3;3;1;;958;546;412;0;5;541;546
8;Barcelona;11;Baix Llobregat;08077;Esplugues de Llobregat;3;3;2;;810;492;318;1;1;490;491
8;Barcelona;11;Baix Llobregat;08077;Esplugues de Llobregat;3;4;1;;743;441;302;0;0;441;441
8;Barcelona;11;Baix Llobregat;08077;Esplugues de Llobregat;3;4;2;;765;430;335;0;1;429;430
8;Barcelona;11;Baix Llobregat;08077;Esplugues de Llobregat;3;5;1;;760;416;344;8;0;408;408
8;Barcelona;11;Baix Llobregat;08077;Esplugues de Llobregat;3;5;2;;629;345;284;0;4;341;345
8;Barcelona;11;Baix Llobregat;08077;Esplugues de Llobregat;3;6;1;;803;477;326;2;0;475;475
8;Barcelona;11;Baix Llobregat;08077;Esplugues de Llobregat;3;6;2;;778;415;363;1;0;414;414
8;Barcelona;11;Baix Llobregat;08077;Esplugues de Llobregat;3;7;1;;941;501;440;8;0;493;493
8;Barcelona;11;Baix Llobregat;08077;Esplugues de Llobregat;3;7;2;;852;455;397;4;0;451;451
8;Barcelona;11;Baix Llobregat;08077;Esplugues de Llobregat;3;8;1;;1019;546;473;6;0;540;540
8;Barcelona;11;Baix Llobregat;08077;Esplugues de Llobregat;4;1;1;;979;627;352;4;0;623;623
8;Barcelona;11;Baix Llobregat;08077;Esplugues de Llobregat;4;2;1;;910;505;405;0;0;505;505
8;Barcelona;11;Baix Llobregat;08077;Esplugues de Llobregat;4;2;2;;797;473;324;1;3;469;472
8;Barcelona;11;Baix Llobregat;08077;Esplugues de Llobregat;4;3;1;;707;392;315;0;2;390;392
8;Barcelona;11;Baix Llobregat;08077;Esplugues de Llobregat;4;3;2;;701;396;305;1;4;391;395
8;Barcelona;11;Baix Llobregat;08077;Esplugues de Llobregat;4;4;1;;879;511;368;2;3;506;509
8;Barcelona;11;Baix Llobregat;08077;Esplugues de Llobregat;4;4;2;;830;473;357;0;3;470;473
8;Barcelona;11;Baix Llobregat;08077;Esplugues de Llobregat;4;5;1;;677;463;214;8;3;452;455
8;Barcelona;11;Baix Llobregat;08077;Esplugues de Llobregat;4;5;2;;636;411;225;1;1;409;410
8;Barcelona;11;Baix Llobregat;08077;Esplugues de Llobregat;4;6;1;;914;535;379;0;3;532;535
8;Barcelona;11;Baix Llobregat;08077;Esplugues de Llobregat;4;6;2;;510;305;205;6;2;297;299
8;Barcelona;11;Baix Llobregat;08077;Esplugues de Llobregat;4;6;3;;646;386;260;0;2;384;386
8;Barcelona;11;Baix Llobregat;08077;Esplugues de Llobregat;5;1;1;;849;448;401;0;3;445;448
8;Barcelona;11;Baix Llobregat;08077;Esplugues de Llobregat;5;1;2;;642;376;266;2;1;373;374
8;Barcelona;11;Baix Llobregat;08077;Esplugues de Llobregat;5;2;1;;812;498;314;1;2;495;497
17;Girona;2;Alt Empordà;17064;Espolla;1;1;1;;339;252;87;1;1;250;251
17;Girona;28;Pla de l'Estany;17065;Esponellà;1;1;1;;286;207;79;0;1;206;207
25;Lleida;26;Pallars Sobirà;25082;Espot;1;1;1;;193;113;80;0;2;111;113
8;Barcelona;14;Berguedà;08078;Espunyola, l';1;1;1;;244;177;67;0;0;177;177
8;Barcelona;24;Osona;08254;Esquirol, l';1;1;1;;1034;772;262;27;3;742;745
8;Barcelona;24;Osona;08254;Esquirol, l';1;2;1;;259;210;49;0;0;210;210
8;Barcelona;24;Osona;08254;Esquirol, l';1;3;1;;198;151;47;0;1;150;151
25;Lleida;4;Alt Urgell;25088;Estamariu;1;1;1;;118;94;24;0;0;94;94
8;Barcelona;;;08079;Estany, l';1;1;1;;295;245;50;0;0;245;245
25;Lleida;32;Segarra;25085;Estaràs;1;1;1;;181;116;65;0;2;114;116
25;Lleida;26;Pallars Sobirà;25086;Esterri d'Àneu;1;1;1;;465;325;140;2;2;321;323
25;Lleida;26;Pallars Sobirà;25087;Esterri de Cardós;1;1;1;;50;42;8;0;0;42;42
43;Tarragona;29;Priorat;43055;Falset;1;1;1;;1061;808;253;6;0;802;802
43;Tarragona;29;Priorat;43055;Falset;2;1;1;;962;670;292;8;5;657;662
17;Girona;2;Alt Empordà;17005;Far d'Empordà, el;1;1;1;;331;203;128;0;2;201;203
25;Lleida;26;Pallars Sobirà;25089;Farrera;1;1;1;;97;61;36;0;0;61;61
43;Tarragona;37;Terra Alta;43056;Fatarella, la;1;1;1;;569;296;273;4;3;289;292
43;Tarragona;37;Terra Alta;43056;Fatarella, la;1;2;1;;644;354;290;7;2;345;347
43;Tarragona;8;Baix Camp;43057;Febró, la;1;1;1;;31;22;9;0;0;22;22
8;Barcelona;41;Vallès Oriental;08134;Figaró-Montmany;1;1;1;;515;410;105;3;1;406;407
8;Barcelona;14;Berguedà;08080;Fígols;1;1;1;;41;22;19;0;0;22;22
25;Lleida;4;Alt Urgell;25908;Fígols i Alinyà;1;1;1;;173;126;47;0;0;126;126
25;Lleida;4;Alt Urgell;25908;Fígols i Alinyà;1;2;1;;180;130;50;0;0;130;130
43;Tarragona;29;Priorat;43058;Figuera, la;1;1;1;;129;82;47;1;0;81;81
17;Girona;2;Alt Empordà;17066;Figueres;1;1;1;;727;412;315;5;1;406;407
17;Girona;2;Alt Empordà;17066;Figueres;1;1;2;;786;471;315;8;3;460;463
17;Girona;2;Alt Empordà;17066;Figueres;1;2;1;;513;334;179;0;4;330;334
17;Girona;2;Alt Empordà;17066;Figueres;1;2;2;;589;397;192;0;4;393;397
17;Girona;2;Alt Empordà;17066;Figueres;1;3;1;;1020;626;394;0;6;620;626
17;Girona;2;Alt Empordà;17066;Figueres;1;4;1;;816;495;321;9;2;484;486
17;Girona;2;Alt Empordà;17066;Figueres;1;4;2;;793;465;328;3;2;460;462
17;Girona;2;Alt Empordà;17066;Figueres;1;5;1;;606;295;311;2;2;291;293
17;Girona;2;Alt Empordà;17066;Figueres;1;5;2;;651;349;302;9;5;335;340
17;Girona;2;Alt Empordà;17066;Figueres;2;1;1;;452;305;147;2;1;302;303
17;Girona;2;Alt Empordà;17066;Figueres;2;1;2;;474;319;155;1;1;317;318
17;Girona;2;Alt Empordà;17066;Figueres;2;2;1;;513;333;180;0;3;330;333
17;Girona;2;Alt Empordà;17066;Figueres;2;2;2;;577;355;222;2;2;351;353
17;Girona;2;Alt Empordà;17066;Figueres;2;3;1;;1108;681;427;1;4;676;680
17;Girona;2;Alt Empordà;17066;Figueres;2;3;2;;1102;690;412;3;3;684;687
17;Girona;2;Alt Empordà;17066;Figueres;3;1;1;;428;280;148;0;4;276;280
17;Girona;2;Alt Empordà;17066;Figueres;3;1;2;;465;299;166;1;1;297;298
17;Girona;2;Alt Empordà;17066;Figueres;3;2;1;;737;494;243;11;3;480;483
17;Girona;2;Alt Empordà;17066;Figueres;3;3;1;;1016;663;353;2;1;660;661
17;Girona;2;Alt Empordà;17066;Figueres;3;3;2;;1014;610;404;3;1;606;607
17;Girona;2;Alt Empordà;17066;Figueres;3;4;1;;630;320;310;0;0;320;320
17;Girona;2;Alt Empordà;17066;Figueres;3;4;2;;571;296;275;3;3;290;293
17;Girona;2;Alt Empordà;17066;Figueres;4;1;1;;660;440;220;6;2;432;434
17;Girona;2;Alt Empordà;17066;Figueres;4;1;2;;668;451;217;0;3;448;451
17;Girona;2;Alt Empordà;17066;Figueres;4;2;1;;1166;715;451;4;8;703;711
17;Girona;2;Alt Empordà;17066;Figueres;4;2;2;;1267;782;485;4;2;776;778
17;Girona;2;Alt Empordà;17066;Figueres;4;3;1;;1040;632;408;2;4;626;630
17;Girona;2;Alt Empordà;17066;Figueres;4;4;1;;826;546;280;2;5;539;544
17;Girona;2;Alt Empordà;17066;Figueres;4;4;2;;761;507;254;0;1;506;507
17;Girona;2;Alt Empordà;17066;Figueres;4;5;1;;655;392;263;1;4;387;391
17;Girona;2;Alt Empordà;17066;Figueres;4;5;2;;676;405;271;0;1;404;405
17;Girona;2;Alt Empordà;17066;Figueres;5;1;1;;595;282;313;1;1;280;281
43;Tarragona;1;Alt Camp;43059;Figuerola del Camp;1;1;1;;179;148;31;1;0;147;147
17;Girona;20;Gironès;17067;Flaçà;1;1;1;;730;561;169;12;2;547;549
43;Tarragona;30;Ribera d'Ebre;43060;Flix;1;1;1;;775;518;257;0;0;518;518
43;Tarragona;30;Ribera d'Ebre;43060;Flix;1;1;2;;704;484;220;2;0;482;482
43;Tarragona;30;Ribera d'Ebre;43060;Flix;1;2;1;;644;419;225;0;4;415;419
43;Tarragona;30;Ribera d'Ebre;43060;Flix;1;2;2;;598;400;198;1;0;399;399
43;Tarragona;30;Ribera d'Ebre;43060;Flix;2;1;1;;653;459;194;1;2;456;458
43;Tarragona;30;Ribera d'Ebre;43060;Flix;2;2;1;;476;318;158;1;2;315;317
25;Lleida;18;Garrigues;25092;Floresta, la;1;1;1;;167;136;31;0;0;136;136
8;Barcelona;34;Selva;08082;Fogars de la Selva;1;1;1;;213;130;83;0;1;129;130
8;Barcelona;41;Vallès Oriental;08081;Fogars de Montclús;1;1;1;;213;161;52;0;3;158;161
17;Girona;10;Baix Empordà;17068;Foixà;1;1;1;;222;184;38;0;2;182;184
8;Barcelona;24;Osona;08083;Folgueroles;1;1;1;;832;652;180;2;1;649;650
25;Lleida;27;Pla d'Urgell;25093;Fondarella;1;1;1;;410;207;203;0;2;205;207
8;Barcelona;7;Bages;08084;Fonollosa;1;1;1;;498;354;144;3;2;349;351
17;Girona;15;Cerdanya;17069;Fontanals de Cerdanya;1;1;1;;269;206;63;0;0;206;206
17;Girona;10;Baix Empordà;17070;Fontanilles;1;1;1;;104;67;37;0;1;66;67
17;Girona;28;Pla de l'Estany;17071;Fontcoberta;1;1;1;;493;331;162;3;0;328;328
8;Barcelona;3;Alt Penedès;08085;Font-rubí;1;1;1;;957;657;300;4;7;646;653
25;Lleida;23;Noguera;25094;Foradada;1;1;1;;135;82;53;2;0;80;80
17;Girona;10;Baix Empordà;17902;Forallac;1;1;1;;570;407;163;9;3;395;398
17;Girona;10;Baix Empordà;17902;Forallac;1;2;1;;336;183;153;0;1;182;183
17;Girona;10;Baix Empordà;17902;Forallac;1;3;1;;256;153;103;3;0;150;150
43;Tarragona;16;Conca de Barberà;43061;Forès;1;1;1;;62;38;24;0;0;38;38
17;Girona;20;Gironès;17073;Fornells de la Selva;1;1;1;;739;513;226;2;0;511;511
17;Girona;2;Alt Empordà;17074;Fortià;1;1;1;;391;308;83;2;0;306;306
8;Barcelona;41;Vallès Oriental;08086;Franqueses del Vallès, les;1;1;1;;1010;683;327;0;1;682;683
8;Barcelona;41;Vallès Oriental;08086;Franqueses del Vallès, les;1;1;2;;760;556;204;3;2;551;553
8;Barcelona;41;Vallès Oriental;08086;Franqueses del Vallès, les;1;2;1;;1067;651;416;0;3;648;651
8;Barcelona;41;Vallès Oriental;08086;Franqueses del Vallès, les;1;2;2;;846;547;299;1;5;541;546
8;Barcelona;41;Vallès Oriental;08086;Franqueses del Vallès, les;1;3;1;;772;480;292;0;2;478;480
8;Barcelona;41;Vallès Oriental;08086;Franqueses del Vallès, les;1;3;2;;814;580;234;0;4;576;580
8;Barcelona;41;Vallès Oriental;08086;Franqueses del Vallès, les;2;1;1;;869;658;211;3;0;655;655
43;Tarragona;22;Montsià;43062;Freginals;1;1;1;;347;282;65;3;1;278;279
25;Lleida;38;Urgell;25096;Fuliola, la;1;1;1;;1043;753;290;5;4;744;748
25;Lleida;18;Garrigues;25097;Fulleda;1;1;1;;102;80;22;0;0;80;80
8;Barcelona;7;Bages;08090;Gaià;1;1;1;;130;99;31;1;0;98;98
43;Tarragona;22;Montsià;43063;Galera, la;1;1;1;;644;403;241;3;4;396;400
8;Barcelona;40;Vallès Occidental;08087;Gallifa;1;1;1;;60;53;7;0;0;53;53
43;Tarragona;37;Terra Alta;43064;Gandesa;1;1;1;;651;460;191;6;3;451;454
43;Tarragona;37;Terra Alta;43064;Gandesa;1;1;2;;606;468;138;4;1;463;464
43;Tarragona;37;Terra Alta;43064;Gandesa;2;1;1;;971;678;293;6;2;670;672
43;Tarragona;30;Ribera d'Ebre;43065;Garcia;1;1;1;;507;381;126;2;2;377;379
43;Tarragona;1;Alt Camp;43066;Garidells, els;1;1;1;;122;93;29;1;0;92;92
8;Barcelona;41;Vallès Oriental;08088;Garriga, la;1;1;1;;1207;832;375;13;2;817;819
8;Barcelona;41;Vallès Oriental;08088;Garriga, la;1;2;1;;1102;767;335;3;1;763;764
8;Barcelona;41;Vallès Oriental;08088;Garriga, la;1;2;2;;866;583;283;7;3;573;576
8;Barcelona;41;Vallès Oriental;08088;Garriga, la;2;1;1;;1146;848;298;3;1;844;845
8;Barcelona;41;Vallès Oriental;08088;Garriga, la;2;2;1;;1150;822;328;2;4;816;820
8;Barcelona;41;Vallès Oriental;08088;Garriga, la;2;2;2;;969;651;318;0;3;648;651
17;Girona;2;Alt Empordà;17075;Garrigàs;1;1;1;;288;186;102;4;1;181;182
17;Girona;10;Baix Empordà;17076;Garrigoles;1;1;1;;132;84;48;0;0;84;84
17;Girona;2;Alt Empordà;17077;Garriguella;1;1;1;;475;335;140;1;1;333;334
8;Barcelona;11;Baix Llobregat;08089;Gavà;1;1;1;;873;576;297;2;0;574;574
8;Barcelona;11;Baix Llobregat;08089;Gavà;1;2;1;;650;463;187;0;0;463;463
8;Barcelona;11;Baix Llobregat;08089;Gavà;1;2;2;;667;485;182;2;5;478;483
8;Barcelona;11;Baix Llobregat;08089;Gavà;1;3;1;;838;572;266;1;1;570;571
8;Barcelona;11;Baix Llobregat;08089;Gavà;1;3;2;;846;566;280;1;2;563;565
8;Barcelona;11;Baix Llobregat;08089;Gavà;1;4;1;;689;443;246;1;1;441;442
8;Barcelona;11;Baix Llobregat;08089;Gavà;1;4;2;;648;401;247;0;2;399;401
8;Barcelona;11;Baix Llobregat;08089;Gavà;1;5;1;;876;496;380;14;1;481;482
8;Barcelona;11;Baix Llobregat;08089;Gavà;1;6;1;;640;372;268;0;2;370;372
8;Barcelona;11;Baix Llobregat;08089;Gavà;1;7;1;;493;196;297;0;2;194;196
8;Barcelona;11;Baix Llobregat;08089;Gavà;1;8;1;;183;105;78;0;0;105;105
8;Barcelona;11;Baix Llobregat;08089;Gavà;2;1;1;;1370;923;447;0;2;921;923
8;Barcelona;11;Baix Llobregat;08089;Gavà;2;2;1;;959;530;429;0;2;528;530
8;Barcelona;11;Baix Llobregat;08089;Gavà;2;2;2;;893;517;376;1;0;516;516
8;Barcelona;11;Baix Llobregat;08089;Gavà;2;3;1;;856;550;306;0;3;547;550
8;Barcelona;11;Baix Llobregat;08089;Gavà;2;3;2;;731;420;311;0;0;420;420
8;Barcelona;11;Baix Llobregat;08089;Gavà;2;4;1;;1167;584;583;5;2;577;579
8;Barcelona;11;Baix Llobregat;08089;Gavà;2;5;1;;672;285;387;6;0;279;279
8;Barcelona;11;Baix Llobregat;08089;Gavà;2;6;1;;1345;767;578;5;0;762;762
8;Barcelona;11;Baix Llobregat;08089;Gavà;2;7;1;;433;253;180;1;0;252;252
8;Barcelona;11;Baix Llobregat;08089;Gavà;3;1;1;;1055;615;440;3;3;609;612
8;Barcelona;11;Baix Llobregat;08089;Gavà;3;2;1;;860;536;324;0;2;534;536
8;Barcelona;11;Baix Llobregat;08089;Gavà;3;3;1;;751;415;336;12;1;402;403
8;Barcelona;11;Baix Llobregat;08089;Gavà;3;4;1;;1107;649;458;3;0;646;646
8;Barcelona;11;Baix Llobregat;08089;Gavà;3;5;1;;821;474;347;1;4;469;473
8;Barcelona;11;Baix Llobregat;08089;Gavà;3;6;1;;255;111;144;0;0;111;111
8;Barcelona;11;Baix Llobregat;08089;Gavà;3;7;1;;846;534;312;0;0;534;534
8;Barcelona;11;Baix Llobregat;08089;Gavà;4;1;1;;1087;627;460;0;2;625;627
8;Barcelona;11;Baix Llobregat;08089;Gavà;4;2;1;;1377;763;614;17;6;740;746
8;Barcelona;11;Baix Llobregat;08089;Gavà;4;3;1;;298;108;190;1;0;107;107
8;Barcelona;11;Baix Llobregat;08089;Gavà;4;4;1;;193;146;47;2;1;143;144
25;Lleida;25;Pallars Jussà;25098;Gavet de la Conca;1;1;1;;401;202;199;1;1;200;201
8;Barcelona;3;Alt Penedès;08091;Gelida;1;1;1;;838;605;233;1;4;600;604
8;Barcelona;3;Alt Penedès;08091;Gelida;1;1;2;;860;595;265;0;1;594;595
8;Barcelona;3;Alt Penedès;08091;Gelida;2;1;1;;605;441;164;1;2;438;440
8;Barcelona;3;Alt Penedès;08091;Gelida;2;1;2;;524;384;140;1;0;383;383
17;Girona;15;Cerdanya;17078;Ger;1;1;1;;219;172;47;0;2;170;172
43;Tarragona;30;Ribera d'Ebre;43067;Ginestar;1;1;1;;788;510;278;3;8;499;507
17;Girona;20;Gironès;17079;Girona;1;1;1;;809;530;279;6;6;518;524
17;Girona;20;Gironès;17079;Girona;1;2;1;;691;485;206;12;4;469;473
17;Girona;20;Gironès;17079;Girona;1;3;1;;943;685;258;3;6;676;682
17;Girona;20;Gironès;17079;Girona;1;4;1;;865;601;264;2;0;599;599
17;Girona;20;Gironès;17079;Girona;1;5;1;;348;228;120;2;0;226;226
17;Girona;20;Gironès;17079;Girona;1;6;1;;582;446;136;3;0;443;443
17;Girona;20;Gironès;17079;Girona;1;6;2;;597;460;137;3;1;456;457
17;Girona;20;Gironès;17079;Girona;1;7;1;;600;332;268;4;0;328;328
17;Girona;20;Gironès;17079;Girona;1;7;2;;490;290;200;2;2;286;288
17;Girona;20;Gironès;17079;Girona;2;1;1;;1023;559;464;4;0;555;555
17;Girona;20;Gironès;17079;Girona;2;10;1;;521;344;177;2;3;339;342
17;Girona;20;Gironès;17079;Girona;2;10;2;;603;421;182;3;5;413;418
17;Girona;20;Gironès;17079;Girona;2;11;1;;587;432;155;10;5;417;422
17;Girona;20;Gironès;17079;Girona;2;11;2;;593;435;158;14;6;415;421
17;Girona;20;Gironès;17079;Girona;2;12;1;;785;617;168;2;2;613;615
17;Girona;20;Gironès;17079;Girona;2;13;1;;541;402;139;10;3;389;392
17;Girona;20;Gironès;17079;Girona;2;13;2;;562;438;124;3;3;432;435
17;Girona;20;Gironès;17079;Girona;2;14;1;;927;614;313;10;5;599;604
17;Girona;20;Gironès;17079;Girona;2;2;1;;617;486;131;1;1;484;485
17;Girona;20;Gironès;17079;Girona;2;3;1;;489;348;141;0;4;344;348
17;Girona;20;Gironès;17079;Girona;2;3;2;;613;448;165;0;5;443;448
17;Girona;20;Gironès;17079;Girona;2;4;1;;585;468;117;0;5;463;468
17;Girona;20;Gironès;17079;Girona;2;4;2;;540;416;124;2;4;410;414
17;Girona;20;Gironès;17079;Girona;2;5;1;;832;599;233;2;8;589;597
17;Girona;20;Gironès;17079;Girona;2;6;1;;650;481;169;5;2;474;476
17;Girona;20;Gironès;17079;Girona;2;6;2;;704;522;182;2;6;514;520
17;Girona;20;Gironès;17079;Girona;2;7;1;;541;371;170;1;5;365;370
17;Girona;20;Gironès;17079;Girona;2;7;2;;524;351;173;1;5;345;350
17;Girona;20;Gironès;17079;Girona;2;8;1;;488;381;107;2;3;376;379
17;Girona;20;Gironès;17079;Girona;2;8;2;;562;415;147;1;1;413;414
17;Girona;20;Gironès;17079;Girona;2;9;1;;785;593;192;6;1;586;587
17;Girona;20;Gironès;17079;Girona;3;1;1;;919;704;215;6;6;692;698
17;Girona;20;Gironès;17079;Girona;3;10;1;;354;227;127;0;0;227;227
17;Girona;20;Gironès;17079;Girona;3;11;1;;683;452;231;0;6;446;452
17;Girona;20;Gironès;17079;Girona;3;11;2;;682;471;211;1;2;468;470
17;Girona;20;Gironès;17079;Girona;3;12;1;;834;555;279;2;0;553;553
17;Girona;20;Gironès;17079;Girona;3;12;2;;860;615;245;1;5;609;614
17;Girona;20;Gironès;17079;Girona;3;13;1;;685;501;184;8;4;489;493
17;Girona;20;Gironès;17079;Girona;3;13;2;;683;508;175;0;5;503;508
17;Girona;20;Gironès;17079;Girona;3;14;1;;584;397;187;1;3;393;396
17;Girona;20;Gironès;17079;Girona;3;14;2;;550;363;187;1;3;359;362
17;Girona;20;Gironès;17079;Girona;3;15;1;;684;485;199;5;2;478;480
17;Girona;20;Gironès;17079;Girona;3;15;2;;693;445;248;3;4;438;442
17;Girona;20;Gironès;17079;Girona;3;15;3;;635;473;162;7;5;461;466
17;Girona;20;Gironès;17079;Girona;3;2;1;;943;736;207;4;4;728;732
17;Girona;20;Gironès;17079;Girona;3;3;1;;804;597;207;3;6;588;594
17;Girona;20;Gironès;17079;Girona;3;4;1;;921;723;198;11;4;708;712
17;Girona;20;Gironès;17079;Girona;3;5;1;;579;414;165;1;4;409;413
17;Girona;20;Gironès;17079;Girona;3;6;1;;541;416;125;1;7;408;415
17;Girona;20;Gironès;17079;Girona;3;6;2;;513;393;120;3;0;390;390
17;Girona;20;Gironès;17079;Girona;3;7;1;;786;528;258;0;7;521;528
17;Girona;20;Gironès;17079;Girona;3;7;2;;802;548;254;0;9;539;548
17;Girona;20;Gironès;17079;Girona;3;8;1;;934;665;269;1;6;658;664
17;Girona;20;Gironès;17079;Girona;3;9;1;;635;444;191;2;1;441;442
17;Girona;20;Gironès;17079;Girona;3;9;2;;625;458;167;5;2;451;453
17;Girona;20;Gironès;17079;Girona;4;1;1;;984;701;283;7;3;691;694
17;Girona;20;Gironès;17079;Girona;4;2;1;;446;302;144;7;1;294;295
17;Girona;20;Gironès;17079;Girona;4;3;1;;751;477;274;1;1;475;476
17;Girona;20;Gironès;17079;Girona;4;4;1;;724;446;278;1;1;444;445
17;Girona;20;Gironès;17079;Girona;5;1;1;;830;598;232;2;1;595;596
17;Girona;20;Gironès;17079;Girona;5;2;1;;660;487;173;2;8;477;485
17;Girona;20;Gironès;17079;Girona;5;3;1;;709;515;194;2;3;510;513
17;Girona;20;Gironès;17079;Girona;5;4;1;;596;430;166;1;1;428;429
17;Girona;20;Gironès;17079;Girona;5;5;1;;578;386;192;0;1;385;386
17;Girona;20;Gironès;17079;Girona;5;5;2;;660;423;237;1;6;416;422
17;Girona;20;Gironès;17079;Girona;8;1;1;;885;473;412;1;1;471;472
17;Girona;20;Gironès;17079;Girona;8;2;1;;600;417;183;0;7;410;417
17;Girona;20;Gironès;17079;Girona;8;2;2;;604;450;154;2;3;445;448
17;Girona;20;Gironès;17079;Girona;8;5;1;;794;587;207;0;0;587;587
8;Barcelona;14;Berguedà;08092;Gironella;1;1;1;;637;474;163;1;2;471;473
8;Barcelona;14;Berguedà;08092;Gironella;1;1;2;;636;474;162;3;3;468;471
8;Barcelona;14;Berguedà;08092;Gironella;2;1;1;;624;460;164;12;0;448;448
8;Barcelona;14;Berguedà;08092;Gironella;2;2;1;;584;444;140;1;2;441;443
8;Barcelona;14;Berguedà;08092;Gironella;2;2;2;;599;453;146;8;1;444;445
8;Barcelona;14;Berguedà;08092;Gironella;2;3;1;;684;531;153;2;0;529;529
8;Barcelona;14;Berguedà;08092;Gironella;2;3;2;;736;534;202;2;2;530;532
8;Barcelona;14;Berguedà;08093;Gisclareny;1;1;1;;20;18;2;0;0;18;18
43;Tarragona;22;Montsià;43068;Godall;1;1;1;;695;508;187;4;1;503;504
25;Lleida;27;Pla d'Urgell;25099;Golmés;1;1;1;;994;636;358;3;3;630;633
17;Girona;31;Ripollès;17080;Gombrèn;1;1;1;;226;165;61;1;0;164;164
25;Lleida;14;Berguedà;25100;Gósol;1;1;1;;170;129;41;1;0;128;128
8;Barcelona;3;Alt Penedès;08094;Granada, la;1;1;1;;899;751;148;2;4;745;749
25;Lleida;18;Garrigues;25101;Granadella, la;1;1;1;;785;550;235;3;4;543;547
8;Barcelona;;;08095;Granera;1;1;1;;42;36;6;0;0;36;36
25;Lleida;33;Segrià;25102;Granja d'Escarp, la;1;1;1;;970;698;272;4;4;690;694
8;Barcelona;41;Vallès Oriental;08096;Granollers;1;1;1;;878;615;263;2;6;607;613
8;Barcelona;41;Vallès Oriental;08096;Granollers;1;10;1;;668;434;234;0;5;429;434
8;Barcelona;41;Vallès Oriental;08096;Granollers;1;10;2;;724;445;279;1;0;444;444
8;Barcelona;41;Vallès Oriental;08096;Granollers;1;2;1;;1184;889;295;2;2;885;887
8;Barcelona;41;Vallès Oriental;08096;Granollers;1;3;1;;1205;812;393;8;3;801;804
8;Barcelona;41;Vallès Oriental;08096;Granollers;1;4;1;;730;517;213;1;2;514;516
8;Barcelona;41;Vallès Oriental;08096;Granollers;1;4;2;;736;499;237;3;6;490;496
8;Barcelona;41;Vallès Oriental;08096;Granollers;1;5;1;;746;499;247;2;0;497;497
8;Barcelona;41;Vallès Oriental;08096;Granollers;1;5;2;;882;592;290;5;2;585;587
8;Barcelona;41;Vallès Oriental;08096;Granollers;1;6;1;;532;383;149;0;1;382;383
8;Barcelona;41;Vallès Oriental;08096;Granollers;1;7;1;;779;540;239;0;2;538;540
8;Barcelona;41;Vallès Oriental;08096;Granollers;1;8;1;;382;257;125;2;0;255;255
8;Barcelona;41;Vallès Oriental;08096;Granollers;1;9;1;;867;542;325;0;4;538;542
8;Barcelona;41;Vallès Oriental;08096;Granollers;1;9;2;;832;507;325;5;1;501;502
8;Barcelona;41;Vallès Oriental;08096;Granollers;2;1;1;;1341;949;392;2;4;943;947
8;Barcelona;41;Vallès Oriental;08096;Granollers;2;2;1;;578;437;141;0;3;434;437
8;Barcelona;41;Vallès Oriental;08096;Granollers;2;3;1;;855;540;315;1;3;536;539
8;Barcelona;41;Vallès Oriental;08096;Granollers;2;3;2;;830;531;299;0;1;530;531
8;Barcelona;41;Vallès Oriental;08096;Granollers;2;4;1;;1215;772;443;2;2;768;770
8;Barcelona;41;Vallès Oriental;08096;Granollers;2;5;1;;1016;746;270;5;7;734;741
8;Barcelona;41;Vallès Oriental;08096;Granollers;2;6;1;;956;627;329;0;3;624;627
8;Barcelona;41;Vallès Oriental;08096;Granollers;3;1;1;;729;560;169;1;3;556;559
8;Barcelona;41;Vallès Oriental;08096;Granollers;3;1;2;;681;515;166;1;2;512;514
8;Barcelona;41;Vallès Oriental;08096;Granollers;3;2;1;;1168;761;407;1;4;756;760
8;Barcelona;41;Vallès Oriental;08096;Granollers;3;3;1;;1011;649;362;7;3;639;642
8;Barcelona;41;Vallès Oriental;08096;Granollers;3;3;2;;965;590;375;0;1;589;590
8;Barcelona;41;Vallès Oriental;08096;Granollers;3;4;1;;1330;826;504;5;2;819;821
8;Barcelona;41;Vallès Oriental;08096;Granollers;3;5;1;;880;551;329;2;3;546;549
8;Barcelona;41;Vallès Oriental;08096;Granollers;4;1;1;;704;509;195;2;3;504;507
8;Barcelona;41;Vallès Oriental;08096;Granollers;4;1;2;;709;528;181;1;0;527;527
8;Barcelona;41;Vallès Oriental;08096;Granollers;4;2;1;;806;488;318;5;1;482;483
8;Barcelona;41;Vallès Oriental;08096;Granollers;4;2;2;;699;483;216;0;2;481;483
8;Barcelona;41;Vallès Oriental;08096;Granollers;4;3;1;;823;508;315;2;3;503;506
8;Barcelona;41;Vallès Oriental;08096;Granollers;4;3;2;;768;473;295;2;3;468;471
8;Barcelona;41;Vallès Oriental;08096;Granollers;4;4;1;;751;451;300;0;2;449;451
8;Barcelona;41;Vallès Oriental;08096;Granollers;4;4;2;;668;399;269;0;1;398;399
8;Barcelona;41;Vallès Oriental;08096;Granollers;4;5;1;;231;172;59;0;1;171;172
8;Barcelona;41;Vallès Oriental;08096;Granollers;4;6;1;;480;308;172;5;0;303;303
8;Barcelona;41;Vallès Oriental;08096;Granollers;4;7;1;;1183;877;306;4;2;871;873
8;Barcelona;41;Vallès Oriental;08096;Granollers;4;8;1;;868;546;322;4;0;542;542
8;Barcelona;41;Vallès Oriental;08096;Granollers;4;8;2;;861;532;329;4;2;526;528
8;Barcelona;41;Vallès Oriental;08096;Granollers;4;9;1;;86;62;24;1;0;61;61
25;Lleida;32;Segarra;25103;Granyanella;1;1;1;;115;55;60;0;2;53;55
25;Lleida;18;Garrigues;25105;Granyena de les Garrigues;1;1;1;;190;137;53;1;2;134;136
25;Lleida;32;Segarra;25104;Granyena de Segarra;1;1;1;;190;133;57;0;0;133;133
43;Tarragona;29;Priorat;43069;Gratallops;1;1;1;;223;160;63;5;2;153;155
8;Barcelona;41;Vallès Oriental;08097;Gualba;1;1;1;;468;332;136;0;1;331;332
17;Girona;10;Baix Empordà;17081;Gualta;1;1;1;;249;176;73;1;0;175;175
8;Barcelona;14;Berguedà;08099;Guardiola de Berguedà;1;1;1;;1078;790;288;5;3;782;785
43;Tarragona;29;Priorat;43070;Guiamets, els;1;1;1;;249;185;64;2;0;183;183
17;Girona;15;Cerdanya;17082;Guils de Cerdanya;1;1;1;;176;144;32;0;1;143;144
25;Lleida;38;Urgell;25109;Guimerà;1;1;1;;417;317;100;0;6;311;317
25;Lleida;26;Pallars Sobirà;25903;Guingueta d'Àneu, la;1;1;1;;263;148;115;0;1;147;148
25;Lleida;32;Segarra;25110;Guissona;1;1;1;;846;601;245;6;2;593;595
25;Lleida;32;Segarra;25110;Guissona;1;2;1;;1203;851;352;5;3;843;846
25;Lleida;35;Solsonès;25111;Guixers;1;1;1;;141;87;54;0;0;87;87
8;Barcelona;24;Osona;08100;Gurb;1;1;1;;1245;959;286;1;1;957;958
43;Tarragona;37;Terra Alta;43071;Horta de Sant Joan;1;1;1;;511;324;187;2;0;322;322
43;Tarragona;37;Terra Alta;43071;Horta de Sant Joan;1;2;1;;623;427;196;4;2;421;423
8;Barcelona;13;Barcelonès;08101;Hospitalet de Llobregat, l';1;1;1;;728;357;371;0;0;357;357
8;Barcelona;13;Barcelonès;08101;Hospitalet de Llobregat, l';1;10;1;;992;560;432;2;0;558;558
8;Barcelona;13;Barcelonès;08101;Hospitalet de Llobregat, l';1;11;1;;819;532;287;0;6;526;532
8;Barcelona;13;Barcelonès;08101;Hospitalet de Llobregat, l';1;12;1;;1034;707;327;5;5;697;702
8;Barcelona;13;Barcelonès;08101;Hospitalet de Llobregat, l';1;13;1;;867;501;366;0;1;500;501
8;Barcelona;13;Barcelonès;08101;Hospitalet de Llobregat, l';1;14;1;;1381;775;606;1;3;771;774
8;Barcelona;13;Barcelonès;08101;Hospitalet de Llobregat, l';1;15;1;;1016;529;487;1;4;524;528
8;Barcelona;13;Barcelonès;08101;Hospitalet de Llobregat, l';1;16;1;;264;161;103;0;2;159;161
8;Barcelona;13;Barcelonès;08101;Hospitalet de Llobregat, l';1;17;1;;850;463;387;1;2;460;462
8;Barcelona;13;Barcelonès;08101;Hospitalet de Llobregat, l';1;18;1;;482;288;194;1;0;287;287
8;Barcelona;13;Barcelonès;08101;Hospitalet de Llobregat, l';1;19;1;;1172;707;465;0;2;705;707
8;Barcelona;13;Barcelonès;08101;Hospitalet de Llobregat, l';1;2;1;;780;493;287;0;2;491;493
8;Barcelona;13;Barcelonès;08101;Hospitalet de Llobregat, l';1;2;2;;664;384;280;1;2;381;383
8;Barcelona;13;Barcelonès;08101;Hospitalet de Llobregat, l';1;20;1;;1033;563;470;4;0;559;559
8;Barcelona;13;Barcelonès;08101;Hospitalet de Llobregat, l';1;21;1;;973;562;411;1;3;558;561
8;Barcelona;13;Barcelonès;08101;Hospitalet de Llobregat, l';1;22;1;;813;472;341;1;7;464;471
8;Barcelona;13;Barcelonès;08101;Hospitalet de Llobregat, l';1;23;1;;1102;677;425;5;1;671;672
8;Barcelona;13;Barcelonès;08101;Hospitalet de Llobregat, l';1;24;1;;643;406;237;0;3;403;406
8;Barcelona;13;Barcelonès;08101;Hospitalet de Llobregat, l';1;25;1;;960;512;448;0;3;509;512
8;Barcelona;13;Barcelonès;08101;Hospitalet de Llobregat, l';1;26;1;;1009;633;376;4;4;625;629
8;Barcelona;13;Barcelonès;08101;Hospitalet de Llobregat, l';1;27;1;;642;363;279;1;2;360;362
8;Barcelona;13;Barcelonès;08101;Hospitalet de Llobregat, l';1;28;1;;846;482;364;0;0;482;482
8;Barcelona;13;Barcelonès;08101;Hospitalet de Llobregat, l';1;29;1;;224;141;83;0;0;141;141
8;Barcelona;13;Barcelonès;08101;Hospitalet de Llobregat, l';1;3;1;;444;276;168;0;0;276;276
8;Barcelona;13;Barcelonès;08101;Hospitalet de Llobregat, l';1;30;1;;666;438;228;2;7;429;436
8;Barcelona;13;Barcelonès;08101;Hospitalet de Llobregat, l';1;31;1;;1091;607;484;2;1;604;605
8;Barcelona;13;Barcelonès;08101;Hospitalet de Llobregat, l';1;32;1;;651;105;546;0;2;103;105
8;Barcelona;13;Barcelonès;08101;Hospitalet de Llobregat, l';1;33;1;;848;576;272;0;1;575;576
8;Barcelona;13;Barcelonès;08101;Hospitalet de Llobregat, l';1;34;1;;959;537;422;0;2;535;537
8;Barcelona;13;Barcelonès;08101;Hospitalet de Llobregat, l';1;35;1;;784;448;336;16;0;432;432
8;Barcelona;13;Barcelonès;08101;Hospitalet de Llobregat, l';1;36;1;;1023;620;403;4;2;614;616
8;Barcelona;13;Barcelonès;08101;Hospitalet de Llobregat, l';1;37;1;;903;541;362;0;2;539;541
8;Barcelona;13;Barcelonès;08101;Hospitalet de Llobregat, l';1;38;1;;670;380;290;0;0;380;380
8;Barcelona;13;Barcelonès;08101;Hospitalet de Llobregat, l';1;39;1;;639;364;275;0;0;364;364
8;Barcelona;13;Barcelonès;08101;Hospitalet de Llobregat, l';1;4;1;;825;576;249;4;3;569;572
8;Barcelona;13;Barcelonès;08101;Hospitalet de Llobregat, l';1;40;1;;894;517;377;0;3;514;517
8;Barcelona;13;Barcelonès;08101;Hospitalet de Llobregat, l';1;41;1;;1246;688;558;1;4;683;687
8;Barcelona;13;Barcelonès;08101;Hospitalet de Llobregat, l';1;42;1;;442;242;200;0;2;240;242
8;Barcelona;13;Barcelonès;08101;Hospitalet de Llobregat, l';1;43;1;;993;534;459;0;4;530;534
8;Barcelona;13;Barcelonès;08101;Hospitalet de Llobregat, l';1;44;1;;366;190;176;0;1;189;190
8;Barcelona;13;Barcelonès;08101;Hospitalet de Llobregat, l';1;45;1;;1024;616;408;1;6;609;615
8;Barcelona;13;Barcelonès;08101;Hospitalet de Llobregat, l';1;46;1;;1195;698;497;1;2;695;697
8;Barcelona;13;Barcelonès;08101;Hospitalet de Llobregat, l';1;47;1;;525;305;220;1;0;304;304
8;Barcelona;13;Barcelonès;08101;Hospitalet de Llobregat, l';1;5;1;;864;545;319;2;2;541;543
8;Barcelona;13;Barcelonès;08101;Hospitalet de Llobregat, l';1;6;1;;917;208;709;1;0;207;207
8;Barcelona;13;Barcelonès;08101;Hospitalet de Llobregat, l';1;7;1;;759;462;297;1;1;460;461
8;Barcelona;13;Barcelonès;08101;Hospitalet de Llobregat, l';1;7;2;;762;406;356;2;5;399;404
8;Barcelona;13;Barcelonès;08101;Hospitalet de Llobregat, l';1;8;1;;1191;805;386;0;8;797;805
8;Barcelona;13;Barcelonès;08101;Hospitalet de Llobregat, l';1;9;1;;935;617;318;5;0;612;612
8;Barcelona;13;Barcelonès;08101;Hospitalet de Llobregat, l';2;1;1;;693;401;292;1;2;398;400
8;Barcelona;13;Barcelonès;08101;Hospitalet de Llobregat, l';2;10;1;;1006;598;408;1;1;596;597
8;Barcelona;13;Barcelonès;08101;Hospitalet de Llobregat, l';2;11;1;;481;283;198;0;1;282;283
8;Barcelona;13;Barcelonès;08101;Hospitalet de Llobregat, l';2;12;1;;745;418;327;3;1;414;415
8;Barcelona;13;Barcelonès;08101;Hospitalet de Llobregat, l';2;13;1;;743;455;288;5;2;448;450
8;Barcelona;13;Barcelonès;08101;Hospitalet de Llobregat, l';2;14;1;;701;410;291;1;0;409;409
8;Barcelona;13;Barcelonès;08101;Hospitalet de Llobregat, l';2;15;1;;843;508;335;2;5;501;506
8;Barcelona;13;Barcelonès;08101;Hospitalet de Llobregat, l';2;16;1;;717;392;325;0;1;391;392
8;Barcelona;13;Barcelonès;08101;Hospitalet de Llobregat, l';2;17;1;;404;233;171;0;1;232;233
8;Barcelona;13;Barcelonès;08101;Hospitalet de Llobregat, l';2;18;1;;497;290;207;0;0;290;290
8;Barcelona;13;Barcelonès;08101;Hospitalet de Llobregat, l';2;19;1;;579;355;224;2;2;351;353
8;Barcelona;13;Barcelonès;08101;Hospitalet de Llobregat, l';2;2;1;;701;407;294;3;0;404;404
8;Barcelona;13;Barcelonès;08101;Hospitalet de Llobregat, l';2;20;1;;796;447;349;4;2;441;443
8;Barcelona;13;Barcelonès;08101;Hospitalet de Llobregat, l';2;21;1;;1018;513;505;0;5;508;513
8;Barcelona;13;Barcelonès;08101;Hospitalet de Llobregat, l';2;22;1;;783;450;333;0;9;441;450
8;Barcelona;13;Barcelonès;08101;Hospitalet de Llobregat, l';2;23;1;;1023;555;468;0;2;553;555
8;Barcelona;13;Barcelonès;08101;Hospitalet de Llobregat, l';2;24;1;;582;344;238;0;1;343;344
8;Barcelona;13;Barcelonès;08101;Hospitalet de Llobregat, l';2;25;1;;542;277;265;0;1;276;277
8;Barcelona;13;Barcelonès;08101;Hospitalet de Llobregat, l';2;26;1;;1000;576;424;0;0;576;576
8;Barcelona;13;Barcelonès;08101;Hospitalet de Llobregat, l';2;27;1;;660;414;246;0;3;411;414
8;Barcelona;13;Barcelonès;08101;Hospitalet de Llobregat, l';2;28;1;;607;340;267;1;2;337;339
8;Barcelona;13;Barcelonès;08101;Hospitalet de Llobregat, l';2;29;1;;726;369;357;1;1;367;368
8;Barcelona;13;Barcelonès;08101;Hospitalet de Llobregat, l';2;3;1;;738;432;306;3;3;426;429
8;Barcelona;13;Barcelonès;08101;Hospitalet de Llobregat, l';2;30;1;;806;422;384;0;7;415;422
8;Barcelona;13;Barcelonès;08101;Hospitalet de Llobregat, l';2;31;1;;1061;621;440;4;3;614;617
8;Barcelona;13;Barcelonès;08101;Hospitalet de Llobregat, l';2;32;1;;1028;609;419;3;3;603;606
8;Barcelona;13;Barcelonès;08101;Hospitalet de Llobregat, l';2;33;1;;819;478;341;8;3;467;470
8;Barcelona;13;Barcelonès;08101;Hospitalet de Llobregat, l';2;34;1;;1006;550;456;0;0;550;550
8;Barcelona;13;Barcelonès;08101;Hospitalet de Llobregat, l';2;35;1;;862;484;378;1;3;480;483
8;Barcelona;13;Barcelonès;08101;Hospitalet de Llobregat, l';2;36;1;;1072;597;475;1;3;593;596
8;Barcelona;13;Barcelonès;08101;Hospitalet de Llobregat, l';2;37;1;;925;511;414;3;5;503;508
8;Barcelona;13;Barcelonès;08101;Hospitalet de Llobregat, l';2;38;1;;359;193;166;0;1;192;193
8;Barcelona;13;Barcelonès;08101;Hospitalet de Llobregat, l';2;39;1;;1147;669;478;2;2;665;667
8;Barcelona;13;Barcelonès;08101;Hospitalet de Llobregat, l';2;4;1;;544;333;211;1;2;330;332
8;Barcelona;13;Barcelonès;08101;Hospitalet de Llobregat, l';2;40;1;;755;416;339;2;1;413;414
8;Barcelona;13;Barcelonès;08101;Hospitalet de Llobregat, l';2;41;1;;641;382;259;3;0;379;379
8;Barcelona;13;Barcelonès;08101;Hospitalet de Llobregat, l';2;42;1;;1028;633;395;3;4;626;630
8;Barcelona;13;Barcelonès;08101;Hospitalet de Llobregat, l';2;43;1;;973;569;404;4;0;565;565
8;Barcelona;13;Barcelonès;08101;Hospitalet de Llobregat, l';2;44;1;;416;227;189;3;0;224;224
8;Barcelona;13;Barcelonès;08101;Hospitalet de Llobregat, l';2;45;1;;964;543;421;3;1;539;540
8;Barcelona;13;Barcelonès;08101;Hospitalet de Llobregat, l';2;46;1;;972;571;401;0;3;568;571
8;Barcelona;13;Barcelonès;08101;Hospitalet de Llobregat, l';2;47;1;;1146;629;517;2;7;620;627
8;Barcelona;13;Barcelonès;08101;Hospitalet de Llobregat, l';2;48;1;;1020;574;446;4;7;563;570
8;Barcelona;13;Barcelonès;08101;Hospitalet de Llobregat, l';2;49;1;;981;566;415;7;5;554;559
8;Barcelona;13;Barcelonès;08101;Hospitalet de Llobregat, l';2;5;1;;790;456;334;1;2;453;455
8;Barcelona;13;Barcelonès;08101;Hospitalet de Llobregat, l';2;50;1;;582;347;235;2;2;343;345
8;Barcelona;13;Barcelonès;08101;Hospitalet de Llobregat, l';2;51;1;;693;373;320;1;5;367;372
8;Barcelona;13;Barcelonès;08101;Hospitalet de Llobregat, l';2;52;1;;586;327;259;8;1;318;319
8;Barcelona;13;Barcelonès;08101;Hospitalet de Llobregat, l';2;53;1;;540;269;271;1;2;266;268
8;Barcelona;13;Barcelonès;08101;Hospitalet de Llobregat, l';2;54;1;;721;422;299;0;2;420;422
8;Barcelona;13;Barcelonès;08101;Hospitalet de Llobregat, l';2;55;1;;659;352;307;1;1;350;351
8;Barcelona;13;Barcelonès;08101;Hospitalet de Llobregat, l';2;56;1;;485;309;176;0;1;308;309
8;Barcelona;13;Barcelonès;08101;Hospitalet de Llobregat, l';2;57;1;;463;259;204;0;1;258;259
8;Barcelona;13;Barcelonès;08101;Hospitalet de Llobregat, l';2;6;1;;825;512;313;0;2;510;512
8;Barcelona;13;Barcelonès;08101;Hospitalet de Llobregat, l';2;7;1;;702;423;279;1;1;421;422
8;Barcelona;13;Barcelonès;08101;Hospitalet de Llobregat, l';2;8;1;;681;404;277;0;2;402;404
8;Barcelona;13;Barcelonès;08101;Hospitalet de Llobregat, l';2;8;2;;610;339;271;0;2;337;339
8;Barcelona;13;Barcelonès;08101;Hospitalet de Llobregat, l';2;9;1;;1000;577;423;3;2;572;574
8;Barcelona;13;Barcelonès;08101;Hospitalet de Llobregat, l';3;1;1;;724;378;346;2;0;376;376
8;Barcelona;13;Barcelonès;08101;Hospitalet de Llobregat, l';3;1;2;;686;364;322;2;3;359;362
8;Barcelona;13;Barcelonès;08101;Hospitalet de Llobregat, l';3;10;1;;587;337;250;3;1;333;334
8;Barcelona;13;Barcelonès;08101;Hospitalet de Llobregat, l';3;11;1;;1237;734;503;2;3;729;732
8;Barcelona;13;Barcelonès;08101;Hospitalet de Llobregat, l';3;12;1;;396;223;173;0;0;223;223
8;Barcelona;13;Barcelonès;08101;Hospitalet de Llobregat, l';3;13;1;;981;595;386;3;1;591;592
8;Barcelona;13;Barcelonès;08101;Hospitalet de Llobregat, l';3;14;1;;1348;641;707;0;0;641;641
8;Barcelona;13;Barcelonès;08101;Hospitalet de Llobregat, l';3;15;1;;1097;580;517;6;3;571;574
8;Barcelona;13;Barcelonès;08101;Hospitalet de Llobregat, l';3;16;1;;1159;543;616;1;3;539;542
8;Barcelona;13;Barcelonès;08101;Hospitalet de Llobregat, l';3;16;2;;1077;512;565;3;0;509;509
8;Barcelona;13;Barcelonès;08101;Hospitalet de Llobregat, l';3;17;1;;772;411;361;2;0;409;409
8;Barcelona;13;Barcelonès;08101;Hospitalet de Llobregat, l';3;18;1;;1013;599;414;2;3;594;597
8;Barcelona;13;Barcelonès;08101;Hospitalet de Llobregat, l';3;18;2;;854;528;326;0;2;526;528
8;Barcelona;13;Barcelonès;08101;Hospitalet de Llobregat, l';3;19;1;;630;363;267;0;4;359;363
8;Barcelona;13;Barcelonès;08101;Hospitalet de Llobregat, l';3;2;1;;803;459;344;2;4;453;457
8;Barcelona;13;Barcelonès;08101;Hospitalet de Llobregat, l';3;20;1;;408;205;203;0;5;200;205
8;Barcelona;13;Barcelonès;08101;Hospitalet de Llobregat, l';3;21;1;;1388;858;530;0;12;846;858
8;Barcelona;13;Barcelonès;08101;Hospitalet de Llobregat, l';3;22;1;;953;523;430;3;6;514;520
8;Barcelona;13;Barcelonès;08101;Hospitalet de Llobregat, l';3;23;1;;828;391;437;0;3;388;391
8;Barcelona;13;Barcelonès;08101;Hospitalet de Llobregat, l';3;23;2;;711;362;349;0;1;361;362
8;Barcelona;13;Barcelonès;08101;Hospitalet de Llobregat, l';3;24;1;;740;403;337;2;2;399;401
8;Barcelona;13;Barcelonès;08101;Hospitalet de Llobregat, l';3;25;1;;738;488;250;2;4;482;486
8;Barcelona;13;Barcelonès;08101;Hospitalet de Llobregat, l';3;25;2;;683;438;245;0;4;434;438
8;Barcelona;13;Barcelonès;08101;Hospitalet de Llobregat, l';3;26;1;;875;493;382;2;8;483;491
8;Barcelona;13;Barcelonès;08101;Hospitalet de Llobregat, l';3;27;1;;683;458;225;2;0;456;456
8;Barcelona;13;Barcelonès;08101;Hospitalet de Llobregat, l';3;3;1;;234;145;89;0;0;145;145
8;Barcelona;13;Barcelonès;08101;Hospitalet de Llobregat, l';3;4;1;;929;489;440;0;1;488;489
8;Barcelona;13;Barcelonès;08101;Hospitalet de Llobregat, l';3;5;1;;1041;669;372;2;3;664;667
8;Barcelona;13;Barcelonès;08101;Hospitalet de Llobregat, l';3;6;1;;678;412;266;0;3;409;412
8;Barcelona;13;Barcelonès;08101;Hospitalet de Llobregat, l';3;6;2;;678;417;261;2;0;415;415
8;Barcelona;13;Barcelonès;08101;Hospitalet de Llobregat, l';3;7;1;;1206;744;462;0;4;740;744
8;Barcelona;13;Barcelonès;08101;Hospitalet de Llobregat, l';3;8;1;;758;451;307;2;3;446;449
8;Barcelona;13;Barcelonès;08101;Hospitalet de Llobregat, l';3;9;1;;395;240;155;0;1;239;240
8;Barcelona;13;Barcelonès;08101;Hospitalet de Llobregat, l';4;1;1;;1059;631;428;2;3;626;629
8;Barcelona;13;Barcelonès;08101;Hospitalet de Llobregat, l';4;10;1;;771;436;335;2;1;433;434
8;Barcelona;13;Barcelonès;08101;Hospitalet de Llobregat, l';4;10;2;;773;434;339;4;3;427;430
8;Barcelona;13;Barcelonès;08101;Hospitalet de Llobregat, l';4;11;1;;1027;557;470;0;3;554;557
8;Barcelona;13;Barcelonès;08101;Hospitalet de Llobregat, l';4;12;1;;671;404;267;1;2;401;403
8;Barcelona;13;Barcelonès;08101;Hospitalet de Llobregat, l';4;12;2;;710;404;306;1;5;398;403
8;Barcelona;13;Barcelonès;08101;Hospitalet de Llobregat, l';4;13;1;;542;327;215;1;0;326;326
8;Barcelona;13;Barcelonès;08101;Hospitalet de Llobregat, l';4;14;1;;851;464;387;0;3;461;464
8;Barcelona;13;Barcelonès;08101;Hospitalet de Llobregat, l';4;15;1;;710;406;304;1;3;402;405
8;Barcelona;13;Barcelonès;08101;Hospitalet de Llobregat, l';4;16;1;;730;444;286;0;1;443;444
8;Barcelona;13;Barcelonès;08101;Hospitalet de Llobregat, l';4;17;1;;572;302;270;0;4;298;302
8;Barcelona;13;Barcelonès;08101;Hospitalet de Llobregat, l';4;18;1;;638;340;298;2;2;336;338
8;Barcelona;13;Barcelonès;08101;Hospitalet de Llobregat, l';4;19;1;;359;187;172;0;0;187;187
8;Barcelona;13;Barcelonès;08101;Hospitalet de Llobregat, l';4;2;1;;869;429;440;0;2;427;429
8;Barcelona;13;Barcelonès;08101;Hospitalet de Llobregat, l';4;20;1;;1141;674;467;15;1;658;659
8;Barcelona;13;Barcelonès;08101;Hospitalet de Llobregat, l';4;21;1;;1121;598;523;1;4;593;597
8;Barcelona;13;Barcelonès;08101;Hospitalet de Llobregat, l';4;22;1;;719;400;319;0;1;399;400
8;Barcelona;13;Barcelonès;08101;Hospitalet de Llobregat, l';4;23;1;;954;543;411;0;1;542;543
8;Barcelona;13;Barcelonès;08101;Hospitalet de Llobregat, l';4;24;1;;381;244;137;1;2;241;243
8;Barcelona;13;Barcelonès;08101;Hospitalet de Llobregat, l';4;25;1;;541;300;241;0;1;299;300
8;Barcelona;13;Barcelonès;08101;Hospitalet de Llobregat, l';4;26;1;;822;493;329;1;1;491;492
8;Barcelona;13;Barcelonès;08101;Hospitalet de Llobregat, l';4;27;1;;864;462;402;0;4;458;462
8;Barcelona;13;Barcelonès;08101;Hospitalet de Llobregat, l';4;28;1;;564;334;230;1;1;332;333
8;Barcelona;13;Barcelonès;08101;Hospitalet de Llobregat, l';4;29;1;;1010;561;449;10;0;551;551
8;Barcelona;13;Barcelonès;08101;Hospitalet de Llobregat, l';4;3;1;;1075;616;459;10;0;606;606
8;Barcelona;13;Barcelonès;08101;Hospitalet de Llobregat, l';4;30;1;;883;471;412;0;2;469;471
8;Barcelona;13;Barcelonès;08101;Hospitalet de Llobregat, l';4;31;1;;1280;797;483;7;0;790;790
8;Barcelona;13;Barcelonès;08101;Hospitalet de Llobregat, l';4;32;1;;1118;642;476;0;4;638;642
8;Barcelona;13;Barcelonès;08101;Hospitalet de Llobregat, l';4;33;1;;892;449;443;0;0;449;449
8;Barcelona;13;Barcelonès;08101;Hospitalet de Llobregat, l';4;34;1;;710;361;349;1;2;358;360
8;Barcelona;13;Barcelonès;08101;Hospitalet de Llobregat, l';4;35;1;;662;364;298;0;0;364;364
8;Barcelona;13;Barcelonès;08101;Hospitalet de Llobregat, l';4;36;1;;479;270;209;0;0;270;270
8;Barcelona;13;Barcelonès;08101;Hospitalet de Llobregat, l';4;37;1;;709;420;289;2;0;418;418
8;Barcelona;13;Barcelonès;08101;Hospitalet de Llobregat, l';4;38;1;;707;445;262;1;0;444;444
8;Barcelona;13;Barcelonès;08101;Hospitalet de Llobregat, l';4;39;1;;924;566;358;1;4;561;565
8;Barcelona;13;Barcelonès;08101;Hospitalet de Llobregat, l';4;4;1;;302;168;134;0;0;168;168
8;Barcelona;13;Barcelonès;08101;Hospitalet de Llobregat, l';4;40;1;;959;554;405;0;2;552;554
8;Barcelona;13;Barcelonès;08101;Hospitalet de Llobregat, l';4;41;1;;767;534;233;0;2;532;534
8;Barcelona;13;Barcelonès;08101;Hospitalet de Llobregat, l';4;41;2;;720;362;358;4;3;355;358
8;Barcelona;13;Barcelonès;08101;Hospitalet de Llobregat, l';4;42;1;;540;275;265;4;2;269;271
8;Barcelona;13;Barcelonès;08101;Hospitalet de Llobregat, l';4;43;1;;725;469;256;0;2;467;469
8;Barcelona;13;Barcelonès;08101;Hospitalet de Llobregat, l';4;44;1;;746;431;315;2;0;429;429
8;Barcelona;13;Barcelonès;08101;Hospitalet de Llobregat, l';4;45;1;;530;267;263;0;0;267;267
8;Barcelona;13;Barcelonès;08101;Hospitalet de Llobregat, l';4;46;1;;726;342;384;10;2;330;332
8;Barcelona;13;Barcelonès;08101;Hospitalet de Llobregat, l';4;47;1;;322;185;137;2;0;183;183
8;Barcelona;13;Barcelonès;08101;Hospitalet de Llobregat, l';4;5;1;;878;469;409;0;3;466;469
8;Barcelona;13;Barcelonès;08101;Hospitalet de Llobregat, l';4;6;1;;1146;637;509;0;0;637;637
8;Barcelona;13;Barcelonès;08101;Hospitalet de Llobregat, l';4;7;1;;735;396;339;0;1;395;396
8;Barcelona;13;Barcelonès;08101;Hospitalet de Llobregat, l';4;8;1;;819;470;349;0;0;470;470
8;Barcelona;13;Barcelonès;08101;Hospitalet de Llobregat, l';4;9;1;;606;314;292;1;1;312;313
8;Barcelona;13;Barcelonès;08101;Hospitalet de Llobregat, l';5;1;1;;738;501;237;0;1;500;501
8;Barcelona;13;Barcelonès;08101;Hospitalet de Llobregat, l';5;10;1;;985;562;423;4;1;557;558
8;Barcelona;13;Barcelonès;08101;Hospitalet de Llobregat, l';5;11;1;;694;415;279;0;3;412;415
8;Barcelona;13;Barcelonès;08101;Hospitalet de Llobregat, l';5;12;1;;873;476;397;0;0;476;476
8;Barcelona;13;Barcelonès;08101;Hospitalet de Llobregat, l';5;13;1;;705;387;318;0;1;386;387
8;Barcelona;13;Barcelonès;08101;Hospitalet de Llobregat, l';5;14;1;;721;409;312;5;2;402;404
8;Barcelona;13;Barcelonès;08101;Hospitalet de Llobregat, l';5;15;1;;528;303;225;1;2;300;302
8;Barcelona;13;Barcelonès;08101;Hospitalet de Llobregat, l';5;16;1;;614;321;293;10;1;310;311
8;Barcelona;13;Barcelonès;08101;Hospitalet de Llobregat, l';5;17;1;;586;342;244;1;1;340;341
8;Barcelona;13;Barcelonès;08101;Hospitalet de Llobregat, l';5;18;1;;1034;620;414;0;2;618;620
8;Barcelona;13;Barcelonès;08101;Hospitalet de Llobregat, l';5;19;1;;605;348;257;1;3;344;347
8;Barcelona;13;Barcelonès;08101;Hospitalet de Llobregat, l';5;2;1;;658;406;252;2;1;403;404
8;Barcelona;13;Barcelonès;08101;Hospitalet de Llobregat, l';5;20;1;;851;502;349;2;0;500;500
8;Barcelona;13;Barcelonès;08101;Hospitalet de Llobregat, l';5;21;1;;421;227;194;0;1;226;227
8;Barcelona;13;Barcelonès;08101;Hospitalet de Llobregat, l';5;22;1;;711;401;310;2;1;398;399
8;Barcelona;13;Barcelonès;08101;Hospitalet de Llobregat, l';5;23;1;;510;327;183;1;2;324;326
8;Barcelona;13;Barcelonès;08101;Hospitalet de Llobregat, l';5;24;1;;625;379;246;1;2;376;378
8;Barcelona;13;Barcelonès;08101;Hospitalet de Llobregat, l';5;25;1;;743;417;326;5;1;411;412
8;Barcelona;13;Barcelonès;08101;Hospitalet de Llobregat, l';5;26;1;;563;338;225;4;2;332;334
8;Barcelona;13;Barcelonès;08101;Hospitalet de Llobregat, l';5;27;1;;975;573;402;0;4;569;573
8;Barcelona;13;Barcelonès;08101;Hospitalet de Llobregat, l';5;28;1;;1007;601;406;2;3;596;599
8;Barcelona;13;Barcelonès;08101;Hospitalet de Llobregat, l';5;29;1;;815;490;325;0;3;487;490
8;Barcelona;13;Barcelonès;08101;Hospitalet de Llobregat, l';5;3;1;;327;193;134;0;0;193;193
8;Barcelona;13;Barcelonès;08101;Hospitalet de Llobregat, l';5;30;1;;409;242;167;4;2;236;238
8;Barcelona;13;Barcelonès;08101;Hospitalet de Llobregat, l';5;31;1;;878;503;375;3;3;497;500
8;Barcelona;13;Barcelonès;08101;Hospitalet de Llobregat, l';5;32;1;;1292;801;491;16;7;778;785
8;Barcelona;13;Barcelonès;08101;Hospitalet de Llobregat, l';5;33;1;;893;517;376;24;0;493;493
8;Barcelona;13;Barcelonès;08101;Hospitalet de Llobregat, l';5;34;1;;837;513;324;19;0;494;494
8;Barcelona;13;Barcelonès;08101;Hospitalet de Llobregat, l';5;35;1;;444;267;177;0;2;265;267
8;Barcelona;13;Barcelonès;08101;Hospitalet de Llobregat, l';5;36;1;;870;535;335;3;0;532;532
8;Barcelona;13;Barcelonès;08101;Hospitalet de Llobregat, l';5;37;1;;1100;672;428;0;9;663;672
8;Barcelona;13;Barcelonès;08101;Hospitalet de Llobregat, l';5;38;1;;729;440;289;0;3;437;440
8;Barcelona;13;Barcelonès;08101;Hospitalet de Llobregat, l';5;39;1;;463;263;200;6;2;255;257
8;Barcelona;13;Barcelonès;08101;Hospitalet de Llobregat, l';5;4;1;;761;433;328;4;2;427;429
8;Barcelona;13;Barcelonès;08101;Hospitalet de Llobregat, l';5;40;1;;1188;664;524;1;3;660;663
8;Barcelona;13;Barcelonès;08101;Hospitalet de Llobregat, l';5;41;1;;796;457;339;1;1;455;456
8;Barcelona;13;Barcelonès;08101;Hospitalet de Llobregat, l';5;42;1;;420;255;165;0;2;253;255
8;Barcelona;13;Barcelonès;08101;Hospitalet de Llobregat, l';5;43;1;;469;304;165;0;0;304;304
8;Barcelona;13;Barcelonès;08101;Hospitalet de Llobregat, l';5;44;1;;1334;802;532;2;8;792;800
8;Barcelona;13;Barcelonès;08101;Hospitalet de Llobregat, l';5;44;2;;1154;699;455;1;3;695;698
8;Barcelona;13;Barcelonès;08101;Hospitalet de Llobregat, l';5;45;1;;87;43;44;0;0;43;43
8;Barcelona;13;Barcelonès;08101;Hospitalet de Llobregat, l';5;5;1;;754;442;312;1;1;440;441
8;Barcelona;13;Barcelonès;08101;Hospitalet de Llobregat, l';5;6;1;;709;441;268;1;3;437;440
8;Barcelona;13;Barcelonès;08101;Hospitalet de Llobregat, l';5;6;2;;541;335;206;0;0;335;335
8;Barcelona;13;Barcelonès;08101;Hospitalet de Llobregat, l';5;7;1;;689;411;278;5;0;406;406
8;Barcelona;13;Barcelonès;08101;Hospitalet de Llobregat, l';5;8;1;;603;390;213;0;0;390;390
8;Barcelona;13;Barcelonès;08101;Hospitalet de Llobregat, l';5;9;1;;682;427;255;2;1;424;425
8;Barcelona;13;Barcelonès;08101;Hospitalet de Llobregat, l';6;1;1;;1087;683;404;2;5;676;681
8;Barcelona;13;Barcelonès;08101;Hospitalet de Llobregat, l';6;10;1;;816;536;280;0;0;536;536
8;Barcelona;13;Barcelonès;08101;Hospitalet de Llobregat, l';6;11;1;;1033;616;417;0;2;614;616
8;Barcelona;13;Barcelonès;08101;Hospitalet de Llobregat, l';6;12;1;;1020;606;414;0;0;606;606
8;Barcelona;13;Barcelonès;08101;Hospitalet de Llobregat, l';6;13;1;;1197;722;475;2;6;714;720
8;Barcelona;13;Barcelonès;08101;Hospitalet de Llobregat, l';6;14;1;;888;541;347;0;0;541;541
8;Barcelona;13;Barcelonès;08101;Hospitalet de Llobregat, l';6;15;1;;796;480;316;9;2;469;471
8;Barcelona;13;Barcelonès;08101;Hospitalet de Llobregat, l';6;16;1;;1707;896;811;3;11;882;893
8;Barcelona;13;Barcelonès;08101;Hospitalet de Llobregat, l';6;17;1;;543;263;280;0;0;263;263
8;Barcelona;13;Barcelonès;08101;Hospitalet de Llobregat, l';6;18;1;;519;313;206;0;2;311;313
8;Barcelona;13;Barcelonès;08101;Hospitalet de Llobregat, l';6;19;1;;1179;721;458;3;4;714;718
8;Barcelona;13;Barcelonès;08101;Hospitalet de Llobregat, l';6;2;1;;554;347;207;2;0;345;345
8;Barcelona;13;Barcelonès;08101;Hospitalet de Llobregat, l';6;20;1;;512;291;221;0;4;287;291
8;Barcelona;13;Barcelonès;08101;Hospitalet de Llobregat, l';6;21;1;;1231;704;527;0;2;702;704
8;Barcelona;13;Barcelonès;08101;Hospitalet de Llobregat, l';6;22;1;;439;273;166;0;3;270;273
8;Barcelona;13;Barcelonès;08101;Hospitalet de Llobregat, l';6;23;1;;805;547;258;0;0;547;547
8;Barcelona;13;Barcelonès;08101;Hospitalet de Llobregat, l';6;24;1;;973;605;368;6;4;595;599
8;Barcelona;13;Barcelonès;08101;Hospitalet de Llobregat, l';6;25;1;;908;544;364;1;2;541;543
8;Barcelona;13;Barcelonès;08101;Hospitalet de Llobregat, l';6;26;1;;1033;507;526;0;1;506;507
8;Barcelona;13;Barcelonès;08101;Hospitalet de Llobregat, l';6;27;1;;853;549;304;1;1;547;548
8;Barcelona;13;Barcelonès;08101;Hospitalet de Llobregat, l';6;28;1;;852;485;367;0;3;482;485
8;Barcelona;13;Barcelonès;08101;Hospitalet de Llobregat, l';6;29;1;;394;240;154;0;0;240;240
8;Barcelona;13;Barcelonès;08101;Hospitalet de Llobregat, l';6;3;1;;541;302;239;0;0;302;302
8;Barcelona;13;Barcelonès;08101;Hospitalet de Llobregat, l';6;30;1;;723;457;266;0;1;456;457
8;Barcelona;13;Barcelonès;08101;Hospitalet de Llobregat, l';6;31;1;;972;574;398;1;0;573;573
8;Barcelona;13;Barcelonès;08101;Hospitalet de Llobregat, l';6;32;1;;814;376;438;1;0;375;375
8;Barcelona;13;Barcelonès;08101;Hospitalet de Llobregat, l';6;33;1;;1036;536;500;3;3;530;533
8;Barcelona;13;Barcelonès;08101;Hospitalet de Llobregat, l';6;34;1;;620;341;279;3;3;335;338
8;Barcelona;13;Barcelonès;08101;Hospitalet de Llobregat, l';6;4;1;;625;358;267;1;2;355;357
8;Barcelona;13;Barcelonès;08101;Hospitalet de Llobregat, l';6;5;1;;684;423;261;1;2;420;422
8;Barcelona;13;Barcelonès;08101;Hospitalet de Llobregat, l';6;6;1;;978;555;423;3;1;551;552
8;Barcelona;13;Barcelonès;08101;Hospitalet de Llobregat, l';6;7;1;;936;528;408;1;1;526;527
8;Barcelona;13;Barcelonès;08101;Hospitalet de Llobregat, l';6;8;1;;887;458;429;1;1;456;457
8;Barcelona;13;Barcelonès;08101;Hospitalet de Llobregat, l';6;9;1;;735;491;244;0;1;490;491
8;Barcelona;6;Anoia;08162;Hostalets de Pierola, els;1;1;1;;690;488;202;0;4;484;488
17;Girona;34;Selva;17083;Hostalric;1;1;1;;1119;813;306;2;1;810;811
17;Girona;34;Selva;17083;Hostalric;1;2;1;;793;536;257;2;2;532;534
8;Barcelona;6;Anoia;08102;Igualada;1;1;1;;714;530;184;1;2;527;529
8;Barcelona;6;Anoia;08102;Igualada;1;2;1;;800;569;231;20;1;548;549
8;Barcelona;6;Anoia;08102;Igualada;1;3;1;;686;482;204;3;4;475;479
8;Barcelona;6;Anoia;08102;Igualada;2;1;1;;806;555;251;3;3;549;552
8;Barcelona;6;Anoia;08102;Igualada;2;2;1;;967;718;249;15;2;701;703
8;Barcelona;6;Anoia;08102;Igualada;2;3;1;;1418;1079;339;5;7;1067;1074
8;Barcelona;6;Anoia;08102;Igualada;3;1;1;;1028;754;274;1;3;750;753
8;Barcelona;6;Anoia;08102;Igualada;3;2;1;;704;499;205;0;3;496;499
8;Barcelona;6;Anoia;08102;Igualada;3;3;1;;875;661;214;1;5;655;660
8;Barcelona;6;Anoia;08102;Igualada;3;3;2;;869;662;207;0;2;660;662
8;Barcelona;6;Anoia;08102;Igualada;3;4;1;;786;517;269;3;2;512;514
8;Barcelona;6;Anoia;08102;Igualada;3;4;2;;843;600;243;4;6;590;596
8;Barcelona;6;Anoia;08102;Igualada;3;5;1;;1132;821;311;0;3;818;821
8;Barcelona;6;Anoia;08102;Igualada;4;1;1;;970;711;259;10;1;700;701
8;Barcelona;6;Anoia;08102;Igualada;4;2;1;;989;710;279;6;1;703;704
8;Barcelona;6;Anoia;08102;Igualada;4;3;1;;604;441;163;1;2;438;440
8;Barcelona;6;Anoia;08102;Igualada;4;4;1;;1033;775;258;5;3;767;770
8;Barcelona;6;Anoia;08102;Igualada;4;5;1;;1245;906;339;0;5;901;906
8;Barcelona;6;Anoia;08102;Igualada;5;1;1;;1105;814;291;3;3;808;811
8;Barcelona;6;Anoia;08102;Igualada;5;2;1;;1172;864;308;1;2;861;863
8;Barcelona;6;Anoia;08102;Igualada;5;3;1;;893;658;235;8;5;645;650
8;Barcelona;6;Anoia;08102;Igualada;5;3;2;;882;680;202;7;3;670;673
8;Barcelona;6;Anoia;08102;Igualada;5;4;1;;775;524;251;5;2;517;519
8;Barcelona;6;Anoia;08102;Igualada;5;4;2;;803;575;228;14;5;556;561
8;Barcelona;6;Anoia;08102;Igualada;5;5;1;;679;468;211;3;2;463;465
8;Barcelona;6;Anoia;08102;Igualada;5;6;1;;1289;863;426;29;18;816;834
25;Lleida;25;Pallars Jussà;25115;Isona i Conca Dellà;1;1;1;;842;468;374;2;3;463;466
25;Lleida;25;Pallars Jussà;25115;Isona i Conca Dellà;1;1;2;;126;96;30;0;0;96;96
25;Lleida;25;Pallars Jussà;25115;Isona i Conca Dellà;1;1;3;;219;172;47;0;1;171;172
25;Lleida;25;Pallars Jussà;25115;Isona i Conca Dellà;1;1;4;;112;74;38;1;0;73;73
17;Girona;15;Cerdanya;17084;Isòvol;1;1;1;;167;123;44;1;0;122;122
25;Lleida;27;Pla d'Urgell;25113;Ivars d'Urgell;1;1;1;;660;510;150;2;1;507;508
25;Lleida;27;Pla d'Urgell;25113;Ivars d'Urgell;1;2;1;;785;580;205;3;7;570;577
25;Lleida;23;Noguera;25112;Ivars de Noguera;1;1;1;;308;237;71;0;0;237;237
25;Lleida;32;Segarra;25114;Ivorra;1;1;1;;156;139;17;0;0;139;139
17;Girona;10;Baix Empordà;17085;Jafre;1;1;1;;294;246;48;1;1;244;245
17;Girona;2;Alt Empordà;17086;Jonquera, la;1;1;1;;946;666;280;3;2;661;663
17;Girona;2;Alt Empordà;17086;Jonquera, la;1;1;2;;903;642;261;6;3;633;636
8;Barcelona;6;Anoia;08103;Jorba;1;1;1;;376;280;96;0;1;279;280
25;Lleida;4;Alt Urgell;25910;Josa i Tuixén;1;1;1;;118;76;42;2;2;72;74
17;Girona;20;Gironès;17087;Juià;1;1;1;;203;142;61;1;0;141;141
25;Lleida;18;Garrigues;25118;Juncosa;1;1;1;;504;338;166;0;2;336;338
25;Lleida;18;Garrigues;25119;Juneda;1;1;1;;1486;1042;444;6;6;1030;1036
25;Lleida;18;Garrigues;25119;Juneda;1;2;1;;897;654;243;2;4;648;652
25;Lleida;39;Consell General d'Aran;25121;Les;1;1;1;;483;346;137;0;1;345;346
25;Lleida;27;Pla d'Urgell;25122;Linyola;1;1;1;;921;675;246;2;6;667;673
25;Lleida;27;Pla d'Urgell;25122;Linyola;1;2;1;;913;630;283;4;2;624;626
8;Barcelona;6;Anoia;08104;Llacuna, la;1;1;1;;597;412;185;2;2;408;410
17;Girona;2;Alt Empordà;17088;Lladó;1;1;1;;433;309;124;2;6;301;307
25;Lleida;26;Pallars Sobirà;25123;Lladorre;1;1;1;;169;136;33;0;1;135;136
25;Lleida;35;Solsonès;25124;Lladurs;1;1;1;;251;132;119;0;1;131;132
8;Barcelona;41;Vallès Oriental;08105;Llagosta, la;1;1;1;;1225;753;472;1;2;750;752
8;Barcelona;41;Vallès Oriental;08105;Llagosta, la;1;1;2;;1186;718;468;0;2;716;718
8;Barcelona;41;Vallès Oriental;08105;Llagosta, la;1;2;1;;837;555;282;1;1;553;554
8;Barcelona;41;Vallès Oriental;08105;Llagosta, la;1;2;2;;869;579;290;5;3;571;574
8;Barcelona;41;Vallès Oriental;08105;Llagosta, la;1;3;1;;1215;671;544;0;4;667;671
8;Barcelona;41;Vallès Oriental;08105;Llagosta, la;1;3;2;;1385;797;588;4;5;788;793
8;Barcelona;41;Vallès Oriental;08105;Llagosta, la;1;4;1;;1097;628;469;0;1;627;628
8;Barcelona;41;Vallès Oriental;08105;Llagosta, la;1;5;1;;668;399;269;0;1;398;399
17;Girona;20;Gironès;17089;Llagostera;1;1;1;;1295;918;377;0;3;915;918
17;Girona;20;Gironès;17089;Llagostera;1;2;1;;1700;1225;475;3;4;1218;1222
17;Girona;20;Gironès;17089;Llagostera;1;3;1;;786;484;302;4;0;480;480
17;Girona;20;Gironès;17090;Llambilles;1;1;1;;312;267;45;1;0;266;266
17;Girona;31;Ripollès;17091;Llanars;1;1;1;;318;265;53;1;3;261;264
17;Girona;2;Alt Empordà;17092;Llançà;1;1;1;;533;384;149;4;0;380;380
17;Girona;2;Alt Empordà;17092;Llançà;1;2;1;;679;480;199;6;2;472;474
17;Girona;2;Alt Empordà;17092;Llançà;1;3;1;;1125;796;329;9;0;787;787
25;Lleida;33;Segrià;25125;Llardecans;1;1;1;;614;435;179;0;1;434;435
25;Lleida;26;Pallars Sobirà;25126;Llavorsí;1;1;1;;269;174;95;0;0;174;174
25;Lleida;33;Segrià;25120;Lleida;1;1;1;;880;603;277;0;10;593;603
25;Lleida;33;Segrià;25120;Lleida;1;1;2;;792;575;217;2;5;568;573
25;Lleida;33;Segrià;25120;Lleida;1;2;1;;853;550;303;2;6;542;548
25;Lleida;33;Segrià;25120;Lleida;1;3;1;;1079;618;461;2;2;614;616
25;Lleida;33;Segrià;25120;Lleida;1;3;2;;991;702;289;4;10;688;698
25;Lleida;33;Segrià;25120;Lleida;1;4;1;;942;563;379;7;5;551;556
25;Lleida;33;Segrià;25120;Lleida;1;5;1;;976;607;369;5;6;596;602
25;Lleida;33;Segrià;25120;Lleida;1;5;2;;959;609;350;1;4;604;608
25;Lleida;33;Segrià;25120;Lleida;1;6;1;;588;293;295;0;3;290;293
25;Lleida;33;Segrià;25120;Lleida;1;6;2;;525;341;184;4;1;336;337
25;Lleida;33;Segrià;25120;Lleida;1;7;1;;1059;536;523;5;0;531;531
25;Lleida;33;Segrià;25120;Lleida;1;8;1;;1504;889;615;8;11;870;881
25;Lleida;33;Segrià;25120;Lleida;2;1;1;;770;477;293;5;2;470;472
25;Lleida;33;Segrià;25120;Lleida;2;2;1;;597;373;224;3;3;367;370
25;Lleida;33;Segrià;25120;Lleida;2;3;1;;681;347;334;0;3;344;347
25;Lleida;33;Segrià;25120;Lleida;2;3;2;;646;348;298;4;3;341;344
25;Lleida;33;Segrià;25120;Lleida;2;4;1;;1392;866;526;4;9;853;862
25;Lleida;33;Segrià;25120;Lleida;2;5;1;;883;577;306;3;4;570;574
25;Lleida;33;Segrià;25120;Lleida;2;5;2;;849;504;345;2;1;501;502
25;Lleida;33;Segrià;25120;Lleida;2;6;1;;1059;599;460;1;1;597;598
25;Lleida;33;Segrià;25120;Lleida;2;7;1;;1215;603;612;4;5;594;599
25;Lleida;33;Segrià;25120;Lleida;3;1;1;;811;464;347;0;2;462;464
25;Lleida;33;Segrià;25120;Lleida;3;2;1;;872;491;381;0;0;491;491
25;Lleida;33;Segrià;25120;Lleida;3;3;1;;874;621;253;3;1;617;618
25;Lleida;33;Segrià;25120;Lleida;3;4;1;;870;553;317;0;7;546;553
25;Lleida;33;Segrià;25120;Lleida;3;4;2;;786;504;282;0;4;500;504
25;Lleida;33;Segrià;25120;Lleida;3;5;1;;1083;349;734;0;3;346;349
25;Lleida;33;Segrià;25120;Lleida;3;6;1;;835;543;292;1;3;539;542
25;Lleida;33;Segrià;25120;Lleida;3;6;2;;823;563;260;1;4;558;562
25;Lleida;33;Segrià;25120;Lleida;4;1;1;;634;370;264;0;5;365;370
25;Lleida;33;Segrià;25120;Lleida;4;1;2;;609;326;283;1;2;323;325
25;Lleida;33;Segrià;25120;Lleida;4;10;1;;1283;703;580;0;7;696;703
25;Lleida;33;Segrià;25120;Lleida;4;2;1;;978;572;406;2;14;556;570
25;Lleida;33;Segrià;25120;Lleida;4;3;1;;1080;698;382;1;4;693;697
25;Lleida;33;Segrià;25120;Lleida;4;3;2;;1025;737;288;2;8;727;735
25;Lleida;33;Segrià;25120;Lleida;4;4;1;;1073;569;504;3;7;559;566
25;Lleida;33;Segrià;25120;Lleida;4;4;2;;1005;578;427;3;9;566;575
25;Lleida;33;Segrià;25120;Lleida;4;5;1;;1194;575;619;1;3;571;574
25;Lleida;33;Segrià;25120;Lleida;4;6;1;;827;545;282;1;11;533;544
25;Lleida;33;Segrià;25120;Lleida;4;6;2;;753;481;272;1;6;474;480
25;Lleida;33;Segrià;25120;Lleida;4;7;1;;927;511;416;3;7;501;508
25;Lleida;33;Segrià;25120;Lleida;4;7;2;;913;524;389;3;5;516;521
25;Lleida;33;Segrià;25120;Lleida;4;8;1;;1082;575;507;3;4;568;572
25;Lleida;33;Segrià;25120;Lleida;4;8;2;;1054;618;436;2;3;613;616
25;Lleida;33;Segrià;25120;Lleida;4;9;1;;966;419;547;1;1;417;418
25;Lleida;33;Segrià;25120;Lleida;4;9;2;;952;536;416;0;3;533;536
25;Lleida;33;Segrià;25120;Lleida;5;1;1;;564;305;259;1;0;304;304
25;Lleida;33;Segrià;25120;Lleida;5;2;1;;740;464;276;1;5;458;463
25;Lleida;33;Segrià;25120;Lleida;5;2;2;;678;442;236;2;6;434;440
25;Lleida;33;Segrià;25120;Lleida;5;3;1;;1168;770;398;3;15;752;767
25;Lleida;33;Segrià;25120;Lleida;5;4;1;;781;468;313;0;5;463;468
25;Lleida;33;Segrià;25120;Lleida;5;4;2;;700;498;202;4;3;491;494
25;Lleida;33;Segrià;25120;Lleida;5;5;1;;933;596;337;2;8;586;594
25;Lleida;33;Segrià;25120;Lleida;5;5;2;;926;609;317;2;8;599;607
25;Lleida;33;Segrià;25120;Lleida;5;6;1;;1098;711;387;2;5;704;709
25;Lleida;33;Segrià;25120;Lleida;5;7;1;;1480;1056;424;2;10;1044;1054
25;Lleida;33;Segrià;25120;Lleida;6;1;1;;951;493;458;0;2;491;493
25;Lleida;33;Segrià;25120;Lleida;6;10;1;;1270;767;503;1;6;760;766
25;Lleida;33;Segrià;25120;Lleida;6;11;1;;1260;774;486;1;9;764;773
25;Lleida;33;Segrià;25120;Lleida;6;12;1;;1065;606;459;0;5;601;606
25;Lleida;33;Segrià;25120;Lleida;6;2;1;;712;470;242;3;6;461;467
25;Lleida;33;Segrià;25120;Lleida;6;2;2;;714;465;249;1;4;460;464
25;Lleida;33;Segrià;25120;Lleida;6;3;1;;782;432;350;1;7;424;431
25;Lleida;33;Segrià;25120;Lleida;6;3;2;;719;479;240;3;3;473;476
25;Lleida;33;Segrià;25120;Lleida;6;4;1;;1683;1084;599;8;14;1062;1076
25;Lleida;33;Segrià;25120;Lleida;6;5;1;;1030;651;379;1;4;646;650
25;Lleida;33;Segrià;25120;Lleida;6;5;2;;935;733;202;4;7;722;729
25;Lleida;33;Segrià;25120;Lleida;6;6;1;;810;453;357;0;10;443;453
25;Lleida;33;Segrià;25120;Lleida;6;6;2;;804;438;366;2;4;432;436
25;Lleida;33;Segrià;25120;Lleida;6;7;1;;692;368;324;4;4;360;364
25;Lleida;33;Segrià;25120;Lleida;6;7;2;;618;323;295;5;4;314;318
25;Lleida;33;Segrià;25120;Lleida;6;8;1;;1073;693;380;5;2;686;688
25;Lleida;33;Segrià;25120;Lleida;6;9;1;;878;465;413;3;2;460;462
25;Lleida;33;Segrià;25120;Lleida;6;9;2;;871;564;307;3;8;553;561
25;Lleida;33;Segrià;25120;Lleida;7;1;1;;687;364;323;4;5;355;360
25;Lleida;33;Segrià;25120;Lleida;7;1;2;;610;359;251;3;1;355;356
25;Lleida;33;Segrià;25120;Lleida;7;2;1;;923;441;482;3;4;434;438
25;Lleida;33;Segrià;25120;Lleida;7;2;2;;893;591;302;2;7;582;589
25;Lleida;33;Segrià;25120;Lleida;7;3;1;;283;153;130;1;0;152;152
25;Lleida;33;Segrià;25120;Lleida;7;4;1;;770;433;337;1;3;429;432
25;Lleida;33;Segrià;25120;Lleida;7;4;2;;686;447;239;1;3;443;446
25;Lleida;33;Segrià;25120;Lleida;7;5;1;;329;160;169;0;1;159;160
25;Lleida;33;Segrià;25120;Lleida;7;6;1;;1253;758;495;3;10;745;755
25;Lleida;33;Segrià;25120;Lleida;8;1;1;;739;316;423;1;2;313;315
25;Lleida;33;Segrià;25120;Lleida;8;1;2;;689;326;363;0;0;326;326
25;Lleida;33;Segrià;25120;Lleida;8;2;1;;768;336;432;0;3;333;336
25;Lleida;33;Segrià;25120;Lleida;8;3;1;;395;228;167;0;1;227;228
25;Lleida;33;Segrià;25120;Lleida;8;3;2;;483;272;211;2;1;269;270
25;Lleida;33;Segrià;25120;Lleida;9;1;1;;999;489;510;7;3;479;482
25;Lleida;33;Segrià;25120;Lleida;9;2;1;;591;344;247;2;3;339;342
25;Lleida;33;Segrià;25120;Lleida;9;2;2;;590;272;318;0;1;271;272
17;Girona;2;Alt Empordà;17093;Llers;1;1;1;;515;315;200;1;1;313;314
25;Lleida;15;Cerdanya;25127;Lles de Cerdanya;1;1;1;;270;199;71;0;1;198;199
8;Barcelona;41;Vallès Oriental;08107;Lliçà d'Amunt;1;1;1;;923;654;269;3;1;650;651
8;Barcelona;41;Vallès Oriental;08107;Lliçà d'Amunt;1;1;2;;1084;788;296;5;1;782;783
8;Barcelona;41;Vallès Oriental;08108;Lliçà de Vall;1;1;1;;700;462;238;13;2;447;449
8;Barcelona;41;Vallès Oriental;08108;Lliçà de Vall;1;1;2;;661;445;216;7;2;436;438
25;Lleida;25;Pallars Jussà;25128;Llimiana;1;1;1;;149;80;69;0;1;79;80
8;Barcelona;41;Vallès Oriental;08106;Llinars del Vallès;1;1;1;;933;602;331;1;3;598;601
8;Barcelona;41;Vallès Oriental;08106;Llinars del Vallès;1;1;2;;814;547;267;6;2;539;541
8;Barcelona;41;Vallès Oriental;08106;Llinars del Vallès;2;1;1;;801;557;244;1;5;551;556
8;Barcelona;41;Vallès Oriental;08106;Llinars del Vallès;2;1;2;;712;474;238;1;2;471;473
17;Girona;15;Cerdanya;17094;Llívia;1;1;1;;677;480;197;6;0;474;474
43;Tarragona;29;Priorat;43072;Lloar, el;1;1;1;;160;119;41;1;0;118;118
25;Lleida;35;Solsonès;25129;Llobera;1;1;1;;208;159;49;1;0;158;158
43;Tarragona;16;Conca de Barberà;43073;Llorac;1;1;1;;80;61;19;1;0;60;60
43;Tarragona;12;Baix Penedès;43074;Llorenç del Penedès;1;1;1;;938;745;193;4;2;739;741
17;Girona;34;Selva;17095;Lloret de Mar;1;1;1;;745;341;404;2;1;338;339
17;Girona;34;Selva;17095;Lloret de Mar;1;2;1;;911;546;365;0;4;542;546
17;Girona;34;Selva;17095;Lloret de Mar;2;1;1;;1519;1024;495;1;3;1020;1023
17;Girona;34;Selva;17095;Lloret de Mar;2;2;1;;1056;627;429;4;1;622;623
17;Girona;34;Selva;17095;Lloret de Mar;2;3;1;;756;413;343;3;0;410;410
17;Girona;34;Selva;17095;Lloret de Mar;3;1;1;;365;203;162;1;1;201;202
17;Girona;34;Selva;17095;Lloret de Mar;3;2;1;;1654;946;708;3;5;938;943
17;Girona;34;Selva;17095;Lloret de Mar;4;1;1;;1026;497;529;0;0;497;497
17;Girona;31;Ripollès;17096;Llosses, les;1;1;1;;378;196;182;1;2;193;195
8;Barcelona;24;Osona;08109;Lluçà;1;1;1;;235;173;62;0;0;173;173
17;Girona;2;Alt Empordà;17102;Maçanet de Cabrenys;1;1;1;;635;455;180;2;0;453;453
17;Girona;34;Selva;17103;Maçanet de la Selva;1;1;1;;757;459;298;0;3;456;459
17;Girona;34;Selva;17103;Maçanet de la Selva;1;1;2;;840;550;290;2;6;542;548
17;Girona;20;Gironès;17097;Madremanya;1;1;1;;163;115;48;1;2;112;114
17;Girona;19;Garrotxa;17098;Maià de Montcal;1;1;1;;294;213;81;1;1;211;212
25;Lleida;33;Segrià;25133;Maials;1;1;1;;1046;713;333;9;1;703;704
25;Lleida;38;Urgell;25130;Maldà;1;1;1;;322;204;118;0;0;204;204
8;Barcelona;21;Maresme;08110;Malgrat de Mar;1;1;1;;751;451;300;1;2;448;450
8;Barcelona;21;Maresme;08110;Malgrat de Mar;1;1;2;;732;495;237;0;4;491;495
8;Barcelona;21;Maresme;08110;Malgrat de Mar;1;2;1;;639;474;165;2;4;468;472
8;Barcelona;21;Maresme;08110;Malgrat de Mar;1;2;2;;585;412;173;10;3;399;402
8;Barcelona;21;Maresme;08110;Malgrat de Mar;1;2;3;;612;453;159;1;1;451;452
8;Barcelona;21;Maresme;08110;Malgrat de Mar;1;3;1;;675;457;218;1;0;456;456
8;Barcelona;21;Maresme;08110;Malgrat de Mar;1;3;2;;630;431;199;13;4;414;418
8;Barcelona;21;Maresme;08110;Malgrat de Mar;1;3;3;;681;453;228;0;1;452;453
8;Barcelona;21;Maresme;08110;Malgrat de Mar;2;1;1;;914;656;258;4;1;651;652
8;Barcelona;21;Maresme;08110;Malgrat de Mar;2;2;1;;496;393;103;0;0;393;393
8;Barcelona;21;Maresme;08110;Malgrat de Mar;2;3;1;;629;447;182;1;1;445;446
8;Barcelona;21;Maresme;08110;Malgrat de Mar;2;3;2;;767;536;231;3;5;528;533
8;Barcelona;24;Osona;08111;Malla;1;1;1;;225;178;47;1;3;174;177
8;Barcelona;24;Osona;08112;Manlleu;1;1;1;;697;516;181;1;1;514;515
8;Barcelona;24;Osona;08112;Manlleu;1;1;2;;677;508;169;1;0;507;507
8;Barcelona;24;Osona;08112;Manlleu;1;2;1;;897;708;189;0;4;704;708
8;Barcelona;24;Osona;08112;Manlleu;2;1;1;;879;667;212;1;0;666;666
8;Barcelona;24;Osona;08112;Manlleu;2;1;2;;901;714;187;2;3;709;712
8;Barcelona;24;Osona;08112;Manlleu;2;2;1;;1189;817;372;3;0;814;814
8;Barcelona;24;Osona;08112;Manlleu;2;2;2;;1457;1008;449;4;2;1002;1004
8;Barcelona;24;Osona;08112;Manlleu;3;1;1;;1157;811;346;2;0;809;809
8;Barcelona;24;Osona;08112;Manlleu;3;1;2;;1335;888;447;2;7;879;886
8;Barcelona;24;Osona;08112;Manlleu;3;2;1;;1160;827;333;3;0;824;824
8;Barcelona;24;Osona;08112;Manlleu;4;1;1;;668;518;150;0;1;517;518
8;Barcelona;24;Osona;08112;Manlleu;4;2;1;;1133;834;299;5;3;826;829
8;Barcelona;7;Bages;08113;Manresa;1;1;1;;1086;657;429;3;2;652;654
8;Barcelona;7;Bages;08113;Manresa;1;2;1;;496;339;157;3;1;335;336
8;Barcelona;7;Bages;08113;Manresa;1;3;1;;565;424;141;4;0;420;420
8;Barcelona;7;Bages;08113;Manresa;1;4;1;;485;377;108;3;0;374;374
8;Barcelona;7;Bages;08113;Manresa;2;1;1;;895;693;202;0;3;690;693
8;Barcelona;7;Bages;08113;Manresa;2;10;1;;1415;1141;274;4;7;1130;1137
8;Barcelona;7;Bages;08113;Manresa;2;11;1;;1053;781;272;0;2;779;781
8;Barcelona;7;Bages;08113;Manresa;2;12;1;;378;295;83;2;1;292;293
8;Barcelona;7;Bages;08113;Manresa;2;13;1;;322;252;70;0;0;252;252
8;Barcelona;7;Bages;08113;Manresa;2;14;1;;576;271;305;1;0;270;270
8;Barcelona;7;Bages;08113;Manresa;2;15;1;;399;282;117;0;2;280;282
8;Barcelona;7;Bages;08113;Manresa;2;2;1;;1258;1017;241;5;2;1010;1012
8;Barcelona;7;Bages;08113;Manresa;2;3;1;;1334;1052;282;3;1;1048;1049
8;Barcelona;7;Bages;08113;Manresa;2;4;1;;1419;1048;371;2;0;1046;1046
8;Barcelona;7;Bages;08113;Manresa;2;5;1;;1120;869;251;7;7;855;862
8;Barcelona;7;Bages;08113;Manresa;2;6;1;;805;555;250;2;8;545;553
8;Barcelona;7;Bages;08113;Manresa;2;7;1;;1047;717;330;3;4;710;714
8;Barcelona;7;Bages;08113;Manresa;2;8;1;;721;542;179;0;5;537;542
8;Barcelona;7;Bages;08113;Manresa;2;9;1;;1007;746;261;6;2;738;740
8;Barcelona;7;Bages;08113;Manresa;2;9;2;;1012;719;293;2;4;713;717
8;Barcelona;7;Bages;08113;Manresa;3;1;1;;671;468;203;0;1;467;468
8;Barcelona;7;Bages;08113;Manresa;3;2;1;;828;630;198;1;0;629;629
8;Barcelona;7;Bages;08113;Manresa;3;3;1;;757;531;226;6;2;523;525
8;Barcelona;7;Bages;08113;Manresa;3;4;1;;1056;812;244;3;1;808;809
8;Barcelona;7;Bages;08113;Manresa;3;5;1;;389;280;109;2;1;277;278
8;Barcelona;7;Bages;08113;Manresa;3;6;1;;1205;940;265;2;4;934;938
8;Barcelona;7;Bages;08113;Manresa;3;7;1;;712;551;161;1;1;549;550
8;Barcelona;7;Bages;08113;Manresa;4;1;1;;627;488;139;1;3;484;487
8;Barcelona;7;Bages;08113;Manresa;4;10;1;;972;723;249;0;5;718;723
8;Barcelona;7;Bages;08113;Manresa;4;11;1;;530;401;129;0;1;400;401
8;Barcelona;7;Bages;08113;Manresa;4;12;1;;164;131;33;0;0;131;131
8;Barcelona;7;Bages;08113;Manresa;4;13;1;;62;46;16;0;0;46;46
8;Barcelona;7;Bages;08113;Manresa;4;14;1;;800;597;203;0;5;592;597
8;Barcelona;7;Bages;08113;Manresa;4;2;1;;1045;790;255;2;8;780;788
8;Barcelona;7;Bages;08113;Manresa;4;3;1;;1002;771;231;1;2;768;770
8;Barcelona;7;Bages;08113;Manresa;4;4;1;;793;619;174;0;1;618;619
8;Barcelona;7;Bages;08113;Manresa;4;4;2;;814;674;140;4;1;669;670
8;Barcelona;7;Bages;08113;Manresa;4;5;1;;453;368;85;0;0;368;368
8;Barcelona;7;Bages;08113;Manresa;4;6;1;;1030;818;212;2;2;814;816
8;Barcelona;7;Bages;08113;Manresa;4;7;1;;1119;843;276;1;1;841;842
8;Barcelona;7;Bages;08113;Manresa;4;8;1;;588;423;165;0;3;420;423
8;Barcelona;7;Bages;08113;Manresa;4;9;1;;942;699;243;1;1;697;698
8;Barcelona;7;Bages;08113;Manresa;4;9;2;;938;669;269;9;0;660;660
8;Barcelona;7;Bages;08113;Manresa;5;1;1;;937;624;313;2;2;620;622
8;Barcelona;7;Bages;08113;Manresa;5;10;1;;863;598;265;1;1;596;597
8;Barcelona;7;Bages;08113;Manresa;5;10;2;;877;560;317;4;6;550;556
8;Barcelona;7;Bages;08113;Manresa;5;11;1;;1076;757;319;2;0;755;755
8;Barcelona;7;Bages;08113;Manresa;5;12;1;;785;553;232;3;5;545;550
8;Barcelona;7;Bages;08113;Manresa;5;13;1;;1065;754;311;3;5;746;751
8;Barcelona;7;Bages;08113;Manresa;5;14;1;;1005;790;215;0;4;786;790
8;Barcelona;7;Bages;08113;Manresa;5;15;1;;1189;762;427;3;6;753;759
8;Barcelona;7;Bages;08113;Manresa;5;2;1;;511;338;173;0;0;338;338
8;Barcelona;7;Bages;08113;Manresa;5;3;1;;816;558;258;1;1;556;557
8;Barcelona;7;Bages;08113;Manresa;5;4;1;;688;544;144;0;2;542;544
8;Barcelona;7;Bages;08113;Manresa;5;5;1;;1155;872;283;3;3;866;869
8;Barcelona;7;Bages;08113;Manresa;5;6;1;;1350;952;398;1;0;951;951
8;Barcelona;7;Bages;08113;Manresa;5;7;1;;468;365;103;0;0;365;365
8;Barcelona;7;Bages;08113;Manresa;5;8;1;;531;429;102;0;3;426;429
8;Barcelona;7;Bages;08113;Manresa;5;9;1;;925;702;223;1;2;699;701
8;Barcelona;7;Bages;08113;Manresa;6;1;1;;1374;956;418;6;0;950;950
8;Barcelona;7;Bages;08113;Manresa;6;2;1;;320;247;73;0;5;242;247
8;Barcelona;7;Bages;08113;Manresa;6;3;1;;215;163;52;0;0;163;163
8;Barcelona;7;Bages;08113;Manresa;6;4;1;;429;300;129;0;3;297;300
8;Barcelona;7;Bages;08113;Manresa;6;5;1;;116;85;31;0;0;85;85
43;Tarragona;29;Priorat;43076;Marçà;1;1;1;;509;382;127;12;1;369;370
43;Tarragona;29;Priorat;43075;Margalef;1;1;1;;140;85;55;0;1;84;85
8;Barcelona;7;Bages;08242;Marganell;1;1;1;;206;148;58;0;0;148;148
8;Barcelona;11;Baix Llobregat;08114;Martorell;1;1;1;;1071;705;366;2;3;700;703
8;Barcelona;11;Baix Llobregat;08114;Martorell;2;1;1;;816;504;312;3;2;499;501
8;Barcelona;11;Baix Llobregat;08114;Martorell;2;2;1;;588;402;186;1;2;399;401
8;Barcelona;11;Baix Llobregat;08114;Martorell;2;2;2;;509;366;143;1;3;362;365
8;Barcelona;11;Baix Llobregat;08114;Martorell;3;1;1;;781;495;286;1;2;492;494
8;Barcelona;11;Baix Llobregat;08114;Martorell;3;1;2;;699;451;248;2;1;448;449
8;Barcelona;11;Baix Llobregat;08114;Martorell;3;2;1;;1050;589;461;1;3;585;588
8;Barcelona;11;Baix Llobregat;08114;Martorell;3;3;1;;534;335;199;2;0;333;333
8;Barcelona;11;Baix Llobregat;08114;Martorell;3;3;2;;541;308;233;2;2;304;306
8;Barcelona;11;Baix Llobregat;08114;Martorell;3;4;1;;845;477;368;2;2;473;475
8;Barcelona;11;Baix Llobregat;08114;Martorell;3;4;2;;874;495;379;0;1;494;495
8;Barcelona;11;Baix Llobregat;08114;Martorell;3;5;1;;800;506;294;1;1;504;505
8;Barcelona;11;Baix Llobregat;08114;Martorell;3;5;2;;713;476;237;1;0;475;475
8;Barcelona;11;Baix Llobregat;08114;Martorell;3;6;1;;793;531;262;2;1;528;529
8;Barcelona;11;Baix Llobregat;08114;Martorell;3;6;2;;698;474;224;1;1;472;473
8;Barcelona;11;Baix Llobregat;08114;Martorell;3;7;1;;104;74;30;0;0;74;74
8;Barcelona;41;Vallès Oriental;08115;Martorelles;1;1;1;;709;481;228;0;1;480;481
8;Barcelona;41;Vallès Oriental;08115;Martorelles;1;1;2;;735;499;236;0;1;498;499
8;Barcelona;41;Vallès Oriental;08115;Martorelles;1;2;1;;697;514;183;5;2;507;509
8;Barcelona;41;Vallès Oriental;08115;Martorelles;1;2;2;;840;592;248;0;1;591;592
17;Girona;2;Alt Empordà;17100;Masarac;1;1;1;;228;156;72;3;3;150;153
43;Tarragona;22;Montsià;43077;Mas de Barberans;1;1;1;;635;448;187;3;0;445;445
43;Tarragona;22;Montsià;43078;Masdenverge;1;1;1;;662;381;281;2;4;375;379
8;Barcelona;24;Osona;08116;Masies de Roda, les;1;1;1;;449;320;129;8;1;311;312
8;Barcelona;24;Osona;08117;Masies de Voltregà, les;1;1;1;;1118;841;277;1;9;831;840
8;Barcelona;24;Osona;08117;Masies de Voltregà, les;1;2;1;;735;489;246;0;3;486;489
43;Tarragona;12;Baix Penedès;43079;Masllorenç;1;1;1;;341;260;81;0;1;259;260
8;Barcelona;21;Maresme;08118;Masnou, el;1;1;1;;1169;717;452;0;4;713;717
8;Barcelona;21;Maresme;08118;Masnou, el;1;1;2;;1043;666;377;10;2;654;656
8;Barcelona;21;Maresme;08118;Masnou, el;1;2;1;;1215;767;448;1;1;765;766
8;Barcelona;21;Maresme;08118;Masnou, el;1;2;2;;1173;727;446;1;9;717;726
8;Barcelona;21;Maresme;08118;Masnou, el;1;3;1;;1278;824;454;14;6;804;810
8;Barcelona;21;Maresme;08118;Masnou, el;1;4;1;;1091;665;426;0;5;660;665
8;Barcelona;21;Maresme;08118;Masnou, el;1;4;2;;1068;653;415;0;0;653;653
8;Barcelona;21;Maresme;08118;Masnou, el;2;1;1;;851;530;321;3;1;526;527
8;Barcelona;21;Maresme;08118;Masnou, el;2;1;2;;884;533;351;12;3;518;521
8;Barcelona;21;Maresme;08118;Masnou, el;2;2;1;;808;547;261;0;0;547;547
8;Barcelona;21;Maresme;08118;Masnou, el;2;2;2;;679;474;205;0;1;473;474
43;Tarragona;1;Alt Camp;43080;Masó, la;1;1;1;;235;172;63;4;2;166;168
43;Tarragona;8;Baix Camp;43081;Maspujols;1;1;1;;312;243;69;0;3;240;243
8;Barcelona;6;Anoia;08119;Masquefa;1;1;1;;890;611;279;0;1;610;611
8;Barcelona;6;Anoia;08119;Masquefa;1;1;2;;815;567;248;3;1;563;564
43;Tarragona;29;Priorat;43082;Masroig, el;1;1;1;;489;402;87;6;0;396;396
25;Lleida;33;Segrià;25131;Massalcoreig;1;1;1;;575;452;123;3;4;445;449
17;Girona;34;Selva;17101;Massanes;1;1;1;;387;279;108;2;0;277;277
25;Lleida;32;Segarra;25132;Massoteres;1;1;1;;160;103;57;0;0;103;103
8;Barcelona;40;Vallès Occidental;08120;Matadepera;1;1;1;;947;773;174;2;2;769;771
8;Barcelona;40;Vallès Occidental;08120;Matadepera;1;1;2;;966;776;190;4;3;769;772
8;Barcelona;21;Maresme;08121;Mataró;1;1;1;;767;653;114;3;2;648;650
8;Barcelona;21;Maresme;08121;Mataró;1;10;1;;437;367;70;0;1;366;367
8;Barcelona;21;Maresme;08121;Mataró;1;2;1;;520;371;149;1;3;367;370
8;Barcelona;21;Maresme;08121;Mataró;1;2;2;;476;369;107;1;0;368;368
8;Barcelona;21;Maresme;08121;Mataró;1;3;1;;735;575;160;0;3;572;575
8;Barcelona;21;Maresme;08121;Mataró;1;4;1;;405;307;98;5;1;301;302
8;Barcelona;21;Maresme;08121;Mataró;1;5;1;;622;496;126;0;2;494;496
8;Barcelona;21;Maresme;08121;Mataró;1;5;2;;615;478;137;1;0;477;477
8;Barcelona;21;Maresme;08121;Mataró;1;6;1;;736;552;184;1;2;549;551
8;Barcelona;21;Maresme;08121;Mataró;1;6;2;;661;507;154;0;0;507;507
8;Barcelona;21;Maresme;08121;Mataró;1;7;1;;575;433;142;0;2;431;433
8;Barcelona;21;Maresme;08121;Mataró;1;7;2;;521;405;116;0;2;403;405
8;Barcelona;21;Maresme;08121;Mataró;1;8;1;;632;496;136;1;2;493;495
8;Barcelona;21;Maresme;08121;Mataró;1;9;1;;631;492;139;0;0;492;492
8;Barcelona;21;Maresme;08121;Mataró;2;1;1;;491;365;126;1;0;364;364
8;Barcelona;21;Maresme;08121;Mataró;2;1;2;;425;347;78;1;0;346;346
8;Barcelona;21;Maresme;08121;Mataró;2;10;1;;503;327;176;0;0;327;327
8;Barcelona;21;Maresme;08121;Mataró;2;10;2;;532;390;142;1;2;387;389
8;Barcelona;21;Maresme;08121;Mataró;2;11;1;;602;458;144;3;3;452;455
8;Barcelona;21;Maresme;08121;Mataró;2;11;2;;530;402;128;0;0;402;402
8;Barcelona;21;Maresme;08121;Mataró;2;2;1;;783;545;238;8;4;533;537
8;Barcelona;21;Maresme;08121;Mataró;2;3;1;;711;404;307;0;0;404;404
8;Barcelona;21;Maresme;08121;Mataró;2;4;1;;445;275;170;0;1;274;275
8;Barcelona;21;Maresme;08121;Mataró;2;4;2;;458;301;157;1;0;300;300
8;Barcelona;21;Maresme;08121;Mataró;2;5;1;;621;436;185;8;1;427;428
8;Barcelona;21;Maresme;08121;Mataró;2;5;2;;572;433;139;0;0;433;433
8;Barcelona;21;Maresme;08121;Mataró;2;6;1;;522;369;153;2;0;367;367
8;Barcelona;21;Maresme;08121;Mataró;2;6;2;;524;370;154;2;4;364;368
8;Barcelona;21;Maresme;08121;Mataró;2;7;1;;558;396;162;0;1;395;396
8;Barcelona;21;Maresme;08121;Mataró;2;8;1;;971;682;289;1;4;677;681
8;Barcelona;21;Maresme;08121;Mataró;2;8;2;;944;708;236;3;2;703;705
8;Barcelona;21;Maresme;08121;Mataró;2;9;1;;457;345;112;2;0;343;343
8;Barcelona;21;Maresme;08121;Mataró;2;9;2;;507;363;144;0;2;361;363
8;Barcelona;21;Maresme;08121;Mataró;3;1;1;;658;441;217;0;2;439;441
8;Barcelona;21;Maresme;08121;Mataró;3;1;2;;675;444;231;0;4;440;444
8;Barcelona;21;Maresme;08121;Mataró;3;10;1;;516;410;106;2;2;406;408
8;Barcelona;21;Maresme;08121;Mataró;3;11;1;;622;423;199;1;7;415;422
8;Barcelona;21;Maresme;08121;Mataró;3;11;2;;626;410;216;2;1;407;408
8;Barcelona;21;Maresme;08121;Mataró;3;2;1;;772;501;271;1;2;498;500
8;Barcelona;21;Maresme;08121;Mataró;3;2;2;;573;412;161;0;0;412;412
8;Barcelona;21;Maresme;08121;Mataró;3;3;1;;565;362;203;0;1;361;362
8;Barcelona;21;Maresme;08121;Mataró;3;3;2;;510;368;142;0;1;367;368
8;Barcelona;21;Maresme;08121;Mataró;3;4;1;;835;521;314;0;5;516;521
8;Barcelona;21;Maresme;08121;Mataró;3;4;2;;836;524;312;1;3;520;523
8;Barcelona;21;Maresme;08121;Mataró;3;5;1;;648;427;221;0;2;425;427
8;Barcelona;21;Maresme;08121;Mataró;3;5;2;;618;395;223;2;0;393;393
8;Barcelona;21;Maresme;08121;Mataró;3;6;1;;838;575;263;0;4;571;575
8;Barcelona;21;Maresme;08121;Mataró;3;7;1;;571;373;198;1;4;368;372
8;Barcelona;21;Maresme;08121;Mataró;3;7;2;;539;315;224;0;1;314;315
8;Barcelona;21;Maresme;08121;Mataró;3;8;1;;513;346;167;0;1;345;346
8;Barcelona;21;Maresme;08121;Mataró;3;8;2;;504;323;181;0;4;319;323
8;Barcelona;21;Maresme;08121;Mataró;3;9;1;;615;389;226;3;0;386;386
8;Barcelona;21;Maresme;08121;Mataró;3;9;2;;595;379;216;3;2;374;376
8;Barcelona;21;Maresme;08121;Mataró;4;1;1;;504;365;139;0;0;365;365
8;Barcelona;21;Maresme;08121;Mataró;4;1;2;;496;359;137;1;0;358;358
8;Barcelona;21;Maresme;08121;Mataró;4;2;1;;663;365;298;2;1;362;363
8;Barcelona;21;Maresme;08121;Mataró;4;2;2;;575;396;179;2;0;394;394
8;Barcelona;21;Maresme;08121;Mataró;4;3;1;;443;277;166;5;0;272;272
8;Barcelona;21;Maresme;08121;Mataró;4;3;2;;444;295;149;10;2;283;285
8;Barcelona;21;Maresme;08121;Mataró;4;4;1;;836;516;320;3;0;513;513
8;Barcelona;21;Maresme;08121;Mataró;4;5;1;;810;461;349;2;2;457;459
8;Barcelona;21;Maresme;08121;Mataró;4;5;2;;789;478;311;2;3;473;476
8;Barcelona;21;Maresme;08121;Mataró;4;6;1;;575;391;184;0;0;391;391
8;Barcelona;21;Maresme;08121;Mataró;4;6;2;;493;347;146;1;0;346;346
8;Barcelona;21;Maresme;08121;Mataró;5;1;1;;842;566;276;0;1;565;566
8;Barcelona;21;Maresme;08121;Mataró;5;10;1;;534;362;172;0;2;360;362
8;Barcelona;21;Maresme;08121;Mataró;5;11;1;;644;367;277;0;1;366;367
8;Barcelona;21;Maresme;08121;Mataró;5;11;2;;491;310;181;0;1;309;310
8;Barcelona;21;Maresme;08121;Mataró;5;12;1;;887;586;301;11;2;573;575
8;Barcelona;21;Maresme;08121;Mataró;5;13;1;;425;276;149;3;0;273;273
8;Barcelona;21;Maresme;08121;Mataró;5;13;2;;817;522;295;8;0;514;514
8;Barcelona;21;Maresme;08121;Mataró;5;13;3;;646;442;204;5;3;434;437
8;Barcelona;21;Maresme;08121;Mataró;5;14;1;;397;265;132;0;1;264;265
8;Barcelona;21;Maresme;08121;Mataró;5;14;2;;349;246;103;0;1;245;246
8;Barcelona;21;Maresme;08121;Mataró;5;15;1;;943;596;347;3;0;593;593
8;Barcelona;21;Maresme;08121;Mataró;5;15;2;;864;533;331;3;7;523;530
8;Barcelona;21;Maresme;08121;Mataró;5;16;1;;581;366;215;0;0;366;366
8;Barcelona;21;Maresme;08121;Mataró;5;16;2;;449;299;150;1;3;295;298
8;Barcelona;21;Maresme;08121;Mataró;5;17;1;;764;478;286;1;0;477;477
8;Barcelona;21;Maresme;08121;Mataró;5;18;1;;544;367;177;1;1;365;366
8;Barcelona;21;Maresme;08121;Mataró;5;19;1;;564;405;159;2;4;399;403
8;Barcelona;21;Maresme;08121;Mataró;5;2;1;;615;407;208;8;3;396;399
8;Barcelona;21;Maresme;08121;Mataró;5;2;2;;571;391;180;0;2;389;391
8;Barcelona;21;Maresme;08121;Mataró;5;3;1;;610;365;245;1;4;360;364
8;Barcelona;21;Maresme;08121;Mataró;5;3;2;;620;381;239;0;5;376;381
8;Barcelona;21;Maresme;08121;Mataró;5;4;1;;646;430;216;2;1;427;428
8;Barcelona;21;Maresme;08121;Mataró;5;5;1;;569;374;195;11;0;363;363
8;Barcelona;21;Maresme;08121;Mataró;5;6;1;;616;357;259;2;1;354;355
8;Barcelona;21;Maresme;08121;Mataró;5;6;2;;499;309;190;1;1;307;308
8;Barcelona;21;Maresme;08121;Mataró;5;7;1;;975;672;303;0;3;669;672
8;Barcelona;21;Maresme;08121;Mataró;5;8;1;;496;314;182;1;0;313;313
8;Barcelona;21;Maresme;08121;Mataró;5;8;2;;400;290;110;0;4;286;290
8;Barcelona;21;Maresme;08121;Mataró;5;9;1;;502;352;150;2;2;348;350
8;Barcelona;21;Maresme;08121;Mataró;5;9;2;;474;330;144;0;1;329;330
8;Barcelona;21;Maresme;08121;Mataró;6;1;1;;647;448;199;2;2;444;446
8;Barcelona;21;Maresme;08121;Mataró;6;1;2;;627;423;204;2;1;420;421
8;Barcelona;21;Maresme;08121;Mataró;6;10;1;;972;595;377;1;3;591;594
8;Barcelona;21;Maresme;08121;Mataró;6;10;2;;794;515;279;13;1;501;502
8;Barcelona;21;Maresme;08121;Mataró;6;10;3;;658;373;285;1;1;371;372
8;Barcelona;21;Maresme;08121;Mataró;6;10;4;;611;327;284;5;1;321;322
8;Barcelona;21;Maresme;08121;Mataró;6;11;1;;686;425;261;12;2;411;413
8;Barcelona;21;Maresme;08121;Mataró;6;11;2;;660;461;199;7;1;453;454
8;Barcelona;21;Maresme;08121;Mataró;6;2;1;;616;451;165;8;1;442;443
8;Barcelona;21;Maresme;08121;Mataró;6;3;1;;439;350;89;0;0;350;350
8;Barcelona;21;Maresme;08121;Mataró;6;3;2;;430;344;86;2;2;340;342
8;Barcelona;21;Maresme;08121;Mataró;6;4;1;;549;418;131;6;0;412;412
8;Barcelona;21;Maresme;08121;Mataró;6;5;1;;421;334;87;1;0;333;333
8;Barcelona;21;Maresme;08121;Mataró;6;6;1;;636;478;158;2;1;475;476
8;Barcelona;21;Maresme;08121;Mataró;6;6;2;;565;417;148;1;2;414;416
8;Barcelona;21;Maresme;08121;Mataró;6;7;1;;600;388;212;1;2;385;387
8;Barcelona;21;Maresme;08121;Mataró;6;7;2;;560;371;189;1;2;368;370
8;Barcelona;21;Maresme;08121;Mataró;6;7;3;;692;483;209;0;2;481;483
8;Barcelona;21;Maresme;08121;Mataró;6;7;4;;612;409;203;1;0;408;408
8;Barcelona;21;Maresme;08121;Mataró;6;8;1;;1015;677;338;3;2;672;674
8;Barcelona;21;Maresme;08121;Mataró;6;8;2;;879;606;273;1;2;603;605
8;Barcelona;21;Maresme;08121;Mataró;6;9;1;;693;474;219;0;1;473;474
8;Barcelona;3;Alt Penedès;08122;Mediona;1;1;1;;789;644;145;4;5;635;640
25;Lleida;23;Noguera;25134;Menàrguens;1;1;1;;834;483;351;5;4;474;478
17;Girona;15;Cerdanya;17099;Meranges;1;1;1;;57;44;13;0;0;44;44
17;Girona;19;Garrotxa;17105;Mieres;1;1;1;;325;188;137;2;0;186;186
43;Tarragona;1;Alt Camp;43083;Milà, el;1;1;1;;120;97;23;1;0;96;96
25;Lleida;27;Pla d'Urgell;25135;Miralcamp;1;1;1;;940;642;298;6;6;630;636
43;Tarragona;30;Ribera d'Ebre;43084;Miravet;1;1;1;;707;395;312;3;3;389;392
8;Barcelona;;;08138;Moià;1;1;1;;947;778;169;1;4;773;777
8;Barcelona;;;08138;Moià;1;2;1;;1375;1063;312;3;5;1055;1060
43;Tarragona;29;Priorat;43085;Molar, el;1;1;1;;304;229;75;5;2;222;224
8;Barcelona;11;Baix Llobregat;08123;Molins de Rei;1;1;1;;676;447;229;1;2;444;446
8;Barcelona;11;Baix Llobregat;08123;Molins de Rei;1;1;2;;637;464;173;2;1;461;462
8;Barcelona;11;Baix Llobregat;08123;Molins de Rei;1;2;1;;896;584;312;0;0;584;584
8;Barcelona;11;Baix Llobregat;08123;Molins de Rei;1;3;1;;806;533;273;0;1;532;533
8;Barcelona;11;Baix Llobregat;08123;Molins de Rei;1;3;2;;782;522;260;3;1;518;519
8;Barcelona;11;Baix Llobregat;08123;Molins de Rei;2;1;1;;811;562;249;0;2;560;562
8;Barcelona;11;Baix Llobregat;08123;Molins de Rei;2;2;1;;931;701;230;0;2;699;701
8;Barcelona;11;Baix Llobregat;08123;Molins de Rei;2;3;1;;996;648;348;4;4;640;644
8;Barcelona;11;Baix Llobregat;08123;Molins de Rei;2;3;2;;918;620;298;0;5;615;620
8;Barcelona;11;Baix Llobregat;08123;Molins de Rei;2;4;1;;769;479;290;0;0;479;479
8;Barcelona;11;Baix Llobregat;08123;Molins de Rei;3;1;1;;587;434;153;0;2;432;434
8;Barcelona;11;Baix Llobregat;08123;Molins de Rei;3;1;2;;624;443;181;0;2;441;443
8;Barcelona;11;Baix Llobregat;08123;Molins de Rei;3;2;1;;722;457;265;0;3;454;457
8;Barcelona;11;Baix Llobregat;08123;Molins de Rei;3;3;1;;657;480;177;0;1;479;480
8;Barcelona;11;Baix Llobregat;08123;Molins de Rei;3;3;2;;669;484;185;1;0;483;483
8;Barcelona;11;Baix Llobregat;08123;Molins de Rei;3;4;1;;717;453;264;0;0;453;453
8;Barcelona;11;Baix Llobregat;08123;Molins de Rei;3;4;2;;705;470;235;3;2;465;467
8;Barcelona;11;Baix Llobregat;08123;Molins de Rei;4;1;1;;753;515;238;0;0;515;515
8;Barcelona;11;Baix Llobregat;08123;Molins de Rei;4;2;1;;722;457;265;3;0;454;454
25;Lleida;27;Pla d'Urgell;25137;Mollerussa;1;1;1;;1530;1105;425;8;2;1095;1097
25;Lleida;27;Pla d'Urgell;25137;Mollerussa;1;2;1;;1465;986;479;5;4;977;981
25;Lleida;27;Pla d'Urgell;25137;Mollerussa;1;3;1;;1612;1091;521;5;10;1076;1086
25;Lleida;27;Pla d'Urgell;25137;Mollerussa;1;4;1;;1488;886;602;3;3;880;883
8;Barcelona;41;Vallès Oriental;08124;Mollet del Vallès;1;1;1;;550;353;197;11;3;339;342
8;Barcelona;41;Vallès Oriental;08124;Mollet del Vallès;1;1;2;;700;414;286;1;1;412;413
8;Barcelona;41;Vallès Oriental;08124;Mollet del Vallès;1;1;3;;763;458;305;0;0;458;458
8;Barcelona;41;Vallès Oriental;08124;Mollet del Vallès;1;2;1;;1014;628;386;1;5;622;627
8;Barcelona;41;Vallès Oriental;08124;Mollet del Vallès;1;2;2;;683;423;260;4;0;419;419
8;Barcelona;41;Vallès Oriental;08124;Mollet del Vallès;1;2;3;;545;340;205;3;2;335;337
8;Barcelona;41;Vallès Oriental;08124;Mollet del Vallès;1;3;1;;526;354;172;1;1;352;353
8;Barcelona;41;Vallès Oriental;08124;Mollet del Vallès;1;3;2;;524;303;221;0;0;303;303
8;Barcelona;41;Vallès Oriental;08124;Mollet del Vallès;1;3;3;;569;349;220;3;0;346;346
8;Barcelona;41;Vallès Oriental;08124;Mollet del Vallès;1;4;1;;446;306;140;4;2;300;302
8;Barcelona;41;Vallès Oriental;08124;Mollet del Vallès;1;4;2;;369;245;124;1;2;242;244
8;Barcelona;41;Vallès Oriental;08124;Mollet del Vallès;1;5;1;;590;352;238;17;1;334;335
8;Barcelona;41;Vallès Oriental;08124;Mollet del Vallès;1;5;2;;598;325;273;0;1;324;325
8;Barcelona;41;Vallès Oriental;08124;Mollet del Vallès;1;5;3;;637;360;277;1;3;356;359
8;Barcelona;41;Vallès Oriental;08124;Mollet del Vallès;2;1;1;;678;412;266;0;0;412;412
8;Barcelona;41;Vallès Oriental;08124;Mollet del Vallès;2;1;2;;652;380;272;2;0;378;378
8;Barcelona;41;Vallès Oriental;08124;Mollet del Vallès;2;1;3;;709;452;257;2;1;449;450
8;Barcelona;41;Vallès Oriental;08124;Mollet del Vallès;2;2;1;;677;460;217;2;1;457;458
8;Barcelona;41;Vallès Oriental;08124;Mollet del Vallès;2;3;1;;632;299;333;0;0;299;299
8;Barcelona;41;Vallès Oriental;08124;Mollet del Vallès;2;3;2;;617;315;302;4;0;311;311
8;Barcelona;41;Vallès Oriental;08124;Mollet del Vallès;2;3;3;;806;403;403;1;2;400;402
8;Barcelona;41;Vallès Oriental;08124;Mollet del Vallès;2;3;4;;632;331;301;2;3;326;329
8;Barcelona;41;Vallès Oriental;08124;Mollet del Vallès;3;1;1;;521;341;180;0;3;338;341
8;Barcelona;41;Vallès Oriental;08124;Mollet del Vallès;3;1;2;;604;354;250;0;2;352;354
8;Barcelona;41;Vallès Oriental;08124;Mollet del Vallès;3;1;3;;602;379;223;2;5;372;377
8;Barcelona;41;Vallès Oriental;08124;Mollet del Vallès;3;2;1;;585;369;216;4;0;365;365
8;Barcelona;41;Vallès Oriental;08124;Mollet del Vallès;3;2;2;;663;418;245;2;3;413;416
8;Barcelona;41;Vallès Oriental;08124;Mollet del Vallès;3;2;3;;639;416;223;2;7;407;414
8;Barcelona;41;Vallès Oriental;08124;Mollet del Vallès;3;3;1;;607;345;262;0;2;343;345
8;Barcelona;41;Vallès Oriental;08124;Mollet del Vallès;3;3;2;;638;384;254;8;1;375;376
8;Barcelona;41;Vallès Oriental;08124;Mollet del Vallès;3;4;1;;469;274;195;2;5;267;272
8;Barcelona;41;Vallès Oriental;08124;Mollet del Vallès;3;4;2;;447;270;177;1;1;268;269
8;Barcelona;41;Vallès Oriental;08124;Mollet del Vallès;3;5;1;;450;268;182;2;1;265;266
8;Barcelona;41;Vallès Oriental;08124;Mollet del Vallès;3;5;2;;529;300;229;0;1;299;300
8;Barcelona;41;Vallès Oriental;08124;Mollet del Vallès;3;5;3;;537;313;224;4;3;306;309
8;Barcelona;41;Vallès Oriental;08124;Mollet del Vallès;3;6;1;;459;296;163;1;0;295;295
8;Barcelona;41;Vallès Oriental;08124;Mollet del Vallès;3;7;1;;442;277;165;0;0;277;277
8;Barcelona;41;Vallès Oriental;08124;Mollet del Vallès;3;7;2;;493;303;190;0;0;303;303
8;Barcelona;41;Vallès Oriental;08124;Mollet del Vallès;3;7;3;;456;269;187;0;0;269;269
8;Barcelona;41;Vallès Oriental;08124;Mollet del Vallès;3;8;1;;418;220;198;0;0;220;220
8;Barcelona;41;Vallès Oriental;08124;Mollet del Vallès;3;8;2;;374;199;175;1;0;198;198
8;Barcelona;41;Vallès Oriental;08124;Mollet del Vallès;3;9;1;;628;384;244;0;2;382;384
8;Barcelona;41;Vallès Oriental;08124;Mollet del Vallès;3;9;2;;512;328;184;1;0;327;327
17;Girona;2;Alt Empordà;17106;Mollet de Peralada;1;1;1;;168;121;47;0;0;121;121
17;Girona;31;Ripollès;17107;Molló;1;1;1;;325;251;74;1;0;250;250
25;Lleida;35;Solsonès;25136;Molsosa, la;1;1;1;;121;106;15;6;0;100;100
8;Barcelona;;;08128;Monistrol de Calders;1;1;1;;463;392;71;0;3;389;392
8;Barcelona;7;Bages;08127;Monistrol de Montserrat;1;1;1;;685;480;205;0;7;473;480
8;Barcelona;7;Bages;08127;Monistrol de Montserrat;1;2;1;;695;538;157;10;0;528;528
8;Barcelona;7;Bages;08127;Monistrol de Montserrat;2;1;1;;643;468;175;3;0;465;465
17;Girona;19;Garrotxa;17109;Montagut i Oix;1;1;1;;672;402;270;9;0;393;393
43;Tarragona;16;Conca de Barberà;43086;Montblanc;1;1;1;;800;569;231;0;4;565;569
43;Tarragona;16;Conca de Barberà;43086;Montblanc;1;2;1;;778;518;260;4;9;505;514
43;Tarragona;16;Conca de Barberà;43086;Montblanc;2;1;1;;763;551;212;2;4;545;549
43;Tarragona;16;Conca de Barberà;43086;Montblanc;2;1;2;;729;568;161;7;1;560;561
43;Tarragona;16;Conca de Barberà;43086;Montblanc;2;2;1;;1132;800;332;18;6;776;782
43;Tarragona;8;Baix Camp;43088;Montbrió del Camp;1;1;1;;643;534;109;5;3;526;529
43;Tarragona;8;Baix Camp;43088;Montbrió del Camp;1;1;2;;540;432;108;7;1;424;425
8;Barcelona;40;Vallès Occidental;08125;Montcada i Reixac;1;1;1;;962;639;323;1;3;635;638
8;Barcelona;40;Vallès Occidental;08125;Montcada i Reixac;1;1;2;;934;575;359;4;1;570;571
8;Barcelona;40;Vallès Occidental;08125;Montcada i Reixac;1;2;1;;792;552;240;2;4;546;550
8;Barcelona;40;Vallès Occidental;08125;Montcada i Reixac;1;3;1;;630;409;221;4;1;404;405
8;Barcelona;40;Vallès Occidental;08125;Montcada i Reixac;1;4;1;;1331;783;548;1;4;778;782
8;Barcelona;40;Vallès Occidental;08125;Montcada i Reixac;2;1;1;;892;455;437;0;0;455;455
8;Barcelona;40;Vallès Occidental;08125;Montcada i Reixac;2;1;2;;813;429;384;0;2;427;429
8;Barcelona;40;Vallès Occidental;08125;Montcada i Reixac;2;2;1;;1300;816;484;0;1;815;816
8;Barcelona;40;Vallès Occidental;08125;Montcada i Reixac;2;3;1;;1497;960;537;3;3;954;957
8;Barcelona;40;Vallès Occidental;08125;Montcada i Reixac;2;4;1;;185;122;63;0;1;121;122
8;Barcelona;40;Vallès Occidental;08125;Montcada i Reixac;3;1;1;;1327;891;436;0;2;889;891
8;Barcelona;40;Vallès Occidental;08125;Montcada i Reixac;3;2;1;;1472;828;644;3;1;824;825
8;Barcelona;40;Vallès Occidental;08125;Montcada i Reixac;3;2;2;;1399;792;607;2;4;786;790
8;Barcelona;40;Vallès Occidental;08125;Montcada i Reixac;4;1;1;;1385;819;566;1;1;817;818
8;Barcelona;40;Vallès Occidental;08125;Montcada i Reixac;5;1;1;;996;523;473;0;0;523;523
8;Barcelona;40;Vallès Occidental;08125;Montcada i Reixac;5;1;2;;915;487;428;1;0;486;486
8;Barcelona;40;Vallès Occidental;08125;Montcada i Reixac;5;2;1;;1156;580;576;5;0;575;575
8;Barcelona;40;Vallès Occidental;08125;Montcada i Reixac;5;3;1;;1274;645;629;3;2;640;642
8;Barcelona;40;Vallès Occidental;08125;Montcada i Reixac;6;1;1;;354;205;149;0;0;205;205
8;Barcelona;14;Berguedà;08130;Montclar;1;1;1;;196;94;102;0;0;94;94
25;Lleida;15;Cerdanya;25139;Montellà i Martinet;1;1;1;;489;350;139;1;2;347;349
8;Barcelona;24;Osona;08131;Montesquiu;1;1;1;;827;564;263;6;1;557;558
25;Lleida;4;Alt Urgell;25140;Montferrer i Castellbò;1;1;1;;548;311;237;0;1;310;311
43;Tarragona;1;Alt Camp;43089;Montferri;1;1;1;;148;118;30;0;3;115;118
25;Lleida;23;Noguera;25138;Montgai;1;1;1;;798;533;265;0;1;532;533
8;Barcelona;21;Maresme;08126;Montgat;1;1;1;;783;524;259;2;0;522;522
8;Barcelona;21;Maresme;08126;Montgat;1;1;2;;787;578;209;1;2;575;577
8;Barcelona;21;Maresme;08126;Montgat;1;2;1;;904;552;352;2;7;543;550
8;Barcelona;21;Maresme;08126;Montgat;1;2;2;;812;524;288;1;2;521;523
8;Barcelona;21;Maresme;08126;Montgat;1;3;1;;864;481;383;14;5;462;467
8;Barcelona;21;Maresme;08126;Montgat;1;3;2;;870;504;366;1;3;500;503
8;Barcelona;14;Berguedà;08132;Montmajor;1;1;1;;458;336;122;0;0;336;336
8;Barcelona;6;Anoia;08133;Montmaneu;1;1;1;;243;143;100;0;2;141;143
43;Tarragona;12;Baix Penedès;43090;Montmell, el;1;1;1;;132;98;34;0;1;97;98
8;Barcelona;41;Vallès Oriental;08135;Montmeló;1;1;1;;597;402;195;1;3;398;401
8;Barcelona;41;Vallès Oriental;08135;Montmeló;1;1;2;;698;450;248;0;4;446;450
8;Barcelona;41;Vallès Oriental;08135;Montmeló;1;1;3;;754;468;286;3;2;463;465
8;Barcelona;41;Vallès Oriental;08135;Montmeló;1;2;1;;1144;765;379;2;3;760;763
8;Barcelona;41;Vallès Oriental;08135;Montmeló;1;2;2;;1174;774;400;5;2;767;769
8;Barcelona;41;Vallès Oriental;08135;Montmeló;1;3;1;;469;339;130;4;7;328;335
25;Lleida;33;Segrià;25142;Montoliu de Lleida;1;1;1;;340;239;101;0;2;237;239
25;Lleida;32;Segarra;25141;Montoliu de Segarra;1;1;1;;188;128;60;0;1;127;128
8;Barcelona;41;Vallès Oriental;08136;Montornès del Vallès;1;1;1;;1177;744;433;5;4;735;739
8;Barcelona;41;Vallès Oriental;08136;Montornès del Vallès;1;1;2;;731;453;278;8;0;445;445
8;Barcelona;41;Vallès Oriental;08136;Montornès del Vallès;1;1;3;;580;373;207;7;3;363;366
8;Barcelona;41;Vallès Oriental;08136;Montornès del Vallès;1;2;1;;596;352;244;8;3;341;344
8;Barcelona;41;Vallès Oriental;08136;Montornès del Vallès;1;2;2;;694;425;269;1;0;424;424
8;Barcelona;41;Vallès Oriental;08136;Montornès del Vallès;1;2;3;;612;384;228;3;1;380;381
8;Barcelona;41;Vallès Oriental;08136;Montornès del Vallès;2;1;1;;634;363;271;0;2;361;363
8;Barcelona;41;Vallès Oriental;08136;Montornès del Vallès;2;1;2;;592;339;253;0;0;339;339
8;Barcelona;41;Vallès Oriental;08136;Montornès del Vallès;2;2;1;;500;323;177;1;1;321;322
8;Barcelona;41;Vallès Oriental;08136;Montornès del Vallès;2;2;2;;527;316;211;2;0;314;314
8;Barcelona;41;Vallès Oriental;08136;Montornès del Vallès;2;3;1;;475;284;191;0;0;284;284
8;Barcelona;41;Vallès Oriental;08136;Montornès del Vallès;3;1;1;;255;193;62;0;0;193;193
25;Lleida;32;Segarra;25143;Montornès de Segarra;1;1;1;;122;68;54;0;2;66;68
43;Tarragona;1;Alt Camp;43091;Mont-ral;1;1;1;;49;32;17;0;1;31;32
17;Girona;10;Baix Empordà;17110;Mont-ras;1;1;1;;689;480;209;0;1;479;480
43;Tarragona;8;Baix Camp;43092;Mont-roig del Camp;1;1;1;;870;658;212;3;2;653;655
43;Tarragona;8;Baix Camp;43092;Mont-roig del Camp;1;1;2;;892;692;200;4;3;685;688
43;Tarragona;8;Baix Camp;43092;Mont-roig del Camp;1;2;1;;203;115;88;0;2;113;115
43;Tarragona;8;Baix Camp;43092;Mont-roig del Camp;1;3;1;;875;421;454;5;5;411;416
8;Barcelona;41;Vallès Oriental;08137;Montseny;1;1;1;;207;152;55;0;0;152;152
43;Tarragona;30;Ribera d'Ebre;43093;Móra d'Ebre;1;1;1;;752;457;295;2;1;454;455
43;Tarragona;30;Ribera d'Ebre;43093;Móra d'Ebre;1;1;2;;584;357;227;2;3;352;355
43;Tarragona;30;Ribera d'Ebre;43093;Móra d'Ebre;1;2;1;;695;399;296;6;3;390;393
43;Tarragona;30;Ribera d'Ebre;43093;Móra d'Ebre;2;1;1;;849;536;313;5;5;526;531
43;Tarragona;30;Ribera d'Ebre;43093;Móra d'Ebre;2;2;1;;579;331;248;2;0;329;329
43;Tarragona;30;Ribera d'Ebre;43094;Móra la Nova;1;1;1;;662;436;226;7;1;428;429
43;Tarragona;30;Ribera d'Ebre;43094;Móra la Nova;1;1;2;;578;359;219;1;2;356;358
43;Tarragona;30;Ribera d'Ebre;43094;Móra la Nova;2;1;1;;1030;688;342;0;7;681;688
43;Tarragona;36;Tarragonès;43095;Morell, el;1;1;1;;864;643;221;6;3;634;637
43;Tarragona;36;Tarragonès;43095;Morell, el;1;1;2;;731;559;172;1;1;557;558
43;Tarragona;29;Priorat;43096;Morera de Montsant, la;1;1;1;;111;86;25;0;0;86;86
8;Barcelona;24;Osona;08129;Muntanyola;1;1;1;;153;80;73;0;0;80;80
8;Barcelona;7;Bages;08139;Mura;1;1;1;;169;112;57;0;0;112;112
25;Lleida;38;Urgell;25145;Nalec;1;1;1;;92;78;14;0;0;78;78
25;Lleida;39;Consell General d'Aran;25025;Naut Aran;1;1;1;;272;187;85;13;1;173;174
25;Lleida;39;Consell General d'Aran;25025;Naut Aran;1;1;2;;163;95;68;1;2;92;94
25;Lleida;39;Consell General d'Aran;25025;Naut Aran;1;1;3;;264;206;58;1;2;203;205
25;Lleida;39;Consell General d'Aran;25025;Naut Aran;1;1;4;;87;70;17;0;0;70;70
25;Lleida;39;Consell General d'Aran;25025;Naut Aran;1;1;5;;78;59;19;0;1;58;59
8;Barcelona;7;Bages;08140;Navarcles;1;1;1;;815;625;190;1;3;621;624
8;Barcelona;7;Bages;08140;Navarcles;1;1;2;;1041;758;283;1;4;753;757
8;Barcelona;7;Bages;08140;Navarcles;1;2;1;;760;614;146;5;3;606;609
8;Barcelona;7;Bages;08140;Navarcles;1;2;2;;885;702;183;1;3;698;701
8;Barcelona;7;Bages;08141;Navàs;1;1;1;;873;660;213;9;3;648;651
8;Barcelona;7;Bages;08141;Navàs;1;1;2;;816;630;186;4;2;624;626
8;Barcelona;7;Bages;08141;Navàs;1;2;1;;955;643;312;5;4;634;638
8;Barcelona;7;Bages;08141;Navàs;1;2;2;;884;655;229;9;1;645;646
8;Barcelona;7;Bages;08141;Navàs;2;1;1;;80;58;22;0;0;58;58
8;Barcelona;7;Bages;08141;Navàs;2;2;1;;524;387;137;0;0;387;387
17;Girona;2;Alt Empordà;17111;Navata;1;1;1;;509;332;177;4;2;326;328
25;Lleida;35;Solsonès;25146;Navès;1;1;1;;286;197;89;0;0;197;197
8;Barcelona;14;Berguedà;08142;Nou de Berguedà, la;1;1;1;;124;97;27;0;0;97;97
43;Tarragona;36;Tarragonès;43097;Nou de Gaià, la;1;1;1;;298;216;82;3;1;212;213
43;Tarragona;1;Alt Camp;43098;Nulles;1;1;1;;317;222;95;2;0;220;220
25;Lleida;35;Solsonès;25148;Odèn;1;1;1;;294;147;147;0;1;146;147
8;Barcelona;6;Anoia;08143;Òdena;1;1;1;;1340;899;441;5;0;894;894
8;Barcelona;6;Anoia;08143;Òdena;1;2;1;;571;388;183;0;1;387;388
17;Girona;31;Ripollès;17112;Ogassa;1;1;1;;242;193;49;0;0;193;193
8;Barcelona;3;Alt Penedès;08145;Olèrdola;1;1;1;;482;340;142;0;0;340;340
8;Barcelona;3;Alt Penedès;08145;Olèrdola;1;2;1;;677;533;144;1;2;530;532
8;Barcelona;3;Alt Penedès;08146;Olesa de Bonesvalls;1;1;1;;261;188;73;1;0;187;187
8;Barcelona;11;Baix Llobregat;08147;Olesa de Montserrat;1;1;1;;609;551;58;0;0;551;551
8;Barcelona;11;Baix Llobregat;08147;Olesa de Montserrat;1;1;2;;715;469;246;1;2;466;468
8;Barcelona;11;Baix Llobregat;08147;Olesa de Montserrat;1;2;1;;802;573;229;0;0;573;573
8;Barcelona;11;Baix Llobregat;08147;Olesa de Montserrat;1;2;2;;841;599;242;2;2;595;597
8;Barcelona;11;Baix Llobregat;08147;Olesa de Montserrat;1;3;1;;509;376;133;0;3;373;376
8;Barcelona;11;Baix Llobregat;08147;Olesa de Montserrat;1;3;2;;531;378;153;4;2;372;374
8;Barcelona;11;Baix Llobregat;08147;Olesa de Montserrat;1;4;1;;595;489;106;1;0;488;488
8;Barcelona;11;Baix Llobregat;08147;Olesa de Montserrat;1;4;2;;603;430;173;1;4;425;429
8;Barcelona;11;Baix Llobregat;08147;Olesa de Montserrat;1;5;1;;564;412;152;3;2;407;409
8;Barcelona;11;Baix Llobregat;08147;Olesa de Montserrat;1;5;2;;550;399;151;0;1;398;399
8;Barcelona;11;Baix Llobregat;08147;Olesa de Montserrat;1;6;1;;549;375;174;1;0;374;374
8;Barcelona;11;Baix Llobregat;08147;Olesa de Montserrat;1;6;2;;516;364;152;0;0;364;364
8;Barcelona;11;Baix Llobregat;08147;Olesa de Montserrat;1;7;1;;559;413;146;2;0;411;411
8;Barcelona;11;Baix Llobregat;08147;Olesa de Montserrat;1;7;2;;574;435;139;0;0;435;435
8;Barcelona;11;Baix Llobregat;08147;Olesa de Montserrat;1;8;1;;606;514;92;0;2;512;514
8;Barcelona;11;Baix Llobregat;08147;Olesa de Montserrat;1;8;2;;662;466;196;2;1;463;464
25;Lleida;4;Alt Urgell;25149;Oliana;1;1;1;;835;581;254;0;0;581;581
25;Lleida;4;Alt Urgell;25149;Oliana;1;1;2;;834;660;174;0;0;660;660
25;Lleida;23;Noguera;25150;Oliola;1;1;1;;220;144;76;3;1;140;141
25;Lleida;35;Solsonès;25151;Olius;1;1;1;;360;227;133;0;1;226;227
8;Barcelona;17;Garraf;08148;Olivella;1;1;1;;98;67;31;0;1;66;67
8;Barcelona;24;Osona;08149;Olost;1;1;1;;763;564;199;0;6;558;564
17;Girona;19;Garrotxa;17114;Olot;1;1;1;;442;331;111;0;0;331;331
17;Girona;19;Garrotxa;17114;Olot;1;1;2;;468;317;151;0;2;315;317
17;Girona;19;Garrotxa;17114;Olot;1;2;1;;647;487;160;3;1;483;484
17;Girona;19;Garrotxa;17114;Olot;1;2;2;;642;456;186;4;3;449;452
17;Girona;19;Garrotxa;17114;Olot;1;2;3;;653;500;153;1;1;498;499
17;Girona;19;Garrotxa;17114;Olot;1;3;1;;494;329;165;1;2;326;328
17;Girona;19;Garrotxa;17114;Olot;1;3;2;;484;331;153;6;3;322;325
17;Girona;19;Garrotxa;17114;Olot;2;1;1;;536;401;135;2;4;395;399
17;Girona;19;Garrotxa;17114;Olot;2;1;2;;569;424;145;1;6;417;423
17;Girona;19;Garrotxa;17114;Olot;2;2;1;;794;606;188;0;2;604;606
17;Girona;19;Garrotxa;17114;Olot;2;3;1;;748;503;245;9;2;492;494
17;Girona;19;Garrotxa;17114;Olot;2;3;2;;728;517;211;4;5;508;513
17;Girona;19;Garrotxa;17114;Olot;2;4;1;;549;385;164;3;3;379;382
17;Girona;19;Garrotxa;17114;Olot;2;4;2;;531;382;149;3;2;377;379
17;Girona;19;Garrotxa;17114;Olot;3;1;1;;844;566;278;2;5;559;564
17;Girona;19;Garrotxa;17114;Olot;3;1;2;;803;545;258;1;2;542;544
17;Girona;19;Garrotxa;17114;Olot;3;2;1;;550;411;139;4;3;404;407
17;Girona;19;Garrotxa;17114;Olot;3;2;2;;575;451;124;1;7;443;450
17;Girona;19;Garrotxa;17114;Olot;4;1;1;;477;301;176;0;4;297;301
17;Girona;19;Garrotxa;17114;Olot;4;2;1;;681;471;210;3;2;466;468
17;Girona;19;Garrotxa;17114;Olot;4;3;1;;646;448;198;4;2;442;444
17;Girona;19;Garrotxa;17114;Olot;4;3;2;;641;455;186;2;7;446;453
17;Girona;19;Garrotxa;17114;Olot;4;4;1;;497;371;126;5;1;365;366
17;Girona;19;Garrotxa;17114;Olot;4;4;2;;562;409;153;8;5;396;401
17;Girona;19;Garrotxa;17114;Olot;4;5;1;;496;363;133;2;3;358;361
17;Girona;19;Garrotxa;17114;Olot;4;5;2;;508;380;128;0;3;377;380
17;Girona;19;Garrotxa;17114;Olot;5;1;1;;600;443;157;6;1;436;437
17;Girona;19;Garrotxa;17114;Olot;5;1;2;;562;412;150;2;1;409;410
17;Girona;19;Garrotxa;17114;Olot;5;2;1;;548;415;133;2;3;410;413
17;Girona;19;Garrotxa;17114;Olot;5;2;2;;449;349;100;1;3;345;348
17;Girona;19;Garrotxa;17114;Olot;5;2;3;;626;470;156;5;0;465;465
17;Girona;19;Garrotxa;17114;Olot;5;3;1;;495;359;136;2;4;353;357
17;Girona;19;Garrotxa;17114;Olot;5;4;1;;550;362;188;0;2;360;362
17;Girona;19;Garrotxa;17114;Olot;5;4;2;;549;355;194;0;4;351;355
17;Girona;19;Garrotxa;17114;Olot;5;4;3;;590;399;191;4;3;392;395
25;Lleida;32;Segarra;25152;Oluges, les;1;1;1;;231;107;124;0;1;106;107
8;Barcelona;14;Berguedà;08144;Olvan;1;1;1;;419;289;130;2;0;287;287
8;Barcelona;14;Berguedà;08144;Olvan;1;2;1;;572;395;177;1;0;394;394
25;Lleida;18;Garrigues;25153;Omellons, els;1;1;1;;234;131;103;0;4;127;131
25;Lleida;38;Urgell;25154;Omells de na Gaia, els;1;1;1;;149;118;31;0;0;118;118
17;Girona;2;Alt Empordà;17115;Ordis;1;1;1;;227;170;57;5;2;163;165
25;Lleida;4;Alt Urgell;25155;Organyà;1;1;1;;962;723;239;0;1;722;723
8;Barcelona;24;Osona;08150;Orís;1;1;1;;221;169;52;0;0;169;169
8;Barcelona;24;Osona;08151;Oristà;1;1;1;;746;497;249;1;0;496;496
8;Barcelona;6;Anoia;08152;Orpí;1;1;1;;124;111;13;0;0;111;111
8;Barcelona;21;Maresme;08153;Òrrius;1;1;1;;219;191;28;0;0;191;191
25;Lleida;23;Noguera;25156;Os de Balaguer;1;1;1;;771;414;357;0;1;413;414
17;Girona;34;Selva;17116;Osor;1;1;1;;421;310;111;1;2;307;309
25;Lleida;38;Urgell;25157;Ossó de Sió;1;1;1;;221;150;71;0;0;150;150
8;Barcelona;3;Alt Penedès;08154;Pacs del Penedès;1;1;1;;295;199;96;1;1;197;198
8;Barcelona;21;Maresme;08155;Palafolls;1;1;1;;914;579;335;17;3;559;562
8;Barcelona;21;Maresme;08155;Palafolls;1;1;2;;916;608;308;15;0;593;593
8;Barcelona;21;Maresme;08155;Palafolls;1;2;1;;159;97;62;2;1;94;95
17;Girona;10;Baix Empordà;17117;Palafrugell;1;1;1;;840;558;282;2;1;555;556
17;Girona;10;Baix Empordà;17117;Palafrugell;1;1;2;;717;489;228;2;1;486;487
17;Girona;10;Baix Empordà;17117;Palafrugell;1;2;1;;618;430;188;5;2;423;425
17;Girona;10;Baix Empordà;17117;Palafrugell;1;2;2;;670;484;186;1;2;481;483
17;Girona;10;Baix Empordà;17117;Palafrugell;1;3;1;;587;403;184;3;3;397;400
17;Girona;10;Baix Empordà;17117;Palafrugell;1;3;2;;568;369;199;8;3;358;361
17;Girona;10;Baix Empordà;17117;Palafrugell;1;3;3;;566;414;152;3;3;408;411
17;Girona;10;Baix Empordà;17117;Palafrugell;1;4;1;;309;215;94;0;0;215;215
17;Girona;10;Baix Empordà;17117;Palafrugell;2;1;1;;698;471;227;1;3;467;470
17;Girona;10;Baix Empordà;17117;Palafrugell;2;1;2;;646;444;202;8;3;433;436
17;Girona;10;Baix Empordà;17117;Palafrugell;2;2;1;;582;398;184;0;2;396;398
17;Girona;10;Baix Empordà;17117;Palafrugell;2;2;2;;591;384;207;1;4;379;383
17;Girona;10;Baix Empordà;17117;Palafrugell;2;2;3;;665;460;205;0;4;456;460
17;Girona;10;Baix Empordà;17117;Palafrugell;2;3;1;;541;378;163;3;2;373;375
17;Girona;10;Baix Empordà;17117;Palafrugell;3;1;1;;788;533;255;0;0;533;533
17;Girona;10;Baix Empordà;17117;Palafrugell;3;1;2;;763;506;257;0;3;503;506
17;Girona;10;Baix Empordà;17117;Palafrugell;3;2;1;;520;387;133;2;0;385;385
17;Girona;10;Baix Empordà;17117;Palafrugell;3;2;2;;539;388;151;2;0;386;386
17;Girona;10;Baix Empordà;17117;Palafrugell;3;3;1;;261;186;75;0;4;182;186
17;Girona;10;Baix Empordà;17118;Palamós;1;1;1;;774;529;245;0;2;527;529
17;Girona;10;Baix Empordà;17118;Palamós;1;1;2;;728;537;191;2;0;535;535
17;Girona;10;Baix Empordà;17118;Palamós;1;2;1;;653;492;161;0;0;492;492
17;Girona;10;Baix Empordà;17118;Palamós;1;2;2;;649;502;147;1;2;499;501
17;Girona;10;Baix Empordà;17118;Palamós;1;3;1;;752;492;260;0;0;492;492
17;Girona;10;Baix Empordà;17118;Palamós;1;3;2;;705;456;249;4;1;451;452
17;Girona;10;Baix Empordà;17118;Palamós;1;4;1;;544;400;144;4;1;395;396
17;Girona;10;Baix Empordà;17118;Palamós;2;1;1;;670;469;201;4;4;461;465
17;Girona;10;Baix Empordà;17118;Palamós;2;1;2;;654;448;206;0;1;447;448
17;Girona;10;Baix Empordà;17118;Palamós;3;1;1;;838;515;323;1;2;512;514
17;Girona;10;Baix Empordà;17118;Palamós;3;1;2;;803;563;240;4;1;558;559
17;Girona;10;Baix Empordà;17118;Palamós;4;1;1;;818;558;260;3;2;553;555
17;Girona;10;Baix Empordà;17118;Palamós;4;1;2;;749;513;236;1;7;505;512
25;Lleida;27;Pla d'Urgell;25158;Palau d'Anglesola, el;1;1;1;;1277;897;380;4;0;893;893
17;Girona;2;Alt Empordà;17119;Palau de Santa Eulàlia;1;1;1;;74;45;29;0;0;45;45
17;Girona;10;Baix Empordà;17121;Palau-sator;1;1;1;;253;169;84;0;0;169;169
17;Girona;2;Alt Empordà;17120;Palau-saverdera;1;1;1;;511;414;97;1;3;410;413
8;Barcelona;40;Vallès Occidental;08156;Palau-solità i Plegamans;1;1;1;;1242;805;437;1;2;802;804
8;Barcelona;40;Vallès Occidental;08156;Palau-solità i Plegamans;1;1;2;;811;585;226;1;4;580;584
8;Barcelona;40;Vallès Occidental;08156;Palau-solità i Plegamans;1;2;1;;1176;742;434;2;1;739;740
43;Tarragona;36;Tarragonès;43100;Pallaresos, els;1;1;1;;272;220;52;0;1;219;220
8;Barcelona;11;Baix Llobregat;08157;Pallejà;1;1;1;;652;436;216;3;2;431;433
8;Barcelona;11;Baix Llobregat;08157;Pallejà;1;1;2;;682;435;247;1;2;432;434
8;Barcelona;11;Baix Llobregat;08157;Pallejà;1;2;1;;713;473;240;2;0;471;471
8;Barcelona;11;Baix Llobregat;08157;Pallejà;1;2;2;;623;400;223;0;1;399;400
8;Barcelona;11;Baix Llobregat;08157;Pallejà;1;3;1;;707;434;273;0;4;430;434
8;Barcelona;11;Baix Llobregat;08157;Pallejà;1;3;2;;565;368;197;2;1;365;366
43;Tarragona;30;Ribera d'Ebre;43099;Palma d'Ebre, la;1;1;1;;403;296;107;2;1;293;294
17;Girona;;;17122;Palmerola;1;1;1;;30;11;19;0;0;11;11
17;Girona;28;Pla de l'Estany;17123;Palol de Revardit;1;1;1;;292;196;96;0;0;196;196
17;Girona;10;Baix Empordà;17124;Pals;1;1;1;;1269;835;434;3;3;829;832
8;Barcelona;11;Baix Llobregat;08158;Papiol, el;1;1;1;;1001;674;327;1;0;673;673
8;Barcelona;11;Baix Llobregat;08158;Papiol, el;1;1;2;;583;405;178;0;2;403;405
8;Barcelona;11;Baix Llobregat;08158;Papiol, el;1;1;3;;696;484;212;2;1;481;482
17;Girona;31;Ripollès;17125;Pardines;1;1;1;;101;69;32;0;1;68;69
8;Barcelona;41;Vallès Oriental;08159;Parets del Vallès;1;1;1;;728;480;248;3;3;474;477
8;Barcelona;41;Vallès Oriental;08159;Parets del Vallès;1;1;2;;791;513;278;7;0;506;506
8;Barcelona;41;Vallès Oriental;08159;Parets del Vallès;1;2;1;;614;435;179;0;1;434;435
8;Barcelona;41;Vallès Oriental;08159;Parets del Vallès;1;2;2;;698;483;215;2;2;479;481
8;Barcelona;41;Vallès Oriental;08159;Parets del Vallès;2;1;1;;1085;593;492;5;0;588;588
8;Barcelona;41;Vallès Oriental;08159;Parets del Vallès;2;2;1;;924;489;435;3;2;484;486
8;Barcelona;41;Vallès Oriental;08159;Parets del Vallès;2;2;2;;905;530;375;14;2;514;516
8;Barcelona;41;Vallès Oriental;08159;Parets del Vallès;2;3;1;;929;470;459;2;3;465;468
17;Girona;10;Baix Empordà;17126;Parlavà;1;1;1;;295;229;66;0;1;228;229
43;Tarragona;16;Conca de Barberà;43101;Passanant i Belltall;1;1;1;;191;133;58;1;0;132;132
17;Girona;2;Alt Empordà;17128;Pau;1;1;1;;244;155;89;0;0;155;155
43;Tarragona;9;Baix Ebre;43102;Paüls;1;1;1;;605;463;142;6;1;456;457
17;Girona;2;Alt Empordà;17129;Pedret i Marzà;1;1;1;;113;88;25;0;0;88;88
25;Lleida;23;Noguera;25164;Penelles;1;1;1;;566;373;193;1;3;369;372
17;Girona;10;Baix Empordà;17130;Pera, la;1;1;1;;292;223;69;2;0;221;221
8;Barcelona;24;Osona;08160;Perafita;1;1;1;;275;218;57;0;0;218;218
43;Tarragona;36;Tarragonès;43103;Perafort;1;1;1;;340;233;107;1;0;232;232
17;Girona;2;Alt Empordà;17132;Peralada;1;1;1;;789;615;174;3;3;609;612
17;Girona;2;Alt Empordà;17132;Peralada;1;2;1;;241;175;66;1;0;174;174
25;Lleida;4;Alt Urgell;25165;Peramola;1;1;1;;393;300;93;2;0;298;298
43;Tarragona;9;Baix Ebre;43104;Perelló, el;1;1;1;;546;289;257;6;0;283;283
43;Tarragona;9;Baix Ebre;43104;Perelló, el;1;2;1;;662;388;274;7;1;380;381
43;Tarragona;9;Baix Ebre;43104;Perelló, el;1;2;2;;560;337;223;5;0;332;332
43;Tarragona;9;Baix Ebre;43104;Perelló, el;2;1;1;;1012;717;295;12;2;703;705
8;Barcelona;6;Anoia;08161;Piera;1;1;1;;474;364;110;9;3;352;355
8;Barcelona;6;Anoia;08161;Piera;1;2;1;;1215;846;369;0;5;841;846
8;Barcelona;6;Anoia;08161;Piera;1;3;1;;850;524;326;1;0;523;523
8;Barcelona;6;Anoia;08161;Piera;1;3;2;;841;500;341;3;1;496;497
8;Barcelona;6;Anoia;08161;Piera;1;4;1;;406;301;105;0;0;301;301
43;Tarragona;16;Conca de Barberà;43105;Piles, les;1;1;1;;101;60;41;1;0;59;59
8;Barcelona;21;Maresme;08163;Pineda de Mar;1;1;1;;976;669;307;3;3;663;666
8;Barcelona;21;Maresme;08163;Pineda de Mar;1;1;2;;1282;843;439;11;7;825;832
8;Barcelona;21;Maresme;08163;Pineda de Mar;1;2;1;;668;449;219;8;0;441;441
8;Barcelona;21;Maresme;08163;Pineda de Mar;1;2;2;;676;461;215;7;3;451;454
8;Barcelona;21;Maresme;08163;Pineda de Mar;1;3;1;;810;542;268;1;1;540;541
8;Barcelona;21;Maresme;08163;Pineda de Mar;1;3;2;;788;525;263;1;3;521;524
8;Barcelona;21;Maresme;08163;Pineda de Mar;1;4;1;;701;411;290;0;0;411;411
8;Barcelona;21;Maresme;08163;Pineda de Mar;1;5;1;;848;477;371;2;0;475;475
8;Barcelona;21;Maresme;08163;Pineda de Mar;1;6;1;;950;509;441;1;0;508;508
8;Barcelona;21;Maresme;08163;Pineda de Mar;1;6;2;;897;543;354;2;1;540;541
43;Tarragona;37;Terra Alta;43106;Pinell de Brai, el;1;1;1;;1015;618;397;4;1;613;614
25;Lleida;35;Solsonès;25166;Pinell de Solsonès;1;1;1;;242;182;60;0;0;182;182
25;Lleida;35;Solsonès;25167;Pinós;1;1;1;;365;240;125;0;0;240;240
43;Tarragona;16;Conca de Barberà;43107;Pira;1;1;1;;311;211;100;2;0;209;209
8;Barcelona;3;Alt Penedès;08164;Pla del Penedès, el;1;1;1;;778;615;163;2;2;611;613
43;Tarragona;1;Alt Camp;43108;Pla de Santa Maria, el;1;1;1;;651;479;172;7;0;472;472
43;Tarragona;1;Alt Camp;43108;Pla de Santa Maria, el;1;1;2;;556;398;158;0;0;398;398
17;Girona;19;Garrotxa;17133;Planes d'Hostoles, les;1;1;1;;495;389;106;3;2;384;386
17;Girona;19;Garrotxa;17133;Planes d'Hostoles, les;1;1;2;;524;425;99;4;3;418;421
17;Girona;19;Garrotxa;17133;Planes d'Hostoles, les;1;2;1;;437;297;140;5;4;288;292
17;Girona;31;Ripollès;17134;Planoles;1;1;1;;255;204;51;0;0;204;204
25;Lleida;32;Segarra;25911;Plans de Sió, els;1;1;1;;680;415;265;1;3;411;414
25;Lleida;27;Pla d'Urgell;25168;Poal, el;1;1;1;;604;429;175;3;2;424;426
25;Lleida;18;Garrigues;25169;Pobla de Cérvoles, la;1;1;1;;207;157;50;0;0;157;157
8;Barcelona;6;Anoia;08165;Pobla de Claramunt, la;1;1;1;;1245;982;263;6;0;976;976
8;Barcelona;14;Berguedà;08166;Pobla de Lillet, la;1;1;1;;613;434;179;2;1;431;432
8;Barcelona;14;Berguedà;08166;Pobla de Lillet, la;1;2;1;;1018;743;275;9;3;731;734
43;Tarragona;36;Tarragonès;43109;Pobla de Mafumet, la;1;1;1;;592;477;115;5;0;472;472
43;Tarragona;37;Terra Alta;43110;Pobla de Massaluca, la;1;1;1;;413;273;140;3;1;269;270
43;Tarragona;36;Tarragonès;43111;Pobla de Montornès, la;1;1;1;;577;359;218;10;1;348;349
25;Lleida;25;Pallars Jussà;25171;Pobla de Segur, la;1;1;1;;1196;744;452;2;0;742;742
25;Lleida;25;Pallars Jussà;25171;Pobla de Segur, la;1;2;1;;842;582;260;1;0;581;581
25;Lleida;25;Pallars Jussà;25171;Pobla de Segur, la;1;2;2;;772;516;256;0;4;512;516
43;Tarragona;29;Priorat;43112;Poboleda;1;1;1;;309;215;94;2;0;213;213
8;Barcelona;40;Vallès Occidental;08167;Polinyà;1;1;1;;781;462;319;1;0;461;461
8;Barcelona;40;Vallès Occidental;08167;Polinyà;1;1;2;;837;528;309;4;1;523;524
43;Tarragona;1;Alt Camp;43113;Pont d'Armentera, el;1;1;1;;466;408;58;3;0;405;405
25;Lleida;4;Alt Urgell;25030;Pont de Bar, el;1;1;1;;178;107;71;0;0;107;107
17;Girona;2;Alt Empordà;17135;Pont de Molins;1;1;1;;292;209;83;1;1;207;208
25;Lleida;5;Alta Ribagorça;25173;Pont de Suert, el;1;1;1;;1299;720;579;2;1;717;718
25;Lleida;5;Alta Ribagorça;25173;Pont de Suert, el;1;2;1;;943;565;378;4;8;553;561
8;Barcelona;7;Bages;08182;Pont de Vilomara i Rocafort, el;1;1;1;;1540;1202;338;1;5;1196;1201
43;Tarragona;16;Conca de Barberà;43141;Pontils;1;1;1;;72;56;16;0;0;56;56
8;Barcelona;3;Alt Penedès;08168;Pontons;1;1;1;;186;132;54;1;0;131;131
17;Girona;2;Alt Empordà;17136;Pontós;1;1;1;;183;130;53;1;0;129;129
25;Lleida;23;Noguera;25172;Ponts;1;1;1;;940;710;230;5;1;704;705
25;Lleida;23;Noguera;25172;Ponts;1;2;1;;812;560;252;1;6;553;559
17;Girona;28;Pla de l'Estany;17137;Porqueres;1;1;1;;640;405;235;2;5;398;403
17;Girona;28;Pla de l'Estany;17137;Porqueres;1;2;1;;1265;907;358;1;6;900;906
43;Tarragona;29;Priorat;43114;Porrera;1;1;1;;421;299;122;3;1;295;296
17;Girona;2;Alt Empordà;17138;Portbou;1;1;1;;1230;740;490;5;6;729;735
17;Girona;2;Alt Empordà;17138;Portbou;1;2;1;;490;328;162;1;3;324;327
17;Girona;2;Alt Empordà;17140;Port de la Selva, el;1;1;1;;545;456;89;1;1;454;455
25;Lleida;33;Segrià;25174;Portella, la;1;1;1;;471;310;161;2;2;306;308
43;Tarragona;29;Priorat;43115;Pradell de la Teixeta;1;1;1;;226;127;99;0;1;126;127
43;Tarragona;8;Baix Camp;43116;Prades;1;1;1;;449;325;124;3;1;321;322
43;Tarragona;37;Terra Alta;43117;Prat de Comte;1;1;1;;213;166;47;0;0;166;166
8;Barcelona;11;Baix Llobregat;08169;Prat de Llobregat, el;1;1;1;;676;435;241;0;5;430;435
8;Barcelona;11;Baix Llobregat;08169;Prat de Llobregat, el;1;1;2;;668;432;236;0;2;430;432
8;Barcelona;11;Baix Llobregat;08169;Prat de Llobregat, el;1;2;1;;570;458;112;2;4;452;456
8;Barcelona;11;Baix Llobregat;08169;Prat de Llobregat, el;1;2;2;;702;482;220;1;2;479;481
8;Barcelona;11;Baix Llobregat;08169;Prat de Llobregat, el;1;3;1;;952;676;276;3;0;673;673
8;Barcelona;11;Baix Llobregat;08169;Prat de Llobregat, el;1;4;1;;767;526;241;6;3;517;520
8;Barcelona;11;Baix Llobregat;08169;Prat de Llobregat, el;1;4;2;;862;580;282;7;1;572;573
8;Barcelona;11;Baix Llobregat;08169;Prat de Llobregat, el;1;5;1;;642;375;267;0;2;373;375
8;Barcelona;11;Baix Llobregat;08169;Prat de Llobregat, el;1;5;2;;669;374;295;0;4;370;374
8;Barcelona;11;Baix Llobregat;08169;Prat de Llobregat, el;2;1;1;;768;515;253;2;4;509;513
8;Barcelona;11;Baix Llobregat;08169;Prat de Llobregat, el;2;1;2;;787;524;263;0;2;522;524
8;Barcelona;11;Baix Llobregat;08169;Prat de Llobregat, el;2;2;1;;729;480;249;0;2;478;480
8;Barcelona;11;Baix Llobregat;08169;Prat de Llobregat, el;2;2;2;;695;451;244;1;1;449;450
8;Barcelona;11;Baix Llobregat;08169;Prat de Llobregat, el;2;3;1;;722;432;290;9;1;422;423
8;Barcelona;11;Baix Llobregat;08169;Prat de Llobregat, el;2;3;2;;541;347;194;0;1;346;347
8;Barcelona;11;Baix Llobregat;08169;Prat de Llobregat, el;2;4;1;;774;466;308;1;1;464;465
8;Barcelona;11;Baix Llobregat;08169;Prat de Llobregat, el;2;4;2;;731;410;321;0;0;410;410
8;Barcelona;11;Baix Llobregat;08169;Prat de Llobregat, el;2;5;1;;683;404;279;3;2;399;401
8;Barcelona;11;Baix Llobregat;08169;Prat de Llobregat, el;2;5;2;;695;431;264;1;1;429;430
8;Barcelona;11;Baix Llobregat;08169;Prat de Llobregat, el;2;6;1;;777;478;299;1;2;475;477
8;Barcelona;11;Baix Llobregat;08169;Prat de Llobregat, el;2;6;2;;755;466;289;0;2;464;466
8;Barcelona;11;Baix Llobregat;08169;Prat de Llobregat, el;3;1;1;;634;438;196;0;1;437;438
8;Barcelona;11;Baix Llobregat;08169;Prat de Llobregat, el;3;1;2;;663;457;206;0;3;454;457
8;Barcelona;11;Baix Llobregat;08169;Prat de Llobregat, el;3;2;1;;674;294;380;2;0;292;292
8;Barcelona;11;Baix Llobregat;08169;Prat de Llobregat, el;3;3;1;;1092;639;453;2;4;633;637
8;Barcelona;11;Baix Llobregat;08169;Prat de Llobregat, el;3;3;2;;717;423;294;5;2;416;418
8;Barcelona;11;Baix Llobregat;08169;Prat de Llobregat, el;3;3;3;;685;408;277;0;5;403;408
8;Barcelona;11;Baix Llobregat;08169;Prat de Llobregat, el;3;4;1;;824;511;313;1;3;507;510
8;Barcelona;11;Baix Llobregat;08169;Prat de Llobregat, el;3;4;2;;817;483;334;3;5;475;480
8;Barcelona;11;Baix Llobregat;08169;Prat de Llobregat, el;3;5;1;;825;450;375;1;1;448;449
8;Barcelona;11;Baix Llobregat;08169;Prat de Llobregat, el;3;5;2;;849;478;371;1;0;477;477
8;Barcelona;11;Baix Llobregat;08169;Prat de Llobregat, el;3;6;1;;876;484;392;0;3;481;484
8;Barcelona;11;Baix Llobregat;08169;Prat de Llobregat, el;3;7;1;;964;545;419;2;0;543;543
8;Barcelona;11;Baix Llobregat;08169;Prat de Llobregat, el;3;7;2;;999;543;456;2;1;540;541
8;Barcelona;11;Baix Llobregat;08169;Prat de Llobregat, el;4;1;1;;763;437;326;0;1;436;437
8;Barcelona;11;Baix Llobregat;08169;Prat de Llobregat, el;4;1;2;;726;420;306;4;2;414;416
8;Barcelona;11;Baix Llobregat;08169;Prat de Llobregat, el;4;2;1;;583;287;296;0;0;287;287
8;Barcelona;11;Baix Llobregat;08169;Prat de Llobregat, el;4;2;2;;620;327;293;0;1;326;327
8;Barcelona;11;Baix Llobregat;08169;Prat de Llobregat, el;4;3;1;;582;339;243;0;3;336;339
8;Barcelona;11;Baix Llobregat;08169;Prat de Llobregat, el;4;3;2;;568;339;229;1;2;336;338
8;Barcelona;11;Baix Llobregat;08169;Prat de Llobregat, el;4;4;1;;807;447;360;0;0;447;447
8;Barcelona;11;Baix Llobregat;08169;Prat de Llobregat, el;4;4;2;;802;466;336;1;1;464;465
8;Barcelona;11;Baix Llobregat;08169;Prat de Llobregat, el;4;5;1;;654;174;480;1;4;169;173
8;Barcelona;11;Baix Llobregat;08169;Prat de Llobregat, el;4;5;2;;676;198;478;1;0;197;197
8;Barcelona;11;Baix Llobregat;08169;Prat de Llobregat, el;5;1;1;;625;378;247;0;2;376;378
8;Barcelona;11;Baix Llobregat;08169;Prat de Llobregat, el;5;1;2;;565;325;240;0;0;325;325
8;Barcelona;11;Baix Llobregat;08169;Prat de Llobregat, el;5;2;1;;970;562;408;2;5;555;560
8;Barcelona;11;Baix Llobregat;08169;Prat de Llobregat, el;5;2;2;;934;517;417;2;0;515;515
8;Barcelona;11;Baix Llobregat;08169;Prat de Llobregat, el;5;3;1;;979;608;371;1;2;605;607
8;Barcelona;11;Baix Llobregat;08169;Prat de Llobregat, el;5;3;2;;1021;636;385;1;3;632;635
8;Barcelona;11;Baix Llobregat;08169;Prat de Llobregat, el;5;4;1;;629;378;251;2;1;375;376
8;Barcelona;11;Baix Llobregat;08169;Prat de Llobregat, el;5;4;2;;643;406;237;0;1;405;406
8;Barcelona;11;Baix Llobregat;08169;Prat de Llobregat, el;5;5;1;;781;452;329;7;0;445;445
8;Barcelona;11;Baix Llobregat;08169;Prat de Llobregat, el;5;5;2;;744;446;298;1;4;441;445
8;Barcelona;11;Baix Llobregat;08169;Prat de Llobregat, el;5;6;1;;1100;649;451;2;4;643;647
43;Tarragona;8;Baix Camp;43118;Pratdip;1;1;1;;360;244;116;0;1;243;244
8;Barcelona;24;Osona;08171;Prats de Lluçanès;1;1;1;;922;675;247;0;1;674;675
8;Barcelona;24;Osona;08171;Prats de Lluçanès;1;1;2;;875;600;275;3;1;596;597
8;Barcelona;6;Anoia;08170;Prats de Rei, els;1;1;1;;480;392;88;1;0;391;391
25;Lleida;15;Cerdanya;25175;Prats i Sansor;1;1;1;;94;58;36;0;0;58;58
25;Lleida;38;Urgell;25176;Preixana;1;1;1;;408;294;114;0;3;291;294
25;Lleida;23;Noguera;25177;Preixens;1;1;1;;488;289;199;0;3;286;289
8;Barcelona;21;Maresme;08230;Premià de Dalt;1;1;1;;729;578;151;1;2;575;577
8;Barcelona;21;Maresme;08230;Premià de Dalt;1;1;2;;660;531;129;0;1;530;531
8;Barcelona;21;Maresme;08230;Premià de Dalt;1;2;1;;1191;846;345;3;2;841;843
8;Barcelona;21;Maresme;08230;Premià de Dalt;1;3;1;;1066;668;398;6;0;662;662
8;Barcelona;21;Maresme;08172;Premià de Mar;1;1;1;;1059;659;400;2;0;657;657
8;Barcelona;21;Maresme;08172;Premià de Mar;1;2;1;;774;511;263;4;2;505;507
8;Barcelona;21;Maresme;08172;Premià de Mar;1;2;2;;667;416;251;4;3;409;412
8;Barcelona;21;Maresme;08172;Premià de Mar;1;3;1;;1219;740;479;6;1;733;734
8;Barcelona;21;Maresme;08172;Premià de Mar;2;1;1;;815;570;245;1;2;567;569
8;Barcelona;21;Maresme;08172;Premià de Mar;2;1;2;;885;583;302;1;1;581;582
8;Barcelona;21;Maresme;08172;Premià de Mar;2;2;1;;689;432;257;1;0;431;431
8;Barcelona;21;Maresme;08172;Premià de Mar;2;2;2;;684;419;265;1;3;415;418
8;Barcelona;21;Maresme;08172;Premià de Mar;2;3;1;;1263;829;434;18;8;803;811
8;Barcelona;21;Maresme;08172;Premià de Mar;2;4;1;;1191;679;512;2;0;677;677
8;Barcelona;21;Maresme;08172;Premià de Mar;3;1;1;;1140;612;528;6;0;606;606
8;Barcelona;21;Maresme;08172;Premià de Mar;3;2;1;;1178;674;504;4;0;670;670
8;Barcelona;21;Maresme;08172;Premià de Mar;3;3;1;;1341;781;560;5;1;775;776
8;Barcelona;21;Maresme;08172;Premià de Mar;3;4;1;;921;527;394;21;4;502;506
8;Barcelona;21;Maresme;08172;Premià de Mar;3;4;2;;914;532;382;12;0;520;520
17;Girona;19;Garrotxa;17139;Preses, les;1;1;1;;538;341;197;5;1;335;336
17;Girona;19;Garrotxa;17139;Preses, les;1;1;2;;510;344;166;4;5;335;340
25;Lleida;15;Cerdanya;25179;Prullans;1;1;1;;144;98;46;1;0;97;97
17;Girona;15;Cerdanya;17141;Puigcerdà;1;1;1;;520;342;178;9;1;332;333
17;Girona;15;Cerdanya;17141;Puigcerdà;1;1;2;;636;457;179;5;0;452;452
17;Girona;15;Cerdanya;17141;Puigcerdà;1;2;1;;881;637;244;4;5;628;633
17;Girona;15;Cerdanya;17141;Puigcerdà;1;2;2;;1315;945;370;9;5;931;936
17;Girona;15;Cerdanya;17141;Puigcerdà;1;3;1;;483;296;187;0;3;293;296
17;Girona;15;Cerdanya;17141;Puigcerdà;1;3;2;;583;356;227;3;3;350;353
17;Girona;15;Cerdanya;17141;Puigcerdà;1;4;1;;129;92;37;0;0;92;92
8;Barcelona;3;Alt Penedès;08174;Puigdàlber;1;1;1;;230;195;35;0;2;193;195
25;Lleida;18;Garrigues;25180;Puiggròs;1;1;1;;226;174;52;0;4;170;174
43;Tarragona;1;Alt Camp;43119;Puigpelat;1;1;1;;311;210;101;3;0;207;207
8;Barcelona;14;Berguedà;08175;Puig-reig;1;1;1;;974;685;289;2;3;680;683
8;Barcelona;14;Berguedà;08175;Puig-reig;1;1;2;;909;666;243;1;4;661;665
8;Barcelona;14;Berguedà;08175;Puig-reig;1;2;1;;650;493;157;0;0;493;493
8;Barcelona;14;Berguedà;08175;Puig-reig;1;2;2;;644;481;163;1;1;479;480
8;Barcelona;14;Berguedà;08175;Puig-reig;2;1;1;;540;403;137;2;0;401;401
8;Barcelona;14;Berguedà;08175;Puig-reig;2;2;1;;460;300;160;0;3;297;300
8;Barcelona;14;Berguedà;08175;Puig-reig;2;3;1;;446;352;94;6;0;346;346
25;Lleida;38;Urgell;25181;Puigverd d'Agramunt;1;1;1;;221;148;73;0;1;147;148
25;Lleida;33;Segrià;25182;Puigverd de Lleida;1;1;1;;791;478;313;0;4;474;478
8;Barcelona;6;Anoia;08176;Pujalt;1;1;1;;145;97;48;0;0;97;97
8;Barcelona;14;Berguedà;08177;Quar, la;1;1;1;;32;24;8;0;0;24;24
17;Girona;20;Gironès;17142;Quart;1;1;1;;950;706;244;5;2;699;701
17;Girona;31;Ripollès;17043;Queralbs;1;1;1;;185;125;60;0;0;125;125
43;Tarragona;1;Alt Camp;43120;Querol;1;1;1;;110;62;48;0;0;62;62
17;Girona;2;Alt Empordà;17143;Rabós;1;1;1;;129;85;44;0;0;85;85
8;Barcelona;7;Bages;08178;Rajadell;1;1;1;;218;155;63;0;0;155;155
43;Tarragona;30;Ribera d'Ebre;43121;Rasquera;1;1;1;;747;319;428;0;0;319;319
17;Girona;10;Baix Empordà;17144;Regencós;1;1;1;;202;163;39;0;0;163;163
8;Barcelona;40;Vallès Occidental;08179;Rellinars;1;1;1;;136;123;13;0;0;123;123
43;Tarragona;36;Tarragonès;43122;Renau;1;1;1;;36;35;1;0;0;35;35
43;Tarragona;8;Baix Camp;43123;Reus;1;1;1;;922;544;378;0;1;543;544
43;Tarragona;8;Baix Camp;43123;Reus;1;2;1;;705;412;293;6;1;405;406
43;Tarragona;8;Baix Camp;43123;Reus;1;3;1;;837;521;316;0;2;519;521
43;Tarragona;8;Baix Camp;43123;Reus;1;3;2;;763;472;291;3;1;468;469
43;Tarragona;8;Baix Camp;43123;Reus;1;4;1;;880;563;317;3;3;557;560
43;Tarragona;8;Baix Camp;43123;Reus;1;4;2;;782;510;272;0;2;508;510
43;Tarragona;8;Baix Camp;43123;Reus;10;1;1;;772;245;527;2;2;241;243
43;Tarragona;8;Baix Camp;43123;Reus;2;1;1;;1005;542;463;12;3;527;530
43;Tarragona;8;Baix Camp;43123;Reus;2;2;1;;917;539;378;0;6;533;539
43;Tarragona;8;Baix Camp;43123;Reus;2;2;2;;884;543;341;3;1;539;540
43;Tarragona;8;Baix Camp;43123;Reus;2;3;1;;942;605;337;6;2;597;599
43;Tarragona;8;Baix Camp;43123;Reus;2;3;2;;840;514;326;0;4;510;514
43;Tarragona;8;Baix Camp;43123;Reus;2;3;3;;842;520;322;0;8;512;520
43;Tarragona;8;Baix Camp;43123;Reus;2;3;4;;863;537;326;0;6;531;537
43;Tarragona;8;Baix Camp;43123;Reus;2;4;1;;894;551;343;5;0;546;546
43;Tarragona;8;Baix Camp;43123;Reus;2;4;2;;882;491;391;0;3;488;491
43;Tarragona;8;Baix Camp;43123;Reus;2;5;1;;936;555;381;0;2;553;555
43;Tarragona;8;Baix Camp;43123;Reus;2;6;1;;792;472;320;1;2;469;471
43;Tarragona;8;Baix Camp;43123;Reus;2;6;2;;667;363;304;0;3;360;363
43;Tarragona;8;Baix Camp;43123;Reus;2;6;3;;733;417;316;1;3;413;416
43;Tarragona;8;Baix Camp;43123;Reus;2;6;4;;683;381;302;4;7;370;377
43;Tarragona;8;Baix Camp;43123;Reus;3;1;1;;651;388;263;3;1;384;385
43;Tarragona;8;Baix Camp;43123;Reus;3;1;2;;571;303;268;4;4;295;299
43;Tarragona;8;Baix Camp;43123;Reus;3;2;1;;797;423;374;0;0;423;423
43;Tarragona;8;Baix Camp;43123;Reus;3;3;1;;1126;660;466;7;11;642;653
43;Tarragona;8;Baix Camp;43123;Reus;3;3;2;;1053;571;482;3;3;565;568
43;Tarragona;8;Baix Camp;43123;Reus;3;4;1;;814;413;401;3;2;408;410
43;Tarragona;8;Baix Camp;43123;Reus;3;4;2;;736;400;336;6;0;394;394
43;Tarragona;8;Baix Camp;43123;Reus;3;5;1;;1069;667;402;0;3;664;667
43;Tarragona;8;Baix Camp;43123;Reus;3;6;1;;976;567;409;2;3;562;565
43;Tarragona;8;Baix Camp;43123;Reus;3;6;2;;884;516;368;3;3;510;513
43;Tarragona;8;Baix Camp;43123;Reus;3;7;1;;561;237;324;2;2;233;235
43;Tarragona;8;Baix Camp;43123;Reus;3;8;1;;913;428;485;3;4;421;425
43;Tarragona;8;Baix Camp;43123;Reus;3;8;2;;808;310;498;10;0;300;300
43;Tarragona;8;Baix Camp;43123;Reus;3;8;3;;873;358;515;4;5;349;354
43;Tarragona;8;Baix Camp;43123;Reus;3;8;4;;786;326;460;1;2;323;325
43;Tarragona;8;Baix Camp;43123;Reus;4;1;1;;616;279;337;7;2;270;272
43;Tarragona;8;Baix Camp;43123;Reus;4;1;2;;571;285;286;0;3;282;285
43;Tarragona;8;Baix Camp;43123;Reus;4;2;1;;1182;664;518;9;0;655;655
43;Tarragona;8;Baix Camp;43123;Reus;4;2;2;;985;522;463;0;10;512;522
43;Tarragona;8;Baix Camp;43123;Reus;4;3;1;;787;419;368;7;0;412;412
43;Tarragona;8;Baix Camp;43123;Reus;4;4;1;;998;570;428;4;6;560;566
43;Tarragona;8;Baix Camp;43123;Reus;4;4;2;;966;483;483;1;3;479;482
43;Tarragona;8;Baix Camp;43123;Reus;5;1;1;;428;229;199;2;1;226;227
43;Tarragona;8;Baix Camp;43123;Reus;5;2;1;;649;340;309;2;4;334;338
43;Tarragona;8;Baix Camp;43123;Reus;5;2;2;;657;343;314;0;5;338;343
43;Tarragona;8;Baix Camp;43123;Reus;5;2;3;;709;386;323;4;2;380;382
43;Tarragona;8;Baix Camp;43123;Reus;5;2;4;;607;317;290;0;0;317;317
43;Tarragona;8;Baix Camp;43123;Reus;5;3;1;;912;507;405;6;1;500;501
43;Tarragona;8;Baix Camp;43123;Reus;5;3;2;;866;507;359;0;4;503;507
43;Tarragona;8;Baix Camp;43123;Reus;5;4;1;;300;197;103;0;0;197;197
43;Tarragona;8;Baix Camp;43123;Reus;5;5;1;;798;464;334;1;3;460;463
43;Tarragona;8;Baix Camp;43123;Reus;5;5;2;;787;462;325;5;4;453;457
43;Tarragona;8;Baix Camp;43123;Reus;6;1;1;;899;552;347;4;6;542;548
43;Tarragona;8;Baix Camp;43123;Reus;6;1;2;;777;478;299;0;0;478;478
43;Tarragona;8;Baix Camp;43123;Reus;6;2;1;;738;475;263;0;7;468;475
43;Tarragona;8;Baix Camp;43123;Reus;6;2;2;;675;440;235;0;6;434;440
43;Tarragona;8;Baix Camp;43123;Reus;6;3;1;;1184;809;375;1;3;805;808
43;Tarragona;8;Baix Camp;43123;Reus;6;4;1;;695;453;242;7;2;444;446
43;Tarragona;8;Baix Camp;43123;Reus;6;4;2;;589;391;198;1;1;389;390
43;Tarragona;8;Baix Camp;43123;Reus;6;4;3;;550;363;187;1;0;362;362
43;Tarragona;8;Baix Camp;43123;Reus;6;4;4;;613;395;218;6;0;389;389
43;Tarragona;8;Baix Camp;43123;Reus;6;5;1;;585;351;234;5;4;342;346
43;Tarragona;8;Baix Camp;43123;Reus;6;5;2;;678;356;322;0;4;352;356
43;Tarragona;8;Baix Camp;43123;Reus;6;5;3;;630;388;242;4;3;381;384
43;Tarragona;8;Baix Camp;43123;Reus;6;5;4;;628;339;289;3;2;334;336
43;Tarragona;8;Baix Camp;43123;Reus;6;6;1;;1248;842;406;0;5;837;842
43;Tarragona;8;Baix Camp;43123;Reus;7;1;1;;1544;637;907;2;0;635;635
43;Tarragona;8;Baix Camp;43123;Reus;7;2;1;;1572;367;1205;0;0;367;367
43;Tarragona;8;Baix Camp;43123;Reus;8;1;1;;442;158;284;0;0;158;158
43;Tarragona;8;Baix Camp;43123;Reus;8;2;1;;1069;519;550;3;6;510;516
43;Tarragona;8;Baix Camp;43123;Reus;8;2;2;;945;462;483;2;2;458;460
43;Tarragona;8;Baix Camp;43123;Reus;8;3;1;;892;467;425;1;1;465;466
43;Tarragona;8;Baix Camp;43123;Reus;8;3;2;;850;432;418;5;2;425;427
43;Tarragona;8;Baix Camp;43123;Reus;8;4;1;;921;455;466;0;1;454;455
43;Tarragona;8;Baix Camp;43123;Reus;8;5;1;;84;45;39;0;0;45;45
43;Tarragona;8;Baix Camp;43123;Reus;9;1;1;;1118;331;787;0;0;331;331
43;Tarragona;8;Baix Camp;43123;Reus;9;1;2;;976;282;694;1;0;281;281
25;Lleida;26;Pallars Sobirà;25183;Rialp;1;1;1;;343;240;103;0;1;239;240
43;Tarragona;1;Alt Camp;43124;Riba, la;1;1;1;;764;595;169;4;5;586;591
43;Tarragona;30;Ribera d'Ebre;43125;Riba-roja d'Ebre;1;1;1;;631;394;237;3;2;389;391
43;Tarragona;30;Ribera d'Ebre;43125;Riba-roja d'Ebre;1;1;2;;456;283;173;1;0;282;282
43;Tarragona;30;Ribera d'Ebre;43125;Riba-roja d'Ebre;2;1;1;;410;248;162;1;0;247;247
25;Lleida;32;Segarra;25905;Ribera d'Ondara;1;1;1;;467;300;167;0;3;297;300
25;Lleida;4;Alt Urgell;25185;Ribera d'Urgellet;1;1;1;;814;444;370;9;0;435;435
17;Girona;31;Ripollès;17145;Ribes de Freser;1;1;1;;501;376;125;2;2;372;374
17;Girona;31;Ripollès;17145;Ribes de Freser;1;1;2;;474;397;77;3;0;394;394
17;Girona;31;Ripollès;17145;Ribes de Freser;1;2;1;;917;680;237;3;2;675;677
17;Girona;31;Ripollès;17145;Ribes de Freser;1;3;1;;250;169;81;0;0;169;169
17;Girona;34;Selva;17146;Riells i Viabrea;1;1;1;;448;342;106;4;1;337;338
43;Tarragona;36;Tarragonès;43126;Riera de Gaià, la;1;1;1;;711;570;141;2;0;568;568
25;Lleida;35;Solsonès;25186;Riner;1;1;1;;229;180;49;0;0;180;180
17;Girona;31;Ripollès;17147;Ripoll;1;1;1;;744;538;206;1;2;535;537
17;Girona;31;Ripollès;17147;Ripoll;1;2;1;;503;361;142;1;4;356;360
17;Girona;31;Ripollès;17147;Ripoll;1;3;1;;582;420;162;0;3;417;420
17;Girona;31;Ripollès;17147;Ripoll;2;1;1;;998;728;270;5;5;718;723
17;Girona;31;Ripollès;17147;Ripoll;2;2;1;;585;419;166;2;3;414;417
17;Girona;31;Ripollès;17147;Ripoll;2;2;2;;696;498;198;2;7;489;496
17;Girona;31;Ripollès;17147;Ripoll;3;1;1;;938;657;281;10;1;646;647
17;Girona;31;Ripollès;17147;Ripoll;3;2;1;;817;633;184;3;3;627;630
17;Girona;31;Ripollès;17147;Ripoll;3;3;1;;638;480;158;3;2;475;477
17;Girona;31;Ripollès;17147;Ripoll;3;3;2;;806;613;193;4;4;605;609
17;Girona;31;Ripollès;17147;Ripoll;3;4;1;;542;375;167;1;3;371;374
17;Girona;31;Ripollès;17147;Ripoll;3;4;2;;687;451;236;3;0;448;448
17;Girona;31;Ripollès;17147;Ripoll;4;1;1;;1052;623;429;6;3;614;617
8;Barcelona;40;Vallès Occidental;08180;Ripollet;1;1;1;;1129;653;476;3;0;650;650
8;Barcelona;40;Vallès Occidental;08180;Ripollet;1;2;1;;1279;844;435;0;0;844;844
8;Barcelona;40;Vallès Occidental;08180;Ripollet;1;3;1;;1350;818;532;3;4;811;815
8;Barcelona;40;Vallès Occidental;08180;Ripollet;1;4;1;;1063;744;319;3;2;739;741
8;Barcelona;40;Vallès Occidental;08180;Ripollet;1;5;1;;761;439;322;4;0;435;435
8;Barcelona;40;Vallès Occidental;08180;Ripollet;1;6;1;;1350;741;609;2;1;738;739
8;Barcelona;40;Vallès Occidental;08180;Ripollet;1;7;1;;1251;708;543;0;3;705;708
8;Barcelona;40;Vallès Occidental;08180;Ripollet;1;8;1;;1172;668;504;5;6;657;663
8;Barcelona;40;Vallès Occidental;08180;Ripollet;2;1;1;;1148;623;525;4;0;619;619
8;Barcelona;40;Vallès Occidental;08180;Ripollet;2;2;1;;1121;620;501;5;0;615;615
8;Barcelona;40;Vallès Occidental;08180;Ripollet;2;3;1;;1314;799;515;2;0;797;797
8;Barcelona;40;Vallès Occidental;08180;Ripollet;2;4;1;;1251;735;516;0;0;735;735
8;Barcelona;40;Vallès Occidental;08180;Ripollet;2;5;1;;1188;637;551;3;2;632;634
8;Barcelona;40;Vallès Occidental;08180;Ripollet;2;6;1;;1355;710;645;4;1;705;706
8;Barcelona;40;Vallès Occidental;08180;Ripollet;2;7;1;;1157;660;497;3;5;652;657
17;Girona;34;Selva;17148;Riudarenes;1;1;1;;869;597;272;5;3;589;592
17;Girona;19;Garrotxa;17149;Riudaura;1;1;1;;339;187;152;5;2;180;182
43;Tarragona;8;Baix Camp;43127;Riudecanyes;1;1;1;;482;361;121;0;1;360;361
43;Tarragona;8;Baix Camp;43128;Riudecols;1;1;1;;687;510;177;17;4;489;493
17;Girona;34;Selva;17150;Riudellots de la Selva;1;1;1;;899;649;250;10;2;637;639
43;Tarragona;8;Baix Camp;43129;Riudoms;1;1;1;;673;434;239;2;4;428;432
43;Tarragona;8;Baix Camp;43129;Riudoms;1;1;2;;493;323;170;2;3;318;321
43;Tarragona;8;Baix Camp;43129;Riudoms;2;1;1;;1075;697;378;2;2;693;695
43;Tarragona;8;Baix Camp;43129;Riudoms;2;2;1;;1411;836;575;0;4;832;836
17;Girona;2;Alt Empordà;17151;Riumors;1;1;1;;180;123;57;2;0;121;121
8;Barcelona;41;Vallès Oriental;08181;Roca del Vallès, la;1;1;1;;776;522;254;26;5;491;496
8;Barcelona;41;Vallès Oriental;08181;Roca del Vallès, la;1;1;2;;614;384;230;1;5;378;383
8;Barcelona;41;Vallès Oriental;08181;Roca del Vallès, la;1;1;3;;725;499;226;0;2;497;499
8;Barcelona;41;Vallès Oriental;08181;Roca del Vallès, la;1;2;1;;1033;671;362;0;2;669;671
8;Barcelona;41;Vallès Oriental;08181;Roca del Vallès, la;2;1;1;;354;253;101;0;0;253;253
8;Barcelona;41;Vallès Oriental;08181;Roca del Vallès, la;3;1;1;;716;485;231;0;0;485;485
43;Tarragona;16;Conca de Barberà;43130;Rocafort de Queralt;1;1;1;;257;177;80;1;0;176;176
43;Tarragona;36;Tarragonès;43131;Roda de Berà;1;1;1;;1090;855;235;13;2;840;842
8;Barcelona;24;Osona;08183;Roda de Ter;1;1;1;;1706;1242;464;4;4;1234;1238
8;Barcelona;24;Osona;08183;Roda de Ter;1;2;1;;1027;746;281;1;2;743;745
8;Barcelona;24;Osona;08183;Roda de Ter;2;1;1;;888;657;231;14;1;642;643
43;Tarragona;1;Alt Camp;43132;Rodonyà;1;1;1;;314;250;64;4;0;246;246
43;Tarragona;9;Baix Ebre;43133;Roquetes;1;1;1;;804;512;292;4;4;504;508
43;Tarragona;9;Baix Ebre;43133;Roquetes;1;1;2;;487;301;186;4;5;292;297
43;Tarragona;9;Baix Ebre;43133;Roquetes;1;2;1;;818;448;370;4;5;439;444
43;Tarragona;9;Baix Ebre;43133;Roquetes;2;1;1;;928;549;379;11;0;538;538
43;Tarragona;9;Baix Ebre;43133;Roquetes;2;1;2;;628;379;249;3;6;370;376
43;Tarragona;9;Baix Ebre;43133;Roquetes;2;2;1;;745;374;371;1;2;371;373
17;Girona;2;Alt Empordà;17152;Roses;1;1;1;;778;511;267;2;0;509;509
17;Girona;2;Alt Empordà;17152;Roses;1;2;1;;690;411;279;6;0;405;405
17;Girona;2;Alt Empordà;17152;Roses;1;2;2;;873;481;392;4;0;477;477
17;Girona;2;Alt Empordà;17152;Roses;2;1;1;;835;556;279;7;0;549;549
17;Girona;2;Alt Empordà;17152;Roses;2;2;1;;764;477;287;2;1;474;475
17;Girona;2;Alt Empordà;17152;Roses;2;2;2;;909;582;327;0;0;582;582
17;Girona;2;Alt Empordà;17152;Roses;2;3;1;;831;530;301;0;8;522;530
25;Lleida;33;Segrià;25189;Rosselló;1;1;1;;1177;786;391;3;2;781;783
43;Tarragona;1;Alt Camp;43134;Rourell, el;1;1;1;;257;200;57;0;2;198;200
8;Barcelona;40;Vallès Occidental;08184;Rubí;1;1;1;;151;76;75;0;1;75;76
8;Barcelona;40;Vallès Occidental;08184;Rubí;1;2;1;;305;180;125;0;2;178;180
8;Barcelona;40;Vallès Occidental;08184;Rubí;1;3;1;;682;392;290;1;2;389;391
8;Barcelona;40;Vallès Occidental;08184;Rubí;1;3;2;;661;382;279;0;1;381;382
8;Barcelona;40;Vallès Occidental;08184;Rubí;2;1;1;;185;81;104;2;0;79;79
8;Barcelona;40;Vallès Occidental;08184;Rubí;2;2;1;;598;382;216;2;0;380;380
8;Barcelona;40;Vallès Occidental;08184;Rubí;3;1;1;;369;230;139;0;0;230;230
8;Barcelona;40;Vallès Occidental;08184;Rubí;3;2;1;;448;298;150;3;0;295;295
8;Barcelona;40;Vallès Occidental;08184;Rubí;3;3;1;;544;272;272;0;1;271;272
8;Barcelona;40;Vallès Occidental;08184;Rubí;3;3;2;;520;267;253;0;0;267;267
8;Barcelona;40;Vallès Occidental;08184;Rubí;3;4;1;;598;321;277;1;0;320;320
8;Barcelona;40;Vallès Occidental;08184;Rubí;3;5;1;;490;233;257;0;2;231;233
8;Barcelona;40;Vallès Occidental;08184;Rubí;3;5;2;;534;263;271;1;0;262;262
8;Barcelona;40;Vallès Occidental;08184;Rubí;3;6;1;;539;328;211;3;0;325;325
8;Barcelona;40;Vallès Occidental;08184;Rubí;3;6;2;;481;295;186;1;2;292;294
8;Barcelona;40;Vallès Occidental;08184;Rubí;3;7;1;;741;419;322;1;1;417;418
8;Barcelona;40;Vallès Occidental;08184;Rubí;3;7;2;;689;400;289;0;0;400;400
8;Barcelona;40;Vallès Occidental;08184;Rubí;3;7;3;;733;434;299;1;1;432;433
8;Barcelona;40;Vallès Occidental;08184;Rubí;3;8;1;;767;450;317;1;0;449;449
8;Barcelona;40;Vallès Occidental;08184;Rubí;3;8;2;;819;481;338;0;2;479;481
8;Barcelona;40;Vallès Occidental;08184;Rubí;4;1;1;;537;346;191;0;1;345;346
8;Barcelona;40;Vallès Occidental;08184;Rubí;4;1;2;;584;353;231;2;0;351;351
8;Barcelona;40;Vallès Occidental;08184;Rubí;4;10;1;;152;57;95;3;0;54;54
8;Barcelona;40;Vallès Occidental;08184;Rubí;4;11;1;;734;405;329;0;7;398;405
8;Barcelona;40;Vallès Occidental;08184;Rubí;4;11;2;;777;421;356;0;1;420;421
8;Barcelona;40;Vallès Occidental;08184;Rubí;4;12;1;;679;345;334;2;1;342;343
8;Barcelona;40;Vallès Occidental;08184;Rubí;4;12;2;;684;346;338;0;1;345;346
8;Barcelona;40;Vallès Occidental;08184;Rubí;4;13;1;;774;460;314;1;2;457;459
8;Barcelona;40;Vallès Occidental;08184;Rubí;4;13;2;;741;441;300;1;0;440;440
8;Barcelona;40;Vallès Occidental;08184;Rubí;4;14;1;;159;106;53;0;0;106;106
8;Barcelona;40;Vallès Occidental;08184;Rubí;4;15;1;;729;361;368;0;0;361;361
8;Barcelona;40;Vallès Occidental;08184;Rubí;4;15;2;;778;433;345;5;1;427;428
8;Barcelona;40;Vallès Occidental;08184;Rubí;4;16;1;;809;414;395;1;2;411;413
8;Barcelona;40;Vallès Occidental;08184;Rubí;4;17;1;;358;187;171;0;0;187;187
8;Barcelona;40;Vallès Occidental;08184;Rubí;4;2;1;;614;370;244;0;1;369;370
8;Barcelona;40;Vallès Occidental;08184;Rubí;4;2;2;;600;355;245;1;1;353;354
8;Barcelona;40;Vallès Occidental;08184;Rubí;4;2;3;;603;363;240;1;1;361;362
8;Barcelona;40;Vallès Occidental;08184;Rubí;4;2;4;;646;366;280;2;0;364;364
8;Barcelona;40;Vallès Occidental;08184;Rubí;4;2;5;;607;334;273;1;0;333;333
8;Barcelona;40;Vallès Occidental;08184;Rubí;4;2;6;;630;396;234;1;2;393;395
8;Barcelona;40;Vallès Occidental;08184;Rubí;4;3;1;;85;52;33;0;0;52;52
8;Barcelona;40;Vallès Occidental;08184;Rubí;4;4;1;;582;342;240;2;3;337;340
8;Barcelona;40;Vallès Occidental;08184;Rubí;4;4;2;;632;371;261;0;2;369;371
8;Barcelona;40;Vallès Occidental;08184;Rubí;4;4;3;;624;383;241;4;0;379;379
8;Barcelona;40;Vallès Occidental;08184;Rubí;4;5;1;;583;417;166;0;3;414;417
8;Barcelona;40;Vallès Occidental;08184;Rubí;4;5;2;;562;389;173;0;1;388;389
8;Barcelona;40;Vallès Occidental;08184;Rubí;4;6;1;;583;362;221;0;2;360;362
8;Barcelona;40;Vallès Occidental;08184;Rubí;4;6;2;;598;380;218;5;2;373;375
8;Barcelona;40;Vallès Occidental;08184;Rubí;4;7;1;;632;374;258;6;1;367;368
8;Barcelona;40;Vallès Occidental;08184;Rubí;4;7;2;;666;408;258;2;0;406;406
8;Barcelona;40;Vallès Occidental;08184;Rubí;4;8;1;;583;301;282;4;1;296;297
8;Barcelona;40;Vallès Occidental;08184;Rubí;4;8;2;;455;256;199;5;1;250;251
8;Barcelona;40;Vallès Occidental;08184;Rubí;4;9;1;;587;294;293;0;2;292;294
8;Barcelona;40;Vallès Occidental;08184;Rubí;4;9;2;;528;268;260;0;1;267;268
8;Barcelona;6;Anoia;08185;Rubió;1;1;1;;116;84;32;0;3;81;84
17;Girona;10;Baix Empordà;17153;Rupià;1;1;1;;185;134;51;2;4;128;132
8;Barcelona;24;Osona;08901;Rupit i Pruit;1;1;1;;303;215;88;1;1;213;214
8;Barcelona;40;Vallès Occidental;08187;Sabadell;1;1;1;;1478;785;693;3;3;779;782
8;Barcelona;40;Vallès Occidental;08187;Sabadell;1;10;1;;800;601;199;0;1;600;601
8;Barcelona;40;Vallès Occidental;08187;Sabadell;1;11;1;;913;717;196;2;1;714;715
8;Barcelona;40;Vallès Occidental;08187;Sabadell;1;12;1;;1359;1073;286;0;2;1071;1073
8;Barcelona;40;Vallès Occidental;08187;Sabadell;1;13;1;;792;553;239;10;2;541;543
8;Barcelona;40;Vallès Occidental;08187;Sabadell;1;14;1;;1340;1042;298;1;4;1037;1041
8;Barcelona;40;Vallès Occidental;08187;Sabadell;1;15;1;;1105;915;190;0;4;911;915
8;Barcelona;40;Vallès Occidental;08187;Sabadell;1;2;1;;1293;1048;245;0;3;1045;1048
8;Barcelona;40;Vallès Occidental;08187;Sabadell;1;3;1;;908;701;207;0;4;697;701
8;Barcelona;40;Vallès Occidental;08187;Sabadell;1;4;1;;915;680;235;0;2;678;680
8;Barcelona;40;Vallès Occidental;08187;Sabadell;1;5;1;;1542;1135;407;2;4;1129;1133
8;Barcelona;40;Vallès Occidental;08187;Sabadell;1;6;1;;1050;845;205;1;4;840;844
8;Barcelona;40;Vallès Occidental;08187;Sabadell;1;7;1;;796;632;164;0;5;627;632
8;Barcelona;40;Vallès Occidental;08187;Sabadell;1;8;1;;930;703;227;0;0;703;703
8;Barcelona;40;Vallès Occidental;08187;Sabadell;1;9;1;;1062;858;204;14;0;844;844
8;Barcelona;40;Vallès Occidental;08187;Sabadell;1;9;2;;953;749;204;0;4;745;749
8;Barcelona;40;Vallès Occidental;08187;Sabadell;2;1;1;;1127;884;243;1;5;878;883
8;Barcelona;40;Vallès Occidental;08187;Sabadell;2;10;1;;898;585;313;7;2;576;578
8;Barcelona;40;Vallès Occidental;08187;Sabadell;2;10;2;;839;523;316;0;1;522;523
8;Barcelona;40;Vallès Occidental;08187;Sabadell;2;11;1;;1209;937;272;0;7;930;937
8;Barcelona;40;Vallès Occidental;08187;Sabadell;2;12;1;;1047;609;438;0;0;609;609
8;Barcelona;40;Vallès Occidental;08187;Sabadell;2;13;1;;1341;836;505;1;3;832;835
8;Barcelona;40;Vallès Occidental;08187;Sabadell;2;14;1;;865;551;314;3;2;546;548
8;Barcelona;40;Vallès Occidental;08187;Sabadell;2;14;2;;868;518;350;4;4;510;514
8;Barcelona;40;Vallès Occidental;08187;Sabadell;2;15;1;;981;650;331;0;7;643;650
8;Barcelona;40;Vallès Occidental;08187;Sabadell;2;16;1;;1151;826;325;1;6;819;825
8;Barcelona;40;Vallès Occidental;08187;Sabadell;2;17;1;;1398;907;491;1;2;904;906
8;Barcelona;40;Vallès Occidental;08187;Sabadell;2;18;1;;879;535;344;1;1;533;534
8;Barcelona;40;Vallès Occidental;08187;Sabadell;2;2;1;;951;703;248;11;0;692;692
8;Barcelona;40;Vallès Occidental;08187;Sabadell;2;3;1;;1308;868;440;5;0;863;863
8;Barcelona;40;Vallès Occidental;08187;Sabadell;2;4;1;;1427;993;434;1;3;989;992
8;Barcelona;40;Vallès Occidental;08187;Sabadell;2;5;1;;1249;910;339;1;3;906;909
8;Barcelona;40;Vallès Occidental;08187;Sabadell;2;6;1;;1419;998;421;6;3;989;992
8;Barcelona;40;Vallès Occidental;08187;Sabadell;2;7;1;;1216;886;330;1;5;880;885
8;Barcelona;40;Vallès Occidental;08187;Sabadell;2;8;1;;979;596;383;0;5;591;596
8;Barcelona;40;Vallès Occidental;08187;Sabadell;2;9;1;;933;597;336;0;2;595;597
8;Barcelona;40;Vallès Occidental;08187;Sabadell;2;9;2;;994;637;357;1;6;630;636
8;Barcelona;40;Vallès Occidental;08187;Sabadell;3;1;1;;1350;1018;332;9;3;1006;1009
8;Barcelona;40;Vallès Occidental;08187;Sabadell;3;2;1;;862;616;246;3;4;609;613
8;Barcelona;40;Vallès Occidental;08187;Sabadell;3;3;1;;372;260;112;2;1;257;258
8;Barcelona;40;Vallès Occidental;08187;Sabadell;3;4;1;;1335;945;390;20;2;923;925
8;Barcelona;40;Vallès Occidental;08187;Sabadell;3;5;1;;965;759;206;4;4;751;755
8;Barcelona;40;Vallès Occidental;08187;Sabadell;4;1;1;;1265;981;284;0;5;976;981
8;Barcelona;40;Vallès Occidental;08187;Sabadell;4;2;1;;1675;1193;482;0;2;1191;1193
8;Barcelona;40;Vallès Occidental;08187;Sabadell;4;3;1;;1090;731;359;3;2;726;728
8;Barcelona;40;Vallès Occidental;08187;Sabadell;4;4;1;;1266;837;429;2;2;833;835
8;Barcelona;40;Vallès Occidental;08187;Sabadell;4;5;1;;884;633;251;0;0;633;633
8;Barcelona;40;Vallès Occidental;08187;Sabadell;4;6;1;;1316;1010;306;2;5;1003;1008
8;Barcelona;40;Vallès Occidental;08187;Sabadell;4;7;1;;1022;601;421;0;5;596;601
8;Barcelona;40;Vallès Occidental;08187;Sabadell;4;8;1;;1174;800;374;7;2;791;793
8;Barcelona;40;Vallès Occidental;08187;Sabadell;5;1;1;;1300;952;348;0;17;935;952
8;Barcelona;40;Vallès Occidental;08187;Sabadell;5;2;1;;1430;943;487;1;6;936;942
8;Barcelona;40;Vallès Occidental;08187;Sabadell;5;3;1;;1392;892;500;0;4;888;892
8;Barcelona;40;Vallès Occidental;08187;Sabadell;5;4;1;;1439;1014;425;0;6;1008;1014
8;Barcelona;40;Vallès Occidental;08187;Sabadell;6;1;1;;425;224;201;1;0;223;223
8;Barcelona;40;Vallès Occidental;08187;Sabadell;6;10;1;;993;624;369;1;1;622;623
8;Barcelona;40;Vallès Occidental;08187;Sabadell;6;11;1;;1094;701;393;1;2;698;700
8;Barcelona;40;Vallès Occidental;08187;Sabadell;6;12;1;;627;415;212;0;0;415;415
8;Barcelona;40;Vallès Occidental;08187;Sabadell;6;13;1;;886;610;276;1;6;603;609
8;Barcelona;40;Vallès Occidental;08187;Sabadell;6;13;2;;817;577;240;1;5;571;576
8;Barcelona;40;Vallès Occidental;08187;Sabadell;6;14;1;;1468;967;501;2;0;965;965
8;Barcelona;40;Vallès Occidental;08187;Sabadell;6;15;1;;1322;863;459;12;2;849;851
8;Barcelona;40;Vallès Occidental;08187;Sabadell;6;16;1;;905;606;299;0;1;605;606
8;Barcelona;40;Vallès Occidental;08187;Sabadell;6;17;1;;789;539;250;6;2;531;533
8;Barcelona;40;Vallès Occidental;08187;Sabadell;6;18;1;;1054;670;384;24;2;644;646
8;Barcelona;40;Vallès Occidental;08187;Sabadell;6;19;1;;1592;965;627;7;6;952;958
8;Barcelona;40;Vallès Occidental;08187;Sabadell;6;2;1;;1412;825;587;0;7;818;825
8;Barcelona;40;Vallès Occidental;08187;Sabadell;6;20;1;;1322;876;446;0;6;870;876
8;Barcelona;40;Vallès Occidental;08187;Sabadell;6;21;1;;1323;851;472;1;3;847;850
8;Barcelona;40;Vallès Occidental;08187;Sabadell;6;22;1;;1226;795;431;1;7;787;794
8;Barcelona;40;Vallès Occidental;08187;Sabadell;6;23;1;;765;506;259;2;1;503;504
8;Barcelona;40;Vallès Occidental;08187;Sabadell;6;24;1;;631;410;221;1;0;409;409
8;Barcelona;40;Vallès Occidental;08187;Sabadell;6;25;1;;664;411;253;1;4;406;410
8;Barcelona;40;Vallès Occidental;08187;Sabadell;6;26;1;;831;528;303;3;2;523;525
8;Barcelona;40;Vallès Occidental;08187;Sabadell;6;27;1;;1142;733;409;0;3;730;733
8;Barcelona;40;Vallès Occidental;08187;Sabadell;6;3;1;;799;440;359;0;5;435;440
8;Barcelona;40;Vallès Occidental;08187;Sabadell;6;4;1;;825;534;291;0;3;531;534
8;Barcelona;40;Vallès Occidental;08187;Sabadell;6;5;1;;548;391;157;5;2;384;386
8;Barcelona;40;Vallès Occidental;08187;Sabadell;6;6;1;;868;555;313;0;3;552;555
8;Barcelona;40;Vallès Occidental;08187;Sabadell;6;7;1;;1460;972;488;4;4;964;968
8;Barcelona;40;Vallès Occidental;08187;Sabadell;6;8;1;;1322;786;536;2;4;780;784
8;Barcelona;40;Vallès Occidental;08187;Sabadell;6;9;1;;1068;632;436;0;4;628;632
8;Barcelona;40;Vallès Occidental;08187;Sabadell;7;1;1;;1158;701;457;1;5;695;700
8;Barcelona;40;Vallès Occidental;08187;Sabadell;7;10;1;;1219;793;426;2;7;784;791
8;Barcelona;40;Vallès Occidental;08187;Sabadell;7;11;1;;1039;650;389;9;4;637;641
8;Barcelona;40;Vallès Occidental;08187;Sabadell;7;12;1;;946;601;345;3;3;595;598
8;Barcelona;40;Vallès Occidental;08187;Sabadell;7;13;1;;1016;616;400;0;1;615;616
8;Barcelona;40;Vallès Occidental;08187;Sabadell;7;14;1;;961;560;401;6;4;550;554
8;Barcelona;40;Vallès Occidental;08187;Sabadell;7;15;1;;1421;812;609;3;2;807;809
8;Barcelona;40;Vallès Occidental;08187;Sabadell;7;16;1;;1327;814;513;0;4;810;814
8;Barcelona;40;Vallès Occidental;08187;Sabadell;7;2;1;;1025;633;392;1;2;630;632
8;Barcelona;40;Vallès Occidental;08187;Sabadell;7;3;1;;920;584;336;21;1;562;563
8;Barcelona;40;Vallès Occidental;08187;Sabadell;7;4;1;;810;505;305;2;0;503;503
8;Barcelona;40;Vallès Occidental;08187;Sabadell;7;5;1;;1026;657;369;1;5;651;656
8;Barcelona;40;Vallès Occidental;08187;Sabadell;7;6;1;;1314;797;517;10;1;786;787
8;Barcelona;40;Vallès Occidental;08187;Sabadell;7;7;1;;655;397;258;8;0;389;389
8;Barcelona;40;Vallès Occidental;08187;Sabadell;7;8;1;;1437;878;559;22;11;845;856
8;Barcelona;40;Vallès Occidental;08187;Sabadell;7;9;1;;1453;847;606;4;5;838;843
8;Barcelona;40;Vallès Occidental;08187;Sabadell;8;1;1;;599;401;198;1;3;397;400
8;Barcelona;40;Vallès Occidental;08187;Sabadell;8;10;1;;1138;617;521;0;0;617;617
8;Barcelona;40;Vallès Occidental;08187;Sabadell;8;11;1;;1195;623;572;2;2;619;621
8;Barcelona;40;Vallès Occidental;08187;Sabadell;8;12;1;;1544;874;670;2;1;871;872
8;Barcelona;40;Vallès Occidental;08187;Sabadell;8;13;1;;1134;633;501;5;0;628;628
8;Barcelona;40;Vallès Occidental;08187;Sabadell;8;14;1;;546;332;214;0;4;328;332
8;Barcelona;40;Vallès Occidental;08187;Sabadell;8;15;1;;1153;629;524;16;9;604;613
8;Barcelona;40;Vallès Occidental;08187;Sabadell;8;16;1;;1444;989;455;8;8;973;981
8;Barcelona;40;Vallès Occidental;08187;Sabadell;8;17;1;;1436;920;516;9;4;907;911
8;Barcelona;40;Vallès Occidental;08187;Sabadell;8;18;1;;1173;747;426;1;3;743;746
8;Barcelona;40;Vallès Occidental;08187;Sabadell;8;19;1;;807;531;276;3;2;526;528
8;Barcelona;40;Vallès Occidental;08187;Sabadell;8;2;1;;1288;814;474;25;6;783;789
8;Barcelona;40;Vallès Occidental;08187;Sabadell;8;20;1;;1140;682;458;1;4;677;681
8;Barcelona;40;Vallès Occidental;08187;Sabadell;8;21;1;;892;540;352;4;2;534;536
8;Barcelona;40;Vallès Occidental;08187;Sabadell;8;22;1;;1213;702;511;18;7;677;684
8;Barcelona;40;Vallès Occidental;08187;Sabadell;8;23;1;;1488;853;635;11;10;832;842
8;Barcelona;40;Vallès Occidental;08187;Sabadell;8;3;1;;524;297;227;1;0;296;296
8;Barcelona;40;Vallès Occidental;08187;Sabadell;8;4;1;;845;553;292;11;0;542;542
8;Barcelona;40;Vallès Occidental;08187;Sabadell;8;5;1;;1077;590;487;4;0;586;586
8;Barcelona;40;Vallès Occidental;08187;Sabadell;8;6;1;;838;498;340;2;3;493;496
8;Barcelona;40;Vallès Occidental;08187;Sabadell;8;7;1;;1102;677;425;5;3;669;672
8;Barcelona;40;Vallès Occidental;08187;Sabadell;8;8;1;;1391;904;487;2;5;897;902
8;Barcelona;40;Vallès Occidental;08187;Sabadell;8;9;1;;1594;992;602;3;4;985;989
8;Barcelona;40;Vallès Occidental;08187;Sabadell;9;1;1;;1051;743;308;9;1;733;734
8;Barcelona;40;Vallès Occidental;08187;Sabadell;9;2;1;;1103;833;270;5;2;826;828
8;Barcelona;40;Vallès Occidental;08187;Sabadell;9;3;1;;1376;956;420;0;3;953;956
8;Barcelona;40;Vallès Occidental;08187;Sabadell;9;4;1;;784;596;188;3;5;588;593
8;Barcelona;40;Vallès Occidental;08187;Sabadell;9;5;1;;599;464;135;1;1;462;463
8;Barcelona;40;Vallès Occidental;08187;Sabadell;9;6;1;;667;472;195;9;0;463;463
8;Barcelona;14;Berguedà;08188;Sagàs;1;1;1;;202;150;52;0;0;150;150
25;Lleida;25;Pallars Jussà;25190;Salàs de Pallars;1;1;1;;372;297;75;1;0;296;296
8;Barcelona;14;Berguedà;08190;Saldes;1;1;1;;255;171;84;0;0;171;171
17;Girona;19;Garrotxa;17154;Sales de Llierca;1;1;1;;40;23;17;0;0;23;23
8;Barcelona;7;Bages;08191;Sallent;1;1;1;;832;545;287;2;0;543;543
8;Barcelona;7;Bages;08191;Sallent;1;2;1;;837;612;225;0;2;610;612
8;Barcelona;7;Bages;08191;Sallent;1;3;1;;1174;898;276;3;2;893;895
8;Barcelona;7;Bages;08191;Sallent;1;4;1;;965;618;347;0;3;615;618
8;Barcelona;7;Bages;08191;Sallent;1;5;1;;730;536;194;0;0;536;536
8;Barcelona;7;Bages;08191;Sallent;1;8;1;;1096;779;317;5;4;770;774
8;Barcelona;7;Bages;08191;Sallent;2;1;1;;780;492;288;2;0;490;490
8;Barcelona;7;Bages;08191;Sallent;3;1;1;;70;57;13;0;0;57;57
43;Tarragona;36;Tarragonès;43135;Salomó;1;1;1;;421;361;60;1;1;359;360
17;Girona;20;Gironès;17155;Salt;1;1;1;;601;423;178;2;0;421;421
17;Girona;20;Gironès;17155;Salt;1;1;2;;566;397;169;1;2;394;396
17;Girona;20;Gironès;17155;Salt;1;2;1;;930;680;250;0;3;677;680
17;Girona;20;Gironès;17155;Salt;1;3;1;;923;614;309;2;3;609;612
17;Girona;20;Gironès;17155;Salt;1;4;1;;700;489;211;4;2;483;485
17;Girona;20;Gironès;17155;Salt;1;4;2;;647;467;180;2;2;463;465
17;Girona;20;Gironès;17155;Salt;1;5;1;;649;437;212;7;5;425;430
17;Girona;20;Gironès;17155;Salt;1;5;2;;431;326;105;7;3;316;319
17;Girona;20;Gironès;17155;Salt;1;6;1;;700;449;251;0;3;446;449
17;Girona;20;Gironès;17155;Salt;1;6;2;;546;358;188;4;2;352;354
17;Girona;20;Gironès;17155;Salt;1;7;1;;600;423;177;5;5;413;418
17;Girona;20;Gironès;17155;Salt;1;7;2;;476;353;123;2;5;346;351
17;Girona;20;Gironès;17155;Salt;1;8;1;;682;527;155;1;8;518;526
17;Girona;20;Gironès;17155;Salt;2;1;1;;700;478;222;1;3;474;477
17;Girona;20;Gironès;17155;Salt;2;1;2;;554;400;154;0;1;399;400
17;Girona;20;Gironès;17155;Salt;2;2;1;;899;570;329;3;3;564;567
17;Girona;20;Gironès;17155;Salt;2;2;2;;770;512;258;3;5;504;509
17;Girona;20;Gironès;17155;Salt;2;3;1;;948;643;305;6;6;631;637
17;Girona;20;Gironès;17155;Salt;2;4;1;;699;272;427;0;4;268;272
17;Girona;20;Gironès;17155;Salt;2;4;2;;651;253;398;12;2;239;241
17;Girona;20;Gironès;17155;Salt;2;5;1;;620;453;167;2;4;447;451
25;Lleida;32;Segarra;25191;Sanaüja;1;1;1;;444;313;131;0;1;312;313
43;Tarragona;22;Montsià;43138;Santa Bàrbara;1;1;1;;605;416;189;5;3;408;411
43;Tarragona;22;Montsià;43138;Santa Bàrbara;1;2;1;;630;448;182;2;2;444;446
43;Tarragona;22;Montsià;43138;Santa Bàrbara;1;3;1;;335;206;129;0;0;206;206
43;Tarragona;22;Montsià;43138;Santa Bàrbara;2;1;1;;652;463;189;4;1;458;459
43;Tarragona;22;Montsià;43138;Santa Bàrbara;2;2;1;;417;284;133;1;4;279;283
8;Barcelona;24;Osona;08243;Santa Cecília de Voltregà;1;1;1;;156;132;24;0;0;132;132
8;Barcelona;11;Baix Llobregat;08244;Santa Coloma de Cervelló;1;1;1;;1129;823;306;4;1;818;819
8;Barcelona;11;Baix Llobregat;08244;Santa Coloma de Cervelló;1;2;1;;736;559;177;4;1;554;555
17;Girona;34;Selva;17180;Santa Coloma de Farners;1;1;1;;1075;684;391;7;8;669;677
17;Girona;34;Selva;17180;Santa Coloma de Farners;1;1;2;;1042;663;379;6;5;652;657
17;Girona;34;Selva;17180;Santa Coloma de Farners;1;2;1;;531;401;130;1;3;397;400
17;Girona;34;Selva;17180;Santa Coloma de Farners;1;2;2;;494;351;143;3;0;348;348
17;Girona;34;Selva;17180;Santa Coloma de Farners;1;3;1;;1096;769;327;2;4;763;767
17;Girona;34;Selva;17180;Santa Coloma de Farners;1;3;2;;959;683;276;6;4;673;677
17;Girona;34;Selva;17180;Santa Coloma de Farners;1;4;1;;312;146;166;0;0;146;146
8;Barcelona;13;Barcelonès;08245;Santa Coloma de Gramenet;1;1;1;;1012;630;382;1;6;623;629
8;Barcelona;13;Barcelonès;08245;Santa Coloma de Gramenet;1;10;1;;637;325;312;0;1;324;325
8;Barcelona;13;Barcelonès;08245;Santa Coloma de Gramenet;1;10;2;;632;355;277;0;0;355;355
8;Barcelona;13;Barcelonès;08245;Santa Coloma de Gramenet;1;11;1;;483;262;221;1;0;261;261
8;Barcelona;13;Barcelonès;08245;Santa Coloma de Gramenet;1;11;2;;568;289;279;0;3;286;289
8;Barcelona;13;Barcelonès;08245;Santa Coloma de Gramenet;1;12;1;;747;452;295;3;3;446;449
8;Barcelona;13;Barcelonès;08245;Santa Coloma de Gramenet;1;13;1;;500;261;239;0;2;259;261
8;Barcelona;13;Barcelonès;08245;Santa Coloma de Gramenet;1;13;2;;497;245;252;0;2;243;245
8;Barcelona;13;Barcelonès;08245;Santa Coloma de Gramenet;1;13;3;;472;249;223;0;1;248;249
8;Barcelona;13;Barcelonès;08245;Santa Coloma de Gramenet;1;14;1;;760;441;319;0;9;432;441
8;Barcelona;13;Barcelonès;08245;Santa Coloma de Gramenet;1;15;1;;806;444;362;1;1;442;443
8;Barcelona;13;Barcelonès;08245;Santa Coloma de Gramenet;1;16;1;;706;450;256;0;1;449;450
8;Barcelona;13;Barcelonès;08245;Santa Coloma de Gramenet;1;17;1;;700;365;335;0;3;362;365
8;Barcelona;13;Barcelonès;08245;Santa Coloma de Gramenet;1;17;2;;652;345;307;4;0;341;341
8;Barcelona;13;Barcelonès;08245;Santa Coloma de Gramenet;1;18;1;;601;342;259;2;0;340;340
8;Barcelona;13;Barcelonès;08245;Santa Coloma de Gramenet;1;18;2;;560;326;234;4;1;321;322
8;Barcelona;13;Barcelonès;08245;Santa Coloma de Gramenet;1;19;1;;581;317;264;0;3;314;317
8;Barcelona;13;Barcelonès;08245;Santa Coloma de Gramenet;1;19;2;;551;314;237;0;1;313;314
8;Barcelona;13;Barcelonès;08245;Santa Coloma de Gramenet;1;2;1;;673;357;316;0;1;356;357
8;Barcelona;13;Barcelonès;08245;Santa Coloma de Gramenet;1;3;1;;600;319;281;1;0;318;318
8;Barcelona;13;Barcelonès;08245;Santa Coloma de Gramenet;1;3;2;;614;339;275;0;2;337;339
8;Barcelona;13;Barcelonès;08245;Santa Coloma de Gramenet;1;4;1;;778;439;339;1;1;437;438
8;Barcelona;13;Barcelonès;08245;Santa Coloma de Gramenet;1;5;1;;777;454;323;0;0;454;454
8;Barcelona;13;Barcelonès;08245;Santa Coloma de Gramenet;1;6;1;;817;431;386;0;0;431;431
8;Barcelona;13;Barcelonès;08245;Santa Coloma de Gramenet;1;7;1;;662;381;281;1;1;379;380
8;Barcelona;13;Barcelonès;08245;Santa Coloma de Gramenet;1;8;1;;629;329;300;0;0;329;329
8;Barcelona;13;Barcelonès;08245;Santa Coloma de Gramenet;1;9;1;;583;343;240;3;2;338;340
8;Barcelona;13;Barcelonès;08245;Santa Coloma de Gramenet;1;9;2;;582;334;248;12;1;321;322
8;Barcelona;13;Barcelonès;08245;Santa Coloma de Gramenet;2;1;1;;799;509;290;3;0;506;506
8;Barcelona;13;Barcelonès;08245;Santa Coloma de Gramenet;2;10;1;;1011;577;434;7;5;565;570
8;Barcelona;13;Barcelonès;08245;Santa Coloma de Gramenet;2;11;1;;671;358;313;0;0;358;358
8;Barcelona;13;Barcelonès;08245;Santa Coloma de Gramenet;2;12;1;;632;328;304;2;0;326;326
8;Barcelona;13;Barcelonès;08245;Santa Coloma de Gramenet;2;12;2;;506;308;198;0;0;308;308
8;Barcelona;13;Barcelonès;08245;Santa Coloma de Gramenet;2;2;1;;343;203;140;0;0;203;203
8;Barcelona;13;Barcelonès;08245;Santa Coloma de Gramenet;2;3;1;;631;363;268;1;1;361;362
8;Barcelona;13;Barcelonès;08245;Santa Coloma de Gramenet;2;3;2;;678;375;303;3;0;372;372
8;Barcelona;13;Barcelonès;08245;Santa Coloma de Gramenet;2;4;1;;538;286;252;2;0;284;284
8;Barcelona;13;Barcelonès;08245;Santa Coloma de Gramenet;2;4;2;;489;269;220;3;0;266;266
8;Barcelona;13;Barcelonès;08245;Santa Coloma de Gramenet;2;5;1;;650;285;365;5;1;279;280
8;Barcelona;13;Barcelonès;08245;Santa Coloma de Gramenet;2;5;2;;619;276;343;0;0;276;276
8;Barcelona;13;Barcelonès;08245;Santa Coloma de Gramenet;2;6;1;;625;342;283;0;0;342;342
8;Barcelona;13;Barcelonès;08245;Santa Coloma de Gramenet;2;6;2;;562;317;245;2;2;313;315
8;Barcelona;13;Barcelonès;08245;Santa Coloma de Gramenet;2;7;1;;633;325;308;1;0;324;324
8;Barcelona;13;Barcelonès;08245;Santa Coloma de Gramenet;2;7;2;;569;301;268;0;1;300;301
8;Barcelona;13;Barcelonès;08245;Santa Coloma de Gramenet;2;8;1;;483;271;212;1;0;270;270
8;Barcelona;13;Barcelonès;08245;Santa Coloma de Gramenet;2;8;2;;488;257;231;5;1;251;252
8;Barcelona;13;Barcelonès;08245;Santa Coloma de Gramenet;2;8;3;;545;277;268;0;0;277;277
8;Barcelona;13;Barcelonès;08245;Santa Coloma de Gramenet;2;9;1;;645;353;292;0;2;351;353
8;Barcelona;13;Barcelonès;08245;Santa Coloma de Gramenet;2;9;2;;590;315;275;1;0;314;314
8;Barcelona;13;Barcelonès;08245;Santa Coloma de Gramenet;3;1;1;;892;497;395;9;5;483;488
8;Barcelona;13;Barcelonès;08245;Santa Coloma de Gramenet;3;10;1;;501;289;212;1;0;288;288
8;Barcelona;13;Barcelonès;08245;Santa Coloma de Gramenet;3;11;1;;748;416;332;5;7;404;411
8;Barcelona;13;Barcelonès;08245;Santa Coloma de Gramenet;3;12;1;;600;321;279;2;0;319;319
8;Barcelona;13;Barcelonès;08245;Santa Coloma de Gramenet;3;12;2;;546;305;241;1;2;302;304
8;Barcelona;13;Barcelonès;08245;Santa Coloma de Gramenet;3;13;1;;480;297;183;2;2;293;295
8;Barcelona;13;Barcelonès;08245;Santa Coloma de Gramenet;3;13;2;;483;274;209;3;0;271;271
8;Barcelona;13;Barcelonès;08245;Santa Coloma de Gramenet;3;13;3;;483;276;207;2;1;273;274
8;Barcelona;13;Barcelonès;08245;Santa Coloma de Gramenet;3;14;1;;967;549;418;11;0;538;538
8;Barcelona;13;Barcelonès;08245;Santa Coloma de Gramenet;3;15;1;;471;279;192;1;0;278;278
8;Barcelona;13;Barcelonès;08245;Santa Coloma de Gramenet;3;16;1;;425;195;230;0;1;194;195
8;Barcelona;13;Barcelonès;08245;Santa Coloma de Gramenet;3;17;1;;875;446;429;0;5;441;446
8;Barcelona;13;Barcelonès;08245;Santa Coloma de Gramenet;3;18;1;;368;246;122;0;0;246;246
8;Barcelona;13;Barcelonès;08245;Santa Coloma de Gramenet;3;2;1;;615;320;295;6;5;309;314
8;Barcelona;13;Barcelonès;08245;Santa Coloma de Gramenet;3;3;1;;874;502;372;0;4;498;502
8;Barcelona;13;Barcelonès;08245;Santa Coloma de Gramenet;3;4;1;;550;295;255;8;0;287;287
8;Barcelona;13;Barcelonès;08245;Santa Coloma de Gramenet;3;4;2;;1124;315;809;10;0;305;305
8;Barcelona;13;Barcelonès;08245;Santa Coloma de Gramenet;3;5;1;;580;297;283;3;0;294;294
8;Barcelona;13;Barcelonès;08245;Santa Coloma de Gramenet;3;5;2;;625;309;316;4;0;305;305
8;Barcelona;13;Barcelonès;08245;Santa Coloma de Gramenet;3;6;1;;863;499;364;1;1;497;498
8;Barcelona;13;Barcelonès;08245;Santa Coloma de Gramenet;3;7;1;;475;251;224;0;0;251;251
8;Barcelona;13;Barcelonès;08245;Santa Coloma de Gramenet;3;7;2;;500;277;223;0;0;277;277
8;Barcelona;13;Barcelonès;08245;Santa Coloma de Gramenet;3;7;3;;556;278;278;0;0;278;278
8;Barcelona;13;Barcelonès;08245;Santa Coloma de Gramenet;3;8;1;;714;365;349;0;0;365;365
8;Barcelona;13;Barcelonès;08245;Santa Coloma de Gramenet;3;9;1;;856;482;374;13;0;469;469
8;Barcelona;13;Barcelonès;08245;Santa Coloma de Gramenet;4;1;1;;890;468;422;2;8;458;466
8;Barcelona;13;Barcelonès;08245;Santa Coloma de Gramenet;4;10;1;;574;317;257;11;3;303;306
8;Barcelona;13;Barcelonès;08245;Santa Coloma de Gramenet;4;10;2;;503;354;149;12;1;341;342
8;Barcelona;13;Barcelonès;08245;Santa Coloma de Gramenet;4;11;1;;1059;562;497;2;1;559;560
8;Barcelona;13;Barcelonès;08245;Santa Coloma de Gramenet;4;12;1;;948;523;425;4;4;515;519
8;Barcelona;13;Barcelonès;08245;Santa Coloma de Gramenet;4;13;1;;600;317;283;1;0;316;316
8;Barcelona;13;Barcelonès;08245;Santa Coloma de Gramenet;4;13;2;;512;278;234;3;2;273;275
8;Barcelona;13;Barcelonès;08245;Santa Coloma de Gramenet;4;13;3;;596;321;275;0;1;320;321
8;Barcelona;13;Barcelonès;08245;Santa Coloma de Gramenet;4;13;4;;681;379;302;1;1;377;378
8;Barcelona;13;Barcelonès;08245;Santa Coloma de Gramenet;4;14;1;;523;307;216;7;0;300;300
8;Barcelona;13;Barcelonès;08245;Santa Coloma de Gramenet;4;14;2;;533;240;293;5;4;231;235
8;Barcelona;13;Barcelonès;08245;Santa Coloma de Gramenet;4;14;3;;644;358;286;4;4;350;354
8;Barcelona;13;Barcelonès;08245;Santa Coloma de Gramenet;4;15;1;;648;330;318;2;2;326;328
8;Barcelona;13;Barcelonès;08245;Santa Coloma de Gramenet;4;15;2;;619;309;310;1;2;306;308
8;Barcelona;13;Barcelonès;08245;Santa Coloma de Gramenet;4;2;1;;530;347;183;1;0;346;346
8;Barcelona;13;Barcelonès;08245;Santa Coloma de Gramenet;4;2;2;;482;316;166;1;3;312;315
8;Barcelona;13;Barcelonès;08245;Santa Coloma de Gramenet;4;3;1;;857;442;415;1;0;441;441
8;Barcelona;13;Barcelonès;08245;Santa Coloma de Gramenet;4;4;1;;534;310;224;0;1;309;310
8;Barcelona;13;Barcelonès;08245;Santa Coloma de Gramenet;4;4;2;;537;272;265;0;1;271;272
8;Barcelona;13;Barcelonès;08245;Santa Coloma de Gramenet;4;5;1;;896;434;462;2;0;432;432
8;Barcelona;13;Barcelonès;08245;Santa Coloma de Gramenet;4;6;1;;537;286;251;1;2;283;285
8;Barcelona;13;Barcelonès;08245;Santa Coloma de Gramenet;4;6;2;;532;293;239;0;1;292;293
8;Barcelona;13;Barcelonès;08245;Santa Coloma de Gramenet;4;7;1;;670;342;328;5;0;337;337
8;Barcelona;13;Barcelonès;08245;Santa Coloma de Gramenet;4;7;2;;686;359;327;9;0;350;350
8;Barcelona;13;Barcelonès;08245;Santa Coloma de Gramenet;4;8;1;;492;248;244;0;0;248;248
8;Barcelona;13;Barcelonès;08245;Santa Coloma de Gramenet;4;8;2;;484;250;234;4;5;241;246
8;Barcelona;13;Barcelonès;08245;Santa Coloma de Gramenet;4;8;3;;479;254;225;9;1;244;245
8;Barcelona;13;Barcelonès;08245;Santa Coloma de Gramenet;4;9;1;;643;301;342;0;5;296;301
8;Barcelona;13;Barcelonès;08245;Santa Coloma de Gramenet;4;9;2;;625;323;302;0;2;321;323
8;Barcelona;13;Barcelonès;08245;Santa Coloma de Gramenet;5;1;1;;919;443;476;0;1;442;443
8;Barcelona;13;Barcelonès;08245;Santa Coloma de Gramenet;5;10;1;;689;350;339;1;2;347;349
8;Barcelona;13;Barcelonès;08245;Santa Coloma de Gramenet;5;11;1;;500;273;227;4;0;269;269
8;Barcelona;13;Barcelonès;08245;Santa Coloma de Gramenet;5;11;2;;544;296;248;1;0;295;295
8;Barcelona;13;Barcelonès;08245;Santa Coloma de Gramenet;5;12;1;;800;416;384;10;0;406;406
8;Barcelona;13;Barcelonès;08245;Santa Coloma de Gramenet;5;13;1;;476;264;212;0;5;259;264
8;Barcelona;13;Barcelonès;08245;Santa Coloma de Gramenet;5;14;1;;600;302;298;6;1;295;296
8;Barcelona;13;Barcelonès;08245;Santa Coloma de Gramenet;5;14;2;;1155;569;586;6;4;559;563
8;Barcelona;13;Barcelonès;08245;Santa Coloma de Gramenet;5;15;1;;711;350;361;0;1;349;350
8;Barcelona;13;Barcelonès;08245;Santa Coloma de Gramenet;5;16;1;;575;271;304;0;1;270;271
8;Barcelona;13;Barcelonès;08245;Santa Coloma de Gramenet;5;16;2;;592;305;287;10;0;295;295
8;Barcelona;13;Barcelonès;08245;Santa Coloma de Gramenet;5;17;1;;801;386;415;5;3;378;381
8;Barcelona;13;Barcelonès;08245;Santa Coloma de Gramenet;5;18;1;;725;306;419;0;4;302;306
8;Barcelona;13;Barcelonès;08245;Santa Coloma de Gramenet;5;19;1;;812;368;444;4;0;364;364
8;Barcelona;13;Barcelonès;08245;Santa Coloma de Gramenet;5;2;1;;651;344;307;1;1;342;343
8;Barcelona;13;Barcelonès;08245;Santa Coloma de Gramenet;5;2;2;;669;345;324;1;0;344;344
8;Barcelona;13;Barcelonès;08245;Santa Coloma de Gramenet;5;20;1;;450;213;237;0;3;210;213
8;Barcelona;13;Barcelonès;08245;Santa Coloma de Gramenet;5;21;1;;764;378;386;1;0;377;377
8;Barcelona;13;Barcelonès;08245;Santa Coloma de Gramenet;5;3;1;;819;399;420;0;1;398;399
8;Barcelona;13;Barcelonès;08245;Santa Coloma de Gramenet;5;4;1;;720;399;321;2;0;397;397
8;Barcelona;13;Barcelonès;08245;Santa Coloma de Gramenet;5;5;1;;550;268;282;7;1;260;261
8;Barcelona;13;Barcelonès;08245;Santa Coloma de Gramenet;5;5;2;;517;249;268;0;2;247;249
8;Barcelona;13;Barcelonès;08245;Santa Coloma de Gramenet;5;6;1;;910;484;426;2;2;480;482
8;Barcelona;13;Barcelonès;08245;Santa Coloma de Gramenet;5;7;1;;967;557;410;0;0;557;557
8;Barcelona;13;Barcelonès;08245;Santa Coloma de Gramenet;5;8;1;;777;389;388;2;5;382;387
8;Barcelona;13;Barcelonès;08245;Santa Coloma de Gramenet;5;9;1;;867;476;391;1;0;475;475
8;Barcelona;13;Barcelonès;08245;Santa Coloma de Gramenet;6;1;1;;566;313;253;0;3;310;313
8;Barcelona;13;Barcelonès;08245;Santa Coloma de Gramenet;6;10;1;;808;439;369;0;0;439;439
8;Barcelona;13;Barcelonès;08245;Santa Coloma de Gramenet;6;11;1;;794;412;382;0;2;410;412
8;Barcelona;13;Barcelonès;08245;Santa Coloma de Gramenet;6;12;1;;718;418;300;6;5;407;412
8;Barcelona;13;Barcelonès;08245;Santa Coloma de Gramenet;6;13;1;;550;287;263;0;3;284;287
8;Barcelona;13;Barcelonès;08245;Santa Coloma de Gramenet;6;14;1;;538;260;278;1;0;259;259
8;Barcelona;13;Barcelonès;08245;Santa Coloma de Gramenet;6;14;2;;577;282;295;0;1;281;282
8;Barcelona;13;Barcelonès;08245;Santa Coloma de Gramenet;6;15;1;;681;365;316;0;3;362;365
8;Barcelona;13;Barcelonès;08245;Santa Coloma de Gramenet;6;16;1;;629;308;321;0;1;307;308
8;Barcelona;13;Barcelonès;08245;Santa Coloma de Gramenet;6;17;1;;730;356;374;12;0;344;344
8;Barcelona;13;Barcelonès;08245;Santa Coloma de Gramenet;6;2;1;;850;495;355;0;7;488;495
8;Barcelona;13;Barcelonès;08245;Santa Coloma de Gramenet;6;3;1;;546;323;223;0;1;322;323
8;Barcelona;13;Barcelonès;08245;Santa Coloma de Gramenet;6;3;2;;523;319;204;4;1;314;315
8;Barcelona;13;Barcelonès;08245;Santa Coloma de Gramenet;6;4;1;;906;547;359;0;9;538;547
8;Barcelona;13;Barcelonès;08245;Santa Coloma de Gramenet;6;5;1;;852;501;351;0;2;499;501
8;Barcelona;13;Barcelonès;08245;Santa Coloma de Gramenet;6;6;1;;675;364;311;0;2;362;364
8;Barcelona;13;Barcelonès;08245;Santa Coloma de Gramenet;6;7;1;;546;278;268;0;0;278;278
8;Barcelona;13;Barcelonès;08245;Santa Coloma de Gramenet;6;8;1;;955;501;454;2;1;498;499
8;Barcelona;13;Barcelonès;08245;Santa Coloma de Gramenet;6;9;1;;575;324;251;0;4;320;324
43;Tarragona;16;Conca de Barberà;43139;Santa Coloma de Queralt;1;1;1;;742;549;193;8;1;540;541
43;Tarragona;16;Conca de Barberà;43139;Santa Coloma de Queralt;1;1;2;;810;608;202;14;1;593;594
43;Tarragona;16;Conca de Barberà;43139;Santa Coloma de Queralt;2;1;1;;529;350;179;0;0;350;350
17;Girona;10;Baix Empordà;17181;Santa Cristina d'Aro;1;1;1;;894;671;223;7;3;661;664
8;Barcelona;13;Barcelonès;08194;Sant Adrià de Besòs;1;1;1;;521;323;198;1;1;321;322
8;Barcelona;13;Barcelonès;08194;Sant Adrià de Besòs;1;1;2;;471;291;180;0;1;290;291
8;Barcelona;13;Barcelonès;08194;Sant Adrià de Besòs;1;2;1;;499;331;168;1;2;328;330
8;Barcelona;13;Barcelonès;08194;Sant Adrià de Besòs;1;2;2;;550;378;172;2;4;372;376
8;Barcelona;13;Barcelonès;08194;Sant Adrià de Besòs;1;3;1;;609;340;269;1;0;339;339
8;Barcelona;13;Barcelonès;08194;Sant Adrià de Besòs;1;3;2;;674;385;289;2;0;383;383
8;Barcelona;13;Barcelonès;08194;Sant Adrià de Besòs;1;4;1;;663;409;254;3;0;406;406
8;Barcelona;13;Barcelonès;08194;Sant Adrià de Besòs;1;4;2;;641;399;242;2;0;397;397
8;Barcelona;13;Barcelonès;08194;Sant Adrià de Besòs;1;5;1;;715;461;254;1;2;458;460
8;Barcelona;13;Barcelonès;08194;Sant Adrià de Besòs;1;5;2;;685;419;266;3;0;416;416
8;Barcelona;13;Barcelonès;08194;Sant Adrià de Besòs;1;6;1;;544;359;185;0;1;358;359
8;Barcelona;13;Barcelonès;08194;Sant Adrià de Besòs;1;6;2;;588;376;212;0;0;376;376
8;Barcelona;13;Barcelonès;08194;Sant Adrià de Besòs;1;6;3;;620;419;201;1;3;415;418
8;Barcelona;13;Barcelonès;08194;Sant Adrià de Besòs;2;1;1;;657;412;245;3;3;406;409
8;Barcelona;13;Barcelonès;08194;Sant Adrià de Besòs;2;1;2;;624;389;235;0;1;388;389
8;Barcelona;13;Barcelonès;08194;Sant Adrià de Besòs;2;2;1;;698;413;285;1;6;406;412
8;Barcelona;13;Barcelonès;08194;Sant Adrià de Besòs;2;2;2;;652;413;239;4;1;408;409
8;Barcelona;13;Barcelonès;08194;Sant Adrià de Besòs;3;1;1;;667;425;242;1;1;423;424
8;Barcelona;13;Barcelonès;08194;Sant Adrià de Besòs;4;1;1;;526;271;255;0;5;266;271
8;Barcelona;13;Barcelonès;08194;Sant Adrià de Besòs;4;1;2;;549;324;225;0;0;324;324
8;Barcelona;13;Barcelonès;08194;Sant Adrià de Besòs;5;1;1;;715;369;346;2;3;364;367
8;Barcelona;13;Barcelonès;08194;Sant Adrià de Besòs;5;1;2;;666;356;310;2;1;353;354
8;Barcelona;13;Barcelonès;08194;Sant Adrià de Besòs;5;10;1;;528;247;281;0;2;245;247
8;Barcelona;13;Barcelonès;08194;Sant Adrià de Besòs;5;10;2;;501;256;245;1;1;254;255
8;Barcelona;13;Barcelonès;08194;Sant Adrià de Besòs;5;11;1;;614;259;355;1;1;257;258
8;Barcelona;13;Barcelonès;08194;Sant Adrià de Besòs;5;2;1;;529;307;222;1;1;305;306
8;Barcelona;13;Barcelonès;08194;Sant Adrià de Besòs;5;2;2;;548;323;225;0;2;321;323
8;Barcelona;13;Barcelonès;08194;Sant Adrià de Besòs;5;2;3;;496;268;228;0;0;268;268
8;Barcelona;13;Barcelonès;08194;Sant Adrià de Besòs;5;3;1;;871;535;336;0;3;532;535
8;Barcelona;13;Barcelonès;08194;Sant Adrià de Besòs;5;4;1;;672;412;260;2;0;410;410
8;Barcelona;13;Barcelonès;08194;Sant Adrià de Besòs;5;4;2;;621;358;263;0;2;356;358
8;Barcelona;13;Barcelonès;08194;Sant Adrià de Besòs;5;5;1;;651;218;433;1;0;217;217
8;Barcelona;13;Barcelonès;08194;Sant Adrià de Besòs;5;5;2;;671;269;402;1;0;268;268
8;Barcelona;13;Barcelonès;08194;Sant Adrià de Besòs;5;6;1;;600;279;321;1;4;274;278
8;Barcelona;13;Barcelonès;08194;Sant Adrià de Besòs;5;6;2;;650;333;317;0;2;331;333
8;Barcelona;13;Barcelonès;08194;Sant Adrià de Besòs;5;7;1;;436;214;222;1;0;213;213
8;Barcelona;13;Barcelonès;08194;Sant Adrià de Besòs;5;8;1;;684;303;381;10;2;291;293
8;Barcelona;13;Barcelonès;08194;Sant Adrià de Besòs;5;8;2;;651;315;336;0;8;307;315
8;Barcelona;13;Barcelonès;08194;Sant Adrià de Besòs;5;9;1;;684;387;297;0;1;386;387
8;Barcelona;13;Barcelonès;08194;Sant Adrià de Besòs;5;9;2;;682;413;269;3;0;410;410
8;Barcelona;24;Osona;08246;Santa Eugènia de Berga;1;1;1;;869;671;198;2;0;669;669
8;Barcelona;24;Osona;08247;Santa Eulàlia de Riuprimer;1;1;1;;584;453;131;1;1;451;452
8;Barcelona;41;Vallès Oriental;08248;Santa Eulàlia de Ronçana;1;1;1;;943;667;276;0;6;661;667
8;Barcelona;41;Vallès Oriental;08248;Santa Eulàlia de Ronçana;1;1;2;;816;523;293;0;3;520;523
8;Barcelona;3;Alt Penedès;08249;Santa Fe del Penedès;1;1;1;;145;104;41;0;1;103;104
8;Barcelona;24;Osona;08195;Sant Agustí de Lluçanès;1;1;1;;113;72;41;1;0;71;71
17;Girona;2;Alt Empordà;17182;Santa Llogaia d'Àlguema;1;1;1;;197;143;54;1;0;142;142
8;Barcelona;6;Anoia;08250;Santa Margarida de Montbui;1;1;1;;696;409;287;1;2;406;408
8;Barcelona;6;Anoia;08250;Santa Margarida de Montbui;1;2;1;;958;569;389;3;4;562;566
8;Barcelona;6;Anoia;08250;Santa Margarida de Montbui;1;2;2;;1115;670;445;1;5;664;669
8;Barcelona;6;Anoia;08250;Santa Margarida de Montbui;1;3;1;;869;474;395;4;2;468;470
8;Barcelona;6;Anoia;08250;Santa Margarida de Montbui;1;4;1;;1167;688;479;3;6;679;685
8;Barcelona;6;Anoia;08250;Santa Margarida de Montbui;1;4;2;;1210;733;477;4;0;729;729
8;Barcelona;3;Alt Penedès;08251;Santa Margarida i els Monjos;1;1;1;;897;610;287;2;2;606;608
8;Barcelona;3;Alt Penedès;08251;Santa Margarida i els Monjos;1;1;2;;913;589;324;4;3;582;585
8;Barcelona;3;Alt Penedès;08251;Santa Margarida i els Monjos;1;2;1;;644;433;211;0;1;432;433
8;Barcelona;;;08258;Santa Maria d'Oló;1;1;1;;810;584;226;0;2;582;584
8;Barcelona;24;Osona;08253;Santa Maria de Besora;1;1;1;;165;120;45;0;0;120;120
8;Barcelona;41;Vallès Oriental;08256;Santa Maria de Martorelles;1;1;1;;311;236;75;3;1;232;233
8;Barcelona;14;Berguedà;08255;Santa Maria de Merlès;1;1;1;;190;107;83;0;0;107;107
8;Barcelona;6;Anoia;08257;Santa Maria de Miralles;1;1;1;;87;55;32;0;0;55;55
8;Barcelona;41;Vallès Oriental;08259;Santa Maria de Palautordera;1;1;1;;711;556;155;8;0;548;548
8;Barcelona;41;Vallès Oriental;08259;Santa Maria de Palautordera;1;1;2;;692;565;127;5;2;558;560
8;Barcelona;41;Vallès Oriental;08259;Santa Maria de Palautordera;1;2;1;;862;673;189;11;2;660;662
8;Barcelona;41;Vallès Oriental;08259;Santa Maria de Palautordera;1;3;1;;447;308;139;1;1;306;307
8;Barcelona;41;Vallès Oriental;08259;Santa Maria de Palautordera;1;4;1;;485;379;106;3;1;375;376
8;Barcelona;11;Baix Llobregat;08196;Sant Andreu de la Barca;1;1;1;;918;540;378;1;4;535;539
8;Barcelona;11;Baix Llobregat;08196;Sant Andreu de la Barca;1;1;2;;867;530;337;1;2;527;529
8;Barcelona;11;Baix Llobregat;08196;Sant Andreu de la Barca;1;2;1;;642;334;308;0;1;333;334
8;Barcelona;11;Baix Llobregat;08196;Sant Andreu de la Barca;1;2;2;;662;301;361;2;1;298;299
8;Barcelona;11;Baix Llobregat;08196;Sant Andreu de la Barca;1;3;1;;817;441;376;0;4;437;441
8;Barcelona;11;Baix Llobregat;08196;Sant Andreu de la Barca;1;3;2;;841;442;399;1;1;440;441
8;Barcelona;11;Baix Llobregat;08196;Sant Andreu de la Barca;1;4;1;;1365;745;620;2;3;740;743
8;Barcelona;11;Baix Llobregat;08196;Sant Andreu de la Barca;1;4;2;;908;518;390;1;1;516;517
8;Barcelona;11;Baix Llobregat;08196;Sant Andreu de la Barca;1;4;3;;1036;601;435;1;1;599;600
8;Barcelona;11;Baix Llobregat;08196;Sant Andreu de la Barca;1;5;1;;703;393;310;3;1;389;390
8;Barcelona;11;Baix Llobregat;08196;Sant Andreu de la Barca;1;5;2;;645;363;282;1;0;362;362
8;Barcelona;21;Maresme;08197;Sant Andreu de Llavaneres;1;1;1;;843;651;192;2;3;646;649
8;Barcelona;21;Maresme;08197;Sant Andreu de Llavaneres;1;1;2;;789;597;192;0;2;595;597
8;Barcelona;21;Maresme;08197;Sant Andreu de Llavaneres;2;1;1;;560;412;148;0;1;411;412
17;Girona;20;Gironès;17157;Sant Andreu Salou;1;1;1;;132;98;34;1;0;97;97
17;Girona;19;Garrotxa;17183;Sant Aniol de Finestres;1;1;1;;213;131;82;0;0;131;131
8;Barcelona;41;Vallès Oriental;08198;Sant Antoni de Vilamajor;1;1;1;;1257;922;335;0;11;911;922
43;Tarragona;12;Baix Penedès;43140;Santa Oliva;1;1;1;;886;574;312;9;1;564;565
17;Girona;19;Garrotxa;17184;Santa Pau;1;1;1;;501;289;212;0;4;285;289
17;Girona;19;Garrotxa;17184;Santa Pau;1;1;2;;533;312;221;1;7;304;311
8;Barcelona;40;Vallès Occidental;08260;Santa Perpètua de Mogoda;1;1;1;;1630;940;690;2;4;934;938
8;Barcelona;40;Vallès Occidental;08260;Santa Perpètua de Mogoda;1;2;1;;1541;892;649;2;4;886;890
8;Barcelona;40;Vallès Occidental;08260;Santa Perpètua de Mogoda;1;3;1;;987;654;333;0;0;654;654
8;Barcelona;40;Vallès Occidental;08260;Santa Perpètua de Mogoda;1;4;1;;1533;656;877;0;3;653;656
8;Barcelona;40;Vallès Occidental;08260;Santa Perpètua de Mogoda;1;5;1;;567;259;308;0;0;259;259
8;Barcelona;40;Vallès Occidental;08260;Santa Perpètua de Mogoda;1;6;1;;805;466;339;5;0;461;461
8;Barcelona;40;Vallès Occidental;08260;Santa Perpètua de Mogoda;1;7;1;;685;385;300;1;3;381;384
8;Barcelona;40;Vallès Occidental;08260;Santa Perpètua de Mogoda;1;8;1;;1343;708;635;4;0;704;704
8;Barcelona;40;Vallès Occidental;08260;Santa Perpètua de Mogoda;1;9;1;;281;160;121;0;0;160;160
8;Barcelona;21;Maresme;08261;Santa Susanna;1;1;1;;409;300;109;0;1;299;300
8;Barcelona;24;Osona;08199;Sant Bartomeu del Grau;1;1;1;;809;506;303;2;2;502;504
8;Barcelona;11;Baix Llobregat;08200;Sant Boi de Llobregat;1;1;1;;1103;745;358;5;8;732;740
8;Barcelona;11;Baix Llobregat;08200;Sant Boi de Llobregat;1;2;1;;825;527;298;0;0;527;527
8;Barcelona;11;Baix Llobregat;08200;Sant Boi de Llobregat;1;2;2;;677;418;259;4;1;413;414
8;Barcelona;11;Baix Llobregat;08200;Sant Boi de Llobregat;1;3;1;;1045;707;338;6;4;697;701
8;Barcelona;11;Baix Llobregat;08200;Sant Boi de Llobregat;1;4;1;;635;410;225;8;0;402;402
8;Barcelona;11;Baix Llobregat;08200;Sant Boi de Llobregat;1;4;2;;623;390;233;2;0;388;388
8;Barcelona;11;Baix Llobregat;08200;Sant Boi de Llobregat;1;5;1;;738;317;421;8;0;309;309
8;Barcelona;11;Baix Llobregat;08200;Sant Boi de Llobregat;1;5;2;;619;229;390;2;0;227;227
8;Barcelona;11;Baix Llobregat;08200;Sant Boi de Llobregat;1;6;1;;1038;666;372;17;0;649;649
8;Barcelona;11;Baix Llobregat;08200;Sant Boi de Llobregat;1;7;1;;1041;684;357;16;0;668;668
8;Barcelona;11;Baix Llobregat;08200;Sant Boi de Llobregat;2;1;1;;417;259;158;1;0;258;258
8;Barcelona;11;Baix Llobregat;08200;Sant Boi de Llobregat;2;10;1;;1040;679;361;16;5;658;663
8;Barcelona;11;Baix Llobregat;08200;Sant Boi de Llobregat;2;11;1;;1105;683;422;13;4;666;670
8;Barcelona;11;Baix Llobregat;08200;Sant Boi de Llobregat;2;2;1;;1024;607;417;0;4;603;607
8;Barcelona;11;Baix Llobregat;08200;Sant Boi de Llobregat;2;2;2;;1018;546;472;0;5;541;546
8;Barcelona;11;Baix Llobregat;08200;Sant Boi de Llobregat;2;3;1;;730;444;286;13;1;430;431
8;Barcelona;11;Baix Llobregat;08200;Sant Boi de Llobregat;2;3;2;;799;489;310;15;0;474;474
8;Barcelona;11;Baix Llobregat;08200;Sant Boi de Llobregat;2;4;1;;974;606;368;10;0;596;596
8;Barcelona;11;Baix Llobregat;08200;Sant Boi de Llobregat;2;5;1;;733;458;275;7;1;450;451
8;Barcelona;11;Baix Llobregat;08200;Sant Boi de Llobregat;2;5;2;;652;395;257;0;1;394;395
8;Barcelona;11;Baix Llobregat;08200;Sant Boi de Llobregat;2;6;1;;282;140;142;0;1;139;140
8;Barcelona;11;Baix Llobregat;08200;Sant Boi de Llobregat;2;7;1;;223;124;99;8;0;116;116
8;Barcelona;11;Baix Llobregat;08200;Sant Boi de Llobregat;2;8;1;;78;30;48;2;0;28;28
8;Barcelona;11;Baix Llobregat;08200;Sant Boi de Llobregat;2;9;1;;939;578;361;0;0;578;578
8;Barcelona;11;Baix Llobregat;08200;Sant Boi de Llobregat;3;1;1;;781;527;254;12;0;515;515
8;Barcelona;11;Baix Llobregat;08200;Sant Boi de Llobregat;3;1;2;;731;506;225;14;0;492;492
8;Barcelona;11;Baix Llobregat;08200;Sant Boi de Llobregat;3;2;1;;978;596;382;1;0;595;595
8;Barcelona;11;Baix Llobregat;08200;Sant Boi de Llobregat;3;2;2;;1081;728;353;9;1;718;719
8;Barcelona;11;Baix Llobregat;08200;Sant Boi de Llobregat;3;3;1;;1181;762;419;1;0;761;761
8;Barcelona;11;Baix Llobregat;08200;Sant Boi de Llobregat;3;4;1;;829;534;295;9;0;525;525
8;Barcelona;11;Baix Llobregat;08200;Sant Boi de Llobregat;3;4;2;;701;454;247;12;0;442;442
8;Barcelona;11;Baix Llobregat;08200;Sant Boi de Llobregat;3;5;1;;789;511;278;0;0;511;511
8;Barcelona;11;Baix Llobregat;08200;Sant Boi de Llobregat;3;5;2;;580;382;198;3;0;379;379
8;Barcelona;11;Baix Llobregat;08200;Sant Boi de Llobregat;3;6;1;;926;627;299;2;0;625;625
8;Barcelona;11;Baix Llobregat;08200;Sant Boi de Llobregat;4;1;1;;1264;742;522;15;0;727;727
8;Barcelona;11;Baix Llobregat;08200;Sant Boi de Llobregat;4;1;2;;1466;871;595;2;0;869;869
8;Barcelona;11;Baix Llobregat;08200;Sant Boi de Llobregat;4;2;1;;987;584;403;10;3;571;574
8;Barcelona;11;Baix Llobregat;08200;Sant Boi de Llobregat;4;2;2;;999;604;395;12;0;592;592
8;Barcelona;11;Baix Llobregat;08200;Sant Boi de Llobregat;4;3;1;;1075;731;344;18;0;713;713
8;Barcelona;11;Baix Llobregat;08200;Sant Boi de Llobregat;4;4;1;;652;432;220;1;0;431;431
8;Barcelona;11;Baix Llobregat;08200;Sant Boi de Llobregat;4;5;1;;785;539;246;3;2;534;536
8;Barcelona;11;Baix Llobregat;08200;Sant Boi de Llobregat;4;5;2;;802;528;274;5;0;523;523
8;Barcelona;11;Baix Llobregat;08200;Sant Boi de Llobregat;4;6;1;;109;76;33;0;0;76;76
8;Barcelona;11;Baix Llobregat;08200;Sant Boi de Llobregat;5;1;1;;1220;825;395;14;0;811;811
8;Barcelona;11;Baix Llobregat;08200;Sant Boi de Llobregat;5;2;1;;580;390;190;4;0;386;386
8;Barcelona;11;Baix Llobregat;08200;Sant Boi de Llobregat;5;3;1;;1285;816;469;13;0;803;803
8;Barcelona;11;Baix Llobregat;08200;Sant Boi de Llobregat;5;4;1;;877;539;338;12;0;527;527
8;Barcelona;11;Baix Llobregat;08200;Sant Boi de Llobregat;5;4;2;;825;500;325;2;3;495;498
8;Barcelona;11;Baix Llobregat;08200;Sant Boi de Llobregat;5;5;1;;1006;633;373;6;0;627;627
8;Barcelona;11;Baix Llobregat;08200;Sant Boi de Llobregat;5;5;2;;1160;732;428;4;0;728;728
8;Barcelona;11;Baix Llobregat;08200;Sant Boi de Llobregat;5;6;1;;785;536;249;5;2;529;531
8;Barcelona;11;Baix Llobregat;08200;Sant Boi de Llobregat;5;6;2;;729;489;240;10;0;479;479
8;Barcelona;11;Baix Llobregat;08200;Sant Boi de Llobregat;5;7;1;;1009;598;411;0;4;594;598
8;Barcelona;11;Baix Llobregat;08200;Sant Boi de Llobregat;6;1;1;;623;353;270;7;1;345;346
8;Barcelona;11;Baix Llobregat;08200;Sant Boi de Llobregat;6;1;2;;626;387;239;0;4;383;387
8;Barcelona;11;Baix Llobregat;08200;Sant Boi de Llobregat;6;2;1;;674;376;298;9;5;362;367
8;Barcelona;11;Baix Llobregat;08200;Sant Boi de Llobregat;6;2;2;;643;388;255;1;0;387;387
8;Barcelona;11;Baix Llobregat;08200;Sant Boi de Llobregat;6;3;1;;822;432;390;4;2;426;428
8;Barcelona;11;Baix Llobregat;08200;Sant Boi de Llobregat;6;4;1;;601;359;242;4;0;355;355
8;Barcelona;11;Baix Llobregat;08200;Sant Boi de Llobregat;6;5;1;;737;380;357;6;2;372;374
8;Barcelona;11;Baix Llobregat;08200;Sant Boi de Llobregat;6;5;2;;671;351;320;2;1;348;349
8;Barcelona;11;Baix Llobregat;08200;Sant Boi de Llobregat;6;6;1;;1096;690;406;1;0;689;689
8;Barcelona;11;Baix Llobregat;08200;Sant Boi de Llobregat;6;7;1;;972;555;417;2;5;548;553
8;Barcelona;24;Osona;08201;Sant Boi de Lluçanès;1;1;1;;410;294;116;0;1;293;294
43;Tarragona;22;Montsià;43136;Sant Carles de la Ràpita;1;1;1;;631;411;220;6;3;402;405
43;Tarragona;22;Montsià;43136;Sant Carles de la Ràpita;1;1;2;;616;404;212;0;3;401;404
43;Tarragona;22;Montsià;43136;Sant Carles de la Ràpita;1;2;1;;851;548;303;8;7;533;540
43;Tarragona;22;Montsià;43136;Sant Carles de la Ràpita;1;3;1;;1052;726;326;4;8;714;722
43;Tarragona;22;Montsià;43136;Sant Carles de la Ràpita;1;4;1;;988;666;322;10;4;652;656
43;Tarragona;22;Montsià;43136;Sant Carles de la Ràpita;1;5;1;;629;379;250;4;9;366;375
43;Tarragona;22;Montsià;43136;Sant Carles de la Ràpita;2;1;1;;764;491;273;3;2;486;488
43;Tarragona;22;Montsià;43136;Sant Carles de la Ràpita;2;2;1;;873;624;249;6;1;617;618
43;Tarragona;22;Montsià;43136;Sant Carles de la Ràpita;2;3;1;;1032;682;350;6;7;669;676
8;Barcelona;21;Maresme;08203;Sant Cebrià de Vallalta;1;1;1;;461;355;106;0;0;355;355
8;Barcelona;41;Vallès Oriental;08202;Sant Celoni;1;1;1;;830;622;208;1;2;619;621
8;Barcelona;41;Vallès Oriental;08202;Sant Celoni;1;1;2;;867;656;211;2;0;654;654
8;Barcelona;41;Vallès Oriental;08202;Sant Celoni;1;2;1;;498;372;126;0;1;371;372
8;Barcelona;41;Vallès Oriental;08202;Sant Celoni;1;2;2;;481;374;107;0;1;373;374
8;Barcelona;41;Vallès Oriental;08202;Sant Celoni;1;3;1;;628;470;158;1;1;468;469
8;Barcelona;41;Vallès Oriental;08202;Sant Celoni;1;3;2;;669;472;197;1;5;466;471
8;Barcelona;41;Vallès Oriental;08202;Sant Celoni;1;4;1;;678;499;179;0;5;494;499
8;Barcelona;41;Vallès Oriental;08202;Sant Celoni;1;4;2;;677;470;207;0;1;469;470
8;Barcelona;41;Vallès Oriental;08202;Sant Celoni;1;5;1;;819;567;252;0;0;567;567
8;Barcelona;41;Vallès Oriental;08202;Sant Celoni;1;5;2;;861;567;294;1;1;565;566
8;Barcelona;41;Vallès Oriental;08202;Sant Celoni;1;6;1;;534;364;170;0;3;361;364
8;Barcelona;41;Vallès Oriental;08202;Sant Celoni;1;6;2;;506;358;148;0;0;358;358
8;Barcelona;41;Vallès Oriental;08202;Sant Celoni;2;1;1;;352;252;100;0;0;252;252
8;Barcelona;41;Vallès Oriental;08202;Sant Celoni;2;2;1;;270;161;109;0;0;161;161
8;Barcelona;11;Baix Llobregat;08204;Sant Climent de Llobregat;1;1;1;;748;526;222;0;3;523;526
8;Barcelona;11;Baix Llobregat;08204;Sant Climent de Llobregat;1;1;2;;791;570;221;0;4;566;570
17;Girona;2;Alt Empordà;17158;Sant Climent Sescebes;1;1;1;;386;291;95;0;3;288;291
8;Barcelona;40;Vallès Occidental;08205;Sant Cugat del Vallès;1;1;1;;1113;764;349;0;3;761;764
8;Barcelona;40;Vallès Occidental;08205;Sant Cugat del Vallès;1;2;1;;981;666;315;9;7;650;657
8;Barcelona;40;Vallès Occidental;08205;Sant Cugat del Vallès;1;2;2;;1010;694;316;1;11;682;693
8;Barcelona;40;Vallès Occidental;08205;Sant Cugat del Vallès;1;2;3;;1007;688;319;12;4;672;676
8;Barcelona;40;Vallès Occidental;08205;Sant Cugat del Vallès;1;3;1;;308;226;82;0;2;224;226
8;Barcelona;40;Vallès Occidental;08205;Sant Cugat del Vallès;1;4;1;;1136;811;325;9;4;798;802
8;Barcelona;40;Vallès Occidental;08205;Sant Cugat del Vallès;1;4;2;;1133;758;375;3;2;753;755
8;Barcelona;40;Vallès Occidental;08205;Sant Cugat del Vallès;1;5;1;;428;180;248;2;0;178;178
8;Barcelona;40;Vallès Occidental;08205;Sant Cugat del Vallès;1;6;1;;733;481;252;8;2;471;473
8;Barcelona;40;Vallès Occidental;08205;Sant Cugat del Vallès;1;6;2;;727;496;231;2;0;494;494
8;Barcelona;40;Vallès Occidental;08205;Sant Cugat del Vallès;1;7;1;;889;597;292;0;1;596;597
8;Barcelona;40;Vallès Occidental;08205;Sant Cugat del Vallès;1;7;2;;820;531;289;1;2;528;530
8;Barcelona;40;Vallès Occidental;08205;Sant Cugat del Vallès;1;7;3;;830;521;309;0;0;521;521
8;Barcelona;40;Vallès Occidental;08205;Sant Cugat del Vallès;2;1;1;;763;576;187;0;3;573;576
8;Barcelona;40;Vallès Occidental;08205;Sant Cugat del Vallès;2;2;1;;678;484;194;6;1;477;478
8;Barcelona;40;Vallès Occidental;08205;Sant Cugat del Vallès;2;2;2;;684;483;201;1;3;479;482
8;Barcelona;40;Vallès Occidental;08205;Sant Cugat del Vallès;2;2;3;;665;461;204;1;3;457;460
8;Barcelona;40;Vallès Occidental;08205;Sant Cugat del Vallès;2;3;1;;878;617;261;1;1;615;616
8;Barcelona;40;Vallès Occidental;08205;Sant Cugat del Vallès;2;3;2;;865;627;238;1;3;623;626
8;Barcelona;40;Vallès Occidental;08205;Sant Cugat del Vallès;2;4;1;;634;467;167;0;5;462;467
8;Barcelona;40;Vallès Occidental;08205;Sant Cugat del Vallès;2;4;2;;627;477;150;2;3;472;475
8;Barcelona;40;Vallès Occidental;08205;Sant Cugat del Vallès;3;1;1;;820;492;328;0;1;491;492
8;Barcelona;40;Vallès Occidental;08205;Sant Cugat del Vallès;3;2;1;;1319;828;491;0;3;825;828
8;Barcelona;40;Vallès Occidental;08205;Sant Cugat del Vallès;4;1;1;;797;462;335;0;2;460;462
8;Barcelona;40;Vallès Occidental;08205;Sant Cugat del Vallès;4;2;1;;682;438;244;0;1;437;438
8;Barcelona;40;Vallès Occidental;08205;Sant Cugat del Vallès;4;3;1;;729;430;299;0;0;430;430
8;Barcelona;40;Vallès Occidental;08205;Sant Cugat del Vallès;4;4;1;;726;348;378;2;0;346;346
8;Barcelona;40;Vallès Occidental;08205;Sant Cugat del Vallès;5;1;1;;708;430;278;1;1;428;429
8;Barcelona;40;Vallès Occidental;08205;Sant Cugat del Vallès;5;2;1;;711;479;232;3;4;472;476
8;Barcelona;3;Alt Penedès;08206;Sant Cugat Sesgarrigues;1;1;1;;517;409;108;0;0;409;409
25;Lleida;25;Pallars Jussà;25196;Sant Esteve de la Sarga;1;1;1;;196;34;162;0;0;34;34
8;Barcelona;41;Vallès Oriental;08207;Sant Esteve de Palautordera;1;1;1;;754;609;145;1;8;600;608
8;Barcelona;11;Baix Llobregat;08208;Sant Esteve Sesrovires;1;1;1;;1126;798;328;1;0;797;797
17;Girona;34;Selva;17159;Sant Feliu de Buixalleu;1;1;1;;492;328;164;1;1;326;327
8;Barcelona;41;Vallès Oriental;08210;Sant Feliu de Codines;1;1;1;;478;369;109;5;3;361;364
8;Barcelona;41;Vallès Oriental;08210;Sant Feliu de Codines;1;2;1;;691;552;139;2;1;549;550
8;Barcelona;41;Vallès Oriental;08210;Sant Feliu de Codines;2;1;1;;667;474;193;1;3;470;473
8;Barcelona;41;Vallès Oriental;08210;Sant Feliu de Codines;2;2;1;;677;506;171;1;0;505;505
17;Girona;10;Baix Empordà;17160;Sant Feliu de Guíxols;1;1;1;;622;385;237;1;2;382;384
17;Girona;10;Baix Empordà;17160;Sant Feliu de Guíxols;1;1;2;;542;385;157;7;1;377;378
17;Girona;10;Baix Empordà;17160;Sant Feliu de Guíxols;1;2;1;;577;390;187;3;2;385;387
17;Girona;10;Baix Empordà;17160;Sant Feliu de Guíxols;1;2;2;;565;402;163;0;1;401;402
17;Girona;10;Baix Empordà;17160;Sant Feliu de Guíxols;2;1;1;;570;399;171;4;0;395;395
17;Girona;10;Baix Empordà;17160;Sant Feliu de Guíxols;2;1;2;;563;403;160;0;2;401;403
17;Girona;10;Baix Empordà;17160;Sant Feliu de Guíxols;2;2;1;;862;575;287;3;4;568;572
17;Girona;10;Baix Empordà;17160;Sant Feliu de Guíxols;2;2;2;;832;584;248;1;2;581;583
17;Girona;10;Baix Empordà;17160;Sant Feliu de Guíxols;2;3;1;;1138;711;427;2;2;707;709
17;Girona;10;Baix Empordà;17160;Sant Feliu de Guíxols;2;3;2;;1247;794;453;3;6;785;791
17;Girona;10;Baix Empordà;17160;Sant Feliu de Guíxols;3;1;1;;719;512;207;0;0;512;512
17;Girona;10;Baix Empordà;17160;Sant Feliu de Guíxols;3;1;2;;704;482;222;0;2;480;482
17;Girona;10;Baix Empordà;17160;Sant Feliu de Guíxols;3;2;1;;840;563;277;3;3;557;560
17;Girona;10;Baix Empordà;17160;Sant Feliu de Guíxols;3;2;2;;872;592;280;1;3;588;591
17;Girona;10;Baix Empordà;17160;Sant Feliu de Guíxols;4;1;1;;497;326;171;1;2;323;325
17;Girona;10;Baix Empordà;17160;Sant Feliu de Guíxols;4;2;1;;477;356;121;0;0;356;356
8;Barcelona;11;Baix Llobregat;08211;Sant Feliu de Llobregat;1;1;1;;911;556;355;0;1;555;556
8;Barcelona;11;Baix Llobregat;08211;Sant Feliu de Llobregat;1;1;2;;750;519;231;3;0;516;516
8;Barcelona;11;Baix Llobregat;08211;Sant Feliu de Llobregat;1;2;1;;1330;795;535;2;6;787;793
8;Barcelona;11;Baix Llobregat;08211;Sant Feliu de Llobregat;1;3;1;;1125;519;606;5;1;513;514
8;Barcelona;11;Baix Llobregat;08211;Sant Feliu de Llobregat;1;3;2;;1130;518;612;9;0;509;509
8;Barcelona;11;Baix Llobregat;08211;Sant Feliu de Llobregat;2;1;1;;1033;654;379;1;0;653;653
8;Barcelona;11;Baix Llobregat;08211;Sant Feliu de Llobregat;2;1;2;;988;633;355;0;0;633;633
8;Barcelona;11;Baix Llobregat;08211;Sant Feliu de Llobregat;2;2;1;;1144;597;547;2;2;593;595
8;Barcelona;11;Baix Llobregat;08211;Sant Feliu de Llobregat;2;2;2;;1055;549;506;3;3;543;546
8;Barcelona;11;Baix Llobregat;08211;Sant Feliu de Llobregat;2;3;1;;650;336;314;0;0;336;336
8;Barcelona;11;Baix Llobregat;08211;Sant Feliu de Llobregat;2;3;2;;567;322;245;0;2;320;322
8;Barcelona;11;Baix Llobregat;08211;Sant Feliu de Llobregat;2;4;1;;1112;575;537;1;0;574;574
8;Barcelona;11;Baix Llobregat;08211;Sant Feliu de Llobregat;2;4;2;;1036;478;558;1;0;477;477
8;Barcelona;11;Baix Llobregat;08211;Sant Feliu de Llobregat;3;1;1;;1131;689;442;1;7;681;688
8;Barcelona;11;Baix Llobregat;08211;Sant Feliu de Llobregat;3;1;2;;1059;615;444;4;4;607;611
8;Barcelona;11;Baix Llobregat;08211;Sant Feliu de Llobregat;3;2;1;;896;531;365;1;3;527;530
8;Barcelona;11;Baix Llobregat;08211;Sant Feliu de Llobregat;3;2;2;;899;566;333;3;1;562;563
8;Barcelona;11;Baix Llobregat;08211;Sant Feliu de Llobregat;3;3;1;;1046;613;433;2;3;608;611
8;Barcelona;11;Baix Llobregat;08211;Sant Feliu de Llobregat;3;3;2;;596;370;226;2;1;367;368
8;Barcelona;11;Baix Llobregat;08211;Sant Feliu de Llobregat;3;3;3;;753;486;267;1;3;482;485
8;Barcelona;11;Baix Llobregat;08211;Sant Feliu de Llobregat;4;1;1;;969;481;488;1;2;478;480
8;Barcelona;11;Baix Llobregat;08211;Sant Feliu de Llobregat;4;1;2;;896;432;464;1;0;431;431
8;Barcelona;11;Baix Llobregat;08211;Sant Feliu de Llobregat;4;2;1;;577;353;224;1;1;351;352
8;Barcelona;11;Baix Llobregat;08211;Sant Feliu de Llobregat;4;2;2;;593;370;223;0;4;366;370
8;Barcelona;11;Baix Llobregat;08211;Sant Feliu de Llobregat;4;3;1;;972;513;459;0;2;511;513
8;Barcelona;11;Baix Llobregat;08211;Sant Feliu de Llobregat;4;4;1;;652;325;327;0;4;321;325
8;Barcelona;11;Baix Llobregat;08211;Sant Feliu de Llobregat;4;4;2;;645;302;343;0;6;296;302
8;Barcelona;11;Baix Llobregat;08211;Sant Feliu de Llobregat;5;1;1;;1072;569;503;0;8;561;569
8;Barcelona;11;Baix Llobregat;08211;Sant Feliu de Llobregat;5;2;1;;865;425;440;0;2;423;425
8;Barcelona;11;Baix Llobregat;08211;Sant Feliu de Llobregat;6;1;1;;901;487;414;0;3;484;487
8;Barcelona;11;Baix Llobregat;08211;Sant Feliu de Llobregat;6;1;2;;875;477;398;0;2;475;477
8;Barcelona;11;Baix Llobregat;08211;Sant Feliu de Llobregat;6;2;1;;732;462;270;1;5;456;461
8;Barcelona;11;Baix Llobregat;08211;Sant Feliu de Llobregat;6;3;1;;733;437;296;0;1;436;437
17;Girona;19;Garrotxa;17161;Sant Feliu de Pallerols;1;1;1;;511;388;123;1;2;385;387
17;Girona;19;Garrotxa;17161;Sant Feliu de Pallerols;1;2;1;;418;283;135;0;1;282;283
8;Barcelona;7;Bages;08212;Sant Feliu Sasserra;1;1;1;;506;374;132;2;7;365;372
17;Girona;19;Garrotxa;17162;Sant Ferriol;1;1;1;;156;108;48;0;0;108;108
8;Barcelona;41;Vallès Oriental;08209;Sant Fost de Campsentelles;1;1;1;;711;536;175;7;2;527;529
8;Barcelona;41;Vallès Oriental;08209;Sant Fost de Campsentelles;1;1;2;;733;505;228;0;3;502;505
8;Barcelona;41;Vallès Oriental;08209;Sant Fost de Campsentelles;1;1;3;;827;564;263;1;2;561;563
8;Barcelona;7;Bages;08213;Sant Fruitós de Bages;1;1;1;;1364;1016;348;7;7;1002;1009
8;Barcelona;7;Bages;08213;Sant Fruitós de Bages;1;2;1;;1615;1137;478;0;2;1135;1137
17;Girona;20;Gironès;17163;Sant Gregori;1;1;1;;1115;777;338;3;3;771;774
17;Girona;20;Gironès;17163;Sant Gregori;1;2;1;;176;107;69;1;1;105;106
25;Lleida;32;Segarra;25192;Sant Guim de Freixenet;1;1;1;;836;638;198;1;5;632;637
25;Lleida;32;Segarra;25197;Sant Guim de la Plana;1;1;1;;171;125;46;0;0;125;125
17;Girona;34;Selva;17164;Sant Hilari Sacalm;1;1;1;;778;509;269;3;0;506;506
17;Girona;34;Selva;17164;Sant Hilari Sacalm;1;1;2;;768;631;137;5;0;626;626
17;Girona;34;Selva;17164;Sant Hilari Sacalm;1;2;1;;821;512;309;0;2;510;512
17;Girona;34;Selva;17164;Sant Hilari Sacalm;1;2;2;;853;621;232;2;4;615;619
17;Girona;34;Selva;17164;Sant Hilari Sacalm;2;1;1;;97;48;49;1;0;47;47
8;Barcelona;24;Osona;08215;Sant Hipòlit de Voltregà;1;1;1;;904;688;216;4;5;679;684
8;Barcelona;24;Osona;08215;Sant Hipòlit de Voltregà;1;2;1;;1446;1149;297;5;11;1133;1144
8;Barcelona;21;Maresme;08193;Sant Iscle de Vallalta;1;1;1;;390;285;105;0;0;285;285
43;Tarragona;22;Montsià;43902;Sant Jaume d'Enveja;1;1;1;;701;398;303;4;4;390;394
43;Tarragona;22;Montsià;43902;Sant Jaume d'Enveja;1;2;1;;851;527;324;7;0;520;520
43;Tarragona;22;Montsià;43902;Sant Jaume d'Enveja;1;2;2;;629;371;258;1;2;368;370
43;Tarragona;22;Montsià;43902;Sant Jaume d'Enveja;1;3;1;;361;250;111;9;3;238;241
8;Barcelona;14;Berguedà;08216;Sant Jaume de Frontanyà;1;1;1;;14;12;2;1;0;11;11
17;Girona;19;Garrotxa;17165;Sant Jaume de Llierca;1;1;1;;672;492;180;7;6;479;485
43;Tarragona;12;Baix Penedès;43137;Sant Jaume dels Domenys;1;1;1;;841;576;265;5;3;568;571
17;Girona;31;Ripollès;17167;Sant Joan de les Abadesses;1;1;1;;505;379;126;1;2;376;378
17;Girona;31;Ripollès;17167;Sant Joan de les Abadesses;1;1;2;;474;367;107;0;0;367;367
17;Girona;31;Ripollès;17167;Sant Joan de les Abadesses;1;2;1;;678;554;124;4;3;547;550
17;Girona;31;Ripollès;17167;Sant Joan de les Abadesses;1;2;2;;692;562;130;9;3;550;553
17;Girona;31;Ripollès;17167;Sant Joan de les Abadesses;1;3;1;;534;414;120;0;7;407;414
17;Girona;31;Ripollès;17167;Sant Joan de les Abadesses;2;1;1;;440;322;118;4;1;317;318
17;Girona;20;Gironès;17168;Sant Joan de Mollet;1;1;1;;253;218;35;3;6;209;215
8;Barcelona;11;Baix Llobregat;08217;Sant Joan Despí;1;1;1;;489;314;175;1;2;311;313
8;Barcelona;11;Baix Llobregat;08217;Sant Joan Despí;1;2;1;;964;585;379;5;1;579;580
8;Barcelona;11;Baix Llobregat;08217;Sant Joan Despí;1;2;2;;939;569;370;4;4;561;565
8;Barcelona;11;Baix Llobregat;08217;Sant Joan Despí;1;3;1;;893;604;289;1;0;603;603
8;Barcelona;11;Baix Llobregat;08217;Sant Joan Despí;1;3;2;;850;597;253;2;0;595;595
8;Barcelona;11;Baix Llobregat;08217;Sant Joan Despí;1;4;1;;860;576;284;4;0;572;572
8;Barcelona;11;Baix Llobregat;08217;Sant Joan Despí;1;4;2;;494;316;178;2;0;314;314
8;Barcelona;11;Baix Llobregat;08217;Sant Joan Despí;1;4;3;;595;381;214;2;0;379;379
8;Barcelona;11;Baix Llobregat;08217;Sant Joan Despí;1;5;1;;669;451;218;1;3;447;450
8;Barcelona;11;Baix Llobregat;08217;Sant Joan Despí;1;5;2;;434;292;142;0;0;292;292
8;Barcelona;11;Baix Llobregat;08217;Sant Joan Despí;1;5;3;;553;353;200;0;0;353;353
8;Barcelona;11;Baix Llobregat;08217;Sant Joan Despí;2;1;1;;575;403;172;6;6;391;397
8;Barcelona;11;Baix Llobregat;08217;Sant Joan Despí;2;2;1;;519;353;166;0;2;351;353
8;Barcelona;11;Baix Llobregat;08217;Sant Joan Despí;2;2;2;;455;309;146;1;0;308;308
8;Barcelona;11;Baix Llobregat;08217;Sant Joan Despí;2;3;1;;721;449;272;0;1;448;449
8;Barcelona;11;Baix Llobregat;08217;Sant Joan Despí;2;4;1;;616;374;242;4;2;368;370
8;Barcelona;11;Baix Llobregat;08217;Sant Joan Despí;2;4;2;;615;405;210;1;0;404;404
8;Barcelona;11;Baix Llobregat;08217;Sant Joan Despí;3;1;1;;887;576;311;1;2;573;575
8;Barcelona;11;Baix Llobregat;08217;Sant Joan Despí;3;1;2;;547;370;177;3;0;367;367
8;Barcelona;11;Baix Llobregat;08217;Sant Joan Despí;3;1;3;;567;387;180;0;0;387;387
8;Barcelona;11;Baix Llobregat;08217;Sant Joan Despí;3;2;1;;702;480;222;0;1;479;480
8;Barcelona;11;Baix Llobregat;08217;Sant Joan Despí;3;2;2;;636;435;201;0;1;434;435
8;Barcelona;11;Baix Llobregat;08217;Sant Joan Despí;3;3;1;;713;523;190;0;1;522;523
8;Barcelona;11;Baix Llobregat;08217;Sant Joan Despí;3;3;2;;465;311;154;0;0;311;311
8;Barcelona;11;Baix Llobregat;08217;Sant Joan Despí;3;3;3;;532;364;168;1;1;362;363
8;Barcelona;11;Baix Llobregat;08217;Sant Joan Despí;3;4;1;;582;382;200;1;0;381;381
8;Barcelona;11;Baix Llobregat;08217;Sant Joan Despí;3;4;2;;528;332;196;1;1;330;331
8;Barcelona;7;Bages;08218;Sant Joan de Vilatorrada;1;1;1;;1052;748;304;7;0;741;741
8;Barcelona;7;Bages;08218;Sant Joan de Vilatorrada;1;1;2;;1329;936;393;3;6;927;933
8;Barcelona;7;Bages;08218;Sant Joan de Vilatorrada;1;2;1;;836;557;279;1;2;554;556
8;Barcelona;7;Bages;08218;Sant Joan de Vilatorrada;1;2;2;;1079;680;399;3;0;677;677
8;Barcelona;7;Bages;08218;Sant Joan de Vilatorrada;1;3;1;;1026;750;276;3;0;747;747
8;Barcelona;7;Bages;08218;Sant Joan de Vilatorrada;1;3;2;;242;191;51;3;0;188;188
17;Girona;19;Garrotxa;17185;Sant Joan les Fonts;1;1;1;;500;379;121;7;1;371;372
17;Girona;19;Garrotxa;17185;Sant Joan les Fonts;1;1;2;;493;379;114;3;2;374;376
17;Girona;19;Garrotxa;17185;Sant Joan les Fonts;1;2;1;;637;479;158;8;2;469;471
17;Girona;19;Garrotxa;17185;Sant Joan les Fonts;1;3;1;;478;367;111;2;7;358;365
17;Girona;19;Garrotxa;17185;Sant Joan les Fonts;1;4;1;;204;133;71;0;1;132;133
17;Girona;20;Gironès;17166;Sant Jordi Desvalls;1;1;1;;481;308;173;2;1;305;306
17;Girona;34;Selva;17903;Sant Julià del Llor i Bonmatí;1;1;1;;656;522;134;2;3;517;520
17;Girona;20;Gironès;17169;Sant Julià de Ramis;1;1;1;;1051;720;331;4;2;714;716
8;Barcelona;24;Osona;08220;Sant Julià de Vilatorta;1;1;1;;1201;916;285;5;6;905;911
8;Barcelona;11;Baix Llobregat;08221;Sant Just Desvern;1;1;1;;804;585;219;4;2;579;581
8;Barcelona;11;Baix Llobregat;08221;Sant Just Desvern;1;1;2;;707;503;204;0;1;502;503
8;Barcelona;11;Baix Llobregat;08221;Sant Just Desvern;1;2;1;;1003;674;329;1;3;670;673
8;Barcelona;11;Baix Llobregat;08221;Sant Just Desvern;1;3;1;;1051;711;340;1;4;706;710
8;Barcelona;11;Baix Llobregat;08221;Sant Just Desvern;1;3;2;;981;703;278;0;6;697;703
8;Barcelona;11;Baix Llobregat;08221;Sant Just Desvern;1;4;1;;1185;749;436;0;1;748;749
8;Barcelona;11;Baix Llobregat;08221;Sant Just Desvern;1;4;2;;1039;688;351;4;2;682;684
8;Barcelona;11;Baix Llobregat;08221;Sant Just Desvern;1;5;1;;709;463;246;3;1;459;460
8;Barcelona;11;Baix Llobregat;08221;Sant Just Desvern;1;5;2;;680;436;244;0;3;433;436
8;Barcelona;3;Alt Penedès;08222;Sant Llorenç d'Hortons;1;1;1;;763;539;224;1;0;538;538
17;Girona;2;Alt Empordà;17171;Sant Llorenç de la Muga;1;1;1;;148;108;40;2;0;106;106
25;Lleida;35;Solsonès;25193;Sant Llorenç de Morunys;1;1;1;;684;562;122;2;3;557;560
8;Barcelona;40;Vallès Occidental;08223;Sant Llorenç Savall;1;1;1;;733;532;201;14;3;515;518
8;Barcelona;40;Vallès Occidental;08223;Sant Llorenç Savall;1;1;2;;716;523;193;13;0;510;510
8;Barcelona;24;Osona;08225;Sant Martí d'Albars;1;1;1;;116;83;33;0;0;83;83
8;Barcelona;24;Osona;08224;Sant Martí de Centelles;1;1;1;;554;416;138;4;0;412;412
17;Girona;20;Gironès;17172;Sant Martí de Llémena;1;1;1;;278;170;108;0;3;167;170
25;Lleida;38;Urgell;25902;Sant Martí de Riucorb;1;1;1;;733;480;253;1;2;477;479
8;Barcelona;6;Anoia;08226;Sant Martí de Tous;1;1;1;;780;619;161;2;0;617;617
8;Barcelona;3;Alt Penedès;08227;Sant Martí Sarroca;1;1;1;;590;375;215;1;1;373;374
8;Barcelona;3;Alt Penedès;08227;Sant Martí Sarroca;1;1;2;;635;416;219;3;0;413;413
8;Barcelona;3;Alt Penedès;08227;Sant Martí Sarroca;1;2;1;;551;369;182;1;0;368;368
8;Barcelona;6;Anoia;08228;Sant Martí Sesgueioles;1;1;1;;318;262;56;0;0;262;262
17;Girona;20;Gironès;17173;Sant Martí Vell;1;1;1;;167;124;43;0;1;123;124
8;Barcelona;7;Bages;08229;Sant Mateu de Bages;1;1;1;;151;117;34;1;0;116;116
8;Barcelona;7;Bages;08229;Sant Mateu de Bages;1;1;2;;351;282;69;1;0;281;281
17;Girona;28;Pla de l'Estany;17174;Sant Miquel de Campmajor;1;1;1;;192;139;53;0;0;139;139
17;Girona;2;Alt Empordà;17175;Sant Miquel de Fluvià;1;1;1;;370;242;128;2;1;239;240
17;Girona;2;Alt Empordà;17176;Sant Mori;1;1;1;;108;76;32;1;0;75;75
17;Girona;31;Ripollès;17177;Sant Pau de Segúries;1;1;1;;476;398;78;2;4;392;396
8;Barcelona;7;Bages;08192;Santpedor;1;1;1;;1699;1180;519;10;7;1163;1170
8;Barcelona;7;Bages;08192;Santpedor;1;2;1;;1101;820;281;6;2;812;814
8;Barcelona;17;Garraf;08231;Sant Pere de Ribes;1;1;1;;1739;1148;591;8;5;1135;1140
8;Barcelona;17;Garraf;08231;Sant Pere de Ribes;1;1;2;;899;576;323;4;4;568;572
8;Barcelona;17;Garraf;08231;Sant Pere de Ribes;1;2;1;;1925;1069;856;29;5;1035;1040
8;Barcelona;17;Garraf;08231;Sant Pere de Ribes;1;3;1;;1551;824;727;3;4;817;821
8;Barcelona;17;Garraf;08231;Sant Pere de Ribes;1;3;2;;782;391;391;0;1;390;391
8;Barcelona;17;Garraf;08231;Sant Pere de Ribes;1;4;1;;610;287;323;0;0;287;287
8;Barcelona;3;Alt Penedès;08232;Sant Pere de Riudebitlles;1;1;1;;787;597;190;0;2;595;597
8;Barcelona;3;Alt Penedès;08232;Sant Pere de Riudebitlles;1;2;2;;808;604;204;5;2;597;599
8;Barcelona;24;Osona;08233;Sant Pere de Torelló;1;1;1;;695;574;121;0;2;572;574
8;Barcelona;24;Osona;08233;Sant Pere de Torelló;1;2;1;;855;651;204;3;1;647;648
8;Barcelona;41;Vallès Oriental;08234;Sant Pere de Vilamajor;1;1;1;;575;417;158;0;3;414;417
17;Girona;2;Alt Empordà;17178;Sant Pere Pescador;1;1;1;;839;659;180;3;1;655;656
8;Barcelona;6;Anoia;08189;Sant Pere Sallavinera;1;1;1;;153;135;18;0;1;134;135
8;Barcelona;21;Maresme;08235;Sant Pol de Mar;1;1;1;;480;361;119;1;1;359;360
8;Barcelona;21;Maresme;08235;Sant Pol de Mar;1;2;1;;1244;1008;236;1;6;1001;1007
8;Barcelona;3;Alt Penedès;08236;Sant Quintí de Mediona;1;1;1;;1168;842;326;3;4;835;839
8;Barcelona;24;Osona;08237;Sant Quirze de Besora;1;1;1;;985;773;212;3;0;770;770
8;Barcelona;24;Osona;08237;Sant Quirze de Besora;1;2;1;;666;522;144;1;1;520;521
8;Barcelona;40;Vallès Occidental;08238;Sant Quirze del Vallès;1;1;1;;1561;1033;528;0;0;1033;1033
8;Barcelona;40;Vallès Occidental;08238;Sant Quirze del Vallès;1;2;1;;1583;1022;561;2;6;1014;1020
8;Barcelona;40;Vallès Occidental;08238;Sant Quirze del Vallès;1;3;1;;756;505;251;3;1;501;502
8;Barcelona;;;08239;Sant Quirze Safaja;1;1;1;;203;141;62;2;1;138;139
25;Lleida;32;Segarra;25194;Sant Ramon;1;1;1;;524;367;157;0;2;365;367
8;Barcelona;3;Alt Penedès;08240;Sant Sadurní d'Anoia;1;1;1;;854;658;196;1;4;653;657
8;Barcelona;3;Alt Penedès;08240;Sant Sadurní d'Anoia;1;1;2;;858;681;177;1;4;676;680
8;Barcelona;3;Alt Penedès;08240;Sant Sadurní d'Anoia;1;2;1;;886;682;204;0;4;678;682
8;Barcelona;3;Alt Penedès;08240;Sant Sadurní d'Anoia;1;2;2;;856;662;194;3;1;658;659
8;Barcelona;3;Alt Penedès;08240;Sant Sadurní d'Anoia;1;3;1;;599;497;102;0;2;495;497
8;Barcelona;3;Alt Penedès;08240;Sant Sadurní d'Anoia;2;1;1;;1037;820;217;5;0;815;815
8;Barcelona;3;Alt Penedès;08240;Sant Sadurní d'Anoia;2;1;2;;1125;880;245;3;0;877;877
8;Barcelona;3;Alt Penedès;08240;Sant Sadurní d'Anoia;3;1;1;;329;254;75;0;3;251;254
8;Barcelona;24;Osona;08241;Sant Sadurní d'Osormort;1;1;1;;60;58;2;0;1;57;58
8;Barcelona;7;Bages;08098;Sant Salvador de Guardiola;1;1;1;;574;377;197;0;0;377;377
8;Barcelona;7;Bages;08262;Sant Vicenç de Castellet;1;1;1;;973;674;299;1;3;670;673
8;Barcelona;7;Bages;08262;Sant Vicenç de Castellet;1;1;2;;1247;882;365;0;7;875;882
8;Barcelona;7;Bages;08262;Sant Vicenç de Castellet;1;2;1;;1131;860;271;2;7;851;858
8;Barcelona;7;Bages;08262;Sant Vicenç de Castellet;2;1;1;;1347;925;422;2;4;919;923
8;Barcelona;7;Bages;08262;Sant Vicenç de Castellet;2;2;1;;1213;904;309;0;1;903;904
8;Barcelona;11;Baix Llobregat;08263;Sant Vicenç dels Horts;1;1;1;;713;429;284;0;3;426;429
8;Barcelona;11;Baix Llobregat;08263;Sant Vicenç dels Horts;1;1;2;;705;469;236;0;3;466;469
8;Barcelona;11;Baix Llobregat;08263;Sant Vicenç dels Horts;1;2;1;;436;383;53;0;1;382;383
8;Barcelona;11;Baix Llobregat;08263;Sant Vicenç dels Horts;1;2;2;;569;398;171;1;0;397;397
8;Barcelona;11;Baix Llobregat;08263;Sant Vicenç dels Horts;1;3;1;;835;569;266;8;0;561;561
8;Barcelona;11;Baix Llobregat;08263;Sant Vicenç dels Horts;1;3;2;;737;524;213;2;0;522;522
8;Barcelona;11;Baix Llobregat;08263;Sant Vicenç dels Horts;1;4;1;;932;651;281;0;2;649;651
8;Barcelona;11;Baix Llobregat;08263;Sant Vicenç dels Horts;1;5;1;;732;496;236;2;2;492;494
8;Barcelona;11;Baix Llobregat;08263;Sant Vicenç dels Horts;1;5;2;;695;481;214;0;1;480;481
8;Barcelona;11;Baix Llobregat;08263;Sant Vicenç dels Horts;1;6;1;;685;425;260;0;2;423;425
8;Barcelona;11;Baix Llobregat;08263;Sant Vicenç dels Horts;1;6;2;;621;421;200;1;1;419;420
8;Barcelona;11;Baix Llobregat;08263;Sant Vicenç dels Horts;1;7;1;;812;557;255;0;0;557;557
8;Barcelona;11;Baix Llobregat;08263;Sant Vicenç dels Horts;2;1;1;;741;411;330;3;3;405;408
8;Barcelona;11;Baix Llobregat;08263;Sant Vicenç dels Horts;2;2;1;;991;631;360;0;1;630;631
8;Barcelona;11;Baix Llobregat;08263;Sant Vicenç dels Horts;2;3;1;;508;342;166;1;1;340;341
8;Barcelona;11;Baix Llobregat;08263;Sant Vicenç dels Horts;3;1;1;;580;351;229;0;0;351;351
8;Barcelona;11;Baix Llobregat;08263;Sant Vicenç dels Horts;3;1;2;;536;352;184;2;0;350;350
8;Barcelona;11;Baix Llobregat;08263;Sant Vicenç dels Horts;3;2;1;;259;129;130;0;1;128;129
8;Barcelona;11;Baix Llobregat;08263;Sant Vicenç dels Horts;3;3;1;;717;421;296;1;1;419;420
8;Barcelona;11;Baix Llobregat;08263;Sant Vicenç dels Horts;4;1;1;;498;297;201;2;3;292;295
8;Barcelona;21;Maresme;08264;Sant Vicenç de Montalt;1;1;1;;1014;714;300;2;2;710;712
8;Barcelona;24;Osona;08265;Sant Vicenç de Torelló;1;1;1;;912;657;255;0;0;657;657
8;Barcelona;24;Osona;08265;Sant Vicenç de Torelló;1;2;1;;577;425;152;2;1;422;423
43;Tarragona;16;Conca de Barberà;43142;Sarral;1;1;1;;1092;683;409;13;1;669;670
17;Girona;20;Gironès;17186;Sarrià de Ter;1;1;1;;780;580;200;2;2;576;578
17;Girona;20;Gironès;17186;Sarrià de Ter;1;1;2;;826;617;209;3;2;612;614
17;Girona;20;Gironès;17186;Sarrià de Ter;1;2;1;;537;380;157;3;2;375;377
17;Girona;20;Gironès;17186;Sarrià de Ter;1;2;2;;546;382;164;4;1;377;378
25;Lleida;25;Pallars Jussà;25201;Sarroca de Bellera;1;1;1;;141;72;69;0;0;72;72
25;Lleida;33;Segrià;25200;Sarroca de Lleida;1;1;1;;448;305;143;1;2;302;304
17;Girona;2;Alt Empordà;17187;Saus, Camallera i Llampaies;1;1;1;;610;417;193;2;0;415;415
43;Tarragona;16;Conca de Barberà;43143;Savallà del Comtat;1;1;1;;52;44;8;0;0;44;44
43;Tarragona;36;Tarragonès;43144;Secuita, la;1;1;1;;607;431;176;0;0;431;431
43;Tarragona;8;Baix Camp;43145;Selva del Camp, la;1;1;1;;851;608;243;4;3;601;604
43;Tarragona;8;Baix Camp;43145;Selva del Camp, la;2;1;1;;1661;1224;437;4;4;1216;1220
17;Girona;2;Alt Empordà;17188;Selva de Mar, la;1;1;1;;134;111;23;0;0;111;111
43;Tarragona;16;Conca de Barberà;43146;Senan;1;1;1;;29;19;10;0;0;19;19
43;Tarragona;22;Montsià;43044;Sénia, la;1;1;1;;784;476;308;8;6;462;468
43;Tarragona;22;Montsià;43044;Sénia, la;1;1;2;;738;445;293;3;3;439;442
43;Tarragona;22;Montsià;43044;Sénia, la;2;1;1;;727;479;248;8;0;471;471
43;Tarragona;22;Montsià;43044;Sénia, la;2;1;2;;629;411;218;3;1;407;408
43;Tarragona;22;Montsià;43044;Sénia, la;2;2;1;;659;406;253;1;12;393;405
25;Lleida;25;Pallars Jussà;25202;Senterada;1;1;1;;118;73;45;0;0;73;73
25;Lleida;23;Noguera;25035;Sentiu de Sió, la;1;1;1;;430;324;106;1;2;321;323
8;Barcelona;40;Vallès Occidental;08267;Sentmenat;1;1;1;;781;550;231;3;1;546;547
8;Barcelona;40;Vallès Occidental;08267;Sentmenat;1;1;2;;767;545;222;2;5;538;543
8;Barcelona;40;Vallès Occidental;08267;Sentmenat;1;2;1;;639;469;170;6;1;462;463
8;Barcelona;40;Vallès Occidental;08267;Sentmenat;1;2;2;;709;554;155;4;4;546;550
17;Girona;28;Pla de l'Estany;17190;Serinyà;1;1;1;;553;417;136;4;12;401;413
25;Lleida;33;Segrià;25204;Seròs;1;1;1;;648;439;209;0;4;435;439
25;Lleida;33;Segrià;25204;Seròs;1;2;1;;918;627;291;4;8;615;623
17;Girona;10;Baix Empordà;17191;Serra de Daró;1;1;1;;177;140;37;1;0;139;139
17;Girona;31;Ripollès;17192;Setcases;1;1;1;;123;104;19;0;1;103;104
25;Lleida;4;Alt Urgell;25203;Seu d'Urgell, la;1;1;1;;1138;751;387;6;3;742;745
25;Lleida;4;Alt Urgell;25203;Seu d'Urgell, la;1;2;1;;640;380;260;0;1;379;380
25;Lleida;4;Alt Urgell;25203;Seu d'Urgell, la;1;2;2;;577;420;157;0;2;418;420
25;Lleida;4;Alt Urgell;25203;Seu d'Urgell, la;1;3;1;;846;451;395;0;2;449;451
25;Lleida;4;Alt Urgell;25203;Seu d'Urgell, la;1;4;1;;1210;819;391;2;2;815;817
25;Lleida;4;Alt Urgell;25203;Seu d'Urgell, la;1;5;1;;977;605;372;0;5;600;605
25;Lleida;4;Alt Urgell;25203;Seu d'Urgell, la;1;5;2;;903;635;268;0;1;634;635
25;Lleida;4;Alt Urgell;25203;Seu d'Urgell, la;1;6;1;;860;549;311;3;5;541;546
25;Lleida;4;Alt Urgell;25203;Seu d'Urgell, la;1;7;1;;996;559;437;10;0;549;549
8;Barcelona;24;Osona;08269;Seva;1;1;1;;618;522;96;2;2;518;520
8;Barcelona;24;Osona;08269;Seva;1;2;1;;562;440;122;0;4;436;440
25;Lleida;27;Pla d'Urgell;25205;Sidamon;1;1;1;;359;267;92;0;3;264;267
17;Girona;34;Selva;17193;Sils;1;1;1;;1436;955;481;14;1;940;941
8;Barcelona;17;Garraf;08270;Sitges;1;1;1;;903;608;295;1;0;607;607
8;Barcelona;17;Garraf;08270;Sitges;1;2;1;;799;549;250;2;0;547;547
8;Barcelona;17;Garraf;08270;Sitges;1;2;2;;757;536;221;3;2;531;533
8;Barcelona;17;Garraf;08270;Sitges;1;3;1;;384;230;154;0;2;228;230
8;Barcelona;17;Garraf;08270;Sitges;1;4;1;;182;123;59;0;1;122;123
8;Barcelona;17;Garraf;08270;Sitges;2;1;1;;612;433;179;1;4;428;432
8;Barcelona;17;Garraf;08270;Sitges;2;1;2;;709;520;189;1;2;517;519
8;Barcelona;17;Garraf;08270;Sitges;2;2;1;;985;618;367;16;4;598;602
8;Barcelona;17;Garraf;08270;Sitges;2;2;2;;936;608;328;12;2;594;596
8;Barcelona;17;Garraf;08270;Sitges;2;3;1;;648;439;209;2;2;435;437
8;Barcelona;17;Garraf;08270;Sitges;2;3;2;;692;463;229;1;2;460;462
8;Barcelona;17;Garraf;08270;Sitges;2;4;1;;695;458;237;3;0;455;455
8;Barcelona;17;Garraf;08270;Sitges;2;4;2;;765;495;270;5;0;490;490
8;Barcelona;17;Garraf;08270;Sitges;3;1;1;;62;36;26;0;0;36;36
8;Barcelona;17;Garraf;08270;Sitges;3;2;1;;148;104;44;0;4;100;104
8;Barcelona;17;Garraf;08270;Sitges;3;3;1;;91;50;41;0;0;50;50
17;Girona;2;Alt Empordà;17052;Siurana;1;1;1;;149;89;60;1;1;87;88
8;Barcelona;24;Osona;08271;Sobremunt;1;1;1;;54;39;15;0;0;39;39
25;Lleida;18;Garrigues;25206;Soleràs, el;1;1;1;;444;285;159;0;1;284;285
43;Tarragona;16;Conca de Barberà;43147;Solivella;1;1;1;;660;460;200;2;4;454;458
25;Lleida;35;Solsonès;25207;Solsona;1;1;1;;1359;1004;355;2;4;998;1002
25;Lleida;35;Solsonès;25207;Solsona;1;2;1;;783;554;229;0;4;550;554
25;Lleida;35;Solsonès;25207;Solsona;1;2;2;;767;518;249;11;0;507;507
25;Lleida;35;Solsonès;25207;Solsona;2;1;1;;940;656;284;9;2;645;647
25;Lleida;35;Solsonès;25207;Solsona;2;2;1;;1033;758;275;15;0;743;743
8;Barcelona;24;Osona;08272;Sora;1;1;1;;204;146;58;1;1;144;145
25;Lleida;26;Pallars Sobirà;25208;Soriguera;1;1;1;;250;128;122;2;0;126;126
25;Lleida;26;Pallars Sobirà;25209;Sort;1;1;1;;1180;798;382;8;3;787;790
25;Lleida;26;Pallars Sobirà;25209;Sort;1;2;1;;121;68;53;0;0;68;68
25;Lleida;33;Segrià;25210;Soses;1;1;1;;1156;772;384;2;5;765;770
8;Barcelona;3;Alt Penedès;08273;Subirats;1;1;1;;579;416;163;2;0;414;414
8;Barcelona;3;Alt Penedès;08273;Subirats;1;2;1;;347;280;67;9;0;271;271
8;Barcelona;3;Alt Penedès;08273;Subirats;1;3;1;;266;173;93;0;1;172;173
8;Barcelona;3;Alt Penedès;08273;Subirats;1;4;1;;578;452;126;4;4;444;448
25;Lleida;33;Segrià;25211;Sudanell;1;1;1;;645;358;287;1;1;356;357
25;Lleida;33;Segrià;25212;Sunyer;1;1;1;;248;180;68;0;1;179;180
8;Barcelona;7;Bages;08274;Súria;1;1;1;;1669;1321;348;0;2;1319;1321
8;Barcelona;7;Bages;08274;Súria;1;2;1;;1159;917;242;1;1;915;916
8;Barcelona;7;Bages;08274;Súria;1;4;1;;1345;1003;342;3;10;990;1000
8;Barcelona;7;Bages;08274;Súria;1;5;1;;1148;902;246;1;2;899;901
17;Girona;34;Selva;17194;Susqueda;1;1;1;;121;78;43;0;0;78;78
8;Barcelona;41;Vallès Oriental;08276;Tagamanent;1;1;1;;107;84;23;0;0;84;84
8;Barcelona;7;Bages;08277;Talamanca;1;1;1;;59;50;9;0;0;50;50
25;Lleida;25;Pallars Jussà;25215;Talarn;1;1;1;;340;197;143;1;1;195;196
25;Lleida;32;Segarra;25216;Talavera;1;1;1;;286;192;94;0;0;192;192
17;Girona;10;Baix Empordà;17195;Tallada d'Empordà, la;1;1;1;;312;191;121;2;1;188;189
8;Barcelona;24;Osona;08278;Taradell;1;1;1;;1414;1113;301;4;4;1105;1109
8;Barcelona;24;Osona;08278;Taradell;1;2;1;;1669;1299;370;1;5;1293;1298
43;Tarragona;36;Tarragonès;43148;Tarragona;1;1;1;;812;519;293;0;1;518;519
43;Tarragona;36;Tarragonès;43148;Tarragona;1;2;1;;486;310;176;1;1;308;309
43;Tarragona;36;Tarragonès;43148;Tarragona;1;3;1;;314;180;134;1;4;175;179
43;Tarragona;36;Tarragonès;43148;Tarragona;1;4;1;;495;302;193;3;1;298;299
43;Tarragona;36;Tarragonès;43148;Tarragona;2;1;1;;730;438;292;7;0;431;431
43;Tarragona;36;Tarragonès;43148;Tarragona;2;2;1;;886;551;335;23;3;525;528
43;Tarragona;36;Tarragonès;43148;Tarragona;3;1;1;;638;439;199;4;3;432;435
43;Tarragona;36;Tarragonès;43148;Tarragona;3;2;1;;721;456;265;3;3;450;453
43;Tarragona;36;Tarragonès;43148;Tarragona;3;3;1;;610;398;212;0;3;395;398
43;Tarragona;36;Tarragonès;43148;Tarragona;3;4;1;;884;587;297;0;0;587;587
43;Tarragona;36;Tarragonès;43148;Tarragona;4;1;1;;711;536;175;2;10;524;534
43;Tarragona;36;Tarragonès;43148;Tarragona;4;10;1;;735;491;244;4;4;483;487
43;Tarragona;36;Tarragonès;43148;Tarragona;4;10;2;;722;497;225;2;1;494;495
43;Tarragona;36;Tarragonès;43148;Tarragona;4;11;1;;789;532;257;4;4;524;528
43;Tarragona;36;Tarragonès;43148;Tarragona;4;12;1;;857;645;212;0;6;639;645
43;Tarragona;36;Tarragonès;43148;Tarragona;4;13;1;;435;264;171;0;5;259;264
43;Tarragona;36;Tarragonès;43148;Tarragona;4;14;1;;612;366;246;2;1;363;364
43;Tarragona;36;Tarragonès;43148;Tarragona;4;15;1;;656;399;257;3;2;394;396
43;Tarragona;36;Tarragonès;43148;Tarragona;4;15;2;;677;442;235;5;5;432;437
43;Tarragona;36;Tarragonès;43148;Tarragona;4;16;1;;633;428;205;2;3;423;426
43;Tarragona;36;Tarragonès;43148;Tarragona;4;2;1;;906;657;249;8;0;649;649
43;Tarragona;36;Tarragonès;43148;Tarragona;4;3;1;;448;314;134;1;3;310;313
43;Tarragona;36;Tarragonès;43148;Tarragona;4;3;2;;465;327;138;2;1;324;325
43;Tarragona;36;Tarragonès;43148;Tarragona;4;4;1;;672;465;207;0;2;463;465
43;Tarragona;36;Tarragonès;43148;Tarragona;4;4;2;;601;454;147;4;0;450;450
43;Tarragona;36;Tarragonès;43148;Tarragona;4;5;1;;820;538;282;0;4;534;538
43;Tarragona;36;Tarragonès;43148;Tarragona;4;6;1;;509;357;152;2;1;354;355
43;Tarragona;36;Tarragonès;43148;Tarragona;4;6;2;;479;369;110;2;4;363;367
43;Tarragona;36;Tarragonès;43148;Tarragona;4;7;1;;794;583;211;0;4;579;583
43;Tarragona;36;Tarragonès;43148;Tarragona;4;8;1;;822;529;293;3;2;524;526
43;Tarragona;36;Tarragonès;43148;Tarragona;4;8;2;;677;461;216;0;3;458;461
43;Tarragona;36;Tarragonès;43148;Tarragona;4;9;1;;349;240;109;0;3;237;240
43;Tarragona;36;Tarragonès;43148;Tarragona;5;1;1;;544;385;159;1;1;383;384
43;Tarragona;36;Tarragonès;43148;Tarragona;5;1;2;;497;375;122;0;6;369;375
43;Tarragona;36;Tarragonès;43148;Tarragona;5;10;1;;324;209;115;0;1;208;209
43;Tarragona;36;Tarragonès;43148;Tarragona;5;2;1;;723;584;139;11;1;572;573
43;Tarragona;36;Tarragonès;43148;Tarragona;5;2;2;;635;351;284;9;3;339;342
43;Tarragona;36;Tarragonès;43148;Tarragona;5;3;1;;783;510;273;3;2;505;507
43;Tarragona;36;Tarragonès;43148;Tarragona;5;3;2;;812;526;286;10;1;515;516
43;Tarragona;36;Tarragonès;43148;Tarragona;5;4;1;;897;574;323;4;1;569;570
43;Tarragona;36;Tarragonès;43148;Tarragona;5;5;1;;836;491;345;5;2;484;486
43;Tarragona;36;Tarragonès;43148;Tarragona;5;6;1;;813;430;383;11;2;417;419
43;Tarragona;36;Tarragonès;43148;Tarragona;5;7;1;;542;328;214;0;2;326;328
43;Tarragona;36;Tarragonès;43148;Tarragona;5;7;2;;444;279;165;2;2;275;277
43;Tarragona;36;Tarragonès;43148;Tarragona;5;8;1;;656;447;209;4;7;436;443
43;Tarragona;36;Tarragonès;43148;Tarragona;5;8;2;;751;524;227;1;1;522;523
43;Tarragona;36;Tarragonès;43148;Tarragona;5;9;1;;570;427;143;2;2;423;425
43;Tarragona;36;Tarragonès;43148;Tarragona;6;1;1;;701;469;232;0;4;465;469
43;Tarragona;36;Tarragonès;43148;Tarragona;6;1;2;;622;416;206;0;4;412;416
43;Tarragona;36;Tarragonès;43148;Tarragona;6;10;1;;817;555;262;2;6;547;553
43;Tarragona;36;Tarragonès;43148;Tarragona;6;10;2;;710;499;211;6;7;486;493
43;Tarragona;36;Tarragonès;43148;Tarragona;6;11;1;;838;571;267;1;6;564;570
43;Tarragona;36;Tarragonès;43148;Tarragona;6;11;2;;765;543;222;7;2;534;536
43;Tarragona;36;Tarragonès;43148;Tarragona;6;12;1;;823;459;364;1;7;451;458
43;Tarragona;36;Tarragonès;43148;Tarragona;6;13;1;;705;475;230;2;2;471;473
43;Tarragona;36;Tarragonès;43148;Tarragona;6;13;2;;634;426;208;4;2;420;422
43;Tarragona;36;Tarragonès;43148;Tarragona;6;14;1;;487;298;189;0;2;296;298
43;Tarragona;36;Tarragonès;43148;Tarragona;6;15;1;;814;546;268;1;1;544;545
43;Tarragona;36;Tarragonès;43148;Tarragona;6;16;1;;474;264;210;0;4;260;264
43;Tarragona;36;Tarragonès;43148;Tarragona;6;17;1;;504;271;233;0;4;267;271
43;Tarragona;36;Tarragonès;43148;Tarragona;6;17;2;;449;268;181;1;4;263;267
43;Tarragona;36;Tarragonès;43148;Tarragona;6;2;1;;235;142;93;2;0;140;140
43;Tarragona;36;Tarragonès;43148;Tarragona;6;3;1;;917;548;369;2;5;541;546
43;Tarragona;36;Tarragonès;43148;Tarragona;6;3;2;;823;468;355;9;4;455;459
43;Tarragona;36;Tarragonès;43148;Tarragona;6;4;1;;496;325;171;3;2;320;322
43;Tarragona;36;Tarragonès;43148;Tarragona;6;4;2;;477;345;132;0;1;344;345
43;Tarragona;36;Tarragonès;43148;Tarragona;6;5;1;;500;361;139;2;5;354;359
43;Tarragona;36;Tarragonès;43148;Tarragona;6;6;1;;838;522;316;4;1;517;518
43;Tarragona;36;Tarragonès;43148;Tarragona;6;7;1;;168;80;88;0;0;80;80
43;Tarragona;36;Tarragonès;43148;Tarragona;6;8;1;;964;684;280;3;3;678;681
43;Tarragona;36;Tarragonès;43148;Tarragona;6;9;1;;673;448;225;1;3;444;447
43;Tarragona;36;Tarragonès;43148;Tarragona;6;9;2;;629;432;197;5;6;421;427
43;Tarragona;36;Tarragonès;43148;Tarragona;7;1;1;;734;428;306;7;9;412;421
43;Tarragona;36;Tarragonès;43148;Tarragona;7;10;1;;364;248;116;0;0;248;248
43;Tarragona;36;Tarragonès;43148;Tarragona;7;11;1;;877;508;369;8;4;496;500
43;Tarragona;36;Tarragonès;43148;Tarragona;7;12;1;;717;420;297;0;0;420;420
43;Tarragona;36;Tarragonès;43148;Tarragona;7;12;2;;627;391;236;3;2;386;388
43;Tarragona;36;Tarragonès;43148;Tarragona;7;13;1;;716;439;277;3;1;435;436
43;Tarragona;36;Tarragonès;43148;Tarragona;7;13;2;;635;410;225;0;5;405;410
43;Tarragona;36;Tarragonès;43148;Tarragona;7;14;1;;513;291;222;0;0;291;291
43;Tarragona;36;Tarragonès;43148;Tarragona;7;14;2;;426;248;178;0;1;247;248
43;Tarragona;36;Tarragonès;43148;Tarragona;7;2;1;;892;570;322;7;0;563;563
43;Tarragona;36;Tarragonès;43148;Tarragona;7;3;1;;997;522;475;4;2;516;518
43;Tarragona;36;Tarragonès;43148;Tarragona;7;4;1;;591;354;237;1;1;352;353
43;Tarragona;36;Tarragonès;43148;Tarragona;7;4;2;;521;307;214;4;0;303;303
43;Tarragona;36;Tarragonès;43148;Tarragona;7;5;1;;523;343;180;2;2;339;341
43;Tarragona;36;Tarragonès;43148;Tarragona;7;5;2;;522;328;194;0;1;327;328
43;Tarragona;36;Tarragonès;43148;Tarragona;7;6;1;;840;507;333;2;2;503;505
43;Tarragona;36;Tarragonès;43148;Tarragona;7;7;1;;870;474;396;4;1;469;470
43;Tarragona;36;Tarragonès;43148;Tarragona;7;8;1;;422;254;168;0;1;253;254
43;Tarragona;36;Tarragonès;43148;Tarragona;7;9;1;;271;203;68;0;1;202;203
43;Tarragona;36;Tarragonès;43148;Tarragona;8;1;1;;696;402;294;0;1;401;402
43;Tarragona;36;Tarragonès;43148;Tarragona;8;1;2;;623;353;270;0;1;352;353
43;Tarragona;36;Tarragonès;43148;Tarragona;8;2;1;;726;414;312;1;2;411;413
43;Tarragona;36;Tarragonès;43148;Tarragona;8;2;2;;631;412;219;1;5;406;411
43;Tarragona;36;Tarragonès;43148;Tarragona;8;3;1;;680;376;304;2;5;369;374
43;Tarragona;36;Tarragonès;43148;Tarragona;8;3;2;;711;390;321;1;4;385;389
43;Tarragona;36;Tarragonès;43148;Tarragona;8;4;1;;592;375;217;1;8;366;374
43;Tarragona;36;Tarragonès;43148;Tarragona;8;4;2;;498;328;170;1;7;320;327
43;Tarragona;36;Tarragonès;43148;Tarragona;8;5;1;;824;476;348;3;5;468;473
43;Tarragona;36;Tarragonès;43148;Tarragona;8;6;1;;558;348;210;2;2;344;346
43;Tarragona;36;Tarragonès;43148;Tarragona;8;6;2;;516;301;215;2;1;298;299
43;Tarragona;36;Tarragonès;43148;Tarragona;8;7;1;;983;564;419;0;2;562;564
43;Tarragona;36;Tarragonès;43148;Tarragona;8;8;1;;1509;731;778;11;7;713;720
43;Tarragona;36;Tarragonès;43148;Tarragona;8;9;1;;831;403;428;2;4;397;401
43;Tarragona;36;Tarragonès;43148;Tarragona;9;1;1;;750;444;306;1;0;443;443
43;Tarragona;36;Tarragonès;43148;Tarragona;9;10;1;;736;439;297;3;7;429;436
43;Tarragona;36;Tarragonès;43148;Tarragona;9;2;1;;884;554;330;2;1;551;552
43;Tarragona;36;Tarragonès;43148;Tarragona;9;3;1;;909;534;375;3;1;530;531
43;Tarragona;36;Tarragonès;43148;Tarragona;9;4;1;;857;542;315;10;1;531;532
43;Tarragona;36;Tarragonès;43148;Tarragona;9;5;1;;919;645;274;3;1;641;642
43;Tarragona;36;Tarragonès;43148;Tarragona;9;6;1;;743;441;302;6;4;431;435
43;Tarragona;36;Tarragonès;43148;Tarragona;9;6;2;;695;470;225;10;0;460;460
43;Tarragona;36;Tarragonès;43148;Tarragona;9;7;1;;731;487;244;7;2;478;480
43;Tarragona;36;Tarragonès;43148;Tarragona;9;8;1;;791;484;307;4;0;480;480
43;Tarragona;36;Tarragonès;43148;Tarragona;9;9;1;;530;306;224;5;0;301;301
25;Lleida;38;Urgell;25217;Tàrrega;1;1;1;;999;690;309;2;2;686;688
25;Lleida;38;Urgell;25217;Tàrrega;1;2;1;;1030;664;366;1;4;659;663
25;Lleida;38;Urgell;25217;Tàrrega;2;1;1;;608;428;180;1;3;424;427
25;Lleida;38;Urgell;25217;Tàrrega;2;2;1;;1305;951;354;15;4;932;936
25;Lleida;38;Urgell;25217;Tàrrega;3;1;1;;1156;793;363;2;5;786;791
25;Lleida;38;Urgell;25217;Tàrrega;3;2;1;;809;573;236;1;3;569;572
25;Lleida;38;Urgell;25217;Tàrrega;4;1;1;;604;432;172;4;0;428;428
25;Lleida;38;Urgell;25217;Tàrrega;4;2;1;;733;562;171;6;4;552;556
25;Lleida;38;Urgell;25217;Tàrrega;4;2;2;;673;510;163;0;3;507;510
25;Lleida;38;Urgell;25217;Tàrrega;5;1;1;;279;225;54;5;1;219;220
25;Lleida;38;Urgell;25217;Tàrrega;5;2;1;;216;151;65;0;0;151;151
25;Lleida;38;Urgell;25217;Tàrrega;5;3;1;;293;190;103;4;1;185;186
25;Lleida;18;Garrigues;25218;Tarrés;1;1;1;;87;58;29;0;0;58;58
25;Lleida;32;Segarra;25219;Tarroja de Segarra;1;1;1;;200;139;61;0;5;134;139
8;Barcelona;24;Osona;08275;Tavèrnoles;1;1;1;;153;102;51;0;1;101;102
8;Barcelona;24;Osona;08280;Tavertet;1;1;1;;82;54;28;0;0;54;54
8;Barcelona;21;Maresme;08281;Teià;1;1;1;;1021;693;328;12;0;681;681
8;Barcelona;21;Maresme;08281;Teià;1;2;1;;765;585;180;12;2;571;573
25;Lleida;23;Noguera;25220;Térmens;1;1;1;;590;435;155;0;0;435;435
25;Lleida;23;Noguera;25220;Térmens;1;1;2;;504;354;150;1;1;352;353
17;Girona;2;Alt Empordà;17196;Terrades;1;1;1;;171;126;45;1;0;125;125
8;Barcelona;40;Vallès Occidental;08279;Terrassa;1;1;1;;650;549;101;0;5;544;549
8;Barcelona;40;Vallès Occidental;08279;Terrassa;1;1;2;;649;531;118;1;1;529;530
8;Barcelona;40;Vallès Occidental;08279;Terrassa;1;2;1;;703;534;169;3;4;527;531
8;Barcelona;40;Vallès Occidental;08279;Terrassa;1;3;1;;424;363;61;0;1;362;363
8;Barcelona;40;Vallès Occidental;08279;Terrassa;1;4;1;;500;381;119;1;0;380;380
8;Barcelona;40;Vallès Occidental;08279;Terrassa;1;4;2;;499;375;124;1;1;373;374
8;Barcelona;40;Vallès Occidental;08279;Terrassa;1;5;1;;650;485;165;0;2;483;485
8;Barcelona;40;Vallès Occidental;08279;Terrassa;1;5;2;;666;494;172;1;1;492;493
8;Barcelona;40;Vallès Occidental;08279;Terrassa;1;6;1;;700;549;151;2;0;547;547
8;Barcelona;40;Vallès Occidental;08279;Terrassa;1;6;2;;659;500;159;1;3;496;499
8;Barcelona;40;Vallès Occidental;08279;Terrassa;2;1;1;;1140;441;699;0;1;440;441
8;Barcelona;40;Vallès Occidental;08279;Terrassa;2;10;1;;472;294;178;1;0;293;293
8;Barcelona;40;Vallès Occidental;08279;Terrassa;2;11;1;;600;343;257;1;1;341;342
8;Barcelona;40;Vallès Occidental;08279;Terrassa;2;11;2;;557;324;233;0;2;322;324
8;Barcelona;40;Vallès Occidental;08279;Terrassa;2;12;1;;750;517;233;5;1;511;512
8;Barcelona;40;Vallès Occidental;08279;Terrassa;2;12;2;;725;498;227;1;0;497;497
8;Barcelona;40;Vallès Occidental;08279;Terrassa;2;13;1;;650;377;273;10;2;365;367
8;Barcelona;40;Vallès Occidental;08279;Terrassa;2;13;2;;611;343;268;0;0;343;343
8;Barcelona;40;Vallès Occidental;08279;Terrassa;2;13;3;;607;318;289;0;1;317;318
8;Barcelona;40;Vallès Occidental;08279;Terrassa;2;14;1;;818;454;364;1;0;453;453
8;Barcelona;40;Vallès Occidental;08279;Terrassa;2;15;1;;700;434;266;13;5;416;421
8;Barcelona;40;Vallès Occidental;08279;Terrassa;2;15;2;;700;377;323;8;0;369;369
8;Barcelona;40;Vallès Occidental;08279;Terrassa;2;15;3;;719;420;299;1;0;419;419
8;Barcelona;40;Vallès Occidental;08279;Terrassa;2;16;1;;800;427;373;2;0;425;425
8;Barcelona;40;Vallès Occidental;08279;Terrassa;2;16;2;;800;434;366;4;2;428;430
8;Barcelona;40;Vallès Occidental;08279;Terrassa;2;16;3;;892;471;421;1;4;466;470
8;Barcelona;40;Vallès Occidental;08279;Terrassa;2;17;1;;586;380;206;3;1;376;377
8;Barcelona;40;Vallès Occidental;08279;Terrassa;2;18;1;;742;494;248;1;0;493;493
8;Barcelona;40;Vallès Occidental;08279;Terrassa;2;19;1;;650;426;224;6;3;417;420
8;Barcelona;40;Vallès Occidental;08279;Terrassa;2;19;2;;610;382;228;4;3;375;378
8;Barcelona;40;Vallès Occidental;08279;Terrassa;2;2;1;;800;600;200;1;7;592;599
8;Barcelona;40;Vallès Occidental;08279;Terrassa;2;2;2;;821;645;176;1;5;639;644
8;Barcelona;40;Vallès Occidental;08279;Terrassa;2;20;1;;901;624;277;17;3;604;607
8;Barcelona;40;Vallès Occidental;08279;Terrassa;2;21;1;;650;430;220;2;2;426;428
8;Barcelona;40;Vallès Occidental;08279;Terrassa;2;21;2;;654;434;220;2;0;432;432
8;Barcelona;40;Vallès Occidental;08279;Terrassa;2;22;1;;882;520;362;1;2;517;519
8;Barcelona;40;Vallès Occidental;08279;Terrassa;2;23;1;;850;504;346;10;1;493;494
8;Barcelona;40;Vallès Occidental;08279;Terrassa;2;23;2;;818;488;330;7;0;481;481
8;Barcelona;40;Vallès Occidental;08279;Terrassa;2;24;1;;850;490;360;6;1;483;484
8;Barcelona;40;Vallès Occidental;08279;Terrassa;2;24;2;;817;499;318;6;1;492;493
8;Barcelona;40;Vallès Occidental;08279;Terrassa;2;25;1;;850;559;291;1;0;558;558
8;Barcelona;40;Vallès Occidental;08279;Terrassa;2;25;2;;864;582;282;9;0;573;573
8;Barcelona;40;Vallès Occidental;08279;Terrassa;2;26;1;;850;484;366;0;5;479;484
8;Barcelona;40;Vallès Occidental;08279;Terrassa;2;26;2;;885;515;370;1;3;511;514
8;Barcelona;40;Vallès Occidental;08279;Terrassa;2;3;1;;550;407;143;1;0;406;406
8;Barcelona;40;Vallès Occidental;08279;Terrassa;2;3;2;;613;456;157;0;2;454;456
8;Barcelona;40;Vallès Occidental;08279;Terrassa;2;4;1;;850;572;278;1;2;569;571
8;Barcelona;40;Vallès Occidental;08279;Terrassa;2;4;2;;826;553;273;1;5;547;552
8;Barcelona;40;Vallès Occidental;08279;Terrassa;2;5;1;;550;344;206;3;2;339;341
8;Barcelona;40;Vallès Occidental;08279;Terrassa;2;5;2;;525;320;205;5;0;315;315
8;Barcelona;40;Vallès Occidental;08279;Terrassa;2;6;1;;600;374;226;3;1;370;371
8;Barcelona;40;Vallès Occidental;08279;Terrassa;2;6;2;;586;372;214;9;0;363;363
8;Barcelona;40;Vallès Occidental;08279;Terrassa;2;7;1;;587;398;189;15;2;381;383
8;Barcelona;40;Vallès Occidental;08279;Terrassa;2;8;1;;885;542;343;1;1;540;541
8;Barcelona;40;Vallès Occidental;08279;Terrassa;2;9;1;;859;548;311;0;0;548;548
8;Barcelona;40;Vallès Occidental;08279;Terrassa;3;1;1;;550;419;131;3;0;416;416
8;Barcelona;40;Vallès Occidental;08279;Terrassa;3;1;2;;541;423;118;0;3;420;423
8;Barcelona;40;Vallès Occidental;08279;Terrassa;3;10;1;;1005;538;467;2;1;535;536
8;Barcelona;40;Vallès Occidental;08279;Terrassa;3;10;2;;1000;522;478;6;2;514;516
8;Barcelona;40;Vallès Occidental;08279;Terrassa;3;10;3;;917;485;432;0;3;482;485
8;Barcelona;40;Vallès Occidental;08279;Terrassa;3;2;1;;833;649;184;1;1;647;648
8;Barcelona;40;Vallès Occidental;08279;Terrassa;3;3;1;;886;635;251;2;5;628;633
8;Barcelona;40;Vallès Occidental;08279;Terrassa;3;4;1;;576;347;229;0;1;346;347
8;Barcelona;40;Vallès Occidental;08279;Terrassa;3;5;1;;600;418;182;0;0;418;418
8;Barcelona;40;Vallès Occidental;08279;Terrassa;3;5;2;;627;431;196;2;2;427;429
8;Barcelona;40;Vallès Occidental;08279;Terrassa;3;6;1;;822;598;224;0;2;596;598
8;Barcelona;40;Vallès Occidental;08279;Terrassa;3;7;1;;585;431;154;0;1;430;431
8;Barcelona;40;Vallès Occidental;08279;Terrassa;3;8;1;;1050;591;459;2;2;587;589
8;Barcelona;40;Vallès Occidental;08279;Terrassa;3;8;2;;1048;599;449;0;0;599;599
8;Barcelona;40;Vallès Occidental;08279;Terrassa;3;9;1;;738;454;284;2;0;452;452
8;Barcelona;40;Vallès Occidental;08279;Terrassa;4;1;1;;981;724;257;0;4;720;724
8;Barcelona;40;Vallès Occidental;08279;Terrassa;4;2;1;;1076;772;304;1;0;771;771
8;Barcelona;40;Vallès Occidental;08279;Terrassa;4;3;1;;550;382;168;2;5;375;380
8;Barcelona;40;Vallès Occidental;08279;Terrassa;4;3;2;;553;398;155;4;0;394;394
8;Barcelona;40;Vallès Occidental;08279;Terrassa;4;4;1;;603;397;206;4;2;391;393
8;Barcelona;40;Vallès Occidental;08279;Terrassa;4;4;2;;584;371;213;0;2;369;371
8;Barcelona;40;Vallès Occidental;08279;Terrassa;4;5;1;;750;485;265;3;1;481;482
8;Barcelona;40;Vallès Occidental;08279;Terrassa;4;5;2;;755;514;241;6;5;503;508
8;Barcelona;40;Vallès Occidental;08279;Terrassa;4;6;1;;1026;665;361;0;5;660;665
8;Barcelona;40;Vallès Occidental;08279;Terrassa;4;7;1;;800;463;337;0;2;461;463
8;Barcelona;40;Vallès Occidental;08279;Terrassa;4;7;2;;787;425;362;11;3;411;414
8;Barcelona;40;Vallès Occidental;08279;Terrassa;4;8;1;;600;363;237;0;1;362;363
8;Barcelona;40;Vallès Occidental;08279;Terrassa;4;8;2;;577;365;212;0;2;363;365
8;Barcelona;40;Vallès Occidental;08279;Terrassa;5;1;1;;1038;799;239;0;3;796;799
8;Barcelona;40;Vallès Occidental;08279;Terrassa;5;10;1;;651;423;228;7;7;409;416
8;Barcelona;40;Vallès Occidental;08279;Terrassa;5;10;2;;655;421;234;14;2;405;407
8;Barcelona;40;Vallès Occidental;08279;Terrassa;5;11;1;;750;490;260;0;0;490;490
8;Barcelona;40;Vallès Occidental;08279;Terrassa;5;11;2;;740;462;278;5;2;455;457
8;Barcelona;40;Vallès Occidental;08279;Terrassa;5;12;1;;712;450;262;0;0;450;450
8;Barcelona;40;Vallès Occidental;08279;Terrassa;5;13;1;;450;270;180;0;1;269;270
8;Barcelona;40;Vallès Occidental;08279;Terrassa;5;13;2;;400;246;154;1;4;241;245
8;Barcelona;40;Vallès Occidental;08279;Terrassa;5;14;1;;600;397;203;1;1;395;396
8;Barcelona;40;Vallès Occidental;08279;Terrassa;5;14;2;;650;417;233;6;0;411;411
8;Barcelona;40;Vallès Occidental;08279;Terrassa;5;14;3;;619;401;218;2;4;395;399
8;Barcelona;40;Vallès Occidental;08279;Terrassa;5;15;1;;600;368;232;0;0;368;368
8;Barcelona;40;Vallès Occidental;08279;Terrassa;5;15;2;;646;395;251;0;1;394;395
8;Barcelona;40;Vallès Occidental;08279;Terrassa;5;16;1;;587;427;160;5;0;422;422
8;Barcelona;40;Vallès Occidental;08279;Terrassa;5;17;1;;500;330;170;1;0;329;329
8;Barcelona;40;Vallès Occidental;08279;Terrassa;5;17;2;;500;339;161;0;2;337;339
8;Barcelona;40;Vallès Occidental;08279;Terrassa;5;18;1;;788;476;312;0;2;474;476
8;Barcelona;40;Vallès Occidental;08279;Terrassa;5;19;1;;626;390;236;0;1;389;390
8;Barcelona;40;Vallès Occidental;08279;Terrassa;5;2;1;;800;609;191;0;5;604;609
8;Barcelona;40;Vallès Occidental;08279;Terrassa;5;2;2;;776;586;190;2;1;583;584
8;Barcelona;40;Vallès Occidental;08279;Terrassa;5;20;1;;850;525;325;0;4;521;525
8;Barcelona;40;Vallès Occidental;08279;Terrassa;5;20;2;;851;560;291;4;1;555;556
8;Barcelona;40;Vallès Occidental;08279;Terrassa;5;3;1;;550;426;124;0;0;426;426
8;Barcelona;40;Vallès Occidental;08279;Terrassa;5;3;2;;599;448;151;2;1;445;446
8;Barcelona;40;Vallès Occidental;08279;Terrassa;5;4;1;;936;634;302;0;6;628;634
8;Barcelona;40;Vallès Occidental;08279;Terrassa;5;5;1;;600;449;151;1;1;447;448
8;Barcelona;40;Vallès Occidental;08279;Terrassa;5;5;2;;649;476;173;0;0;476;476
8;Barcelona;40;Vallès Occidental;08279;Terrassa;5;6;1;;623;402;221;0;1;401;402
8;Barcelona;40;Vallès Occidental;08279;Terrassa;5;7;1;;600;384;216;1;1;382;383
8;Barcelona;40;Vallès Occidental;08279;Terrassa;5;7;2;;600;378;222;2;4;372;376
8;Barcelona;40;Vallès Occidental;08279;Terrassa;5;7;3;;652;425;227;0;3;422;425
8;Barcelona;40;Vallès Occidental;08279;Terrassa;5;8;1;;874;501;373;0;1;500;501
8;Barcelona;40;Vallès Occidental;08279;Terrassa;5;9;1;;550;400;150;0;3;397;400
8;Barcelona;40;Vallès Occidental;08279;Terrassa;5;9;2;;522;345;177;2;1;342;343
8;Barcelona;40;Vallès Occidental;08279;Terrassa;6;1;1;;800;567;233;2;5;560;565
8;Barcelona;40;Vallès Occidental;08279;Terrassa;6;1;2;;800;549;251;0;3;546;549
8;Barcelona;40;Vallès Occidental;08279;Terrassa;6;1;3;;759;535;224;0;4;531;535
8;Barcelona;40;Vallès Occidental;08279;Terrassa;6;10;1;;450;231;219;1;2;228;230
8;Barcelona;40;Vallès Occidental;08279;Terrassa;6;10;2;;484;277;207;0;1;276;277
8;Barcelona;40;Vallès Occidental;08279;Terrassa;6;11;1;;651;374;277;1;1;372;373
8;Barcelona;40;Vallès Occidental;08279;Terrassa;6;11;2;;688;401;287;1;1;399;400
8;Barcelona;40;Vallès Occidental;08279;Terrassa;6;12;1;;550;303;247;1;1;301;302
8;Barcelona;40;Vallès Occidental;08279;Terrassa;6;12;2;;562;299;263;0;0;299;299
8;Barcelona;40;Vallès Occidental;08279;Terrassa;6;13;1;;856;522;334;0;2;520;522
8;Barcelona;40;Vallès Occidental;08279;Terrassa;6;14;1;;453;244;209;0;1;243;244
8;Barcelona;40;Vallès Occidental;08279;Terrassa;6;14;2;;412;225;187;0;0;225;225
8;Barcelona;40;Vallès Occidental;08279;Terrassa;6;15;1;;507;359;148;10;2;347;349
8;Barcelona;40;Vallès Occidental;08279;Terrassa;6;16;1;;537;317;220;0;0;317;317
8;Barcelona;40;Vallès Occidental;08279;Terrassa;6;17;1;;543;309;234;0;2;307;309
8;Barcelona;40;Vallès Occidental;08279;Terrassa;6;18;1;;769;442;327;0;1;441;442
8;Barcelona;40;Vallès Occidental;08279;Terrassa;6;19;1;;733;485;248;1;1;483;484
8;Barcelona;40;Vallès Occidental;08279;Terrassa;6;2;1;;700;498;202;0;5;493;498
8;Barcelona;40;Vallès Occidental;08279;Terrassa;6;2;2;;720;506;214;0;3;503;506
8;Barcelona;40;Vallès Occidental;08279;Terrassa;6;20;1;;752;445;307;0;2;443;445
8;Barcelona;40;Vallès Occidental;08279;Terrassa;6;21;1;;700;440;260;2;2;436;438
8;Barcelona;40;Vallès Occidental;08279;Terrassa;6;22;1;;800;498;302;1;3;494;497
8;Barcelona;40;Vallès Occidental;08279;Terrassa;6;22;2;;767;457;310;2;0;455;455
8;Barcelona;40;Vallès Occidental;08279;Terrassa;6;23;1;;450;248;202;0;1;247;248
8;Barcelona;40;Vallès Occidental;08279;Terrassa;6;23;2;;486;289;197;0;1;288;289
8;Barcelona;40;Vallès Occidental;08279;Terrassa;6;24;1;;750;415;335;11;0;404;404
8;Barcelona;40;Vallès Occidental;08279;Terrassa;6;24;2;;716;425;291;2;1;422;423
8;Barcelona;40;Vallès Occidental;08279;Terrassa;6;25;1;;566;381;185;0;1;380;381
8;Barcelona;40;Vallès Occidental;08279;Terrassa;6;26;1;;759;448;311;0;3;445;448
8;Barcelona;40;Vallès Occidental;08279;Terrassa;6;27;1;;750;513;237;0;4;509;513
8;Barcelona;40;Vallès Occidental;08279;Terrassa;6;28;1;;603;175;428;0;0;175;175
8;Barcelona;40;Vallès Occidental;08279;Terrassa;6;29;1;;821;521;300;0;2;519;521
8;Barcelona;40;Vallès Occidental;08279;Terrassa;6;3;1;;700;460;240;1;1;458;459
8;Barcelona;40;Vallès Occidental;08279;Terrassa;6;3;2;;715;474;241;9;1;464;465
8;Barcelona;40;Vallès Occidental;08279;Terrassa;6;30;1;;653;385;268;1;3;381;384
8;Barcelona;40;Vallès Occidental;08279;Terrassa;6;30;2;;682;364;318;0;0;364;364
8;Barcelona;40;Vallès Occidental;08279;Terrassa;6;31;1;;400;247;153;0;0;247;247
8;Barcelona;40;Vallès Occidental;08279;Terrassa;6;31;2;;433;257;176;1;0;256;256
8;Barcelona;40;Vallès Occidental;08279;Terrassa;6;32;1;;650;400;250;7;1;392;393
8;Barcelona;40;Vallès Occidental;08279;Terrassa;6;32;2;;685;395;290;0;3;392;395
8;Barcelona;40;Vallès Occidental;08279;Terrassa;6;33;1;;650;425;225;1;1;423;424
8;Barcelona;40;Vallès Occidental;08279;Terrassa;6;33;2;;620;377;243;3;5;369;374
8;Barcelona;40;Vallès Occidental;08279;Terrassa;6;4;1;;650;446;204;2;6;438;444
8;Barcelona;40;Vallès Occidental;08279;Terrassa;6;4;2;;694;472;222;7;1;464;465
8;Barcelona;40;Vallès Occidental;08279;Terrassa;6;5;1;;800;494;306;0;3;491;494
8;Barcelona;40;Vallès Occidental;08279;Terrassa;6;5;2;;778;502;276;0;2;500;502
8;Barcelona;40;Vallès Occidental;08279;Terrassa;6;6;1;;613;354;259;0;1;353;354
8;Barcelona;40;Vallès Occidental;08279;Terrassa;6;7;1;;562;342;220;1;0;341;341
8;Barcelona;40;Vallès Occidental;08279;Terrassa;6;8;1;;700;437;263;0;2;435;437
8;Barcelona;40;Vallès Occidental;08279;Terrassa;6;8;2;;687;399;288;0;2;397;399
8;Barcelona;40;Vallès Occidental;08279;Terrassa;6;9;1;;904;509;395;0;1;508;509
8;Barcelona;40;Vallès Occidental;08279;Terrassa;6;9;2;;948;529;419;0;0;529;529
8;Barcelona;21;Maresme;08282;Tiana;1;1;1;;1319;976;343;1;5;970;975
8;Barcelona;21;Maresme;08282;Tiana;1;2;1;;1032;777;255;7;3;767;770
25;Lleida;26;Pallars Sobirà;25221;Tírvia;1;1;1;;115;74;41;0;0;74;74
25;Lleida;23;Noguera;25222;Tiurana;1;1;1;;158;135;23;0;1;134;135
43;Tarragona;9;Baix Ebre;43149;Tivenys;1;1;1;;916;666;250;9;2;655;657
43;Tarragona;30;Ribera d'Ebre;43150;Tivissa;1;1;1;;1122;709;413;6;6;697;703
43;Tarragona;30;Ribera d'Ebre;43150;Tivissa;1;2;1;;286;189;97;0;0;189;189
43;Tarragona;30;Ribera d'Ebre;43150;Tivissa;1;3;1;;107;65;42;0;1;64;65
8;Barcelona;24;Osona;08283;Tona;1;1;1;;1912;1449;463;44;6;1399;1405
8;Barcelona;24;Osona;08283;Tona;1;2;1;;1719;1290;429;32;2;1256;1258
25;Lleida;32;Segarra;25223;Torà;1;1;1;;1022;704;318;1;5;698;703
8;Barcelona;21;Maresme;08284;Tordera;1;1;1;;759;523;236;1;1;521;522
8;Barcelona;21;Maresme;08284;Tordera;1;1;2;;749;549;200;0;1;548;549
8;Barcelona;21;Maresme;08284;Tordera;1;2;1;;995;586;409;17;0;569;569
8;Barcelona;21;Maresme;08284;Tordera;1;2;2;;994;640;354;2;3;635;638
8;Barcelona;21;Maresme;08284;Tordera;2;1;1;;650;429;221;1;2;426;428
8;Barcelona;21;Maresme;08284;Tordera;2;1;2;;649;431;218;4;2;425;427
8;Barcelona;21;Maresme;08284;Tordera;2;2;1;;864;550;314;2;4;544;548
8;Barcelona;24;Osona;08285;Torelló;1;1;1;;1140;774;366;2;1;771;772
8;Barcelona;24;Osona;08285;Torelló;1;2;1;;955;682;273;4;4;674;678
8;Barcelona;24;Osona;08285;Torelló;1;2;2;;926;642;284;0;4;638;642
8;Barcelona;24;Osona;08285;Torelló;1;3;1;;955;714;241;2;1;711;712
8;Barcelona;24;Osona;08285;Torelló;2;1;1;;920;664;256;0;6;658;664
8;Barcelona;24;Osona;08285;Torelló;2;2;1;;911;594;317;3;3;588;591
8;Barcelona;24;Osona;08285;Torelló;2;2;2;;958;647;311;1;4;642;646
8;Barcelona;24;Osona;08285;Torelló;2;3;1;;831;557;274;0;3;554;557
8;Barcelona;24;Osona;08285;Torelló;2;3;2;;855;573;282;3;1;569;570
8;Barcelona;24;Osona;08285;Torelló;2;4;1;;149;84;65;0;1;83;84
25;Lleida;18;Garrigues;25224;Torms, els;1;1;1;;194;140;54;0;2;138;140
25;Lleida;38;Urgell;25225;Tornabous;1;1;1;;784;547;237;2;0;545;545
25;Lleida;33;Segrià;25226;Torrebesses;1;1;1;;334;168;166;0;0;168;168
25;Lleida;25;Pallars Jussà;25227;Torre de Cabdella, la;1;1;1;;665;376;289;1;2;373;375
8;Barcelona;6;Anoia;08286;Torre de Claramunt, la;1;1;1;;894;596;298;3;0;593;593
43;Tarragona;29;Priorat;43151;Torre de Fontaubella, la;1;1;1;;65;37;28;0;0;37;37
43;Tarragona;30;Ribera d'Ebre;43152;Torre de l'Espanyol, la;1;1;1;;671;489;182;0;0;489;489
43;Tarragona;36;Tarragonès;43153;Torredembarra;1;1;1;;817;590;227;3;0;587;587
43;Tarragona;36;Tarragonès;43153;Torredembarra;1;1;2;;876;617;259;3;1;613;614
43;Tarragona;36;Tarragonès;43153;Torredembarra;1;2;1;;755;553;202;9;6;538;544
43;Tarragona;36;Tarragonès;43153;Torredembarra;1;2;2;;839;612;227;0;1;611;612
43;Tarragona;36;Tarragonès;43153;Torredembarra;1;3;1;;569;411;158;2;4;405;409
25;Lleida;33;Segrià;25228;Torrefarrera;1;1;1;;1106;746;360;2;0;744;744
25;Lleida;32;Segarra;25907;Torrefeta i Florejacs;1;1;1;;654;388;266;1;1;386;387
25;Lleida;27;Pla d'Urgell;25230;Torregrossa;1;1;1;;722;569;153;0;2;567;569
25;Lleida;27;Pla d'Urgell;25230;Torregrossa;1;2;1;;1208;897;311;1;9;887;896
25;Lleida;23;Noguera;25231;Torrelameu;1;1;1;;482;294;188;1;2;291;293
8;Barcelona;3;Alt Penedès;08287;Torrelavit;1;1;1;;885;617;268;2;2;613;615
8;Barcelona;3;Alt Penedès;08288;Torrelles de Foix;1;1;1;;859;550;309;8;7;535;542
8;Barcelona;11;Baix Llobregat;08289;Torrelles de Llobregat;1;1;1;;1126;821;305;1;5;815;820
17;Girona;10;Baix Empordà;17197;Torrent;1;1;1;;146;101;45;0;1;100;101
25;Lleida;33;Segrià;25232;Torres de Segre;1;1;1;;1484;1075;409;2;2;1071;1073
25;Lleida;33;Segrià;25233;Torre-serona;1;1;1;;230;141;89;0;0;141;141
17;Girona;2;Alt Empordà;17198;Torroella de Fluvià;1;1;1;;259;172;87;1;0;171;171
17;Girona;10;Baix Empordà;17199;Torroella de Montgrí;1;1;1;;959;651;308;3;2;646;648
17;Girona;10;Baix Empordà;17199;Torroella de Montgrí;1;1;2;;867;593;274;5;0;588;588
17;Girona;10;Baix Empordà;17199;Torroella de Montgrí;1;2;1;;813;570;243;4;3;563;566
17;Girona;10;Baix Empordà;17199;Torroella de Montgrí;1;2;2;;744;522;222;1;1;520;521
17;Girona;10;Baix Empordà;17199;Torroella de Montgrí;1;3;1;;688;506;182;2;0;504;504
17;Girona;10;Baix Empordà;17199;Torroella de Montgrí;1;4;1;;87;50;37;0;0;50;50
17;Girona;10;Baix Empordà;17199;Torroella de Montgrí;1;5;1;;185;95;90;2;0;93;93
43;Tarragona;29;Priorat;43154;Torroja del Priorat;1;1;1;;134;69;65;0;0;69;69
17;Girona;19;Garrotxa;17200;Tortellà;1;1;1;;635;454;181;5;1;448;449
43;Tarragona;9;Baix Ebre;43155;Tortosa;1;1;1;;647;420;227;6;1;413;414
43;Tarragona;9;Baix Ebre;43155;Tortosa;1;1;2;;467;275;192;8;1;266;267
43;Tarragona;9;Baix Ebre;43155;Tortosa;1;2;1;;836;431;405;6;3;422;425
43;Tarragona;9;Baix Ebre;43155;Tortosa;1;3;1;;1175;841;334;9;7;825;832
43;Tarragona;9;Baix Ebre;43155;Tortosa;1;4;1;;1037;627;410;4;5;618;623
43;Tarragona;9;Baix Ebre;43155;Tortosa;1;4;2;;806;479;327;9;1;469;470
43;Tarragona;9;Baix Ebre;43155;Tortosa;1;5;1;;819;448;371;14;0;434;434
43;Tarragona;9;Baix Ebre;43155;Tortosa;1;6;1;;946;631;315;18;4;609;613
43;Tarragona;9;Baix Ebre;43155;Tortosa;2;1;1;;525;299;226;5;0;294;294
43;Tarragona;9;Baix Ebre;43155;Tortosa;2;2;1;;517;264;253;4;1;259;260
43;Tarragona;9;Baix Ebre;43155;Tortosa;2;3;1;;926;541;385;2;4;535;539
43;Tarragona;9;Baix Ebre;43155;Tortosa;2;3;2;;723;425;298;3;2;420;422
43;Tarragona;9;Baix Ebre;43155;Tortosa;2;4;1;;953;524;429;6;1;517;518
43;Tarragona;9;Baix Ebre;43155;Tortosa;2;5;1;;819;439;380;2;2;435;437
43;Tarragona;9;Baix Ebre;43155;Tortosa;3;1;1;;419;208;211;1;4;203;207
43;Tarragona;9;Baix Ebre;43155;Tortosa;3;2;1;;561;366;195;2;2;362;364
43;Tarragona;9;Baix Ebre;43155;Tortosa;3;3;1;;530;258;272;14;2;242;244
43;Tarragona;9;Baix Ebre;43155;Tortosa;3;4;1;;809;436;373;4;1;431;432
43;Tarragona;9;Baix Ebre;43155;Tortosa;3;4;2;;632;353;279;6;4;343;347
43;Tarragona;9;Baix Ebre;43155;Tortosa;3;5;1;;455;207;248;2;0;205;205
43;Tarragona;9;Baix Ebre;43155;Tortosa;3;6;1;;960;501;459;1;4;496;500
43;Tarragona;9;Baix Ebre;43155;Tortosa;4;1;1;;1214;695;519;2;5;688;693
43;Tarragona;9;Baix Ebre;43155;Tortosa;4;2;1;;1348;753;595;14;10;729;739
43;Tarragona;9;Baix Ebre;43155;Tortosa;4;2;2;;1039;573;466;5;5;563;568
43;Tarragona;9;Baix Ebre;43155;Tortosa;4;3;1;;769;399;370;9;0;390;390
43;Tarragona;9;Baix Ebre;43155;Tortosa;4;3;2;;570;301;269;3;5;293;298
43;Tarragona;9;Baix Ebre;43155;Tortosa;4;4;1;;790;461;329;5;4;452;456
43;Tarragona;9;Baix Ebre;43155;Tortosa;4;5;1;;594;353;241;5;3;345;348
43;Tarragona;9;Baix Ebre;43155;Tortosa;4;6;1;;478;282;196;1;1;280;281
43;Tarragona;9;Baix Ebre;43155;Tortosa;4;7;1;;260;143;117;1;0;142;142
17;Girona;31;Ripollès;17201;Toses;1;1;1;;121;91;30;0;0;91;91
17;Girona;34;Selva;17202;Tossa de Mar;1;1;1;;783;618;165;3;5;610;615
17;Girona;34;Selva;17202;Tossa de Mar;1;2;1;;592;443;149;2;6;435;441
17;Girona;34;Selva;17202;Tossa de Mar;1;3;1;;794;592;202;2;1;589;590
25;Lleida;25;Pallars Jussà;25234;Tremp;1;1;1;;974;636;338;5;2;629;631
25;Lleida;25;Pallars Jussà;25234;Tremp;1;2;1;;969;615;354;4;2;609;611
25;Lleida;25;Pallars Jussà;25234;Tremp;2;1;1;;1076;794;282;5;4;785;789
25;Lleida;25;Pallars Jussà;25234;Tremp;2;2;1;;910;627;283;2;10;615;625
25;Lleida;25;Pallars Jussà;25234;Tremp;3;1;1;;144;27;117;0;0;27;27
25;Lleida;25;Pallars Jussà;25234;Tremp;3;2;1;;155;111;44;0;2;109;111
25;Lleida;25;Pallars Jussà;25234;Tremp;3;3;1;;136;63;73;1;1;61;62
25;Lleida;25;Pallars Jussà;25234;Tremp;3;4;1;;230;123;107;0;0;123;123
17;Girona;10;Baix Empordà;17204;Ullà;1;1;1;;570;369;201;8;3;358;361
8;Barcelona;40;Vallès Occidental;08290;Ullastrell;1;1;1;;575;477;98;2;3;472;475
17;Girona;10;Baix Empordà;17205;Ullastret;1;1;1;;223;161;62;0;0;161;161
43;Tarragona;22;Montsià;43156;Ulldecona;1;1;1;;810;559;251;14;5;540;545
43;Tarragona;22;Montsià;43156;Ulldecona;1;2;1;;710;511;199;4;5;502;507
43;Tarragona;22;Montsià;43156;Ulldecona;1;2;2;;755;528;227;1;3;524;527
43;Tarragona;22;Montsià;43156;Ulldecona;2;1;1;;579;426;153;5;6;415;421
43;Tarragona;22;Montsià;43156;Ulldecona;2;2;1;;739;518;221;3;4;511;515
43;Tarragona;22;Montsià;43156;Ulldecona;3;1;1;;538;283;255;3;3;277;280
43;Tarragona;29;Priorat;43157;Ulldemolins;1;1;1;;449;386;63;3;0;383;383
17;Girona;10;Baix Empordà;17203;Ultramort;1;1;1;;182;134;48;0;0;134;134
17;Girona;15;Cerdanya;17206;Urús;1;1;1;;77;65;12;0;0;65;65
8;Barcelona;40;Vallès Occidental;08291;Vacarisses;1;1;1;;372;284;88;2;0;282;282
17;Girona;2;Alt Empordà;17014;Vajol, la;1;1;1;;60;43;17;0;0;43;43
8;Barcelona;6;Anoia;08292;Vallbona d'Anoia;1;1;1;;790;630;160;4;1;625;626
25;Lleida;38;Urgell;25238;Vallbona de les Monges;1;1;1;;240;160;80;1;2;157;159
8;Barcelona;14;Berguedà;08293;Vallcebre;1;1;1;;300;190;110;2;1;187;188
43;Tarragona;16;Conca de Barberà;43158;Vallclara;1;1;1;;68;48;20;1;0;47;47
17;Girona;19;Garrotxa;17207;Vall d'en Bas, la;1;1;1;;390;273;117;0;1;272;273
17;Girona;19;Garrotxa;17207;Vall d'en Bas, la;1;1;2;;401;262;139;4;2;256;258
17;Girona;19;Garrotxa;17207;Vall d'en Bas, la;1;2;1;;259;203;56;0;6;197;203
17;Girona;19;Garrotxa;17207;Vall d'en Bas, la;1;3;1;;342;230;112;0;2;228;230
17;Girona;19;Garrotxa;17207;Vall d'en Bas, la;1;3;2;;321;226;95;1;0;225;225
17;Girona;19;Garrotxa;17207;Vall d'en Bas, la;1;4;1;;253;161;92;1;1;159;160
17;Girona;19;Garrotxa;17207;Vall d'en Bas, la;1;5;1;;152;99;53;4;0;95;95
17;Girona;19;Garrotxa;17208;Vall de Bianya, la;1;1;1;;470;292;178;2;2;288;290
17;Girona;19;Garrotxa;17208;Vall de Bianya, la;1;2;1;;427;320;107;3;0;317;317
25;Lleida;5;Alta Ribagorça;25043;Vall de Boí, la;1;1;1;;527;250;277;0;0;250;250
25;Lleida;26;Pallars Sobirà;25901;Vall de Cardós;1;1;1;;327;233;94;0;0;233;233
25;Lleida;23;Noguera;25240;Vallfogona de Balaguer;1;1;1;;1052;709;343;1;2;706;708
17;Girona;31;Ripollès;17170;Vallfogona de Ripollès;1;1;1;;222;154;68;0;0;154;154
43;Tarragona;16;Conca de Barberà;43159;Vallfogona de Riucorb;1;1;1;;110;86;24;0;0;86;86
8;Barcelona;41;Vallès Oriental;08294;Vallgorguina;1;1;1;;477;363;114;2;0;361;361
8;Barcelona;11;Baix Llobregat;08295;Vallirana;1;1;1;;923;589;334;1;1;587;588
8;Barcelona;11;Baix Llobregat;08295;Vallirana;1;1;2;;787;562;225;1;1;560;561
8;Barcelona;11;Baix Llobregat;08295;Vallirana;1;2;1;;773;515;258;1;2;512;514
8;Barcelona;11;Baix Llobregat;08295;Vallirana;1;2;2;;725;496;229;2;3;491;494
17;Girona;10;Baix Empordà;17209;Vall-llobrega;1;1;1;;141;116;25;0;0;116;116
43;Tarragona;1;Alt Camp;43160;Vallmoll;1;1;1;;720;553;167;9;2;542;544
8;Barcelona;41;Vallès Oriental;08296;Vallromanes;1;1;1;;304;243;61;1;1;241;242
43;Tarragona;1;Alt Camp;43161;Valls;1;1;1;;655;470;185;5;2;463;465
43;Tarragona;1;Alt Camp;43161;Valls;1;1;2;;572;458;114;4;0;454;454
43;Tarragona;1;Alt Camp;43161;Valls;2;1;1;;514;373;141;2;2;369;371
43;Tarragona;1;Alt Camp;43161;Valls;2;1;2;;514;391;123;0;1;390;391
43;Tarragona;1;Alt Camp;43161;Valls;3;1;1;;875;643;232;2;1;640;641
43;Tarragona;1;Alt Camp;43161;Valls;3;1;2;;840;653;187;4;3;646;649
43;Tarragona;1;Alt Camp;43161;Valls;4;1;1;;608;393;215;1;0;392;392
43;Tarragona;1;Alt Camp;43161;Valls;4;1;2;;651;477;174;3;1;473;474
43;Tarragona;1;Alt Camp;43161;Valls;4;2;1;;828;682;146;0;3;679;682
43;Tarragona;1;Alt Camp;43161;Valls;4;3;1;;462;393;69;1;0;392;392
43;Tarragona;1;Alt Camp;43161;Valls;5;1;1;;886;697;189;3;7;687;694
43;Tarragona;1;Alt Camp;43161;Valls;5;1;2;;887;737;150;1;3;733;736
43;Tarragona;1;Alt Camp;43161;Valls;5;2;1;;890;648;242;3;2;643;645
43;Tarragona;1;Alt Camp;43161;Valls;5;2;2;;891;674;217;1;1;672;673
43;Tarragona;1;Alt Camp;43161;Valls;5;3;1;;114;98;16;0;0;98;98
43;Tarragona;1;Alt Camp;43161;Valls;6;1;1;;1468;1075;393;18;3;1054;1057
43;Tarragona;1;Alt Camp;43161;Valls;6;2;1;;1169;848;321;1;0;847;847
43;Tarragona;1;Alt Camp;43161;Valls;6;2;2;;1066;810;256;2;2;806;808
25;Lleida;4;Alt Urgell;25906;Valls d'Aguilar, les;1;1;1;;275;119;156;0;1;118;119
25;Lleida;4;Alt Urgell;25239;Valls de Valira, les;1;1;1;;695;357;338;1;0;356;356
43;Tarragona;8;Baix Camp;43162;Vandellòs i l'Hospitalet de l'Infant;1;1;1;;966;583;383;3;5;575;580
43;Tarragona;8;Baix Camp;43162;Vandellòs i l'Hospitalet de l'Infant;1;2;1;;1155;686;469;5;9;672;681
43;Tarragona;8;Baix Camp;43162;Vandellòs i l'Hospitalet de l'Infant;1;3;1;;701;452;249;4;6;442;448
25;Lleida;4;Alt Urgell;25909;Vansa i Fórnols, la;1;1;1;;169;90;79;0;0;90;90
8;Barcelona;6;Anoia;08297;Veciana;1;1;1;;173;100;73;0;0;100;100
43;Tarragona;12;Baix Penedès;43163;Vendrell, el;1;1;1;;605;411;194;2;3;406;409
43;Tarragona;12;Baix Penedès;43163;Vendrell, el;1;1;2;;568;425;143;3;2;420;422
43;Tarragona;12;Baix Penedès;43163;Vendrell, el;1;2;1;;532;391;141;3;0;388;388
43;Tarragona;12;Baix Penedès;43163;Vendrell, el;1;2;2;;527;373;154;0;2;371;373
43;Tarragona;12;Baix Penedès;43163;Vendrell, el;2;1;1;;485;353;132;3;1;349;350
43;Tarragona;12;Baix Penedès;43163;Vendrell, el;2;1;2;;510;367;143;1;4;362;366
43;Tarragona;12;Baix Penedès;43163;Vendrell, el;2;2;1;;512;365;147;2;6;357;363
43;Tarragona;12;Baix Penedès;43163;Vendrell, el;2;2;2;;691;485;206;5;0;480;480
43;Tarragona;12;Baix Penedès;43163;Vendrell, el;2;3;1;;614;375;239;2;1;372;373
43;Tarragona;12;Baix Penedès;43163;Vendrell, el;2;3;2;;698;419;279;1;2;416;418
43;Tarragona;12;Baix Penedès;43163;Vendrell, el;3;1;1;;709;509;200;4;0;505;505
43;Tarragona;12;Baix Penedès;43163;Vendrell, el;3;1;2;;808;571;237;2;7;562;569
43;Tarragona;12;Baix Penedès;43163;Vendrell, el;3;2;1;;583;365;218;0;0;365;365
43;Tarragona;12;Baix Penedès;43163;Vendrell, el;3;2;2;;563;344;219;7;0;337;337
43;Tarragona;12;Baix Penedès;43163;Vendrell, el;3;3;1;;794;435;359;1;2;432;434
17;Girona;2;Alt Empordà;17210;Ventalló;1;1;1;;412;285;127;9;2;274;276
25;Lleida;38;Urgell;25242;Verdú;1;1;1;;796;568;228;2;0;566;566
17;Girona;10;Baix Empordà;17211;Verges;1;1;1;;928;665;263;28;6;631;637
43;Tarragona;36;Tarragonès;43164;Vespella de Gaià;1;1;1;;68;51;17;0;1;50;51
8;Barcelona;24;Osona;08298;Vic;1;1;1;;948;673;275;4;2;667;669
8;Barcelona;24;Osona;08298;Vic;1;2;1;;1040;704;336;2;3;699;702
8;Barcelona;24;Osona;08298;Vic;1;3;1;;823;668;155;0;1;667;668
8;Barcelona;24;Osona;08298;Vic;2;1;1;;996;696;300;1;6;689;695
8;Barcelona;24;Osona;08298;Vic;2;2;1;;1118;816;302;3;2;811;813
8;Barcelona;24;Osona;08298;Vic;2;2;2;;1305;1036;269;4;1;1031;1032
8;Barcelona;24;Osona;08298;Vic;2;3;1;;1454;1073;381;0;2;1071;1073
8;Barcelona;24;Osona;08298;Vic;3;1;1;;1077;797;280;3;2;792;794
8;Barcelona;24;Osona;08298;Vic;3;1;2;;1253;943;310;6;3;934;937
8;Barcelona;24;Osona;08298;Vic;3;2;1;;1104;819;285;4;0;815;815
8;Barcelona;24;Osona;08298;Vic;3;3;1;;1861;1282;579;3;5;1274;1279
8;Barcelona;24;Osona;08298;Vic;3;4;1;;1896;1287;609;1;3;1283;1286
8;Barcelona;24;Osona;08298;Vic;3;5;1;;1979;1278;701;3;3;1272;1275
8;Barcelona;24;Osona;08298;Vic;3;6;1;;1592;1104;488;1;0;1103;1103
8;Barcelona;24;Osona;08298;Vic;4;1;1;;1197;799;398;1;0;798;798
8;Barcelona;24;Osona;08298;Vic;4;1;2;;1602;1091;511;0;8;1083;1091
8;Barcelona;24;Osona;08298;Vic;4;2;1;;1275;882;393;0;2;880;882
8;Barcelona;24;Osona;08298;Vic;4;3;1;;362;271;91;2;1;268;269
8;Barcelona;24;Osona;08298;Vic;5;1;1;;456;359;97;1;0;358;358
17;Girona;24;Osona;17212;Vidrà;1;1;1;;160;105;55;2;0;103;103
17;Girona;34;Selva;17213;Vidreres;1;1;1;;1147;867;280;4;1;862;863
17;Girona;34;Selva;17213;Vidreres;1;2;1;;673;472;201;1;1;470;471
17;Girona;34;Selva;17213;Vidreres;1;3;1;;616;413;203;2;2;409;411
25;Lleida;39;Consell General d'Aran;25243;Vielha e Mijaran;1;1;1;;1371;903;468;2;3;898;901
25;Lleida;39;Consell General d'Aran;25243;Vielha e Mijaran;1;2;1;;250;176;74;0;0;176;176
25;Lleida;39;Consell General d'Aran;25243;Vielha e Mijaran;1;2;2;;241;139;102;0;0;139;139
25;Lleida;39;Consell General d'Aran;25243;Vielha e Mijaran;1;2;3;;54;43;11;0;0;43;43
25;Lleida;39;Consell General d'Aran;25243;Vielha e Mijaran;1;2;4;;128;95;33;0;0;95;95
25;Lleida;39;Consell General d'Aran;25243;Vielha e Mijaran;1;2;5;;74;58;16;0;0;58;58
43;Tarragona;1;Alt Camp;43165;Vilabella;1;1;1;;646;525;121;2;1;522;523
17;Girona;2;Alt Empordà;17214;Vilabertran;1;1;1;;656;416;240;0;2;414;416
17;Girona;20;Gironès;17215;Vilablareix;1;1;1;;580;447;133;1;2;444;446
8;Barcelona;14;Berguedà;08299;Vilada;1;1;1;;503;372;131;2;0;370;370
17;Girona;2;Alt Empordà;17217;Viladamat;1;1;1;;309;215;94;1;0;214;214
17;Girona;20;Gironès;17216;Viladasens;1;1;1;;157;104;53;0;1;103;104
8;Barcelona;11;Baix Llobregat;08301;Viladecans;1;1;1;;843;451;392;5;0;446;446
8;Barcelona;11;Baix Llobregat;08301;Viladecans;1;1;2;;822;457;365;0;0;457;457
8;Barcelona;11;Baix Llobregat;08301;Viladecans;1;10;1;;677;417;260;6;3;408;411
8;Barcelona;11;Baix Llobregat;08301;Viladecans;1;10;2;;631;382;249;13;2;367;369
8;Barcelona;11;Baix Llobregat;08301;Viladecans;1;2;1;;548;306;242;5;1;300;301
8;Barcelona;11;Baix Llobregat;08301;Viladecans;1;2;2;;721;410;311;13;0;397;397
8;Barcelona;11;Baix Llobregat;08301;Viladecans;1;3;1;;1053;648;405;3;5;640;645
8;Barcelona;11;Baix Llobregat;08301;Viladecans;1;3;2;;943;560;383;8;2;550;552
8;Barcelona;11;Baix Llobregat;08301;Viladecans;1;4;1;;1091;647;444;9;3;635;638
8;Barcelona;11;Baix Llobregat;08301;Viladecans;1;5;1;;584;362;222;3;1;358;359
8;Barcelona;11;Baix Llobregat;08301;Viladecans;1;6;1;;1306;732;574;20;0;712;712
8;Barcelona;11;Baix Llobregat;08301;Viladecans;1;7;1;;1106;681;425;12;1;668;669
8;Barcelona;11;Baix Llobregat;08301;Viladecans;1;8;1;;795;497;298;0;1;496;497
8;Barcelona;11;Baix Llobregat;08301;Viladecans;1;8;2;;903;521;382;6;5;510;515
8;Barcelona;11;Baix Llobregat;08301;Viladecans;1;9;1;;833;527;306;4;4;519;523
8;Barcelona;11;Baix Llobregat;08301;Viladecans;2;1;1;;997;493;504;3;2;488;490
8;Barcelona;11;Baix Llobregat;08301;Viladecans;2;1;2;;997;502;495;21;0;481;481
8;Barcelona;11;Baix Llobregat;08301;Viladecans;2;10;1;;974;521;453;7;1;513;514
8;Barcelona;11;Baix Llobregat;08301;Viladecans;2;10;2;;1119;590;529;2;0;588;588
8;Barcelona;11;Baix Llobregat;08301;Viladecans;2;2;1;;817;479;338;8;3;468;471
8;Barcelona;11;Baix Llobregat;08301;Viladecans;2;2;2;;754;450;304;0;2;448;450
8;Barcelona;11;Baix Llobregat;08301;Viladecans;2;3;1;;1129;628;501;1;4;623;627
8;Barcelona;11;Baix Llobregat;08301;Viladecans;2;4;1;;810;426;384;4;5;417;422
8;Barcelona;11;Baix Llobregat;08301;Viladecans;2;4;2;;820;446;374;13;0;433;433
8;Barcelona;11;Baix Llobregat;08301;Viladecans;2;5;1;;915;541;374;1;2;538;540
8;Barcelona;11;Baix Llobregat;08301;Viladecans;2;5;2;;976;587;389;2;3;582;585
8;Barcelona;11;Baix Llobregat;08301;Viladecans;2;6;1;;634;369;265;7;3;359;362
8;Barcelona;11;Baix Llobregat;08301;Viladecans;2;6;2;;617;354;263;5;2;347;349
8;Barcelona;11;Baix Llobregat;08301;Viladecans;2;6;3;;380;219;161;4;0;215;215
8;Barcelona;11;Baix Llobregat;08301;Viladecans;2;7;1;;600;352;248;4;4;344;348
8;Barcelona;11;Baix Llobregat;08301;Viladecans;2;7;2;;568;338;230;0;2;336;338
8;Barcelona;11;Baix Llobregat;08301;Viladecans;2;8;1;;1089;498;591;11;7;480;487
8;Barcelona;11;Baix Llobregat;08301;Viladecans;2;8;2;;1073;493;580;17;3;473;476
8;Barcelona;11;Baix Llobregat;08301;Viladecans;2;9;1;;1047;517;530;14;2;501;503
8;Barcelona;11;Baix Llobregat;08301;Viladecans;2;9;2;;968;509;459;19;2;488;490
8;Barcelona;40;Vallès Occidental;08300;Viladecavalls;1;1;1;;612;446;166;7;2;437;439
8;Barcelona;40;Vallès Occidental;08300;Viladecavalls;1;1;2;;629;380;249;5;3;372;375
17;Girona;28;Pla de l'Estany;17218;Vilademuls;1;1;1;;314;217;97;2;3;212;215
17;Girona;28;Pla de l'Estany;17218;Vilademuls;1;1;2;;352;266;86;0;3;263;266
17;Girona;24;Osona;17220;Viladrau;1;1;1;;589;527;62;0;0;527;527
17;Girona;2;Alt Empordà;17221;Vilafant;1;1;1;;1154;734;420;14;6;714;720
8;Barcelona;3;Alt Penedès;08305;Vilafranca del Penedès;1;1;1;;729;513;216;2;4;507;511
8;Barcelona;3;Alt Penedès;08305;Vilafranca del Penedès;1;1;2;;739;542;197;1;1;540;541
8;Barcelona;3;Alt Penedès;08305;Vilafranca del Penedès;1;2;1;;734;508;226;2;3;503;506
8;Barcelona;3;Alt Penedès;08305;Vilafranca del Penedès;1;2;2;;766;528;238;21;2;505;507
8;Barcelona;3;Alt Penedès;08305;Vilafranca del Penedès;2;1;1;;1216;811;405;3;2;806;808
8;Barcelona;3;Alt Penedès;08305;Vilafranca del Penedès;2;1;2;;1244;862;382;7;0;855;855
8;Barcelona;3;Alt Penedès;08305;Vilafranca del Penedès;2;2;1;;1025;681;344;2;4;675;679
8;Barcelona;3;Alt Penedès;08305;Vilafranca del Penedès;2;2;2;;1023;741;282;4;2;735;737
8;Barcelona;3;Alt Penedès;08305;Vilafranca del Penedès;2;3;1;;824;539;285;7;5;527;532
8;Barcelona;3;Alt Penedès;08305;Vilafranca del Penedès;2;3;2;;794;519;275;3;3;513;516
8;Barcelona;3;Alt Penedès;08305;Vilafranca del Penedès;3;1;1;;1366;951;415;1;7;943;950
8;Barcelona;3;Alt Penedès;08305;Vilafranca del Penedès;3;1;2;;1348;960;388;3;9;948;957
8;Barcelona;3;Alt Penedès;08305;Vilafranca del Penedès;3;2;1;;845;718;127;4;11;703;714
8;Barcelona;3;Alt Penedès;08305;Vilafranca del Penedès;4;1;1;;835;618;217;2;5;611;616
8;Barcelona;3;Alt Penedès;08305;Vilafranca del Penedès;4;1;2;;811;617;194;1;3;613;616
8;Barcelona;3;Alt Penedès;08305;Vilafranca del Penedès;4;2;1;;968;683;285;0;1;682;683
8;Barcelona;3;Alt Penedès;08305;Vilafranca del Penedès;4;2;2;;939;699;240;0;2;697;699
8;Barcelona;3;Alt Penedès;08305;Vilafranca del Penedès;4;3;1;;1079;807;272;1;6;800;806
8;Barcelona;3;Alt Penedès;08305;Vilafranca del Penedès;4;3;2;;1083;792;291;2;7;783;790
25;Lleida;38;Urgell;25244;Vilagrassa;1;1;1;;367;274;93;1;1;272;273
17;Girona;2;Alt Empordà;17223;Vilajuïga;1;1;1;;584;421;163;2;5;414;419
43;Tarragona;37;Terra Alta;43175;Vilalba dels Arcs;1;1;1;;646;551;95;5;3;543;546
8;Barcelona;41;Vallès Oriental;08306;Vilalba Sasserra;1;1;1;;179;135;44;0;0;135;135
25;Lleida;5;Alta Ribagorça;25245;Vilaller;1;1;1;;620;320;300;1;0;319;319
43;Tarragona;36;Tarragonès;43166;Vilallonga del Camp;1;1;1;;852;646;206;11;0;635;635
17;Girona;31;Ripollès;17224;Vilallonga de Ter;1;1;1;;391;318;73;0;2;316;318
17;Girona;2;Alt Empordà;17225;Vilamacolum;1;1;1;;226;158;68;0;2;156;158
17;Girona;2;Alt Empordà;17226;Vilamalla;1;1;1;;301;210;91;1;1;208;209
17;Girona;2;Alt Empordà;17227;Vilamaniscle;1;1;1;;97;74;23;0;0;74;74
25;Lleida;39;Consell General d'Aran;25247;Vilamòs;1;1;1;;70;49;21;0;0;49;49
17;Girona;2;Alt Empordà;17228;Vilanant;1;1;1;;222;132;90;0;2;130;132
43;Tarragona;8;Baix Camp;43167;Vilanova d'Escornalbou;1;1;1;;323;268;55;0;0;268;268
25;Lleida;27;Pla d'Urgell;25248;Vilanova de Bellpuig;1;1;1;;1036;785;251;3;6;776;782
25;Lleida;23;Noguera;25249;Vilanova de l'Aguda;1;1;1;;267;155;112;1;0;154;154
25;Lleida;33;Segrià;25254;Vilanova de la Barca;1;1;1;;742;577;165;4;3;570;573
8;Barcelona;6;Anoia;08302;Vilanova del Camí;1;1;1;;1199;779;420;8;11;760;771
8;Barcelona;6;Anoia;08302;Vilanova del Camí;1;2;1;;1058;675;383;0;4;671;675
8;Barcelona;6;Anoia;08302;Vilanova del Camí;1;2;2;;1207;760;447;0;4;756;760
8;Barcelona;6;Anoia;08302;Vilanova del Camí;1;3;1;;1129;747;382;0;2;745;747
8;Barcelona;6;Anoia;08302;Vilanova del Camí;1;3;2;;1178;771;407;4;2;765;767
25;Lleida;23;Noguera;25250;Vilanova de Meià;1;1;1;;451;357;94;0;1;356;357
43;Tarragona;16;Conca de Barberà;43168;Vilanova de Prades;1;1;1;;135;107;28;0;2;105;107
8;Barcelona;24;Osona;08303;Vilanova de Sau;1;1;1;;256;192;64;0;0;192;192
25;Lleida;33;Segrià;25251;Vilanova de Segrià;1;1;1;;545;330;215;0;0;330;330
8;Barcelona;17;Garraf;08307;Vilanova i la Geltrú;1;1;1;;1259;660;599;1;6;653;659
8;Barcelona;17;Garraf;08307;Vilanova i la Geltrú;1;1;2;;1137;651;486;2;2;647;649
8;Barcelona;17;Garraf;08307;Vilanova i la Geltrú;1;2;1;;1728;1144;584;1;7;1136;1143
8;Barcelona;17;Garraf;08307;Vilanova i la Geltrú;1;3;1;;1139;757;382;4;2;751;753
8;Barcelona;17;Garraf;08307;Vilanova i la Geltrú;1;3;2;;679;484;195;2;2;480;482
8;Barcelona;17;Garraf;08307;Vilanova i la Geltrú;1;4;1;;885;652;233;4;3;645;648
8;Barcelona;17;Garraf;08307;Vilanova i la Geltrú;1;5;1;;1008;687;321;4;3;680;683
8;Barcelona;17;Garraf;08307;Vilanova i la Geltrú;1;6;1;;1172;775;397;1;4;770;774
8;Barcelona;17;Garraf;08307;Vilanova i la Geltrú;1;7;1;;978;639;339;0;2;637;639
8;Barcelona;17;Garraf;08307;Vilanova i la Geltrú;1;7;2;;498;303;195;0;0;303;303
8;Barcelona;17;Garraf;08307;Vilanova i la Geltrú;1;8;1;;1438;869;569;5;2;862;864
8;Barcelona;17;Garraf;08307;Vilanova i la Geltrú;2;1;1;;718;496;222;0;0;496;496
8;Barcelona;17;Garraf;08307;Vilanova i la Geltrú;2;2;1;;1448;923;525;3;4;916;920
8;Barcelona;17;Garraf;08307;Vilanova i la Geltrú;2;3;1;;734;515;219;2;0;513;513
8;Barcelona;17;Garraf;08307;Vilanova i la Geltrú;2;4;1;;1054;655;399;3;2;650;652
8;Barcelona;17;Garraf;08307;Vilanova i la Geltrú;2;4;2;;618;403;215;0;4;399;403
8;Barcelona;17;Garraf;08307;Vilanova i la Geltrú;2;5;1;;1403;848;555;0;0;848;848
8;Barcelona;17;Garraf;08307;Vilanova i la Geltrú;3;1;1;;768;531;237;0;0;531;531
8;Barcelona;17;Garraf;08307;Vilanova i la Geltrú;3;2;1;;956;652;304;4;1;647;648
8;Barcelona;17;Garraf;08307;Vilanova i la Geltrú;3;3;1;;809;524;285;1;1;522;523
8;Barcelona;17;Garraf;08307;Vilanova i la Geltrú;3;4;1;;952;598;354;0;1;597;598
8;Barcelona;17;Garraf;08307;Vilanova i la Geltrú;3;4;2;;505;318;187;1;1;316;317
8;Barcelona;17;Garraf;08307;Vilanova i la Geltrú;3;5;1;;934;509;425;2;2;505;507
8;Barcelona;17;Garraf;08307;Vilanova i la Geltrú;4;1;1;;1081;753;328;2;2;749;751
8;Barcelona;17;Garraf;08307;Vilanova i la Geltrú;4;2;1;;856;562;294;6;1;555;556
8;Barcelona;17;Garraf;08307;Vilanova i la Geltrú;4;3;1;;1114;606;508;3;1;602;603
8;Barcelona;17;Garraf;08307;Vilanova i la Geltrú;4;4;1;;1180;763;417;4;4;755;759
8;Barcelona;17;Garraf;08307;Vilanova i la Geltrú;4;4;2;;640;425;215;1;0;424;424
8;Barcelona;17;Garraf;08307;Vilanova i la Geltrú;4;5;1;;872;516;356;0;2;514;516
8;Barcelona;17;Garraf;08307;Vilanova i la Geltrú;4;5;2;;424;289;135;1;1;287;288
8;Barcelona;17;Garraf;08307;Vilanova i la Geltrú;4;6;1;;1235;823;412;2;3;818;821
8;Barcelona;17;Garraf;08307;Vilanova i la Geltrú;4;6;2;;703;455;248;2;2;451;453
8;Barcelona;17;Garraf;08307;Vilanova i la Geltrú;4;7;1;;1397;815;582;3;4;808;812
8;Barcelona;17;Garraf;08307;Vilanova i la Geltrú;4;7;2;;824;506;318;0;0;506;506
8;Barcelona;17;Garraf;08307;Vilanova i la Geltrú;4;8;1;;952;619;333;3;2;614;616
43;Tarragona;8;Baix Camp;43169;Vilaplana;1;1;1;;415;311;104;5;0;306;306
43;Tarragona;1;Alt Camp;43170;Vila-rodona;1;1;1;;865;647;218;6;6;635;641
17;Girona;2;Alt Empordà;17230;Vila-sacra;1;1;1;;304;220;84;2;1;217;218
25;Lleida;27;Pla d'Urgell;25252;Vila-sana;1;1;1;;431;269;162;0;1;268;269
43;Tarragona;36;Tarragonès;43171;Vila-seca;1;1;1;;812;506;306;2;1;503;504
43;Tarragona;36;Tarragonès;43171;Vila-seca;1;10;1;;305;142;163;0;1;141;142
43;Tarragona;36;Tarragonès;43171;Vila-seca;1;11;1;;644;306;338;3;0;303;303
43;Tarragona;36;Tarragonès;43171;Vila-seca;1;11;2;;560;263;297;0;3;260;263
43;Tarragona;36;Tarragonès;43171;Vila-seca;1;12;1;;735;368;367;6;0;362;362
43;Tarragona;36;Tarragonès;43171;Vila-seca;1;12;2;;565;296;269;1;3;292;295
43;Tarragona;36;Tarragonès;43171;Vila-seca;1;13;1;;934;554;380;3;2;549;551
43;Tarragona;36;Tarragonès;43171;Vila-seca;1;14;1;;398;197;201;0;1;196;197
43;Tarragona;36;Tarragonès;43171;Vila-seca;1;2;1;;396;192;204;0;0;192;192
43;Tarragona;36;Tarragonès;43171;Vila-seca;1;3;1;;675;410;265;2;1;407;408
43;Tarragona;36;Tarragonès;43171;Vila-seca;1;3;2;;771;487;284;6;2;479;481
43;Tarragona;36;Tarragonès;43171;Vila-seca;1;4;1;;886;544;342;3;6;535;541
43;Tarragona;36;Tarragonès;43171;Vila-seca;1;5;1;;921;663;258;3;4;656;660
43;Tarragona;36;Tarragonès;43171;Vila-seca;1;6;1;;596;383;213;1;2;380;382
43;Tarragona;36;Tarragonès;43171;Vila-seca;1;6;2;;561;365;196;2;4;359;363
43;Tarragona;36;Tarragonès;43171;Vila-seca;1;7;1;;860;474;386;2;5;467;472
43;Tarragona;36;Tarragonès;43171;Vila-seca;1;8;1;;550;318;232;5;3;310;313
43;Tarragona;36;Tarragonès;43171;Vila-seca;1;9;1;;519;171;348;0;2;169;171
8;Barcelona;21;Maresme;08214;Vilassar de Dalt;1;1;1;;982;675;307;2;1;672;673
8;Barcelona;21;Maresme;08214;Vilassar de Dalt;1;1;2;;886;624;262;1;0;623;623
8;Barcelona;21;Maresme;08214;Vilassar de Dalt;1;2;1;;749;527;222;0;2;525;527
8;Barcelona;21;Maresme;08214;Vilassar de Dalt;2;1;1;;552;394;158;0;1;393;394
8;Barcelona;21;Maresme;08214;Vilassar de Dalt;2;2;1;;1005;724;281;1;0;723;723
8;Barcelona;21;Maresme;08219;Vilassar de Mar;1;1;1;;672;477;195;0;0;477;477
8;Barcelona;21;Maresme;08219;Vilassar de Mar;1;1;2;;624;443;181;1;0;442;442
8;Barcelona;21;Maresme;08219;Vilassar de Mar;1;2;1;;849;572;277;0;10;562;572
8;Barcelona;21;Maresme;08219;Vilassar de Mar;1;2;2;;862;586;276;0;4;582;586
8;Barcelona;21;Maresme;08219;Vilassar de Mar;2;1;1;;1042;729;313;2;4;723;727
8;Barcelona;21;Maresme;08219;Vilassar de Mar;2;1;2;;907;626;281;1;2;623;625
8;Barcelona;21;Maresme;08219;Vilassar de Mar;3;1;1;;816;589;227;1;1;587;588
8;Barcelona;21;Maresme;08219;Vilassar de Mar;3;2;1;;750;491;259;0;3;488;491
8;Barcelona;21;Maresme;08219;Vilassar de Mar;3;2;2;;586;402;184;1;0;401;401
17;Girona;2;Alt Empordà;17222;Vilaür;1;1;1;;99;71;28;0;0;71;71
43;Tarragona;16;Conca de Barberà;43172;Vilaverd;1;1;1;;344;294;50;5;0;289;289
43;Tarragona;29;Priorat;43173;Vilella Alta, la;1;1;1;;116;89;27;0;0;89;89
43;Tarragona;29;Priorat;43174;Vilella Baixa, la;1;1;1;;164;120;44;0;0;120;120
17;Girona;34;Selva;17233;Vilobí d'Onyar;1;1;1;;1300;927;373;15;1;911;912
8;Barcelona;3;Alt Penedès;08304;Vilobí del Penedès;1;1;1;;592;405;187;1;3;401;404
17;Girona;10;Baix Empordà;17232;Vilopriu;1;1;1;;161;102;59;0;0;102;102
25;Lleida;18;Garrigues;25253;Vilosell, el;1;1;1;;208;165;43;0;0;165;165
43;Tarragona;16;Conca de Barberà;43176;Vimbodí i Poblet;1;1;1;;920;620;300;7;0;613;613
25;Lleida;18;Garrigues;25255;Vinaixa;1;1;1;;612;469;143;3;2;464;466
43;Tarragona;30;Ribera d'Ebre;43177;Vinebre;1;1;1;;428;287;141;6;0;281;281
43;Tarragona;8;Baix Camp;43178;Vinyols i els Arcs;1;1;1;;615;478;137;8;1;469;470
8;Barcelona;14;Berguedà;08308;Viver i Serrateix;1;1;1;;175;146;29;0;0;146;146
43;Tarragona;9;Baix Ebre;43052;Xerta;1;1;1;;1035;744;291;4;11;729;740
