﻿Codi Província;Nom Província;Codi Comarca;Nom Comarca;Codi Municipi;Nom Municipi;Districte;Secció;Mesa;Població;Cens;Participació 13:00;Participació 18:00;Participació 20:00;Abstenció;Vots nuls;Vots en blanc;Vots a candidatures;Vots vàlids
25;Lleida;25;Pallars Jussà;25001;Abella de la Conca;1;1;U;;142;21;49;83;59;0;0;83;83
8;Barcelona;11;Baix Llobregat;08001;Abrera;1;1;A;;341;77;163;237;104;0;3;234;237
8;Barcelona;11;Baix Llobregat;08001;Abrera;1;1;B;;349;89;178;240;109;1;3;236;239
8;Barcelona;11;Baix Llobregat;08001;Abrera;1;1;C;;391;88;191;268;123;0;2;266;268
8;Barcelona;11;Baix Llobregat;08001;Abrera;1;2;A;;934;187;380;541;393;1;2;538;540
8;Barcelona;11;Baix Llobregat;08001;Abrera;1;2;B;;975;200;383;548;427;1;2;545;547
8;Barcelona;11;Baix Llobregat;08001;Abrera;1;3;U;;418;66;145;220;198;0;1;219;220
8;Barcelona;11;Baix Llobregat;08001;Abrera;1;4;U;;650;135;273;365;285;0;3;362;365
8;Barcelona;11;Baix Llobregat;08001;Abrera;1;5;A;;635;100;215;343;292;2;3;338;341
8;Barcelona;11;Baix Llobregat;08001;Abrera;1;5;B;;702;111;256;395;307;0;0;395;395
8;Barcelona;11;Baix Llobregat;08001;Abrera;1;7;U;;974;160;336;417;557;0;2;415;417
25;Lleida;23;Noguera;25002;Àger;1;1;U;;493;146;242;336;157;3;2;331;333
25;Lleida;38;Urgell;25003;Agramunt;1;1;U;;792;177;333;480;312;4;2;474;476
25;Lleida;38;Urgell;25003;Agramunt;1;2;U;;925;178;398;588;337;3;2;583;585
25;Lleida;38;Urgell;25003;Agramunt;1;3;U;;1095;194;435;656;439;5;10;641;651
25;Lleida;38;Urgell;25003;Agramunt;1;4;U;;1079;184;450;646;433;7;5;634;639
8;Barcelona;7;Bages;08002;Aguilar de Segarra;1;1;U;;183;51;86;124;59;0;0;124;124
17;Girona;2;Alt Empordà;17001;Agullana;1;1;U;;566;180;334;413;153;0;0;413;413
8;Barcelona;41;Vallès Oriental;08014;Aiguafreda;1;1;A;;779;202;440;559;220;0;7;552;559
8;Barcelona;41;Vallès Oriental;08014;Aiguafreda;1;1;B;;1044;293;610;759;285;3;6;750;756
43;Tarragona;1;Alt Camp;43001;Aiguamúrcia;1;1;A;;251;61;155;199;52;2;3;194;197
43;Tarragona;1;Alt Camp;43001;Aiguamúrcia;1;1;B;;268;45;127;185;83;2;0;183;183
17;Girona;20;Gironès;17002;Aiguaviva;1;1;U;;411;125;260;301;110;5;4;292;296
25;Lleida;33;Segrià;25038;Aitona;1;1;U;;842;244;470;585;257;0;4;581;585
25;Lleida;33;Segrià;25038;Aitona;1;2;U;;966;172;464;597;369;2;0;595;595
25;Lleida;33;Segrià;25004;Alamús, els;1;1;U;;596;168;360;459;137;0;1;458;459
25;Lleida;4;Alt Urgell;25005;Alàs i Cerc;1;1;U;;359;83;196;233;126;0;0;233;233
25;Lleida;18;Garrigues;25006;Albagés, l';1;1;U;;444;112;247;313;131;2;3;308;311
17;Girona;2;Alt Empordà;17003;Albanyà;1;1;U;;105;26;49;72;33;0;1;71;72
25;Lleida;33;Segrià;25007;Albatàrrec;1;1;U;;971;225;489;628;343;3;0;625;625
25;Lleida;23;Noguera;25008;Albesa;1;1;A;;648;94;275;418;230;1;8;409;417
25;Lleida;23;Noguera;25008;Albesa;1;1;B;;620;127;301;418;202;3;8;407;415
25;Lleida;18;Garrigues;25009;Albi, l';1;1;U;;677;152;376;497;180;0;1;496;497
43;Tarragona;12;Baix Penedès;43002;Albinyana;1;1;A;;340;120;214;266;74;0;1;265;266
43;Tarragona;12;Baix Penedès;43002;Albinyana;1;1;B;;853;216;429;524;329;3;6;515;521
43;Tarragona;8;Baix Camp;43003;Albiol, l';1;1;U;;139;31;59;82;57;0;1;81;82
17;Girona;10;Baix Empordà;17004;Albons;1;1;U;;477;171;271;336;141;2;3;331;334
43;Tarragona;22;Montsià;43004;Alcanar;1;1;U;;921;165;346;466;455;3;7;456;463
43;Tarragona;22;Montsià;43004;Alcanar;1;2;A;;484;93;192;274;210;1;4;269;273
43;Tarragona;22;Montsià;43004;Alcanar;1;2;B;;272;47;103;157;115;0;4;153;157
43;Tarragona;22;Montsià;43004;Alcanar;1;2;C;;577;110;229;331;246;0;8;323;331
43;Tarragona;22;Montsià;43004;Alcanar;1;3;U;;1089;215;408;507;582;0;4;503;507
43;Tarragona;22;Montsià;43004;Alcanar;1;4;U;;623;101;250;359;264;0;2;357;359
43;Tarragona;22;Montsià;43004;Alcanar;2;1;A;;561;103;204;279;282;2;2;275;277
43;Tarragona;22;Montsià;43004;Alcanar;2;1;B;;577;94;208;280;297;6;1;273;274
43;Tarragona;22;Montsià;43004;Alcanar;2;2;U;;722;170;320;378;344;1;1;376;377
43;Tarragona;22;Montsià;43004;Alcanar;2;3;U;;501;100;197;236;265;0;2;234;236
25;Lleida;33;Segrià;25010;Alcanó;1;1;U;;238;41;98;147;91;0;0;147;147
25;Lleida;33;Segrià;25011;Alcarràs;1;1;A;;889;165;430;554;335;0;0;554;554
25;Lleida;33;Segrià;25011;Alcarràs;1;1;B;;768;140;335;436;332;4;0;432;432
25;Lleida;33;Segrià;25011;Alcarràs;1;2;A;;819;165;367;452;367;2;1;449;450
25;Lleida;33;Segrià;25011;Alcarràs;1;2;B;;740;135;296;401;339;0;1;400;401
25;Lleida;33;Segrià;25011;Alcarràs;1;3;U;;689;112;289;370;319;1;2;367;369
25;Lleida;33;Segrià;25012;Alcoletge;1;1;A;;631;136;318;392;239;2;1;389;390
25;Lleida;33;Segrià;25012;Alcoletge;1;1;B;;768;148;379;467;301;1;5;461;466
43;Tarragona;1;Alt Camp;43005;Alcover;1;1;A;;820;132;330;486;334;2;4;480;484
43;Tarragona;1;Alt Camp;43005;Alcover;1;1;B;;856;154;370;504;352;0;4;500;504
43;Tarragona;1;Alt Camp;43005;Alcover;2;1;A;;672;107;259;351;321;2;2;347;349
43;Tarragona;1;Alt Camp;43005;Alcover;2;1;B;;679;116;275;372;307;0;3;369;372
43;Tarragona;9;Baix Ebre;43904;Aldea, l';1;1;A;;845;202;392;484;361;1;6;477;483
43;Tarragona;9;Baix Ebre;43904;Aldea, l';1;1;B;;773;199;330;403;370;5;2;396;398
43;Tarragona;9;Baix Ebre;43904;Aldea, l';1;2;A;;756;148;314;400;356;1;7;392;399
43;Tarragona;9;Baix Ebre;43904;Aldea, l';1;2;B;;558;119;225;300;258;1;4;295;299
43;Tarragona;9;Baix Ebre;43006;Aldover;1;1;U;;712;149;370;437;275;6;6;425;431
43;Tarragona;8;Baix Camp;43007;Aleixar, l';1;1;U;;607;139;308;398;209;6;2;390;392
8;Barcelona;21;Maresme;08003;Alella;1;1;A;;794;201;392;522;272;0;3;519;522
8;Barcelona;21;Maresme;08003;Alella;1;1;B;;829;214;459;559;270;2;6;551;557
8;Barcelona;21;Maresme;08003;Alella;1;2;A;;838;273;376;509;329;1;4;504;508
8;Barcelona;21;Maresme;08003;Alella;1;2;B;;998;211;444;569;429;2;5;562;567
8;Barcelona;21;Maresme;08003;Alella;1;3;A;;819;187;414;558;261;3;13;542;555
8;Barcelona;21;Maresme;08003;Alella;1;3;B;;898;207;458;610;288;3;9;598;607
8;Barcelona;21;Maresme;08003;Alella;1;4;A;;609;160;289;388;221;0;3;385;388
8;Barcelona;21;Maresme;08003;Alella;1;4;B;;685;164;325;420;265;0;5;415;420
43;Tarragona;9;Baix Ebre;43008;Alfara de Carles;1;1;U;;333;58;146;221;112;1;3;217;220
25;Lleida;33;Segrià;25013;Alfarràs;1;1;A;;647;143;307;423;224;0;2;421;423
25;Lleida;33;Segrià;25013;Alfarràs;1;1;B;;703;140;301;435;268;1;3;431;434
25;Lleida;33;Segrià;25013;Alfarràs;1;2;A;;492;113;209;287;205;0;2;285;287
25;Lleida;33;Segrià;25013;Alfarràs;1;2;B;;610;106;238;332;278;1;2;329;331
25;Lleida;33;Segrià;25014;Alfés;1;1;U;;293;75;165;203;90;0;4;199;203
43;Tarragona;8;Baix Camp;43009;Alforja;1;1;U;;1051;353;664;801;250;6;5;790;795
25;Lleida;23;Noguera;25015;Algerri;1;1;U;;464;115;250;333;131;3;1;329;330
25;Lleida;33;Segrià;25016;Alguaire;1;1;A;;648;158;302;410;238;1;0;409;409
25;Lleida;33;Segrià;25016;Alguaire;1;1;B;;706;181;310;401;305;1;0;400;400
25;Lleida;33;Segrià;25016;Alguaire;1;2;U;;988;137;397;562;426;0;0;562;562
25;Lleida;26;Pallars Sobirà;25017;Alins;1;1;U;;259;49;136;184;75;1;1;182;183
43;Tarragona;1;Alt Camp;43010;Alió;1;1;U;;284;71;178;216;68;1;2;213;215
25;Lleida;33;Segrià;25019;Almacelles;1;1;U;;765;180;327;452;313;1;8;443;451
25;Lleida;33;Segrià;25019;Almacelles;1;2;A;;633;135;254;365;268;2;2;361;363
25;Lleida;33;Segrià;25019;Almacelles;1;2;B;;765;162;306;449;316;1;4;444;448
25;Lleida;33;Segrià;25019;Almacelles;2;1;A;;523;145;225;299;224;1;2;296;298
25;Lleida;33;Segrià;25019;Almacelles;2;1;B;;645;168;293;399;246;1;4;394;398
25;Lleida;33;Segrià;25019;Almacelles;2;2;A;;593;128;245;335;258;2;2;331;333
25;Lleida;33;Segrià;25019;Almacelles;2;2;B;;684;132;261;339;345;0;3;336;339
25;Lleida;33;Segrià;25020;Almatret;1;1;U;;431;127;244;280;151;0;4;276;280
25;Lleida;33;Segrià;25021;Almenar;1;1;U;;806;162;349;416;390;0;3;413;416
25;Lleida;33;Segrià;25021;Almenar;2;1;U;;1117;205;487;688;429;2;3;683;686
25;Lleida;33;Segrià;25021;Almenar;2;2;U;;988;164;400;612;376;1;2;609;611
43;Tarragona;8;Baix Camp;43011;Almoster;1;1;U;;632;127;306;435;197;1;2;432;434
25;Lleida;23;Noguera;25022;Alòs de Balaguer;1;1;U;;175;52;102;137;38;0;1;136;137
17;Girona;15;Cerdanya;17006;Alp;1;1;U;;927;214;382;532;395;1;3;528;531
8;Barcelona;24;Osona;08004;Alpens;1;1;U;;218;63;141;172;46;0;1;171;172
25;Lleida;33;Segrià;25023;Alpicat;1;1;A;;704;138;314;427;277;0;4;423;427
25;Lleida;33;Segrià;25023;Alpicat;1;1;B;;802;155;350;468;334;0;6;462;468
25;Lleida;33;Segrià;25023;Alpicat;1;2;A;;753;173;336;471;282;0;8;463;471
25;Lleida;33;Segrià;25023;Alpicat;1;2;B;;852;189;382;548;304;2;8;538;546
43;Tarragona;36;Tarragonès;43012;Altafulla;1;1;A;;743;202;393;491;252;0;3;488;491
43;Tarragona;36;Tarragonès;43012;Altafulla;1;1;B;;837;218;449;590;247;1;5;584;589
43;Tarragona;36;Tarragonès;43012;Altafulla;1;2;U;;689;185;312;381;308;0;4;377;381
25;Lleida;26;Pallars Sobirà;25024;Alt Àneu;1;1;U;;352;85;174;228;124;0;1;227;228
17;Girona;34;Selva;17007;Amer;1;1;A;;610;203;363;436;174;3;1;432;433
17;Girona;34;Selva;17007;Amer;1;1;B;;597;197;354;428;169;1;1;426;427
17;Girona;34;Selva;17007;Amer;1;1;C;;692;205;392;498;194;3;5;490;495
8;Barcelona;41;Vallès Oriental;08005;Ametlla del Vallès, l';1;1;A;;489;132;233;327;162;0;5;322;327
8;Barcelona;41;Vallès Oriental;08005;Ametlla del Vallès, l';1;1;B;;481;123;255;293;188;0;4;289;293
8;Barcelona;41;Vallès Oriental;08005;Ametlla del Vallès, l';1;1;C;;487;110;232;301;186;0;4;297;301
8;Barcelona;41;Vallès Oriental;08005;Ametlla del Vallès, l';1;2;A;;544;149;320;385;159;0;1;384;385
8;Barcelona;41;Vallès Oriental;08005;Ametlla del Vallès, l';1;2;B;;579;141;311;391;188;1;4;386;390
8;Barcelona;41;Vallès Oriental;08005;Ametlla del Vallès, l';1;3;A;;534;133;250;340;194;0;5;335;340
8;Barcelona;41;Vallès Oriental;08005;Ametlla del Vallès, l';1;3;B;;520;117;216;314;206;2;1;311;312
8;Barcelona;41;Vallès Oriental;08005;Ametlla del Vallès, l';1;3;C;;533;115;263;338;195;0;3;335;338
43;Tarragona;9;Baix Ebre;43013;Ametlla de Mar, l';1;1;A;;582;203;324;394;188;1;5;388;393
43;Tarragona;9;Baix Ebre;43013;Ametlla de Mar, l';1;1;B;;647;245;372;455;192;0;5;450;455
43;Tarragona;9;Baix Ebre;43013;Ametlla de Mar, l';1;2;A;;573;212;352;421;152;3;1;417;418
43;Tarragona;9;Baix Ebre;43013;Ametlla de Mar, l';1;2;B;;523;187;310;359;164;0;0;359;359
43;Tarragona;9;Baix Ebre;43013;Ametlla de Mar, l';1;3;A;;494;132;245;305;189;0;2;303;305
43;Tarragona;9;Baix Ebre;43013;Ametlla de Mar, l';1;3;B;;482;145;236;300;182;0;1;299;300
43;Tarragona;9;Baix Ebre;43013;Ametlla de Mar, l';1;3;C;;504;114;206;260;244;2;1;257;258
43;Tarragona;9;Baix Ebre;43906;Ampolla, l';1;1;A;;676;184;340;458;218;3;0;455;455
43;Tarragona;9;Baix Ebre;43906;Ampolla, l';1;1;B;;313;95;170;220;93;1;1;218;219
43;Tarragona;9;Baix Ebre;43906;Ampolla, l';1;1;C;;412;127;216;291;121;1;4;286;290
43;Tarragona;22;Montsià;43014;Amposta;1;1;A;;373;106;173;215;158;2;0;213;213
43;Tarragona;22;Montsià;43014;Amposta;1;1;B;;418;156;236;278;140;0;0;278;278
43;Tarragona;22;Montsià;43014;Amposta;1;2;A;;534;157;274;348;186;0;6;342;348
43;Tarragona;22;Montsià;43014;Amposta;1;2;B;;582;189;293;375;207;0;1;374;375
43;Tarragona;22;Montsià;43014;Amposta;2;1;U;;805;321;485;576;229;2;11;563;574
43;Tarragona;22;Montsià;43014;Amposta;2;2;A;;376;122;221;256;120;2;0;254;254
43;Tarragona;22;Montsià;43014;Amposta;2;2;B;;387;134;215;260;127;2;4;254;258
43;Tarragona;22;Montsià;43014;Amposta;3;1;A;;510;124;237;297;213;1;3;293;296
43;Tarragona;22;Montsià;43014;Amposta;3;1;B;;485;132;243;307;178;0;6;301;307
43;Tarragona;22;Montsià;43014;Amposta;3;2;A;;593;143;265;342;251;0;5;337;342
43;Tarragona;22;Montsià;43014;Amposta;3;2;B;;668;160;307;381;287;0;3;378;381
43;Tarragona;22;Montsià;43014;Amposta;4;1;A;;583;189;289;382;201;1;6;375;381
43;Tarragona;22;Montsià;43014;Amposta;4;1;B;;671;209;342;411;260;0;7;404;411
43;Tarragona;22;Montsià;43014;Amposta;4;2;A;;845;195;344;458;387;3;6;449;455
43;Tarragona;22;Montsià;43014;Amposta;4;2;B;;668;170;290;377;291;4;2;371;373
43;Tarragona;22;Montsià;43014;Amposta;4;2;C;;772;176;330;441;331;0;5;436;441
43;Tarragona;22;Montsià;43014;Amposta;4;3;A;;635;174;310;395;240;1;7;387;394
43;Tarragona;22;Montsià;43014;Amposta;4;3;B;;499;108;197;289;210;0;1;288;289
43;Tarragona;22;Montsià;43014;Amposta;4;3;C;;652;186;314;402;250;2;2;398;400
43;Tarragona;22;Montsià;43014;Amposta;4;4;A;;826;189;370;483;343;1;5;477;482
43;Tarragona;22;Montsià;43014;Amposta;4;4;B;;604;112;248;330;274;0;0;330;330
43;Tarragona;22;Montsià;43014;Amposta;4;4;C;;811;175;337;444;367;2;1;441;442
17;Girona;34;Selva;17008;Anglès;1;1;A;;565;144;301;378;187;2;1;375;376
17;Girona;34;Selva;17008;Anglès;1;1;B;;581;143;332;403;178;5;4;394;398
17;Girona;34;Selva;17008;Anglès;1;2;A;;807;235;448;548;259;4;2;542;544
17;Girona;34;Selva;17008;Anglès;1;2;B;;797;236;461;562;235;5;2;555;557
17;Girona;34;Selva;17008;Anglès;1;3;A;;628;188;352;412;216;0;0;412;412
17;Girona;34;Selva;17008;Anglès;1;3;B;;640;211;356;429;211;0;1;428;429
25;Lleida;38;Urgell;25027;Anglesola;1;1;U;;1082;280;540;734;348;1;2;731;733
25;Lleida;18;Garrigues;25029;Arbeca;1;1;U;;944;254;495;652;292;10;9;633;642
25;Lleida;18;Garrigues;25029;Arbeca;1;2;U;;997;258;501;667;330;2;4;661;665
43;Tarragona;12;Baix Penedès;43016;Arboç, l';1;1;A;;559;157;285;376;183;2;3;371;374
43;Tarragona;12;Baix Penedès;43016;Arboç, l';1;1;B;;833;231;417;533;300;1;6;526;532
43;Tarragona;12;Baix Penedès;43016;Arboç, l';1;2;A;;677;163;326;448;229;3;2;443;445
43;Tarragona;12;Baix Penedès;43016;Arboç, l';1;2;B;;734;187;362;476;258;1;4;471;475
43;Tarragona;8;Baix Camp;43015;Arbolí;1;1;U;;122;27;55;75;47;0;0;75;75
17;Girona;34;Selva;17009;Arbúcies;1;1;A;;751;156;373;481;270;1;4;476;480
17;Girona;34;Selva;17009;Arbúcies;1;1;B;;818;194;479;564;254;2;0;562;562
17;Girona;34;Selva;17009;Arbúcies;1;2;A;;840;200;419;570;270;2;3;565;568
17;Girona;34;Selva;17009;Arbúcies;1;2;B;;769;199;427;560;209;1;2;557;559
17;Girona;34;Selva;17009;Arbúcies;2;1;U;;866;183;421;550;316;1;6;543;549
8;Barcelona;21;Maresme;08006;Arenys de Mar;1;1;A;;666;177;316;404;262;2;4;398;402
8;Barcelona;21;Maresme;08006;Arenys de Mar;1;1;B;;826;235;420;531;295;0;2;529;531
8;Barcelona;21;Maresme;08006;Arenys de Mar;1;2;A;;849;260;450;552;297;2;9;541;550
8;Barcelona;21;Maresme;08006;Arenys de Mar;1;2;B;;1006;290;486;623;383;1;5;617;622
8;Barcelona;21;Maresme;08006;Arenys de Mar;1;3;U;;1043;330;590;715;328;6;4;705;709
8;Barcelona;21;Maresme;08006;Arenys de Mar;2;1;A;;537;183;289;353;184;2;4;347;351
8;Barcelona;21;Maresme;08006;Arenys de Mar;2;1;B;;680;189;326;420;260;0;3;417;420
8;Barcelona;21;Maresme;08006;Arenys de Mar;2;2;A;;646;209;370;455;191;0;2;453;455
8;Barcelona;21;Maresme;08006;Arenys de Mar;2;2;B;;761;235;401;501;260;1;1;499;500
8;Barcelona;21;Maresme;08006;Arenys de Mar;2;3;A;;532;144;262;329;203;0;3;326;329
8;Barcelona;21;Maresme;08006;Arenys de Mar;2;3;B;;680;188;348;430;250;3;1;426;427
8;Barcelona;21;Maresme;08006;Arenys de Mar;2;4;A;;898;206;403;514;384;2;2;510;512
8;Barcelona;21;Maresme;08006;Arenys de Mar;2;4;B;;963;213;438;558;405;3;3;552;555
8;Barcelona;21;Maresme;08007;Arenys de Munt;1;1;U;;791;243;445;559;232;1;4;554;558
8;Barcelona;21;Maresme;08007;Arenys de Munt;1;2;A;;865;237;449;574;291;3;4;567;571
8;Barcelona;21;Maresme;08007;Arenys de Munt;1;2;B;;1047;284;531;694;353;0;7;687;694
8;Barcelona;21;Maresme;08007;Arenys de Munt;2;1;A;;508;139;284;352;156;0;1;351;352
8;Barcelona;21;Maresme;08007;Arenys de Munt;2;1;B;;630;180;358;472;158;0;2;470;472
8;Barcelona;21;Maresme;08007;Arenys de Munt;2;2;A;;532;100;254;330;202;0;3;327;330
8;Barcelona;21;Maresme;08007;Arenys de Munt;2;2;B;;694;159;328;432;262;1;4;427;431
17;Girona;19;Garrotxa;17010;Argelaguer;1;1;U;;301;103;173;200;101;3;2;195;197
8;Barcelona;6;Anoia;08008;Argençola;1;1;U;;185;60;97;128;57;2;5;121;126
43;Tarragona;8;Baix Camp;43017;Argentera, l';1;1;U;;135;14;68;87;48;0;3;84;87
8;Barcelona;21;Maresme;08009;Argentona;1;1;A;;947;228;462;602;345;5;5;592;597
8;Barcelona;21;Maresme;08009;Argentona;1;1;B;;1028;252;454;611;417;0;5;606;611
8;Barcelona;21;Maresme;08009;Argentona;1;2;A;;1028;263;550;703;325;2;2;699;701
8;Barcelona;21;Maresme;08009;Argentona;1;2;B;;1082;325;598;752;330;4;4;744;748
8;Barcelona;21;Maresme;08009;Argentona;1;3;A;;476;90;213;276;200;2;2;272;274
8;Barcelona;21;Maresme;08009;Argentona;1;3;B;;591;102;257;359;232;0;1;358;359
8;Barcelona;21;Maresme;08009;Argentona;2;1;A;;656;172;307;422;234;0;2;420;422
8;Barcelona;21;Maresme;08009;Argentona;2;1;B;;713;213;357;456;257;0;6;450;456
8;Barcelona;21;Maresme;08009;Argentona;2;2;A;;521;147;282;359;162;3;1;355;356
8;Barcelona;21;Maresme;08009;Argentona;2;2;B;;560;153;275;357;203;3;5;349;354
17;Girona;2;Alt Empordà;17011;Armentera, l';1;1;U;;638;219;416;490;148;0;9;481;490
43;Tarragona;37;Terra Alta;43018;Arnes;1;1;U;;468;160;307;365;103;2;3;360;363
25;Lleida;39;Consell General d'Aran;25031;Arres;1;1;U;;59;14;15;29;30;0;0;29;29
25;Lleida;4;Alt Urgell;25032;Arsèguel;1;1;U;;102;26;52;66;36;0;0;66;66
8;Barcelona;7;Bages;08010;Artés;1;1;A;;446;105;237;291;155;1;4;286;290
8;Barcelona;7;Bages;08010;Artés;1;1;B;;545;114;271;340;205;0;3;337;340
8;Barcelona;7;Bages;08010;Artés;2;1;A;;899;194;464;603;296;1;5;597;602
8;Barcelona;7;Bages;08010;Artés;2;1;B;;1124;258;563;755;369;2;6;747;753
8;Barcelona;7;Bages;08010;Artés;2;2;U;;566;170;321;413;153;1;3;409;412
25;Lleida;33;Segrià;25033;Artesa de Lleida;1;1;A;;587;151;301;406;181;0;0;406;406
25;Lleida;33;Segrià;25033;Artesa de Lleida;1;1;B;;524;139;267;344;180;1;2;341;343
25;Lleida;23;Noguera;25034;Artesa de Segre;1;1;A;;602;133;292;414;188;2;3;409;412
25;Lleida;23;Noguera;25034;Artesa de Segre;1;1;B;;722;135;335;470;252;3;4;463;467
25;Lleida;23;Noguera;25034;Artesa de Segre;1;2;U;;806;260;450;510;296;0;4;506;510
25;Lleida;23;Noguera;25034;Artesa de Segre;2;1;A;;310;53;125;174;136;0;2;172;174
25;Lleida;23;Noguera;25034;Artesa de Segre;2;1;B;;213;33;98;138;75;0;2;136;138
43;Tarragona;30;Ribera d'Ebre;43019;Ascó;1;1;A;;665;140;330;436;229;1;2;433;435
43;Tarragona;30;Ribera d'Ebre;43019;Ascó;1;1;B;;756;159;338;477;279;3;2;472;474
25;Lleida;33;Segrià;25036;Aspa;1;1;U;;235;74;147;171;64;0;6;165;171
25;Lleida;23;Noguera;25037;Avellanes i Santa Linya, les;1;1;U;;451;77;178;272;179;2;2;268;270
8;Barcelona;14;Berguedà;08011;Avià;1;1;A;;756;174;376;497;259;2;5;490;495
8;Barcelona;14;Berguedà;08011;Avià;1;1;B;;802;176;379;525;277;1;6;518;524
8;Barcelona;7;Bages;08012;Avinyó;1;1;A;;847;215;512;643;204;2;0;641;641
8;Barcelona;7;Bages;08012;Avinyó;1;1;B;;818;208;480;617;201;0;1;616;617
8;Barcelona;3;Alt Penedès;08013;Avinyonet del Penedès;1;1;U;;1040;200;503;691;349;2;1;688;689
17;Girona;2;Alt Empordà;17012;Avinyonet de Puigventós;1;1;U;;521;114;260;321;200;0;6;315;321
8;Barcelona;13;Barcelonès;08015;Badalona;1;1;U;;1097;270;577;734;363;3;6;725;731
8;Barcelona;13;Barcelonès;08015;Badalona;1;2;A;;511;144;285;341;170;0;4;337;341
8;Barcelona;13;Barcelonès;08015;Badalona;1;2;B;;592;165;338;404;188;1;2;401;403
8;Barcelona;13;Barcelonès;08015;Badalona;1;3;U;;834;257;465;563;271;0;3;560;563
8;Barcelona;13;Barcelonès;08015;Badalona;1;4;U;;720;211;396;483;237;0;4;479;483
8;Barcelona;13;Barcelonès;08015;Badalona;1;5;A;;649;228;384;474;175;0;1;473;474
8;Barcelona;13;Barcelonès;08015;Badalona;1;5;B;;721;248;418;508;213;1;14;493;507
8;Barcelona;13;Barcelonès;08015;Badalona;1;7;A;;517;151;288;355;162;0;4;351;355
8;Barcelona;13;Barcelonès;08015;Badalona;1;7;B;;616;158;323;400;216;0;7;393;400
8;Barcelona;13;Barcelonès;08015;Badalona;1;8;U;;634;197;376;445;189;2;5;438;443
8;Barcelona;13;Barcelonès;08015;Badalona;2;1;A;;579;148;257;317;262;0;1;316;317
8;Barcelona;13;Barcelonès;08015;Badalona;2;1;B;;662;173;307;388;274;0;1;387;388
8;Barcelona;13;Barcelonès;08015;Badalona;2;10;A;;634;152;265;347;287;0;3;344;347
8;Barcelona;13;Barcelonès;08015;Badalona;2;10;B;;749;162;261;372;377;0;2;370;372
8;Barcelona;13;Barcelonès;08015;Badalona;2;11;A;;684;145;248;346;338;3;0;343;343
8;Barcelona;13;Barcelonès;08015;Badalona;2;11;B;;801;162;314;424;377;0;2;422;424
8;Barcelona;13;Barcelonès;08015;Badalona;2;12;U;;987;200;389;438;549;3;3;432;435
8;Barcelona;13;Barcelonès;08015;Badalona;2;13;A;;516;86;180;239;277;1;3;235;238
8;Barcelona;13;Barcelonès;08015;Badalona;2;13;B;;650;113;246;322;328;1;2;319;321
8;Barcelona;13;Barcelonès;08015;Badalona;2;14;U;;514;110;233;294;220;1;3;290;293
8;Barcelona;13;Barcelonès;08015;Badalona;2;15;A;;504;130;221;277;227;2;1;274;275
8;Barcelona;13;Barcelonès;08015;Badalona;2;15;B;;614;148;227;290;324;1;0;289;289
8;Barcelona;13;Barcelonès;08015;Badalona;2;2;A;;687;173;357;437;250;0;3;434;437
8;Barcelona;13;Barcelonès;08015;Badalona;2;2;B;;715;193;381;485;230;2;5;478;483
8;Barcelona;13;Barcelonès;08015;Badalona;2;3;U;;764;218;416;502;262;1;9;492;501
8;Barcelona;13;Barcelonès;08015;Badalona;2;4;A;;820;218;433;567;253;0;4;563;567
8;Barcelona;13;Barcelonès;08015;Badalona;2;4;B;;900;246;480;605;295;0;4;601;605
8;Barcelona;13;Barcelonès;08015;Badalona;2;5;U;;546;156;253;315;231;0;5;310;315
8;Barcelona;13;Barcelonès;08015;Badalona;2;6;U;;625;151;234;291;334;0;4;287;291
8;Barcelona;13;Barcelonès;08015;Badalona;2;7;U;;689;132;256;336;353;0;2;334;336
8;Barcelona;13;Barcelonès;08015;Badalona;2;8;A;;614;177;319;400;214;1;3;396;399
8;Barcelona;13;Barcelonès;08015;Badalona;2;8;B;;552;195;295;355;197;1;7;347;354
8;Barcelona;13;Barcelonès;08015;Badalona;2;8;C;;656;171;328;422;234;1;9;412;421
8;Barcelona;13;Barcelonès;08015;Badalona;2;9;A;;500;120;198;247;253;0;0;247;247
8;Barcelona;13;Barcelonès;08015;Badalona;2;9;B;;577;164;243;284;293;0;0;284;284
8;Barcelona;13;Barcelonès;08015;Badalona;3;1;U;;690;150;264;321;369;0;2;319;321
8;Barcelona;13;Barcelonès;08015;Badalona;3;10;A;;509;133;274;330;179;0;1;329;330
8;Barcelona;13;Barcelonès;08015;Badalona;3;10;B;;567;111;255;335;232;4;1;330;331
8;Barcelona;13;Barcelonès;08015;Badalona;3;11;U;;887;222;430;519;368;0;4;515;519
8;Barcelona;13;Barcelonès;08015;Badalona;3;12;A;;526;144;274;350;176;0;11;339;350
8;Barcelona;13;Barcelonès;08015;Badalona;3;12;B;;618;168;316;392;226;1;2;389;391
8;Barcelona;13;Barcelonès;08015;Badalona;3;2;A;;592;137;276;351;241;1;3;347;350
8;Barcelona;13;Barcelonès;08015;Badalona;3;2;B;;683;149;295;385;298;0;1;384;385
8;Barcelona;13;Barcelonès;08015;Badalona;3;3;A;;591;151;280;332;259;0;1;331;332
8;Barcelona;13;Barcelonès;08015;Badalona;3;3;B;;713;183;345;406;307;1;5;400;405
8;Barcelona;13;Barcelonès;08015;Badalona;3;4;U;;902;263;451;554;348;1;5;548;553
8;Barcelona;13;Barcelonès;08015;Badalona;3;5;A;;586;127;230;314;272;1;4;309;313
8;Barcelona;13;Barcelonès;08015;Badalona;3;5;B;;640;138;257;349;291;0;3;346;349
8;Barcelona;13;Barcelonès;08015;Badalona;3;6;U;;850;255;473;590;260;1;4;585;589
8;Barcelona;13;Barcelonès;08015;Badalona;3;7;U;;874;254;474;600;274;0;14;586;600
8;Barcelona;13;Barcelonès;08015;Badalona;3;8;U;;537;154;286;335;202;0;3;332;335
8;Barcelona;13;Barcelonès;08015;Badalona;3;9;U;;483;150;244;306;177;0;2;304;306
8;Barcelona;13;Barcelonès;08015;Badalona;4;1;A;;640;91;215;311;329;0;4;307;311
8;Barcelona;13;Barcelonès;08015;Badalona;4;1;B;;795;140;265;385;410;0;5;380;385
8;Barcelona;13;Barcelonès;08015;Badalona;4;10;U;;1061;229;423;523;538;2;2;519;521
8;Barcelona;13;Barcelonès;08015;Badalona;4;11;A;;561;85;194;265;296;0;2;263;265
8;Barcelona;13;Barcelonès;08015;Badalona;4;11;B;;654;113;248;310;344;0;1;309;310
8;Barcelona;13;Barcelonès;08015;Badalona;4;12;U;;946;174;327;467;479;0;1;466;467
8;Barcelona;13;Barcelonès;08015;Badalona;4;13;U;;927;207;395;537;390;1;5;531;536
8;Barcelona;13;Barcelonès;08015;Badalona;4;14;A;;802;151;348;467;335;3;6;458;464
8;Barcelona;13;Barcelonès;08015;Badalona;4;14;B;;937;180;400;530;407;2;7;521;528
8;Barcelona;13;Barcelonès;08015;Badalona;4;2;A;;521;132;249;300;221;0;0;300;300
8;Barcelona;13;Barcelonès;08015;Badalona;4;2;B;;700;165;344;418;282;1;1;416;417
8;Barcelona;13;Barcelonès;08015;Badalona;4;3;U;;1047;241;462;607;440;2;7;598;605
8;Barcelona;13;Barcelonès;08015;Badalona;4;4;A;;571;122;260;324;247;1;2;321;323
8;Barcelona;13;Barcelonès;08015;Badalona;4;4;B;;657;135;293;376;281;0;0;376;376
8;Barcelona;13;Barcelonès;08015;Badalona;4;4;C;;605;134;249;325;280;0;8;317;325
8;Barcelona;13;Barcelonès;08015;Badalona;4;5;U;;953;227;410;517;436;5;2;510;512
8;Barcelona;13;Barcelonès;08015;Badalona;4;6;A;;616;141;234;284;332;1;2;281;283
8;Barcelona;13;Barcelonès;08015;Badalona;4;6;B;;829;189;341;421;408;0;4;417;421
8;Barcelona;13;Barcelonès;08015;Badalona;4;7;A;;614;117;273;360;254;3;5;352;357
8;Barcelona;13;Barcelonès;08015;Badalona;4;7;B;;714;169;334;425;289;1;3;421;424
8;Barcelona;13;Barcelonès;08015;Badalona;4;8;A;;625;140;261;321;304;0;2;319;321
8;Barcelona;13;Barcelonès;08015;Badalona;4;8;B;;742;169;334;402;340;1;4;397;401
8;Barcelona;13;Barcelonès;08015;Badalona;4;9;U;;741;162;514;439;302;0;6;433;439
8;Barcelona;13;Barcelonès;08015;Badalona;5;1;A;;731;217;406;501;230;0;2;499;501
8;Barcelona;13;Barcelonès;08015;Badalona;5;1;B;;891;266;500;595;296;1;8;586;594
8;Barcelona;13;Barcelonès;08015;Badalona;5;2;U;;904;247;505;630;274;0;5;625;630
8;Barcelona;13;Barcelonès;08015;Badalona;5;3;A;;766;193;351;456;310;0;2;454;456
8;Barcelona;13;Barcelonès;08015;Badalona;5;3;B;;786;173;366;480;306;0;1;479;480
8;Barcelona;13;Barcelonès;08015;Badalona;5;4;A;;863;196;353;439;424;2;0;437;437
8;Barcelona;13;Barcelonès;08015;Badalona;5;4;B;;867;202;369;472;395;1;6;465;471
8;Barcelona;13;Barcelonès;08015;Badalona;5;5;A;;563;168;281;361;202;1;1;359;360
8;Barcelona;13;Barcelonès;08015;Badalona;5;5;B;;619;164;288;360;259;0;5;355;360
8;Barcelona;13;Barcelonès;08015;Badalona;5;5;C;;568;137;234;344;224;1;3;340;343
8;Barcelona;13;Barcelonès;08015;Badalona;5;6;U;;1006;330;588;709;297;2;4;703;707
8;Barcelona;13;Barcelonès;08015;Badalona;6;1;A;;509;112;216;288;221;0;0;288;288
8;Barcelona;13;Barcelonès;08015;Badalona;6;1;B;;542;131;224;295;247;2;1;292;293
8;Barcelona;13;Barcelonès;08015;Badalona;6;2;A;;680;158;308;382;298;1;8;373;381
8;Barcelona;13;Barcelonès;08015;Badalona;6;2;B;;527;103;237;316;211;1;8;307;315
8;Barcelona;13;Barcelonès;08015;Badalona;6;3;A;;559;92;191;253;306;1;1;251;252
8;Barcelona;13;Barcelonès;08015;Badalona;6;3;B;;642;132;263;332;310;0;4;328;332
8;Barcelona;13;Barcelonès;08015;Badalona;6;4;A;;540;118;205;262;278;1;1;260;261
8;Barcelona;13;Barcelonès;08015;Badalona;6;4;B;;707;149;273;337;370;2;0;335;335
8;Barcelona;13;Barcelonès;08015;Badalona;6;5;A;;611;104;205;276;335;0;0;276;276
8;Barcelona;13;Barcelonès;08015;Badalona;6;5;B;;822;150;331;395;427;0;0;395;395
8;Barcelona;13;Barcelonès;08015;Badalona;6;6;A;;487;90;168;213;274;0;1;212;213
8;Barcelona;13;Barcelonès;08015;Badalona;6;6;B;;602;137;239;285;317;0;3;282;285
8;Barcelona;13;Barcelonès;08015;Badalona;7;1;A;;576;100;196;255;321;2;2;251;253
8;Barcelona;13;Barcelonès;08015;Badalona;7;1;B;;752;155;290;366;386;1;2;363;365
8;Barcelona;13;Barcelonès;08015;Badalona;7;10;U;;752;162;293;363;389;2;2;359;361
8;Barcelona;13;Barcelonès;08015;Badalona;7;11;A;;631;131;231;287;344;0;3;284;287
8;Barcelona;13;Barcelonès;08015;Badalona;7;11;B;;710;142;257;327;383;0;2;325;327
8;Barcelona;13;Barcelonès;08015;Badalona;7;12;A;;596;117;230;305;291;0;2;303;305
8;Barcelona;13;Barcelonès;08015;Badalona;7;12;B;;710;133;251;339;371;0;4;335;339
8;Barcelona;13;Barcelonès;08015;Badalona;7;13;U;;1038;167;305;405;633;2;1;402;403
8;Barcelona;13;Barcelonès;08015;Badalona;7;14;A;;726;132;232;324;402;0;0;324;324
8;Barcelona;13;Barcelonès;08015;Badalona;7;14;B;;857;152;319;399;458;0;1;398;399
8;Barcelona;13;Barcelonès;08015;Badalona;7;15;U;;895;165;283;378;517;1;1;376;377
8;Barcelona;13;Barcelonès;08015;Badalona;7;17;U;;609;140;224;285;324;0;1;284;285
8;Barcelona;13;Barcelonès;08015;Badalona;7;18;A;;570;92;227;323;247;0;0;323;323
8;Barcelona;13;Barcelonès;08015;Badalona;7;18;B;;689;111;265;387;302;0;2;385;387
8;Barcelona;13;Barcelonès;08015;Badalona;7;19;U;;514;105;176;242;272;0;2;240;242
8;Barcelona;13;Barcelonès;08015;Badalona;7;2;A;;873;192;321;448;425;0;5;443;448
8;Barcelona;13;Barcelonès;08015;Badalona;7;2;B;;900;192;369;482;418;0;6;476;482
8;Barcelona;13;Barcelonès;08015;Badalona;7;20;A;;535;130;214;302;233;0;2;300;302
8;Barcelona;13;Barcelonès;08015;Badalona;7;20;B;;627;135;250;344;283;0;2;342;344
8;Barcelona;13;Barcelonès;08015;Badalona;7;21;U;;897;143;272;385;512;1;5;379;384
8;Barcelona;13;Barcelonès;08015;Badalona;7;22;U;;666;172;336;415;251;0;6;409;415
8;Barcelona;13;Barcelonès;08015;Badalona;7;23;A;;727;187;374;454;273;1;3;450;453
8;Barcelona;13;Barcelonès;08015;Badalona;7;23;B;;903;210;456;553;350;5;6;542;548
8;Barcelona;13;Barcelonès;08015;Badalona;7;24;A;;485;113;213;260;225;3;0;257;257
8;Barcelona;13;Barcelonès;08015;Badalona;7;24;B;;621;138;267;325;296;1;3;321;324
8;Barcelona;13;Barcelonès;08015;Badalona;7;25;U;;674;92;179;241;433;0;3;238;241
8;Barcelona;13;Barcelonès;08015;Badalona;7;26;U;;599;107;193;260;339;0;1;259;260
8;Barcelona;13;Barcelonès;08015;Badalona;7;27;A;;605;130;233;288;317;0;3;285;288
8;Barcelona;13;Barcelonès;08015;Badalona;7;27;B;;685;135;233;312;373;1;1;310;311
8;Barcelona;13;Barcelonès;08015;Badalona;7;28;A;;772;123;241;339;433;1;9;329;338
8;Barcelona;13;Barcelonès;08015;Badalona;7;28;B;;983;204;369;471;512;2;7;462;469
8;Barcelona;13;Barcelonès;08015;Badalona;7;29;A;;483;100;186;269;214;0;1;268;269
8;Barcelona;13;Barcelonès;08015;Badalona;7;29;B;;676;129;267;378;298;0;6;372;378
8;Barcelona;13;Barcelonès;08015;Badalona;7;29;C;;627;120;234;330;297;0;1;329;330
8;Barcelona;13;Barcelonès;08015;Badalona;7;3;A;;614;163;274;348;266;0;1;347;348
8;Barcelona;13;Barcelonès;08015;Badalona;7;3;B;;746;172;296;380;366;0;3;377;380
8;Barcelona;13;Barcelonès;08015;Badalona;7;30;A;;606;117;241;332;274;0;3;329;332
8;Barcelona;13;Barcelonès;08015;Badalona;7;30;B;;725;145;245;401;324;1;4;396;400
8;Barcelona;13;Barcelonès;08015;Badalona;7;31;A;;528;94;174;250;278;0;3;247;250
8;Barcelona;13;Barcelonès;08015;Badalona;7;31;B;;683;114;230;355;328;0;6;349;355
8;Barcelona;13;Barcelonès;08015;Badalona;7;4;U;;890;177;337;481;409;2;2;477;479
8;Barcelona;13;Barcelonès;08015;Badalona;7;5;U;;756;150;279;372;384;0;5;367;372
8;Barcelona;13;Barcelonès;08015;Badalona;7;6;U;;877;173;343;496;381;3;6;487;493
8;Barcelona;13;Barcelonès;08015;Badalona;7;7;U;;866;131;253;337;529;2;3;332;335
8;Barcelona;13;Barcelonès;08015;Badalona;7;8;A;;544;100;183;230;314;1;2;227;229
8;Barcelona;13;Barcelonès;08015;Badalona;7;8;B;;687;107;236;297;390;0;6;291;297
8;Barcelona;13;Barcelonès;08015;Badalona;7;9;U;;598;135;214;274;324;1;3;270;273
8;Barcelona;13;Barcelonès;08015;Badalona;8;1;U;;749;108;216;275;474;1;4;270;274
8;Barcelona;13;Barcelonès;08015;Badalona;8;10;A;;720;120;253;336;384;0;3;333;336
8;Barcelona;13;Barcelonès;08015;Badalona;8;10;B;;738;123;266;346;392;0;1;345;346
8;Barcelona;13;Barcelonès;08015;Badalona;8;11;U;;809;164;335;442;367;0;4;438;442
8;Barcelona;13;Barcelonès;08015;Badalona;8;12;A;;830;204;387;510;320;0;4;506;510
8;Barcelona;13;Barcelonès;08015;Badalona;8;12;B;;939;220;435;560;379;0;7;553;560
8;Barcelona;13;Barcelonès;08015;Badalona;8;13;U;;699;150;253;372;327;0;4;368;372
8;Barcelona;13;Barcelonès;08015;Badalona;8;2;A;;579;107;225;320;259;1;4;315;319
8;Barcelona;13;Barcelonès;08015;Badalona;8;2;B;;761;128;262;380;381;1;3;376;379
8;Barcelona;13;Barcelonès;08015;Badalona;8;2;C;;692;114;262;367;325;1;1;365;366
8;Barcelona;13;Barcelonès;08015;Badalona;8;3;A;;785;129;258;368;417;0;5;363;368
8;Barcelona;13;Barcelonès;08015;Badalona;8;3;B;;940;169;305;438;502;0;2;436;438
8;Barcelona;13;Barcelonès;08015;Badalona;8;4;U;;740;115;233;352;388;1;9;342;351
8;Barcelona;13;Barcelonès;08015;Badalona;8;5;U;;928;186;350;461;467;5;1;455;456
8;Barcelona;13;Barcelonès;08015;Badalona;8;6;A;;741;117;260;373;368;0;2;371;373
8;Barcelona;13;Barcelonès;08015;Badalona;8;6;B;;893;171;330;472;421;0;4;468;472
8;Barcelona;13;Barcelonès;08015;Badalona;8;7;A;;509;103;179;243;266;0;0;243;243
8;Barcelona;13;Barcelonès;08015;Badalona;8;7;B;;557;104;204;266;291;0;2;264;266
8;Barcelona;13;Barcelonès;08015;Badalona;8;8;A;;819;151;259;366;453;1;5;360;365
8;Barcelona;13;Barcelonès;08015;Badalona;8;8;B;;997;128;250;402;595;3;5;394;399
8;Barcelona;13;Barcelonès;08015;Badalona;8;9;A;;584;133;217;279;305;1;3;275;278
8;Barcelona;13;Barcelonès;08015;Badalona;8;9;B;;698;165;282;361;337;0;5;356;361
8;Barcelona;13;Barcelonès;08015;Badalona;9;1;U;;562;128;248;306;256;0;6;300;306
8;Barcelona;13;Barcelonès;08015;Badalona;9;10;A;;547;142;226;268;279;1;5;262;267
8;Barcelona;13;Barcelonès;08015;Badalona;9;10;B;;721;172;273;365;356;0;3;362;365
8;Barcelona;13;Barcelonès;08015;Badalona;9;11;U;;932;248;424;519;413;2;5;512;517
8;Barcelona;13;Barcelonès;08015;Badalona;9;12;U;;652;165;298;371;281;0;4;367;371
8;Barcelona;13;Barcelonès;08015;Badalona;9;13;U;;828;183;340;412;416;0;0;412;412
8;Barcelona;13;Barcelonès;08015;Badalona;9;14;A;;700;139;274;369;331;0;2;367;369
8;Barcelona;13;Barcelonès;08015;Badalona;9;14;B;;852;175;353;465;387;0;3;462;465
8;Barcelona;13;Barcelonès;08015;Badalona;9;15;U;;728;165;275;351;377;0;0;351;351
8;Barcelona;13;Barcelonès;08015;Badalona;9;16;A;;750;18;248;364;386;0;0;364;364
8;Barcelona;13;Barcelonès;08015;Badalona;9;16;B;;788;133;300;393;395;0;2;391;393
8;Barcelona;13;Barcelonès;08015;Badalona;9;17;U;;673;137;211;258;415;0;0;258;258
8;Barcelona;13;Barcelonès;08015;Badalona;9;18;U;;569;103;206;257;312;1;3;253;256
8;Barcelona;13;Barcelonès;08015;Badalona;9;19;A;;503;107;176;237;266;2;0;235;235
8;Barcelona;13;Barcelonès;08015;Badalona;9;19;B;;585;111;218;281;304;0;4;277;281
8;Barcelona;13;Barcelonès;08015;Badalona;9;2;A;;729;106;226;293;436;0;1;292;293
8;Barcelona;13;Barcelonès;08015;Badalona;9;2;B;;730;124;240;315;415;0;1;314;315
8;Barcelona;13;Barcelonès;08015;Badalona;9;20;U;;648;116;243;334;314;0;5;329;334
8;Barcelona;13;Barcelonès;08015;Badalona;9;21;A;;584;113;237;308;276;5;4;299;303
8;Barcelona;13;Barcelonès;08015;Badalona;9;21;B;;670;131;252;338;332;0;4;334;338
8;Barcelona;13;Barcelonès;08015;Badalona;9;22;A;;573;121;226;308;265;0;2;306;308
8;Barcelona;13;Barcelonès;08015;Badalona;9;22;B;;745;149;313;400;345;1;4;395;399
8;Barcelona;13;Barcelonès;08015;Badalona;9;23;U;;648;156;265;361;287;0;5;356;361
8;Barcelona;13;Barcelonès;08015;Badalona;9;24;A;;549;109;203;287;262;2;2;283;285
8;Barcelona;13;Barcelonès;08015;Badalona;9;24;B;;593;120;224;315;278;1;2;312;314
8;Barcelona;13;Barcelonès;08015;Badalona;9;24;C;;661;124;265;364;297;0;7;357;364
8;Barcelona;13;Barcelonès;08015;Badalona;9;25;A;;503;95;193;255;248;0;4;251;255
8;Barcelona;13;Barcelonès;08015;Badalona;9;25;B;;541;112;208;277;264;1;3;273;276
8;Barcelona;13;Barcelonès;08015;Badalona;9;26;A;;513;87;177;254;259;1;3;250;253
8;Barcelona;13;Barcelonès;08015;Badalona;9;26;B;;638;121;256;328;310;0;2;326;328
8;Barcelona;13;Barcelonès;08015;Badalona;9;27;U;;795;128;279;378;417;0;1;377;378
8;Barcelona;13;Barcelonès;08015;Badalona;9;28;A;;829;100;204;288;541;0;0;288;288
8;Barcelona;13;Barcelonès;08015;Badalona;9;28;B;;868;112;200;273;595;0;3;270;273
8;Barcelona;13;Barcelonès;08015;Badalona;9;29;U;;871;167;329;411;460;0;2;409;411
8;Barcelona;13;Barcelonès;08015;Badalona;9;3;U;;684;124;220;287;397;0;1;286;287
8;Barcelona;13;Barcelonès;08015;Badalona;9;30;U;;1016;188;351;438;578;1;0;437;437
8;Barcelona;13;Barcelonès;08015;Badalona;9;31;A;;532;87;203;283;249;0;1;282;283
8;Barcelona;13;Barcelonès;08015;Badalona;9;31;B;;602;120;219;298;304;0;0;298;298
8;Barcelona;13;Barcelonès;08015;Badalona;9;32;U;;831;160;280;376;455;1;5;370;375
8;Barcelona;13;Barcelonès;08015;Badalona;9;33;A;;661;142;287;350;311;0;0;350;350
8;Barcelona;13;Barcelonès;08015;Badalona;9;33;B;;900;173;362;474;426;2;1;471;472
8;Barcelona;13;Barcelonès;08015;Badalona;9;34;A;;780;131;395;417;363;0;1;416;417
8;Barcelona;13;Barcelonès;08015;Badalona;9;34;B;;872;184;334;474;398;0;6;468;474
8;Barcelona;13;Barcelonès;08015;Badalona;9;35;A;;607;118;237;299;308;0;8;291;299
8;Barcelona;13;Barcelonès;08015;Badalona;9;35;B;;743;137;233;313;430;0;3;310;313
8;Barcelona;13;Barcelonès;08015;Badalona;9;36;A;;611;107;196;256;355;1;4;251;255
8;Barcelona;13;Barcelonès;08015;Badalona;9;36;B;;673;131;226;306;367;1;2;303;305
8;Barcelona;13;Barcelonès;08015;Badalona;9;37;U;;980;189;314;378;602;2;1;375;376
8;Barcelona;13;Barcelonès;08015;Badalona;9;38;U;;1027;200;356;461;566;0;3;458;461
8;Barcelona;13;Barcelonès;08015;Badalona;9;4;A;;733;159;267;327;406;0;3;324;327
8;Barcelona;13;Barcelonès;08015;Badalona;9;4;B;;721;145;255;301;420;2;0;299;299
8;Barcelona;13;Barcelonès;08015;Badalona;9;42;A;;519;107;189;216;303;0;2;214;216
8;Barcelona;13;Barcelonès;08015;Badalona;9;42;B;;565;143;209;248;317;0;0;248;248
8;Barcelona;13;Barcelonès;08015;Badalona;9;43;A;;681;125;524;353;328;0;4;349;353
8;Barcelona;13;Barcelonès;08015;Badalona;9;43;B;;795;158;291;394;401;2;1;391;392
8;Barcelona;13;Barcelonès;08015;Badalona;9;44;U;;860;169;297;396;464;0;1;395;396
8;Barcelona;13;Barcelonès;08015;Badalona;9;45;A;;681;110;262;320;361;0;2;318;320
8;Barcelona;13;Barcelonès;08015;Badalona;9;45;B;;838;161;304;406;432;0;1;405;406
8;Barcelona;13;Barcelonès;08015;Badalona;9;46;U;;763;130;253;344;419;2;4;338;342
8;Barcelona;13;Barcelonès;08015;Badalona;9;47;U;;917;141;302;423;494;1;2;420;422
8;Barcelona;13;Barcelonès;08015;Badalona;9;48;U;;1045;167;351;474;571;0;4;470;474
8;Barcelona;13;Barcelonès;08015;Badalona;9;49;A;;609;139;258;321;288;0;5;316;321
8;Barcelona;13;Barcelonès;08015;Badalona;9;49;B;;659;150;263;324;335;2;2;320;322
8;Barcelona;13;Barcelonès;08015;Badalona;9;5;A;;539;114;218;257;282;0;2;255;257
8;Barcelona;13;Barcelonès;08015;Badalona;9;5;B;;661;131;248;309;352;3;0;306;306
8;Barcelona;13;Barcelonès;08015;Badalona;9;50;U;;799;155;304;386;413;2;1;383;384
8;Barcelona;13;Barcelonès;08015;Badalona;9;52;U;;845;182;320;435;410;0;2;433;435
8;Barcelona;13;Barcelonès;08015;Badalona;9;53;U;;1039;192;355;494;545;0;0;494;494
8;Barcelona;13;Barcelonès;08015;Badalona;9;54;A;;534;75;201;281;253;0;2;279;281
8;Barcelona;13;Barcelonès;08015;Badalona;9;54;B;;684;108;260;363;321;2;7;354;361
8;Barcelona;13;Barcelonès;08015;Badalona;9;55;U;;900;192;379;489;411;3;3;483;486
8;Barcelona;13;Barcelonès;08015;Badalona;9;56;U;;631;106;211;282;349;1;1;280;281
8;Barcelona;13;Barcelonès;08015;Badalona;9;57;U;;921;160;330;434;487;0;1;433;434
8;Barcelona;13;Barcelonès;08015;Badalona;9;58;A;;601;104;196;279;322;1;0;278;278
8;Barcelona;13;Barcelonès;08015;Badalona;9;58;B;;663;122;264;347;316;0;1;346;347
8;Barcelona;13;Barcelonès;08015;Badalona;9;59;U;;1035;215;429;550;485;3;11;536;547
8;Barcelona;13;Barcelonès;08015;Badalona;9;6;A;;700;125;237;309;391;2;1;306;307
8;Barcelona;13;Barcelonès;08015;Badalona;9;6;B;;671;131;250;314;357;1;1;312;313
8;Barcelona;13;Barcelonès;08015;Badalona;9;8;A;;791;152;330;389;402;3;1;385;386
8;Barcelona;13;Barcelonès;08015;Badalona;9;8;B;;864;166;322;391;473;4;1;386;387
8;Barcelona;13;Barcelonès;08015;Badalona;9;9;A;;499;123;227;293;206;3;6;284;290
8;Barcelona;13;Barcelonès;08015;Badalona;9;9;B;;627;164;303;372;255;5;3;364;367
8;Barcelona;40;Vallès Occidental;08904;Badia del Vallès;1;1;A;;491;69;153;224;267;0;3;221;224
8;Barcelona;40;Vallès Occidental;08904;Badia del Vallès;1;1;B;;605;116;232;312;293;0;2;310;312
8;Barcelona;40;Vallès Occidental;08904;Badia del Vallès;1;10;A;;565;90;183;238;327;1;4;233;237
8;Barcelona;40;Vallès Occidental;08904;Badia del Vallès;1;10;B;;486;99;188;241;245;0;2;239;241
8;Barcelona;40;Vallès Occidental;08904;Badia del Vallès;1;11;A;;578;128;215;294;284;2;3;289;292
8;Barcelona;40;Vallès Occidental;08904;Badia del Vallès;1;11;B;;639;127;233;319;320;1;2;316;318
8;Barcelona;40;Vallès Occidental;08904;Badia del Vallès;1;12;A;;547;96;209;280;267;2;3;275;278
8;Barcelona;40;Vallès Occidental;08904;Badia del Vallès;1;12;B;;548;75;181;271;277;0;4;267;271
8;Barcelona;40;Vallès Occidental;08904;Badia del Vallès;1;2;U;;910;139;247;408;502;0;3;405;408
8;Barcelona;40;Vallès Occidental;08904;Badia del Vallès;1;3;A;;623;122;212;304;319;0;2;302;304
8;Barcelona;40;Vallès Occidental;08904;Badia del Vallès;1;3;B;;624;92;180;276;348;0;3;273;276
8;Barcelona;40;Vallès Occidental;08904;Badia del Vallès;1;4;A;;539;72;150;200;339;1;0;199;199
8;Barcelona;40;Vallès Occidental;08904;Badia del Vallès;1;4;B;;638;104;203;264;374;0;2;262;264
8;Barcelona;40;Vallès Occidental;08904;Badia del Vallès;1;5;A;;610;85;161;234;376;1;0;233;233
8;Barcelona;40;Vallès Occidental;08904;Badia del Vallès;1;5;B;;589;109;187;267;322;1;4;262;266
8;Barcelona;40;Vallès Occidental;08904;Badia del Vallès;1;6;A;;702;108;230;320;382;0;1;319;320
8;Barcelona;40;Vallès Occidental;08904;Badia del Vallès;1;6;B;;756;125;242;349;407;0;5;344;349
8;Barcelona;40;Vallès Occidental;08904;Badia del Vallès;1;7;A;;569;107;203;273;296;0;1;272;273
8;Barcelona;40;Vallès Occidental;08904;Badia del Vallès;1;7;B;;450;72;156;203;247;0;2;201;203
8;Barcelona;40;Vallès Occidental;08904;Badia del Vallès;1;8;A;;582;114;204;265;317;0;0;265;265
8;Barcelona;40;Vallès Occidental;08904;Badia del Vallès;1;8;B;;475;77;150;206;269;0;0;206;206
8;Barcelona;40;Vallès Occidental;08904;Badia del Vallès;1;9;A;;608;110;192;239;369;0;2;237;239
8;Barcelona;40;Vallès Occidental;08904;Badia del Vallès;1;9;B;;497;80;149;192;305;1;1;190;191
8;Barcelona;14;Berguedà;08016;Bagà;1;1;A;;829;193;431;531;298;1;4;526;530
8;Barcelona;14;Berguedà;08016;Bagà;1;1;B;;933;233;492;616;317;1;3;612;615
25;Lleida;26;Pallars Sobirà;25039;Baix Pallars;1;1;U;;336;50;134;217;119;0;0;217;217
25;Lleida;23;Noguera;25040;Balaguer;1;1;A;;487;119;237;306;181;3;2;301;303
25;Lleida;23;Noguera;25040;Balaguer;1;1;B;;585;177;304;373;212;3;2;368;370
25;Lleida;23;Noguera;25040;Balaguer;1;2;U;;921;174;424;582;339;0;9;573;582
25;Lleida;23;Noguera;25040;Balaguer;2;1;A;;469;117;184;216;253;1;2;213;215
25;Lleida;23;Noguera;25040;Balaguer;2;1;B;;318;83;160;191;127;1;7;183;190
25;Lleida;23;Noguera;25040;Balaguer;2;1;C;;381;77;138;197;184;1;0;196;196
25;Lleida;23;Noguera;25040;Balaguer;3;1;A;;863;196;412;554;309;1;7;546;553
25;Lleida;23;Noguera;25040;Balaguer;3;1;B;;921;199;405;563;358;0;2;561;563
25;Lleida;23;Noguera;25040;Balaguer;3;2;U;;913;166;390;552;361;0;7;545;552
25;Lleida;23;Noguera;25040;Balaguer;4;1;A;;685;173;344;469;216;1;7;461;468
25;Lleida;23;Noguera;25040;Balaguer;4;1;B;;786;186;430;554;232;3;4;547;551
25;Lleida;23;Noguera;25040;Balaguer;4;2;A;;775;178;330;454;321;0;4;450;454
25;Lleida;23;Noguera;25040;Balaguer;4;2;B;;919;215;416;572;347;3;6;563;569
25;Lleida;23;Noguera;25040;Balaguer;4;3;A;;871;164;395;590;281;1;10;579;589
25;Lleida;23;Noguera;25040;Balaguer;4;3;B;;1078;255;535;747;331;6;11;730;741
8;Barcelona;24;Osona;08017;Balenyà;1;1;A;;626;156;328;427;199;0;2;425;427
8;Barcelona;24;Osona;08017;Balenyà;1;1;B;;504;130;252;340;164;0;2;338;340
8;Barcelona;24;Osona;08017;Balenyà;1;1;C;;650;170;352;465;185;0;1;464;465
8;Barcelona;24;Osona;08017;Balenyà;1;2;U;;687;158;339;452;235;0;2;450;452
8;Barcelona;7;Bages;08018;Balsareny;1;1;A;;717;175;360;445;272;0;5;440;445
8;Barcelona;7;Bages;08018;Balsareny;1;1;B;;661;162;347;449;212;2;2;445;447
8;Barcelona;7;Bages;08018;Balsareny;1;2;U;;960;261;470;605;355;2;2;601;603
8;Barcelona;7;Bages;08018;Balsareny;1;3;A;;282;91;158;200;82;1;1;198;199
8;Barcelona;7;Bages;08018;Balsareny;1;3;B;;137;47;74;94;43;0;2;92;94
43;Tarragona;12;Baix Penedès;43020;Banyeres del Penedès;1;1;A;;677;164;359;459;218;3;3;453;456
43;Tarragona;12;Baix Penedès;43020;Banyeres del Penedès;1;1;B;;736;194;387;493;243;2;6;485;491
17;Girona;28;Pla de l'Estany;17015;Banyoles;1;1;A;;610;184;321;404;206;1;11;392;403
17;Girona;28;Pla de l'Estany;17015;Banyoles;1;1;B;;645;220;374;475;170;1;4;470;474
17;Girona;28;Pla de l'Estany;17015;Banyoles;1;2;U;;708;218;381;483;225;2;6;475;481
17;Girona;28;Pla de l'Estany;17015;Banyoles;1;3;A;;776;208;394;506;270;2;4;500;504
17;Girona;28;Pla de l'Estany;17015;Banyoles;1;3;B;;791;218;405;515;276;2;3;510;513
17;Girona;28;Pla de l'Estany;17015;Banyoles;1;4;A;;632;205;375;431;201;3;3;425;428
17;Girona;28;Pla de l'Estany;17015;Banyoles;1;4;B;;781;229;442;528;253;4;3;521;524
17;Girona;28;Pla de l'Estany;17015;Banyoles;2;1;A;;910;250;510;630;280;2;9;619;628
17;Girona;28;Pla de l'Estany;17015;Banyoles;2;1;B;;994;287;545;685;309;6;5;674;679
17;Girona;28;Pla de l'Estany;17015;Banyoles;2;2;U;;788;274;471;566;222;2;4;560;564
17;Girona;28;Pla de l'Estany;17015;Banyoles;2;3;A;;955;258;478;618;337;7;5;606;611
17;Girona;28;Pla de l'Estany;17015;Banyoles;2;3;B;;1002;263;496;643;359;1;5;637;642
17;Girona;28;Pla de l'Estany;17015;Banyoles;3;1;A;;585;192;352;418;167;0;4;414;418
17;Girona;28;Pla de l'Estany;17015;Banyoles;3;1;B;;607;174;356;433;174;3;3;427;430
17;Girona;28;Pla de l'Estany;17015;Banyoles;3;2;U;;832;171;356;468;364;2;5;461;466
25;Lleida;27;Pla d'Urgell;25041;Barbens;1;1;U;;689;107;325;450;239;6;4;440;444
43;Tarragona;16;Conca de Barberà;43021;Barberà de la Conca;1;1;U;;350;95;165;211;139;4;1;206;207
8;Barcelona;40;Vallès Occidental;08252;Barberà del Vallès;1;1;A;;769;150;315;427;342;0;1;426;427
8;Barcelona;40;Vallès Occidental;08252;Barberà del Vallès;1;1;B;;723;137;272;396;327;2;3;391;394
8;Barcelona;40;Vallès Occidental;08252;Barberà del Vallès;1;10;A;;571;120;228;317;254;1;3;313;316
8;Barcelona;40;Vallès Occidental;08252;Barberà del Vallès;1;10;B;;670;130;247;363;307;1;3;359;362
8;Barcelona;40;Vallès Occidental;08252;Barberà del Vallès;1;11;A;;719;145;271;389;330;2;4;383;387
8;Barcelona;40;Vallès Occidental;08252;Barberà del Vallès;1;11;B;;629;123;241;335;294;0;6;329;335
8;Barcelona;40;Vallès Occidental;08252;Barberà del Vallès;1;18;U;;891;165;319;408;483;0;3;405;408
8;Barcelona;40;Vallès Occidental;08252;Barberà del Vallès;1;19;A;;628;106;226;314;314;0;2;312;314
8;Barcelona;40;Vallès Occidental;08252;Barberà del Vallès;1;19;B;;484;77;175;231;253;0;0;231;231
8;Barcelona;40;Vallès Occidental;08252;Barberà del Vallès;1;2;U;;766;153;260;398;368;0;1;397;398
8;Barcelona;40;Vallès Occidental;08252;Barberà del Vallès;1;20;U;;881;143;306;438;443;2;8;428;436
8;Barcelona;40;Vallès Occidental;08252;Barberà del Vallès;1;21;A;;546;112;218;296;250;2;2;292;294
8;Barcelona;40;Vallès Occidental;08252;Barberà del Vallès;1;21;B;;536;93;200;292;244;1;0;291;291
8;Barcelona;40;Vallès Occidental;08252;Barberà del Vallès;1;22;A;;890;171;359;528;362;0;9;519;528
8;Barcelona;40;Vallès Occidental;08252;Barberà del Vallès;1;22;B;;835;151;332;483;352;2;4;477;481
8;Barcelona;40;Vallès Occidental;08252;Barberà del Vallès;1;23;U;;650;149;309;407;243;0;7;400;407
8;Barcelona;40;Vallès Occidental;08252;Barberà del Vallès;1;24;U;;803;210;345;417;386;0;7;410;417
8;Barcelona;40;Vallès Occidental;08252;Barberà del Vallès;1;25;U;;868;146;277;437;431;0;5;432;437
8;Barcelona;40;Vallès Occidental;08252;Barberà del Vallès;1;26;A;;641;132;280;380;261;2;1;377;378
8;Barcelona;40;Vallès Occidental;08252;Barberà del Vallès;1;26;B;;589;113;236;313;276;0;4;309;313
8;Barcelona;40;Vallès Occidental;08252;Barberà del Vallès;1;3;A;;685;134;253;356;329;0;2;354;356
8;Barcelona;40;Vallès Occidental;08252;Barberà del Vallès;1;3;B;;644;123;236;330;314;0;1;329;330
8;Barcelona;40;Vallès Occidental;08252;Barberà del Vallès;1;4;A;;610;137;236;313;297;0;0;313;313
8;Barcelona;40;Vallès Occidental;08252;Barberà del Vallès;1;4;B;;585;154;254;328;257;0;4;324;328
8;Barcelona;40;Vallès Occidental;08252;Barberà del Vallès;1;5;A;;605;111;228;304;301;0;4;300;304
8;Barcelona;40;Vallès Occidental;08252;Barberà del Vallès;1;5;B;;585;93;219;297;288;0;4;293;297
8;Barcelona;40;Vallès Occidental;08252;Barberà del Vallès;1;6;U;;912;180;323;441;471;2;7;432;439
8;Barcelona;40;Vallès Occidental;08252;Barberà del Vallès;1;7;U;;709;129;292;397;312;2;3;392;395
8;Barcelona;40;Vallès Occidental;08252;Barberà del Vallès;1;8;A;;596;90;215;309;287;2;3;304;307
8;Barcelona;40;Vallès Occidental;08252;Barberà del Vallès;1;8;B;;552;100;216;290;262;1;3;286;289
8;Barcelona;40;Vallès Occidental;08252;Barberà del Vallès;1;9;U;;735;130;267;370;365;0;5;365;370
8;Barcelona;13;Barcelonès;08019;Barcelona;1;1;U;;537;170;241;306;231;0;9;297;306
8;Barcelona;13;Barcelonès;08019;Barcelona;1;100;U;;1093;272;440;516;577;0;13;503;516
8;Barcelona;13;Barcelonès;08019;Barcelona;1;103;U;;665;165;262;327;338;0;3;324;327
8;Barcelona;13;Barcelonès;08019;Barcelona;1;104;U;;664;161;229;286;378;3;4;279;283
8;Barcelona;13;Barcelonès;08019;Barcelona;1;105;U;;551;131;186;219;332;0;1;218;219
8;Barcelona;13;Barcelonès;08019;Barcelona;1;107;U;;570;87;126;145;425;0;3;142;145
8;Barcelona;13;Barcelonès;08019;Barcelona;1;109;A;;663;186;269;299;364;2;0;297;297
8;Barcelona;13;Barcelonès;08019;Barcelona;1;109;B;;692;198;288;329;363;0;2;327;329
8;Barcelona;13;Barcelonès;08019;Barcelona;1;11;A;;599;190;286;338;261;0;4;334;338
8;Barcelona;13;Barcelonès;08019;Barcelona;1;11;B;;699;210;336;395;304;1;2;392;394
8;Barcelona;13;Barcelonès;08019;Barcelona;1;112;U;;910;234;371;461;449;4;6;451;457
8;Barcelona;13;Barcelonès;08019;Barcelona;1;114;U;;607;155;245;285;322;0;4;281;285
8;Barcelona;13;Barcelonès;08019;Barcelona;1;115;U;;1244;238;449;527;717;2;4;521;525
8;Barcelona;13;Barcelonès;08019;Barcelona;1;116;U;;874;186;300;358;516;1;1;356;357
8;Barcelona;13;Barcelonès;08019;Barcelona;1;118;U;;787;202;316;369;418;0;0;369;369
8;Barcelona;13;Barcelonès;08019;Barcelona;1;120;U;;948;259;408;469;479;0;4;465;469
8;Barcelona;13;Barcelonès;08019;Barcelona;1;122;U;;605;123;214;258;347;0;1;257;258
8;Barcelona;13;Barcelonès;08019;Barcelona;1;123;U;;672;220;339;411;261;0;3;408;411
8;Barcelona;13;Barcelonès;08019;Barcelona;1;124;U;;848;195;318;372;476;1;4;367;371
8;Barcelona;13;Barcelonès;08019;Barcelona;1;126;U;;699;183;296;332;367;3;1;328;329
8;Barcelona;13;Barcelonès;08019;Barcelona;1;127;U;;722;192;291;356;366;2;2;352;354
8;Barcelona;13;Barcelonès;08019;Barcelona;1;129;U;;561;172;281;343;218;0;9;334;343
8;Barcelona;13;Barcelonès;08019;Barcelona;1;13;U;;955;353;528;518;437;2;8;508;516
8;Barcelona;13;Barcelonès;08019;Barcelona;1;130;U;;822;223;361;439;383;0;2;437;439
8;Barcelona;13;Barcelonès;08019;Barcelona;1;132;U;;632;156;296;346;286;2;4;340;344
8;Barcelona;13;Barcelonès;08019;Barcelona;1;134;U;;746;227;312;372;374;2;7;363;370
8;Barcelona;13;Barcelonès;08019;Barcelona;1;137;U;;474;100;178;217;257;2;3;212;215
8;Barcelona;13;Barcelonès;08019;Barcelona;1;138;U;;493;120;176;213;280;0;2;211;213
8;Barcelona;13;Barcelonès;08019;Barcelona;1;139;U;;647;173;251;315;332;2;3;310;313
8;Barcelona;13;Barcelonès;08019;Barcelona;1;14;U;;1278;322;570;630;648;2;4;624;628
8;Barcelona;13;Barcelonès;08019;Barcelona;1;140;U;;566;152;224;274;292;1;4;269;273
8;Barcelona;13;Barcelonès;08019;Barcelona;1;141;U;;570;146;229;286;284;0;1;285;286
8;Barcelona;13;Barcelonès;08019;Barcelona;1;142;U;;731;159;379;353;378;1;2;350;352
8;Barcelona;13;Barcelonès;08019;Barcelona;1;144;U;;617;193;311;350;267;6;3;341;344
8;Barcelona;13;Barcelonès;08019;Barcelona;1;146;U;;823;217;391;465;358;4;3;458;461
8;Barcelona;13;Barcelonès;08019;Barcelona;1;148;U;;764;233;398;500;264;2;8;490;498
8;Barcelona;13;Barcelonès;08019;Barcelona;1;150;U;;568;176;259;310;258;0;1;309;310
8;Barcelona;13;Barcelonès;08019;Barcelona;1;151;U;;601;114;259;313;288;0;4;309;313
8;Barcelona;13;Barcelonès;08019;Barcelona;1;18;U;;611;16;270;294;317;1;2;291;293
8;Barcelona;13;Barcelonès;08019;Barcelona;1;19;U;;749;219;325;392;357;0;0;392;392
8;Barcelona;13;Barcelonès;08019;Barcelona;1;2;U;;528;151;235;287;241;0;1;286;287
8;Barcelona;13;Barcelonès;08019;Barcelona;1;20;U;;776;223;312;381;395;1;1;379;380
8;Barcelona;13;Barcelonès;08019;Barcelona;1;22;U;;532;148;219;251;281;0;2;249;251
8;Barcelona;13;Barcelonès;08019;Barcelona;1;23;A;;705;200;312;377;328;2;5;370;375
8;Barcelona;13;Barcelonès;08019;Barcelona;1;23;B;;835;242;378;456;379;2;0;454;454
8;Barcelona;13;Barcelonès;08019;Barcelona;1;25;U;;675;165;299;383;292;0;3;380;383
8;Barcelona;13;Barcelonès;08019;Barcelona;1;27;U;;897;264;440;510;387;3;4;503;507
8;Barcelona;13;Barcelonès;08019;Barcelona;1;29;U;;1069;311;503;592;477;1;6;585;591
8;Barcelona;13;Barcelonès;08019;Barcelona;1;3;U;;697;192;290;336;361;0;2;334;336
8;Barcelona;13;Barcelonès;08019;Barcelona;1;31;U;;626;155;248;313;313;0;4;309;313
8;Barcelona;13;Barcelonès;08019;Barcelona;1;32;U;;514;134;221;261;253;1;0;260;260
8;Barcelona;13;Barcelonès;08019;Barcelona;1;33;U;;615;183;295;351;264;3;3;345;348
8;Barcelona;13;Barcelonès;08019;Barcelona;1;34;U;;841;224;406;476;365;0;0;476;476
8;Barcelona;13;Barcelonès;08019;Barcelona;1;36;U;;709;214;338;389;320;2;1;386;387
8;Barcelona;13;Barcelonès;08019;Barcelona;1;38;U;;636;154;260;313;323;0;1;312;313
8;Barcelona;13;Barcelonès;08019;Barcelona;1;39;U;;769;195;350;458;311;2;4;452;456
8;Barcelona;13;Barcelonès;08019;Barcelona;1;40;U;;910;228;371;452;458;2;5;445;450
8;Barcelona;13;Barcelonès;08019;Barcelona;1;43;U;;776;170;274;316;460;2;5;309;314
8;Barcelona;13;Barcelonès;08019;Barcelona;1;45;U;;510;130;222;268;242;2;0;266;266
8;Barcelona;13;Barcelonès;08019;Barcelona;1;46;U;;835;201;358;425;410;0;4;421;425
8;Barcelona;13;Barcelonès;08019;Barcelona;1;48;U;;543;164;237;277;266;3;2;272;274
8;Barcelona;13;Barcelonès;08019;Barcelona;1;49;U;;925;250;386;467;458;5;3;459;462
8;Barcelona;13;Barcelonès;08019;Barcelona;1;5;U;;525;153;232;261;264;2;3;256;259
8;Barcelona;13;Barcelonès;08019;Barcelona;1;50;U;;893;294;435;519;374;3;4;512;516
8;Barcelona;13;Barcelonès;08019;Barcelona;1;52;U;;614;205;313;373;241;0;7;366;373
8;Barcelona;13;Barcelonès;08019;Barcelona;1;53;U;;705;184;302;368;337;3;2;363;365
8;Barcelona;13;Barcelonès;08019;Barcelona;1;54;U;;504;149;211;253;251;0;2;251;253
8;Barcelona;13;Barcelonès;08019;Barcelona;1;55;U;;477;138;204;246;231;1;3;242;245
8;Barcelona;13;Barcelonès;08019;Barcelona;1;56;U;;931;247;461;541;390;2;7;532;539
8;Barcelona;13;Barcelonès;08019;Barcelona;1;58;U;;621;179;306;388;233;1;5;382;387
8;Barcelona;13;Barcelonès;08019;Barcelona;1;59;U;;581;156;254;311;270;0;5;306;311
8;Barcelona;13;Barcelonès;08019;Barcelona;1;6;U;;691;164;271;320;371;2;5;313;318
8;Barcelona;13;Barcelonès;08019;Barcelona;1;61;U;;764;195;332;426;338;1;13;412;425
8;Barcelona;13;Barcelonès;08019;Barcelona;1;63;U;;1089;288;553;682;407;2;7;673;680
8;Barcelona;13;Barcelonès;08019;Barcelona;1;66;U;;767;210;347;417;350;0;5;412;417
8;Barcelona;13;Barcelonès;08019;Barcelona;1;68;U;;1151;182;330;403;748;1;4;398;402
8;Barcelona;13;Barcelonès;08019;Barcelona;1;69;U;;675;183;326;381;294;1;6;374;380
8;Barcelona;13;Barcelonès;08019;Barcelona;1;7;U;;653;152;284;339;314;1;3;335;338
8;Barcelona;13;Barcelonès;08019;Barcelona;1;71;U;;673;145;276;357;316;2;2;353;355
8;Barcelona;13;Barcelonès;08019;Barcelona;1;73;A;;724;180;319;384;340;1;3;380;383
8;Barcelona;13;Barcelonès;08019;Barcelona;1;73;B;;847;190;366;448;399;1;8;439;447
8;Barcelona;13;Barcelonès;08019;Barcelona;1;77;U;;884;330;451;503;381;0;8;495;503
8;Barcelona;13;Barcelonès;08019;Barcelona;1;79;U;;678;169;272;333;345;0;2;331;333
8;Barcelona;13;Barcelonès;08019;Barcelona;1;8;U;;661;196;287;343;318;4;8;331;339
8;Barcelona;13;Barcelonès;08019;Barcelona;1;82;U;;804;209;361;425;379;0;8;417;425
8;Barcelona;13;Barcelonès;08019;Barcelona;1;83;U;;918;220;393;484;434;1;4;479;483
8;Barcelona;13;Barcelonès;08019;Barcelona;1;86;U;;494;139;201;241;253;0;0;241;241
8;Barcelona;13;Barcelonès;08019;Barcelona;1;87;U;;850;200;314;347;503;0;0;347;347
8;Barcelona;13;Barcelonès;08019;Barcelona;1;88;U;;628;150;272;352;276;1;5;346;351
8;Barcelona;13;Barcelonès;08019;Barcelona;1;89;U;;1020;303;703;480;540;2;5;473;478
8;Barcelona;13;Barcelonès;08019;Barcelona;1;9;U;;1022;267;446;541;481;0;0;541;541
8;Barcelona;13;Barcelonès;08019;Barcelona;1;91;U;;858;202;303;360;498;0;5;355;360
8;Barcelona;13;Barcelonès;08019;Barcelona;1;94;U;;950;224;393;477;473;0;8;469;477
8;Barcelona;13;Barcelonès;08019;Barcelona;1;95;U;;983;237;373;429;554;1;3;425;428
8;Barcelona;13;Barcelonès;08019;Barcelona;1;97;U;;695;162;275;320;375;2;5;313;318
8;Barcelona;13;Barcelonès;08019;Barcelona;1;99;U;;666;144;229;281;385;0;4;277;281
8;Barcelona;13;Barcelonès;08019;Barcelona;10;1;U;;1157;265;555;732;425;2;14;716;730
8;Barcelona;13;Barcelonès;08019;Barcelona;10;10;U;;1074;280;559;692;382;4;10;678;688
8;Barcelona;13;Barcelonès;08019;Barcelona;10;100;U;;515;124;240;302;213;0;6;296;302
8;Barcelona;13;Barcelonès;08019;Barcelona;10;101;A;;861;189;385;511;350;0;4;507;511
8;Barcelona;13;Barcelonès;08019;Barcelona;10;101;B;;887;203;389;518;369;1;4;513;517
8;Barcelona;13;Barcelonès;08019;Barcelona;10;101;C;;1006;214;445;567;439;1;5;561;566
8;Barcelona;13;Barcelonès;08019;Barcelona;10;102;A;;683;190;369;462;221;0;3;459;462
8;Barcelona;13;Barcelonès;08019;Barcelona;10;102;B;;673;173;318;419;254;0;5;414;419
8;Barcelona;13;Barcelonès;08019;Barcelona;10;103;A;;761;197;393;480;281;0;3;477;480
8;Barcelona;13;Barcelonès;08019;Barcelona;10;103;B;;857;217;421;525;332;4;10;511;521
8;Barcelona;13;Barcelonès;08019;Barcelona;10;104;U;;845;215;408;524;321;2;3;519;522
8;Barcelona;13;Barcelonès;08019;Barcelona;10;105;U;;1050;266;526;692;358;1;7;684;691
8;Barcelona;13;Barcelonès;08019;Barcelona;10;106;A;;576;164;320;371;205;0;1;370;371
8;Barcelona;13;Barcelonès;08019;Barcelona;10;106;B;;654;177;341;438;216;1;11;426;437
8;Barcelona;13;Barcelonès;08019;Barcelona;10;107;U;;680;191;337;424;256;0;2;422;424
8;Barcelona;13;Barcelonès;08019;Barcelona;10;108;U;;584;166;313;369;215;0;1;368;369
8;Barcelona;13;Barcelonès;08019;Barcelona;10;109;U;;797;232;407;510;287;4;3;503;506
8;Barcelona;13;Barcelonès;08019;Barcelona;10;11;U;;1196;329;638;800;396;0;7;793;800
8;Barcelona;13;Barcelonès;08019;Barcelona;10;110;U;;674;194;356;422;252;1;2;419;421
8;Barcelona;13;Barcelonès;08019;Barcelona;10;111;U;;937;235;448;562;375;1;5;556;561
8;Barcelona;13;Barcelonès;08019;Barcelona;10;113;A;;675;174;331;421;254;1;4;416;420
8;Barcelona;13;Barcelonès;08019;Barcelona;10;113;B;;711;178;328;435;276;2;8;425;433
8;Barcelona;13;Barcelonès;08019;Barcelona;10;115;U;;901;214;439;552;349;0;7;545;552
8;Barcelona;13;Barcelonès;08019;Barcelona;10;116;U;;1078;243;525;701;377;0;6;695;701
8;Barcelona;13;Barcelonès;08019;Barcelona;10;117;U;;636;169;318;407;229;0;2;405;407
8;Barcelona;13;Barcelonès;08019;Barcelona;10;118;U;;972;284;511;638;334;1;7;630;637
8;Barcelona;13;Barcelonès;08019;Barcelona;10;120;U;;684;185;364;440;244;0;6;434;440
8;Barcelona;13;Barcelonès;08019;Barcelona;10;121;U;;933;330;525;645;288;1;3;641;644
8;Barcelona;13;Barcelonès;08019;Barcelona;10;122;U;;1116;292;563;757;359;3;10;744;754
8;Barcelona;13;Barcelonès;08019;Barcelona;10;123;U;;1067;320;550;668;399;1;6;661;667
8;Barcelona;13;Barcelonès;08019;Barcelona;10;125;U;;547;176;307;361;186;0;9;352;361
8;Barcelona;13;Barcelonès;08019;Barcelona;10;126;U;;499;128;237;305;194;0;3;302;305
8;Barcelona;13;Barcelonès;08019;Barcelona;10;127;U;;1078;293;566;729;349;2;8;719;727
8;Barcelona;13;Barcelonès;08019;Barcelona;10;129;U;;533;160;254;309;224;0;3;306;309
8;Barcelona;13;Barcelonès;08019;Barcelona;10;130;U;;1003;247;542;671;332;0;7;664;671
8;Barcelona;13;Barcelonès;08019;Barcelona;10;132;U;;496;158;298;362;134;0;3;359;362
8;Barcelona;13;Barcelonès;08019;Barcelona;10;133;A;;584;147;299;418;166;0;10;408;418
8;Barcelona;13;Barcelonès;08019;Barcelona;10;133;B;;714;186;378;502;212;1;9;492;501
8;Barcelona;13;Barcelonès;08019;Barcelona;10;134;U;;797;258;448;524;273;0;9;515;524
8;Barcelona;13;Barcelonès;08019;Barcelona;10;135;U;;969;247;450;594;375;1;6;587;593
8;Barcelona;13;Barcelonès;08019;Barcelona;10;137;U;;569;158;282;358;211;0;6;352;358
8;Barcelona;13;Barcelonès;08019;Barcelona;10;138;U;;941;279;502;619;322;0;8;611;619
8;Barcelona;13;Barcelonès;08019;Barcelona;10;139;U;;774;208;394;502;272;0;7;495;502
8;Barcelona;13;Barcelonès;08019;Barcelona;10;14;A;;1258;373;704;869;389;1;10;858;868
8;Barcelona;13;Barcelonès;08019;Barcelona;10;14;B;;926;270;825;626;300;0;6;620;626
8;Barcelona;13;Barcelonès;08019;Barcelona;10;14;C;;1229;331;671;882;347;5;11;866;877
8;Barcelona;13;Barcelonès;08019;Barcelona;10;14;D;;997;290;538;678;319;0;4;674;678
8;Barcelona;13;Barcelonès;08019;Barcelona;10;140;A;;611;149;309;385;226;1;6;378;384
8;Barcelona;13;Barcelonès;08019;Barcelona;10;140;B;;681;198;358;447;234;4;1;442;443
8;Barcelona;13;Barcelonès;08019;Barcelona;10;142;U;;783;236;405;488;295;2;1;485;486
8;Barcelona;13;Barcelonès;08019;Barcelona;10;143;U;;472;144;243;288;184;0;0;288;288
8;Barcelona;13;Barcelonès;08019;Barcelona;10;144;U;;729;198;350;452;277;0;8;444;452
8;Barcelona;13;Barcelonès;08019;Barcelona;10;145;U;;954;260;441;567;387;1;7;559;566
8;Barcelona;13;Barcelonès;08019;Barcelona;10;146;U;;694;198;331;421;273;1;3;417;420
8;Barcelona;13;Barcelonès;08019;Barcelona;10;147;U;;740;233;399;511;229;1;5;505;510
8;Barcelona;13;Barcelonès;08019;Barcelona;10;149;U;;746;232;380;455;291;0;3;452;455
8;Barcelona;13;Barcelonès;08019;Barcelona;10;150;U;;1079;257;560;727;352;0;12;715;727
8;Barcelona;13;Barcelonès;08019;Barcelona;10;151;U;;629;216;347;408;221;0;1;407;408
8;Barcelona;13;Barcelonès;08019;Barcelona;10;152;A;;574;159;287;362;212;0;3;359;362
8;Barcelona;13;Barcelonès;08019;Barcelona;10;152;B;;668;189;350;434;234;1;6;427;433
8;Barcelona;13;Barcelonès;08019;Barcelona;10;154;U;;1068;315;554;712;356;0;8;704;712
8;Barcelona;13;Barcelonès;08019;Barcelona;10;155;A;;669;164;304;422;247;2;1;419;420
8;Barcelona;13;Barcelonès;08019;Barcelona;10;155;B;;744;196;346;486;258;1;8;477;485
8;Barcelona;13;Barcelonès;08019;Barcelona;10;156;A;;682;195;348;440;242;0;0;440;440
8;Barcelona;13;Barcelonès;08019;Barcelona;10;156;B;;725;195;355;451;274;0;0;451;451
8;Barcelona;13;Barcelonès;08019;Barcelona;10;158;U;;564;153;255;342;222;0;0;342;342
8;Barcelona;13;Barcelonès;08019;Barcelona;10;160;U;;1116;297;572;694;422;4;8;682;690
8;Barcelona;13;Barcelonès;08019;Barcelona;10;161;U;;1132;324;566;710;422;1;9;700;709
8;Barcelona;13;Barcelonès;08019;Barcelona;10;163;A;;795;190;376;501;294;2;10;489;499
8;Barcelona;13;Barcelonès;08019;Barcelona;10;163;B;;886;206;431;554;332;0;4;550;554
8;Barcelona;13;Barcelonès;08019;Barcelona;10;164;A;;634;210;324;390;244;0;2;388;390
8;Barcelona;13;Barcelonès;08019;Barcelona;10;164;B;;737;197;365;442;295;2;4;436;440
8;Barcelona;13;Barcelonès;08019;Barcelona;10;165;U;;915;264;488;570;345;0;3;567;570
8;Barcelona;13;Barcelonès;08019;Barcelona;10;166;U;;931;307;491;590;341;0;3;587;590
8;Barcelona;13;Barcelonès;08019;Barcelona;10;168;U;;801;242;381;459;342;2;10;447;457
8;Barcelona;13;Barcelonès;08019;Barcelona;10;170;U;;909;288;525;568;341;0;2;566;568
8;Barcelona;13;Barcelonès;08019;Barcelona;10;172;U;;721;190;350;470;251;0;3;467;470
8;Barcelona;13;Barcelonès;08019;Barcelona;10;173;A;;688;174;339;457;231;0;2;455;457
8;Barcelona;13;Barcelonès;08019;Barcelona;10;173;B;;799;188;390;545;254;0;12;533;545
8;Barcelona;13;Barcelonès;08019;Barcelona;10;174;U;;1067;249;506;672;395;0;9;663;672
8;Barcelona;13;Barcelonès;08019;Barcelona;10;175;U;;1031;253;504;657;374;1;8;648;656
8;Barcelona;13;Barcelonès;08019;Barcelona;10;176;A;;753;152;297;413;340;0;8;405;413
8;Barcelona;13;Barcelonès;08019;Barcelona;10;176;B;;840;150;310;426;414;0;2;424;426
8;Barcelona;13;Barcelonès;08019;Barcelona;10;177;U;;608;245;343;402;206;1;2;399;401
8;Barcelona;13;Barcelonès;08019;Barcelona;10;178;U;;936;276;482;574;362;0;6;568;574
8;Barcelona;13;Barcelonès;08019;Barcelona;10;18;U;;996;214;387;494;502;0;4;490;494
8;Barcelona;13;Barcelonès;08019;Barcelona;10;180;U;;1120;287;515;683;437;5;6;672;678
8;Barcelona;13;Barcelonès;08019;Barcelona;10;182;U;;496;144;240;313;183;0;0;313;313
8;Barcelona;13;Barcelonès;08019;Barcelona;10;183;A;;876;241;400;540;336;0;2;538;540
8;Barcelona;13;Barcelonès;08019;Barcelona;10;183;B;;1020;284;470;618;402;1;2;615;617
8;Barcelona;13;Barcelonès;08019;Barcelona;10;184;A;;582;190;324;392;190;1;3;388;391
8;Barcelona;13;Barcelonès;08019;Barcelona;10;184;B;;684;228;387;466;218;0;5;461;466
8;Barcelona;13;Barcelonès;08019;Barcelona;10;185;U;;872;212;417;570;302;0;7;563;570
8;Barcelona;13;Barcelonès;08019;Barcelona;10;186;U;;566;168;289;380;186;0;2;378;380
8;Barcelona;13;Barcelonès;08019;Barcelona;10;187;U;;797;229;435;516;281;5;5;506;511
8;Barcelona;13;Barcelonès;08019;Barcelona;10;189;U;;627;210;356;413;214;0;3;410;413
8;Barcelona;13;Barcelonès;08019;Barcelona;10;190;U;;761;213;455;476;285;0;6;470;476
8;Barcelona;13;Barcelonès;08019;Barcelona;10;191;U;;1112;270;558;741;371;3;12;726;738
8;Barcelona;13;Barcelonès;08019;Barcelona;10;192;A;;761;210;361;439;322;2;3;434;437
8;Barcelona;13;Barcelonès;08019;Barcelona;10;192;B;;867;252;408;504;363;2;5;497;502
8;Barcelona;13;Barcelonès;08019;Barcelona;10;194;A;;678;126;257;371;307;1;2;368;370
8;Barcelona;13;Barcelonès;08019;Barcelona;10;194;B;;678;146;273;369;309;0;2;367;369
8;Barcelona;13;Barcelonès;08019;Barcelona;10;195;A;;746;196;351;455;291;2;2;451;453
8;Barcelona;13;Barcelonès;08019;Barcelona;10;195;B;;984;251;456;577;407;3;5;569;574
8;Barcelona;13;Barcelonès;08019;Barcelona;10;197;U;;1016;335;576;684;332;1;9;674;683
8;Barcelona;13;Barcelonès;08019;Barcelona;10;198;U;;836;233;447;558;278;0;14;544;558
8;Barcelona;13;Barcelonès;08019;Barcelona;10;199;A;;575;132;268;364;211;0;3;361;364
8;Barcelona;13;Barcelonès;08019;Barcelona;10;199;B;;652;153;302;396;256;0;5;391;396
8;Barcelona;13;Barcelonès;08019;Barcelona;10;2;U;;1149;332;574;744;405;0;7;737;744
8;Barcelona;13;Barcelonès;08019;Barcelona;10;20;U;;680;156;282;350;330;0;3;347;350
8;Barcelona;13;Barcelonès;08019;Barcelona;10;200;U;;962;250;433;576;386;0;4;572;576
8;Barcelona;13;Barcelonès;08019;Barcelona;10;201;U;;521;112;245;322;199;0;1;321;322
8;Barcelona;13;Barcelonès;08019;Barcelona;10;202;A;;838;173;369;497;341;0;2;495;497
8;Barcelona;13;Barcelonès;08019;Barcelona;10;202;B;;918;178;394;552;366;0;1;551;552
8;Barcelona;13;Barcelonès;08019;Barcelona;10;203;U;;622;168;298;363;259;0;3;360;363
8;Barcelona;13;Barcelonès;08019;Barcelona;10;204;U;;686;170;368;403;283;0;5;398;403
8;Barcelona;13;Barcelonès;08019;Barcelona;10;205;U;;548;122;236;328;220;0;3;325;328
8;Barcelona;13;Barcelonès;08019;Barcelona;10;206;U;;1053;203;503;664;389;0;8;656;664
8;Barcelona;13;Barcelonès;08019;Barcelona;10;207;A;;558;126;278;377;181;1;4;372;376
8;Barcelona;13;Barcelonès;08019;Barcelona;10;207;B;;743;185;372;484;259;0;3;481;484
8;Barcelona;13;Barcelonès;08019;Barcelona;10;208;U;;792;184;357;496;296;0;1;495;496
8;Barcelona;13;Barcelonès;08019;Barcelona;10;209;U;;850;217;389;545;305;3;8;534;542
8;Barcelona;13;Barcelonès;08019;Barcelona;10;21;A;;683;195;349;441;242;0;4;437;441
8;Barcelona;13;Barcelonès;08019;Barcelona;10;21;B;;728;219;380;468;260;0;5;463;468
8;Barcelona;13;Barcelonès;08019;Barcelona;10;210;U;;543;139;245;318;225;0;1;317;318
8;Barcelona;13;Barcelonès;08019;Barcelona;10;211;A;;534;130;248;335;199;0;4;331;335
8;Barcelona;13;Barcelonès;08019;Barcelona;10;211;B;;677;163;315;423;254;1;4;418;422
8;Barcelona;13;Barcelonès;08019;Barcelona;10;212;U;;941;216;419;563;378;0;6;557;563
8;Barcelona;13;Barcelonès;08019;Barcelona;10;213;U;;820;193;374;473;347;0;3;470;473
8;Barcelona;13;Barcelonès;08019;Barcelona;10;214;U;;1103;306;532;635;468;3;4;628;632
8;Barcelona;13;Barcelonès;08019;Barcelona;10;215;U;;881;226;385;472;409;0;7;465;472
8;Barcelona;13;Barcelonès;08019;Barcelona;10;217;U;;739;217;359;426;313;0;1;425;426
8;Barcelona;13;Barcelonès;08019;Barcelona;10;218;U;;739;227;400;462;277;2;2;458;460
8;Barcelona;13;Barcelonès;08019;Barcelona;10;22;U;;432;99;167;205;227;0;6;199;205
8;Barcelona;13;Barcelonès;08019;Barcelona;10;220;U;;954;243;459;549;405;0;3;546;549
8;Barcelona;13;Barcelonès;08019;Barcelona;10;221;U;;730;205;342;426;304;0;3;423;426
8;Barcelona;13;Barcelonès;08019;Barcelona;10;222;U;;818;212;359;458;360;0;3;455;458
8;Barcelona;13;Barcelonès;08019;Barcelona;10;223;A;;754;174;310;395;359;0;4;391;395
8;Barcelona;13;Barcelonès;08019;Barcelona;10;223;B;;852;194;352;466;386;0;4;462;466
8;Barcelona;13;Barcelonès;08019;Barcelona;10;224;A;;725;171;334;453;272;3;4;446;450
8;Barcelona;13;Barcelonès;08019;Barcelona;10;224;B;;710;204;354;468;242;0;2;466;468
8;Barcelona;13;Barcelonès;08019;Barcelona;10;225;U;;1119;246;501;666;453;0;7;659;666
8;Barcelona;13;Barcelonès;08019;Barcelona;10;226;U;;934;224;406;521;413;2;3;516;519
8;Barcelona;13;Barcelonès;08019;Barcelona;10;227;U;;797;168;299;355;442;3;0;352;352
8;Barcelona;13;Barcelonès;08019;Barcelona;10;229;U;;745;243;401;469;276;0;5;464;469
8;Barcelona;13;Barcelonès;08019;Barcelona;10;23;U;;938;231;450;555;383;1;8;546;554
8;Barcelona;13;Barcelonès;08019;Barcelona;10;230;A;;760;225;404;501;259;0;3;498;501
8;Barcelona;13;Barcelonès;08019;Barcelona;10;230;B;;753;181;371;489;264;3;3;483;486
8;Barcelona;13;Barcelonès;08019;Barcelona;10;25;U;;728;216;366;453;275;0;1;452;453
8;Barcelona;13;Barcelonès;08019;Barcelona;10;26;A;;670;207;336;413;257;1;4;408;412
8;Barcelona;13;Barcelonès;08019;Barcelona;10;26;B;;624;173;293;366;258;0;2;364;366
8;Barcelona;13;Barcelonès;08019;Barcelona;10;28;A;;563;168;288;340;223;0;0;340;340
8;Barcelona;13;Barcelonès;08019;Barcelona;10;28;B;;633;191;323;384;249;2;1;381;382
8;Barcelona;13;Barcelonès;08019;Barcelona;10;3;U;;489;100;217;298;191;0;2;296;298
8;Barcelona;13;Barcelonès;08019;Barcelona;10;30;U;;529;149;227;324;205;0;3;321;324
8;Barcelona;13;Barcelonès;08019;Barcelona;10;31;U;;764;232;410;517;247;2;6;509;515
8;Barcelona;13;Barcelonès;08019;Barcelona;10;34;U;;594;156;304;389;205;0;1;388;389
8;Barcelona;13;Barcelonès;08019;Barcelona;10;35;U;;646;222;367;467;179;0;3;464;467
8;Barcelona;13;Barcelonès;08019;Barcelona;10;36;U;;713;186;353;423;290;5;1;417;418
8;Barcelona;13;Barcelonès;08019;Barcelona;10;37;U;;613;142;267;321;292;0;5;316;321
8;Barcelona;13;Barcelonès;08019;Barcelona;10;38;U;;583;154;243;306;277;3;1;302;303
8;Barcelona;13;Barcelonès;08019;Barcelona;10;39;U;;536;147;251;301;235;2;5;294;299
8;Barcelona;13;Barcelonès;08019;Barcelona;10;4;U;;909;213;417;551;358;2;1;548;549
8;Barcelona;13;Barcelonès;08019;Barcelona;10;40;A;;687;154;302;369;318;1;4;364;368
8;Barcelona;13;Barcelonès;08019;Barcelona;10;40;B;;822;188;339;418;404;1;3;414;417
8;Barcelona;13;Barcelonès;08019;Barcelona;10;41;U;;1007;267;501;639;368;1;3;635;638
8;Barcelona;13;Barcelonès;08019;Barcelona;10;43;A;;640;151;319;405;235;0;5;400;405
8;Barcelona;13;Barcelonès;08019;Barcelona;10;43;B;;766;183;353;434;332;0;3;431;434
8;Barcelona;13;Barcelonès;08019;Barcelona;10;45;U;;811;217;378;470;341;0;8;462;470
8;Barcelona;13;Barcelonès;08019;Barcelona;10;46;U;;1146;300;533;698;448;2;5;691;696
8;Barcelona;13;Barcelonès;08019;Barcelona;10;47;U;;718;163;346;440;278;0;6;434;440
8;Barcelona;13;Barcelonès;08019;Barcelona;10;48;U;;762;202;368;448;314;1;3;444;447
8;Barcelona;13;Barcelonès;08019;Barcelona;10;49;U;;1107;261;591;705;402;5;8;692;700
8;Barcelona;13;Barcelonès;08019;Barcelona;10;5;U;;1194;276;607;763;431;2;4;757;761
8;Barcelona;13;Barcelonès;08019;Barcelona;10;50;U;;753;209;360;465;288;2;2;461;463
8;Barcelona;13;Barcelonès;08019;Barcelona;10;51;U;;1144;293;557;682;462;2;4;676;680
8;Barcelona;13;Barcelonès;08019;Barcelona;10;54;U;;609;187;488;355;254;1;1;353;354
8;Barcelona;13;Barcelonès;08019;Barcelona;10;56;U;;1130;400;623;742;388;2;6;734;740
8;Barcelona;13;Barcelonès;08019;Barcelona;10;57;A;;731;184;333;429;302;3;1;425;426
8;Barcelona;13;Barcelonès;08019;Barcelona;10;57;B;;838;168;405;498;340;0;6;492;498
8;Barcelona;13;Barcelonès;08019;Barcelona;10;58;U;;894;237;440;577;317;0;7;570;577
8;Barcelona;13;Barcelonès;08019;Barcelona;10;59;U;;754;174;326;443;311;0;1;442;443
8;Barcelona;13;Barcelonès;08019;Barcelona;10;6;U;;1053;267;555;694;359;1;8;685;693
8;Barcelona;13;Barcelonès;08019;Barcelona;10;60;A;;1069;263;552;693;376;0;13;680;693
8;Barcelona;13;Barcelonès;08019;Barcelona;10;60;B;;1096;283;529;713;383;1;7;705;712
8;Barcelona;13;Barcelonès;08019;Barcelona;10;62;A;;662;141;282;340;322;0;2;338;340
8;Barcelona;13;Barcelonès;08019;Barcelona;10;62;B;;691;157;276;324;367;0;1;323;324
8;Barcelona;13;Barcelonès;08019;Barcelona;10;65;A;;805;224;414;506;299;0;2;504;506
8;Barcelona;13;Barcelonès;08019;Barcelona;10;65;B;;902;266;420;593;309;1;5;587;592
8;Barcelona;13;Barcelonès;08019;Barcelona;10;65;C;;947;253;470;607;340;4;2;601;603
8;Barcelona;13;Barcelonès;08019;Barcelona;10;66;U;;990;239;389;503;487;1;4;498;502
8;Barcelona;13;Barcelonès;08019;Barcelona;10;68;U;;988;252;469;625;363;0;9;616;625
8;Barcelona;13;Barcelonès;08019;Barcelona;10;69;U;;576;172;303;363;213;1;2;360;362
8;Barcelona;13;Barcelonès;08019;Barcelona;10;70;U;;589;169;279;341;248;0;3;338;341
8;Barcelona;13;Barcelonès;08019;Barcelona;10;71;U;;1054;288;505;603;451;0;4;599;603
8;Barcelona;13;Barcelonès;08019;Barcelona;10;72;U;;767;214;380;471;296;0;7;464;471
8;Barcelona;13;Barcelonès;08019;Barcelona;10;73;A;;698;152;313;415;283;0;4;411;415
8;Barcelona;13;Barcelonès;08019;Barcelona;10;73;B;;700;152;315;427;273;2;2;423;425
8;Barcelona;13;Barcelonès;08019;Barcelona;10;75;U;;623;184;263;307;316;0;2;305;307
8;Barcelona;13;Barcelonès;08019;Barcelona;10;76;U;;490;155;248;307;183;1;9;297;306
8;Barcelona;13;Barcelonès;08019;Barcelona;10;77;U;;871;195;332;419;452;3;2;414;416
8;Barcelona;13;Barcelonès;08019;Barcelona;10;78;U;;581;156;243;288;293;0;0;288;288
8;Barcelona;13;Barcelonès;08019;Barcelona;10;79;A;;582;182;292;340;242;0;0;340;340
8;Barcelona;13;Barcelonès;08019;Barcelona;10;79;B;;607;185;286;344;263;2;3;339;342
8;Barcelona;13;Barcelonès;08019;Barcelona;10;8;U;;759;182;382;487;272;1;3;483;486
8;Barcelona;13;Barcelonès;08019;Barcelona;10;82;U;;989;275;458;541;448;0;2;539;541
8;Barcelona;13;Barcelonès;08019;Barcelona;10;83;U;;757;187;314;394;363;0;3;391;394
8;Barcelona;13;Barcelonès;08019;Barcelona;10;85;U;;794;233;369;432;362;1;3;428;431
8;Barcelona;13;Barcelonès;08019;Barcelona;10;86;U;;519;182;261;293;226;1;1;291;292
8;Barcelona;13;Barcelonès;08019;Barcelona;10;87;U;;523;180;276;307;216;0;1;306;307
8;Barcelona;13;Barcelonès;08019;Barcelona;10;88;U;;738;240;390;437;301;2;4;431;435
8;Barcelona;13;Barcelonès;08019;Barcelona;10;89;U;;675;214;334;424;251;0;2;422;424
8;Barcelona;13;Barcelonès;08019;Barcelona;10;9;U;;823;240;432;532;291;1;10;521;531
8;Barcelona;13;Barcelonès;08019;Barcelona;10;90;U;;879;283;421;518;361;0;5;513;518
8;Barcelona;13;Barcelonès;08019;Barcelona;10;92;U;;538;194;276;340;198;0;11;329;340
8;Barcelona;13;Barcelonès;08019;Barcelona;10;93;A;;643;127;260;377;266;0;5;372;377
8;Barcelona;13;Barcelonès;08019;Barcelona;10;93;B;;654;147;278;390;264;1;4;385;389
8;Barcelona;13;Barcelonès;08019;Barcelona;10;94;U;;733;258;410;488;245;1;3;484;487
8;Barcelona;13;Barcelonès;08019;Barcelona;10;96;A;;545;146;261;314;231;0;1;313;314
8;Barcelona;13;Barcelonès;08019;Barcelona;10;96;B;;638;204;327;377;261;0;2;375;377
8;Barcelona;13;Barcelonès;08019;Barcelona;10;98;A;;733;174;338;435;298;0;5;430;435
8;Barcelona;13;Barcelonès;08019;Barcelona;10;98;B;;867;215;385;528;339;7;0;521;521
8;Barcelona;13;Barcelonès;08019;Barcelona;10;98;C;;791;216;400;482;309;0;3;479;482
8;Barcelona;13;Barcelonès;08019;Barcelona;10;99;U;;811;157;354;478;333;1;4;473;477
8;Barcelona;13;Barcelonès;08019;Barcelona;2;1;U;;568;155;277;338;230;2;2;334;336
8;Barcelona;13;Barcelonès;08019;Barcelona;2;10;U;;509;146;239;290;219;0;5;285;290
8;Barcelona;13;Barcelonès;08019;Barcelona;2;100;U;;501;124;260;316;185;0;4;312;316
8;Barcelona;13;Barcelonès;08019;Barcelona;2;101;U;;873;215;406;494;379;0;1;493;494
8;Barcelona;13;Barcelonès;08019;Barcelona;2;102;U;;781;224;397;485;296;0;7;478;485
8;Barcelona;13;Barcelonès;08019;Barcelona;2;103;U;;718;174;313;415;303;2;8;405;413
8;Barcelona;13;Barcelonès;08019;Barcelona;2;104;U;;608;171;330;385;223;0;12;373;385
8;Barcelona;13;Barcelonès;08019;Barcelona;2;105;U;;576;152;286;344;232;1;2;341;343
8;Barcelona;13;Barcelonès;08019;Barcelona;2;106;U;;599;167;296;386;213;1;3;382;385
8;Barcelona;13;Barcelonès;08019;Barcelona;2;107;U;;1027;282;521;664;363;0;10;654;664
8;Barcelona;13;Barcelonès;08019;Barcelona;2;109;U;;507;131;255;332;175;1;7;324;331
8;Barcelona;13;Barcelonès;08019;Barcelona;2;11;U;;764;188;345;429;335;1;4;424;428
8;Barcelona;13;Barcelonès;08019;Barcelona;2;110;U;;743;204;366;450;293;0;10;440;450
8;Barcelona;13;Barcelonès;08019;Barcelona;2;112;U;;716;181;394;500;216;2;4;494;498
8;Barcelona;13;Barcelonès;08019;Barcelona;2;114;U;;748;210;373;491;257;11;1;479;480
8;Barcelona;13;Barcelonès;08019;Barcelona;2;115;U;;826;228;434;526;300;0;7;519;526
8;Barcelona;13;Barcelonès;08019;Barcelona;2;117;U;;920;138;410;620;300;2;9;609;618
8;Barcelona;13;Barcelonès;08019;Barcelona;2;118;U;;1095;267;567;698;397;1;10;687;697
8;Barcelona;13;Barcelonès;08019;Barcelona;2;12;U;;783;234;407;518;265;2;5;511;516
8;Barcelona;13;Barcelonès;08019;Barcelona;2;121;U;;998;308;556;683;315;0;8;675;683
8;Barcelona;13;Barcelonès;08019;Barcelona;2;124;U;;641;179;336;409;232;1;7;401;408
8;Barcelona;13;Barcelonès;08019;Barcelona;2;125;U;;730;184;383;490;240;0;7;483;490
8;Barcelona;13;Barcelonès;08019;Barcelona;2;126;U;;514;157;320;380;134;9;0;371;371
8;Barcelona;13;Barcelonès;08019;Barcelona;2;127;U;;661;193;341;422;239;8;3;411;414
8;Barcelona;13;Barcelonès;08019;Barcelona;2;128;U;;1000;293;533;666;334;3;7;656;663
8;Barcelona;13;Barcelonès;08019;Barcelona;2;129;U;;978;247;540;699;279;4;13;682;695
8;Barcelona;13;Barcelonès;08019;Barcelona;2;13;A;;585;146;300;406;179;0;5;401;406
8;Barcelona;13;Barcelonès;08019;Barcelona;2;13;B;;647;172;327;427;220;0;4;423;427
8;Barcelona;13;Barcelonès;08019;Barcelona;2;130;U;;704;190;375;454;250;1;7;446;453
8;Barcelona;13;Barcelonès;08019;Barcelona;2;131;U;;793;201;417;495;298;0;19;476;495
8;Barcelona;13;Barcelonès;08019;Barcelona;2;132;U;;1069;305;586;748;321;1;16;731;747
8;Barcelona;13;Barcelonès;08019;Barcelona;2;133;A;;610;190;348;448;162;3;6;439;445
8;Barcelona;13;Barcelonès;08019;Barcelona;2;133;B;;640;213;381;465;175;2;5;458;463
8;Barcelona;13;Barcelonès;08019;Barcelona;2;134;A;;583;155;281;352;231;1;2;349;351
8;Barcelona;13;Barcelonès;08019;Barcelona;2;134;B;;632;194;330;422;210;1;5;416;421
8;Barcelona;13;Barcelonès;08019;Barcelona;2;135;U;;984;275;512;660;324;0;7;653;660
8;Barcelona;13;Barcelonès;08019;Barcelona;2;137;U;;1123;269;574;750;373;0;10;740;750
8;Barcelona;13;Barcelonès;08019;Barcelona;2;138;A;;665;196;360;434;231;0;3;431;434
8;Barcelona;13;Barcelonès;08019;Barcelona;2;138;B;;771;234;405;494;277;0;3;491;494
8;Barcelona;13;Barcelonès;08019;Barcelona;2;14;U;;737;162;353;438;299;1;4;433;437
8;Barcelona;13;Barcelonès;08019;Barcelona;2;140;U;;1060;282;483;614;446;1;12;601;613
8;Barcelona;13;Barcelonès;08019;Barcelona;2;141;U;;754;160;343;445;309;0;2;443;445
8;Barcelona;13;Barcelonès;08019;Barcelona;2;142;U;;723;182;343;454;269;0;8;446;454
8;Barcelona;13;Barcelonès;08019;Barcelona;2;143;U;;766;177;359;454;312;0;1;453;454
8;Barcelona;13;Barcelonès;08019;Barcelona;2;144;U;;961;262;481;638;323;2;2;634;636
8;Barcelona;13;Barcelonès;08019;Barcelona;2;145;A;;540;134;262;343;197;1;3;339;342
8;Barcelona;13;Barcelonès;08019;Barcelona;2;145;B;;699;202;382;472;227;0;3;469;472
8;Barcelona;13;Barcelonès;08019;Barcelona;2;146;A;;704;220;358;465;239;0;8;457;465
8;Barcelona;13;Barcelonès;08019;Barcelona;2;146;B;;700;190;374;459;241;0;9;450;459
8;Barcelona;13;Barcelonès;08019;Barcelona;2;148;A;;634;138;304;421;213;2;4;415;419
8;Barcelona;13;Barcelonès;08019;Barcelona;2;148;B;;638;151;315;449;189;0;5;444;449
8;Barcelona;13;Barcelonès;08019;Barcelona;2;149;U;;786;221;398;499;287;2;5;492;497
8;Barcelona;13;Barcelonès;08019;Barcelona;2;15;U;;1061;261;572;722;339;1;5;716;721
8;Barcelona;13;Barcelonès;08019;Barcelona;2;151;U;;661;199;364;440;221;1;5;434;439
8;Barcelona;13;Barcelonès;08019;Barcelona;2;152;U;;864;245;453;566;298;0;8;558;566
8;Barcelona;13;Barcelonès;08019;Barcelona;2;153;U;;612;166;325;415;197;0;6;409;415
8;Barcelona;13;Barcelonès;08019;Barcelona;2;154;U;;901;263;485;619;282;0;9;610;619
8;Barcelona;13;Barcelonès;08019;Barcelona;2;155;U;;957;253;505;656;301;0;10;646;656
8;Barcelona;13;Barcelonès;08019;Barcelona;2;156;U;;657;178;342;414;243;0;1;413;414
8;Barcelona;13;Barcelonès;08019;Barcelona;2;157;U;;840;233;481;600;240;1;11;588;599
8;Barcelona;13;Barcelonès;08019;Barcelona;2;158;U;;894;217;470;641;253;0;7;634;641
8;Barcelona;13;Barcelonès;08019;Barcelona;2;159;U;;1065;319;590;692;373;3;9;680;689
8;Barcelona;13;Barcelonès;08019;Barcelona;2;161;U;;788;199;400;526;262;0;13;513;526
8;Barcelona;13;Barcelonès;08019;Barcelona;2;162;U;;702;147;365;481;221;0;5;476;481
8;Barcelona;13;Barcelonès;08019;Barcelona;2;163;U;;1051;238;543;699;352;1;12;686;698
8;Barcelona;13;Barcelonès;08019;Barcelona;2;167;U;;865;263;490;603;262;2;19;582;601
8;Barcelona;13;Barcelonès;08019;Barcelona;2;168;U;;769;235;445;543;226;0;10;533;543
8;Barcelona;13;Barcelonès;08019;Barcelona;2;169;U;;544;134;274;344;200;0;5;339;344
8;Barcelona;13;Barcelonès;08019;Barcelona;2;17;U;;609;174;325;390;219;0;6;384;390
8;Barcelona;13;Barcelonès;08019;Barcelona;2;170;U;;814;217;467;565;249;0;5;560;565
8;Barcelona;13;Barcelonès;08019;Barcelona;2;171;U;;635;170;324;414;221;0;5;409;414
8;Barcelona;13;Barcelonès;08019;Barcelona;2;172;U;;618;232;392;480;138;1;8;471;479
8;Barcelona;13;Barcelonès;08019;Barcelona;2;173;U;;553;156;306;367;186;0;3;364;367
8;Barcelona;13;Barcelonès;08019;Barcelona;2;174;U;;539;139;268;351;188;0;10;341;351
8;Barcelona;13;Barcelonès;08019;Barcelona;2;175;U;;637;179;365;445;192;0;6;439;445
8;Barcelona;13;Barcelonès;08019;Barcelona;2;176;U;;935;266;474;583;352;2;1;580;581
8;Barcelona;13;Barcelonès;08019;Barcelona;2;177;U;;556;162;290;371;185;0;6;365;371
8;Barcelona;13;Barcelonès;08019;Barcelona;2;178;U;;666;178;356;433;233;1;0;432;432
8;Barcelona;13;Barcelonès;08019;Barcelona;2;179;U;;622;156;333;401;221;1;11;389;400
8;Barcelona;13;Barcelonès;08019;Barcelona;2;18;A;;576;179;301;400;176;0;6;394;400
8;Barcelona;13;Barcelonès;08019;Barcelona;2;18;B;;658;189;369;459;199;0;10;449;459
8;Barcelona;13;Barcelonès;08019;Barcelona;2;180;U;;859;288;473;589;270;1;6;582;588
8;Barcelona;13;Barcelonès;08019;Barcelona;2;182;A;;574;167;318;409;165;3;5;401;406
8;Barcelona;13;Barcelonès;08019;Barcelona;2;182;B;;700;184;362;485;215;0;11;474;485
8;Barcelona;13;Barcelonès;08019;Barcelona;2;184;U;;771;216;419;516;255;0;9;507;516
8;Barcelona;13;Barcelonès;08019;Barcelona;2;185;U;;974;321;572;717;257;0;7;710;717
8;Barcelona;13;Barcelonès;08019;Barcelona;2;187;U;;602;151;336;405;197;0;8;397;405
8;Barcelona;13;Barcelonès;08019;Barcelona;2;189;U;;700;230;432;518;182;0;7;511;518
8;Barcelona;13;Barcelonès;08019;Barcelona;2;19;U;;1013;254;473;640;373;0;9;631;640
8;Barcelona;13;Barcelonès;08019;Barcelona;2;190;U;;558;162;324;400;158;0;7;393;400
8;Barcelona;13;Barcelonès;08019;Barcelona;2;191;U;;582;160;300;387;195;4;8;375;383
8;Barcelona;13;Barcelonès;08019;Barcelona;2;192;U;;758;237;435;514;244;4;5;505;510
8;Barcelona;13;Barcelonès;08019;Barcelona;2;193;U;;722;198;400;511;211;2;9;500;509
8;Barcelona;13;Barcelonès;08019;Barcelona;2;195;U;;928;282;530;658;270;4;12;642;654
8;Barcelona;13;Barcelonès;08019;Barcelona;2;197;U;;879;238;479;592;287;0;7;585;592
8;Barcelona;13;Barcelonès;08019;Barcelona;2;199;U;;596;170;326;404;192;1;6;397;403
8;Barcelona;13;Barcelonès;08019;Barcelona;2;2;U;;821;286;477;552;269;0;6;546;552
8;Barcelona;13;Barcelonès;08019;Barcelona;2;20;A;;599;140;265;344;255;2;0;342;342
8;Barcelona;13;Barcelonès;08019;Barcelona;2;20;B;;626;178;307;399;227;1;6;392;398
8;Barcelona;13;Barcelonès;08019;Barcelona;2;201;U;;1003;280;535;679;324;1;5;673;678
8;Barcelona;13;Barcelonès;08019;Barcelona;2;203;U;;613;170;356;426;187;0;2;424;426
8;Barcelona;13;Barcelonès;08019;Barcelona;2;206;U;;862;241;483;591;271;0;11;580;591
8;Barcelona;13;Barcelonès;08019;Barcelona;2;207;U;;667;205;394;481;186;0;10;471;481
8;Barcelona;13;Barcelonès;08019;Barcelona;2;209;U;;534;162;288;370;164;0;6;364;370
8;Barcelona;13;Barcelonès;08019;Barcelona;2;21;U;;1147;272;527;679;468;0;13;666;679
8;Barcelona;13;Barcelonès;08019;Barcelona;2;210;U;;1108;287;554;738;370;1;9;728;737
8;Barcelona;13;Barcelonès;08019;Barcelona;2;212;U;;948;231;495;632;316;3;9;620;629
8;Barcelona;13;Barcelonès;08019;Barcelona;2;213;U;;752;209;400;502;250;2;3;497;500
8;Barcelona;13;Barcelonès;08019;Barcelona;2;214;U;;773;228;396;482;291;3;10;469;479
8;Barcelona;13;Barcelonès;08019;Barcelona;2;215;U;;956;259;508;651;305;0;8;643;651
8;Barcelona;13;Barcelonès;08019;Barcelona;2;216;U;;839;250;442;558;281;1;5;552;557
8;Barcelona;13;Barcelonès;08019;Barcelona;2;219;U;;800;225;439;531;269;0;7;524;531
8;Barcelona;13;Barcelonès;08019;Barcelona;2;220;A;;648;170;364;447;201;1;4;442;446
8;Barcelona;13;Barcelonès;08019;Barcelona;2;220;B;;672;200;364;451;221;0;0;451;451
8;Barcelona;13;Barcelonès;08019;Barcelona;2;221;U;;1086;275;532;679;407;0;9;670;679
8;Barcelona;13;Barcelonès;08019;Barcelona;2;224;U;;623;167;356;431;192;0;9;422;431
8;Barcelona;13;Barcelonès;08019;Barcelona;2;226;U;;604;187;243;436;168;0;9;427;436
8;Barcelona;13;Barcelonès;08019;Barcelona;2;229;U;;664;156;362;448;216;0;10;438;448
8;Barcelona;13;Barcelonès;08019;Barcelona;2;230;U;;865;223;417;511;354;0;7;504;511
8;Barcelona;13;Barcelonès;08019;Barcelona;2;231;U;;695;187;429;525;170;0;6;519;525
8;Barcelona;13;Barcelonès;08019;Barcelona;2;232;U;;523;164;274;333;190;0;6;327;333
8;Barcelona;13;Barcelonès;08019;Barcelona;2;233;U;;800;203;460;595;205;0;2;593;595
8;Barcelona;13;Barcelonès;08019;Barcelona;2;234;U;;712;205;396;502;210;2;6;494;500
8;Barcelona;13;Barcelonès;08019;Barcelona;2;236;U;;864;274;470;585;279;0;6;579;585
8;Barcelona;13;Barcelonès;08019;Barcelona;2;237;U;;744;197;396;494;250;1;7;486;493
8;Barcelona;13;Barcelonès;08019;Barcelona;2;238;U;;968;261;613;702;266;1;4;697;701
8;Barcelona;13;Barcelonès;08019;Barcelona;2;239;U;;824;250;460;572;252;0;10;562;572
8;Barcelona;13;Barcelonès;08019;Barcelona;2;24;U;;734;185;383;492;242;0;4;488;492
8;Barcelona;13;Barcelonès;08019;Barcelona;2;240;A;;572;143;299;378;194;0;6;372;378
8;Barcelona;13;Barcelonès;08019;Barcelona;2;240;B;;604;154;311;396;208;2;0;394;394
8;Barcelona;13;Barcelonès;08019;Barcelona;2;241;U;;1224;306;670;859;365;1;13;845;858
8;Barcelona;13;Barcelonès;08019;Barcelona;2;243;U;;846;187;502;549;297;5;9;535;544
8;Barcelona;13;Barcelonès;08019;Barcelona;2;244;U;;714;216;366;467;247;2;4;461;465
8;Barcelona;13;Barcelonès;08019;Barcelona;2;246;U;;1142;252;547;712;430;0;9;703;712
8;Barcelona;13;Barcelonès;08019;Barcelona;2;247;U;;970;217;453;585;385;0;5;580;585
8;Barcelona;13;Barcelonès;08019;Barcelona;2;248;U;;1008;224;487;658;350;0;8;650;658
8;Barcelona;13;Barcelonès;08019;Barcelona;2;249;U;;963;260;535;613;350;1;3;609;612
8;Barcelona;13;Barcelonès;08019;Barcelona;2;25;U;;1166;241;584;749;417;5;1;743;744
8;Barcelona;13;Barcelonès;08019;Barcelona;2;251;U;;995;322;474;571;424;4;6;561;567
8;Barcelona;13;Barcelonès;08019;Barcelona;2;252;U;;839;200;401;522;317;0;5;517;522
8;Barcelona;13;Barcelonès;08019;Barcelona;2;253;U;;958;238;451;562;396;1;5;556;561
8;Barcelona;13;Barcelonès;08019;Barcelona;2;255;U;;726;217;419;496;230;1;6;489;495
8;Barcelona;13;Barcelonès;08019;Barcelona;2;256;U;;651;188;330;408;243;0;4;404;408
8;Barcelona;13;Barcelonès;08019;Barcelona;2;257;U;;1030;260;539;696;334;0;9;687;696
8;Barcelona;13;Barcelonès;08019;Barcelona;2;258;U;;1063;250;508;693;370;2;3;688;691
8;Barcelona;13;Barcelonès;08019;Barcelona;2;259;U;;800;206;411;523;277;0;7;516;523
8;Barcelona;13;Barcelonès;08019;Barcelona;2;26;U;;874;251;506;627;247;3;6;618;624
8;Barcelona;13;Barcelonès;08019;Barcelona;2;260;U;;740;203;359;469;271;1;9;459;468
8;Barcelona;13;Barcelonès;08019;Barcelona;2;261;U;;765;210;413;493;272;1;6;486;492
8;Barcelona;13;Barcelonès;08019;Barcelona;2;262;A;;557;147;292;379;178;0;2;377;379
8;Barcelona;13;Barcelonès;08019;Barcelona;2;262;B;;628;170;333;440;188;1;1;438;439
8;Barcelona;13;Barcelonès;08019;Barcelona;2;264;U;;852;184;408;503;349;2;2;499;501
8;Barcelona;13;Barcelonès;08019;Barcelona;2;265;U;;751;207;394;485;266;3;5;477;482
8;Barcelona;13;Barcelonès;08019;Barcelona;2;266;U;;684;178;309;390;294;1;6;383;389
8;Barcelona;13;Barcelonès;08019;Barcelona;2;267;U;;707;188;341;415;292;1;3;411;414
8;Barcelona;13;Barcelonès;08019;Barcelona;2;268;U;;740;211;362;480;260;2;3;475;478
8;Barcelona;13;Barcelonès;08019;Barcelona;2;269;U;;967;266;480;615;352;1;5;609;614
8;Barcelona;13;Barcelonès;08019;Barcelona;2;27;U;;620;188;344;417;203;3;5;409;414
8;Barcelona;13;Barcelonès;08019;Barcelona;2;271;U;;927;191;409;542;385;0;5;537;542
8;Barcelona;13;Barcelonès;08019;Barcelona;2;272;U;;755;236;386;458;297;2;2;454;456
8;Barcelona;13;Barcelonès;08019;Barcelona;2;273;U;;1010;286;525;649;361;1;7;641;648
8;Barcelona;13;Barcelonès;08019;Barcelona;2;274;U;;928;242;466;607;321;1;9;597;606
8;Barcelona;13;Barcelonès;08019;Barcelona;2;275;U;;978;219;464;621;357;0;6;615;621
8;Barcelona;13;Barcelonès;08019;Barcelona;2;276;U;;1030;314;533;656;374;6;2;648;650
8;Barcelona;13;Barcelonès;08019;Barcelona;2;277;U;;1020;249;538;687;333;3;10;674;684
8;Barcelona;13;Barcelonès;08019;Barcelona;2;278;U;;749;159;333;465;284;1;2;462;464
8;Barcelona;13;Barcelonès;08019;Barcelona;2;279;U;;812;245;419;527;285;1;8;518;526
8;Barcelona;13;Barcelonès;08019;Barcelona;2;28;U;;804;228;437;528;276;0;3;525;528
8;Barcelona;13;Barcelonès;08019;Barcelona;2;280;A;;577;181;314;401;176;0;5;396;401
8;Barcelona;13;Barcelonès;08019;Barcelona;2;280;B;;690;214;376;470;220;1;4;465;469
8;Barcelona;13;Barcelonès;08019;Barcelona;2;281;U;;706;209;386;498;208;1;5;492;497
8;Barcelona;13;Barcelonès;08019;Barcelona;2;282;U;;884;274;500;618;266;0;7;611;618
8;Barcelona;13;Barcelonès;08019;Barcelona;2;283;U;;964;297;528;631;333;1;7;623;630
8;Barcelona;13;Barcelonès;08019;Barcelona;2;284;U;;988;258;494;608;380;1;6;601;607
8;Barcelona;13;Barcelonès;08019;Barcelona;2;285;A;;596;188;343;407;189;1;6;400;406
8;Barcelona;13;Barcelonès;08019;Barcelona;2;285;B;;620;182;340;428;192;0;5;423;428
8;Barcelona;13;Barcelonès;08019;Barcelona;2;286;U;;721;210;391;495;226;0;13;482;495
8;Barcelona;13;Barcelonès;08019;Barcelona;2;287;U;;815;258;431;537;278;3;13;521;534
8;Barcelona;13;Barcelonès;08019;Barcelona;2;288;U;;699;210;349;425;274;0;4;421;425
8;Barcelona;13;Barcelonès;08019;Barcelona;2;289;U;;910;249;456;574;336;0;9;565;574
8;Barcelona;13;Barcelonès;08019;Barcelona;2;29;U;;856;220;444;558;298;0;7;551;558
8;Barcelona;13;Barcelonès;08019;Barcelona;2;290;U;;766;206;385;459;307;2;9;448;457
8;Barcelona;13;Barcelonès;08019;Barcelona;2;292;U;;736;207;363;484;252;0;2;482;484
8;Barcelona;13;Barcelonès;08019;Barcelona;2;294;U;;520;176;301;364;156;3;7;354;361
8;Barcelona;13;Barcelonès;08019;Barcelona;2;295;U;;763;183;405;517;246;4;5;508;513
8;Barcelona;13;Barcelonès;08019;Barcelona;2;296;U;;830;233;442;530;300;0;5;525;530
8;Barcelona;13;Barcelonès;08019;Barcelona;2;297;U;;962;252;482;611;351;2;6;603;609
8;Barcelona;13;Barcelonès;08019;Barcelona;2;298;U;;814;230;374;468;346;0;3;465;468
8;Barcelona;13;Barcelonès;08019;Barcelona;2;3;U;;646;197;328;418;228;6;2;410;412
8;Barcelona;13;Barcelonès;08019;Barcelona;2;30;U;;1148;316;697;712;436;2;5;705;710
8;Barcelona;13;Barcelonès;08019;Barcelona;2;300;U;;857;280;502;589;268;1;9;579;588
8;Barcelona;13;Barcelonès;08019;Barcelona;2;301;A;;590;228;368;422;168;1;9;412;421
8;Barcelona;13;Barcelonès;08019;Barcelona;2;301;B;;708;261;440;511;197;1;3;507;510
8;Barcelona;13;Barcelonès;08019;Barcelona;2;302;U;;1044;255;527;683;361;6;11;666;677
8;Barcelona;13;Barcelonès;08019;Barcelona;2;303;U;;1057;286;565;715;342;1;10;704;714
8;Barcelona;13;Barcelonès;08019;Barcelona;2;304;U;;1017;272;543;644;373;0;4;640;644
8;Barcelona;13;Barcelonès;08019;Barcelona;2;305;U;;1085;293;560;690;395;1;19;670;689
8;Barcelona;13;Barcelonès;08019;Barcelona;2;306;U;;1067;306;623;744;323;2;10;732;742
8;Barcelona;13;Barcelonès;08019;Barcelona;2;307;A;;751;200;391;520;231;0;3;517;520
8;Barcelona;13;Barcelonès;08019;Barcelona;2;307;B;;799;200;420;556;243;0;4;552;556
8;Barcelona;13;Barcelonès;08019;Barcelona;2;308;U;;1012;250;510;679;333;2;8;669;677
8;Barcelona;13;Barcelonès;08019;Barcelona;2;309;U;;889;221;417;493;396;2;7;484;491
8;Barcelona;13;Barcelonès;08019;Barcelona;2;31;U;;891;287;485;589;302;0;3;586;589
8;Barcelona;13;Barcelonès;08019;Barcelona;2;311;U;;956;253;477;590;366;1;4;585;589
8;Barcelona;13;Barcelonès;08019;Barcelona;2;312;U;;866;258;474;586;280;4;21;561;582
8;Barcelona;13;Barcelonès;08019;Barcelona;2;314;U;;658;175;338;445;213;1;4;440;444
8;Barcelona;13;Barcelonès;08019;Barcelona;2;315;U;;909;184;433;565;344;1;6;558;564
8;Barcelona;13;Barcelonès;08019;Barcelona;2;317;A;;613;163;296;358;255;1;0;357;357
8;Barcelona;13;Barcelonès;08019;Barcelona;2;317;B;;614;191;323;375;239;2;2;371;373
8;Barcelona;13;Barcelonès;08019;Barcelona;2;32;U;;903;256;506;637;266;7;6;624;630
8;Barcelona;13;Barcelonès;08019;Barcelona;2;33;U;;838;249;458;573;265;2;3;568;571
8;Barcelona;13;Barcelonès;08019;Barcelona;2;34;U;;993;293;540;664;329;1;7;656;663
8;Barcelona;13;Barcelonès;08019;Barcelona;2;35;U;;688;166;308;408;280;0;2;406;408
8;Barcelona;13;Barcelonès;08019;Barcelona;2;36;U;;772;226;385;469;303;2;4;463;467
8;Barcelona;13;Barcelonès;08019;Barcelona;2;37;U;;838;273;457;548;290;1;10;537;547
8;Barcelona;13;Barcelonès;08019;Barcelona;2;39;U;;645;165;331;394;251;1;3;390;393
8;Barcelona;13;Barcelonès;08019;Barcelona;2;4;U;;665;204;347;418;247;2;4;412;416
8;Barcelona;13;Barcelonès;08019;Barcelona;2;40;U;;719;224;387;494;225;1;5;488;493
8;Barcelona;13;Barcelonès;08019;Barcelona;2;41;U;;831;220;422;523;308;2;4;517;521
8;Barcelona;13;Barcelonès;08019;Barcelona;2;42;U;;674;177;322;396;278;2;3;391;394
8;Barcelona;13;Barcelonès;08019;Barcelona;2;43;U;;753;201;393;462;291;1;6;455;461
8;Barcelona;13;Barcelonès;08019;Barcelona;2;45;U;;561;140;265;355;206;2;1;352;353
8;Barcelona;13;Barcelonès;08019;Barcelona;2;47;A;;576;142;250;362;214;1;4;357;361
8;Barcelona;13;Barcelonès;08019;Barcelona;2;47;B;;649;167;312;400;249;0;3;397;400
8;Barcelona;13;Barcelonès;08019;Barcelona;2;49;U;;965;241;475;617;348;4;9;604;613
8;Barcelona;13;Barcelonès;08019;Barcelona;2;5;U;;654;170;320;397;257;2;3;392;395
8;Barcelona;13;Barcelonès;08019;Barcelona;2;51;U;;530;124;257;333;197;1;3;329;332
8;Barcelona;13;Barcelonès;08019;Barcelona;2;52;U;;667;192;359;433;234;2;8;423;431
8;Barcelona;13;Barcelonès;08019;Barcelona;2;53;U;;627;153;334;424;203;0;4;420;424
8;Barcelona;13;Barcelonès;08019;Barcelona;2;54;U;;731;214;393;482;249;1;3;478;481
8;Barcelona;13;Barcelonès;08019;Barcelona;2;55;U;;988;208;552;682;306;1;5;676;681
8;Barcelona;13;Barcelonès;08019;Barcelona;2;56;U;;639;177;325;444;195;2;6;436;442
8;Barcelona;13;Barcelonès;08019;Barcelona;2;57;U;;681;195;365;447;234;1;7;439;446
8;Barcelona;13;Barcelonès;08019;Barcelona;2;59;U;;638;160;293;381;257;1;4;376;380
8;Barcelona;13;Barcelonès;08019;Barcelona;2;6;U;;578;158;285;341;237;0;7;334;341
8;Barcelona;13;Barcelonès;08019;Barcelona;2;60;U;;779;220;402;499;280;1;6;492;498
8;Barcelona;13;Barcelonès;08019;Barcelona;2;61;U;;823;229;443;536;287;4;7;525;532
8;Barcelona;13;Barcelonès;08019;Barcelona;2;62;U;;667;198;362;447;220;1;1;445;446
8;Barcelona;13;Barcelonès;08019;Barcelona;2;63;U;;848;235;457;565;283;0;4;561;565
8;Barcelona;13;Barcelonès;08019;Barcelona;2;65;U;;821;256;480;585;236;0;3;582;585
8;Barcelona;13;Barcelonès;08019;Barcelona;2;66;U;;760;189;414;530;230;1;8;521;529
8;Barcelona;13;Barcelonès;08019;Barcelona;2;67;U;;854;251;471;567;287;2;12;553;565
8;Barcelona;13;Barcelonès;08019;Barcelona;2;68;U;;930;229;438;561;369;0;6;555;561
8;Barcelona;13;Barcelonès;08019;Barcelona;2;7;U;;654;172;307;374;280;0;7;367;374
8;Barcelona;13;Barcelonès;08019;Barcelona;2;70;U;;685;177;318;416;269;2;1;413;414
8;Barcelona;13;Barcelonès;08019;Barcelona;2;71;U;;944;208;486;630;314;0;4;626;630
8;Barcelona;13;Barcelonès;08019;Barcelona;2;72;U;;747;180;348;472;275;0;5;467;472
8;Barcelona;13;Barcelonès;08019;Barcelona;2;73;U;;917;264;529;666;251;0;4;662;666
8;Barcelona;13;Barcelonès;08019;Barcelona;2;74;U;;965;288;516;629;336;0;7;622;629
8;Barcelona;13;Barcelonès;08019;Barcelona;2;75;U;;1143;282;645;750;393;1;11;738;749
8;Barcelona;13;Barcelonès;08019;Barcelona;2;77;U;;924;249;490;626;298;2;8;616;624
8;Barcelona;13;Barcelonès;08019;Barcelona;2;78;U;;630;150;304;388;242;1;2;385;387
8;Barcelona;13;Barcelonès;08019;Barcelona;2;79;U;;996;250;495;634;362;8;10;616;626
8;Barcelona;13;Barcelonès;08019;Barcelona;2;8;U;;738;204;342;417;321;0;3;414;417
8;Barcelona;13;Barcelonès;08019;Barcelona;2;80;U;;1013;241;526;692;321;0;9;683;692
8;Barcelona;13;Barcelonès;08019;Barcelona;2;81;U;;952;228;456;594;358;0;13;581;594
8;Barcelona;13;Barcelonès;08019;Barcelona;2;82;U;;969;248;457;578;391;0;5;573;578
8;Barcelona;13;Barcelonès;08019;Barcelona;2;83;U;;645;159;329;418;227;2;5;411;416
8;Barcelona;13;Barcelonès;08019;Barcelona;2;84;A;;625;147;303;380;245;0;3;377;380
8;Barcelona;13;Barcelonès;08019;Barcelona;2;84;B;;635;181;331;408;227;2;3;403;406
8;Barcelona;13;Barcelonès;08019;Barcelona;2;85;U;;814;222;421;538;276;1;8;529;537
8;Barcelona;13;Barcelonès;08019;Barcelona;2;86;U;;1081;261;544;675;406;0;6;669;675
8;Barcelona;13;Barcelonès;08019;Barcelona;2;87;U;;1149;300;613;772;377;3;8;761;769
8;Barcelona;13;Barcelonès;08019;Barcelona;2;89;U;;1015;297;570;741;274;1;14;726;740
8;Barcelona;13;Barcelonès;08019;Barcelona;2;9;U;;734;218;374;477;257;0;4;473;477
8;Barcelona;13;Barcelonès;08019;Barcelona;2;90;U;;1055;380;690;741;314;0;10;731;741
8;Barcelona;13;Barcelonès;08019;Barcelona;2;91;U;;529;147;288;356;173;0;10;346;356
8;Barcelona;13;Barcelonès;08019;Barcelona;2;92;U;;1051;263;541;721;330;1;13;707;720
8;Barcelona;13;Barcelonès;08019;Barcelona;2;93;U;;941;191;455;601;340;0;3;598;601
8;Barcelona;13;Barcelonès;08019;Barcelona;2;94;U;;1082;275;550;699;383;0;13;686;699
8;Barcelona;13;Barcelonès;08019;Barcelona;2;95;A;;553;184;337;413;140;0;5;408;413
8;Barcelona;13;Barcelonès;08019;Barcelona;2;95;B;;649;205;360;446;203;0;7;439;446
8;Barcelona;13;Barcelonès;08019;Barcelona;2;96;U;;641;294;362;438;203;0;4;434;438
8;Barcelona;13;Barcelonès;08019;Barcelona;2;97;U;;916;270;509;629;287;2;8;619;627
8;Barcelona;13;Barcelonès;08019;Barcelona;2;98;U;;736;230;434;487;249;0;9;478;487
8;Barcelona;13;Barcelonès;08019;Barcelona;2;99;U;;587;187;302;386;201;0;0;386;386
8;Barcelona;13;Barcelonès;08019;Barcelona;3;1;A;;623;162;312;388;235;0;9;379;388
8;Barcelona;13;Barcelonès;08019;Barcelona;3;1;B;;625;167;321;379;246;2;12;365;377
8;Barcelona;13;Barcelonès;08019;Barcelona;3;10;U;;980;215;400;495;485;4;6;485;491
8;Barcelona;13;Barcelonès;08019;Barcelona;3;100;U;;1145;308;611;744;401;2;11;731;742
8;Barcelona;13;Barcelonès;08019;Barcelona;3;101;U;;1162;270;575;733;429;1;8;724;732
8;Barcelona;13;Barcelonès;08019;Barcelona;3;102;U;;856;167;402;519;337;5;5;509;514
8;Barcelona;13;Barcelonès;08019;Barcelona;3;103;U;;648;198;312;397;251;0;9;388;397
8;Barcelona;13;Barcelonès;08019;Barcelona;3;104;U;;963;278;480;606;357;0;3;603;606
8;Barcelona;13;Barcelonès;08019;Barcelona;3;106;U;;507;184;294;334;173;0;3;331;334
8;Barcelona;13;Barcelonès;08019;Barcelona;3;107;U;;846;245;411;514;332;1;8;505;513
8;Barcelona;13;Barcelonès;08019;Barcelona;3;109;A;;779;173;359;458;321;0;5;453;458
8;Barcelona;13;Barcelonès;08019;Barcelona;3;109;B;;974;211;446;607;367;0;5;602;607
8;Barcelona;13;Barcelonès;08019;Barcelona;3;110;A;;718;190;336;442;276;0;7;435;442
8;Barcelona;13;Barcelonès;08019;Barcelona;3;110;B;;861;193;393;512;349;1;3;508;511
8;Barcelona;13;Barcelonès;08019;Barcelona;3;111;A;;721;176;332;439;282;4;4;431;435
8;Barcelona;13;Barcelonès;08019;Barcelona;3;111;B;;867;215;378;490;377;1;4;485;489
8;Barcelona;13;Barcelonès;08019;Barcelona;3;112;U;;724;194;319;403;321;1;5;397;402
8;Barcelona;13;Barcelonès;08019;Barcelona;3;113;U;;730;178;336;429;301;0;4;425;429
8;Barcelona;13;Barcelonès;08019;Barcelona;3;114;U;;648;169;320;417;231;0;6;411;417
8;Barcelona;13;Barcelonès;08019;Barcelona;3;115;U;;1063;270;609;634;429;1;8;625;633
8;Barcelona;13;Barcelonès;08019;Barcelona;3;117;U;;654;182;328;426;228;3;3;420;423
8;Barcelona;13;Barcelonès;08019;Barcelona;3;118;U;;753;273;445;496;257;2;4;490;494
8;Barcelona;13;Barcelonès;08019;Barcelona;3;119;U;;505;154;245;311;194;0;7;304;311
8;Barcelona;13;Barcelonès;08019;Barcelona;3;12;U;;930;218;380;455;475;0;3;452;455
8;Barcelona;13;Barcelonès;08019;Barcelona;3;120;U;;679;202;355;438;241;7;4;427;431
8;Barcelona;13;Barcelonès;08019;Barcelona;3;121;U;;586;175;290;350;236;1;1;348;349
8;Barcelona;13;Barcelonès;08019;Barcelona;3;122;U;;885;301;488;572;313;1;3;568;571
8;Barcelona;13;Barcelonès;08019;Barcelona;3;124;U;;742;243;426;505;237;2;6;497;503
8;Barcelona;13;Barcelonès;08019;Barcelona;3;125;U;;777;216;407;522;255;0;5;517;522
8;Barcelona;13;Barcelonès;08019;Barcelona;3;127;U;;639;221;350;433;206;4;4;425;429
8;Barcelona;13;Barcelonès;08019;Barcelona;3;128;U;;521;157;266;320;201;0;6;314;320
8;Barcelona;13;Barcelonès;08019;Barcelona;3;129;U;;654;175;336;429;225;0;2;427;429
8;Barcelona;13;Barcelonès;08019;Barcelona;3;130;U;;1073;295;544;677;396;2;8;667;675
8;Barcelona;13;Barcelonès;08019;Barcelona;3;132;U;;870;281;493;613;257;0;16;597;613
8;Barcelona;13;Barcelonès;08019;Barcelona;3;133;U;;510;123;226;293;217;0;3;290;293
8;Barcelona;13;Barcelonès;08019;Barcelona;3;134;A;;993;287;496;622;371;1;11;610;621
8;Barcelona;13;Barcelonès;08019;Barcelona;3;134;B;;1035;314;535;655;380;3;3;649;652
8;Barcelona;13;Barcelonès;08019;Barcelona;3;135;U;;903;219;370;469;434;1;2;466;468
8;Barcelona;13;Barcelonès;08019;Barcelona;3;137;U;;974;300;460;544;430;0;5;539;544
8;Barcelona;13;Barcelonès;08019;Barcelona;3;138;U;;873;248;462;568;305;0;5;563;568
8;Barcelona;13;Barcelonès;08019;Barcelona;3;139;U;;581;171;279;349;232;0;6;343;349
8;Barcelona;13;Barcelonès;08019;Barcelona;3;14;U;;799;214;348;403;396;1;3;399;402
8;Barcelona;13;Barcelonès;08019;Barcelona;3;140;U;;540;138;265;339;201;0;2;337;339
8;Barcelona;13;Barcelonès;08019;Barcelona;3;141;U;;637;191;301;375;262;0;0;375;375
8;Barcelona;13;Barcelonès;08019;Barcelona;3;142;U;;783;212;413;523;260;0;6;517;523
8;Barcelona;13;Barcelonès;08019;Barcelona;3;143;U;;596;160;277;340;256;2;6;332;338
8;Barcelona;13;Barcelonès;08019;Barcelona;3;144;U;;873;235;474;597;276;1;3;593;596
8;Barcelona;13;Barcelonès;08019;Barcelona;3;146;U;;656;175;327;423;233;0;1;422;423
8;Barcelona;13;Barcelonès;08019;Barcelona;3;147;A;;706;202;414;495;211;0;6;489;495
8;Barcelona;13;Barcelonès;08019;Barcelona;3;147;B;;733;217;404;516;217;0;6;510;516
8;Barcelona;13;Barcelonès;08019;Barcelona;3;148;A;;565;151;278;356;209;4;7;345;352
8;Barcelona;13;Barcelonès;08019;Barcelona;3;148;B;;647;153;335;432;215;2;4;426;430
8;Barcelona;13;Barcelonès;08019;Barcelona;3;149;U;;933;260;480;622;311;0;6;616;622
8;Barcelona;13;Barcelonès;08019;Barcelona;3;15;U;;582;141;239;290;292;0;1;289;290
8;Barcelona;13;Barcelonès;08019;Barcelona;3;150;U;;770;228;398;492;278;1;3;488;491
8;Barcelona;13;Barcelonès;08019;Barcelona;3;151;U;;840;253;451;556;284;1;3;552;555
8;Barcelona;13;Barcelonès;08019;Barcelona;3;152;U;;578;162;265;362;216;2;5;355;360
8;Barcelona;13;Barcelonès;08019;Barcelona;3;153;A;;618;176;305;369;249;0;6;363;369
8;Barcelona;13;Barcelonès;08019;Barcelona;3;153;B;;690;217;345;415;275;6;0;409;409
8;Barcelona;13;Barcelonès;08019;Barcelona;3;154;U;;810;243;410;487;323;1;5;481;486
8;Barcelona;13;Barcelonès;08019;Barcelona;3;157;U;;805;220;371;504;301;0;0;504;504
8;Barcelona;13;Barcelonès;08019;Barcelona;3;159;U;;687;212;389;486;201;9;2;475;477
8;Barcelona;13;Barcelonès;08019;Barcelona;3;16;U;;603;201;278;330;273;0;3;327;330
8;Barcelona;13;Barcelonès;08019;Barcelona;3;160;U;;1166;330;661;830;336;2;10;818;828
8;Barcelona;13;Barcelonès;08019;Barcelona;3;162;U;;844;210;386;511;333;1;2;508;510
8;Barcelona;13;Barcelonès;08019;Barcelona;3;163;U;;545;147;277;362;183;2;4;356;360
8;Barcelona;13;Barcelonès;08019;Barcelona;3;164;U;;626;185;342;434;192;3;4;427;431
8;Barcelona;13;Barcelonès;08019;Barcelona;3;165;U;;526;147;287;353;173;1;2;350;352
8;Barcelona;13;Barcelonès;08019;Barcelona;3;167;U;;758;212;420;516;242;1;8;507;515
8;Barcelona;13;Barcelonès;08019;Barcelona;3;168;A;;673;201;366;464;209;2;10;452;462
8;Barcelona;13;Barcelonès;08019;Barcelona;3;168;B;;729;208;392;483;246;1;8;474;482
8;Barcelona;13;Barcelonès;08019;Barcelona;3;169;A;;557;128;290;373;184;0;3;370;373
8;Barcelona;13;Barcelonès;08019;Barcelona;3;169;B;;667;151;342;449;218;4;6;439;445
8;Barcelona;13;Barcelonès;08019;Barcelona;3;17;U;;717;183;316;402;315;3;0;399;399
8;Barcelona;13;Barcelonès;08019;Barcelona;3;170;A;;565;212;325;335;230;1;1;333;334
8;Barcelona;13;Barcelonès;08019;Barcelona;3;170;B;;710;190;336;423;287;0;3;420;423
8;Barcelona;13;Barcelonès;08019;Barcelona;3;172;U;;795;261;385;500;295;0;5;495;500
8;Barcelona;13;Barcelonès;08019;Barcelona;3;173;U;;864;240;453;540;324;2;5;533;538
8;Barcelona;13;Barcelonès;08019;Barcelona;3;176;U;;663;194;350;430;233;0;7;423;430
8;Barcelona;13;Barcelonès;08019;Barcelona;3;177;U;;544;170;257;308;236;1;1;306;307
8;Barcelona;13;Barcelonès;08019;Barcelona;3;178;U;;725;210;374;444;281;3;5;436;441
8;Barcelona;13;Barcelonès;08019;Barcelona;3;179;U;;949;300;472;553;396;2;9;542;551
8;Barcelona;13;Barcelonès;08019;Barcelona;3;18;U;;591;161;264;316;275;2;0;314;314
8;Barcelona;13;Barcelonès;08019;Barcelona;3;180;U;;768;191;346;411;357;0;3;408;411
8;Barcelona;13;Barcelonès;08019;Barcelona;3;182;U;;552;147;253;310;242;0;0;310;310
8;Barcelona;13;Barcelonès;08019;Barcelona;3;183;U;;802;206;358;445;357;3;3;439;442
8;Barcelona;13;Barcelonès;08019;Barcelona;3;184;U;;684;161;325;435;249;2;1;432;433
8;Barcelona;13;Barcelonès;08019;Barcelona;3;185;U;;806;198;376;435;371;1;3;431;434
8;Barcelona;13;Barcelonès;08019;Barcelona;3;186;U;;589;192;317;392;197;0;2;390;392
8;Barcelona;13;Barcelonès;08019;Barcelona;3;188;U;;576;153;280;377;199;0;2;375;377
8;Barcelona;13;Barcelonès;08019;Barcelona;3;189;U;;760;178;340;433;327;1;6;426;432
8;Barcelona;13;Barcelonès;08019;Barcelona;3;19;U;;604;129;270;336;268;1;2;333;335
8;Barcelona;13;Barcelonès;08019;Barcelona;3;191;U;;992;305;540;660;332;1;4;655;659
8;Barcelona;13;Barcelonès;08019;Barcelona;3;192;U;;640;15;305;398;242;0;0;398;398
8;Barcelona;13;Barcelonès;08019;Barcelona;3;193;A;;727;183;346;459;268;2;7;450;457
8;Barcelona;13;Barcelonès;08019;Barcelona;3;193;B;;789;199;366;473;316;1;5;467;472
8;Barcelona;13;Barcelonès;08019;Barcelona;3;195;U;;576;183;284;336;240;2;6;328;334
8;Barcelona;13;Barcelonès;08019;Barcelona;3;196;U;;696;184;329;426;270;0;1;425;426
8;Barcelona;13;Barcelonès;08019;Barcelona;3;197;U;;549;139;254;321;228;1;6;314;320
8;Barcelona;13;Barcelonès;08019;Barcelona;3;198;U;;1185;315;580;750;435;0;8;742;750
8;Barcelona;13;Barcelonès;08019;Barcelona;3;199;U;;557;132;235;307;250;0;2;305;307
8;Barcelona;13;Barcelonès;08019;Barcelona;3;20;U;;689;191;370;458;231;2;4;452;456
8;Barcelona;13;Barcelonès;08019;Barcelona;3;200;U;;836;220;386;483;353;0;3;480;483
8;Barcelona;13;Barcelonès;08019;Barcelona;3;201;A;;620;151;279;369;251;0;2;367;369
8;Barcelona;13;Barcelonès;08019;Barcelona;3;201;B;;705;180;334;430;275;1;4;425;429
8;Barcelona;13;Barcelonès;08019;Barcelona;3;202;A;;597;138;286;367;230;0;2;365;367
8;Barcelona;13;Barcelonès;08019;Barcelona;3;202;B;;682;176;327;427;255;1;3;423;426
8;Barcelona;13;Barcelonès;08019;Barcelona;3;204;U;;867;239;391;512;355;1;13;498;511
8;Barcelona;13;Barcelonès;08019;Barcelona;3;205;U;;960;252;507;618;342;0;10;608;618
8;Barcelona;13;Barcelonès;08019;Barcelona;3;207;U;;851;216;383;491;360;0;1;490;491
8;Barcelona;13;Barcelonès;08019;Barcelona;3;208;U;;711;209;382;494;217;1;8;485;493
8;Barcelona;13;Barcelonès;08019;Barcelona;3;209;U;;926;240;486;624;302;0;10;614;624
8;Barcelona;13;Barcelonès;08019;Barcelona;3;210;U;;1058;251;486;612;446;0;6;606;612
8;Barcelona;13;Barcelonès;08019;Barcelona;3;22;U;;820;257;424;491;329;5;2;484;486
8;Barcelona;13;Barcelonès;08019;Barcelona;3;23;A;;551;152;269;323;228;2;1;320;321
8;Barcelona;13;Barcelonès;08019;Barcelona;3;23;B;;644;184;322;375;269;4;4;367;371
8;Barcelona;13;Barcelonès;08019;Barcelona;3;24;U;;590;154;272;342;248;1;1;340;341
8;Barcelona;13;Barcelonès;08019;Barcelona;3;25;U;;870;267;404;479;391;0;1;478;479
8;Barcelona;13;Barcelonès;08019;Barcelona;3;26;U;;508;148;268;316;192;2;6;308;314
8;Barcelona;13;Barcelonès;08019;Barcelona;3;29;U;;645;164;283;352;293;3;3;346;349
8;Barcelona;13;Barcelonès;08019;Barcelona;3;3;U;;796;180;364;473;323;0;8;465;473
8;Barcelona;13;Barcelonès;08019;Barcelona;3;30;U;;859;239;416;514;345;0;2;512;514
8;Barcelona;13;Barcelonès;08019;Barcelona;3;32;U;;887;356;449;518;369;0;3;515;518
8;Barcelona;13;Barcelonès;08019;Barcelona;3;33;U;;695;193;326;381;314;4;1;376;377
8;Barcelona;13;Barcelonès;08019;Barcelona;3;37;U;;708;167;279;378;330;0;1;377;378
8;Barcelona;13;Barcelonès;08019;Barcelona;3;38;U;;1017;221;448;588;429;3;9;576;585
8;Barcelona;13;Barcelonès;08019;Barcelona;3;39;U;;878;229;396;479;399;0;8;471;479
8;Barcelona;13;Barcelonès;08019;Barcelona;3;4;U;;1026;239;418;517;509;0;4;513;517
8;Barcelona;13;Barcelonès;08019;Barcelona;3;41;U;;595;152;284;323;272;0;1;322;323
8;Barcelona;13;Barcelonès;08019;Barcelona;3;42;U;;605;187;302;363;242;2;4;357;361
8;Barcelona;13;Barcelonès;08019;Barcelona;3;43;U;;884;215;413;507;377;2;1;504;505
8;Barcelona;13;Barcelonès;08019;Barcelona;3;45;U;;811;191;352;447;364;0;3;444;447
8;Barcelona;13;Barcelonès;08019;Barcelona;3;47;U;;687;193;339;402;285;6;5;391;396
8;Barcelona;13;Barcelonès;08019;Barcelona;3;48;U;;840;213;369;436;404;0;1;435;436
8;Barcelona;13;Barcelonès;08019;Barcelona;3;49;U;;651;201;318;383;268;6;2;375;377
8;Barcelona;13;Barcelonès;08019;Barcelona;3;50;U;;1004;300;497;620;384;1;13;606;619
8;Barcelona;13;Barcelonès;08019;Barcelona;3;53;U;;501;144;244;312;189;0;0;312;312
8;Barcelona;13;Barcelonès;08019;Barcelona;3;55;U;;794;234;406;495;299;1;3;491;494
8;Barcelona;13;Barcelonès;08019;Barcelona;3;56;U;;544;160;264;327;217;5;2;320;322
8;Barcelona;13;Barcelonès;08019;Barcelona;3;57;A;;320;76;141;132;188;0;2;130;132
8;Barcelona;13;Barcelonès;08019;Barcelona;3;57;B;;318;59;85;113;205;0;1;112;113
8;Barcelona;13;Barcelonès;08019;Barcelona;3;6;U;;720;197;321;413;307;2;3;408;411
8;Barcelona;13;Barcelonès;08019;Barcelona;3;61;U;;380;16;28;44;336;0;1;43;44
8;Barcelona;13;Barcelonès;08019;Barcelona;3;62;U;;962;135;295;387;575;3;3;381;384
8;Barcelona;13;Barcelonès;08019;Barcelona;3;65;U;;782;180;356;463;319;2;6;455;461
8;Barcelona;13;Barcelonès;08019;Barcelona;3;66;U;;841;214;411;513;328;1;6;506;512
8;Barcelona;13;Barcelonès;08019;Barcelona;3;67;U;;594;206;355;385;209;1;4;380;384
8;Barcelona;13;Barcelonès;08019;Barcelona;3;68;A;;692;220;311;447;245;0;3;444;447
8;Barcelona;13;Barcelonès;08019;Barcelona;3;68;B;;828;251;408;523;305;0;7;516;523
8;Barcelona;13;Barcelonès;08019;Barcelona;3;69;A;;609;133;250;337;272;0;0;337;337
8;Barcelona;13;Barcelonès;08019;Barcelona;3;69;B;;675;186;313;406;269;0;4;402;406
8;Barcelona;13;Barcelonès;08019;Barcelona;3;7;U;;544;127;230;288;256;2;3;283;286
8;Barcelona;13;Barcelonès;08019;Barcelona;3;71;A;;737;170;311;433;304;1;4;428;432
8;Barcelona;13;Barcelonès;08019;Barcelona;3;71;B;;760;197;364;467;293;2;4;461;465
8;Barcelona;13;Barcelonès;08019;Barcelona;3;72;A;;824;214;377;481;343;1;7;473;480
8;Barcelona;13;Barcelonès;08019;Barcelona;3;72;B;;843;216;383;523;320;4;5;514;519
8;Barcelona;13;Barcelonès;08019;Barcelona;3;72;C;;1154;290;513;658;496;2;4;652;656
8;Barcelona;13;Barcelonès;08019;Barcelona;3;72;D;;1156;310;524;679;477;1;3;675;678
8;Barcelona;13;Barcelonès;08019;Barcelona;3;72;E;;1123;260;506;651;472;4;9;638;647
8;Barcelona;13;Barcelonès;08019;Barcelona;3;72;F;;853;200;353;491;362;2;7;482;489
8;Barcelona;13;Barcelonès;08019;Barcelona;3;73;A;;1076;224;445;602;474;2;3;597;600
8;Barcelona;13;Barcelonès;08019;Barcelona;3;73;B;;1224;255;491;644;580;1;5;638;643
8;Barcelona;13;Barcelonès;08019;Barcelona;3;74;A;;782;178;309;416;366;0;4;412;416
8;Barcelona;13;Barcelonès;08019;Barcelona;3;74;B;;860;216;395;494;366;2;2;490;492
8;Barcelona;13;Barcelonès;08019;Barcelona;3;74;C;;892;204;377;510;382;0;9;501;510
8;Barcelona;13;Barcelonès;08019;Barcelona;3;75;A;;819;301;430;411;408;0;4;407;411
8;Barcelona;13;Barcelonès;08019;Barcelona;3;75;B;;900;241;392;462;438;1;7;454;461
8;Barcelona;13;Barcelonès;08019;Barcelona;3;76;U;;801;154;300;400;401;1;1;398;399
8;Barcelona;13;Barcelonès;08019;Barcelona;3;77;U;;1060;279;448;568;492;0;4;564;568
8;Barcelona;13;Barcelonès;08019;Barcelona;3;78;U;;800;151;270;343;457;0;1;342;343
8;Barcelona;13;Barcelonès;08019;Barcelona;3;8;U;;969;229;414;507;462;2;5;500;505
8;Barcelona;13;Barcelonès;08019;Barcelona;3;80;U;;370;69;136;170;200;0;0;170;170
8;Barcelona;13;Barcelonès;08019;Barcelona;3;81;U;;417;91;173;216;201;0;1;215;216
8;Barcelona;13;Barcelonès;08019;Barcelona;3;82;A;;774;198;332;458;316;0;8;450;458
8;Barcelona;13;Barcelonès;08019;Barcelona;3;82;B;;801;216;389;508;293;0;7;501;508
8;Barcelona;13;Barcelonès;08019;Barcelona;3;83;U;;957;247;428;546;411;2;12;532;544
8;Barcelona;13;Barcelonès;08019;Barcelona;3;84;U;;591;151;281;345;246;0;3;342;345
8;Barcelona;13;Barcelonès;08019;Barcelona;3;85;U;;839;217;411;506;333;3;4;499;503
8;Barcelona;13;Barcelonès;08019;Barcelona;3;86;U;;704;160;291;381;323;1;4;376;380
8;Barcelona;13;Barcelonès;08019;Barcelona;3;87;U;;594;159;285;365;229;0;7;358;365
8;Barcelona;13;Barcelonès;08019;Barcelona;3;88;U;;851;268;460;551;300;1;3;547;550
8;Barcelona;13;Barcelonès;08019;Barcelona;3;89;U;;481;150;250;308;173;0;3;305;308
8;Barcelona;13;Barcelonès;08019;Barcelona;3;90;U;;573;147;282;366;207;0;1;365;366
8;Barcelona;13;Barcelonès;08019;Barcelona;3;91;U;;1165;252;551;766;399;2;17;747;764
8;Barcelona;13;Barcelonès;08019;Barcelona;3;92;U;;547;177;287;357;190;0;3;354;357
8;Barcelona;13;Barcelonès;08019;Barcelona;3;93;U;;652;205;315;375;277;2;2;371;373
8;Barcelona;13;Barcelonès;08019;Barcelona;3;94;U;;638;172;277;351;287;0;3;348;351
8;Barcelona;13;Barcelonès;08019;Barcelona;3;95;U;;685;180;314;396;289;0;6;390;396
8;Barcelona;13;Barcelonès;08019;Barcelona;3;97;U;;652;195;330;402;250;0;4;398;402
8;Barcelona;13;Barcelonès;08019;Barcelona;3;98;U;;1085;298;538;657;428;2;12;643;655
8;Barcelona;13;Barcelonès;08019;Barcelona;4;1;U;;764;182;407;527;237;1;7;519;526
8;Barcelona;13;Barcelonès;08019;Barcelona;4;10;A;;857;220;490;605;252;1;11;593;604
8;Barcelona;13;Barcelonès;08019;Barcelona;4;10;B;;797;194;436;559;238;0;3;556;559
8;Barcelona;13;Barcelonès;08019;Barcelona;4;10;C;;941;228;504;652;289;1;11;640;651
8;Barcelona;13;Barcelonès;08019;Barcelona;4;11;A;;744;239;400;508;236;2;2;504;506
8;Barcelona;13;Barcelonès;08019;Barcelona;4;11;B;;926;288;529;631;295;3;2;626;628
8;Barcelona;13;Barcelonès;08019;Barcelona;4;12;U;;558;142;305;354;204;3;1;350;351
8;Barcelona;13;Barcelonès;08019;Barcelona;4;13;U;;992;310;485;589;403;1;9;579;588
8;Barcelona;13;Barcelonès;08019;Barcelona;4;14;U;;608;159;291;360;248;0;4;356;360
8;Barcelona;13;Barcelonès;08019;Barcelona;4;15;U;;630;148;250;325;305;0;2;323;325
8;Barcelona;13;Barcelonès;08019;Barcelona;4;16;A;;688;158;316;409;279;0;2;407;409
8;Barcelona;13;Barcelonès;08019;Barcelona;4;16;B;;869;191;361;489;380;0;7;482;489
8;Barcelona;13;Barcelonès;08019;Barcelona;4;17;U;;488;104;194;268;220;6;1;261;262
8;Barcelona;13;Barcelonès;08019;Barcelona;4;18;A;;551;130;266;352;199;0;5;347;352
8;Barcelona;13;Barcelonès;08019;Barcelona;4;18;B;;650;122;283;395;255;0;1;394;395
8;Barcelona;13;Barcelonès;08019;Barcelona;4;19;A;;937;276;509;680;257;2;7;671;678
8;Barcelona;13;Barcelonès;08019;Barcelona;4;19;B;;1002;350;519;683;319;9;3;671;674
8;Barcelona;13;Barcelonès;08019;Barcelona;4;2;U;;676;167;361;474;202;1;6;467;473
8;Barcelona;13;Barcelonès;08019;Barcelona;4;20;A;;829;231;479;591;238;0;5;586;591
8;Barcelona;13;Barcelonès;08019;Barcelona;4;20;B;;853;220;457;600;253;1;14;585;599
8;Barcelona;13;Barcelonès;08019;Barcelona;4;21;A;;621;179;365;461;160;1;5;455;460
8;Barcelona;13;Barcelonès;08019;Barcelona;4;21;B;;652;183;353;484;168;0;7;477;484
8;Barcelona;13;Barcelonès;08019;Barcelona;4;22;U;;862;254;464;581;281;1;10;570;580
8;Barcelona;13;Barcelonès;08019;Barcelona;4;23;U;;657;193;364;464;193;1;10;453;463
8;Barcelona;13;Barcelonès;08019;Barcelona;4;24;U;;840;206;454;602;238;2;6;594;600
8;Barcelona;13;Barcelonès;08019;Barcelona;4;25;U;;643;178;321;402;241;0;4;398;402
8;Barcelona;13;Barcelonès;08019;Barcelona;4;26;U;;814;217;447;569;245;0;9;560;569
8;Barcelona;13;Barcelonès;08019;Barcelona;4;27;U;;704;163;334;442;262;0;8;434;442
8;Barcelona;13;Barcelonès;08019;Barcelona;4;28;U;;770;176;393;488;282;1;1;486;487
8;Barcelona;13;Barcelonès;08019;Barcelona;4;29;U;;1072;374;625;702;370;1;9;692;701
8;Barcelona;13;Barcelonès;08019;Barcelona;4;3;U;;497;134;262;329;168;0;3;326;329
8;Barcelona;13;Barcelonès;08019;Barcelona;4;30;U;;882;262;455;543;339;0;7;536;543
8;Barcelona;13;Barcelonès;08019;Barcelona;4;32;U;;828;248;445;564;264;0;12;552;564
8;Barcelona;13;Barcelonès;08019;Barcelona;4;33;U;;837;187;414;548;289;0;5;543;548
8;Barcelona;13;Barcelonès;08019;Barcelona;4;34;U;;905;221;428;603;302;1;7;595;602
8;Barcelona;13;Barcelonès;08019;Barcelona;4;35;U;;989;250;455;585;404;0;7;578;585
8;Barcelona;13;Barcelonès;08019;Barcelona;4;36;U;;664;184;365;464;200;6;0;458;458
8;Barcelona;13;Barcelonès;08019;Barcelona;4;37;U;;1118;282;570;771;347;0;7;764;771
8;Barcelona;13;Barcelonès;08019;Barcelona;4;38;U;;673;198;343;434;239;0;6;428;434
8;Barcelona;13;Barcelonès;08019;Barcelona;4;39;U;;757;211;423;539;218;1;6;532;538
8;Barcelona;13;Barcelonès;08019;Barcelona;4;4;U;;767;240;409;512;255;0;5;507;512
8;Barcelona;13;Barcelonès;08019;Barcelona;4;40;A;;722;163;362;483;239;0;6;477;483
8;Barcelona;13;Barcelonès;08019;Barcelona;4;40;B;;828;167;419;576;252;0;7;569;576
8;Barcelona;13;Barcelonès;08019;Barcelona;4;41;A;;633;136;337;427;206;1;6;420;426
8;Barcelona;13;Barcelonès;08019;Barcelona;4;41;B;;681;135;354;483;198;3;7;473;480
8;Barcelona;13;Barcelonès;08019;Barcelona;4;42;A;;716;201;383;495;221;0;6;489;495
8;Barcelona;13;Barcelonès;08019;Barcelona;4;42;B;;755;220;422;545;210;0;5;540;545
8;Barcelona;13;Barcelonès;08019;Barcelona;4;43;U;;639;180;311;432;207;0;3;429;432
8;Barcelona;13;Barcelonès;08019;Barcelona;4;44;U;;1009;251;534;669;340;0;8;661;669
8;Barcelona;13;Barcelonès;08019;Barcelona;4;45;U;;1149;253;566;719;430;1;10;708;718
8;Barcelona;13;Barcelonès;08019;Barcelona;4;48;U;;1108;307;598;774;334;1;11;762;773
8;Barcelona;13;Barcelonès;08019;Barcelona;4;5;U;;726;194;379;465;261;1;2;462;464
8;Barcelona;13;Barcelonès;08019;Barcelona;4;50;U;;736;202;441;521;215;1;3;517;520
8;Barcelona;13;Barcelonès;08019;Barcelona;4;51;U;;518;149;287;362;156;1;7;354;361
8;Barcelona;13;Barcelonès;08019;Barcelona;4;52;U;;806;223;445;547;259;0;10;537;547
8;Barcelona;13;Barcelonès;08019;Barcelona;4;53;A;;601;172;345;424;177;0;6;418;424
8;Barcelona;13;Barcelonès;08019;Barcelona;4;53;B;;593;208;345;426;167;0;4;422;426
8;Barcelona;13;Barcelonès;08019;Barcelona;4;54;U;;935;251;512;671;264;0;12;659;671
8;Barcelona;13;Barcelonès;08019;Barcelona;4;55;U;;627;155;353;441;186;1;5;435;440
8;Barcelona;13;Barcelonès;08019;Barcelona;4;57;U;;1041;227;517;670;371;1;9;660;669
8;Barcelona;13;Barcelonès;08019;Barcelona;4;58;U;;656;169;360;465;191;1;3;461;464
8;Barcelona;13;Barcelonès;08019;Barcelona;4;6;U;;644;156;289;388;256;0;3;385;388
8;Barcelona;13;Barcelonès;08019;Barcelona;4;60;U;;647;190;354;444;203;0;1;443;444
8;Barcelona;13;Barcelonès;08019;Barcelona;4;61;U;;591;182;356;420;171;0;4;416;420
8;Barcelona;13;Barcelonès;08019;Barcelona;4;62;U;;554;154;300;390;164;1;2;387;389
8;Barcelona;13;Barcelonès;08019;Barcelona;4;63;U;;856;233;493;609;247;0;6;603;609
8;Barcelona;13;Barcelonès;08019;Barcelona;4;65;U;;1117;293;603;798;319;1;13;784;797
8;Barcelona;13;Barcelonès;08019;Barcelona;4;66;U;;1189;288;654;886;303;1;19;866;885
8;Barcelona;13;Barcelonès;08019;Barcelona;4;68;U;;672;229;411;493;179;2;7;484;491
8;Barcelona;13;Barcelonès;08019;Barcelona;4;69;U;;1153;292;602;760;393;2;11;747;758
8;Barcelona;13;Barcelonès;08019;Barcelona;4;7;A;;728;180;379;514;214;0;8;506;514
8;Barcelona;13;Barcelonès;08019;Barcelona;4;7;B;;816;225;410;538;278;2;5;531;536
8;Barcelona;13;Barcelonès;08019;Barcelona;4;71;A;;864;161;451;606;258;2;4;600;604
8;Barcelona;13;Barcelonès;08019;Barcelona;4;71;B;;888;166;440;603;285;2;9;592;601
8;Barcelona;13;Barcelonès;08019;Barcelona;4;73;U;;1164;269;613;816;348;0;14;802;816
8;Barcelona;13;Barcelonès;08019;Barcelona;4;74;A;;700;198;386;486;214;1;7;478;485
8;Barcelona;13;Barcelonès;08019;Barcelona;4;74;B;;763;213;406;505;258;0;4;501;505
8;Barcelona;13;Barcelonès;08019;Barcelona;4;75;U;;561;124;303;394;167;0;4;390;394
8;Barcelona;13;Barcelonès;08019;Barcelona;4;76;U;;1221;277;700;893;328;1;16;876;892
8;Barcelona;13;Barcelonès;08019;Barcelona;4;77;A;;765;152;423;538;227;0;10;528;538
8;Barcelona;13;Barcelonès;08019;Barcelona;4;77;B;;802;188;434;592;210;1;7;584;591
8;Barcelona;13;Barcelonès;08019;Barcelona;4;78;U;;952;239;506;621;331;0;8;613;621
8;Barcelona;13;Barcelonès;08019;Barcelona;4;79;U;;943;212;542;689;254;2;13;674;687
8;Barcelona;13;Barcelonès;08019;Barcelona;4;8;U;;974;157;436;604;370;2;9;593;602
8;Barcelona;13;Barcelonès;08019;Barcelona;4;81;U;;956;180;514;690;266;1;8;681;689
8;Barcelona;13;Barcelonès;08019;Barcelona;4;82;U;;738;239;445;513;225;1;3;509;512
8;Barcelona;13;Barcelonès;08019;Barcelona;4;83;A;;1109;235;600;773;336;2;14;757;771
8;Barcelona;13;Barcelonès;08019;Barcelona;4;83;B;;1196;267;630;838;358;0;15;823;838
8;Barcelona;13;Barcelonès;08019;Barcelona;5;1;U;;798;204;444;556;242;0;6;550;556
8;Barcelona;13;Barcelonès;08019;Barcelona;5;10;U;;754;235;429;517;237;1;5;511;516
8;Barcelona;13;Barcelonès;08019;Barcelona;5;100;U;;673;195;401;479;194;0;7;472;479
8;Barcelona;13;Barcelonès;08019;Barcelona;5;101;U;;597;154;266;321;276;0;2;319;321
8;Barcelona;13;Barcelonès;08019;Barcelona;5;102;U;;868;258;517;628;240;0;2;626;628
8;Barcelona;13;Barcelonès;08019;Barcelona;5;103;U;;541;152;287;377;164;0;6;371;377
8;Barcelona;13;Barcelonès;08019;Barcelona;5;104;U;;778;191;391;516;262;0;10;506;516
8;Barcelona;13;Barcelonès;08019;Barcelona;5;105;A;;620;136;325;416;204;1;11;404;415
8;Barcelona;13;Barcelonès;08019;Barcelona;5;105;B;;673;194;392;489;184;0;6;483;489
8;Barcelona;13;Barcelonès;08019;Barcelona;5;106;U;;826;200;465;601;225;0;8;593;601
8;Barcelona;13;Barcelonès;08019;Barcelona;5;107;U;;866;188;462;574;292;0;11;563;574
8;Barcelona;13;Barcelonès;08019;Barcelona;5;109;U;;712;183;396;527;185;0;22;505;527
8;Barcelona;13;Barcelonès;08019;Barcelona;5;11;U;;1105;273;545;736;369;0;14;722;736
8;Barcelona;13;Barcelonès;08019;Barcelona;5;110;U;;1121;266;586;766;355;3;8;755;763
8;Barcelona;13;Barcelonès;08019;Barcelona;5;112;A;;640;158;338;436;204;1;9;426;435
8;Barcelona;13;Barcelonès;08019;Barcelona;5;112;B;;682;154;394;458;224;2;7;449;456
8;Barcelona;13;Barcelonès;08019;Barcelona;5;115;U;;942;184;414;570;372;0;11;559;570
8;Barcelona;13;Barcelonès;08019;Barcelona;5;117;U;;1125;278;647;828;297;1;4;823;827
8;Barcelona;13;Barcelonès;08019;Barcelona;5;118;U;;967;253;541;691;276;0;13;678;691
8;Barcelona;13;Barcelonès;08019;Barcelona;5;120;U;;854;232;444;558;296;0;7;551;558
8;Barcelona;13;Barcelonès;08019;Barcelona;5;121;U;;719;190;338;504;215;4;9;491;500
8;Barcelona;13;Barcelonès;08019;Barcelona;5;122;U;;948;235;524;660;288;2;5;653;658
8;Barcelona;13;Barcelonès;08019;Barcelona;5;124;U;;583;132;320;418;165;1;11;406;417
8;Barcelona;13;Barcelonès;08019;Barcelona;5;125;U;;515;150;260;325;190;0;8;317;325
8;Barcelona;13;Barcelonès;08019;Barcelona;5;126;U;;553;127;269;380;173;0;6;374;380
8;Barcelona;13;Barcelonès;08019;Barcelona;5;127;U;;536;128;302;384;152;0;4;380;384
8;Barcelona;13;Barcelonès;08019;Barcelona;5;129;U;;569;155;275;377;192;0;2;375;377
8;Barcelona;13;Barcelonès;08019;Barcelona;5;13;U;;893;218;426;557;336;0;8;549;557
8;Barcelona;13;Barcelonès;08019;Barcelona;5;131;U;;908;272;523;654;254;0;7;647;654
8;Barcelona;13;Barcelonès;08019;Barcelona;5;133;U;;981;207;527;705;276;5;7;693;700
8;Barcelona;13;Barcelonès;08019;Barcelona;5;134;U;;613;135;334;431;182;0;5;426;431
8;Barcelona;13;Barcelonès;08019;Barcelona;5;135;U;;1074;273;594;770;304;0;17;753;770
8;Barcelona;13;Barcelonès;08019;Barcelona;5;136;U;;794;172;430;611;183;0;10;601;611
8;Barcelona;13;Barcelonès;08019;Barcelona;5;137;U;;606;146;356;480;126;0;12;468;480
8;Barcelona;13;Barcelonès;08019;Barcelona;5;138;U;;716;180;389;488;228;1;11;476;487
8;Barcelona;13;Barcelonès;08019;Barcelona;5;139;U;;851;182;465;607;244;0;7;600;607
8;Barcelona;13;Barcelonès;08019;Barcelona;5;14;U;;647;173;342;434;213;0;10;424;434
8;Barcelona;13;Barcelonès;08019;Barcelona;5;140;U;;1038;272;566;737;301;1;13;723;736
8;Barcelona;13;Barcelonès;08019;Barcelona;5;141;U;;917;249;448;580;337;1;9;570;579
8;Barcelona;13;Barcelonès;08019;Barcelona;5;144;U;;709;174;399;526;183;0;12;514;526
8;Barcelona;13;Barcelonès;08019;Barcelona;5;145;U;;796;190;426;574;222;0;10;564;574
8;Barcelona;13;Barcelonès;08019;Barcelona;5;146;U;;764;201;422;532;232;0;15;517;532
8;Barcelona;13;Barcelonès;08019;Barcelona;5;147;U;;722;195;334;516;206;1;9;506;515
8;Barcelona;13;Barcelonès;08019;Barcelona;5;148;A;;630;135;346;455;175;0;9;446;455
8;Barcelona;13;Barcelonès;08019;Barcelona;5;148;B;;688;181;389;505;183;1;5;499;504
8;Barcelona;13;Barcelonès;08019;Barcelona;5;149;A;;699;199;380;482;217;2;7;473;480
8;Barcelona;13;Barcelonès;08019;Barcelona;5;149;B;;777;226;431;535;242;1;11;523;534
8;Barcelona;13;Barcelonès;08019;Barcelona;5;15;U;;980;260;570;713;267;0;6;707;713
8;Barcelona;13;Barcelonès;08019;Barcelona;5;152;U;;565;135;266;333;232;1;5;327;332
8;Barcelona;13;Barcelonès;08019;Barcelona;5;153;U;;654;152;347;438;216;3;10;425;435
8;Barcelona;13;Barcelonès;08019;Barcelona;5;154;U;;627;137;354;455;172;0;10;445;455
8;Barcelona;13;Barcelonès;08019;Barcelona;5;155;U;;589;137;315;442;147;0;4;438;442
8;Barcelona;13;Barcelonès;08019;Barcelona;5;156;U;;822;229;500;600;222;1;10;589;599
8;Barcelona;13;Barcelonès;08019;Barcelona;5;157;U;;689;186;361;488;201;3;12;473;485
8;Barcelona;13;Barcelonès;08019;Barcelona;5;158;U;;820;20;467;605;215;1;10;594;604
8;Barcelona;13;Barcelonès;08019;Barcelona;5;16;U;;929;230;500;636;293;0;12;624;636
8;Barcelona;13;Barcelonès;08019;Barcelona;5;160;U;;940;248;502;650;290;0;11;639;650
8;Barcelona;13;Barcelonès;08019;Barcelona;5;161;U;;779;232;450;545;234;0;9;536;545
8;Barcelona;13;Barcelonès;08019;Barcelona;5;162;U;;1055;269;558;703;352;0;15;688;703
8;Barcelona;13;Barcelonès;08019;Barcelona;5;164;U;;601;176;316;392;209;0;9;383;392
8;Barcelona;13;Barcelonès;08019;Barcelona;5;165;U;;659;207;417;519;140;0;5;514;519
8;Barcelona;13;Barcelonès;08019;Barcelona;5;166;U;;751;191;413;513;238;0;3;510;513
8;Barcelona;13;Barcelonès;08019;Barcelona;5;168;U;;599;167;332;433;166;0;8;425;433
8;Barcelona;13;Barcelonès;08019;Barcelona;5;169;U;;874;216;481;647;227;1;14;632;646
8;Barcelona;13;Barcelonès;08019;Barcelona;5;170;U;;687;178;380;475;212;0;4;471;475
8;Barcelona;13;Barcelonès;08019;Barcelona;5;171;U;;1142;353;661;826;316;2;11;813;824
8;Barcelona;13;Barcelonès;08019;Barcelona;5;174;U;;613;170;277;348;265;1;7;340;347
8;Barcelona;13;Barcelonès;08019;Barcelona;5;175;U;;1131;304;618;755;376;3;12;740;752
8;Barcelona;13;Barcelonès;08019;Barcelona;5;177;U;;560;166;338;415;145;0;4;411;415
8;Barcelona;13;Barcelonès;08019;Barcelona;5;178;U;;882;232;509;614;268;1;47;566;613
8;Barcelona;13;Barcelonès;08019;Barcelona;5;18;U;;690;189;381;474;216;5;7;462;469
8;Barcelona;13;Barcelonès;08019;Barcelona;5;180;U;;656;197;384;466;190;0;6;460;466
8;Barcelona;13;Barcelonès;08019;Barcelona;5;182;U;;993;264;550;670;323;0;9;661;670
8;Barcelona;13;Barcelonès;08019;Barcelona;5;183;U;;676;174;321;385;291;2;4;379;383
8;Barcelona;13;Barcelonès;08019;Barcelona;5;19;U;;594;230;328;400;194;0;4;396;400
8;Barcelona;13;Barcelonès;08019;Barcelona;5;2;U;;600;147;327;415;185;1;5;409;414
8;Barcelona;13;Barcelonès;08019;Barcelona;5;20;U;;551;147;289;350;201;1;5;344;349
8;Barcelona;13;Barcelonès;08019;Barcelona;5;21;U;;502;158;298;361;141;0;7;354;361
8;Barcelona;13;Barcelonès;08019;Barcelona;5;23;U;;571;171;320;401;170;0;5;396;401
8;Barcelona;13;Barcelonès;08019;Barcelona;5;24;U;;604;169;346;439;165;0;5;434;439
8;Barcelona;13;Barcelonès;08019;Barcelona;5;25;U;;611;197;343;421;190;0;8;413;421
8;Barcelona;13;Barcelonès;08019;Barcelona;5;27;U;;642;161;359;439;203;0;6;433;439
8;Barcelona;13;Barcelonès;08019;Barcelona;5;28;U;;606;169;334;433;173;3;7;423;430
8;Barcelona;13;Barcelonès;08019;Barcelona;5;29;U;;1082;316;642;827;255;0;19;808;827
8;Barcelona;13;Barcelonès;08019;Barcelona;5;3;A;;649;140;344;456;193;0;6;450;456
8;Barcelona;13;Barcelonès;08019;Barcelona;5;3;B;;676;133;368;503;173;0;13;490;503
8;Barcelona;13;Barcelonès;08019;Barcelona;5;31;U;;758;205;413;519;239;0;8;511;519
8;Barcelona;13;Barcelonès;08019;Barcelona;5;32;U;;513;127;282;354;159;0;3;351;354
8;Barcelona;13;Barcelonès;08019;Barcelona;5;33;U;;502;134;256;355;147;0;11;344;355
8;Barcelona;13;Barcelonès;08019;Barcelona;5;34;U;;722;182;377;493;229;0;7;486;493
8;Barcelona;13;Barcelonès;08019;Barcelona;5;35;U;;1120;246;550;728;392;3;9;716;725
8;Barcelona;13;Barcelonès;08019;Barcelona;5;37;U;;796;231;418;531;265;0;8;523;531
8;Barcelona;13;Barcelonès;08019;Barcelona;5;38;U;;524;135;267;349;175;0;4;345;349
8;Barcelona;13;Barcelonès;08019;Barcelona;5;39;U;;1013;220;521;683;330;1;5;677;682
8;Barcelona;13;Barcelonès;08019;Barcelona;5;4;U;;882;174;465;636;246;0;11;625;636
8;Barcelona;13;Barcelonès;08019;Barcelona;5;40;U;;567;145;343;421;146;1;7;413;420
8;Barcelona;13;Barcelonès;08019;Barcelona;5;41;U;;1017;263;562;711;306;3;11;697;708
8;Barcelona;13;Barcelonès;08019;Barcelona;5;42;U;;769;198;459;518;251;1;0;517;517
8;Barcelona;13;Barcelonès;08019;Barcelona;5;43;U;;1066;253;597;790;276;4;8;778;786
8;Barcelona;13;Barcelonès;08019;Barcelona;5;45;U;;541;117;283;380;161;0;3;377;380
8;Barcelona;13;Barcelonès;08019;Barcelona;5;46;U;;682;168;387;519;163;2;6;511;517
8;Barcelona;13;Barcelonès;08019;Barcelona;5;47;U;;642;170;388;482;160;0;6;476;482
8;Barcelona;13;Barcelonès;08019;Barcelona;5;48;U;;1115;292;615;783;332;0;15;768;783
8;Barcelona;13;Barcelonès;08019;Barcelona;5;49;U;;636;198;375;454;182;1;10;443;453
8;Barcelona;13;Barcelonès;08019;Barcelona;5;5;U;;932;213;463;651;281;1;12;638;650
8;Barcelona;13;Barcelonès;08019;Barcelona;5;50;U;;612;125;282;403;209;2;5;396;401
8;Barcelona;13;Barcelonès;08019;Barcelona;5;52;U;;724;202;416;536;188;0;8;528;536
8;Barcelona;13;Barcelonès;08019;Barcelona;5;53;U;;553;143;286;385;168;0;4;381;385
8;Barcelona;13;Barcelonès;08019;Barcelona;5;54;U;;707;180;394;507;200;1;7;499;506
8;Barcelona;13;Barcelonès;08019;Barcelona;5;55;U;;895;270;518;631;264;1;6;624;630
8;Barcelona;13;Barcelonès;08019;Barcelona;5;56;U;;608;131;335;456;152;0;12;444;456
8;Barcelona;13;Barcelonès;08019;Barcelona;5;57;U;;602;139;324;436;166;1;8;427;435
8;Barcelona;13;Barcelonès;08019;Barcelona;5;58;U;;842;234;478;608;234;1;7;600;607
8;Barcelona;13;Barcelonès;08019;Barcelona;5;59;U;;494;135;274;358;136;0;1;357;358
8;Barcelona;13;Barcelonès;08019;Barcelona;5;6;U;;1140;253;639;831;309;1;11;819;830
8;Barcelona;13;Barcelonès;08019;Barcelona;5;60;U;;730;207;402;520;210;0;5;515;520
8;Barcelona;13;Barcelonès;08019;Barcelona;5;61;U;;738;172;393;529;209;1;9;519;528
8;Barcelona;13;Barcelonès;08019;Barcelona;5;62;U;;717;179;418;525;192;6;6;513;519
8;Barcelona;13;Barcelonès;08019;Barcelona;5;64;U;;642;147;308;385;257;0;8;377;385
8;Barcelona;13;Barcelonès;08019;Barcelona;5;65;U;;924;267;484;619;305;2;12;605;617
8;Barcelona;13;Barcelonès;08019;Barcelona;5;67;U;;915;232;501;636;279;2;7;627;634
8;Barcelona;13;Barcelonès;08019;Barcelona;5;68;U;;542;146;279;346;196;1;5;340;345
8;Barcelona;13;Barcelonès;08019;Barcelona;5;69;U;;1104;303;594;722;382;0;13;709;722
8;Barcelona;13;Barcelonès;08019;Barcelona;5;70;U;;645;189;389;468;177;0;10;458;468
8;Barcelona;13;Barcelonès;08019;Barcelona;5;72;U;;695;186;393;494;201;1;8;485;493
8;Barcelona;13;Barcelonès;08019;Barcelona;5;73;U;;1079;292;589;763;316;0;9;754;763
8;Barcelona;13;Barcelonès;08019;Barcelona;5;75;U;;705;201;376;474;231;0;4;470;474
8;Barcelona;13;Barcelonès;08019;Barcelona;5;76;U;;625;159;342;426;199;2;7;417;424
8;Barcelona;13;Barcelonès;08019;Barcelona;5;77;U;;1066;266;563;738;328;1;10;727;737
8;Barcelona;13;Barcelonès;08019;Barcelona;5;79;U;;690;207;400;508;182;0;4;504;508
8;Barcelona;13;Barcelonès;08019;Barcelona;5;8;U;;564;131;286;372;192;2;6;364;370
8;Barcelona;13;Barcelonès;08019;Barcelona;5;80;U;;936;275;537;696;240;1;7;688;695
8;Barcelona;13;Barcelonès;08019;Barcelona;5;81;U;;526;140;273;358;168;1;5;352;357
8;Barcelona;13;Barcelonès;08019;Barcelona;5;82;U;;836;211;451;604;232;0;13;591;604
8;Barcelona;13;Barcelonès;08019;Barcelona;5;84;A;;691;163;371;500;191;0;9;491;500
8;Barcelona;13;Barcelonès;08019;Barcelona;5;84;B;;762;201;410;538;224;1;3;534;537
8;Barcelona;13;Barcelonès;08019;Barcelona;5;86;U;;809;200;414;524;285;0;8;516;524
8;Barcelona;13;Barcelonès;08019;Barcelona;5;87;U;;588;177;338;412;176;2;2;408;410
8;Barcelona;13;Barcelonès;08019;Barcelona;5;88;U;;569;120;269;390;179;0;12;378;390
8;Barcelona;13;Barcelonès;08019;Barcelona;5;89;U;;904;220;456;620;284;0;9;611;620
8;Barcelona;13;Barcelonès;08019;Barcelona;5;90;U;;711;138;368;497;214;0;4;493;497
8;Barcelona;13;Barcelonès;08019;Barcelona;5;91;A;;953;255;487;650;303;4;8;638;646
8;Barcelona;13;Barcelonès;08019;Barcelona;5;91;B;;1217;287;624;836;381;0;9;827;836
8;Barcelona;13;Barcelonès;08019;Barcelona;5;93;U;;516;106;274;364;152;0;7;357;364
8;Barcelona;13;Barcelonès;08019;Barcelona;5;94;U;;564;119;279;364;200;0;0;364;364
8;Barcelona;13;Barcelonès;08019;Barcelona;5;95;U;;879;193;436;557;322;0;12;545;557
8;Barcelona;13;Barcelonès;08019;Barcelona;5;96;U;;675;150;355;486;189;1;7;478;485
8;Barcelona;13;Barcelonès;08019;Barcelona;5;97;A;;685;179;379;483;202;0;6;477;483
8;Barcelona;13;Barcelonès;08019;Barcelona;5;97;B;;756;183;418;536;220;1;8;527;535
8;Barcelona;13;Barcelonès;08019;Barcelona;5;98;U;;627;202;328;412;215;0;5;407;412
8;Barcelona;13;Barcelonès;08019;Barcelona;5;99;U;;563;156;309;417;146;0;2;415;417
8;Barcelona;13;Barcelonès;08019;Barcelona;6;1;A;;649;210;353;444;205;2;8;434;442
8;Barcelona;13;Barcelonès;08019;Barcelona;6;1;B;;611;172;297;393;218;2;5;386;391
8;Barcelona;13;Barcelonès;08019;Barcelona;6;10;U;;765;191;379;459;306;2;2;455;457
8;Barcelona;13;Barcelonès;08019;Barcelona;6;100;U;;784;230;399;519;265;2;5;512;517
8;Barcelona;13;Barcelonès;08019;Barcelona;6;102;U;;643;196;352;438;205;0;5;433;438
8;Barcelona;13;Barcelonès;08019;Barcelona;6;103;U;;900;299;519;652;248;2;8;642;650
8;Barcelona;13;Barcelonès;08019;Barcelona;6;104;U;;652;172;351;426;226;1;6;419;425
8;Barcelona;13;Barcelonès;08019;Barcelona;6;105;U;;755;213;404;500;255;1;6;493;499
8;Barcelona;13;Barcelonès;08019;Barcelona;6;106;U;;784;203;352;455;329;6;1;448;449
8;Barcelona;13;Barcelonès;08019;Barcelona;6;107;U;;1021;300;559;684;337;4;12;668;680
8;Barcelona;13;Barcelonès;08019;Barcelona;6;109;U;;739;210;354;465;274;1;1;463;464
8;Barcelona;13;Barcelonès;08019;Barcelona;6;11;U;;966;275;489;590;376;0;11;579;590
8;Barcelona;13;Barcelonès;08019;Barcelona;6;110;U;;997;250;482;634;363;1;10;623;633
8;Barcelona;13;Barcelonès;08019;Barcelona;6;112;U;;931;288;493;610;321;1;6;603;609
8;Barcelona;13;Barcelonès;08019;Barcelona;6;113;U;;869;271;501;622;247;3;9;610;619
8;Barcelona;13;Barcelonès;08019;Barcelona;6;114;A;;801;214;455;567;234;0;7;560;567
8;Barcelona;13;Barcelonès;08019;Barcelona;6;114;B;;969;222;616;690;279;0;13;677;690
8;Barcelona;13;Barcelonès;08019;Barcelona;6;115;A;;558;149;321;408;150;0;5;403;408
8;Barcelona;13;Barcelonès;08019;Barcelona;6;115;B;;658;175;383;485;173;0;6;479;485
8;Barcelona;13;Barcelonès;08019;Barcelona;6;116;U;;576;157;295;390;186;0;4;386;390
8;Barcelona;13;Barcelonès;08019;Barcelona;6;117;U;;799;219;414;550;249;1;6;543;549
8;Barcelona;13;Barcelonès;08019;Barcelona;6;118;U;;813;216;439;570;243;1;6;563;569
8;Barcelona;13;Barcelonès;08019;Barcelona;6;119;U;;796;239;430;540;256;1;11;528;539
8;Barcelona;13;Barcelonès;08019;Barcelona;6;12;U;;489;148;241;306;183;0;3;303;306
8;Barcelona;13;Barcelonès;08019;Barcelona;6;120;U;;730;187;392;495;235;0;8;487;495
8;Barcelona;13;Barcelonès;08019;Barcelona;6;121;U;;729;190;358;458;271;1;5;452;457
8;Barcelona;13;Barcelonès;08019;Barcelona;6;122;U;;1189;241;655;867;322;4;13;850;863
8;Barcelona;13;Barcelonès;08019;Barcelona;6;124;U;;759;200;324;381;378;0;6;375;381
8;Barcelona;13;Barcelonès;08019;Barcelona;6;125;U;;627;161;289;353;274;0;2;351;353
8;Barcelona;13;Barcelonès;08019;Barcelona;6;127;U;;912;200;400;562;350;0;5;557;562
8;Barcelona;13;Barcelonès;08019;Barcelona;6;128;U;;909;338;564;622;287;1;2;619;621
8;Barcelona;13;Barcelonès;08019;Barcelona;6;129;U;;539;138;245;349;190;3;7;339;346
8;Barcelona;13;Barcelonès;08019;Barcelona;6;13;U;;582;159;275;342;240;2;5;335;340
8;Barcelona;13;Barcelonès;08019;Barcelona;6;130;U;;593;161;294;379;214;1;2;376;378
8;Barcelona;13;Barcelonès;08019;Barcelona;6;131;U;;772;210;374;480;292;1;8;471;479
8;Barcelona;13;Barcelonès;08019;Barcelona;6;132;U;;760;198;341;427;333;1;2;424;426
8;Barcelona;13;Barcelonès;08019;Barcelona;6;133;U;;713;190;376;437;276;0;3;434;437
8;Barcelona;13;Barcelonès;08019;Barcelona;6;134;A;;682;221;377;461;221;1;2;458;460
8;Barcelona;13;Barcelonès;08019;Barcelona;6;134;B;;757;236;421;518;239;1;4;513;517
8;Barcelona;13;Barcelonès;08019;Barcelona;6;136;A;;564;143;273;353;211;0;0;353;353
8;Barcelona;13;Barcelonès;08019;Barcelona;6;136;B;;626;172;295;386;240;0;6;380;386
8;Barcelona;13;Barcelonès;08019;Barcelona;6;137;U;;624;192;352;418;206;1;4;413;417
8;Barcelona;13;Barcelonès;08019;Barcelona;6;138;U;;837;283;458;541;296;0;4;537;541
8;Barcelona;13;Barcelonès;08019;Barcelona;6;139;U;;675;184;333;411;264;1;5;405;410
8;Barcelona;13;Barcelonès;08019;Barcelona;6;14;U;;841;251;429;534;307;2;5;527;532
8;Barcelona;13;Barcelonès;08019;Barcelona;6;140;U;;676;184;345;451;225;2;4;445;449
8;Barcelona;13;Barcelonès;08019;Barcelona;6;141;U;;614;173;339;407;207;1;4;402;406
8;Barcelona;13;Barcelonès;08019;Barcelona;6;142;A;;612;144;280;360;252;3;6;351;357
8;Barcelona;13;Barcelonès;08019;Barcelona;6;142;B;;641;157;287;364;277;3;6;355;361
8;Barcelona;13;Barcelonès;08019;Barcelona;6;144;U;;694;153;346;431;263;0;7;424;431
8;Barcelona;13;Barcelonès;08019;Barcelona;6;145;U;;1068;223;475;608;460;1;0;607;607
8;Barcelona;13;Barcelonès;08019;Barcelona;6;146;U;;814;192;361;447;367;2;4;441;445
8;Barcelona;13;Barcelonès;08019;Barcelona;6;148;U;;655;154;288;390;265;1;3;386;389
8;Barcelona;13;Barcelonès;08019;Barcelona;6;149;U;;669;146;300;389;280;1;9;379;388
8;Barcelona;13;Barcelonès;08019;Barcelona;6;150;U;;1161;305;643;832;329;0;18;814;832
8;Barcelona;13;Barcelonès;08019;Barcelona;6;152;U;;626;128;415;433;193;1;13;419;432
8;Barcelona;13;Barcelonès;08019;Barcelona;6;153;U;;718;185;386;494;224;2;2;490;492
8;Barcelona;13;Barcelonès;08019;Barcelona;6;154;A;;866;250;459;562;304;0;12;550;562
8;Barcelona;13;Barcelonès;08019;Barcelona;6;154;B;;974;245;480;600;374;0;5;595;600
8;Barcelona;13;Barcelonès;08019;Barcelona;6;157;A;;763;237;423;528;235;1;8;519;527
8;Barcelona;13;Barcelonès;08019;Barcelona;6;157;B;;861;268;477;563;298;3;5;555;560
8;Barcelona;13;Barcelonès;08019;Barcelona;6;158;A;;595;149;306;403;192;0;9;394;403
8;Barcelona;13;Barcelonès;08019;Barcelona;6;158;B;;649;162;350;434;215;1;7;426;433
8;Barcelona;13;Barcelonès;08019;Barcelona;6;16;U;;681;180;312;366;315;1;4;361;365
8;Barcelona;13;Barcelonès;08019;Barcelona;6;17;U;;584;160;270;334;250;0;4;330;334
8;Barcelona;13;Barcelonès;08019;Barcelona;6;18;U;;702;201;336;405;297;4;6;395;401
8;Barcelona;13;Barcelonès;08019;Barcelona;6;19;U;;606;183;311;395;211;1;4;390;394
8;Barcelona;13;Barcelonès;08019;Barcelona;6;20;U;;832;264;460;552;280;0;7;545;552
8;Barcelona;13;Barcelonès;08019;Barcelona;6;21;U;;650;336;366;435;215;2;8;425;433
8;Barcelona;13;Barcelonès;08019;Barcelona;6;22;U;;1073;338;515;663;410;0;3;660;663
8;Barcelona;13;Barcelonès;08019;Barcelona;6;23;U;;985;276;548;665;320;2;3;660;663
8;Barcelona;13;Barcelonès;08019;Barcelona;6;26;U;;1132;345;638;779;353;0;9;770;779
8;Barcelona;13;Barcelonès;08019;Barcelona;6;28;U;;658;175;309;395;263;0;3;392;395
8;Barcelona;13;Barcelonès;08019;Barcelona;6;29;U;;927;268;501;617;310;3;6;608;614
8;Barcelona;13;Barcelonès;08019;Barcelona;6;30;U;;704;185;343;444;260;3;4;437;441
8;Barcelona;13;Barcelonès;08019;Barcelona;6;31;U;;798;232;402;499;299;0;3;496;499
8;Barcelona;13;Barcelonès;08019;Barcelona;6;32;U;;812;225;425;531;281;0;4;527;531
8;Barcelona;13;Barcelonès;08019;Barcelona;6;33;U;;624;180;314;370;254;1;5;364;369
8;Barcelona;13;Barcelonès;08019;Barcelona;6;34;U;;943;255;501;649;294;2;2;645;647
8;Barcelona;13;Barcelonès;08019;Barcelona;6;35;U;;972;262;503;628;344;0;7;621;628
8;Barcelona;13;Barcelonès;08019;Barcelona;6;36;U;;592;176;336;434;158;0;5;429;434
8;Barcelona;13;Barcelonès;08019;Barcelona;6;37;U;;670;209;397;501;169;2;11;488;499
8;Barcelona;13;Barcelonès;08019;Barcelona;6;38;U;;872;243;458;584;288;1;1;582;583
8;Barcelona;13;Barcelonès;08019;Barcelona;6;39;U;;587;181;317;412;175;2;6;404;410
8;Barcelona;13;Barcelonès;08019;Barcelona;6;4;U;;983;287;516;645;338;0;9;636;645
8;Barcelona;13;Barcelonès;08019;Barcelona;6;40;U;;838;199;416;544;294;2;6;536;542
8;Barcelona;13;Barcelonès;08019;Barcelona;6;41;A;;574;164;320;408;166;3;2;403;405
8;Barcelona;13;Barcelonès;08019;Barcelona;6;41;B;;658;215;386;467;191;0;3;464;467
8;Barcelona;13;Barcelonès;08019;Barcelona;6;42;U;;927;297;526;614;313;0;12;602;614
8;Barcelona;13;Barcelonès;08019;Barcelona;6;43;U;;937;219;480;640;297;3;8;629;637
8;Barcelona;13;Barcelonès;08019;Barcelona;6;44;U;;974;272;518;643;331;2;1;640;641
8;Barcelona;13;Barcelonès;08019;Barcelona;6;45;U;;697;190;331;401;296;0;5;396;401
8;Barcelona;13;Barcelonès;08019;Barcelona;6;47;U;;509;149;276;339;170;0;0;339;339
8;Barcelona;13;Barcelonès;08019;Barcelona;6;48;U;;591;157;297;381;210;3;7;371;378
8;Barcelona;13;Barcelonès;08019;Barcelona;6;49;U;;534;131;277;340;194;1;2;337;339
8;Barcelona;13;Barcelonès;08019;Barcelona;6;50;U;;868;239;439;574;294;0;3;571;574
8;Barcelona;13;Barcelonès;08019;Barcelona;6;52;U;;954;261;470;629;325;2;10;617;627
8;Barcelona;13;Barcelonès;08019;Barcelona;6;54;U;;634;177;352;443;191;0;3;440;443
8;Barcelona;13;Barcelonès;08019;Barcelona;6;55;U;;840;242;453;579;261;0;5;574;579
8;Barcelona;13;Barcelonès;08019;Barcelona;6;56;U;;794;231;417;519;275;6;9;504;513
8;Barcelona;13;Barcelonès;08019;Barcelona;6;57;U;;1132;338;586;751;381;1;11;739;750
8;Barcelona;13;Barcelonès;08019;Barcelona;6;58;U;;522;121;273;360;162;2;3;355;358
8;Barcelona;13;Barcelonès;08019;Barcelona;6;59;U;;1011;240;515;704;307;0;6;698;704
8;Barcelona;13;Barcelonès;08019;Barcelona;6;6;U;;1018;299;528;640;378;1;8;631;639
8;Barcelona;13;Barcelonès;08019;Barcelona;6;60;U;;567;157;275;352;215;1;5;346;351
8;Barcelona;13;Barcelonès;08019;Barcelona;6;61;U;;605;158;307;399;206;0;6;393;399
8;Barcelona;13;Barcelonès;08019;Barcelona;6;63;U;;489;142;225;303;186;1;0;302;302
8;Barcelona;13;Barcelonès;08019;Barcelona;6;64;U;;681;196;348;417;264;2;4;411;415
8;Barcelona;13;Barcelonès;08019;Barcelona;6;66;A;;582;170;298;364;218;2;5;357;362
8;Barcelona;13;Barcelonès;08019;Barcelona;6;66;B;;633;167;311;394;239;0;4;390;394
8;Barcelona;13;Barcelonès;08019;Barcelona;6;68;U;;738;207;335;421;317;0;4;417;421
8;Barcelona;13;Barcelonès;08019;Barcelona;6;69;U;;901;269;475;588;313;0;10;578;588
8;Barcelona;13;Barcelonès;08019;Barcelona;6;72;U;;967;299;516;626;341;0;10;616;626
8;Barcelona;13;Barcelonès;08019;Barcelona;6;74;U;;958;263;472;615;343;1;8;606;614
8;Barcelona;13;Barcelonès;08019;Barcelona;6;76;U;;585;170;296;359;226;0;4;355;359
8;Barcelona;13;Barcelonès;08019;Barcelona;6;77;U;;533;147;252;327;206;0;4;323;327
8;Barcelona;13;Barcelonès;08019;Barcelona;6;78;U;;836;214;386;514;322;4;6;504;510
8;Barcelona;13;Barcelonès;08019;Barcelona;6;8;U;;991;244;467;589;402;0;9;580;589
8;Barcelona;13;Barcelonès;08019;Barcelona;6;80;U;;1009;309;485;613;396;2;10;601;611
8;Barcelona;13;Barcelonès;08019;Barcelona;6;82;U;;892;226;425;569;323;0;5;564;569
8;Barcelona;13;Barcelonès;08019;Barcelona;6;84;U;;649;166;332;395;254;0;5;390;395
8;Barcelona;13;Barcelonès;08019;Barcelona;6;85;U;;670;191;476;462;208;0;0;462;462
8;Barcelona;13;Barcelonès;08019;Barcelona;6;86;U;;907;265;470;598;309;1;8;589;597
8;Barcelona;13;Barcelonès;08019;Barcelona;6;88;U;;1006;289;521;650;356;0;4;646;650
8;Barcelona;13;Barcelonès;08019;Barcelona;6;89;U;;882;285;525;623;259;5;8;610;618
8;Barcelona;13;Barcelonès;08019;Barcelona;6;91;U;;493;162;279;328;165;0;4;324;328
8;Barcelona;13;Barcelonès;08019;Barcelona;6;92;U;;528;162;291;349;179;0;6;343;349
8;Barcelona;13;Barcelonès;08019;Barcelona;6;93;U;;620;163;310;382;238;0;4;378;382
8;Barcelona;13;Barcelonès;08019;Barcelona;6;94;U;;680;160;303;387;293;1;2;384;386
8;Barcelona;13;Barcelonès;08019;Barcelona;6;95;U;;612;154;292;371;241;1;1;369;370
8;Barcelona;13;Barcelonès;08019;Barcelona;6;96;U;;548;168;280;349;199;0;6;343;349
8;Barcelona;13;Barcelonès;08019;Barcelona;6;97;U;;947;220;474;633;314;1;9;623;632
8;Barcelona;13;Barcelonès;08019;Barcelona;6;98;U;;820;252;470;569;251;1;9;559;568
8;Barcelona;13;Barcelonès;08019;Barcelona;7;1;A;;735;206;418;507;228;0;8;499;507
8;Barcelona;13;Barcelonès;08019;Barcelona;7;1;B;;777;236;420;513;264;2;6;505;511
8;Barcelona;13;Barcelonès;08019;Barcelona;7;10;U;;920;186;421;580;340;2;12;566;578
8;Barcelona;13;Barcelonès;08019;Barcelona;7;100;U;;883;205;408;533;350;0;4;529;533
8;Barcelona;13;Barcelonès;08019;Barcelona;7;101;U;;629;135;289;394;235;0;4;390;394
8;Barcelona;13;Barcelonès;08019;Barcelona;7;102;U;;527;154;276;341;186;0;5;336;341
8;Barcelona;13;Barcelonès;08019;Barcelona;7;103;U;;583;153;320;399;184;1;4;394;398
8;Barcelona;13;Barcelonès;08019;Barcelona;7;104;U;;1158;291;543;716;442;1;9;706;715
8;Barcelona;13;Barcelonès;08019;Barcelona;7;105;U;;649;162;321;411;238;1;10;400;410
8;Barcelona;13;Barcelonès;08019;Barcelona;7;106;U;;696;213;371;488;208;0;7;481;488
8;Barcelona;13;Barcelonès;08019;Barcelona;7;107;U;;554;170;322;379;175;0;2;377;379
8;Barcelona;13;Barcelonès;08019;Barcelona;7;108;U;;620;172;291;373;247;0;4;369;373
8;Barcelona;13;Barcelonès;08019;Barcelona;7;109;U;;708;199;375;464;244;1;6;457;463
8;Barcelona;13;Barcelonès;08019;Barcelona;7;11;U;;712;167;357;451;261;4;4;443;447
8;Barcelona;13;Barcelonès;08019;Barcelona;7;110;U;;1172;249;493;597;575;0;2;595;597
8;Barcelona;13;Barcelonès;08019;Barcelona;7;112;U;;582;134;252;345;237;0;2;343;345
8;Barcelona;13;Barcelonès;08019;Barcelona;7;113;U;;664;166;270;331;333;0;1;330;331
8;Barcelona;13;Barcelonès;08019;Barcelona;7;114;U;;726;156;280;373;353;0;3;370;373
8;Barcelona;13;Barcelonès;08019;Barcelona;7;116;U;;883;180;311;426;457;1;1;424;425
8;Barcelona;13;Barcelonès;08019;Barcelona;7;117;U;;825;206;362;472;353;0;10;462;472
8;Barcelona;13;Barcelonès;08019;Barcelona;7;118;U;;1038;221;395;515;523;0;3;512;515
8;Barcelona;13;Barcelonès;08019;Barcelona;7;119;U;;910;210;367;481;429;0;4;477;481
8;Barcelona;13;Barcelonès;08019;Barcelona;7;12;U;;655;183;334;426;229;6;6;414;420
8;Barcelona;13;Barcelonès;08019;Barcelona;7;120;U;;693;168;313;399;294;3;8;388;396
8;Barcelona;13;Barcelonès;08019;Barcelona;7;121;U;;558;121;245;318;240;1;3;314;317
8;Barcelona;13;Barcelonès;08019;Barcelona;7;122;U;;953;208;404;517;436;1;1;515;516
8;Barcelona;13;Barcelonès;08019;Barcelona;7;123;A;;699;170;316;399;300;7;4;388;392
8;Barcelona;13;Barcelonès;08019;Barcelona;7;123;B;;852;197;377;494;358;0;2;492;494
8;Barcelona;13;Barcelonès;08019;Barcelona;7;124;U;;767;154;307;403;364;1;5;397;402
8;Barcelona;13;Barcelonès;08019;Barcelona;7;125;U;;1081;230;414;561;520;6;7;548;555
8;Barcelona;13;Barcelonès;08019;Barcelona;7;127;U;;738;169;311;398;340;0;2;396;398
8;Barcelona;13;Barcelonès;08019;Barcelona;7;128;U;;795;159;328;432;363;0;9;423;432
8;Barcelona;13;Barcelonès;08019;Barcelona;7;129;U;;617;150;236;329;288;0;2;327;329
8;Barcelona;13;Barcelonès;08019;Barcelona;7;13;U;;920;281;512;615;305;0;12;603;615
8;Barcelona;13;Barcelonès;08019;Barcelona;7;130;U;;548;123;219;271;277;0;2;269;271
8;Barcelona;13;Barcelonès;08019;Barcelona;7;131;U;;795;170;315;409;386;3;2;404;406
8;Barcelona;13;Barcelonès;08019;Barcelona;7;132;U;;554;125;219;294;260;1;4;289;293
8;Barcelona;13;Barcelonès;08019;Barcelona;7;133;U;;877;201;384;525;352;0;12;513;525
8;Barcelona;13;Barcelonès;08019;Barcelona;7;134;A;;646;156;271;359;287;0;2;357;359
8;Barcelona;13;Barcelonès;08019;Barcelona;7;134;B;;716;170;311;417;299;0;6;411;417
8;Barcelona;13;Barcelonès;08019;Barcelona;7;136;U;;516;129;226;290;226;0;2;288;290
8;Barcelona;13;Barcelonès;08019;Barcelona;7;137;U;;909;230;403;511;398;1;5;505;510
8;Barcelona;13;Barcelonès;08019;Barcelona;7;138;U;;683;187;319;423;260;1;1;421;422
8;Barcelona;13;Barcelonès;08019;Barcelona;7;139;U;;1001;271;481;578;423;0;7;571;578
8;Barcelona;13;Barcelonès;08019;Barcelona;7;14;U;;984;269;465;589;395;0;6;583;589
8;Barcelona;13;Barcelonès;08019;Barcelona;7;140;U;;527;138;257;326;201;1;6;319;325
8;Barcelona;13;Barcelonès;08019;Barcelona;7;141;U;;701;165;346;434;267;0;11;423;434
8;Barcelona;13;Barcelonès;08019;Barcelona;7;142;A;;563;148;271;321;242;0;0;321;321
8;Barcelona;13;Barcelonès;08019;Barcelona;7;142;B;;663;167;299;378;285;4;7;367;374
8;Barcelona;13;Barcelonès;08019;Barcelona;7;144;A;;551;172;277;354;197;1;2;351;353
8;Barcelona;13;Barcelonès;08019;Barcelona;7;144;B;;674;157;308;392;282;1;3;388;391
8;Barcelona;13;Barcelonès;08019;Barcelona;7;147;A;;593;175;311;370;223;0;1;369;370
8;Barcelona;13;Barcelonès;08019;Barcelona;7;147;B;;642;158;302;386;256;0;2;384;386
8;Barcelona;13;Barcelonès;08019;Barcelona;7;148;U;;1086;245;458;584;502;0;6;578;584
8;Barcelona;13;Barcelonès;08019;Barcelona;7;15;U;;549;139;279;358;191;1;2;355;357
8;Barcelona;13;Barcelonès;08019;Barcelona;7;150;U;;928;258;458;567;361;0;10;557;567
8;Barcelona;13;Barcelonès;08019;Barcelona;7;151;U;;645;150;295;385;260;0;6;379;385
8;Barcelona;13;Barcelonès;08019;Barcelona;7;152;U;;616;184;333;402;214;0;4;398;402
8;Barcelona;13;Barcelonès;08019;Barcelona;7;155;U;;958;248;453;602;356;1;6;595;601
8;Barcelona;13;Barcelonès;08019;Barcelona;7;157;U;;768;197;383;495;273;1;8;486;494
8;Barcelona;13;Barcelonès;08019;Barcelona;7;158;U;;784;194;350;494;290;0;4;490;494
8;Barcelona;13;Barcelonès;08019;Barcelona;7;159;U;;809;185;377;486;323;0;12;474;486
8;Barcelona;13;Barcelonès;08019;Barcelona;7;16;U;;946;237;430;566;380;2;5;559;564
8;Barcelona;13;Barcelonès;08019;Barcelona;7;160;U;;554;162;275;339;215;3;4;332;336
8;Barcelona;13;Barcelonès;08019;Barcelona;7;161;U;;500;174;277;357;143;1;0;356;356
8;Barcelona;13;Barcelonès;08019;Barcelona;7;162;U;;747;168;355;472;275;6;9;457;466
8;Barcelona;13;Barcelonès;08019;Barcelona;7;163;U;;1039;239;472;620;419;9;6;605;611
8;Barcelona;13;Barcelonès;08019;Barcelona;7;165;U;;645;142;297;398;247;0;2;396;398
8;Barcelona;13;Barcelonès;08019;Barcelona;7;166;U;;1214;266;603;794;420;0;13;781;794
8;Barcelona;13;Barcelonès;08019;Barcelona;7;167;U;;879;200;411;527;352;1;8;518;526
8;Barcelona;13;Barcelonès;08019;Barcelona;7;169;U;;697;194;351;435;262;1;4;430;434
8;Barcelona;13;Barcelonès;08019;Barcelona;7;170;U;;973;234;388;503;470;0;5;498;503
8;Barcelona;13;Barcelonès;08019;Barcelona;7;172;U;;565;144;284;375;190;0;1;374;375
8;Barcelona;13;Barcelonès;08019;Barcelona;7;173;U;;1000;308;503;591;409;3;6;582;588
8;Barcelona;13;Barcelonès;08019;Barcelona;7;174;U;;798;231;439;539;259;0;7;532;539
8;Barcelona;13;Barcelonès;08019;Barcelona;7;176;U;;598;173;356;426;172;2;3;421;424
8;Barcelona;13;Barcelonès;08019;Barcelona;7;177;U;;1092;254;508;660;432;0;7;653;660
8;Barcelona;13;Barcelonès;08019;Barcelona;7;179;U;;645;157;313;425;220;2;8;415;423
8;Barcelona;13;Barcelonès;08019;Barcelona;7;18;U;;552;239;304;388;164;0;2;386;388
8;Barcelona;13;Barcelonès;08019;Barcelona;7;180;U;;610;157;288;370;240;0;5;365;370
8;Barcelona;13;Barcelonès;08019;Barcelona;7;181;U;;928;221;400;526;402;0;4;522;526
8;Barcelona;13;Barcelonès;08019;Barcelona;7;183;U;;677;169;283;369;308;1;4;364;368
8;Barcelona;13;Barcelonès;08019;Barcelona;7;184;U;;969;272;483;616;353;0;5;611;616
8;Barcelona;13;Barcelonès;08019;Barcelona;7;185;U;;828;294;474;560;268;1;5;554;559
8;Barcelona;13;Barcelonès;08019;Barcelona;7;187;U;;400;98;156;186;214;0;1;185;186
8;Barcelona;13;Barcelonès;08019;Barcelona;7;188;U;;917;175;311;421;496;3;5;413;418
8;Barcelona;13;Barcelonès;08019;Barcelona;7;189;U;;771;163;311;405;366;0;8;397;405
8;Barcelona;13;Barcelonès;08019;Barcelona;7;19;U;;919;148;484;618;301;1;6;611;617
8;Barcelona;13;Barcelonès;08019;Barcelona;7;190;U;;1050;319;544;633;417;3;2;628;630
8;Barcelona;13;Barcelonès;08019;Barcelona;7;191;U;;777;254;448;528;249;1;6;521;527
8;Barcelona;13;Barcelonès;08019;Barcelona;7;192;U;;832;253;411;478;354;0;2;476;478
8;Barcelona;13;Barcelonès;08019;Barcelona;7;193;U;;605;123;270;344;261;0;3;341;344
8;Barcelona;13;Barcelonès;08019;Barcelona;7;194;U;;540;151;306;404;136;1;4;399;403
8;Barcelona;13;Barcelonès;08019;Barcelona;7;195;U;;959;245;496;618;341;1;10;607;617
8;Barcelona;13;Barcelonès;08019;Barcelona;7;196;U;;879;254;433;528;351;4;15;509;524
8;Barcelona;13;Barcelonès;08019;Barcelona;7;197;U;;727;231;400;481;246;0;3;478;481
8;Barcelona;13;Barcelonès;08019;Barcelona;7;198;U;;739;250;418;506;233;0;5;501;506
8;Barcelona;13;Barcelonès;08019;Barcelona;7;2;U;;646;169;345;422;224;0;6;416;422
8;Barcelona;13;Barcelonès;08019;Barcelona;7;20;U;;621;172;287;369;252;1;5;363;368
8;Barcelona;13;Barcelonès;08019;Barcelona;7;200;U;;975;257;419;505;470;1;8;496;504
8;Barcelona;13;Barcelonès;08019;Barcelona;7;201;U;;738;221;374;484;254;0;10;474;484
8;Barcelona;13;Barcelonès;08019;Barcelona;7;202;U;;683;228;368;458;225;1;3;454;457
8;Barcelona;13;Barcelonès;08019;Barcelona;7;204;A;;966;241;505;627;339;0;5;622;627
8;Barcelona;13;Barcelonès;08019;Barcelona;7;204;B;;1007;249;562;702;305;1;4;697;701
8;Barcelona;13;Barcelonès;08019;Barcelona;7;205;A;;642;135;282;391;251;0;4;387;391
8;Barcelona;13;Barcelonès;08019;Barcelona;7;205;B;;742;202;371;491;251;1;7;483;490
8;Barcelona;13;Barcelonès;08019;Barcelona;7;207;A;;760;180;361;470;290;3;3;464;467
8;Barcelona;13;Barcelonès;08019;Barcelona;7;207;B;;748;201;408;475;273;1;5;469;474
8;Barcelona;13;Barcelonès;08019;Barcelona;7;209;U;;1004;239;448;543;461;0;1;542;543
8;Barcelona;13;Barcelonès;08019;Barcelona;7;210;A;;632;155;296;365;267;1;5;359;364
8;Barcelona;13;Barcelonès;08019;Barcelona;7;210;B;;660;161;309;388;272;0;5;383;388
8;Barcelona;13;Barcelonès;08019;Barcelona;7;211;A;;698;147;284;359;339;0;3;356;359
8;Barcelona;13;Barcelonès;08019;Barcelona;7;211;B;;764;164;311;387;377;0;1;386;387
8;Barcelona;13;Barcelonès;08019;Barcelona;7;213;U;;806;189;324;425;381;0;8;417;425
8;Barcelona;13;Barcelonès;08019;Barcelona;7;214;U;;604;114;262;344;260;0;3;341;344
8;Barcelona;13;Barcelonès;08019;Barcelona;7;215;U;;1037;232;397;544;493;1;3;540;543
8;Barcelona;13;Barcelonès;08019;Barcelona;7;217;U;;518;114;230;302;216;0;1;301;302
8;Barcelona;13;Barcelonès;08019;Barcelona;7;218;U;;699;191;325;404;295;2;7;395;402
8;Barcelona;13;Barcelonès;08019;Barcelona;7;219;U;;761;206;365;445;316;0;5;440;445
8;Barcelona;13;Barcelonès;08019;Barcelona;7;220;U;;763;184;341;434;329;1;0;433;433
8;Barcelona;13;Barcelonès;08019;Barcelona;7;221;U;;742;165;319;435;307;1;6;428;434
8;Barcelona;13;Barcelonès;08019;Barcelona;7;23;U;;539;158;272;350;189;1;2;347;349
8;Barcelona;13;Barcelonès;08019;Barcelona;7;24;U;;779;231;401;482;297;1;5;476;481
8;Barcelona;13;Barcelonès;08019;Barcelona;7;26;U;;567;159;278;371;196;3;3;365;368
8;Barcelona;13;Barcelonès;08019;Barcelona;7;27;U;;502;136;237;303;199;0;2;301;303
8;Barcelona;13;Barcelonès;08019;Barcelona;7;28;U;;483;134;259;307;176;0;5;302;307
8;Barcelona;13;Barcelonès;08019;Barcelona;7;29;U;;755;212;397;488;267;0;11;477;488
8;Barcelona;13;Barcelonès;08019;Barcelona;7;3;U;;647;189;327;385;262;0;4;381;385
8;Barcelona;13;Barcelonès;08019;Barcelona;7;31;U;;848;262;433;555;293;2;7;546;553
8;Barcelona;13;Barcelonès;08019;Barcelona;7;32;U;;562;155;286;343;219;1;5;337;342
8;Barcelona;13;Barcelonès;08019;Barcelona;7;33;U;;795;227;442;543;252;2;9;532;541
8;Barcelona;13;Barcelonès;08019;Barcelona;7;34;U;;957;229;436;529;428;0;7;522;529
8;Barcelona;13;Barcelonès;08019;Barcelona;7;36;U;;507;110;234;308;199;0;1;307;308
8;Barcelona;13;Barcelonès;08019;Barcelona;7;37;U;;580;134;258;384;196;0;11;373;384
8;Barcelona;13;Barcelonès;08019;Barcelona;7;38;U;;718;173;323;423;295;0;1;422;423
8;Barcelona;13;Barcelonès;08019;Barcelona;7;39;U;;576;190;327;403;173;4;4;395;399
8;Barcelona;13;Barcelonès;08019;Barcelona;7;4;U;;844;243;423;549;295;1;2;546;548
8;Barcelona;13;Barcelonès;08019;Barcelona;7;40;U;;609;168;317;417;192;1;8;408;416
8;Barcelona;13;Barcelonès;08019;Barcelona;7;41;U;;479;126;227;285;194;0;6;279;285
8;Barcelona;13;Barcelonès;08019;Barcelona;7;42;U;;512;146;237;317;195;2;5;310;315
8;Barcelona;13;Barcelonès;08019;Barcelona;7;43;U;;827;261;466;559;268;1;3;555;558
8;Barcelona;13;Barcelonès;08019;Barcelona;7;44;U;;690;194;375;481;209;2;7;472;479
8;Barcelona;13;Barcelonès;08019;Barcelona;7;45;U;;892;265;480;626;266;0;5;621;626
8;Barcelona;13;Barcelonès;08019;Barcelona;7;47;U;;758;215;377;465;293;0;2;463;465
8;Barcelona;13;Barcelonès;08019;Barcelona;7;48;U;;1062;272;535;673;389;2;2;669;671
8;Barcelona;13;Barcelonès;08019;Barcelona;7;50;U;;660;166;306;395;265;1;3;391;394
8;Barcelona;13;Barcelonès;08019;Barcelona;7;51;U;;877;221;463;565;312;1;4;560;564
8;Barcelona;13;Barcelonès;08019;Barcelona;7;52;U;;552;171;280;338;214;0;5;333;338
8;Barcelona;13;Barcelonès;08019;Barcelona;7;53;U;;578;154;281;361;217;1;7;353;360
8;Barcelona;13;Barcelonès;08019;Barcelona;7;54;U;;586;192;328;407;179;2;4;401;405
8;Barcelona;13;Barcelonès;08019;Barcelona;7;55;U;;924;230;465;577;347;0;1;576;577
8;Barcelona;13;Barcelonès;08019;Barcelona;7;56;U;;1040;266;511;649;391;2;12;635;647
8;Barcelona;13;Barcelonès;08019;Barcelona;7;57;U;;1029;291;554;673;356;0;11;662;673
8;Barcelona;13;Barcelonès;08019;Barcelona;7;58;U;;736;168;354;461;275;0;9;452;461
8;Barcelona;13;Barcelonès;08019;Barcelona;7;60;U;;809;206;348;464;345;1;5;458;463
8;Barcelona;13;Barcelonès;08019;Barcelona;7;62;U;;865;216;401;499;366;2;6;491;497
8;Barcelona;13;Barcelonès;08019;Barcelona;7;64;U;;576;159;306;391;185;0;5;386;391
8;Barcelona;13;Barcelonès;08019;Barcelona;7;65;U;;938;248;454;584;354;0;7;577;584
8;Barcelona;13;Barcelonès;08019;Barcelona;7;66;U;;520;152;227;285;235;3;2;280;282
8;Barcelona;13;Barcelonès;08019;Barcelona;7;67;U;;1172;307;598;735;437;1;2;732;734
8;Barcelona;13;Barcelonès;08019;Barcelona;7;68;U;;599;148;292;401;198;1;4;396;400
8;Barcelona;13;Barcelonès;08019;Barcelona;7;7;U;;642;209;359;451;191;0;3;448;451
8;Barcelona;13;Barcelonès;08019;Barcelona;7;70;U;;637;163;302;381;256;0;2;379;381
8;Barcelona;13;Barcelonès;08019;Barcelona;7;71;U;;573;175;298;369;204;0;5;364;369
8;Barcelona;13;Barcelonès;08019;Barcelona;7;72;A;;731;199;368;459;272;0;2;457;459
8;Barcelona;13;Barcelonès;08019;Barcelona;7;72;B;;864;245;431;555;309;0;7;548;555
8;Barcelona;13;Barcelonès;08019;Barcelona;7;73;U;;871;198;393;513;358;0;6;507;513
8;Barcelona;13;Barcelonès;08019;Barcelona;7;74;U;;674;184;293;385;289;1;3;381;384
8;Barcelona;13;Barcelonès;08019;Barcelona;7;75;U;;821;217;379;474;347;0;5;469;474
8;Barcelona;13;Barcelonès;08019;Barcelona;7;76;U;;831;209;404;509;322;1;14;494;508
8;Barcelona;13;Barcelonès;08019;Barcelona;7;78;A;;658;201;349;430;228;0;6;424;430
8;Barcelona;13;Barcelonès;08019;Barcelona;7;78;B;;745;218;374;474;271;0;7;467;474
8;Barcelona;13;Barcelonès;08019;Barcelona;7;79;U;;1131;285;570;721;410;2;8;711;719
8;Barcelona;13;Barcelonès;08019;Barcelona;7;8;A;;655;169;333;425;230;8;0;417;417
8;Barcelona;13;Barcelonès;08019;Barcelona;7;8;B;;713;185;389;476;237;0;5;471;476
8;Barcelona;13;Barcelonès;08019;Barcelona;7;80;U;;609;154;305;380;229;1;3;376;379
8;Barcelona;13;Barcelonès;08019;Barcelona;7;81;U;;968;246;490;633;335;0;9;624;633
8;Barcelona;13;Barcelonès;08019;Barcelona;7;83;U;;588;138;256;324;264;0;2;322;324
8;Barcelona;13;Barcelonès;08019;Barcelona;7;84;U;;939;232;458;600;339;0;2;598;600
8;Barcelona;13;Barcelonès;08019;Barcelona;7;85;U;;865;237;438;557;308;0;7;550;557
8;Barcelona;13;Barcelonès;08019;Barcelona;7;86;U;;891;268;479;591;300;0;7;584;591
8;Barcelona;13;Barcelonès;08019;Barcelona;7;88;U;;997;216;480;620;377;5;0;615;615
8;Barcelona;13;Barcelonès;08019;Barcelona;7;89;U;;968;204;399;539;429;4;7;528;535
8;Barcelona;13;Barcelonès;08019;Barcelona;7;9;U;;987;267;495;624;363;0;4;620;624
8;Barcelona;13;Barcelonès;08019;Barcelona;7;91;U;;834;220;386;478;356;0;3;475;478
8;Barcelona;13;Barcelonès;08019;Barcelona;7;92;U;;704;144;278;352;352;1;2;349;351
8;Barcelona;13;Barcelonès;08019;Barcelona;7;93;A;;1085;284;513;641;444;1;6;634;640
8;Barcelona;13;Barcelonès;08019;Barcelona;7;93;B;;1212;309;536;686;526;0;13;673;686
8;Barcelona;13;Barcelonès;08019;Barcelona;7;94;U;;790;177;337;412;378;1;3;408;411
8;Barcelona;13;Barcelonès;08019;Barcelona;7;95;A;;570;116;218;273;297;0;1;272;273
8;Barcelona;13;Barcelonès;08019;Barcelona;7;95;B;;688;161;286;370;318;0;2;368;370
8;Barcelona;13;Barcelonès;08019;Barcelona;7;97;U;;783;184;311;395;388;2;0;393;393
8;Barcelona;13;Barcelonès;08019;Barcelona;7;98;U;;943;235;446;569;374;1;8;560;568
8;Barcelona;13;Barcelonès;08019;Barcelona;8;1;U;;1093;299;529;696;397;0;8;688;696
8;Barcelona;13;Barcelonès;08019;Barcelona;8;10;U;;937;232;430;570;367;0;5;565;570
8;Barcelona;13;Barcelonès;08019;Barcelona;8;100;U;;797;200;371;447;350;0;1;446;447
8;Barcelona;13;Barcelonès;08019;Barcelona;8;101;U;;899;282;456;559;340;0;8;551;559
8;Barcelona;13;Barcelonès;08019;Barcelona;8;102;U;;599;140;250;324;275;2;0;322;322
8;Barcelona;13;Barcelonès;08019;Barcelona;8;103;U;;882;253;450;547;335;1;3;543;546
8;Barcelona;13;Barcelonès;08019;Barcelona;8;104;U;;772;208;333;395;377;0;1;394;395
8;Barcelona;13;Barcelonès;08019;Barcelona;8;107;U;;917;197;386;525;392;1;8;516;524
8;Barcelona;13;Barcelonès;08019;Barcelona;8;108;U;;807;206;356;426;381;0;0;426;426
8;Barcelona;13;Barcelonès;08019;Barcelona;8;109;U;;675;192;302;392;283;0;3;389;392
8;Barcelona;13;Barcelonès;08019;Barcelona;8;11;U;;856;210;384;503;353;1;7;495;502
8;Barcelona;13;Barcelonès;08019;Barcelona;8;111;U;;605;157;270;357;248;0;2;355;357
8;Barcelona;13;Barcelonès;08019;Barcelona;8;112;U;;595;155;273;340;255;0;2;338;340
8;Barcelona;13;Barcelonès;08019;Barcelona;8;113;U;;829;167;361;481;348;3;8;470;478
8;Barcelona;13;Barcelonès;08019;Barcelona;8;114;U;;871;239;426;528;343;0;3;525;528
8;Barcelona;13;Barcelonès;08019;Barcelona;8;115;U;;877;210;408;521;356;0;7;514;521
8;Barcelona;13;Barcelonès;08019;Barcelona;8;116;U;;1075;208;437;624;451;1;7;616;623
8;Barcelona;13;Barcelonès;08019;Barcelona;8;117;U;;637;180;315;401;236;2;3;396;399
8;Barcelona;13;Barcelonès;08019;Barcelona;8;119;U;;916;210;366;491;425;1;3;487;490
8;Barcelona;13;Barcelonès;08019;Barcelona;8;12;U;;641;145;311;398;243;0;2;396;398
8;Barcelona;13;Barcelonès;08019;Barcelona;8;121;U;;645;136;253;366;279;0;0;366;366
8;Barcelona;13;Barcelonès;08019;Barcelona;8;122;U;;937;267;444;554;383;0;1;553;554
8;Barcelona;13;Barcelonès;08019;Barcelona;8;123;U;;505;142;219;282;223;0;3;279;282
8;Barcelona;13;Barcelonès;08019;Barcelona;8;124;U;;1003;205;362;427;576;1;1;425;426
8;Barcelona;13;Barcelonès;08019;Barcelona;8;126;U;;1113;280;480;622;491;0;6;616;622
8;Barcelona;13;Barcelonès;08019;Barcelona;8;127;U;;781;187;354;450;331;1;2;447;449
8;Barcelona;13;Barcelonès;08019;Barcelona;8;129;U;;978;244;447;558;420;0;4;554;558
8;Barcelona;13;Barcelonès;08019;Barcelona;8;13;U;;911;212;414;572;339;0;6;566;572
8;Barcelona;13;Barcelonès;08019;Barcelona;8;131;U;;1076;252;461;594;482;2;3;589;592
8;Barcelona;13;Barcelonès;08019;Barcelona;8;133;U;;673;148;300;398;275;4;3;391;394
8;Barcelona;13;Barcelonès;08019;Barcelona;8;134;U;;542;139;260;344;198;0;3;341;344
8;Barcelona;13;Barcelonès;08019;Barcelona;8;135;U;;1154;240;555;730;424;0;6;724;730
8;Barcelona;13;Barcelonès;08019;Barcelona;8;136;U;;628;151;297;387;241;0;7;380;387
8;Barcelona;13;Barcelonès;08019;Barcelona;8;138;U;;829;185;384;505;324;0;3;502;505
8;Barcelona;13;Barcelonès;08019;Barcelona;8;14;U;;780;248;386;512;268;2;8;502;510
8;Barcelona;13;Barcelonès;08019;Barcelona;8;140;A;;610;140;288;379;231;0;3;376;379
8;Barcelona;13;Barcelonès;08019;Barcelona;8;140;B;;619;142;265;358;261;1;3;354;357
8;Barcelona;13;Barcelonès;08019;Barcelona;8;141;U;;903;256;295;564;339;0;2;562;564
8;Barcelona;13;Barcelonès;08019;Barcelona;8;142;A;;712;156;456;426;286;2;6;418;424
8;Barcelona;13;Barcelonès;08019;Barcelona;8;142;B;;810;159;355;470;340;1;13;456;469
8;Barcelona;13;Barcelonès;08019;Barcelona;8;143;U;;1129;287;555;717;412;3;5;709;714
8;Barcelona;13;Barcelonès;08019;Barcelona;8;144;A;;553;142;252;323;230;2;0;321;321
8;Barcelona;13;Barcelonès;08019;Barcelona;8;144;B;;641;160;303;374;267;1;4;369;373
8;Barcelona;13;Barcelonès;08019;Barcelona;8;145;U;;645;156;284;366;279;1;2;363;365
8;Barcelona;13;Barcelonès;08019;Barcelona;8;146;U;;967;238;404;511;456;1;5;505;510
8;Barcelona;13;Barcelonès;08019;Barcelona;8;147;U;;627;168;266;355;272;3;4;348;352
8;Barcelona;13;Barcelonès;08019;Barcelona;8;149;U;;649;172;307;395;254;1;3;391;394
8;Barcelona;13;Barcelonès;08019;Barcelona;8;15;U;;886;211;436;568;318;1;3;564;567
8;Barcelona;13;Barcelonès;08019;Barcelona;8;150;U;;728;173;331;424;304;1;2;421;423
8;Barcelona;13;Barcelonès;08019;Barcelona;8;151;U;;662;152;271;370;292;0;1;369;370
8;Barcelona;13;Barcelonès;08019;Barcelona;8;152;U;;1027;244;448;570;457;2;2;566;568
8;Barcelona;13;Barcelonès;08019;Barcelona;8;153;U;;512;148;252;304;208;0;3;301;304
8;Barcelona;13;Barcelonès;08019;Barcelona;8;154;U;;636;154;288;384;252;0;3;381;384
8;Barcelona;13;Barcelonès;08019;Barcelona;8;155;U;;751;151;339;432;319;0;9;423;432
8;Barcelona;13;Barcelonès;08019;Barcelona;8;156;U;;1059;291;439;537;522;0;4;533;537
8;Barcelona;13;Barcelonès;08019;Barcelona;8;158;U;;883;269;393;466;417;0;4;462;466
8;Barcelona;13;Barcelonès;08019;Barcelona;8;160;U;;828;240;378;460;368;0;0;460;460
8;Barcelona;13;Barcelonès;08019;Barcelona;8;161;U;;767;216;357;412;355;0;1;411;412
8;Barcelona;13;Barcelonès;08019;Barcelona;8;162;U;;726;176;304;352;374;1;2;349;351
8;Barcelona;13;Barcelonès;08019;Barcelona;8;163;U;;1143;261;442;521;622;1;5;515;520
8;Barcelona;13;Barcelonès;08019;Barcelona;8;164;U;;595;157;265;312;283;0;5;307;312
8;Barcelona;13;Barcelonès;08019;Barcelona;8;166;U;;826;217;355;426;400;1;3;422;425
8;Barcelona;13;Barcelonès;08019;Barcelona;8;167;U;;745;162;292;404;341;1;2;401;403
8;Barcelona;13;Barcelonès;08019;Barcelona;8;168;U;;784;218;341;449;335;0;2;447;449
8;Barcelona;13;Barcelonès;08019;Barcelona;8;17;U;;535;115;245;343;192;0;3;340;343
8;Barcelona;13;Barcelonès;08019;Barcelona;8;170;U;;572;175;275;351;221;0;2;349;351
8;Barcelona;13;Barcelonès;08019;Barcelona;8;171;U;;894;221;368;484;410;0;1;483;484
8;Barcelona;13;Barcelonès;08019;Barcelona;8;172;U;;686;178;272;323;363;0;0;323;323
8;Barcelona;13;Barcelonès;08019;Barcelona;8;173;U;;923;207;425;585;338;3;3;579;582
8;Barcelona;13;Barcelonès;08019;Barcelona;8;174;U;;925;233;407;514;411;8;8;498;506
8;Barcelona;13;Barcelonès;08019;Barcelona;8;176;U;;702;178;311;375;327;1;1;373;374
8;Barcelona;13;Barcelonès;08019;Barcelona;8;178;U;;779;164;343;449;330;2;4;443;447
8;Barcelona;13;Barcelonès;08019;Barcelona;8;18;U;;1153;316;609;779;374;0;8;771;779
8;Barcelona;13;Barcelonès;08019;Barcelona;8;180;U;;634;133;247;338;296;0;6;332;338
8;Barcelona;13;Barcelonès;08019;Barcelona;8;181;U;;646;149;261;348;298;0;0;348;348
8;Barcelona;13;Barcelonès;08019;Barcelona;8;182;U;;531;151;233;305;226;2;5;298;303
8;Barcelona;13;Barcelonès;08019;Barcelona;8;183;U;;846;184;337;454;392;4;1;449;450
8;Barcelona;13;Barcelonès;08019;Barcelona;8;184;U;;692;180;336;417;275;1;1;415;416
8;Barcelona;13;Barcelonès;08019;Barcelona;8;185;U;;778;173;319;421;357;0;1;420;421
8;Barcelona;13;Barcelonès;08019;Barcelona;8;186;U;;882;166;299;384;498;2;3;379;382
8;Barcelona;13;Barcelonès;08019;Barcelona;8;187;U;;534;118;196;248;286;0;1;247;248
8;Barcelona;13;Barcelonès;08019;Barcelona;8;188;U;;580;130;239;326;254;0;2;324;326
8;Barcelona;13;Barcelonès;08019;Barcelona;8;189;U;;1121;273;538;656;465;1;4;651;655
8;Barcelona;13;Barcelonès;08019;Barcelona;8;19;U;;1113;290;612;768;345;2;4;762;766
8;Barcelona;13;Barcelonès;08019;Barcelona;8;190;A;;565;106;236;333;232;2;5;326;331
8;Barcelona;13;Barcelonès;08019;Barcelona;8;190;B;;646;121;249;391;255;2;7;382;389
8;Barcelona;13;Barcelonès;08019;Barcelona;8;191;A;;618;127;237;354;264;2;8;344;352
8;Barcelona;13;Barcelonès;08019;Barcelona;8;191;B;;706;146;293;377;329;1;4;372;376
8;Barcelona;13;Barcelonès;08019;Barcelona;8;192;U;;620;121;207;298;322;2;5;291;296
8;Barcelona;13;Barcelonès;08019;Barcelona;8;193;A;;826;188;337;438;388;0;4;434;438
8;Barcelona;13;Barcelonès;08019;Barcelona;8;193;B;;927;195;369;457;470;0;5;452;457
8;Barcelona;13;Barcelonès;08019;Barcelona;8;194;A;;641;122;233;296;345;0;1;295;296
8;Barcelona;13;Barcelonès;08019;Barcelona;8;194;B;;776;163;316;388;388;2;5;381;386
8;Barcelona;13;Barcelonès;08019;Barcelona;8;195;U;;700;138;229;302;398;1;3;298;301
8;Barcelona;13;Barcelonès;08019;Barcelona;8;196;U;;648;123;220;263;385;0;0;263;263
8;Barcelona;13;Barcelonès;08019;Barcelona;8;198;U;;1031;174;337;452;579;1;3;448;451
8;Barcelona;13;Barcelonès;08019;Barcelona;8;2;U;;696;211;329;396;300;0;4;392;396
8;Barcelona;13;Barcelonès;08019;Barcelona;8;20;U;;967;283;514;629;338;1;9;619;628
8;Barcelona;13;Barcelonès;08019;Barcelona;8;200;U;;783;143;276;357;426;2;3;352;355
8;Barcelona;13;Barcelonès;08019;Barcelona;8;202;U;;978;192;363;500;478;1;2;497;499
8;Barcelona;13;Barcelonès;08019;Barcelona;8;203;U;;1058;242;431;534;524;4;9;521;530
8;Barcelona;13;Barcelonès;08019;Barcelona;8;205;U;;1051;251;433;536;515;0;3;533;536
8;Barcelona;13;Barcelonès;08019;Barcelona;8;207;U;;506;125;224;296;210;0;8;288;296
8;Barcelona;13;Barcelonès;08019;Barcelona;8;208;U;;874;206;374;492;382;0;2;490;492
8;Barcelona;13;Barcelonès;08019;Barcelona;8;209;A;;634;155;259;342;292;0;2;340;342
8;Barcelona;13;Barcelonès;08019;Barcelona;8;209;B;;715;158;312;403;312;0;3;400;403
8;Barcelona;13;Barcelonès;08019;Barcelona;8;21;U;;782;245;401;500;282;2;5;493;498
8;Barcelona;13;Barcelonès;08019;Barcelona;8;211;U;;707;141;242;329;378;0;1;328;329
8;Barcelona;13;Barcelonès;08019;Barcelona;8;213;A;;785;234;372;483;302;2;6;475;481
8;Barcelona;13;Barcelonès;08019;Barcelona;8;213;B;;848;223;393;507;341;1;1;505;506
8;Barcelona;13;Barcelonès;08019;Barcelona;8;214;A;;618;126;273;372;246;0;2;370;372
8;Barcelona;13;Barcelonès;08019;Barcelona;8;214;B;;659;153;317;410;249;0;3;407;410
8;Barcelona;13;Barcelonès;08019;Barcelona;8;22;U;;555;151;274;358;197;0;8;350;358
8;Barcelona;13;Barcelonès;08019;Barcelona;8;24;U;;783;203;389;508;275;0;6;502;508
8;Barcelona;13;Barcelonès;08019;Barcelona;8;27;U;;840;185;408;530;310;0;5;525;530
8;Barcelona;13;Barcelonès;08019;Barcelona;8;28;A;;601;180;288;379;222;0;7;372;379
8;Barcelona;13;Barcelonès;08019;Barcelona;8;28;B;;705;208;360;467;238;0;8;459;467
8;Barcelona;13;Barcelonès;08019;Barcelona;8;29;U;;802;203;397;513;289;1;5;507;512
8;Barcelona;13;Barcelonès;08019;Barcelona;8;3;U;;1185;375;590;746;439;0;7;739;746
8;Barcelona;13;Barcelonès;08019;Barcelona;8;30;U;;1167;280;571;710;457;0;5;705;710
8;Barcelona;13;Barcelonès;08019;Barcelona;8;33;U;;788;230;377;480;308;0;7;473;480
8;Barcelona;13;Barcelonès;08019;Barcelona;8;34;U;;872;292;464;565;307;1;6;558;564
8;Barcelona;13;Barcelonès;08019;Barcelona;8;36;U;;900;239;428;543;357;0;2;541;543
8;Barcelona;13;Barcelonès;08019;Barcelona;8;39;U;;527;133;249;314;213;1;5;308;313
8;Barcelona;13;Barcelonès;08019;Barcelona;8;40;U;;583;132;252;343;240;0;7;336;343
8;Barcelona;13;Barcelonès;08019;Barcelona;8;41;U;;628;180;292;376;252;1;2;373;375
8;Barcelona;13;Barcelonès;08019;Barcelona;8;42;U;;596;150;280;374;222;0;1;373;374
8;Barcelona;13;Barcelonès;08019;Barcelona;8;43;U;;533;180;280;355;178;3;3;349;352
8;Barcelona;13;Barcelonès;08019;Barcelona;8;44;U;;1117;278;541;722;395;3;9;710;719
8;Barcelona;13;Barcelonès;08019;Barcelona;8;45;U;;462;115;209;278;184;0;4;274;278
8;Barcelona;13;Barcelonès;08019;Barcelona;8;46;U;;685;138;256;319;366;0;6;313;319
8;Barcelona;13;Barcelonès;08019;Barcelona;8;47;U;;726;183;342;474;252;1;4;469;473
8;Barcelona;13;Barcelonès;08019;Barcelona;8;48;U;;678;183;296;413;265;0;7;406;413
8;Barcelona;13;Barcelonès;08019;Barcelona;8;49;U;;895;193;385;513;382;1;6;506;512
8;Barcelona;13;Barcelonès;08019;Barcelona;8;5;U;;852;219;404;536;316;0;6;530;536
8;Barcelona;13;Barcelonès;08019;Barcelona;8;50;U;;654;141;274;350;304;1;1;348;349
8;Barcelona;13;Barcelonès;08019;Barcelona;8;51;U;;810;176;411;522;288;0;2;520;522
8;Barcelona;13;Barcelonès;08019;Barcelona;8;52;U;;760;169;358;453;307;0;1;452;453
8;Barcelona;13;Barcelonès;08019;Barcelona;8;53;U;;1073;277;511;663;410;2;15;646;661
8;Barcelona;13;Barcelonès;08019;Barcelona;8;54;U;;614;129;259;367;247;1;5;361;366
8;Barcelona;13;Barcelonès;08019;Barcelona;8;55;U;;482;128;222;276;206;0;3;273;276
8;Barcelona;13;Barcelonès;08019;Barcelona;8;56;U;;1091;310;511;642;449;0;4;638;642
8;Barcelona;13;Barcelonès;08019;Barcelona;8;57;U;;939;277;458;584;355;1;3;580;583
8;Barcelona;13;Barcelonès;08019;Barcelona;8;58;U;;951;229;398;533;418;5;0;528;528
8;Barcelona;13;Barcelonès;08019;Barcelona;8;6;U;;873;197;430;553;320;3;5;545;550
8;Barcelona;13;Barcelonès;08019;Barcelona;8;60;U;;1030;302;487;616;414;3;4;609;613
8;Barcelona;13;Barcelonès;08019;Barcelona;8;62;U;;1142;239;531;714;428;0;12;702;714
8;Barcelona;13;Barcelonès;08019;Barcelona;8;64;U;;514;119;255;319;195;0;6;313;319
8;Barcelona;13;Barcelonès;08019;Barcelona;8;65;U;;871;246;403;517;354;1;3;513;516
8;Barcelona;13;Barcelonès;08019;Barcelona;8;66;U;;587;192;308;353;234;1;1;351;352
8;Barcelona;13;Barcelonès;08019;Barcelona;8;67;U;;682;174;257;317;365;7;3;307;310
8;Barcelona;13;Barcelonès;08019;Barcelona;8;68;U;;520;134;201;264;256;3;3;258;261
8;Barcelona;13;Barcelonès;08019;Barcelona;8;69;U;;198;41;70;97;101;2;0;95;95
8;Barcelona;13;Barcelonès;08019;Barcelona;8;7;U;;758;198;384;482;276;3;6;473;479
8;Barcelona;13;Barcelonès;08019;Barcelona;8;70;U;;569;194;308;360;209;1;0;359;359
8;Barcelona;13;Barcelonès;08019;Barcelona;8;71;U;;851;261;462;575;276;0;4;571;575
8;Barcelona;13;Barcelonès;08019;Barcelona;8;72;U;;583;156;282;357;226;0;2;355;357
8;Barcelona;13;Barcelonès;08019;Barcelona;8;73;U;;709;230;348;436;273;0;4;432;436
8;Barcelona;13;Barcelonès;08019;Barcelona;8;74;U;;811;198;401;543;268;0;12;531;543
8;Barcelona;13;Barcelonès;08019;Barcelona;8;76;U;;1088;256;538;650;438;0;5;645;650
8;Barcelona;13;Barcelonès;08019;Barcelona;8;77;A;;691;204;331;402;289;3;5;394;399
8;Barcelona;13;Barcelonès;08019;Barcelona;8;77;B;;731;195;327;409;322;1;5;403;408
8;Barcelona;13;Barcelonès;08019;Barcelona;8;8;A;;660;163;337;430;230;0;7;423;430
8;Barcelona;13;Barcelonès;08019;Barcelona;8;8;B;;757;151;356;463;294;1;7;455;462
8;Barcelona;13;Barcelonès;08019;Barcelona;8;80;A;;636;168;278;354;282;1;3;350;353
8;Barcelona;13;Barcelonès;08019;Barcelona;8;80;B;;754;210;334;404;350;0;8;396;404
8;Barcelona;13;Barcelonès;08019;Barcelona;8;82;U;;530;166;254;299;231;0;2;297;299
8;Barcelona;13;Barcelonès;08019;Barcelona;8;83;U;;540;168;265;326;214;0;1;325;326
8;Barcelona;13;Barcelonès;08019;Barcelona;8;84;A;;572;171;279;345;227;1;3;341;344
8;Barcelona;13;Barcelonès;08019;Barcelona;8;84;B;;607;162;295;374;233;0;3;371;374
8;Barcelona;13;Barcelonès;08019;Barcelona;8;85;U;;883;239;371;439;444;1;5;433;438
8;Barcelona;13;Barcelonès;08019;Barcelona;8;86;U;;1133;273;467;539;594;2;5;532;537
8;Barcelona;13;Barcelonès;08019;Barcelona;8;88;U;;714;163;330;432;282;0;2;430;432
8;Barcelona;13;Barcelonès;08019;Barcelona;8;89;U;;872;193;383;507;365;1;12;494;506
8;Barcelona;13;Barcelonès;08019;Barcelona;8;90;U;;1101;292;541;736;365;0;9;727;736
8;Barcelona;13;Barcelonès;08019;Barcelona;8;91;A;;860;198;430;521;339;1;2;518;520
8;Barcelona;13;Barcelonès;08019;Barcelona;8;91;B;;954;230;386;584;370;0;5;579;584
8;Barcelona;13;Barcelonès;08019;Barcelona;8;91;C;;866;177;399;535;331;1;4;530;534
8;Barcelona;13;Barcelonès;08019;Barcelona;8;92;A;;815;223;384;486;329;1;8;477;485
8;Barcelona;13;Barcelonès;08019;Barcelona;8;92;B;;926;220;428;551;375;2;8;541;549
8;Barcelona;13;Barcelonès;08019;Barcelona;8;93;A;;874;140;403;537;337;5;11;521;532
8;Barcelona;13;Barcelonès;08019;Barcelona;8;93;B;;1088;218;512;686;402;3;6;677;683
8;Barcelona;13;Barcelonès;08019;Barcelona;8;94;U;;474;158;267;329;145;0;2;327;329
8;Barcelona;13;Barcelonès;08019;Barcelona;8;95;U;;649;232;387;469;180;2;3;464;467
8;Barcelona;13;Barcelonès;08019;Barcelona;8;96;U;;851;246;427;501;350;1;6;494;500
8;Barcelona;13;Barcelonès;08019;Barcelona;8;97;U;;853;236;414;510;343;1;7;502;509
8;Barcelona;13;Barcelonès;08019;Barcelona;8;98;U;;1094;257;547;650;444;0;14;636;650
8;Barcelona;13;Barcelonès;08019;Barcelona;9;10;U;;550;148;253;323;227;0;0;323;323
8;Barcelona;13;Barcelonès;08019;Barcelona;9;100;A;;688;174;331;424;264;1;2;421;423
8;Barcelona;13;Barcelonès;08019;Barcelona;9;100;B;;805;228;389;491;314;0;9;482;491
8;Barcelona;13;Barcelonès;08019;Barcelona;9;102;A;;676;186;309;415;261;0;5;410;415
8;Barcelona;13;Barcelonès;08019;Barcelona;9;102;B;;753;209;353;477;276;5;3;469;472
8;Barcelona;13;Barcelonès;08019;Barcelona;9;103;A;;728;174;305;408;320;0;3;405;408
8;Barcelona;13;Barcelonès;08019;Barcelona;9;103;B;;832;185;347;459;373;1;3;455;458
8;Barcelona;13;Barcelonès;08019;Barcelona;9;103;C;;818;200;354;477;341;0;5;472;477
8;Barcelona;13;Barcelonès;08019;Barcelona;9;104;U;;657;145;297;387;270;1;7;379;386
8;Barcelona;13;Barcelonès;08019;Barcelona;9;105;U;;469;131;213;254;215;1;5;248;253
8;Barcelona;13;Barcelonès;08019;Barcelona;9;106;U;;826;207;392;530;296;0;3;527;530
8;Barcelona;13;Barcelonès;08019;Barcelona;9;107;U;;855;263;441;561;294;0;4;557;561
8;Barcelona;13;Barcelonès;08019;Barcelona;9;108;U;;1006;277;468;597;409;0;4;593;597
8;Barcelona;13;Barcelonès;08019;Barcelona;9;109;U;;1016;247;498;661;355;0;1;660;661
8;Barcelona;13;Barcelonès;08019;Barcelona;9;11;U;;617;177;324;406;211;2;1;403;404
8;Barcelona;13;Barcelonès;08019;Barcelona;9;110;A;;615;182;299;397;218;0;4;393;397
8;Barcelona;13;Barcelonès;08019;Barcelona;9;110;B;;654;151;303;406;248;0;6;400;406
8;Barcelona;13;Barcelonès;08019;Barcelona;9;111;U;;723;183;354;463;260;2;4;457;461
8;Barcelona;13;Barcelonès;08019;Barcelona;9;112;U;;520;115;229;290;230;3;4;283;287
8;Barcelona;13;Barcelonès;08019;Barcelona;9;113;A;;557;137;268;378;179;1;3;374;377
8;Barcelona;13;Barcelonès;08019;Barcelona;9;113;B;;620;168;292;403;217;0;3;400;403
8;Barcelona;13;Barcelonès;08019;Barcelona;9;114;U;;1071;305;531;663;408;0;4;659;663
8;Barcelona;13;Barcelonès;08019;Barcelona;9;115;U;;1010;256;465;618;392;0;8;610;618
8;Barcelona;13;Barcelonès;08019;Barcelona;9;116;A;;553;167;271;352;201;1;5;346;351
8;Barcelona;13;Barcelonès;08019;Barcelona;9;116;B;;656;109;334;443;213;1;1;441;442
8;Barcelona;13;Barcelonès;08019;Barcelona;9;118;U;;1195;280;597;774;421;1;12;761;773
8;Barcelona;13;Barcelonès;08019;Barcelona;9;119;U;;526;156;268;331;195;1;3;327;330
8;Barcelona;13;Barcelonès;08019;Barcelona;9;12;U;;497;137;247;321;176;0;2;319;321
8;Barcelona;13;Barcelonès;08019;Barcelona;9;120;U;;994;206;447;573;421;0;6;567;573
8;Barcelona;13;Barcelonès;08019;Barcelona;9;121;U;;862;207;364;483;379;0;4;479;483
8;Barcelona;13;Barcelonès;08019;Barcelona;9;123;U;;727;214;368;463;264;0;5;458;463
8;Barcelona;13;Barcelonès;08019;Barcelona;9;124;U;;566;148;275;360;206;1;4;355;359
8;Barcelona;13;Barcelonès;08019;Barcelona;9;125;U;;779;196;406;527;252;5;1;521;522
8;Barcelona;13;Barcelonès;08019;Barcelona;9;126;U;;1146;310;580;757;389;2;6;749;755
8;Barcelona;13;Barcelonès;08019;Barcelona;9;128;U;;806;188;345;472;334;0;5;467;472
8;Barcelona;13;Barcelonès;08019;Barcelona;9;129;U;;585;133;242;321;264;0;4;317;321
8;Barcelona;13;Barcelonès;08019;Barcelona;9;13;U;;1107;249;593;766;341;3;11;752;763
8;Barcelona;13;Barcelonès;08019;Barcelona;9;130;U;;1024;200;413;550;474;1;1;548;549
8;Barcelona;13;Barcelonès;08019;Barcelona;9;132;U;;1099;241;443;559;540;0;4;555;559
8;Barcelona;13;Barcelonès;08019;Barcelona;9;133;U;;697;190;333;387;310;0;3;384;387
8;Barcelona;13;Barcelonès;08019;Barcelona;9;134;U;;756;134;314;423;333;0;3;420;423
8;Barcelona;13;Barcelonès;08019;Barcelona;9;136;U;;1085;217;483;621;464;0;4;617;621
8;Barcelona;13;Barcelonès;08019;Barcelona;9;137;U;;898;229;404;477;421;0;3;474;477
8;Barcelona;13;Barcelonès;08019;Barcelona;9;139;U;;674;171;304;374;300;5;1;368;369
8;Barcelona;13;Barcelonès;08019;Barcelona;9;14;U;;974;269;495;653;321;1;12;640;652
8;Barcelona;13;Barcelonès;08019;Barcelona;9;140;U;;951;194;378;463;488;3;0;460;460
8;Barcelona;13;Barcelonès;08019;Barcelona;9;142;U;;683;143;285;358;325;0;5;353;358
8;Barcelona;13;Barcelonès;08019;Barcelona;9;144;A;;592;122;223;279;313;1;0;278;278
8;Barcelona;13;Barcelonès;08019;Barcelona;9;144;B;;634;154;245;307;327;2;2;303;305
8;Barcelona;13;Barcelonès;08019;Barcelona;9;145;U;;658;151;332;367;291;0;2;365;367
8;Barcelona;13;Barcelonès;08019;Barcelona;9;146;U;;779;170;323;441;338;0;3;438;441
8;Barcelona;13;Barcelonès;08019;Barcelona;9;147;U;;1163;271;486;629;534;0;4;625;629
8;Barcelona;13;Barcelonès;08019;Barcelona;9;148;U;;671;139;290;371;300;1;5;365;370
8;Barcelona;13;Barcelonès;08019;Barcelona;9;149;U;;750;144;291;394;356;0;0;394;394
8;Barcelona;13;Barcelonès;08019;Barcelona;9;15;U;;1007;276;526;664;343;0;1;663;664
8;Barcelona;13;Barcelonès;08019;Barcelona;9;150;U;;987;195;363;479;508;0;1;478;479
8;Barcelona;13;Barcelonès;08019;Barcelona;9;151;U;;1030;193;398;540;490;0;3;537;540
8;Barcelona;13;Barcelonès;08019;Barcelona;9;154;U;;733;159;361;353;380;0;6;347;353
8;Barcelona;13;Barcelonès;08019;Barcelona;9;17;U;;1082;276;537;715;367;1;14;700;714
8;Barcelona;13;Barcelonès;08019;Barcelona;9;18;U;;715;187;394;510;205;0;8;502;510
8;Barcelona;13;Barcelonès;08019;Barcelona;9;19;U;;891;258;475;574;317;0;3;571;574
8;Barcelona;13;Barcelonès;08019;Barcelona;9;2;A;;720;155;366;466;254;1;2;463;465
8;Barcelona;13;Barcelonès;08019;Barcelona;9;2;B;;870;212;424;535;335;1;4;530;534
8;Barcelona;13;Barcelonès;08019;Barcelona;9;20;U;;736;244;391;463;273;0;3;460;463
8;Barcelona;13;Barcelonès;08019;Barcelona;9;21;U;;838;312;511;620;218;3;7;610;617
8;Barcelona;13;Barcelonès;08019;Barcelona;9;22;U;;571;194;301;398;173;0;4;394;398
8;Barcelona;13;Barcelonès;08019;Barcelona;9;23;A;;557;149;288;368;189;2;2;364;366
8;Barcelona;13;Barcelonès;08019;Barcelona;9;23;B;;660;185;345;422;238;4;11;407;418
8;Barcelona;13;Barcelonès;08019;Barcelona;9;25;U;;959;211;478;625;334;1;9;615;624
8;Barcelona;13;Barcelonès;08019;Barcelona;9;26;A;;853;231;454;578;275;5;8;565;573
8;Barcelona;13;Barcelonès;08019;Barcelona;9;26;B;;916;240;435;564;352;0;5;559;564
8;Barcelona;13;Barcelonès;08019;Barcelona;9;27;U;;1012;312;557;693;319;0;0;693;693
8;Barcelona;13;Barcelonès;08019;Barcelona;9;28;U;;742;176;360;465;277;1;1;463;464
8;Barcelona;13;Barcelonès;08019;Barcelona;9;3;A;;965;266;505;642;323;1;4;637;641
8;Barcelona;13;Barcelonès;08019;Barcelona;9;3;B;;1009;258;508;650;359;0;7;643;650
8;Barcelona;13;Barcelonès;08019;Barcelona;9;30;A;;791;180;350;496;295;1;5;490;495
8;Barcelona;13;Barcelonès;08019;Barcelona;9;30;B;;956;203;398;552;404;0;8;544;552
8;Barcelona;13;Barcelonès;08019;Barcelona;9;31;U;;857;227;433;552;305;2;6;544;550
8;Barcelona;13;Barcelonès;08019;Barcelona;9;32;U;;756;194;362;479;277;0;3;476;479
8;Barcelona;13;Barcelonès;08019;Barcelona;9;33;U;;812;257;407;535;277;0;4;531;535
8;Barcelona;13;Barcelonès;08019;Barcelona;9;35;U;;604;156;314;390;214;0;1;389;390
8;Barcelona;13;Barcelonès;08019;Barcelona;9;36;U;;487;122;231;266;221;3;2;261;263
8;Barcelona;13;Barcelonès;08019;Barcelona;9;37;A;;592;118;252;353;239;3;4;346;350
8;Barcelona;13;Barcelonès;08019;Barcelona;9;37;B;;594;152;281;368;226;1;3;364;367
8;Barcelona;13;Barcelonès;08019;Barcelona;9;39;A;;940;213;459;608;332;0;9;599;608
8;Barcelona;13;Barcelonès;08019;Barcelona;9;39;B;;943;160;412;563;380;1;5;557;562
8;Barcelona;13;Barcelonès;08019;Barcelona;9;39;C;;1043;209;495;660;383;0;12;648;660
8;Barcelona;13;Barcelonès;08019;Barcelona;9;4;A;;562;145;293;393;169;0;3;390;393
8;Barcelona;13;Barcelonès;08019;Barcelona;9;4;B;;673;155;348;457;216;1;2;454;456
8;Barcelona;13;Barcelonès;08019;Barcelona;9;40;U;;1104;269;560;758;346;0;0;758;758
8;Barcelona;13;Barcelonès;08019;Barcelona;9;41;U;;780;217;368;505;275;0;6;499;505
8;Barcelona;13;Barcelonès;08019;Barcelona;9;42;U;;850;201;412;548;302;0;8;540;548
8;Barcelona;13;Barcelonès;08019;Barcelona;9;43;U;;964;356;481;601;363;1;7;593;600
8;Barcelona;13;Barcelonès;08019;Barcelona;9;44;A;;703;189;346;449;254;0;4;445;449
8;Barcelona;13;Barcelonès;08019;Barcelona;9;44;B;;811;203;365;484;327;5;7;472;479
8;Barcelona;13;Barcelonès;08019;Barcelona;9;45;A;;825;238;433;548;277;1;7;540;547
8;Barcelona;13;Barcelonès;08019;Barcelona;9;45;B;;887;249;395;570;317;4;6;560;566
8;Barcelona;13;Barcelonès;08019;Barcelona;9;46;A;;570;153;252;337;233;0;6;331;337
8;Barcelona;13;Barcelonès;08019;Barcelona;9;46;B;;676;161;286;385;291;1;2;382;384
8;Barcelona;13;Barcelonès;08019;Barcelona;9;47;A;;620;153;292;382;238;0;4;378;382
8;Barcelona;13;Barcelonès;08019;Barcelona;9;47;B;;724;184;340;448;276;0;7;441;448
8;Barcelona;13;Barcelonès;08019;Barcelona;9;48;U;;1040;266;525;672;368;2;11;659;670
8;Barcelona;13;Barcelonès;08019;Barcelona;9;49;U;;755;229;373;467;288;0;1;466;467
8;Barcelona;13;Barcelonès;08019;Barcelona;9;5;U;;1178;316;607;768;410;0;0;768;768
8;Barcelona;13;Barcelonès;08019;Barcelona;9;51;U;;931;222;399;542;389;0;11;531;542
8;Barcelona;13;Barcelonès;08019;Barcelona;9;52;U;;845;204;389;491;354;0;2;489;491
8;Barcelona;13;Barcelonès;08019;Barcelona;9;54;U;;512;136;238;319;193;0;3;316;319
8;Barcelona;13;Barcelonès;08019;Barcelona;9;55;U;;968;233;448;601;367;0;12;589;601
8;Barcelona;13;Barcelonès;08019;Barcelona;9;57;U;;581;192;288;348;233;0;3;345;348
8;Barcelona;13;Barcelonès;08019;Barcelona;9;59;U;;846;282;451;550;296;7;0;543;543
8;Barcelona;13;Barcelonès;08019;Barcelona;9;6;A;;621;164;326;430;191;0;5;425;430
8;Barcelona;13;Barcelonès;08019;Barcelona;9;6;B;;680;145;330;435;245;1;5;429;434
8;Barcelona;13;Barcelonès;08019;Barcelona;9;60;A;;626;179;322;417;209;0;2;415;417
8;Barcelona;13;Barcelonès;08019;Barcelona;9;60;B;;652;191;342;414;238;0;3;411;414
8;Barcelona;13;Barcelonès;08019;Barcelona;9;62;U;;589;163;307;394;195;1;8;385;393
8;Barcelona;13;Barcelonès;08019;Barcelona;9;63;U;;609;229;356;405;204;1;2;402;404
8;Barcelona;13;Barcelonès;08019;Barcelona;9;64;U;;1001;328;576;669;332;1;7;661;668
8;Barcelona;13;Barcelonès;08019;Barcelona;9;66;U;;828;248;440;544;284;2;4;538;542
8;Barcelona;13;Barcelonès;08019;Barcelona;9;67;U;;1154;394;636;772;382;5;6;761;767
8;Barcelona;13;Barcelonès;08019;Barcelona;9;69;A;;585;193;339;426;159;1;6;419;425
8;Barcelona;13;Barcelonès;08019;Barcelona;9;69;B;;664;198;354;454;210;4;5;445;450
8;Barcelona;13;Barcelonès;08019;Barcelona;9;7;U;;1217;336;639;819;398;2;10;807;817
8;Barcelona;13;Barcelonès;08019;Barcelona;9;71;U;;507;123;262;326;181;0;2;324;326
8;Barcelona;13;Barcelonès;08019;Barcelona;9;72;U;;1054;307;572;714;340;0;3;711;714
8;Barcelona;13;Barcelonès;08019;Barcelona;9;73;U;;786;242;430;541;245;0;5;536;541
8;Barcelona;13;Barcelonès;08019;Barcelona;9;74;U;;555;137;275;339;216;0;3;336;339
8;Barcelona;13;Barcelonès;08019;Barcelona;9;75;U;;1056;271;514;658;398;2;16;640;656
8;Barcelona;13;Barcelonès;08019;Barcelona;9;77;U;;884;227;453;578;306;0;10;568;578
8;Barcelona;13;Barcelonès;08019;Barcelona;9;79;U;;905;270;488;620;285;0;8;612;620
8;Barcelona;13;Barcelonès;08019;Barcelona;9;80;A;;666;171;365;446;220;2;6;438;444
8;Barcelona;13;Barcelonès;08019;Barcelona;9;80;B;;687;208;362;481;206;2;2;477;479
8;Barcelona;13;Barcelonès;08019;Barcelona;9;82;U;;938;274;480;623;315;0;7;616;623
8;Barcelona;13;Barcelonès;08019;Barcelona;9;84;U;;1019;295;506;685;334;0;8;677;685
8;Barcelona;13;Barcelonès;08019;Barcelona;9;86;A;;773;214;428;542;231;2;4;536;540
8;Barcelona;13;Barcelonès;08019;Barcelona;9;86;B;;853;233;465;587;266;0;5;582;587
8;Barcelona;13;Barcelonès;08019;Barcelona;9;87;U;;713;209;345;448;265;1;3;444;447
8;Barcelona;13;Barcelonès;08019;Barcelona;9;88;U;;530;152;274;328;202;0;0;328;328
8;Barcelona;13;Barcelonès;08019;Barcelona;9;89;U;;1122;302;559;736;386;1;12;723;735
8;Barcelona;13;Barcelonès;08019;Barcelona;9;9;U;;573;133;288;350;223;0;0;350;350
8;Barcelona;13;Barcelonès;08019;Barcelona;9;90;U;;605;159;298;395;210;0;4;391;395
8;Barcelona;13;Barcelonès;08019;Barcelona;9;91;U;;980;268;479;630;350;0;5;625;630
8;Barcelona;13;Barcelonès;08019;Barcelona;9;92;U;;780;187;357;444;336;0;5;439;444
8;Barcelona;13;Barcelonès;08019;Barcelona;9;94;U;;670;179;343;426;244;2;1;423;424
8;Barcelona;13;Barcelonès;08019;Barcelona;9;95;U;;591;193;307;384;207;1;5;378;383
8;Barcelona;13;Barcelonès;08019;Barcelona;9;96;U;;546;152;265;342;204;3;2;337;339
8;Barcelona;13;Barcelonès;08019;Barcelona;9;97;U;;648;267;402;469;179;3;1;465;466
8;Barcelona;13;Barcelonès;08019;Barcelona;9;98;A;;562;164;281;347;215;1;5;341;346
8;Barcelona;13;Barcelonès;08019;Barcelona;9;98;B;;665;167;320;394;271;2;2;390;392
25;Lleida;23;Noguera;25042;Baronia de Rialb, la;1;1;U;;224;69;113;155;69;0;1;154;155
17;Girona;2;Alt Empordà;17016;Bàscara;1;1;U;;702;247;451;537;165;0;4;533;537
25;Lleida;4;Alt Urgell;25044;Bassella;1;1;U;;274;69;130;180;94;0;1;179;180
43;Tarragona;37;Terra Alta;43022;Batea;1;1;U;;866;198;424;627;239;0;5;622;627
43;Tarragona;37;Terra Alta;43022;Batea;1;2;U;;836;215;400;590;246;2;3;585;588
25;Lleida;39;Consell General d'Aran;25045;Bausen;1;1;U;;61;23;35;50;11;0;1;49;50
8;Barcelona;11;Baix Llobregat;08020;Begues;1;1;A;;858;238;412;577;281;0;9;568;577
8;Barcelona;11;Baix Llobregat;08020;Begues;1;1;B;;736;217;381;526;210;2;6;518;524
8;Barcelona;11;Baix Llobregat;08020;Begues;1;1;C;;561;150;289;394;167;1;6;387;393
8;Barcelona;11;Baix Llobregat;08020;Begues;1;2;U;;955;233;500;650;305;3;10;637;647
17;Girona;10;Baix Empordà;17013;Begur;1;1;A;;633;200;357;428;205;0;3;425;428
17;Girona;10;Baix Empordà;17013;Begur;1;1;B;;675;203;360;451;224;0;3;448;451
17;Girona;10;Baix Empordà;17013;Begur;1;1;C;;644;184;345;434;210;3;2;429;431
17;Girona;10;Baix Empordà;17013;Begur;1;2;U;;554;160;336;409;145;2;6;401;407
25;Lleida;38;Urgell;25046;Belianes;1;1;U;;492;190;312;366;126;0;5;361;366
25;Lleida;18;Garrigues;25170;Bellaguarda;1;1;U;;305;43;130;198;107;1;0;197;197
17;Girona;10;Baix Empordà;17018;Bellcaire d'Empordà;1;1;U;;436;130;262;325;111;0;2;323;325
25;Lleida;23;Noguera;25047;Bellcaire d'Urgell;1;1;A;;554;200;311;402;152;2;4;396;400
25;Lleida;23;Noguera;25047;Bellcaire d'Urgell;1;1;B;;620;227;372;455;165;1;1;453;454
25;Lleida;27;Pla d'Urgell;25048;Bell-lloc d'Urgell;1;1;U;;770;214;422;533;237;1;4;528;532
25;Lleida;27;Pla d'Urgell;25048;Bell-lloc d'Urgell;1;2;U;;971;293;536;687;284;4;2;681;683
25;Lleida;23;Noguera;25049;Bellmunt d'Urgell;1;1;U;;196;57;122;142;54;0;2;140;142
43;Tarragona;29;Priorat;43023;Bellmunt del Priorat;1;1;U;;276;115;195;221;55;0;5;216;221
8;Barcelona;6;Anoia;08021;Bellprat;1;1;U;;84;19;39;51;33;0;0;51;51
25;Lleida;38;Urgell;25050;Bellpuig;1;1;A;;651;167;347;469;182;0;8;461;469
25;Lleida;38;Urgell;25050;Bellpuig;1;1;B;;621;155;300;428;193;4;3;421;424
25;Lleida;38;Urgell;25050;Bellpuig;1;2;U;;1027;268;549;747;280;5;2;740;742
25;Lleida;38;Urgell;25050;Bellpuig;1;3;U;;934;235;470;638;296;0;15;623;638
43;Tarragona;12;Baix Penedès;43024;Bellvei;1;1;U;;1026;232;581;727;299;2;5;720;725
25;Lleida;15;Cerdanya;25051;Bellver de Cerdanya;1;1;U;;1370;324;687;815;555;9;5;801;806
25;Lleida;27;Pla d'Urgell;25052;Bellvís;1;1;A;;974;230;467;626;348;2;4;620;624
25;Lleida;27;Pla d'Urgell;25052;Bellvís;1;1;B;;914;210;461;597;317;5;3;589;592
25;Lleida;33;Segrià;25053;Benavent de Segrià;1;1;U;;743;173;394;497;246;2;7;488;495
43;Tarragona;9;Baix Ebre;43025;Benifallet;1;1;U;;758;178;417;545;213;6;4;535;539
43;Tarragona;30;Ribera d'Ebre;43026;Benissanet;1;1;U;;843;167;400;586;257;2;1;583;584
8;Barcelona;14;Berguedà;08022;Berga;1;1;A;;638;159;310;421;217;2;5;414;419
8;Barcelona;14;Berguedà;08022;Berga;1;1;B;;644;173;325;416;228;3;3;410;413
8;Barcelona;14;Berguedà;08022;Berga;1;2;U;;1120;328;584;753;367;2;10;741;751
8;Barcelona;14;Berguedà;08022;Berga;1;3;U;;800;220;436;580;220;1;8;571;579
8;Barcelona;14;Berguedà;08022;Berga;1;4;A;;920;222;443;605;315;1;5;599;604
8;Barcelona;14;Berguedà;08022;Berga;1;4;B;;1015;256;472;637;378;0;10;627;637
8;Barcelona;14;Berguedà;08022;Berga;1;5;U;;1111;325;610;759;352;3;8;748;756
8;Barcelona;14;Berguedà;08022;Berga;2;1;A;;439;106;177;235;204;3;5;227;232
8;Barcelona;14;Berguedà;08022;Berga;2;1;B;;469;102;195;249;220;2;1;246;247
8;Barcelona;14;Berguedà;08022;Berga;2;2;U;;871;217;394;502;369;1;2;499;501
8;Barcelona;14;Berguedà;08022;Berga;2;3;A;;740;154;316;414;326;5;1;408;409
8;Barcelona;14;Berguedà;08022;Berga;2;3;B;;986;206;404;531;455;3;5;523;528
8;Barcelona;14;Berguedà;08022;Berga;2;4;A;;675;179;320;432;243;1;3;428;431
8;Barcelona;14;Berguedà;08022;Berga;2;4;B;;713;174;343;475;238;1;5;469;474
8;Barcelona;14;Berguedà;08022;Berga;3;1;A;;271;53;117;145;126;2;4;139;143
8;Barcelona;14;Berguedà;08022;Berga;3;1;B;;360;93;178;252;108;1;2;249;251
8;Barcelona;14;Berguedà;08022;Berga;4;1;U;;463;100;213;288;175;1;5;282;287
17;Girona;19;Garrotxa;17019;Besalú;1;1;A;;505;157;298;354;151;4;2;348;350
17;Girona;19;Garrotxa;17019;Besalú;1;1;B;;624;182;365;447;177;0;6;441;447
17;Girona;19;Garrotxa;17019;Besalú;1;1;C;;577;160;335;415;162;5;4;406;410
17;Girona;20;Gironès;17020;Bescanó;1;1;A;;490;156;303;370;120;0;3;367;370
17;Girona;20;Gironès;17020;Bescanó;1;1;B;;582;181;355;436;146;1;4;431;435
17;Girona;20;Gironès;17020;Bescanó;1;1;C;;474;155;302;342;132;1;2;339;341
17;Girona;20;Gironès;17020;Bescanó;1;1;D;;438;149;287;348;90;1;4;343;347
17;Girona;20;Gironès;17020;Bescanó;1;2;A;;325;100;168;205;120;0;0;205;205
17;Girona;20;Gironès;17020;Bescanó;1;2;B;;303;97;165;208;95;0;2;206;208
17;Girona;19;Garrotxa;17021;Beuda;1;1;U;;106;26;52;67;39;0;0;67;67
8;Barcelona;41;Vallès Oriental;08023;Bigues i Riells;1;1;A;;1026;246;460;576;450;2;8;566;574
8;Barcelona;41;Vallès Oriental;08023;Bigues i Riells;1;1;B;;768;155;320;431;337;1;4;426;430
8;Barcelona;41;Vallès Oriental;08023;Bigues i Riells;1;1;C;;1046;243;470;592;454;2;4;586;590
8;Barcelona;41;Vallès Oriental;08023;Bigues i Riells;1;1;D;;928;195;404;540;388;1;8;531;539
8;Barcelona;41;Vallès Oriental;08023;Bigues i Riells;1;1;E;;439;114;222;311;128;1;1;309;310
25;Lleida;32;Segarra;25055;Biosca;1;1;U;;222;78;138;183;39;1;0;182;182
17;Girona;10;Baix Empordà;17022;Bisbal d'Empordà, la;1;2;U;;1035;249;502;649;386;2;10;637;647
17;Girona;10;Baix Empordà;17022;Bisbal d'Empordà, la;1;3;U;;956;240;466;604;352;2;6;596;602
17;Girona;10;Baix Empordà;17022;Bisbal d'Empordà, la;1;4;A;;693;137;316;448;245;0;4;444;448
17;Girona;10;Baix Empordà;17022;Bisbal d'Empordà, la;1;4;B;;667;153;339;445;222;0;5;440;445
17;Girona;10;Baix Empordà;17022;Bisbal d'Empordà, la;2;1;U;;956;273;470;635;321;1;7;627;634
17;Girona;10;Baix Empordà;17022;Bisbal d'Empordà, la;2;2;A;;638;162;336;411;227;1;1;409;410
17;Girona;10;Baix Empordà;17022;Bisbal d'Empordà, la;2;2;B;;648;180;347;435;213;2;6;427;433
17;Girona;10;Baix Empordà;17022;Bisbal d'Empordà, la;2;3;U;;909;275;479;605;304;1;4;600;604
43;Tarragona;29;Priorat;43027;Bisbal de Falset, la;1;1;U;;215;69;106;127;88;1;2;124;126
43;Tarragona;12;Baix Penedès;43028;Bisbal del Penedès, la;1;1;A;;687;185;338;433;254;0;2;431;433
43;Tarragona;12;Baix Penedès;43028;Bisbal del Penedès, la;1;1;B;;831;209;422;532;299;2;8;522;530
17;Girona;2;Alt Empordà;17234;Biure;1;1;U;;181;56;101;124;57;0;0;124;124
43;Tarragona;16;Conca de Barberà;43029;Blancafort;1;1;U;;319;84;182;219;100;1;2;216;218
17;Girona;34;Selva;17023;Blanes;1;1;U;;929;304;522;608;321;4;4;600;604
17;Girona;34;Selva;17023;Blanes;1;2;A;;893;260;474;581;312;1;6;574;580
17;Girona;34;Selva;17023;Blanes;1;2;B;;871;292;481;623;248;0;11;612;623
17;Girona;34;Selva;17023;Blanes;1;4;A;;832;256;438;504;328;1;3;500;503
17;Girona;34;Selva;17023;Blanes;1;4;B;;732;243;371;435;297;2;4;429;433
17;Girona;34;Selva;17023;Blanes;2;1;A;;809;220;369;454;355;1;0;453;453
17;Girona;34;Selva;17023;Blanes;2;1;B;;763;208;368;462;301;1;3;458;461
17;Girona;34;Selva;17023;Blanes;2;10;A;;746;136;275;345;401;5;3;337;340
17;Girona;34;Selva;17023;Blanes;2;10;B;;719;110;240;325;394;4;2;319;321
17;Girona;34;Selva;17023;Blanes;2;11;U;;983;219;355;467;516;0;1;466;467
17;Girona;34;Selva;17023;Blanes;2;2;U;;854;220;369;474;380;0;4;470;474
17;Girona;34;Selva;17023;Blanes;2;3;A;;574;122;228;277;297;2;2;273;275
17;Girona;34;Selva;17023;Blanes;2;3;B;;581;138;258;322;259;1;1;320;321
17;Girona;34;Selva;17023;Blanes;2;4;A;;749;179;343;425;324;0;1;424;425
17;Girona;34;Selva;17023;Blanes;2;4;B;;684;155;305;369;315;1;4;364;368
17;Girona;34;Selva;17023;Blanes;2;5;A;;988;223;541;554;434;2;1;551;552
17;Girona;34;Selva;17023;Blanes;2;5;B;;935;219;436;528;407;0;5;523;528
17;Girona;34;Selva;17023;Blanes;2;6;A;;799;171;359;494;305;1;2;491;493
17;Girona;34;Selva;17023;Blanes;2;6;B;;767;192;355;485;282;1;2;482;484
17;Girona;34;Selva;17023;Blanes;2;7;A;;949;191;427;557;392;0;1;556;557
17;Girona;34;Selva;17023;Blanes;2;7;B;;847;170;370;481;366;2;3;476;479
17;Girona;34;Selva;17023;Blanes;2;8;A;;692;140;305;414;278;0;4;410;414
17;Girona;34;Selva;17023;Blanes;2;8;B;;670;136;316;399;271;0;6;393;399
17;Girona;34;Selva;17023;Blanes;2;9;U;;780;215;396;483;297;2;3;478;481
17;Girona;34;Selva;17023;Blanes;3;1;U;;1030;180;435;547;483;2;2;543;545
17;Girona;34;Selva;17023;Blanes;3;2;U;;1077;223;459;583;494;5;3;575;578
17;Girona;34;Selva;17023;Blanes;3;3;U;;1066;224;467;566;500;2;4;560;564
17;Girona;34;Selva;17023;Blanes;3;4;A;;406;98;200;254;152;0;0;254;254
17;Girona;34;Selva;17023;Blanes;3;4;B;;851;155;329;424;427;5;0;419;419
17;Girona;2;Alt Empordà;17029;Boadella i les Escaules;1;1;U;;194;45;81;120;74;1;3;116;119
17;Girona;15;Cerdanya;17024;Bolvir;1;1;U;;247;56;121;149;98;1;2;146;148
43;Tarragona;12;Baix Penedès;43030;Bonastre;1;1;U;;270;88;170;190;80;0;0;190;190
25;Lleida;39;Consell General d'Aran;25057;Bòrdes, es;1;1;U;;174;51;95;121;53;1;1;119;120
17;Girona;20;Gironès;17025;Bordils;1;1;U;;1063;273;625;756;307;4;9;743;752
25;Lleida;18;Garrigues;25058;Borges Blanques, les;1;1;U;;793;164;369;514;279;2;5;507;512
25;Lleida;18;Garrigues;25058;Borges Blanques, les;1;2;U;;1044;226;514;694;350;5;8;681;689
25;Lleida;18;Garrigues;25058;Borges Blanques, les;2;1;A;;661;153;316;437;224;1;2;434;436
25;Lleida;18;Garrigues;25058;Borges Blanques, les;2;1;B;;668;137;307;421;247;3;3;415;418
25;Lleida;18;Garrigues;25058;Borges Blanques, les;2;2;U;;1204;221;570;731;473;4;4;723;727
43;Tarragona;8;Baix Camp;43031;Borges del Camp, les;1;1;A;;631;137;317;451;180;0;1;450;451
43;Tarragona;8;Baix Camp;43031;Borges del Camp, les;1;1;B;;671;172;333;483;188;1;3;479;482
17;Girona;2;Alt Empordà;17026;Borrassà;1;1;U;;457;152;261;310;147;0;1;309;310
8;Barcelona;14;Berguedà;08024;Borredà;1;1;U;;406;109;222;276;130;1;4;271;275
25;Lleida;39;Consell General d'Aran;25059;Bossòst;1;1;U;;705;200;375;495;210;0;2;493;495
43;Tarragona;37;Terra Alta;43032;Bot;1;1;U;;749;181;410;523;226;6;3;514;517
43;Tarragona;8;Baix Camp;43033;Botarell;1;1;U;;479;105;268;327;152;3;3;321;324
25;Lleida;18;Garrigues;25056;Bovera;1;1;U;;362;127;202;255;107;2;0;253;253
43;Tarragona;1;Alt Camp;43034;Bràfim;1;1;U;;481;140;288;365;116;1;4;360;364
17;Girona;34;Selva;17027;Breda;1;1;A;;511;148;293;361;150;1;2;358;360
17;Girona;34;Selva;17027;Breda;1;1;B;;555;135;283;357;198;2;1;354;355
17;Girona;34;Selva;17027;Breda;1;1;C;;443;137;253;315;128;0;3;312;315
17;Girona;34;Selva;17027;Breda;1;2;A;;557;170;340;402;155;4;2;396;398
17;Girona;34;Selva;17027;Breda;1;2;B;;625;192;359;461;164;1;2;458;460
8;Barcelona;6;Anoia;08025;Bruc, el;1;1;U;;761;177;376;529;232;1;3;525;528
8;Barcelona;24;Osona;08026;Brull, el;1;1;U;;174;34;107;126;48;0;3;123;126
17;Girona;34;Selva;17028;Brunyola i Sant Martí Sapresa;1;1;U;;343;95;160;216;127;0;0;216;216
43;Tarragona;29;Priorat;43035;Cabacés;1;1;U;;302;95;181;214;88;1;1;212;213
25;Lleida;23;Noguera;25060;Cabanabona;1;1;U;;89;17;48;61;28;0;1;60;61
17;Girona;2;Alt Empordà;17031;Cabanelles;1;1;U;;173;49;83;109;64;0;2;107;109
17;Girona;2;Alt Empordà;17030;Cabanes;1;1;U;;669;207;358;427;242;5;1;421;422
8;Barcelona;3;Alt Penedès;08027;Cabanyes, les;1;1;U;;450;110;254;338;112;2;1;335;336
25;Lleida;4;Alt Urgell;25061;Cabó;1;1;U;;109;28;52;61;48;0;0;61;61
43;Tarragona;1;Alt Camp;43036;Cabra del Camp;1;1;U;;496;126;243;295;201;0;2;293;295
8;Barcelona;6;Anoia;08028;Cabrera d'Anoia;1;1;U;;408;122;187;243;165;0;2;241;243
8;Barcelona;21;Maresme;08029;Cabrera de Mar;1;1;A;;821;219;432;572;249;2;5;565;570
8;Barcelona;21;Maresme;08029;Cabrera de Mar;1;1;B;;793;207;428;548;245;0;2;546;548
8;Barcelona;21;Maresme;08029;Cabrera de Mar;1;2;A;;566;132;265;341;225;0;4;337;341
8;Barcelona;21;Maresme;08029;Cabrera de Mar;1;2;B;;633;155;307;391;242;0;3;388;391
8;Barcelona;21;Maresme;08030;Cabrils;1;1;A;;855;174;422;526;329;1;4;521;525
8;Barcelona;21;Maresme;08030;Cabrils;1;1;B;;861;180;466;561;300;0;5;556;561
8;Barcelona;21;Maresme;08030;Cabrils;1;2;A;;888;190;457;591;297;0;9;582;591
8;Barcelona;21;Maresme;08030;Cabrils;1;2;B;;875;175;418;559;316;1;9;549;558
17;Girona;2;Alt Empordà;17032;Cadaqués;1;1;A;;757;210;380;463;294;1;3;459;462
17;Girona;2;Alt Empordà;17032;Cadaqués;1;1;B;;752;197;368;442;310;1;1;440;441
8;Barcelona;6;Anoia;08031;Calaf;1;1;U;;649;153;324;426;223;3;1;422;423
8;Barcelona;6;Anoia;08031;Calaf;1;2;A;;622;153;301;440;182;0;4;436;440
8;Barcelona;6;Anoia;08031;Calaf;1;2;B;;558;134;250;387;171;2;12;373;385
8;Barcelona;6;Anoia;08031;Calaf;1;2;C;;709;151;372;509;200;1;4;504;508
43;Tarragona;12;Baix Penedès;43037;Calafell;1;1;A;;640;135;238;329;311;2;8;319;327
43;Tarragona;12;Baix Penedès;43037;Calafell;1;1;B;;763;190;307;384;379;4;3;377;380
43;Tarragona;12;Baix Penedès;43037;Calafell;1;2;U;;884;211;411;538;346;0;2;536;538
43;Tarragona;12;Baix Penedès;43037;Calafell;1;3;A;;491;118;254;315;176;1;1;313;314
43;Tarragona;12;Baix Penedès;43037;Calafell;1;3;B;;730;206;395;491;239;5;5;481;486
43;Tarragona;12;Baix Penedès;43037;Calafell;2;1;A;;469;101;211;297;172;5;0;292;292
43;Tarragona;12;Baix Penedès;43037;Calafell;2;1;B;;545;113;251;332;213;1;6;325;331
43;Tarragona;12;Baix Penedès;43037;Calafell;2;1;C;;800;158;367;500;300;4;1;495;496
43;Tarragona;12;Baix Penedès;43037;Calafell;2;2;A;;614;153;253;326;288;3;2;321;323
43;Tarragona;12;Baix Penedès;43037;Calafell;2;2;B;;690;178;279;362;328;1;3;358;361
43;Tarragona;12;Baix Penedès;43037;Calafell;2;2;C;;772;203;322;405;367;1;4;400;404
43;Tarragona;12;Baix Penedès;43037;Calafell;2;3;A;;721;149;253;331;390;1;1;329;330
43;Tarragona;12;Baix Penedès;43037;Calafell;2;3;B;;857;200;314;408;449;3;4;401;405
8;Barcelona;;;08034;Calders;1;1;U;;582;165;250;427;155;0;1;426;427
8;Barcelona;21;Maresme;08032;Caldes d'Estrac;1;1;A;;754;224;402;481;273;0;4;477;481
8;Barcelona;21;Maresme;08032;Caldes d'Estrac;1;1;B;;861;240;460;558;303;2;3;553;556
17;Girona;34;Selva;17033;Caldes de Malavella;1;1;U;;1348;310;678;826;522;1;5;820;825
17;Girona;34;Selva;17033;Caldes de Malavella;1;2;U;;1150;286;470;561;589;0;4;557;561
17;Girona;34;Selva;17033;Caldes de Malavella;1;3;U;;781;230;463;551;230;1;4;546;550
8;Barcelona;41;Vallès Oriental;08033;Caldes de Montbui;1;1;A;;516;181;236;326;190;1;1;324;325
8;Barcelona;41;Vallès Oriental;08033;Caldes de Montbui;1;1;B;;708;126;322;431;277;0;5;426;431
8;Barcelona;41;Vallès Oriental;08033;Caldes de Montbui;1;2;A;;805;181;325;429;376;0;0;429;429
8;Barcelona;41;Vallès Oriental;08033;Caldes de Montbui;1;2;B;;917;205;365;518;399;0;1;517;518
8;Barcelona;41;Vallès Oriental;08033;Caldes de Montbui;1;3;U;;750;219;376;474;276;0;10;464;474
8;Barcelona;41;Vallès Oriental;08033;Caldes de Montbui;2;1;A;;592;154;297;385;207;1;2;382;384
8;Barcelona;41;Vallès Oriental;08033;Caldes de Montbui;2;1;B;;611;169;274;376;235;0;1;375;376
8;Barcelona;41;Vallès Oriental;08033;Caldes de Montbui;2;1;C;;625;153;292;390;235;0;1;389;390
8;Barcelona;41;Vallès Oriental;08033;Caldes de Montbui;3;1;A;;610;146;302;383;227;0;1;382;383
8;Barcelona;41;Vallès Oriental;08033;Caldes de Montbui;3;1;B;;716;190;339;453;263;0;4;449;453
8;Barcelona;41;Vallès Oriental;08033;Caldes de Montbui;3;2;U;;709;196;337;455;254;3;2;450;452
8;Barcelona;41;Vallès Oriental;08033;Caldes de Montbui;3;3;A;;744;140;270;348;396;0;6;342;348
8;Barcelona;41;Vallès Oriental;08033;Caldes de Montbui;3;3;B;;1004;277;537;499;505;0;2;497;499
8;Barcelona;41;Vallès Oriental;08033;Caldes de Montbui;3;4;A;;671;151;313;426;245;0;5;421;426
8;Barcelona;41;Vallès Oriental;08033;Caldes de Montbui;3;4;B;;808;172;338;503;305;3;3;497;500
8;Barcelona;21;Maresme;08035;Calella;1;1;A;;497;155;256;323;174;0;1;322;323
8;Barcelona;21;Maresme;08035;Calella;1;1;B;;636;189;319;418;218;0;2;416;418
8;Barcelona;21;Maresme;08035;Calella;1;2;U;;735;201;374;469;266;0;2;467;469
8;Barcelona;21;Maresme;08035;Calella;1;3;A;;484;115;193;251;233;1;0;250;250
8;Barcelona;21;Maresme;08035;Calella;1;3;B;;738;160;274;372;366;0;0;372;372
8;Barcelona;21;Maresme;08035;Calella;2;1;U;;609;168;300;386;223;2;6;378;384
8;Barcelona;21;Maresme;08035;Calella;2;2;A;;465;108;226;284;181;1;0;283;283
8;Barcelona;21;Maresme;08035;Calella;2;2;B;;515;123;232;300;215;1;3;296;299
8;Barcelona;21;Maresme;08035;Calella;2;2;C;;585;158;282;368;217;0;4;364;368
8;Barcelona;21;Maresme;08035;Calella;3;1;A;;532;123;262;337;195;1;6;330;336
8;Barcelona;21;Maresme;08035;Calella;3;1;B;;547;127;248;323;224;0;2;321;323
8;Barcelona;21;Maresme;08035;Calella;3;1;C;;559;132;271;361;198;0;2;359;361
8;Barcelona;21;Maresme;08035;Calella;3;2;A;;478;112;215;277;201;0;5;272;277
8;Barcelona;21;Maresme;08035;Calella;3;2;B;;563;120;222;296;267;0;1;295;296
8;Barcelona;21;Maresme;08035;Calella;3;2;C;;602;149;268;358;244;0;0;358;358
8;Barcelona;21;Maresme;08035;Calella;3;3;A;;541;125;241;315;226;0;0;315;315
8;Barcelona;21;Maresme;08035;Calella;3;3;B;;571;109;207;281;290;0;1;280;281
8;Barcelona;21;Maresme;08035;Calella;3;3;C;;562;123;251;303;259;0;0;303;303
8;Barcelona;24;Osona;08037;Calldetenes;1;1;A;;760;169;425;550;210;1;5;544;549
8;Barcelona;24;Osona;08037;Calldetenes;1;1;B;;798;208;453;581;217;2;4;575;579
8;Barcelona;7;Bages;08038;Callús;1;1;A;;493;122;274;354;139;0;1;353;354
8;Barcelona;7;Bages;08038;Callús;1;1;B;;639;138;319;426;213;0;3;423;426
17;Girona;10;Baix Empordà;17034;Calonge i Sant Antoni;1;1;A;;830;198;374;462;368;0;4;458;462
17;Girona;10;Baix Empordà;17034;Calonge i Sant Antoni;1;1;B;;925;196;400;497;428;1;3;493;496
17;Girona;10;Baix Empordà;17034;Calonge i Sant Antoni;1;2;U;;922;207;427;516;406;8;3;505;508
17;Girona;10;Baix Empordà;17034;Calonge i Sant Antoni;1;3;U;;1019;238;424;554;465;2;1;551;552
17;Girona;10;Baix Empordà;17034;Calonge i Sant Antoni;1;4;A;;724;155;303;369;355;2;2;365;367
17;Girona;10;Baix Empordà;17034;Calonge i Sant Antoni;1;4;B;;732;207;365;435;297;3;3;429;432
8;Barcelona;6;Anoia;08036;Calonge de Segarra;1;1;U;;158;35;86;126;32;0;4;122;126
25;Lleida;23;Noguera;25062;Camarasa;1;1;U;;786;221;450;547;239;0;2;545;547
43;Tarragona;9;Baix Ebre;43903;Camarles;1;1;A;;870;244;478;584;286;3;7;574;581
43;Tarragona;9;Baix Ebre;43903;Camarles;1;1;B;;723;173;358;447;276;0;6;441;447
43;Tarragona;9;Baix Ebre;43903;Camarles;1;2;U;;762;131;327;410;352;0;1;409;410
43;Tarragona;8;Baix Camp;43038;Cambrils;1;1;A;;658;150;255;307;351;0;4;303;307
43;Tarragona;8;Baix Camp;43038;Cambrils;1;1;B;;725;177;274;340;385;3;6;331;337
43;Tarragona;8;Baix Camp;43038;Cambrils;1;2;A;;633;111;227;304;329;3;6;295;301
43;Tarragona;8;Baix Camp;43038;Cambrils;1;2;B;;690;140;270;360;330;2;3;355;358
43;Tarragona;8;Baix Camp;43038;Cambrils;1;2;C;;657;144;274;355;302;2;5;348;353
43;Tarragona;8;Baix Camp;43038;Cambrils;1;3;A;;756;144;310;397;359;1;4;392;396
43;Tarragona;8;Baix Camp;43038;Cambrils;1;3;B;;899;201;383;498;401;1;6;491;497
43;Tarragona;8;Baix Camp;43038;Cambrils;1;4;A;;560;103;214;273;287;0;1;272;273
43;Tarragona;8;Baix Camp;43038;Cambrils;1;4;B;;756;161;283;374;382;0;7;367;374
43;Tarragona;8;Baix Camp;43038;Cambrils;2;1;A;;701;182;298;378;323;0;4;374;378
43;Tarragona;8;Baix Camp;43038;Cambrils;2;1;B;;698;192;328;407;291;0;3;404;407
43;Tarragona;8;Baix Camp;43038;Cambrils;2;2;A;;631;158;251;325;306;1;2;322;324
43;Tarragona;8;Baix Camp;43038;Cambrils;2;2;B;;636;135;229;298;338;1;2;295;297
43;Tarragona;8;Baix Camp;43038;Cambrils;2;3;A;;344;67;114;169;175;0;2;167;169
43;Tarragona;8;Baix Camp;43038;Cambrils;2;3;B;;468;95;185;248;220;0;1;247;248
43;Tarragona;8;Baix Camp;43038;Cambrils;2;4;A;;616;116;211;285;331;0;0;285;285
43;Tarragona;8;Baix Camp;43038;Cambrils;2;4;B;;663;118;210;286;377;0;4;282;286
43;Tarragona;8;Baix Camp;43038;Cambrils;2;4;C;;698;130;243;322;376;0;2;320;322
43;Tarragona;8;Baix Camp;43038;Cambrils;2;5;A;;604;113;213;282;322;1;4;277;281
43;Tarragona;8;Baix Camp;43038;Cambrils;2;5;B;;677;118;240;325;352;1;1;323;324
43;Tarragona;8;Baix Camp;43038;Cambrils;2;6;A;;616;127;275;349;267;1;5;343;348
43;Tarragona;8;Baix Camp;43038;Cambrils;2;6;B;;602;115;256;315;287;0;4;311;315
43;Tarragona;8;Baix Camp;43038;Cambrils;2;6;C;;621;98;239;323;298;0;10;313;323
17;Girona;28;Pla de l'Estany;17035;Camós;1;1;U;;536;170;341;415;121;3;2;410;412
17;Girona;31;Ripollès;17036;Campdevànol;1;1;A;;509;150;299;373;136;1;2;370;372
17;Girona;31;Ripollès;17036;Campdevànol;1;1;B;;574;178;356;437;137;4;3;430;433
17;Girona;31;Ripollès;17036;Campdevànol;1;2;A;;473;154;277;334;139;0;2;332;334
17;Girona;31;Ripollès;17036;Campdevànol;1;2;B;;494;128;259;346;148;2;2;342;344
17;Girona;31;Ripollès;17036;Campdevànol;1;3;U;;838;211;440;576;262;0;3;573;576
17;Girona;31;Ripollès;17037;Campelles;1;1;U;;112;34;59;77;35;1;3;73;76
8;Barcelona;41;Vallès Oriental;08039;Campins;1;1;U;;237;77;127;169;68;0;0;169;169
17;Girona;20;Gironès;17038;Campllong;1;1;U;;246;70;127;169;77;1;3;165;168
17;Girona;31;Ripollès;17039;Camprodon;1;1;A;;581;169;336;431;150;1;10;420;430
17;Girona;31;Ripollès;17039;Camprodon;1;1;B;;709;222;435;527;182;4;8;515;523
17;Girona;31;Ripollès;17039;Camprodon;1;2;U;;745;250;406;492;253;3;3;486;489
25;Lleida;39;Consell General d'Aran;25063;Canejan;1;1;U;;94;31;49;69;25;0;0;69;69
17;Girona;20;Gironès;17040;Canet d'Adri;1;1;U;;419;131;215;264;155;0;3;261;264
8;Barcelona;21;Maresme;08040;Canet de Mar;1;1;A;;1054;312;543;676;378;1;6;669;675
8;Barcelona;21;Maresme;08040;Canet de Mar;1;1;B;;1180;361;624;768;412;1;7;760;767
8;Barcelona;21;Maresme;08040;Canet de Mar;1;2;A;;978;260;481;584;394;3;5;576;581
8;Barcelona;21;Maresme;08040;Canet de Mar;1;2;B;;1053;276;495;605;448;0;2;603;605
8;Barcelona;21;Maresme;08040;Canet de Mar;1;3;A;;816;239;422;535;281;0;1;534;535
8;Barcelona;21;Maresme;08040;Canet de Mar;1;3;B;;1022;301;548;663;359;0;2;661;663
8;Barcelona;21;Maresme;08040;Canet de Mar;1;4;A;;979;238;485;616;363;1;3;612;615
8;Barcelona;21;Maresme;08040;Canet de Mar;1;4;B;;1191;294;555;736;455;0;6;730;736
8;Barcelona;41;Vallès Oriental;08041;Canovelles;1;1;U;;1096;180;420;584;512;6;4;574;578
8;Barcelona;41;Vallès Oriental;08041;Canovelles;1;2;A;;731;223;333;405;326;0;3;402;405
8;Barcelona;41;Vallès Oriental;08041;Canovelles;1;2;B;;898;240;386;486;412;3;2;481;483
8;Barcelona;41;Vallès Oriental;08041;Canovelles;1;3;A;;624;180;278;340;284;0;0;340;340
8;Barcelona;41;Vallès Oriental;08041;Canovelles;1;3;B;;864;168;321;428;436;0;1;427;428
8;Barcelona;41;Vallès Oriental;08041;Canovelles;1;4;U;;961;174;366;476;485;1;3;472;475
8;Barcelona;41;Vallès Oriental;08041;Canovelles;1;5;A;;519;125;232;288;231;0;2;286;288
8;Barcelona;41;Vallès Oriental;08041;Canovelles;1;5;B;;750;198;350;423;327;0;1;422;423
8;Barcelona;41;Vallès Oriental;08041;Canovelles;1;6;A;;664;177;311;392;272;1;7;384;391
8;Barcelona;41;Vallès Oriental;08041;Canovelles;1;6;B;;940;220;422;549;391;1;5;543;548
8;Barcelona;41;Vallès Oriental;08041;Canovelles;1;7;A;;668;147;302;410;258;1;2;407;409
8;Barcelona;41;Vallès Oriental;08041;Canovelles;1;7;B;;901;186;365;514;387;1;2;511;513
8;Barcelona;41;Vallès Oriental;08041;Canovelles;1;8;A;;450;84;174;256;194;0;2;254;256
8;Barcelona;41;Vallès Oriental;08041;Canovelles;1;8;B;;628;133;291;379;249;2;4;373;377
8;Barcelona;41;Vallès Oriental;08042;Cànoves i Samalús;1;1;A;;697;205;382;478;219;1;2;475;477
8;Barcelona;41;Vallès Oriental;08042;Cànoves i Samalús;1;1;B;;795;196;371;488;307;3;0;485;485
17;Girona;2;Alt Empordà;17041;Cantallops;1;1;U;;243;83;138;173;70;0;4;169;173
8;Barcelona;17;Garraf;08043;Canyelles;1;1;A;;692;189;347;439;253;3;1;435;436
8;Barcelona;17;Garraf;08043;Canyelles;1;1;B;;791;237;414;507;284;1;2;504;506
43;Tarragona;8;Baix Camp;43039;Capafonts;1;1;U;;112;34;66;76;36;0;0;76;76
43;Tarragona;29;Priorat;43040;Capçanes;1;1;U;;341;99;203;244;97;3;3;238;241
8;Barcelona;6;Anoia;08044;Capellades;1;1;A;;556;123;252;350;206;3;2;345;347
8;Barcelona;6;Anoia;08044;Capellades;1;1;B;;655;130;266;387;268;3;0;384;384
8;Barcelona;6;Anoia;08044;Capellades;1;1;C;;612;109;259;370;242;3;2;365;367
8;Barcelona;6;Anoia;08044;Capellades;2;1;A;;528;128;256;338;190;0;1;337;338
8;Barcelona;6;Anoia;08044;Capellades;2;1;B;;602;146;311;419;183;2;3;414;417
8;Barcelona;6;Anoia;08044;Capellades;2;2;A;;474;116;227;312;162;1;1;310;311
8;Barcelona;6;Anoia;08044;Capellades;2;2;B;;625;168;309;436;189;2;2;432;434
17;Girona;2;Alt Empordà;17042;Capmany;1;1;U;;378;130;234;281;97;0;0;281;281
8;Barcelona;14;Berguedà;08045;Capolat;1;1;U;;60;14;21;32;28;0;1;31;32
8;Barcelona;41;Vallès Oriental;08046;Cardedeu;1;1;A;;460;94;235;306;154;1;6;299;305
8;Barcelona;41;Vallès Oriental;08046;Cardedeu;1;1;B;;468;89;230;302;166;0;5;297;302
8;Barcelona;41;Vallès Oriental;08046;Cardedeu;1;2;A;;622;145;340;453;169;1;4;448;452
8;Barcelona;41;Vallès Oriental;08046;Cardedeu;1;2;B;;667;152;372;474;193;1;11;462;473
8;Barcelona;41;Vallès Oriental;08046;Cardedeu;1;3;A;;489;124;252;320;169;2;2;316;318
8;Barcelona;41;Vallès Oriental;08046;Cardedeu;1;3;B;;599;144;317;383;216;2;2;379;381
8;Barcelona;41;Vallès Oriental;08046;Cardedeu;2;1;A;;739;198;369;468;271;0;4;464;468
8;Barcelona;41;Vallès Oriental;08046;Cardedeu;2;1;B;;749;189;381;478;271;3;6;469;475
8;Barcelona;41;Vallès Oriental;08046;Cardedeu;2;2;A;;481;122;250;324;157;2;0;322;322
8;Barcelona;41;Vallès Oriental;08046;Cardedeu;2;2;B;;460;125;232;293;167;4;2;287;289
8;Barcelona;41;Vallès Oriental;08046;Cardedeu;2;3;A;;547;123;275;358;189;0;3;355;358
8;Barcelona;41;Vallès Oriental;08046;Cardedeu;2;3;B;;548;130;281;351;197;0;4;347;351
8;Barcelona;41;Vallès Oriental;08046;Cardedeu;2;4;A;;672;195;342;434;238;0;7;427;434
8;Barcelona;41;Vallès Oriental;08046;Cardedeu;2;4;B;;607;138;305;388;219;0;6;382;388
8;Barcelona;41;Vallès Oriental;08046;Cardedeu;3;1;A;;558;144;266;353;205;0;1;352;353
8;Barcelona;41;Vallès Oriental;08046;Cardedeu;3;1;B;;728;165;312;409;319;1;4;404;408
8;Barcelona;7;Bages;08047;Cardona;1;1;A;;432;84;199;281;151;0;5;276;281
8;Barcelona;7;Bages;08047;Cardona;1;1;B;;354;84;182;230;124;2;1;227;228
8;Barcelona;7;Bages;08047;Cardona;1;1;C;;413;97;209;274;139;0;6;268;274
8;Barcelona;7;Bages;08047;Cardona;1;2;A;;483;138;252;301;182;0;0;301;301
8;Barcelona;7;Bages;08047;Cardona;1;2;B;;526;147;266;321;205;0;0;321;321
8;Barcelona;7;Bages;08047;Cardona;1;3;A;;700;134;323;455;245;2;3;450;453
8;Barcelona;7;Bages;08047;Cardona;1;3;B;;650;146;336;443;207;0;4;439;443
8;Barcelona;7;Bages;08047;Cardona;2;1;U;;429;95;183;259;170;2;0;257;257
8;Barcelona;7;Bages;08047;Cardona;2;2;U;;472;140;235;304;168;8;2;294;296
8;Barcelona;7;Bages;08047;Cardona;2;3;U;;540;142;315;409;131;2;3;404;407
8;Barcelona;6;Anoia;08048;Carme;1;1;U;;591;153;347;451;140;1;2;448;450
43;Tarragona;37;Terra Alta;43041;Caseres;1;1;U;;280;51;135;194;86;0;3;191;194
17;Girona;20;Gironès;17044;Cassà de la Selva;1;1;A;;582;175;303;393;189;1;3;389;392
17;Girona;20;Gironès;17044;Cassà de la Selva;1;1;B;;565;168;327;408;157;1;4;403;407
17;Girona;20;Gironès;17044;Cassà de la Selva;1;2;A;;552;159;297;356;196;1;3;352;355
17;Girona;20;Gironès;17044;Cassà de la Selva;1;2;B;;605;159;291;367;238;1;0;366;366
17;Girona;20;Gironès;17044;Cassà de la Selva;2;1;A;;825;239;417;526;299;4;7;515;522
17;Girona;20;Gironès;17044;Cassà de la Selva;2;1;B;;829;244;420;528;301;4;6;518;524
17;Girona;20;Gironès;17044;Cassà de la Selva;2;2;A;;800;232;445;539;261;4;3;532;535
17;Girona;20;Gironès;17044;Cassà de la Selva;2;2;B;;751;233;395;482;269;6;2;474;476
17;Girona;20;Gironès;17044;Cassà de la Selva;2;3;U;;642;205;366;437;205;3;7;427;434
8;Barcelona;14;Berguedà;08049;Casserres;1;1;A;;1167;272;589;741;426;3;3;735;738
8;Barcelona;14;Berguedà;08049;Casserres;1;1;B;;257;58;130;178;79;0;0;178;178
25;Lleida;35;Solsonès;25064;Castellar de la Ribera;1;1;U;;129;41;71;96;33;0;1;95;96
8;Barcelona;14;Berguedà;08050;Castellar del Riu;1;1;U;;101;26;48;70;31;0;0;70;70
8;Barcelona;40;Vallès Occidental;08051;Castellar del Vallès;1;1;U;;971;217;435;607;364;1;0;606;606
8;Barcelona;40;Vallès Occidental;08051;Castellar del Vallès;1;2;A;;701;159;355;474;227;1;1;472;473
8;Barcelona;40;Vallès Occidental;08051;Castellar del Vallès;1;2;B;;906;275;506;609;297;1;4;604;608
8;Barcelona;40;Vallès Occidental;08051;Castellar del Vallès;1;3;U;;1057;231;478;651;406;1;4;646;650
8;Barcelona;40;Vallès Occidental;08051;Castellar del Vallès;1;4;A;;837;211;402;527;310;1;2;524;526
8;Barcelona;40;Vallès Occidental;08051;Castellar del Vallès;1;4;B;;1024;253;479;627;397;0;2;625;627
8;Barcelona;40;Vallès Occidental;08051;Castellar del Vallès;1;5;A;;631;140;273;413;218;0;4;409;413
8;Barcelona;40;Vallès Occidental;08051;Castellar del Vallès;1;5;B;;730;181;366;489;241;1;5;483;488
8;Barcelona;40;Vallès Occidental;08051;Castellar del Vallès;1;6;A;;1139;209;458;623;516;0;4;619;623
8;Barcelona;40;Vallès Occidental;08051;Castellar del Vallès;1;6;B;;1307;248;530;725;582;0;9;716;725
8;Barcelona;40;Vallès Occidental;08051;Castellar del Vallès;1;7;A;;764;180;342;484;280;3;0;481;481
8;Barcelona;40;Vallès Occidental;08051;Castellar del Vallès;1;7;B;;852;191;363;484;368;0;0;484;484
8;Barcelona;40;Vallès Occidental;08051;Castellar del Vallès;1;8;A;;726;134;331;454;272;0;5;449;454
8;Barcelona;40;Vallès Occidental;08051;Castellar del Vallès;1;8;B;;819;146;344;472;347;0;3;469;472
8;Barcelona;40;Vallès Occidental;08051;Castellar del Vallès;1;9;A;;654;145;316;415;239;0;1;414;415
8;Barcelona;40;Vallès Occidental;08051;Castellar del Vallès;1;9;B;;717;152;346;462;255;0;1;461;462
8;Barcelona;14;Berguedà;08052;Castellar de n'Hug;1;1;U;;168;51;101;131;37;0;0;131;131
8;Barcelona;7;Bages;08053;Castellbell i el Vilar;1;1;A;;647;165;343;573;74;5;4;564;568
8;Barcelona;7;Bages;08053;Castellbell i el Vilar;1;1;B;;800;229;475;432;368;2;2;428;430
8;Barcelona;7;Bages;08053;Castellbell i el Vilar;1;2;U;;1137;237;474;600;537;6;2;592;594
8;Barcelona;40;Vallès Occidental;08054;Castellbisbal;1;1;A;;851;159;338;502;349;3;4;495;499
8;Barcelona;40;Vallès Occidental;08054;Castellbisbal;1;1;B;;871;182;384;535;336;1;6;528;534
8;Barcelona;40;Vallès Occidental;08054;Castellbisbal;1;2;A;;885;164;327;401;484;0;0;401;401
8;Barcelona;40;Vallès Occidental;08054;Castellbisbal;1;2;B;;827;150;302;443;384;0;1;442;443
8;Barcelona;40;Vallès Occidental;08054;Castellbisbal;1;3;A;;811;183;329;475;336;0;5;470;475
8;Barcelona;40;Vallès Occidental;08054;Castellbisbal;1;3;B;;882;179;396;556;326;1;8;547;555
8;Barcelona;40;Vallès Occidental;08054;Castellbisbal;1;4;U;;770;152;344;504;266;1;2;501;503
8;Barcelona;;;08055;Castellcir;1;1;U;;302;110;177;219;83;2;6;211;217
25;Lleida;18;Garrigues;25067;Castelldans;1;1;U;;802;174;449;543;259;0;6;537;543
8;Barcelona;11;Baix Llobregat;08056;Castelldefels;1;1;U;;703;141;269;363;340;2;2;359;361
8;Barcelona;11;Baix Llobregat;08056;Castelldefels;1;2;A;;540;136;237;308;232;1;5;302;307
8;Barcelona;11;Baix Llobregat;08056;Castelldefels;1;2;B;;644;154;255;322;322;1;2;319;321
8;Barcelona;11;Baix Llobregat;08056;Castelldefels;1;3;A;;568;124;240;308;260;0;3;305;308
8;Barcelona;11;Baix Llobregat;08056;Castelldefels;1;3;B;;654;148;315;385;269;1;1;383;384
8;Barcelona;11;Baix Llobregat;08056;Castelldefels;1;4;A;;802;138;276;378;424;0;1;377;378
8;Barcelona;11;Baix Llobregat;08056;Castelldefels;1;4;B;;853;150;294;412;441;1;2;409;411
8;Barcelona;11;Baix Llobregat;08056;Castelldefels;1;5;A;;734;155;268;359;375;0;7;352;359
8;Barcelona;11;Baix Llobregat;08056;Castelldefels;1;5;B;;814;247;343;421;393;1;4;416;420
8;Barcelona;11;Baix Llobregat;08056;Castelldefels;1;6;A;;932;180;333;477;455;1;8;468;476
8;Barcelona;11;Baix Llobregat;08056;Castelldefels;1;6;B;;1113;224;411;573;540;1;7;565;572
8;Barcelona;11;Baix Llobregat;08056;Castelldefels;1;7;U;;915;211;375;514;401;1;5;508;513
8;Barcelona;11;Baix Llobregat;08056;Castelldefels;2;1;A;;651;153;257;353;298;1;4;348;352
8;Barcelona;11;Baix Llobregat;08056;Castelldefels;2;1;B;;675;154;259;346;329;2;2;342;344
8;Barcelona;11;Baix Llobregat;08056;Castelldefels;2;2;A;;706;147;286;403;303;1;6;396;402
8;Barcelona;11;Baix Llobregat;08056;Castelldefels;2;2;B;;743;182;305;406;337;0;3;403;406
8;Barcelona;11;Baix Llobregat;08056;Castelldefels;2;2;C;;806;193;364;476;330;0;1;475;476
8;Barcelona;11;Baix Llobregat;08056;Castelldefels;2;3;A;;642;161;283;362;280;3;1;358;359
8;Barcelona;11;Baix Llobregat;08056;Castelldefels;2;3;B;;598;154;268;340;258;0;2;338;340
8;Barcelona;11;Baix Llobregat;08056;Castelldefels;2;4;A;;898;191;377;499;399;2;6;491;497
8;Barcelona;11;Baix Llobregat;08056;Castelldefels;2;4;B;;1018;186;388;524;494;1;6;517;523
8;Barcelona;11;Baix Llobregat;08056;Castelldefels;2;5;U;;1164;233;470;630;534;1;7;622;629
8;Barcelona;11;Baix Llobregat;08056;Castelldefels;3;1;U;;962;198;372;499;463;0;4;495;499
8;Barcelona;11;Baix Llobregat;08056;Castelldefels;3;2;A;;900;190;418;570;330;0;8;562;570
8;Barcelona;11;Baix Llobregat;08056;Castelldefels;3;2;B;;1041;226;452;655;386;3;8;644;652
8;Barcelona;11;Baix Llobregat;08056;Castelldefels;3;2;C;;1032;246;495;658;374;0;13;645;658
8;Barcelona;11;Baix Llobregat;08056;Castelldefels;3;3;A;;897;192;367;490;407;0;2;488;490
8;Barcelona;11;Baix Llobregat;08056;Castelldefels;3;3;B;;1086;196;404;558;528;0;2;556;558
8;Barcelona;11;Baix Llobregat;08056;Castelldefels;4;1;A;;931;213;428;572;359;0;6;566;572
8;Barcelona;11;Baix Llobregat;08056;Castelldefels;4;1;B;;1056;238;490;671;385;2;6;663;669
8;Barcelona;11;Baix Llobregat;08056;Castelldefels;4;2;U;;1146;211;447;570;576;0;8;562;570
8;Barcelona;11;Baix Llobregat;08056;Castelldefels;4;3;A;;660;125;253;341;319;0;3;338;341
8;Barcelona;11;Baix Llobregat;08056;Castelldefels;4;3;B;;717;127;275;382;335;0;6;376;382
8;Barcelona;11;Baix Llobregat;08056;Castelldefels;4;4;A;;738;130;250;316;422;2;5;309;314
8;Barcelona;11;Baix Llobregat;08056;Castelldefels;4;4;B;;676;123;245;297;379;1;2;294;296
8;Barcelona;11;Baix Llobregat;08056;Castelldefels;5;1;A;;848;201;374;488;360;0;8;480;488
8;Barcelona;11;Baix Llobregat;08056;Castelldefels;5;1;B;;1010;260;485;620;390;0;6;614;620
8;Barcelona;11;Baix Llobregat;08056;Castelldefels;5;1;C;;929;219;460;582;347;1;7;574;581
8;Barcelona;11;Baix Llobregat;08056;Castelldefels;5;2;A;;757;127;262;333;424;0;2;331;333
8;Barcelona;11;Baix Llobregat;08056;Castelldefels;5;2;B;;766;144;298;384;382;0;6;378;384
8;Barcelona;11;Baix Llobregat;08056;Castelldefels;5;3;A;;595;130;223;252;343;0;2;250;252
8;Barcelona;11;Baix Llobregat;08056;Castelldefels;5;3;B;;686;109;233;281;405;0;3;278;281
8;Barcelona;14;Berguedà;08057;Castell de l'Areny;1;1;U;;43;14;27;33;10;0;0;33;33
25;Lleida;25;Pallars Jussà;25904;Castell de Mur;1;1;U;;131;14;75;99;32;0;0;99;99
8;Barcelona;3;Alt Penedès;08058;Castellet i la Gornal;1;1;U;;472;89;230;302;170;6;1;295;296
8;Barcelona;3;Alt Penedès;08058;Castellet i la Gornal;1;2;U;;730;191;349;440;290;6;2;432;434
17;Girona;19;Garrotxa;17046;Castellfollit de la Roca;1;1;A;;406;137;256;298;108;0;5;293;298
17;Girona;19;Garrotxa;17046;Castellfollit de la Roca;1;1;B;;423;143;254;307;116;1;1;305;306
8;Barcelona;7;Bages;08059;Castellfollit del Boix;1;1;U;;299;59;137;188;111;3;5;180;185
8;Barcelona;6;Anoia;08060;Castellfollit de Riubregós;1;1;U;;204;45;108;150;54;3;1;146;147
8;Barcelona;7;Bages;08061;Castellgalí;1;1;U;;770;192;432;552;218;1;4;547;551
8;Barcelona;7;Bages;08062;Castellnou de Bages;1;1;U;;407;107;225;267;140;0;2;265;267
25;Lleida;27;Pla d'Urgell;25068;Castellnou de Seana;1;1;U;;631;140;324;435;196;1;0;434;434
17;Girona;2;Alt Empordà;17047;Castelló d'Empúries;1;1;A;;552;135;270;321;231;1;2;318;320
17;Girona;2;Alt Empordà;17047;Castelló d'Empúries;1;1;B;;507;127;236;310;197;0;3;307;310
17;Girona;2;Alt Empordà;17047;Castelló d'Empúries;1;2;A;;557;170;313;379;178;5;3;371;374
17;Girona;2;Alt Empordà;17047;Castelló d'Empúries;1;2;B;;537;166;281;342;195;0;5;337;342
17;Girona;2;Alt Empordà;17047;Castelló d'Empúries;1;3;A;;607;101;223;270;337;2;1;267;268
17;Girona;2;Alt Empordà;17047;Castelló d'Empúries;1;3;B;;685;125;228;296;389;1;1;294;295
25;Lleida;23;Noguera;25069;Castelló de Farfanya;1;1;U;;506;106;253;332;174;1;1;330;331
8;Barcelona;6;Anoia;08063;Castellolí;1;1;U;;356;89;184;265;91;6;5;254;259
17;Girona;10;Baix Empordà;17048;Castell-Platja d'Aro;1;1;U;;852;227;448;557;295;1;3;553;556
17;Girona;10;Baix Empordà;17048;Castell-Platja d'Aro;1;2;A;;1037;200;415;507;530;1;4;502;506
17;Girona;10;Baix Empordà;17048;Castell-Platja d'Aro;1;2;B;;955;200;384;480;475;3;2;475;477
17;Girona;10;Baix Empordà;17048;Castell-Platja d'Aro;1;3;A;;754;150;313;412;342;5;3;404;407
17;Girona;10;Baix Empordà;17048;Castell-Platja d'Aro;1;3;B;;762;176;333;431;331;0;2;429;431
17;Girona;10;Baix Empordà;17048;Castell-Platja d'Aro;1;4;A;;383;96;162;204;179;1;3;200;203
17;Girona;10;Baix Empordà;17048;Castell-Platja d'Aro;1;4;B;;338;83;142;172;166;0;0;172;172
25;Lleida;38;Urgell;25070;Castellserà;1;1;U;;960;275;535;678;282;3;5;670;675
8;Barcelona;;;08064;Castellterçol;1;1;A;;863;258;509;663;200;6;8;649;657
8;Barcelona;;;08064;Castellterçol;1;1;B;;848;239;474;621;227;4;1;616;617
43;Tarragona;8;Baix Camp;43042;Castellvell del Camp;1;1;U;;1164;289;589;802;362;1;6;795;801
8;Barcelona;3;Alt Penedès;08065;Castellví de la Marca;1;1;U;;1227;233;583;752;475;1;4;747;751
8;Barcelona;11;Baix Llobregat;08066;Castellví de Rosanes;1;1;A;;339;81;207;253;86;0;0;253;253
8;Barcelona;11;Baix Llobregat;08066;Castellví de Rosanes;1;1;B;;302;86;146;207;95;1;1;205;206
8;Barcelona;11;Baix Llobregat;08066;Castellví de Rosanes;1;1;C;;246;75;148;179;67;0;2;177;179
43;Tarragona;36;Tarragonès;43043;Catllar, el;1;1;A;;772;212;378;480;292;0;8;472;480
43;Tarragona;36;Tarragonès;43043;Catllar, el;1;1;B;;965;245;453;557;408;1;5;551;556
25;Lleida;4;Alt Urgell;25071;Cava;1;1;U;;50;15;25;30;20;0;0;30;30
17;Girona;34;Selva;17189;Cellera de Ter, la;1;1;U;;840;266;489;614;226;2;2;610;612
17;Girona;34;Selva;17189;Cellera de Ter, la;1;2;U;;806;223;450;579;227;0;4;575;579
17;Girona;20;Gironès;17049;Celrà;1;1;U;;965;234;472;627;338;0;3;624;627
17;Girona;20;Gironès;17049;Celrà;1;2;U;;1143;260;543;696;447;3;5;688;693
8;Barcelona;24;Osona;08067;Centelles;1;1;A;;621;212;342;427;194;0;2;425;427
8;Barcelona;24;Osona;08067;Centelles;1;1;B;;628;198;335;443;185;1;3;439;442
8;Barcelona;24;Osona;08067;Centelles;1;2;A;;422;124;219;273;149;1;1;271;272
8;Barcelona;24;Osona;08067;Centelles;1;2;B;;450;127;247;324;126;3;2;319;321
8;Barcelona;24;Osona;08067;Centelles;1;3;A;;439;127;232;280;159;0;3;277;280
8;Barcelona;24;Osona;08067;Centelles;1;3;B;;592;144;297;401;191;2;4;395;399
8;Barcelona;24;Osona;08067;Centelles;1;4;A;;715;199;341;483;232;0;2;481;483
8;Barcelona;24;Osona;08067;Centelles;1;4;B;;966;256;467;647;319;1;1;645;646
8;Barcelona;14;Berguedà;08268;Cercs;1;1;A;;353;96;206;262;91;1;0;261;261
8;Barcelona;14;Berguedà;08268;Cercs;1;1;B;;304;62;129;169;135;0;0;169;169
8;Barcelona;14;Berguedà;08268;Cercs;1;2;U;;614;243;407;477;137;2;4;471;475
8;Barcelona;40;Vallès Occidental;08266;Cerdanyola del Vallès;1;1;A;;765;158;331;416;349;1;5;410;415
8;Barcelona;40;Vallès Occidental;08266;Cerdanyola del Vallès;1;1;B;;883;205;387;484;399;0;11;473;484
8;Barcelona;40;Vallès Occidental;08266;Cerdanyola del Vallès;1;10;A;;707;140;310;405;302;0;3;402;405
8;Barcelona;40;Vallès Occidental;08266;Cerdanyola del Vallès;1;10;B;;853;168;357;498;355;0;2;496;498
8;Barcelona;40;Vallès Occidental;08266;Cerdanyola del Vallès;1;11;U;;1059;170;321;435;624;0;5;430;435
8;Barcelona;40;Vallès Occidental;08266;Cerdanyola del Vallès;1;12;A;;530;114;217;297;233;1;1;295;296
8;Barcelona;40;Vallès Occidental;08266;Cerdanyola del Vallès;1;12;B;;685;142;298;396;289;0;4;392;396
8;Barcelona;40;Vallès Occidental;08266;Cerdanyola del Vallès;1;12;C;;628;117;252;347;281;0;4;343;347
8;Barcelona;40;Vallès Occidental;08266;Cerdanyola del Vallès;1;13;U;;783;188;358;461;322;0;9;452;461
8;Barcelona;40;Vallès Occidental;08266;Cerdanyola del Vallès;1;14;A;;750;174;311;432;318;0;2;430;432
8;Barcelona;40;Vallès Occidental;08266;Cerdanyola del Vallès;1;14;B;;765;167;342;472;293;1;5;466;471
8;Barcelona;40;Vallès Occidental;08266;Cerdanyola del Vallès;1;15;A;;900;161;317;475;425;0;3;472;475
8;Barcelona;40;Vallès Occidental;08266;Cerdanyola del Vallès;1;15;B;;1019;204;412;583;436;0;5;578;583
8;Barcelona;40;Vallès Occidental;08266;Cerdanyola del Vallès;1;16;A;;816;188;360;508;308;0;9;499;508
8;Barcelona;40;Vallès Occidental;08266;Cerdanyola del Vallès;1;16;B;;829;189;394;515;314;1;6;508;514
8;Barcelona;40;Vallès Occidental;08266;Cerdanyola del Vallès;1;17;A;;942;180;397;495;447;0;1;494;495
8;Barcelona;40;Vallès Occidental;08266;Cerdanyola del Vallès;1;17;B;;1046;164;401;550;496;0;0;550;550
8;Barcelona;40;Vallès Occidental;08266;Cerdanyola del Vallès;1;18;A;;932;201;415;545;387;2;12;531;543
8;Barcelona;40;Vallès Occidental;08266;Cerdanyola del Vallès;1;18;B;;992;186;416;568;424;1;7;560;567
8;Barcelona;40;Vallès Occidental;08266;Cerdanyola del Vallès;1;19;A;;872;170;382;518;354;1;5;512;517
8;Barcelona;40;Vallès Occidental;08266;Cerdanyola del Vallès;1;19;B;;1057;196;445;607;450;1;5;601;606
8;Barcelona;40;Vallès Occidental;08266;Cerdanyola del Vallès;1;2;A;;681;147;270;373;308;1;2;370;372
8;Barcelona;40;Vallès Occidental;08266;Cerdanyola del Vallès;1;2;B;;877;207;388;498;379;0;1;497;498
8;Barcelona;40;Vallès Occidental;08266;Cerdanyola del Vallès;1;20;A;;918;259;487;626;292;0;16;610;626
8;Barcelona;40;Vallès Occidental;08266;Cerdanyola del Vallès;1;20;B;;1066;280;571;734;332;0;9;725;734
8;Barcelona;40;Vallès Occidental;08266;Cerdanyola del Vallès;1;27;A;;764;164;278;379;385;0;2;377;379
8;Barcelona;40;Vallès Occidental;08266;Cerdanyola del Vallès;1;27;B;;850;201;347;452;398;5;5;442;447
8;Barcelona;40;Vallès Occidental;08266;Cerdanyola del Vallès;1;28;A;;511;113;235;318;193;0;7;311;318
8;Barcelona;40;Vallès Occidental;08266;Cerdanyola del Vallès;1;28;B;;634;131;300;384;250;0;5;379;384
8;Barcelona;40;Vallès Occidental;08266;Cerdanyola del Vallès;1;29;A;;815;185;386;537;278;0;3;534;537
8;Barcelona;40;Vallès Occidental;08266;Cerdanyola del Vallès;1;29;B;;885;178;371;539;346;1;9;529;538
8;Barcelona;40;Vallès Occidental;08266;Cerdanyola del Vallès;1;3;A;;719;138;287;414;305;0;7;407;414
8;Barcelona;40;Vallès Occidental;08266;Cerdanyola del Vallès;1;3;B;;862;183;384;481;381;0;5;476;481
8;Barcelona;40;Vallès Occidental;08266;Cerdanyola del Vallès;1;30;A;;487;104;208;278;209;0;6;272;278
8;Barcelona;40;Vallès Occidental;08266;Cerdanyola del Vallès;1;30;B;;672;170;335;404;268;0;3;401;404
8;Barcelona;40;Vallès Occidental;08266;Cerdanyola del Vallès;1;31;A;;544;114;227;290;254;1;5;284;289
8;Barcelona;40;Vallès Occidental;08266;Cerdanyola del Vallès;1;31;B;;576;138;253;309;267;0;7;302;309
8;Barcelona;40;Vallès Occidental;08266;Cerdanyola del Vallès;1;32;U;;661;143;317;435;226;5;3;427;430
8;Barcelona;40;Vallès Occidental;08266;Cerdanyola del Vallès;1;33;A;;653;112;266;358;295;1;6;351;357
8;Barcelona;40;Vallès Occidental;08266;Cerdanyola del Vallès;1;33;B;;768;142;306;429;339;1;11;417;428
8;Barcelona;40;Vallès Occidental;08266;Cerdanyola del Vallès;1;34;A;;653;158;291;376;277;0;2;374;376
8;Barcelona;40;Vallès Occidental;08266;Cerdanyola del Vallès;1;34;B;;735;170;342;448;287;0;4;444;448
8;Barcelona;40;Vallès Occidental;08266;Cerdanyola del Vallès;1;4;A;;792;174;313;416;376;0;3;413;416
8;Barcelona;40;Vallès Occidental;08266;Cerdanyola del Vallès;1;4;B;;871;196;355;454;417;0;2;452;454
8;Barcelona;40;Vallès Occidental;08266;Cerdanyola del Vallès;1;5;A;;535;128;259;307;228;0;1;306;307
8;Barcelona;40;Vallès Occidental;08266;Cerdanyola del Vallès;1;5;B;;528;143;233;292;236;0;1;291;292
8;Barcelona;40;Vallès Occidental;08266;Cerdanyola del Vallès;1;6;A;;1194;231;502;675;519;0;3;672;675
8;Barcelona;40;Vallès Occidental;08266;Cerdanyola del Vallès;1;6;B;;1164;234;468;647;517;0;8;639;647
8;Barcelona;40;Vallès Occidental;08266;Cerdanyola del Vallès;1;6;C;;1289;243;530;735;554;0;12;723;735
8;Barcelona;40;Vallès Occidental;08266;Cerdanyola del Vallès;1;7;U;;690;167;324;427;263;0;7;420;427
8;Barcelona;40;Vallès Occidental;08266;Cerdanyola del Vallès;1;8;A;;677;149;281;374;303;2;5;367;372
8;Barcelona;40;Vallès Occidental;08266;Cerdanyola del Vallès;1;8;B;;852;197;382;479;373;0;7;472;479
8;Barcelona;40;Vallès Occidental;08266;Cerdanyola del Vallès;1;9;A;;682;139;275;382;300;1;3;378;381
8;Barcelona;40;Vallès Occidental;08266;Cerdanyola del Vallès;1;9;B;;840;200;371;498;342;8;0;490;490
8;Barcelona;11;Baix Llobregat;08068;Cervelló;1;1;A;;719;160;344;446;273;3;2;441;443
8;Barcelona;11;Baix Llobregat;08068;Cervelló;1;1;B;;885;190;400;557;328;0;2;555;557
8;Barcelona;11;Baix Llobregat;08068;Cervelló;1;2;A;;550;120;246;331;219;0;4;327;331
8;Barcelona;11;Baix Llobregat;08068;Cervelló;1;2;B;;612;142;293;389;223;3;7;379;386
8;Barcelona;11;Baix Llobregat;08068;Cervelló;1;3;U;;441;118;220;266;175;1;4;261;265
8;Barcelona;11;Baix Llobregat;08068;Cervelló;1;4;A;;729;179;311;422;307;0;6;416;422
8;Barcelona;11;Baix Llobregat;08068;Cervelló;1;4;B;;824;190;359;466;358;0;5;461;466
25;Lleida;32;Segarra;25072;Cervera;1;1;A;;531;130;231;314;217;3;2;309;311
25;Lleida;32;Segarra;25072;Cervera;1;1;B;;682;208;329;427;255;5;2;420;422
25;Lleida;32;Segarra;25072;Cervera;2;1;A;;669;152;315;418;251;2;3;413;416
25;Lleida;32;Segarra;25072;Cervera;2;1;B;;741;199;360;477;264;2;8;467;475
25;Lleida;32;Segarra;25072;Cervera;2;2;A;;688;99;259;396;292;2;4;390;394
25;Lleida;32;Segarra;25072;Cervera;2;2;B;;731;128;290;417;314;4;4;409;413
25;Lleida;32;Segarra;25072;Cervera;2;3;A;;464;87;194;297;167;1;3;293;296
25;Lleida;32;Segarra;25072;Cervera;2;3;B;;523;95;242;345;178;1;4;340;344
25;Lleida;32;Segarra;25072;Cervera;3;1;U;;972;198;419;592;380;6;5;581;586
25;Lleida;18;Garrigues;25073;Cervià de les Garrigues;1;1;U;;764;195;343;469;295;1;2;466;468
17;Girona;20;Gironès;17050;Cervià de Ter;1;1;U;;549;180;333;435;114;5;2;428;430
17;Girona;2;Alt Empordà;17051;Cistella;1;1;U;;196;44;114;145;51;0;0;145;145
25;Lleida;38;Urgell;25074;Ciutadilla;1;1;U;;199;51;122;149;50;0;1;148;149
25;Lleida;35;Solsonès;25075;Clariana de Cardener;1;1;U;;116;35;55;84;32;0;1;83;84
25;Lleida;18;Garrigues;25076;Cogul, el;1;1;U;;198;54;107;127;71;0;0;127;127
17;Girona;2;Alt Empordà;17054;Colera;1;1;U;;506;154;256;325;181;1;2;322;324
8;Barcelona;11;Baix Llobregat;08069;Collbató;1;1;A;;794;204;415;516;278;1;4;511;515
8;Barcelona;11;Baix Llobregat;08069;Collbató;1;1;B;;797;223;395;513;284;2;4;507;511
43;Tarragona;8;Baix Camp;43045;Colldejou;1;1;U;;162;38;38;108;54;0;0;108;108
25;Lleida;4;Alt Urgell;25077;Coll de Nargó;1;1;U;;526;109;232;293;233;0;2;291;293
8;Barcelona;;;08070;Collsuspina;1;1;U;;214;70;146;174;40;0;1;173;174
17;Girona;10;Baix Empordà;17055;Colomers;1;1;U;;169;75;123;134;35;4;1;129;130
25;Lleida;35;Solsonès;25163;Coma i la Pedra, la;1;1;U;;216;48;109;139;77;0;1;138;139
25;Lleida;25;Pallars Jussà;25161;Conca de Dalt;1;1;U;;389;98;168;222;167;0;2;220;222
43;Tarragona;16;Conca de Barberà;43046;Conesa;1;1;U;;107;30;58;72;35;1;1;70;71
43;Tarragona;36;Tarragonès;43047;Constantí;1;1;A;;579;140;300;365;214;0;3;362;365
43;Tarragona;36;Tarragonès;43047;Constantí;1;1;B;;635;151;309;388;247;1;3;384;387
43;Tarragona;36;Tarragonès;43047;Constantí;1;2;A;;579;82;156;201;378;1;1;199;200
43;Tarragona;36;Tarragonès;43047;Constantí;1;2;B;;662;113;201;256;406;1;0;255;255
43;Tarragona;36;Tarragonès;43047;Constantí;2;1;A;;649;146;286;395;254;1;8;386;394
43;Tarragona;36;Tarragonès;43047;Constantí;2;1;B;;958;225;278;569;389;3;6;560;566
8;Barcelona;6;Anoia;08071;Copons;1;1;U;;248;77;145;176;72;2;7;167;174
43;Tarragona;37;Terra Alta;43048;Corbera d'Ebre;1;1;U;;902;224;428;583;319;2;6;575;581
8;Barcelona;11;Baix Llobregat;08072;Corbera de Llobregat;1;1;A;;659;151;281;374;285;1;3;370;373
8;Barcelona;11;Baix Llobregat;08072;Corbera de Llobregat;1;1;B;;630;153;287;359;271;1;1;357;358
8;Barcelona;11;Baix Llobregat;08072;Corbera de Llobregat;1;1;C;;676;130;263;357;319;0;6;351;357
8;Barcelona;11;Baix Llobregat;08072;Corbera de Llobregat;1;1;D;;671;144;277;373;298;0;3;370;373
8;Barcelona;11;Baix Llobregat;08072;Corbera de Llobregat;1;2;A;;491;97;205;305;186;1;3;301;304
8;Barcelona;11;Baix Llobregat;08072;Corbera de Llobregat;1;2;B;;514;96;200;288;226;0;3;285;288
8;Barcelona;11;Baix Llobregat;08072;Corbera de Llobregat;1;2;C;;455;87;199;273;182;0;2;271;273
8;Barcelona;11;Baix Llobregat;08072;Corbera de Llobregat;1;3;A;;481;98;225;304;177;0;3;301;304
8;Barcelona;11;Baix Llobregat;08072;Corbera de Llobregat;1;3;B;;529;117;224;322;207;0;5;317;322
8;Barcelona;11;Baix Llobregat;08072;Corbera de Llobregat;1;4;A;;558;115;254;293;265;3;4;286;290
8;Barcelona;11;Baix Llobregat;08072;Corbera de Llobregat;1;4;B;;691;142;200;352;339;0;3;349;352
8;Barcelona;11;Baix Llobregat;08072;Corbera de Llobregat;1;4;C;;634;112;266;326;308;0;3;323;326
25;Lleida;33;Segrià;25078;Corbins;1;1;U;;888;194;480;627;261;0;4;623;627
17;Girona;10;Baix Empordà;17057;Corçà;1;1;U;;978;277;507;653;325;7;6;640;646
8;Barcelona;11;Baix Llobregat;08073;Cornellà de Llobregat;1;1;A;;677;178;343;436;241;2;5;429;434
8;Barcelona;11;Baix Llobregat;08073;Cornellà de Llobregat;1;1;B;;811;219;403;498;313;2;7;489;496
8;Barcelona;11;Baix Llobregat;08073;Cornellà de Llobregat;1;10;A;;590;122;276;379;211;3;1;375;376
8;Barcelona;11;Baix Llobregat;08073;Cornellà de Llobregat;1;10;B;;691;124;318;440;251;3;2;435;437
8;Barcelona;11;Baix Llobregat;08073;Cornellà de Llobregat;1;11;A;;454;82;187;249;205;0;3;246;249
8;Barcelona;11;Baix Llobregat;08073;Cornellà de Llobregat;1;11;B;;501;103;187;272;229;0;3;269;272
8;Barcelona;11;Baix Llobregat;08073;Cornellà de Llobregat;1;12;U;;784;170;318;428;356;0;1;427;428
8;Barcelona;11;Baix Llobregat;08073;Cornellà de Llobregat;1;13;A;;581;106;210;296;285;3;0;293;293
8;Barcelona;11;Baix Llobregat;08073;Cornellà de Llobregat;1;13;B;;593;121;225;332;261;1;3;328;331
8;Barcelona;11;Baix Llobregat;08073;Cornellà de Llobregat;1;14;U;;943;217;447;576;367;1;4;571;575
8;Barcelona;11;Baix Llobregat;08073;Cornellà de Llobregat;1;2;A;;733;191;361;496;237;1;7;488;495
8;Barcelona;11;Baix Llobregat;08073;Cornellà de Llobregat;1;2;B;;812;200;373;512;300;2;3;507;510
8;Barcelona;11;Baix Llobregat;08073;Cornellà de Llobregat;1;3;A;;572;138;245;317;255;0;3;314;317
8;Barcelona;11;Baix Llobregat;08073;Cornellà de Llobregat;1;3;B;;660;163;295;379;281;0;5;374;379
8;Barcelona;11;Baix Llobregat;08073;Cornellà de Llobregat;1;4;A;;647;145;259;362;285;3;6;353;359
8;Barcelona;11;Baix Llobregat;08073;Cornellà de Llobregat;1;4;B;;723;139;301;412;311;0;5;407;412
8;Barcelona;11;Baix Llobregat;08073;Cornellà de Llobregat;1;5;U;;974;162;369;501;473;1;2;498;500
8;Barcelona;11;Baix Llobregat;08073;Cornellà de Llobregat;1;6;U;;520;131;237;272;248;2;3;267;270
8;Barcelona;11;Baix Llobregat;08073;Cornellà de Llobregat;1;7;A;;599;157;283;380;219;0;5;375;380
8;Barcelona;11;Baix Llobregat;08073;Cornellà de Llobregat;1;7;B;;690;173;343;454;236;0;0;454;454
8;Barcelona;11;Baix Llobregat;08073;Cornellà de Llobregat;1;8;A;;588;125;238;319;269;0;4;315;319
8;Barcelona;11;Baix Llobregat;08073;Cornellà de Llobregat;1;8;B;;610;119;224;323;287;3;1;319;320
8;Barcelona;11;Baix Llobregat;08073;Cornellà de Llobregat;1;9;A;;465;119;216;278;187;3;4;271;275
8;Barcelona;11;Baix Llobregat;08073;Cornellà de Llobregat;1;9;B;;461;130;232;291;170;0;5;286;291
8;Barcelona;11;Baix Llobregat;08073;Cornellà de Llobregat;2;1;A;;695;150;299;388;307;1;2;385;387
8;Barcelona;11;Baix Llobregat;08073;Cornellà de Llobregat;2;1;B;;749;165;312;434;315;1;4;429;433
8;Barcelona;11;Baix Llobregat;08073;Cornellà de Llobregat;2;2;A;;742;157;321;443;299;0;4;439;443
8;Barcelona;11;Baix Llobregat;08073;Cornellà de Llobregat;2;2;B;;823;152;342;456;367;0;5;451;456
8;Barcelona;11;Baix Llobregat;08073;Cornellà de Llobregat;3;1;A;;465;110;207;274;191;1;5;268;273
8;Barcelona;11;Baix Llobregat;08073;Cornellà de Llobregat;3;1;B;;541;125;242;323;218;0;2;321;323
8;Barcelona;11;Baix Llobregat;08073;Cornellà de Llobregat;3;2;A;;450;112;192;247;203;2;4;241;245
8;Barcelona;11;Baix Llobregat;08073;Cornellà de Llobregat;3;2;B;;460;101;209;262;198;2;3;257;260
8;Barcelona;11;Baix Llobregat;08073;Cornellà de Llobregat;3;3;U;;749;156;319;432;317;0;0;432;432
8;Barcelona;11;Baix Llobregat;08073;Cornellà de Llobregat;3;4;A;;595;141;263;364;231;2;5;357;362
8;Barcelona;11;Baix Llobregat;08073;Cornellà de Llobregat;3;4;B;;625;133;267;361;264;0;1;360;361
8;Barcelona;11;Baix Llobregat;08073;Cornellà de Llobregat;3;5;U;;868;166;351;469;399;0;2;467;469
8;Barcelona;11;Baix Llobregat;08073;Cornellà de Llobregat;3;6;U;;643;173;308;403;240;1;3;399;402
8;Barcelona;11;Baix Llobregat;08073;Cornellà de Llobregat;3;7;A;;420;107;195;250;170;5;0;245;245
8;Barcelona;11;Baix Llobregat;08073;Cornellà de Llobregat;3;7;B;;461;106;183;250;211;0;4;246;250
8;Barcelona;11;Baix Llobregat;08073;Cornellà de Llobregat;3;8;U;;738;135;259;322;416;1;5;316;321
8;Barcelona;11;Baix Llobregat;08073;Cornellà de Llobregat;3;9;A;;470;59;160;211;259;0;2;209;211
8;Barcelona;11;Baix Llobregat;08073;Cornellà de Llobregat;3;9;B;;517;71;174;225;292;0;1;224;225
8;Barcelona;11;Baix Llobregat;08073;Cornellà de Llobregat;4;1;A;;600;111;260;356;244;0;5;351;356
8;Barcelona;11;Baix Llobregat;08073;Cornellà de Llobregat;4;1;B;;685;126;280;427;258;0;6;421;427
8;Barcelona;11;Baix Llobregat;08073;Cornellà de Llobregat;4;10;A;;461;112;197;289;172;0;2;287;289
8;Barcelona;11;Baix Llobregat;08073;Cornellà de Llobregat;4;10;B;;519;116;228;300;219;1;0;299;299
8;Barcelona;11;Baix Llobregat;08073;Cornellà de Llobregat;4;11;A;;450;97;185;253;197;0;1;252;253
8;Barcelona;11;Baix Llobregat;08073;Cornellà de Llobregat;4;11;B;;478;108;195;276;202;1;5;270;275
8;Barcelona;11;Baix Llobregat;08073;Cornellà de Llobregat;4;12;A;;583;176;271;342;241;0;2;340;342
8;Barcelona;11;Baix Llobregat;08073;Cornellà de Llobregat;4;12;B;;626;183;306;372;254;1;1;370;371
8;Barcelona;11;Baix Llobregat;08073;Cornellà de Llobregat;4;13;A;;666;150;290;403;263;2;2;399;401
8;Barcelona;11;Baix Llobregat;08073;Cornellà de Llobregat;4;13;B;;724;180;306;421;303;3;3;415;418
8;Barcelona;11;Baix Llobregat;08073;Cornellà de Llobregat;4;14;A;;487;85;220;295;192;0;4;291;295
8;Barcelona;11;Baix Llobregat;08073;Cornellà de Llobregat;4;14;B;;559;90;228;329;230;0;2;327;329
8;Barcelona;11;Baix Llobregat;08073;Cornellà de Llobregat;4;15;A;;432;100;191;252;180;1;2;249;251
8;Barcelona;11;Baix Llobregat;08073;Cornellà de Llobregat;4;15;B;;539;100;220;310;229;0;1;309;310
8;Barcelona;11;Baix Llobregat;08073;Cornellà de Llobregat;4;16;A;;561;123;234;299;262;0;0;299;299
8;Barcelona;11;Baix Llobregat;08073;Cornellà de Llobregat;4;16;B;;629;147;268;359;270;1;1;357;358
8;Barcelona;11;Baix Llobregat;08073;Cornellà de Llobregat;4;17;A;;604;119;257;384;220;0;5;379;384
8;Barcelona;11;Baix Llobregat;08073;Cornellà de Llobregat;4;17;B;;638;141;295;386;252;2;4;380;384
8;Barcelona;11;Baix Llobregat;08073;Cornellà de Llobregat;4;18;U;;781;180;356;452;329;0;1;451;452
8;Barcelona;11;Baix Llobregat;08073;Cornellà de Llobregat;4;19;U;;779;193;321;447;332;0;3;444;447
8;Barcelona;11;Baix Llobregat;08073;Cornellà de Llobregat;4;2;U;;687;133;299;384;303;0;2;382;384
8;Barcelona;11;Baix Llobregat;08073;Cornellà de Llobregat;4;3;A;;643;128;266;399;244;1;3;395;398
8;Barcelona;11;Baix Llobregat;08073;Cornellà de Llobregat;4;3;B;;765;153;310;454;311;0;3;451;454
8;Barcelona;11;Baix Llobregat;08073;Cornellà de Llobregat;4;4;A;;458;123;209;283;175;0;3;280;283
8;Barcelona;11;Baix Llobregat;08073;Cornellà de Llobregat;4;4;B;;477;131;222;289;188;2;1;286;287
8;Barcelona;11;Baix Llobregat;08073;Cornellà de Llobregat;4;5;A;;397;97;229;243;154;0;2;241;243
8;Barcelona;11;Baix Llobregat;08073;Cornellà de Llobregat;4;5;B;;494;93;172;316;178;0;1;315;316
8;Barcelona;11;Baix Llobregat;08073;Cornellà de Llobregat;4;6;A;;678;140;272;396;282;0;5;391;396
8;Barcelona;11;Baix Llobregat;08073;Cornellà de Llobregat;4;6;B;;724;150;317;412;312;1;4;407;411
8;Barcelona;11;Baix Llobregat;08073;Cornellà de Llobregat;4;7;A;;460;118;200;283;177;1;1;281;282
8;Barcelona;11;Baix Llobregat;08073;Cornellà de Llobregat;4;7;B;;540;112;215;298;242;0;2;296;298
8;Barcelona;11;Baix Llobregat;08073;Cornellà de Llobregat;4;8;A;;616;151;250;342;274;0;5;337;342
8;Barcelona;11;Baix Llobregat;08073;Cornellà de Llobregat;4;8;B;;683;142;258;385;298;5;6;374;380
8;Barcelona;11;Baix Llobregat;08073;Cornellà de Llobregat;4;9;U;;886;182;363;495;391;4;6;485;491
8;Barcelona;11;Baix Llobregat;08073;Cornellà de Llobregat;5;1;U;;686;164;296;402;284;1;3;398;401
8;Barcelona;11;Baix Llobregat;08073;Cornellà de Llobregat;5;10;A;;550;136;235;316;234;1;7;308;315
8;Barcelona;11;Baix Llobregat;08073;Cornellà de Llobregat;5;10;B;;548;133;245;329;219;0;1;328;329
8;Barcelona;11;Baix Llobregat;08073;Cornellà de Llobregat;5;2;U;;721;150;269;359;362;0;0;359;359
8;Barcelona;11;Baix Llobregat;08073;Cornellà de Llobregat;5;3;A;;475;125;207;259;216;1;0;258;258
8;Barcelona;11;Baix Llobregat;08073;Cornellà de Llobregat;5;3;B;;477;120;199;269;208;1;0;268;268
8;Barcelona;11;Baix Llobregat;08073;Cornellà de Llobregat;5;4;U;;717;164;295;381;336;1;4;376;380
8;Barcelona;11;Baix Llobregat;08073;Cornellà de Llobregat;5;5;U;;808;165;306;407;401;4;2;401;403
8;Barcelona;11;Baix Llobregat;08073;Cornellà de Llobregat;5;6;A;;447;108;185;269;178;2;0;267;267
8;Barcelona;11;Baix Llobregat;08073;Cornellà de Llobregat;5;6;B;;511;124;216;294;217;0;3;291;294
8;Barcelona;11;Baix Llobregat;08073;Cornellà de Llobregat;5;7;A;;472;121;186;266;206;1;3;262;265
8;Barcelona;11;Baix Llobregat;08073;Cornellà de Llobregat;5;7;B;;560;142;229;297;263;0;1;296;297
8;Barcelona;11;Baix Llobregat;08073;Cornellà de Llobregat;5;8;A;;445;110;197;247;198;0;2;245;247
8;Barcelona;11;Baix Llobregat;08073;Cornellà de Llobregat;5;8;B;;424;115;195;241;183;1;2;238;240
8;Barcelona;11;Baix Llobregat;08073;Cornellà de Llobregat;5;9;U;;857;184;416;572;285;1;6;565;571
8;Barcelona;11;Baix Llobregat;08073;Cornellà de Llobregat;6;1;U;;563;114;206;295;268;0;3;292;295
8;Barcelona;11;Baix Llobregat;08073;Cornellà de Llobregat;6;10;U;;770;185;330;451;319;0;1;450;451
8;Barcelona;11;Baix Llobregat;08073;Cornellà de Llobregat;6;11;U;;508;128;218;280;228;2;1;277;278
8;Barcelona;11;Baix Llobregat;08073;Cornellà de Llobregat;6;12;U;;757;129;261;404;353;0;3;401;404
8;Barcelona;11;Baix Llobregat;08073;Cornellà de Llobregat;6;13;U;;677;158;277;361;316;0;2;359;361
8;Barcelona;11;Baix Llobregat;08073;Cornellà de Llobregat;6;14;U;;842;159;342;485;357;1;5;479;484
8;Barcelona;11;Baix Llobregat;08073;Cornellà de Llobregat;6;15;U;;815;146;343;523;292;0;6;517;523
8;Barcelona;11;Baix Llobregat;08073;Cornellà de Llobregat;6;16;U;;633;137;247;329;304;0;3;326;329
8;Barcelona;11;Baix Llobregat;08073;Cornellà de Llobregat;6;2;A;;431;102;188;260;171;1;2;257;259
8;Barcelona;11;Baix Llobregat;08073;Cornellà de Llobregat;6;2;B;;497;116;217;303;194;0;3;300;303
8;Barcelona;11;Baix Llobregat;08073;Cornellà de Llobregat;6;3;U;;534;122;220;291;243;1;2;288;290
8;Barcelona;11;Baix Llobregat;08073;Cornellà de Llobregat;6;4;U;;594;134;248;317;277;1;0;316;316
8;Barcelona;11;Baix Llobregat;08073;Cornellà de Llobregat;6;5;U;;702;140;310;396;306;2;6;388;394
8;Barcelona;11;Baix Llobregat;08073;Cornellà de Llobregat;6;6;U;;559;129;250;310;249;0;4;306;310
8;Barcelona;11;Baix Llobregat;08073;Cornellà de Llobregat;6;7;A;;466;71;171;260;206;0;4;256;260
8;Barcelona;11;Baix Llobregat;08073;Cornellà de Llobregat;6;7;B;;489;87;221;290;199;0;3;287;290
8;Barcelona;11;Baix Llobregat;08073;Cornellà de Llobregat;6;8;U;;594;125;246;347;247;1;5;341;346
8;Barcelona;11;Baix Llobregat;08073;Cornellà de Llobregat;6;9;A;;563;130;266;347;216;0;2;345;347
8;Barcelona;11;Baix Llobregat;08073;Cornellà de Llobregat;6;9;B;;709;149;322;427;282;0;1;426;427
8;Barcelona;11;Baix Llobregat;08073;Cornellà de Llobregat;6;9;C;;642;140;305;415;227;2;5;408;413
17;Girona;28;Pla de l'Estany;17056;Cornellà del Terri;1;1;A;;750;193;399;529;221;2;5;522;527
17;Girona;28;Pla de l'Estany;17056;Cornellà del Terri;1;1;B;;793;194;421;538;255;0;9;529;538
43;Tarragona;29;Priorat;43049;Cornudella de Montsant;1;1;U;;734;230;467;561;173;1;9;551;560
43;Tarragona;36;Tarragonès;43050;Creixell;1;1;A;;651;203;315;378;273;1;3;374;377
43;Tarragona;36;Tarragonès;43050;Creixell;1;1;B;;757;271;385;441;316;3;3;435;438
17;Girona;28;Pla de l'Estany;17058;Crespià;1;1;U;;179;51;99;112;67;0;0;112;112
17;Girona;10;Baix Empordà;17901;Cruïlles, Monells i Sant Sadurní;1;1;A;;462;109;252;304;158;1;6;297;303
17;Girona;10;Baix Empordà;17901;Cruïlles, Monells i Sant Sadurní;1;1;B;;211;60;114;143;68;1;1;141;142
17;Girona;10;Baix Empordà;17901;Cruïlles, Monells i Sant Sadurní;1;1;C;;200;60;124;148;52;0;1;147;148
8;Barcelona;17;Garraf;08074;Cubelles;1;1;U;;643;158;310;377;266;0;3;374;377
8;Barcelona;17;Garraf;08074;Cubelles;1;2;A;;516;142;253;329;187;2;3;324;327
8;Barcelona;17;Garraf;08074;Cubelles;1;2;B;;499;141;239;301;198;0;4;297;301
8;Barcelona;17;Garraf;08074;Cubelles;1;3;A;;481;127;216;258;223;1;0;257;257
8;Barcelona;17;Garraf;08074;Cubelles;1;3;B;;481;130;217;270;211;2;2;266;268
8;Barcelona;17;Garraf;08074;Cubelles;1;4;U;;751;164;257;358;393;0;2;356;358
8;Barcelona;17;Garraf;08074;Cubelles;1;5;A;;719;174;302;364;355;0;0;364;364
8;Barcelona;17;Garraf;08074;Cubelles;1;5;B;;820;206;351;436;384;0;4;432;436
25;Lleida;23;Noguera;25079;Cubells;1;1;U;;321;79;201;249;72;1;1;247;248
43;Tarragona;12;Baix Penedès;43051;Cunit;1;1;A;;435;102;179;245;190;2;1;242;243
43;Tarragona;12;Baix Penedès;43051;Cunit;1;1;B;;458;111;198;262;196;6;2;254;256
43;Tarragona;12;Baix Penedès;43051;Cunit;1;2;A;;656;165;278;342;314;3;1;338;339
43;Tarragona;12;Baix Penedès;43051;Cunit;1;2;B;;661;169;282;356;305;0;1;355;356
43;Tarragona;12;Baix Penedès;43051;Cunit;1;2;C;;257;68;121;157;100;1;3;153;156
43;Tarragona;12;Baix Penedès;43051;Cunit;1;3;A;;624;184;285;355;269;3;5;347;352
43;Tarragona;12;Baix Penedès;43051;Cunit;1;3;B;;691;190;329;405;286;3;3;399;402
43;Tarragona;12;Baix Penedès;43051;Cunit;1;4;U;;709;157;270;353;356;1;3;349;352
17;Girona;2;Alt Empordà;17060;Darnius;1;1;U;;421;120;265;312;109;0;1;311;312
17;Girona;15;Cerdanya;17061;Das;1;1;U;;126;34;70;89;37;0;0;89;89
43;Tarragona;9;Baix Ebre;43901;Deltebre;1;1;A;;802;149;291;391;411;3;9;379;388
43;Tarragona;9;Baix Ebre;43901;Deltebre;1;1;B;;667;124;257;350;317;0;7;343;350
43;Tarragona;9;Baix Ebre;43901;Deltebre;1;2;A;;1064;245;440;550;514;2;3;545;548
43;Tarragona;9;Baix Ebre;43901;Deltebre;1;2;B;;811;165;315;412;399;0;6;406;412
43;Tarragona;9;Baix Ebre;43901;Deltebre;1;3;A;;600;126;230;309;291;0;2;307;309
43;Tarragona;9;Baix Ebre;43901;Deltebre;1;3;B;;478;105;195;240;238;0;3;237;240
43;Tarragona;9;Baix Ebre;43901;Deltebre;1;4;A;;832;164;301;386;446;0;3;383;386
43;Tarragona;9;Baix Ebre;43901;Deltebre;1;4;B;;516;104;202;255;261;0;2;253;255
43;Tarragona;9;Baix Ebre;43901;Deltebre;1;5;A;;648;127;236;309;339;0;2;307;309
43;Tarragona;9;Baix Ebre;43901;Deltebre;1;5;B;;577;91;201;292;285;1;0;291;291
43;Tarragona;9;Baix Ebre;43901;Deltebre;1;6;A;;862;156;360;459;403;0;2;457;459
43;Tarragona;9;Baix Ebre;43901;Deltebre;1;6;B;;696;108;265;342;354;2;1;339;340
8;Barcelona;21;Maresme;08075;Dosrius;1;1;A;;673;172;333;420;253;0;5;415;420
8;Barcelona;21;Maresme;08075;Dosrius;1;1;B;;670;162;317;397;273;0;2;395;397
8;Barcelona;21;Maresme;08075;Dosrius;1;1;C;;938;186;362;485;453;0;6;479;485
43;Tarragona;8;Baix Camp;43053;Duesaigües;1;1;U;;188;45;107;123;65;0;0;123;123
17;Girona;2;Alt Empordà;17062;Escala, l';1;1;U;;927;245;446;536;391;1;6;529;535
17;Girona;2;Alt Empordà;17062;Escala, l';1;2;A;;1008;331;424;521;487;1;1;519;520
17;Girona;2;Alt Empordà;17062;Escala, l';1;2;B;;952;190;385;477;475;0;6;471;477
17;Girona;2;Alt Empordà;17062;Escala, l';1;3;U;;1157;270;565;662;495;0;10;652;662
17;Girona;2;Alt Empordà;17062;Escala, l';1;4;U;;905;246;453;570;335;0;6;564;570
8;Barcelona;11;Baix Llobregat;08076;Esparreguera;1;1;A;;1114;219;510;646;468;0;3;643;646
8;Barcelona;11;Baix Llobregat;08076;Esparreguera;1;1;B;;1189;272;506;675;514;0;2;673;675
8;Barcelona;11;Baix Llobregat;08076;Esparreguera;1;2;A;;654;141;277;389;265;0;3;386;389
8;Barcelona;11;Baix Llobregat;08076;Esparreguera;1;2;B;;790;175;326;458;332;0;2;456;458
8;Barcelona;11;Baix Llobregat;08076;Esparreguera;1;3;A;;584;167;300;396;188;4;5;387;392
8;Barcelona;11;Baix Llobregat;08076;Esparreguera;1;3;B;;870;222;419;555;315;2;3;550;553
8;Barcelona;11;Baix Llobregat;08076;Esparreguera;1;4;A;;623;195;325;393;230;1;4;388;392
8;Barcelona;11;Baix Llobregat;08076;Esparreguera;1;4;B;;741;208;358;445;296;5;2;438;440
8;Barcelona;11;Baix Llobregat;08076;Esparreguera;1;5;U;;696;181;310;390;306;4;2;384;386
8;Barcelona;11;Baix Llobregat;08076;Esparreguera;2;1;A;;718;194;334;419;299;0;2;417;419
8;Barcelona;11;Baix Llobregat;08076;Esparreguera;2;1;B;;862;162;356;469;393;0;4;465;469
8;Barcelona;11;Baix Llobregat;08076;Esparreguera;2;2;A;;1134;259;461;595;539;2;3;590;593
8;Barcelona;11;Baix Llobregat;08076;Esparreguera;2;2;B;;1256;275;470;648;608;0;9;639;648
8;Barcelona;11;Baix Llobregat;08076;Esparreguera;2;3;U;;971;209;459;635;336;4;3;628;631
8;Barcelona;11;Baix Llobregat;08076;Esparreguera;2;4;U;;1137;243;508;679;458;3;6;670;676
17;Girona;24;Osona;17063;Espinelves;1;1;U;;169;57;105;123;46;0;0;123;123
25;Lleida;18;Garrigues;25081;Espluga Calba, l';1;1;U;;372;56;165;234;138;0;2;232;234
43;Tarragona;16;Conca de Barberà;43054;Espluga de Francolí, l';1;1;A;;663;110;277;454;209;2;4;448;452
43;Tarragona;16;Conca de Barberà;43054;Espluga de Francolí, l';1;1;B;;429;72;175;264;165;4;1;259;260
43;Tarragona;16;Conca de Barberà;43054;Espluga de Francolí, l';1;1;C;;775;148;333;498;277;3;4;491;495
43;Tarragona;16;Conca de Barberà;43054;Espluga de Francolí, l';2;1;A;;490;82;192;300;190;1;4;295;299
43;Tarragona;16;Conca de Barberà;43054;Espluga de Francolí, l';2;1;B;;676;150;288;415;261;0;1;414;415
8;Barcelona;11;Baix Llobregat;08077;Esplugues de Llobregat;1;1;U;;858;222;440;588;270;4;9;575;584
8;Barcelona;11;Baix Llobregat;08077;Esplugues de Llobregat;1;2;A;;543;120;255;346;197;0;6;340;346
8;Barcelona;11;Baix Llobregat;08077;Esplugues de Llobregat;1;2;B;;607;150;303;392;215;0;5;387;392
8;Barcelona;11;Baix Llobregat;08077;Esplugues de Llobregat;1;3;A;;586;133;288;375;211;2;4;369;373
8;Barcelona;11;Baix Llobregat;08077;Esplugues de Llobregat;1;3;B;;595;140;279;382;213;3;1;378;379
8;Barcelona;11;Baix Llobregat;08077;Esplugues de Llobregat;1;4;A;;561;118;281;350;211;1;2;347;349
8;Barcelona;11;Baix Llobregat;08077;Esplugues de Llobregat;1;4;B;;611;142;280;346;265;1;7;338;345
8;Barcelona;11;Baix Llobregat;08077;Esplugues de Llobregat;1;5;A;;658;145;309;397;261;0;6;391;397
8;Barcelona;11;Baix Llobregat;08077;Esplugues de Llobregat;1;5;B;;734;162;341;451;283;0;3;448;451
8;Barcelona;11;Baix Llobregat;08077;Esplugues de Llobregat;10;1;A;;582;127;253;346;236;0;4;342;346
8;Barcelona;11;Baix Llobregat;08077;Esplugues de Llobregat;10;1;B;;730;183;333;449;281;1;0;448;448
8;Barcelona;11;Baix Llobregat;08077;Esplugues de Llobregat;10;1;C;;809;190;364;492;317;4;5;483;488
8;Barcelona;11;Baix Llobregat;08077;Esplugues de Llobregat;10;2;A;;658;117;275;388;270;0;2;386;388
8;Barcelona;11;Baix Llobregat;08077;Esplugues de Llobregat;10;2;B;;799;169;342;487;312;2;5;480;485
8;Barcelona;11;Baix Llobregat;08077;Esplugues de Llobregat;10;3;A;;673;145;293;402;271;1;4;397;401
8;Barcelona;11;Baix Llobregat;08077;Esplugues de Llobregat;10;3;B;;738;145;297;411;327;1;5;405;410
8;Barcelona;11;Baix Llobregat;08077;Esplugues de Llobregat;10;3;C;;668;141;297;391;277;0;2;389;391
8;Barcelona;11;Baix Llobregat;08077;Esplugues de Llobregat;10;4;A;;483;118;207;257;226;0;2;255;257
8;Barcelona;11;Baix Llobregat;08077;Esplugues de Llobregat;10;4;B;;657;149;286;355;302;0;2;353;355
8;Barcelona;11;Baix Llobregat;08077;Esplugues de Llobregat;10;5;A;;538;131;221;276;262;0;5;271;276
8;Barcelona;11;Baix Llobregat;08077;Esplugues de Llobregat;10;5;B;;558;147;227;295;263;0;3;292;295
8;Barcelona;11;Baix Llobregat;08077;Esplugues de Llobregat;10;6;A;;751;183;335;454;297;1;6;447;453
8;Barcelona;11;Baix Llobregat;08077;Esplugues de Llobregat;10;6;B;;855;200;381;495;360;0;3;492;495
8;Barcelona;11;Baix Llobregat;08077;Esplugues de Llobregat;10;7;A;;662;146;279;394;268;0;4;390;394
8;Barcelona;11;Baix Llobregat;08077;Esplugues de Llobregat;10;7;B;;743;183;328;459;284;0;1;458;459
8;Barcelona;11;Baix Llobregat;08077;Esplugues de Llobregat;10;8;A;;812;172;328;439;373;2;4;433;437
8;Barcelona;11;Baix Llobregat;08077;Esplugues de Llobregat;10;8;B;;981;205;404;551;430;0;6;545;551
8;Barcelona;11;Baix Llobregat;08077;Esplugues de Llobregat;2;1;A;;628;128;260;371;257;1;4;366;370
8;Barcelona;11;Baix Llobregat;08077;Esplugues de Llobregat;2;1;B;;670;130;291;396;274;0;5;391;396
8;Barcelona;11;Baix Llobregat;08077;Esplugues de Llobregat;2;2;A;;549;111;219;306;243;0;5;301;306
8;Barcelona;11;Baix Llobregat;08077;Esplugues de Llobregat;2;2;B;;640;104;248;341;299;0;7;334;341
8;Barcelona;11;Baix Llobregat;08077;Esplugues de Llobregat;2;3;A;;752;142;297;445;307;2;10;433;443
8;Barcelona;11;Baix Llobregat;08077;Esplugues de Llobregat;2;3;B;;918;130;296;485;433;1;3;481;484
8;Barcelona;11;Baix Llobregat;08077;Esplugues de Llobregat;2;4;A;;584;126;250;362;222;0;6;356;362
8;Barcelona;11;Baix Llobregat;08077;Esplugues de Llobregat;2;4;B;;688;120;262;384;304;0;6;378;384
8;Barcelona;11;Baix Llobregat;08077;Esplugues de Llobregat;2;5;A;;736;148;317;443;293;3;4;436;440
8;Barcelona;11;Baix Llobregat;08077;Esplugues de Llobregat;2;5;B;;808;157;330;448;360;2;3;443;446
8;Barcelona;11;Baix Llobregat;08077;Esplugues de Llobregat;2;6;U;;1037;236;530;648;389;1;4;643;647
8;Barcelona;11;Baix Llobregat;08077;Esplugues de Llobregat;3;1;A;;534;112;333;324;210;1;3;320;323
8;Barcelona;11;Baix Llobregat;08077;Esplugues de Llobregat;3;1;B;;628;137;279;395;233;3;4;388;392
8;Barcelona;11;Baix Llobregat;08077;Esplugues de Llobregat;3;2;A;;961;186;406;539;422;0;5;534;539
8;Barcelona;11;Baix Llobregat;08077;Esplugues de Llobregat;3;2;B;;1011;211;434;593;418;3;5;585;590
8;Barcelona;11;Baix Llobregat;08077;Esplugues de Llobregat;4;1;U;;712;119;332;461;251;0;5;456;461
8;Barcelona;11;Baix Llobregat;08077;Esplugues de Llobregat;5;1;U;;478;89;196;297;181;0;10;287;297
8;Barcelona;11;Baix Llobregat;08077;Esplugues de Llobregat;6;1;U;;558;129;252;317;241;1;4;312;316
8;Barcelona;11;Baix Llobregat;08077;Esplugues de Llobregat;7;1;U;;922;172;432;611;311;0;12;599;611
8;Barcelona;11;Baix Llobregat;08077;Esplugues de Llobregat;8;1;A;;741;158;332;464;277;0;5;459;464
8;Barcelona;11;Baix Llobregat;08077;Esplugues de Llobregat;8;1;B;;937;204;430;591;346;3;6;582;588
8;Barcelona;11;Baix Llobregat;08077;Esplugues de Llobregat;8;2;A;;900;165;407;530;370;1;7;522;529
8;Barcelona;11;Baix Llobregat;08077;Esplugues de Llobregat;8;2;B;;996;240;490;613;383;0;5;608;613
8;Barcelona;11;Baix Llobregat;08077;Esplugues de Llobregat;9;1;A;;661;121;302;400;261;1;5;394;399
8;Barcelona;11;Baix Llobregat;08077;Esplugues de Llobregat;9;1;B;;735;131;300;400;335;0;3;397;400
8;Barcelona;11;Baix Llobregat;08077;Esplugues de Llobregat;9;2;A;;708;117;300;434;274;0;6;428;434
8;Barcelona;11;Baix Llobregat;08077;Esplugues de Llobregat;9;2;B;;797;123;339;498;299;1;2;495;497
17;Girona;2;Alt Empordà;17064;Espolla;1;1;U;;316;100;237;280;36;0;0;280;280
17;Girona;28;Pla de l'Estany;17065;Esponellà;1;1;U;;340;91;191;220;120;0;4;216;220
25;Lleida;26;Pallars Sobirà;25082;Espot;1;1;U;;271;71;150;170;101;0;2;168;170
8;Barcelona;14;Berguedà;08078;Espunyola, l';1;1;U;;269;54;103;133;136;0;0;133;133
8;Barcelona;24;Osona;08254;Esquirol, l';1;1;A;;1287;348;666;943;344;1;12;930;942
8;Barcelona;24;Osona;08254;Esquirol, l';1;1;B;;196;73;84;148;48;1;0;147;147
8;Barcelona;24;Osona;08254;Esquirol, l';1;1;C;;263;102;140;204;59;0;3;201;204
25;Lleida;4;Alt Urgell;25088;Estamariu;1;1;U;;112;13;70;86;26;0;1;85;86
8;Barcelona;;;08079;Estany, l';1;1;U;;355;141;258;291;64;1;3;287;290
25;Lleida;32;Segarra;25085;Estaràs;1;1;U;;163;47;82;105;58;0;1;104;105
25;Lleida;26;Pallars Sobirà;25086;Esterri d'Àneu;1;1;U;;568;155;287;388;180;2;3;383;386
25;Lleida;26;Pallars Sobirà;25087;Esterri de Cardós;1;1;U;;63;9;36;42;21;0;0;42;42
43;Tarragona;29;Priorat;43055;Falset;1;1;A;;444;111;246;329;115;1;5;323;328
43;Tarragona;29;Priorat;43055;Falset;1;1;B;;589;128;300;398;191;0;3;395;398
43;Tarragona;29;Priorat;43055;Falset;2;1;A;;465;103;247;345;120;1;2;342;344
43;Tarragona;29;Priorat;43055;Falset;2;1;B;;540;118;281;400;140;1;1;398;399
17;Girona;2;Alt Empordà;17005;Far d'Empordà, el;1;1;U;;321;78;198;218;103;3;1;214;215
25;Lleida;26;Pallars Sobirà;25089;Farrera;1;1;U;;66;11;31;54;12;0;0;54;54
43;Tarragona;37;Terra Alta;43056;Fatarella, la;1;1;U;;554;68;205;301;253;1;2;298;300
43;Tarragona;37;Terra Alta;43056;Fatarella, la;1;2;U;;541;77;179;274;267;0;5;269;274
43;Tarragona;8;Baix Camp;43057;Febró, la;1;1;U;;53;9;18;29;24;0;1;28;29
8;Barcelona;41;Vallès Oriental;08134;Figaró-Montmany;1;1;U;;628;174;318;407;221;0;1;406;407
8;Barcelona;14;Berguedà;08080;Fígols;1;1;U;;51;19;31;36;15;0;1;35;36
25;Lleida;4;Alt Urgell;25908;Fígols i Alinyà;1;1;U;;274;78;148;198;76;0;0;198;198
43;Tarragona;29;Priorat;43058;Figuera, la;1;1;U;;109;27;71;89;20;0;0;89;89
17;Girona;2;Alt Empordà;17066;Figueres;1;1;U;;891;204;347;470;421;2;4;464;468
17;Girona;2;Alt Empordà;17066;Figueres;1;2;A;;518;158;258;327;191;0;2;325;327
17;Girona;2;Alt Empordà;17066;Figueres;1;2;B;;557;165;267;344;213;0;5;339;344
17;Girona;2;Alt Empordà;17066;Figueres;1;3;A;;745;172;294;391;354;2;4;385;389
17;Girona;2;Alt Empordà;17066;Figueres;1;3;B;;664;169;300;378;286;0;3;375;378
17;Girona;2;Alt Empordà;17066;Figueres;1;4;U;;957;269;470;549;408;1;2;546;548
17;Girona;2;Alt Empordà;17066;Figueres;1;5;A;;612;120;201;252;360;0;0;252;252
17;Girona;2;Alt Empordà;17066;Figueres;1;5;B;;540;141;214;244;296;0;0;244;244
17;Girona;2;Alt Empordà;17066;Figueres;1;6;A;;881;225;354;432;449;3;2;427;429
17;Girona;2;Alt Empordà;17066;Figueres;1;6;B;;860;210;344;435;425;0;4;431;435
17;Girona;2;Alt Empordà;17066;Figueres;1;7;U;;1029;234;391;510;519;1;9;500;509
17;Girona;2;Alt Empordà;17066;Figueres;1;8;U;;800;188;320;402;398;1;8;393;401
17;Girona;2;Alt Empordà;17066;Figueres;2;1;U;;500;103;230;295;205;1;6;288;294
17;Girona;2;Alt Empordà;17066;Figueres;2;2;U;;904;243;381;492;412;3;6;483;489
17;Girona;2;Alt Empordà;17066;Figueres;2;3;U;;543;136;247;295;248;1;2;292;294
17;Girona;2;Alt Empordà;17066;Figueres;2;4;A;;775;180;333;419;356;0;4;415;419
17;Girona;2;Alt Empordà;17066;Figueres;2;4;B;;759;176;315;405;354;0;2;403;405
17;Girona;2;Alt Empordà;17066;Figueres;2;5;U;;649;277;286;345;304;1;8;336;344
17;Girona;2;Alt Empordà;17066;Figueres;3;1;U;;662;210;308;374;288;2;1;371;372
17;Girona;2;Alt Empordà;17066;Figueres;3;2;A;;708;215;342;400;308;3;6;391;397
17;Girona;2;Alt Empordà;17066;Figueres;3;2;B;;317;85;164;196;121;1;3;192;195
17;Girona;2;Alt Empordà;17066;Figueres;3;3;U;;971;255;420;556;415;3;6;547;553
17;Girona;2;Alt Empordà;17066;Figueres;3;4;A;;739;117;271;343;396;0;0;343;343
17;Girona;2;Alt Empordà;17066;Figueres;3;4;B;;637;107;210;280;357;1;2;277;279
17;Girona;2;Alt Empordà;17066;Figueres;3;5;A;;899;248;423;525;374;0;5;520;525
17;Girona;2;Alt Empordà;17066;Figueres;3;5;B;;783;173;371;444;339;1;4;439;443
17;Girona;2;Alt Empordà;17066;Figueres;4;1;A;;699;195;335;410;289;0;6;404;410
17;Girona;2;Alt Empordà;17066;Figueres;4;1;B;;578;151;270;335;243;0;3;332;335
17;Girona;2;Alt Empordà;17066;Figueres;4;2;A;;738;223;343;414;324;2;9;403;412
17;Girona;2;Alt Empordà;17066;Figueres;4;2;B;;691;193;311;396;295;0;4;392;396
17;Girona;2;Alt Empordà;17066;Figueres;4;3;A;;614;148;287;356;258;0;3;353;356
17;Girona;2;Alt Empordà;17066;Figueres;4;3;B;;580;169;299;340;240;2;4;334;338
17;Girona;2;Alt Empordà;17066;Figueres;4;4;A;;923;265;454;534;389;3;3;528;531
17;Girona;2;Alt Empordà;17066;Figueres;4;4;B;;845;232;404;508;337;2;2;504;506
17;Girona;2;Alt Empordà;17066;Figueres;4;5;A;;880;230;433;526;354;1;4;521;525
17;Girona;2;Alt Empordà;17066;Figueres;4;5;B;;855;238;368;454;401;0;10;444;454
17;Girona;2;Alt Empordà;17066;Figueres;4;7;U;;764;188;332;437;327;1;1;435;436
17;Girona;2;Alt Empordà;17066;Figueres;4;8;U;;685;126;247;356;329;0;9;347;356
43;Tarragona;1;Alt Camp;43059;Figuerola del Camp;1;1;U;;232;48;130;169;63;0;2;167;169
17;Girona;20;Gironès;17067;Flaçà;1;1;U;;727;253;432;540;187;1;1;538;539
43;Tarragona;30;Ribera d'Ebre;43060;Flix;1;1;A;;558;159;319;399;159;0;0;399;399
43;Tarragona;30;Ribera d'Ebre;43060;Flix;1;1;B;;611;162;310;407;204;2;1;404;405
43;Tarragona;30;Ribera d'Ebre;43060;Flix;1;2;A;;625;149;314;431;194;2;7;422;429
43;Tarragona;30;Ribera d'Ebre;43060;Flix;1;2;B;;692;183;351;486;206;5;7;474;481
43;Tarragona;30;Ribera d'Ebre;43060;Flix;2;1;A;;530;132;261;351;179;2;5;344;349
43;Tarragona;30;Ribera d'Ebre;43060;Flix;2;1;B;;552;120;259;355;197;1;3;351;354
25;Lleida;18;Garrigues;25092;Floresta, la;1;1;U;;157;52;94;114;43;1;0;113;113
8;Barcelona;34;Selva;08082;Fogars de la Selva;1;1;U;;594;147;247;329;265;0;0;329;329
8;Barcelona;41;Vallès Oriental;08081;Fogars de Montclús;1;1;U;;290;58;138;181;109;1;4;176;180
17;Girona;10;Baix Empordà;17068;Foixà;1;1;U;;264;95;165;188;76;0;0;188;188
8;Barcelona;24;Osona;08083;Folgueroles;1;1;A;;609;167;355;447;162;0;4;443;447
8;Barcelona;24;Osona;08083;Folgueroles;1;1;B;;687;175;402;515;172;0;7;508;515
25;Lleida;27;Pla d'Urgell;25093;Fondarella;1;1;U;;559;114;281;375;184;4;5;366;371
8;Barcelona;7;Bages;08084;Fonollosa;1;1;A;;318;76;157;229;89;0;4;225;229
8;Barcelona;7;Bages;08084;Fonollosa;1;1;B;;413;102;196;236;177;0;2;234;236
17;Girona;15;Cerdanya;17069;Fontanals de Cerdanya;1;1;U;;348;91;170;227;121;1;1;225;226
17;Girona;10;Baix Empordà;17070;Fontanilles;1;1;U;;146;58;105;121;25;0;3;118;121
17;Girona;28;Pla de l'Estany;17071;Fontcoberta;1;1;U;;907;234;512;632;275;0;4;628;632
8;Barcelona;3;Alt Penedès;08085;Font-rubí;1;1;U;;1001;245;535;731;270;5;3;723;726
25;Lleida;23;Noguera;25094;Foradada;1;1;U;;166;46;83;123;43;1;0;122;122
17;Girona;10;Baix Empordà;17902;Forallac;1;1;U;;791;263;438;543;248;1;1;541;542
17;Girona;10;Baix Empordà;17902;Forallac;1;2;A;;367;95;206;267;100;1;5;261;266
17;Girona;10;Baix Empordà;17902;Forallac;1;2;B;;244;63;142;175;69;0;2;173;175
43;Tarragona;16;Conca de Barberà;43061;Forès;1;1;U;;66;7;25;43;23;0;0;43;43
17;Girona;20;Gironès;17073;Fornells de la Selva;1;1;U;;1177;338;674;842;335;5;11;826;837
17;Girona;2;Alt Empordà;17074;Fortià;1;1;U;;449;118;245;289;160;3;3;283;286
8;Barcelona;41;Vallès Oriental;08086;Franqueses del Vallès, les;1;1;A;;1001;262;517;670;331;2;3;665;668
8;Barcelona;41;Vallès Oriental;08086;Franqueses del Vallès, les;1;1;B;;924;220;440;582;342;1;4;577;581
8;Barcelona;41;Vallès Oriental;08086;Franqueses del Vallès, les;1;2;A;;516;119;221;300;216;0;0;300;300
8;Barcelona;41;Vallès Oriental;08086;Franqueses del Vallès, les;1;2;B;;685;141;264;356;329;0;1;355;356
8;Barcelona;41;Vallès Oriental;08086;Franqueses del Vallès, les;1;2;C;;632;136;258;337;295;1;0;336;336
8;Barcelona;41;Vallès Oriental;08086;Franqueses del Vallès, les;1;3;A;;572;116;225;292;280;1;1;290;291
8;Barcelona;41;Vallès Oriental;08086;Franqueses del Vallès, les;1;3;B;;537;113;199;274;263;0;4;270;274
8;Barcelona;41;Vallès Oriental;08086;Franqueses del Vallès, les;1;3;C;;655;133;248;338;317;0;3;335;338
8;Barcelona;41;Vallès Oriental;08086;Franqueses del Vallès, les;1;4;A;;974;221;458;597;377;2;1;594;595
8;Barcelona;41;Vallès Oriental;08086;Franqueses del Vallès, les;1;4;B;;802;153;384;502;300;2;3;497;500
8;Barcelona;41;Vallès Oriental;08086;Franqueses del Vallès, les;1;5;A;;581;101;222;305;276;0;0;305;305
8;Barcelona;41;Vallès Oriental;08086;Franqueses del Vallès, les;1;5;B;;708;113;267;393;315;0;3;390;393
8;Barcelona;41;Vallès Oriental;08086;Franqueses del Vallès, les;2;1;A;;678;173;382;463;215;2;6;455;461
8;Barcelona;41;Vallès Oriental;08086;Franqueses del Vallès, les;2;1;B;;473;132;251;320;153;0;3;317;320
43;Tarragona;22;Montsià;43062;Freginals;1;1;U;;312;136;202;248;64;2;0;246;246
25;Lleida;38;Urgell;25096;Fuliola, la;1;1;U;;1051;253;572;727;324;5;4;718;722
25;Lleida;18;Garrigues;25097;Fulleda;1;1;U;;101;29;53;71;30;3;2;66;68
8;Barcelona;7;Bages;08090;Gaià;1;1;U;;139;44;77;102;37;0;4;98;102
43;Tarragona;22;Montsià;43063;Galera, la;1;1;U;;639;170;310;402;237;2;4;396;400
8;Barcelona;40;Vallès Occidental;08087;Gallifa;1;1;U;;129;41;69;88;41;0;0;88;88
43;Tarragona;37;Terra Alta;43064;Gandesa;1;1;A;;646;123;312;445;201;4;4;437;441
43;Tarragona;37;Terra Alta;43064;Gandesa;1;1;B;;662;128;337;457;205;5;5;447;452
43;Tarragona;37;Terra Alta;43064;Gandesa;2;1;U;;838;177;419;556;282;0;8;548;556
43;Tarragona;30;Ribera d'Ebre;43065;Garcia;1;1;U;;462;113;269;333;129;1;1;331;332
43;Tarragona;1;Alt Camp;43066;Garidells, els;1;1;U;;130;34;78;94;36;0;0;94;94
8;Barcelona;41;Vallès Oriental;08088;Garriga, la;1;1;A;;741;210;402;508;233;1;7;500;507
8;Barcelona;41;Vallès Oriental;08088;Garriga, la;1;1;B;;727;198;410;481;246;2;2;477;479
8;Barcelona;41;Vallès Oriental;08088;Garriga, la;1;2;A;;552;137;257;321;231;1;0;320;320
8;Barcelona;41;Vallès Oriental;08088;Garriga, la;1;2;B;;485;107;212;273;212;0;4;269;273
8;Barcelona;41;Vallès Oriental;08088;Garriga, la;1;3;A;;711;179;305;443;268;1;3;439;442
8;Barcelona;41;Vallès Oriental;08088;Garriga, la;1;3;B;;700;154;307;432;268;3;7;422;429
8;Barcelona;41;Vallès Oriental;08088;Garriga, la;2;1;A;;812;232;455;553;259;2;6;545;551
8;Barcelona;41;Vallès Oriental;08088;Garriga, la;2;1;B;;911;224;511;618;293;4;11;603;614
8;Barcelona;41;Vallès Oriental;08088;Garriga, la;2;2;A;;737;179;374;478;259;0;3;475;478
8;Barcelona;41;Vallès Oriental;08088;Garriga, la;2;2;B;;827;214;440;539;288;2;5;532;537
8;Barcelona;41;Vallès Oriental;08088;Garriga, la;2;3;A;;867;195;408;565;302;2;6;557;563
8;Barcelona;41;Vallès Oriental;08088;Garriga, la;2;3;B;;978;214;443;627;351;1;8;618;626
17;Girona;2;Alt Empordà;17075;Garrigàs;1;1;U;;273;98;170;197;76;0;1;196;197
17;Girona;10;Baix Empordà;17076;Garrigoles;1;1;U;;133;53;80;96;37;2;6;88;94
17;Girona;2;Alt Empordà;17077;Garriguella;1;1;U;;606;135;297;359;247;2;0;357;357
8;Barcelona;11;Baix Llobregat;08089;Gavà;1;1;A;;591;144;260;322;269;0;5;317;322
8;Barcelona;11;Baix Llobregat;08089;Gavà;1;1;B;;664;157;315;366;298;1;2;363;365
8;Barcelona;11;Baix Llobregat;08089;Gavà;1;2;A;;645;170;319;404;241;2;2;400;402
8;Barcelona;11;Baix Llobregat;08089;Gavà;1;2;B;;725;177;362;454;271;3;6;445;451
8;Barcelona;11;Baix Llobregat;08089;Gavà;1;3;A;;602;176;274;351;251;0;2;349;351
8;Barcelona;11;Baix Llobregat;08089;Gavà;1;3;B;;563;168;270;325;238;2;1;322;323
8;Barcelona;11;Baix Llobregat;08089;Gavà;1;3;C;;648;193;307;384;264;1;4;379;383
8;Barcelona;11;Baix Llobregat;08089;Gavà;1;4;A;;804;212;370;453;351;0;3;450;453
8;Barcelona;11;Baix Llobregat;08089;Gavà;1;4;B;;886;218;412;514;372;1;1;512;513
8;Barcelona;11;Baix Llobregat;08089;Gavà;1;5;U;;1008;205;435;543;465;0;1;542;543
8;Barcelona;11;Baix Llobregat;08089;Gavà;1;6;U;;639;132;235;304;335;2;0;302;302
8;Barcelona;11;Baix Llobregat;08089;Gavà;1;7;A;;948;201;415;563;385;0;2;561;563
8;Barcelona;11;Baix Llobregat;08089;Gavà;1;7;B;;1088;238;501;634;454;0;7;627;634
8;Barcelona;11;Baix Llobregat;08089;Gavà;2;1;A;;813;195;388;490;323;3;2;485;487
8;Barcelona;11;Baix Llobregat;08089;Gavà;2;1;B;;927;215;423;557;370;2;1;554;555
8;Barcelona;11;Baix Llobregat;08089;Gavà;2;2;U;;899;181;370;525;374;0;6;519;525
8;Barcelona;11;Baix Llobregat;08089;Gavà;2;3;A;;412;107;180;252;160;0;2;250;252
8;Barcelona;11;Baix Llobregat;08089;Gavà;2;3;B;;408;98;182;243;165;0;2;241;243
8;Barcelona;11;Baix Llobregat;08089;Gavà;2;4;A;;724;125;230;313;411;0;3;310;313
8;Barcelona;11;Baix Llobregat;08089;Gavà;2;4;B;;879;164;296;418;461;0;4;414;418
8;Barcelona;11;Baix Llobregat;08089;Gavà;2;5;U;;779;146;267;342;437;0;2;340;342
8;Barcelona;11;Baix Llobregat;08089;Gavà;2;6;A;;796;141;270;366;430;3;2;361;363
8;Barcelona;11;Baix Llobregat;08089;Gavà;2;6;B;;904;153;302;410;494;0;1;409;410
8;Barcelona;11;Baix Llobregat;08089;Gavà;2;7;U;;853;151;327;453;400;0;4;449;453
8;Barcelona;11;Baix Llobregat;08089;Gavà;2;8;A;;768;120;261;385;383;2;1;382;383
8;Barcelona;11;Baix Llobregat;08089;Gavà;2;8;B;;802;134;304;414;388;1;4;409;413
8;Barcelona;11;Baix Llobregat;08089;Gavà;2;9;A;;655;145;270;364;291;1;3;360;363
8;Barcelona;11;Baix Llobregat;08089;Gavà;2;9;B;;780;143;302;419;361;0;6;413;419
8;Barcelona;11;Baix Llobregat;08089;Gavà;3;1;A;;529;102;208;281;248;0;2;279;281
8;Barcelona;11;Baix Llobregat;08089;Gavà;3;1;B;;583;133;244;310;273;1;1;308;309
8;Barcelona;11;Baix Llobregat;08089;Gavà;3;2;U;;964;244;430;574;390;3;5;566;571
8;Barcelona;11;Baix Llobregat;08089;Gavà;3;3;A;;732;100;271;383;349;1;5;377;382
8;Barcelona;11;Baix Llobregat;08089;Gavà;3;3;B;;744;137;290;387;357;1;1;385;386
8;Barcelona;11;Baix Llobregat;08089;Gavà;3;4;A;;591;136;232;288;303;0;1;287;288
8;Barcelona;11;Baix Llobregat;08089;Gavà;3;4;B;;670;163;252;322;348;0;0;322;322
8;Barcelona;11;Baix Llobregat;08089;Gavà;3;5;A;;778;140;257;333;445;0;1;332;333
8;Barcelona;11;Baix Llobregat;08089;Gavà;3;5;B;;696;137;245;319;377;0;2;317;319
8;Barcelona;11;Baix Llobregat;08089;Gavà;3;6;U;;980;229;440;583;397;3;7;573;580
8;Barcelona;11;Baix Llobregat;08089;Gavà;3;7;U;;970;206;447;589;381;0;2;587;589
8;Barcelona;11;Baix Llobregat;08089;Gavà;4;1;A;;840;284;385;494;346;0;1;493;494
8;Barcelona;11;Baix Llobregat;08089;Gavà;4;1;B;;1049;264;453;614;435;0;4;610;614
8;Barcelona;11;Baix Llobregat;08089;Gavà;4;2;A;;662;154;267;358;304;0;1;357;358
8;Barcelona;11;Baix Llobregat;08089;Gavà;4;2;B;;843;193;383;486;357;3;4;479;483
25;Lleida;25;Pallars Jussà;25098;Gavet de la Conca;1;1;U;;293;33;94;155;138;0;1;154;155
8;Barcelona;3;Alt Penedès;08091;Gelida;1;1;A;;709;150;351;488;221;2;2;484;486
8;Barcelona;3;Alt Penedès;08091;Gelida;1;1;B;;704;130;304;424;280;1;2;421;423
8;Barcelona;3;Alt Penedès;08091;Gelida;1;1;C;;802;172;374;523;279;0;4;519;523
8;Barcelona;3;Alt Penedès;08091;Gelida;2;1;A;;698;160;349;465;233;2;2;461;463
8;Barcelona;3;Alt Penedès;08091;Gelida;2;1;B;;788;200;407;510;278;3;0;507;507
17;Girona;15;Cerdanya;17078;Ger;1;1;U;;300;92;175;216;84;3;0;213;213
25;Lleida;33;Segrià;25912;Gimenells i el Pla de la Font;1;1;A;;635;178;350;435;200;0;7;428;435
25;Lleida;33;Segrià;25912;Gimenells i el Pla de la Font;1;1;B;;328;48;177;202;126;1;2;199;201
43;Tarragona;30;Ribera d'Ebre;43067;Ginestar;1;1;U;;726;277;453;597;129;0;6;591;597
17;Girona;20;Gironès;17079;Girona;1;1;U;;559;170;267;303;256;2;2;299;301
17;Girona;20;Gironès;17079;Girona;1;2;U;;707;230;382;453;254;1;9;443;452
17;Girona;20;Gironès;17079;Girona;1;3;A;;416;146;241;293;123;0;2;291;293
17;Girona;20;Gironès;17079;Girona;1;3;B;;414;139;219;280;134;1;5;274;279
17;Girona;20;Gironès;17079;Girona;1;4;A;;403;113;196;235;168;0;6;229;235
17;Girona;20;Gironès;17079;Girona;1;4;B;;422;124;200;248;174;3;6;239;245
17;Girona;20;Gironès;17079;Girona;1;5;A;;910;140;267;355;555;0;0;355;355
17;Girona;20;Gironès;17079;Girona;1;5;B;;461;94;168;200;261;1;0;199;199
17;Girona;20;Gironès;17079;Girona;1;6;A;;498;160;268;308;190;0;0;308;308
17;Girona;20;Gironès;17079;Girona;1;6;B;;574;207;341;377;197;0;1;376;377
17;Girona;20;Gironès;17079;Girona;2;1;U;;687;239;422;509;178;3;7;499;506
17;Girona;20;Gironès;17079;Girona;2;10;A;;886;210;473;588;298;0;14;574;588
17;Girona;20;Gironès;17079;Girona;2;10;B;;902;217;458;589;313;3;3;583;586
17;Girona;20;Gironès;17079;Girona;2;11;A;;656;152;291;367;289;0;4;363;367
17;Girona;20;Gironès;17079;Girona;2;11;B;;593;154;296;369;224;0;1;368;369
17;Girona;20;Gironès;17079;Girona;2;12;A;;576;172;328;425;151;1;6;418;424
17;Girona;20;Gironès;17079;Girona;2;12;B;;639;200;371;461;178;1;4;456;460
17;Girona;20;Gironès;17079;Girona;2;13;A;;504;136;269;355;149;1;6;348;354
17;Girona;20;Gironès;17079;Girona;2;13;B;;558;134;273;364;194;1;4;359;363
17;Girona;20;Gironès;17079;Girona;2;14;U;;685;198;320;386;299;3;2;381;383
17;Girona;20;Gironès;17079;Girona;2;15;A;;887;211;433;593;294;3;9;581;590
17;Girona;20;Gironès;17079;Girona;2;15;B;;978;250;507;664;314;2;14;648;662
17;Girona;20;Gironès;17079;Girona;2;16;U;;691;217;408;516;175;2;6;508;514
17;Girona;20;Gironès;17079;Girona;2;17;U;;652;141;328;439;213;0;5;434;439
17;Girona;20;Gironès;17079;Girona;2;2;U;;547;157;301;392;155;0;6;386;392
17;Girona;20;Gironès;17079;Girona;2;3;A;;569;124;272;356;213;0;5;351;356
17;Girona;20;Gironès;17079;Girona;2;3;B;;565;160;290;372;193;0;4;368;372
17;Girona;20;Gironès;17079;Girona;2;4;A;;667;205;377;502;165;0;6;496;502
17;Girona;20;Gironès;17079;Girona;2;4;B;;678;182;379;485;193;3;5;477;482
17;Girona;20;Gironès;17079;Girona;2;5;U;;756;232;396;515;241;3;10;502;512
17;Girona;20;Gironès;17079;Girona;2;6;A;;554;169;326;399;155;0;4;395;399
17;Girona;20;Gironès;17079;Girona;2;6;B;;469;134;254;319;150;1;4;314;318
17;Girona;20;Gironès;17079;Girona;2;6;C;;575;174;320;400;175;1;2;397;399
17;Girona;20;Gironès;17079;Girona;2;7;A;;840;246;442;552;288;1;8;543;551
17;Girona;20;Gironès;17079;Girona;2;7;B;;689;182;354;443;246;3;8;432;440
17;Girona;20;Gironès;17079;Girona;2;8;A;;721;198;422;524;197;0;7;517;524
17;Girona;20;Gironès;17079;Girona;2;8;B;;790;219;426;545;245;5;7;533;540
17;Girona;20;Gironès;17079;Girona;2;9;A;;882;219;411;539;343;2;8;529;537
17;Girona;20;Gironès;17079;Girona;2;9;B;;887;253;415;540;347;4;12;524;536
17;Girona;20;Gironès;17079;Girona;3;1;A;;404;111;203;262;142;0;3;259;262
17;Girona;20;Gironès;17079;Girona;3;1;B;;420;124;249;307;113;0;5;302;307
17;Girona;20;Gironès;17079;Girona;3;10;U;;955;263;480;584;371;0;4;580;584
17;Girona;20;Gironès;17079;Girona;3;11;A;;639;189;298;393;246;0;2;391;393
17;Girona;20;Gironès;17079;Girona;3;11;B;;590;146;269;341;249;1;2;338;340
17;Girona;20;Gironès;17079;Girona;3;11;C;;650;147;273;365;285;1;5;359;364
17;Girona;20;Gironès;17079;Girona;3;12;A;;871;204;391;512;359;1;5;506;511
17;Girona;20;Gironès;17079;Girona;3;12;B;;887;193;378;487;400;1;8;478;486
17;Girona;20;Gironès;17079;Girona;3;13;A;;702;188;337;425;277;2;3;420;423
17;Girona;20;Gironès;17079;Girona;3;13;B;;715;188;336;440;275;0;5;435;440
17;Girona;20;Gironès;17079;Girona;3;14;A;;755;195;341;412;343;1;3;408;411
17;Girona;20;Gironès;17079;Girona;3;14;B;;695;182;304;387;308;0;5;382;387
17;Girona;20;Gironès;17079;Girona;3;15;A;;718;175;351;442;276;11;0;431;431
17;Girona;20;Gironès;17079;Girona;3;15;B;;738;205;347;462;276;7;8;447;455
17;Girona;20;Gironès;17079;Girona;3;16;A;;557;162;302;372;185;0;5;367;372
17;Girona;20;Gironès;17079;Girona;3;16;B;;600;171;339;409;191;1;5;403;408
17;Girona;20;Gironès;17079;Girona;3;17;A;;640;151;269;358;282;1;1;356;357
17;Girona;20;Gironès;17079;Girona;3;17;B;;588;135;260;344;244;1;3;340;343
17;Girona;20;Gironès;17079;Girona;3;2;A;;457;145;229;299;158;2;6;291;297
17;Girona;20;Gironès;17079;Girona;3;2;B;;386;116;193;260;126;0;4;256;260
17;Girona;20;Gironès;17079;Girona;3;3;A;;475;136;240;317;158;2;5;310;315
17;Girona;20;Gironès;17079;Girona;3;3;B;;411;120;217;280;131;0;3;277;280
17;Girona;20;Gironès;17079;Girona;3;4;A;;862;288;484;609;253;0;10;599;609
17;Girona;20;Gironès;17079;Girona;3;4;B;;894;287;481;627;267;1;8;618;626
17;Girona;20;Gironès;17079;Girona;3;5;A;;648;181;354;445;203;1;4;440;444
17;Girona;20;Gironès;17079;Girona;3;5;B;;625;268;416;425;200;1;2;422;424
17;Girona;20;Gironès;17079;Girona;3;6;U;;812;281;472;570;242;2;4;564;568
17;Girona;20;Gironès;17079;Girona;3;7;A;;741;189;357;460;281;1;3;456;459
17;Girona;20;Gironès;17079;Girona;3;7;B;;744;181;344;444;300;0;4;440;444
17;Girona;20;Gironès;17079;Girona;3;8;A;;765;202;383;485;280;1;4;480;484
17;Girona;20;Gironès;17079;Girona;3;8;B;;725;196;352;467;258;5;1;461;462
17;Girona;20;Gironès;17079;Girona;3;9;A;;582;150;275;348;234;1;3;344;347
17;Girona;20;Gironès;17079;Girona;3;9;B;;549;147;269;330;219;1;1;328;329
17;Girona;20;Gironès;17079;Girona;4;1;U;;576;192;307;362;214;3;3;356;359
17;Girona;20;Gironès;17079;Girona;4;2;U;;719;260;359;452;267;3;8;441;449
17;Girona;20;Gironès;17079;Girona;4;3;U;;498;116;192;226;272;1;2;223;225
17;Girona;20;Gironès;17079;Girona;5;1;A;;909;266;483;642;267;1;3;638;641
17;Girona;20;Gironès;17079;Girona;5;1;B;;874;260;505;622;252;1;8;613;621
17;Girona;20;Gironès;17079;Girona;5;2;U;;542;168;257;315;227;0;1;314;315
17;Girona;20;Gironès;17079;Girona;5;3;A;;616;134;259;330;286;1;1;328;329
17;Girona;20;Gironès;17079;Girona;5;3;B;;538;125;254;331;207;1;1;329;330
17;Girona;20;Gironès;17079;Girona;5;4;U;;544;172;312;362;182;1;3;358;361
17;Girona;20;Gironès;17079;Girona;5;5;A;;476;166;255;285;191;0;3;282;285
17;Girona;20;Gironès;17079;Girona;5;5;B;;462;139;239;279;183;0;2;277;279
17;Girona;20;Gironès;17079;Girona;6;1;A;;973;198;434;554;419;0;2;552;554
17;Girona;20;Gironès;17079;Girona;6;1;B;;827;205;418;513;314;1;8;504;512
17;Girona;20;Gironès;17079;Girona;6;2;A;;614;157;305;388;226;0;0;388;388
17;Girona;20;Gironès;17079;Girona;6;2;B;;594;168;304;382;212;1;7;374;381
17;Girona;20;Gironès;17079;Girona;6;3;A;;787;191;393;501;286;0;5;496;501
17;Girona;20;Gironès;17079;Girona;6;3;B;;657;163;322;415;242;0;2;413;415
17;Girona;20;Gironès;17079;Girona;6;4;A;;563;116;256;339;224;0;6;333;339
17;Girona;20;Gironès;17079;Girona;6;4;B;;516;86;252;294;222;0;4;290;294
8;Barcelona;14;Berguedà;08092;Gironella;1;1;A;;615;180;340;420;195;0;7;413;420
8;Barcelona;14;Berguedà;08092;Gironella;1;1;B;;683;178;364;474;209;2;4;468;472
8;Barcelona;14;Berguedà;08092;Gironella;2;1;U;;536;182;269;340;196;0;4;336;340
8;Barcelona;14;Berguedà;08092;Gironella;2;2;A;;578;154;304;400;178;1;4;395;399
8;Barcelona;14;Berguedà;08092;Gironella;2;2;B;;652;150;324;458;194;2;6;450;456
8;Barcelona;14;Berguedà;08092;Gironella;2;3;A;;554;149;313;382;172;3;3;376;379
8;Barcelona;14;Berguedà;08092;Gironella;2;3;B;;664;217;400;464;200;7;4;453;457
8;Barcelona;14;Berguedà;08093;Gisclareny;1;1;U;;25;8;12;18;7;0;0;18;18
43;Tarragona;22;Montsià;43068;Godall;1;1;U;;635;143;335;454;181;7;4;443;447
25;Lleida;27;Pla d'Urgell;25099;Golmés;1;1;U;;1100;223;530;687;413;1;7;679;686
17;Girona;31;Ripollès;17080;Gombrèn;1;1;U;;218;71;145;170;48;0;1;169;170
25;Lleida;14;Berguedà;25100;Gósol;1;1;U;;200;58;120;147;53;1;0;146;146
8;Barcelona;3;Alt Penedès;08094;Granada, la;1;1;U;;1095;223;553;746;349;3;3;740;743
25;Lleida;18;Garrigues;25101;Granadella, la;1;1;U;;718;209;400;528;190;0;5;523;528
8;Barcelona;;;08095;Granera;1;1;U;;56;26;40;43;13;0;0;43;43
25;Lleida;33;Segrià;25102;Granja d'Escarp, la;1;1;U;;900;190;466;555;345;3;6;546;552
8;Barcelona;41;Vallès Oriental;08096;Granollers;1;1;U;;533;182;334;398;135;1;5;392;397
8;Barcelona;41;Vallès Oriental;08096;Granollers;1;10;A;;584;151;268;351;233;2;8;341;349
8;Barcelona;41;Vallès Oriental;08096;Granollers;1;10;B;;753;172;318;425;328;0;2;423;425
8;Barcelona;41;Vallès Oriental;08096;Granollers;1;11;A;;660;176;282;367;293;0;3;364;367
8;Barcelona;41;Vallès Oriental;08096;Granollers;1;11;B;;763;178;308;406;357;0;7;399;406
8;Barcelona;41;Vallès Oriental;08096;Granollers;1;2;A;;460;150;247;316;144;0;3;313;316
8;Barcelona;41;Vallès Oriental;08096;Granollers;1;2;B;;600;190;340;420;180;4;4;412;416
8;Barcelona;41;Vallès Oriental;08096;Granollers;1;3;A;;685;188;344;448;237;1;4;443;447
8;Barcelona;41;Vallès Oriental;08096;Granollers;1;3;B;;870;205;407;549;321;1;10;538;548
8;Barcelona;41;Vallès Oriental;08096;Granollers;1;4;U;;456;115;200;263;193;0;1;262;263
8;Barcelona;41;Vallès Oriental;08096;Granollers;1;5;A;;627;176;339;435;192;0;7;428;435
8;Barcelona;41;Vallès Oriental;08096;Granollers;1;5;B;;785;220;428;541;244;0;8;533;541
8;Barcelona;41;Vallès Oriental;08096;Granollers;1;6;A;;471;147;212;274;197;1;1;272;273
8;Barcelona;41;Vallès Oriental;08096;Granollers;1;6;B;;668;238;350;417;251;0;2;415;417
8;Barcelona;41;Vallès Oriental;08096;Granollers;1;7;A;;513;135;245;323;190;0;4;319;323
8;Barcelona;41;Vallès Oriental;08096;Granollers;1;7;B;;672;161;329;426;246;0;5;421;426
8;Barcelona;41;Vallès Oriental;08096;Granollers;1;8;U;;657;174;285;364;293;3;1;360;361
8;Barcelona;41;Vallès Oriental;08096;Granollers;1;9;A;;496;108;227;269;227;1;1;267;268
8;Barcelona;41;Vallès Oriental;08096;Granollers;1;9;B;;611;125;231;296;315;2;2;292;294
8;Barcelona;41;Vallès Oriental;08096;Granollers;2;1;A;;673;200;360;456;217;0;4;452;456
8;Barcelona;41;Vallès Oriental;08096;Granollers;2;1;B;;702;301;364;468;234;0;4;464;468
8;Barcelona;41;Vallès Oriental;08096;Granollers;2;2;U;;452;163;271;316;136;0;4;312;316
8;Barcelona;41;Vallès Oriental;08096;Granollers;2;3;U;;518;168;302;399;119;0;3;396;399
8;Barcelona;41;Vallès Oriental;08096;Granollers;2;4;A;;556;129;247;320;236;1;1;318;319
8;Barcelona;41;Vallès Oriental;08096;Granollers;2;4;B;;699;171;306;404;295;0;3;401;404
8;Barcelona;41;Vallès Oriental;08096;Granollers;2;4;C;;671;160;295;407;264;0;3;404;407
8;Barcelona;41;Vallès Oriental;08096;Granollers;2;5;U;;899;243;422;530;369;0;3;527;530
8;Barcelona;41;Vallès Oriental;08096;Granollers;2;6;A;;461;128;233;308;153;1;3;304;307
8;Barcelona;41;Vallès Oriental;08096;Granollers;2;6;B;;608;167;320;397;211;0;2;395;397
8;Barcelona;41;Vallès Oriental;08096;Granollers;2;7;A;;462;98;223;279;183;1;4;274;278
8;Barcelona;41;Vallès Oriental;08096;Granollers;2;7;B;;512;109;237;297;215;0;3;294;297
8;Barcelona;41;Vallès Oriental;08096;Granollers;3;1;A;;733;212;370;475;258;0;6;469;475
8;Barcelona;41;Vallès Oriental;08096;Granollers;3;1;B;;827;235;447;563;264;0;7;556;563
8;Barcelona;41;Vallès Oriental;08096;Granollers;3;2;A;;576;118;220;301;275;3;4;294;298
8;Barcelona;41;Vallès Oriental;08096;Granollers;3;2;B;;654;154;277;366;288;1;1;364;365
8;Barcelona;41;Vallès Oriental;08096;Granollers;3;3;A;;511;139;249;305;206;0;2;303;305
8;Barcelona;41;Vallès Oriental;08096;Granollers;3;3;B;;570;144;266;339;231;2;2;335;337
8;Barcelona;41;Vallès Oriental;08096;Granollers;3;4;A;;605;199;286;380;225;2;2;376;378
8;Barcelona;41;Vallès Oriental;08096;Granollers;3;4;B;;752;145;363;475;277;0;14;461;475
8;Barcelona;41;Vallès Oriental;08096;Granollers;3;5;A;;617;151;266;370;247;0;7;363;370
8;Barcelona;41;Vallès Oriental;08096;Granollers;3;5;B;;675;182;316;425;250;0;2;423;425
8;Barcelona;41;Vallès Oriental;08096;Granollers;3;6;A;;747;174;312;426;321;5;5;416;421
8;Barcelona;41;Vallès Oriental;08096;Granollers;3;6;B;;826;170;350;480;346;2;1;477;478
8;Barcelona;41;Vallès Oriental;08096;Granollers;3;7;U;;719;181;308;403;316;1;2;400;402
8;Barcelona;41;Vallès Oriental;08096;Granollers;3;8;A;;458;87;161;215;243;0;0;215;215
8;Barcelona;41;Vallès Oriental;08096;Granollers;3;8;B;;527;90;174;242;285;1;1;240;241
8;Barcelona;41;Vallès Oriental;08096;Granollers;3;9;U;;611;147;290;384;227;2;7;375;382
8;Barcelona;41;Vallès Oriental;08096;Granollers;4;1;A;;611;165;336;415;196;0;1;414;415
8;Barcelona;41;Vallès Oriental;08096;Granollers;4;1;B;;612;173;304;391;221;0;3;388;391
8;Barcelona;41;Vallès Oriental;08096;Granollers;4;1;C;;602;187;327;399;203;0;4;395;399
8;Barcelona;41;Vallès Oriental;08096;Granollers;4;10;A;;676;152;305;432;244;0;1;431;432
8;Barcelona;41;Vallès Oriental;08096;Granollers;4;10;B;;865;174;397;553;312;0;1;552;553
8;Barcelona;41;Vallès Oriental;08096;Granollers;4;10;C;;292;80;153;194;98;0;0;194;194
8;Barcelona;41;Vallès Oriental;08096;Granollers;4;11;A;;563;138;270;360;203;2;5;353;358
8;Barcelona;41;Vallès Oriental;08096;Granollers;4;11;B;;677;175;327;432;245;1;3;428;431
8;Barcelona;41;Vallès Oriental;08096;Granollers;4;2;A;;531;130;232;299;232;0;4;295;299
8;Barcelona;41;Vallès Oriental;08096;Granollers;4;2;B;;690;165;315;410;280;0;3;407;410
8;Barcelona;41;Vallès Oriental;08096;Granollers;4;2;C;;467;120;214;275;192;0;2;273;275
8;Barcelona;41;Vallès Oriental;08096;Granollers;4;3;U;;714;186;303;417;297;2;3;412;415
8;Barcelona;41;Vallès Oriental;08096;Granollers;4;4;U;;803;173;334;454;349;0;6;448;454
8;Barcelona;41;Vallès Oriental;08096;Granollers;4;5;U;;570;117;235;327;243;0;4;323;327
8;Barcelona;41;Vallès Oriental;08096;Granollers;4;6;U;;850;192;359;490;360;1;1;488;489
8;Barcelona;41;Vallès Oriental;08096;Granollers;4;7;A;;725;154;324;455;270;3;2;450;452
8;Barcelona;41;Vallès Oriental;08096;Granollers;4;7;B;;811;180;354;509;302;2;5;502;507
8;Barcelona;41;Vallès Oriental;08096;Granollers;4;8;U;;644;90;253;339;305;0;5;334;339
8;Barcelona;41;Vallès Oriental;08096;Granollers;4;9;A;;524;131;238;314;210;0;3;311;314
8;Barcelona;41;Vallès Oriental;08096;Granollers;4;9;B;;587;150;265;358;229;2;2;354;356
25;Lleida;32;Segarra;25103;Granyanella;1;1;U;;141;22;53;86;55;1;2;83;85
25;Lleida;18;Garrigues;25105;Granyena de les Garrigues;1;1;U;;162;50;77;102;60;2;0;100;100
25;Lleida;32;Segarra;25104;Granyena de Segarra;1;1;U;;148;21;86;103;45;1;4;98;102
43;Tarragona;29;Priorat;43069;Gratallops;1;1;U;;200;56;115;143;57;3;5;135;140
8;Barcelona;41;Vallès Oriental;08097;Gualba;1;1;U;;672;200;375;464;208;0;3;461;464
17;Girona;10;Baix Empordà;17081;Gualta;1;1;U;;237;81;121;177;60;1;0;176;176
8;Barcelona;14;Berguedà;08099;Guardiola de Berguedà;1;1;U;;823;209;470;577;246;4;1;572;573
43;Tarragona;29;Priorat;43070;Guiamets, els;1;1;U;;253;92;160;187;66;1;4;182;186
17;Girona;15;Cerdanya;17082;Guils de Cerdanya;1;1;U;;287;57;158;197;90;0;4;193;197
25;Lleida;38;Urgell;25109;Guimerà;1;1;U;;354;77;171;222;132;1;2;219;221
25;Lleida;26;Pallars Sobirà;25903;Guingueta d'Àneu, la;1;1;U;;251;62;125;169;82;0;0;169;169
25;Lleida;32;Segarra;25110;Guissona;1;1;U;;1069;228;471;682;387;1;8;673;681
25;Lleida;32;Segarra;25110;Guissona;1;2;A;;622;148;255;375;247;1;1;373;374
25;Lleida;32;Segarra;25110;Guissona;1;2;B;;791;107;341;501;290;6;6;489;495
25;Lleida;35;Solsonès;25111;Guixers;1;1;U;;144;34;70;97;47;0;0;97;97
8;Barcelona;24;Osona;08100;Gurb;1;1;A;;668;124;361;477;191;0;6;471;477
8;Barcelona;24;Osona;08100;Gurb;1;1;B;;853;183;465;615;238;0;3;612;615
43;Tarragona;37;Terra Alta;43071;Horta de Sant Joan;1;1;U;;1054;248;510;668;386;2;7;659;666
8;Barcelona;13;Barcelonès;08101;Hospitalet de Llobregat, l';1;1;U;;954;185;354;498;456;0;5;493;498
8;Barcelona;13;Barcelonès;08101;Hospitalet de Llobregat, l';1;10;U;;1154;245;512;665;489;0;7;658;665
8;Barcelona;13;Barcelonès;08101;Hospitalet de Llobregat, l';1;11;U;;846;170;349;484;362;0;3;481;484
8;Barcelona;13;Barcelonès;08101;Hospitalet de Llobregat, l';1;12;U;;1224;251;534;719;505;0;5;714;719
8;Barcelona;13;Barcelonès;08101;Hospitalet de Llobregat, l';1;13;U;;1137;231;465;648;489;0;6;642;648
8;Barcelona;13;Barcelonès;08101;Hospitalet de Llobregat, l';1;14;A;;690;156;263;355;335;0;1;354;355
8;Barcelona;13;Barcelonès;08101;Hospitalet de Llobregat, l';1;14;B;;794;154;273;379;415;0;0;379;379
8;Barcelona;13;Barcelonès;08101;Hospitalet de Llobregat, l';1;15;U;;1092;264;453;620;472;1;8;611;619
8;Barcelona;13;Barcelonès;08101;Hospitalet de Llobregat, l';1;16;A;;654;122;271;363;291;0;7;356;363
8;Barcelona;13;Barcelonès;08101;Hospitalet de Llobregat, l';1;16;B;;752;161;318;428;324;1;3;424;427
8;Barcelona;13;Barcelonès;08101;Hospitalet de Llobregat, l';1;17;A;;732;150;297;418;314;3;6;409;415
8;Barcelona;13;Barcelonès;08101;Hospitalet de Llobregat, l';1;17;B;;859;201;365;504;355;0;3;501;504
8;Barcelona;13;Barcelonès;08101;Hospitalet de Llobregat, l';1;18;A;;820;169;353;465;355;4;4;457;461
8;Barcelona;13;Barcelonès;08101;Hospitalet de Llobregat, l';1;18;B;;666;152;270;380;286;0;2;378;380
8;Barcelona;13;Barcelonès;08101;Hospitalet de Llobregat, l';1;19;U;;1296;257;507;696;600;0;5;691;696
8;Barcelona;13;Barcelonès;08101;Hospitalet de Llobregat, l';1;2;A;;708;179;327;445;263;1;7;437;444
8;Barcelona;13;Barcelonès;08101;Hospitalet de Llobregat, l';1;2;B;;822;170;347;473;349;2;7;464;471
8;Barcelona;13;Barcelonès;08101;Hospitalet de Llobregat, l';1;20;U;;1288;252;540;738;550;0;3;735;738
8;Barcelona;13;Barcelonès;08101;Hospitalet de Llobregat, l';1;21;U;;703;177;324;392;311;1;4;387;391
8;Barcelona;13;Barcelonès;08101;Hospitalet de Llobregat, l';1;22;U;;797;178;331;442;355;0;4;438;442
8;Barcelona;13;Barcelonès;08101;Hospitalet de Llobregat, l';1;23;U;;1088;270;508;673;415;1;12;660;672
8;Barcelona;13;Barcelonès;08101;Hospitalet de Llobregat, l';1;24;U;;708;152;330;443;265;0;8;435;443
8;Barcelona;13;Barcelonès;08101;Hospitalet de Llobregat, l';1;25;U;;1036;234;406;585;451;1;3;581;584
8;Barcelona;13;Barcelonès;08101;Hospitalet de Llobregat, l';1;26;U;;1024;227;468;627;397;3;6;618;624
8;Barcelona;13;Barcelonès;08101;Hospitalet de Llobregat, l';1;27;U;;640;144;278;373;267;0;4;369;373
8;Barcelona;13;Barcelonès;08101;Hospitalet de Llobregat, l';1;28;U;;853;185;310;439;414;2;7;430;437
8;Barcelona;13;Barcelonès;08101;Hospitalet de Llobregat, l';1;29;U;;981;163;372;502;479;2;3;497;500
8;Barcelona;13;Barcelonès;08101;Hospitalet de Llobregat, l';1;3;U;;640;144;282;380;260;0;1;379;380
8;Barcelona;13;Barcelonès;08101;Hospitalet de Llobregat, l';1;30;U;;865;260;438;533;332;1;1;531;532
8;Barcelona;13;Barcelonès;08101;Hospitalet de Llobregat, l';1;31;U;;1287;255;509;668;619;2;11;655;666
8;Barcelona;13;Barcelonès;08101;Hospitalet de Llobregat, l';1;32;A;;783;166;316;429;354;4;5;420;425
8;Barcelona;13;Barcelonès;08101;Hospitalet de Llobregat, l';1;32;B;;940;193;368;490;450;0;1;489;490
8;Barcelona;13;Barcelonès;08101;Hospitalet de Llobregat, l';1;33;U;;771;194;380;503;268;1;5;497;502
8;Barcelona;13;Barcelonès;08101;Hospitalet de Llobregat, l';1;34;U;;1024;256;468;588;436;2;11;575;586
8;Barcelona;13;Barcelonès;08101;Hospitalet de Llobregat, l';1;35;U;;1249;265;511;684;565;0;3;681;684
8;Barcelona;13;Barcelonès;08101;Hospitalet de Llobregat, l';1;36;U;;976;289;477;590;386;0;4;586;590
8;Barcelona;13;Barcelonès;08101;Hospitalet de Llobregat, l';1;37;U;;1109;260;500;298;811;0;11;287;298
8;Barcelona;13;Barcelonès;08101;Hospitalet de Llobregat, l';1;38;U;;700;149;276;401;299;2;4;395;399
8;Barcelona;13;Barcelonès;08101;Hospitalet de Llobregat, l';1;39;U;;712;136;287;388;324;0;2;386;388
8;Barcelona;13;Barcelonès;08101;Hospitalet de Llobregat, l';1;4;U;;730;200;357;454;276;1;8;445;453
8;Barcelona;13;Barcelonès;08101;Hospitalet de Llobregat, l';1;40;U;;856;224;401;474;382;1;3;470;473
8;Barcelona;13;Barcelonès;08101;Hospitalet de Llobregat, l';1;5;U;;1000;220;453;607;393;0;2;605;607
8;Barcelona;13;Barcelonès;08101;Hospitalet de Llobregat, l';1;6;A;;713;131;286;384;329;0;2;382;384
8;Barcelona;13;Barcelonès;08101;Hospitalet de Llobregat, l';1;6;B;;869;161;327;440;429;1;1;438;439
8;Barcelona;13;Barcelonès;08101;Hospitalet de Llobregat, l';1;7;A;;704;135;279;381;323;3;4;374;378
8;Barcelona;13;Barcelonès;08101;Hospitalet de Llobregat, l';1;7;B;;847;143;313;451;396;2;8;441;449
8;Barcelona;13;Barcelonès;08101;Hospitalet de Llobregat, l';1;8;U;;1090;322;542;688;402;0;10;678;688
8;Barcelona;13;Barcelonès;08101;Hospitalet de Llobregat, l';1;9;U;;913;192;384;553;360;1;4;548;552
8;Barcelona;13;Barcelonès;08101;Hospitalet de Llobregat, l';2;1;U;;583;161;300;339;244;0;3;336;339
8;Barcelona;13;Barcelonès;08101;Hospitalet de Llobregat, l';2;10;U;;780;222;385;475;305;0;7;468;475
8;Barcelona;13;Barcelonès;08101;Hospitalet de Llobregat, l';2;11;U;;943;241;391;484;459;0;5;479;484
8;Barcelona;13;Barcelonès;08101;Hospitalet de Llobregat, l';2;12;U;;1085;240;415;517;568;3;0;514;514
8;Barcelona;13;Barcelonès;08101;Hospitalet de Llobregat, l';2;13;U;;767;206;334;417;350;0;0;417;417
8;Barcelona;13;Barcelonès;08101;Hospitalet de Llobregat, l';2;14;U;;537;131;211;278;259;1;1;276;277
8;Barcelona;13;Barcelonès;08101;Hospitalet de Llobregat, l';2;15;U;;708;209;340;419;289;0;1;418;419
8;Barcelona;13;Barcelonès;08101;Hospitalet de Llobregat, l';2;16;U;;1052;269;458;582;470;0;4;578;582
8;Barcelona;13;Barcelonès;08101;Hospitalet de Llobregat, l';2;17;U;;481;117;201;244;237;2;1;241;242
8;Barcelona;13;Barcelonès;08101;Hospitalet de Llobregat, l';2;18;U;;602;129;261;344;258;0;4;340;344
8;Barcelona;13;Barcelonès;08101;Hospitalet de Llobregat, l';2;19;U;;931;258;433;526;405;1;6;519;525
8;Barcelona;13;Barcelonès;08101;Hospitalet de Llobregat, l';2;2;U;;602;158;246;321;281;0;5;316;321
8;Barcelona;13;Barcelonès;08101;Hospitalet de Llobregat, l';2;20;U;;654;165;284;360;294;0;4;356;360
8;Barcelona;13;Barcelonès;08101;Hospitalet de Llobregat, l';2;21;U;;902;212;353;460;442;0;6;454;460
8;Barcelona;13;Barcelonès;08101;Hospitalet de Llobregat, l';2;22;U;;646;110;204;291;355;0;1;290;291
8;Barcelona;13;Barcelonès;08101;Hospitalet de Llobregat, l';2;23;U;;862;224;394;491;371;3;2;486;488
8;Barcelona;13;Barcelonès;08101;Hospitalet de Llobregat, l';2;24;U;;482;130;210;254;228;3;2;249;251
8;Barcelona;13;Barcelonès;08101;Hospitalet de Llobregat, l';2;25;U;;436;117;211;265;171;0;1;264;265
8;Barcelona;13;Barcelonès;08101;Hospitalet de Llobregat, l';2;26;U;;868;188;360;465;403;1;2;462;464
8;Barcelona;13;Barcelonès;08101;Hospitalet de Llobregat, l';2;27;U;;562;161;258;341;221;0;4;337;341
8;Barcelona;13;Barcelonès;08101;Hospitalet de Llobregat, l';2;28;U;;536;130;191;277;259;3;4;270;274
8;Barcelona;13;Barcelonès;08101;Hospitalet de Llobregat, l';2;29;U;;538;146;235;279;259;1;0;278;278
8;Barcelona;13;Barcelonès;08101;Hospitalet de Llobregat, l';2;3;U;;590;183;260;335;255;2;3;330;333
8;Barcelona;13;Barcelonès;08101;Hospitalet de Llobregat, l';2;30;U;;608;144;242;299;309;2;1;296;297
8;Barcelona;13;Barcelonès;08101;Hospitalet de Llobregat, l';2;31;U;;861;200;373;459;402;1;4;454;458
8;Barcelona;13;Barcelonès;08101;Hospitalet de Llobregat, l';2;32;U;;794;228;385;497;297;2;1;494;495
8;Barcelona;13;Barcelonès;08101;Hospitalet de Llobregat, l';2;33;U;;637;187;290;347;290;0;5;342;347
8;Barcelona;13;Barcelonès;08101;Hospitalet de Llobregat, l';2;34;U;;762;198;330;397;365;1;5;391;396
8;Barcelona;13;Barcelonès;08101;Hospitalet de Llobregat, l';2;35;A;;496;122;201;254;242;0;0;254;254
8;Barcelona;13;Barcelonès;08101;Hospitalet de Llobregat, l';2;35;B;;588;157;252;322;266;0;5;317;322
8;Barcelona;13;Barcelonès;08101;Hospitalet de Llobregat, l';2;36;U;;851;261;423;515;336;3;5;507;512
8;Barcelona;13;Barcelonès;08101;Hospitalet de Llobregat, l';2;37;U;;1067;245;430;564;503;0;3;561;564
8;Barcelona;13;Barcelonès;08101;Hospitalet de Llobregat, l';2;38;U;;617;193;293;355;262;1;3;351;354
8;Barcelona;13;Barcelonès;08101;Hospitalet de Llobregat, l';2;39;U;;935;250;406;525;410;1;3;521;524
8;Barcelona;13;Barcelonès;08101;Hospitalet de Llobregat, l';2;4;U;;440;112;190;240;200;0;1;239;240
8;Barcelona;13;Barcelonès;08101;Hospitalet de Llobregat, l';2;40;U;;547;176;283;338;209;1;2;335;337
8;Barcelona;13;Barcelonès;08101;Hospitalet de Llobregat, l';2;41;U;;582;164;277;339;243;1;1;337;338
8;Barcelona;13;Barcelonès;08101;Hospitalet de Llobregat, l';2;42;U;;868;272;467;554;314;3;7;544;551
8;Barcelona;13;Barcelonès;08101;Hospitalet de Llobregat, l';2;43;A;;551;154;240;306;245;2;1;303;304
8;Barcelona;13;Barcelonès;08101;Hospitalet de Llobregat, l';2;43;B;;634;174;269;334;300;3;3;328;331
8;Barcelona;13;Barcelonès;08101;Hospitalet de Llobregat, l';2;44;U;;524;145;230;285;239;0;3;282;285
8;Barcelona;13;Barcelonès;08101;Hospitalet de Llobregat, l';2;45;U;;783;241;385;452;331;2;3;447;450
8;Barcelona;13;Barcelonès;08101;Hospitalet de Llobregat, l';2;46;U;;826;197;332;412;414;3;4;405;409
8;Barcelona;13;Barcelonès;08101;Hospitalet de Llobregat, l';2;47;U;;948;242;409;502;446;0;3;499;502
8;Barcelona;13;Barcelonès;08101;Hospitalet de Llobregat, l';2;48;U;;880;224;396;501;379;1;8;492;500
8;Barcelona;13;Barcelonès;08101;Hospitalet de Llobregat, l';2;49;U;;866;218;390;464;402;3;1;460;461
8;Barcelona;13;Barcelonès;08101;Hospitalet de Llobregat, l';2;5;U;;723;200;372;467;256;1;4;462;466
8;Barcelona;13;Barcelonès;08101;Hospitalet de Llobregat, l';2;6;U;;734;210;384;460;274;1;2;457;459
8;Barcelona;13;Barcelonès;08101;Hospitalet de Llobregat, l';2;7;U;;565;152;288;348;217;0;1;347;348
8;Barcelona;13;Barcelonès;08101;Hospitalet de Llobregat, l';2;8;A;;727;180;352;453;274;0;6;447;453
8;Barcelona;13;Barcelonès;08101;Hospitalet de Llobregat, l';2;8;B;;819;221;408;498;321;2;5;491;496
8;Barcelona;13;Barcelonès;08101;Hospitalet de Llobregat, l';2;9;U;;804;224;396;513;291;0;4;509;513
8;Barcelona;13;Barcelonès;08101;Hospitalet de Llobregat, l';3;1;A;;720;179;294;397;323;0;8;389;397
8;Barcelona;13;Barcelonès;08101;Hospitalet de Llobregat, l';3;1;B;;902;220;374;486;416;0;2;484;486
8;Barcelona;13;Barcelonès;08101;Hospitalet de Llobregat, l';3;10;U;;697;156;295;367;330;0;2;365;367
8;Barcelona;13;Barcelonès;08101;Hospitalet de Llobregat, l';3;11;U;;1193;313;516;639;554;0;4;635;639
8;Barcelona;13;Barcelonès;08101;Hospitalet de Llobregat, l';3;12;A;;648;145;284;362;286;1;7;354;361
8;Barcelona;13;Barcelonès;08101;Hospitalet de Llobregat, l';3;12;B;;666;152;293;369;297;1;2;366;368
8;Barcelona;13;Barcelonès;08101;Hospitalet de Llobregat, l';3;13;A;;713;158;308;402;311;1;3;398;401
8;Barcelona;13;Barcelonès;08101;Hospitalet de Llobregat, l';3;13;B;;810;193;350;475;335;2;1;472;473
8;Barcelona;13;Barcelonès;08101;Hospitalet de Llobregat, l';3;14;A;;805;160;343;442;363;1;5;436;441
8;Barcelona;13;Barcelonès;08101;Hospitalet de Llobregat, l';3;14;B;;1002;210;394;525;477;5;4;516;520
8;Barcelona;13;Barcelonès;08101;Hospitalet de Llobregat, l';3;15;U;;1167;239;388;594;573;1;8;585;593
8;Barcelona;13;Barcelonès;08101;Hospitalet de Llobregat, l';3;16;A;;840;186;410;541;299;1;6;534;540
8;Barcelona;13;Barcelonès;08101;Hospitalet de Llobregat, l';3;16;B;;965;210;473;612;353;4;5;603;608
8;Barcelona;13;Barcelonès;08101;Hospitalet de Llobregat, l';3;17;U;;640;133;248;319;321;1;2;316;318
8;Barcelona;13;Barcelonès;08101;Hospitalet de Llobregat, l';3;18;U;;678;159;328;432;246;0;10;422;432
8;Barcelona;13;Barcelonès;08101;Hospitalet de Llobregat, l';3;19;U;;626;144;274;349;277;1;1;347;348
8;Barcelona;13;Barcelonès;08101;Hospitalet de Llobregat, l';3;2;U;;1289;300;548;694;595;0;7;687;694
8;Barcelona;13;Barcelonès;08101;Hospitalet de Llobregat, l';3;20;U;;512;122;237;300;212;1;3;296;299
8;Barcelona;13;Barcelonès;08101;Hospitalet de Llobregat, l';3;21;A;;955;244;466;618;337;0;7;611;618
8;Barcelona;13;Barcelonès;08101;Hospitalet de Llobregat, l';3;21;B;;1083;284;545;710;373;0;8;702;710
8;Barcelona;13;Barcelonès;08101;Hospitalet de Llobregat, l';3;22;U;;929;198;390;501;428;1;9;491;500
8;Barcelona;13;Barcelonès;08101;Hospitalet de Llobregat, l';3;23;A;;995;190;369;516;479;3;6;507;513
8;Barcelona;13;Barcelonès;08101;Hospitalet de Llobregat, l';3;23;B;;1294;255;504;686;608;0;12;674;686
8;Barcelona;13;Barcelonès;08101;Hospitalet de Llobregat, l';3;24;U;;680;166;285;367;313;0;7;360;367
8;Barcelona;13;Barcelonès;08101;Hospitalet de Llobregat, l';3;25;A;;893;200;413;551;342;0;1;550;551
8;Barcelona;13;Barcelonès;08101;Hospitalet de Llobregat, l';3;25;B;;813;206;433;529;284;2;0;527;527
8;Barcelona;13;Barcelonès;08101;Hospitalet de Llobregat, l';3;3;A;;710;183;328;420;290;0;2;418;420
8;Barcelona;13;Barcelonès;08101;Hospitalet de Llobregat, l';3;3;B;;781;201;377;468;313;0;7;461;468
8;Barcelona;13;Barcelonès;08101;Hospitalet de Llobregat, l';3;4;U;;1000;264;470;567;433;2;5;560;565
8;Barcelona;13;Barcelonès;08101;Hospitalet de Llobregat, l';3;5;U;;1203;316;619;756;447;1;5;750;755
8;Barcelona;13;Barcelonès;08101;Hospitalet de Llobregat, l';3;6;U;;1255;315;630;775;480;0;8;767;775
8;Barcelona;13;Barcelonès;08101;Hospitalet de Llobregat, l';3;7;A;;641;164;325;429;212;1;3;425;428
8;Barcelona;13;Barcelonès;08101;Hospitalet de Llobregat, l';3;7;B;;678;177;350;450;228;0;2;448;450
8;Barcelona;13;Barcelonès;08101;Hospitalet de Llobregat, l';3;8;U;;1322;314;607;795;527;9;2;784;786
8;Barcelona;13;Barcelonès;08101;Hospitalet de Llobregat, l';3;9;U;;584;113;228;314;270;0;4;310;314
8;Barcelona;13;Barcelonès;08101;Hospitalet de Llobregat, l';4;1;U;;955;244;454;607;348;0;3;604;607
8;Barcelona;13;Barcelonès;08101;Hospitalet de Llobregat, l';4;10;A;;649;163;289;370;279;0;3;367;370
8;Barcelona;13;Barcelonès;08101;Hospitalet de Llobregat, l';4;10;B;;793;186;314;432;361;0;2;430;432
8;Barcelona;13;Barcelonès;08101;Hospitalet de Llobregat, l';4;11;U;;904;227;383;509;395;0;2;507;509
8;Barcelona;13;Barcelonès;08101;Hospitalet de Llobregat, l';4;12;A;;627;150;271;350;277;1;4;345;349
8;Barcelona;13;Barcelonès;08101;Hospitalet de Llobregat, l';4;12;B;;759;197;313;406;353;2;2;402;404
8;Barcelona;13;Barcelonès;08101;Hospitalet de Llobregat, l';4;13;U;;470;107;173;237;233;0;4;233;237
8;Barcelona;13;Barcelonès;08101;Hospitalet de Llobregat, l';4;14;U;;745;171;321;419;326;0;6;413;419
8;Barcelona;13;Barcelonès;08101;Hospitalet de Llobregat, l';4;15;U;;575;161;245;295;280;4;0;291;291
8;Barcelona;13;Barcelonès;08101;Hospitalet de Llobregat, l';4;16;U;;597;138;294;358;239;0;7;351;358
8;Barcelona;13;Barcelonès;08101;Hospitalet de Llobregat, l';4;17;U;;516;113;204;267;249;0;2;265;267
8;Barcelona;13;Barcelonès;08101;Hospitalet de Llobregat, l';4;18;U;;929;223;407;524;405;2;2;520;522
8;Barcelona;13;Barcelonès;08101;Hospitalet de Llobregat, l';4;19;U;;630;135;254;325;305;0;0;325;325
8;Barcelona;13;Barcelonès;08101;Hospitalet de Llobregat, l';4;2;U;;696;164;280;335;361;3;5;327;332
8;Barcelona;13;Barcelonès;08101;Hospitalet de Llobregat, l';4;20;U;;1018;455;455;572;446;2;3;567;570
8;Barcelona;13;Barcelonès;08101;Hospitalet de Llobregat, l';4;21;U;;992;268;409;540;452;0;4;536;540
8;Barcelona;13;Barcelonès;08101;Hospitalet de Llobregat, l';4;22;U;;852;224;335;439;413;0;5;434;439
8;Barcelona;13;Barcelonès;08101;Hospitalet de Llobregat, l';4;23;U;;838;217;404;489;349;6;2;481;483
8;Barcelona;13;Barcelonès;08101;Hospitalet de Llobregat, l';4;24;U;;477;108;172;239;238;2;3;234;237
8;Barcelona;13;Barcelonès;08101;Hospitalet de Llobregat, l';4;25;U;;764;194;336;431;333;1;4;426;430
8;Barcelona;13;Barcelonès;08101;Hospitalet de Llobregat, l';4;26;U;;734;161;285;388;346;0;2;386;388
8;Barcelona;13;Barcelonès;08101;Hospitalet de Llobregat, l';4;27;U;;693;194;294;374;319;1;2;371;373
8;Barcelona;13;Barcelonès;08101;Hospitalet de Llobregat, l';4;28;U;;429;111;176;234;195;0;1;233;234
8;Barcelona;13;Barcelonès;08101;Hospitalet de Llobregat, l';4;29;U;;545;125;225;307;238;1;0;306;306
8;Barcelona;13;Barcelonès;08101;Hospitalet de Llobregat, l';4;3;U;;996;255;470;602;394;2;1;599;600
8;Barcelona;13;Barcelonès;08101;Hospitalet de Llobregat, l';4;30;U;;731;160;298;368;363;0;2;366;368
8;Barcelona;13;Barcelonès;08101;Hospitalet de Llobregat, l';4;31;A;;488;138;213;260;228;0;0;260;260
8;Barcelona;13;Barcelonès;08101;Hospitalet de Llobregat, l';4;31;B;;596;170;277;340;256;1;2;337;339
8;Barcelona;13;Barcelonès;08101;Hospitalet de Llobregat, l';4;32;U;;1062;245;475;614;448;0;9;605;614
8;Barcelona;13;Barcelonès;08101;Hospitalet de Llobregat, l';4;33;U;;761;151;274;339;422;1;4;334;338
8;Barcelona;13;Barcelonès;08101;Hospitalet de Llobregat, l';4;34;U;;518;147;215;252;266;2;0;250;250
8;Barcelona;13;Barcelonès;08101;Hospitalet de Llobregat, l';4;35;U;;846;216;341;403;443;3;2;398;400
8;Barcelona;13;Barcelonès;08101;Hospitalet de Llobregat, l';4;36;U;;606;137;225;295;311;1;2;292;294
8;Barcelona;13;Barcelonès;08101;Hospitalet de Llobregat, l';4;37;U;;666;180;287;351;315;0;0;351;351
8;Barcelona;13;Barcelonès;08101;Hospitalet de Llobregat, l';4;38;U;;705;149;272;372;333;0;3;369;372
8;Barcelona;13;Barcelonès;08101;Hospitalet de Llobregat, l';4;39;U;;749;182;318;370;379;0;3;367;370
8;Barcelona;13;Barcelonès;08101;Hospitalet de Llobregat, l';4;4;U;;1040;251;447;562;478;1;2;559;561
8;Barcelona;13;Barcelonès;08101;Hospitalet de Llobregat, l';4;40;U;;1014;236;420;545;469;3;8;534;542
8;Barcelona;13;Barcelonès;08101;Hospitalet de Llobregat, l';4;41;A;;785;174;335;445;340;0;3;442;445
8;Barcelona;13;Barcelonès;08101;Hospitalet de Llobregat, l';4;41;B;;884;264;418;543;341;0;6;537;543
8;Barcelona;13;Barcelonès;08101;Hospitalet de Llobregat, l';4;42;U;;514;134;226;286;228;0;3;283;286
8;Barcelona;13;Barcelonès;08101;Hospitalet de Llobregat, l';4;5;U;;761;194;309;398;363;0;0;398;398
8;Barcelona;13;Barcelonès;08101;Hospitalet de Llobregat, l';4;6;U;;1118;269;464;599;519;1;0;598;598
8;Barcelona;13;Barcelonès;08101;Hospitalet de Llobregat, l';4;7;U;;827;202;300;432;395;2;1;429;430
8;Barcelona;13;Barcelonès;08101;Hospitalet de Llobregat, l';4;8;U;;721;154;278;365;356;0;5;360;365
8;Barcelona;13;Barcelonès;08101;Hospitalet de Llobregat, l';4;9;U;;567;136;257;304;263;2;1;301;302
8;Barcelona;13;Barcelonès;08101;Hospitalet de Llobregat, l';5;1;U;;1092;194;430;611;481;0;6;605;611
8;Barcelona;13;Barcelonès;08101;Hospitalet de Llobregat, l';5;10;U;;888;242;394;496;392;1;3;492;495
8;Barcelona;13;Barcelonès;08101;Hospitalet de Llobregat, l';5;11;U;;565;149;240;288;277;0;1;287;288
8;Barcelona;13;Barcelonès;08101;Hospitalet de Llobregat, l';5;12;U;;735;154;301;396;339;0;0;396;396
8;Barcelona;13;Barcelonès;08101;Hospitalet de Llobregat, l';5;13;U;;629;172;274;336;293;0;1;335;336
8;Barcelona;13;Barcelonès;08101;Hospitalet de Llobregat, l';5;14;U;;572;135;234;313;259;2;0;311;311
8;Barcelona;13;Barcelonès;08101;Hospitalet de Llobregat, l';5;15;U;;429;118;193;246;183;1;1;244;245
8;Barcelona;13;Barcelonès;08101;Hospitalet de Llobregat, l';5;16;U;;522;119;181;238;284;0;0;238;238
8;Barcelona;13;Barcelonès;08101;Hospitalet de Llobregat, l';5;17;U;;901;255;409;519;382;1;2;516;518
8;Barcelona;13;Barcelonès;08101;Hospitalet de Llobregat, l';5;18;U;;917;236;396;527;390;1;9;517;526
8;Barcelona;13;Barcelonès;08101;Hospitalet de Llobregat, l';5;19;U;;451;106;178;214;237;0;1;213;214
8;Barcelona;13;Barcelonès;08101;Hospitalet de Llobregat, l';5;2;A;;600;147;233;334;266;1;3;330;333
8;Barcelona;13;Barcelonès;08101;Hospitalet de Llobregat, l';5;2;B;;663;181;283;396;267;1;4;391;395
8;Barcelona;13;Barcelonès;08101;Hospitalet de Llobregat, l';5;20;U;;777;194;328;434;343;1;2;431;433
8;Barcelona;13;Barcelonès;08101;Hospitalet de Llobregat, l';5;21;U;;1090;230;461;650;440;2;8;640;648
8;Barcelona;13;Barcelonès;08101;Hospitalet de Llobregat, l';5;22;U;;542;119;187;264;278;1;3;260;263
8;Barcelona;13;Barcelonès;08101;Hospitalet de Llobregat, l';5;23;U;;1119;316;528;640;479;0;5;635;640
8;Barcelona;13;Barcelonès;08101;Hospitalet de Llobregat, l';5;24;U;;967;221;388;501;466;0;3;498;501
8;Barcelona;13;Barcelonès;08101;Hospitalet de Llobregat, l';5;25;U;;724;172;291;403;321;4;7;392;399
8;Barcelona;13;Barcelonès;08101;Hospitalet de Llobregat, l';5;26;U;;529;149;236;289;240;1;1;287;288
8;Barcelona;13;Barcelonès;08101;Hospitalet de Llobregat, l';5;27;U;;789;191;300;395;394;0;3;392;395
8;Barcelona;13;Barcelonès;08101;Hospitalet de Llobregat, l';5;28;U;;948;212;418;519;429;2;3;514;517
8;Barcelona;13;Barcelonès;08101;Hospitalet de Llobregat, l';5;29;U;;978;307;517;562;416;0;3;559;562
8;Barcelona;13;Barcelonès;08101;Hospitalet de Llobregat, l';5;3;U;;742;147;301;433;309;0;3;430;433
8;Barcelona;13;Barcelonès;08101;Hospitalet de Llobregat, l';5;30;U;;1094;310;527;655;439;1;7;647;654
8;Barcelona;13;Barcelonès;08101;Hospitalet de Llobregat, l';5;31;U;;754;178;309;394;360;2;1;391;392
8;Barcelona;13;Barcelonès;08101;Hospitalet de Llobregat, l';5;32;U;;1152;316;539;656;496;3;7;646;653
8;Barcelona;13;Barcelonès;08101;Hospitalet de Llobregat, l';5;33;U;;746;201;324;426;320;0;1;425;426
8;Barcelona;13;Barcelonès;08101;Hospitalet de Llobregat, l';5;34;U;;799;163;347;438;361;0;5;433;438
8;Barcelona;13;Barcelonès;08101;Hospitalet de Llobregat, l';5;35;U;;996;212;423;586;410;0;4;582;586
8;Barcelona;13;Barcelonès;08101;Hospitalet de Llobregat, l';5;36;U;;800;257;396;502;298;0;2;500;502
8;Barcelona;13;Barcelonès;08101;Hospitalet de Llobregat, l';5;37;U;;1054;268;452;579;475;4;6;569;575
8;Barcelona;13;Barcelonès;08101;Hospitalet de Llobregat, l';5;38;U;;993;250;442;552;441;0;5;547;552
8;Barcelona;13;Barcelonès;08101;Hospitalet de Llobregat, l';5;4;U;;1122;240;432;577;545;1;6;570;576
8;Barcelona;13;Barcelonès;08101;Hospitalet de Llobregat, l';5;5;A;;645;128;314;357;288;0;4;353;357
8;Barcelona;13;Barcelonès;08101;Hospitalet de Llobregat, l';5;5;B;;651;157;278;371;280;1;6;364;370
8;Barcelona;13;Barcelonès;08101;Hospitalet de Llobregat, l';5;6;A;;867;177;370;491;376;1;6;484;490
8;Barcelona;13;Barcelonès;08101;Hospitalet de Llobregat, l';5;6;B;;871;180;361;497;374;3;6;488;494
8;Barcelona;13;Barcelonès;08101;Hospitalet de Llobregat, l';5;7;U;;774;175;316;446;328;1;5;440;445
8;Barcelona;13;Barcelonès;08101;Hospitalet de Llobregat, l';5;8;U;;492;131;218;280;212;0;1;279;280
8;Barcelona;13;Barcelonès;08101;Hospitalet de Llobregat, l';5;9;U;;646;150;270;357;289;2;1;354;355
8;Barcelona;13;Barcelonès;08101;Hospitalet de Llobregat, l';6;1;U;;1277;275;550;723;554;1;10;712;722
8;Barcelona;13;Barcelonès;08101;Hospitalet de Llobregat, l';6;10;A;;652;159;435;388;264;1;9;378;387
8;Barcelona;13;Barcelonès;08101;Hospitalet de Llobregat, l';6;10;B;;541;131;233;311;230;1;5;305;310
8;Barcelona;13;Barcelonès;08101;Hospitalet de Llobregat, l';6;11;A;;757;168;305;387;370;0;3;384;387
8;Barcelona;13;Barcelonès;08101;Hospitalet de Llobregat, l';6;11;B;;720;137;276;373;347;1;2;370;372
8;Barcelona;13;Barcelonès;08101;Hospitalet de Llobregat, l';6;12;U;;1021;260;448;565;456;1;0;564;564
8;Barcelona;13;Barcelonès;08101;Hospitalet de Llobregat, l';6;13;A;;675;135;244;345;330;2;4;339;343
8;Barcelona;13;Barcelonès;08101;Hospitalet de Llobregat, l';6;13;B;;565;108;223;323;242;0;2;321;323
8;Barcelona;13;Barcelonès;08101;Hospitalet de Llobregat, l';6;14;U;;910;200;399;534;376;3;5;526;531
8;Barcelona;13;Barcelonès;08101;Hospitalet de Llobregat, l';6;15;U;;893;188;402;536;357;1;4;531;535
8;Barcelona;13;Barcelonès;08101;Hospitalet de Llobregat, l';6;16;A;;765;112;242;336;429;1;4;331;335
8;Barcelona;13;Barcelonès;08101;Hospitalet de Llobregat, l';6;16;B;;893;170;290;385;508;2;1;382;383
8;Barcelona;13;Barcelonès;08101;Hospitalet de Llobregat, l';6;17;U;;973;210;401;536;437;0;7;529;536
8;Barcelona;13;Barcelonès;08101;Hospitalet de Llobregat, l';6;18;U;;544;145;265;347;197;0;4;343;347
8;Barcelona;13;Barcelonès;08101;Hospitalet de Llobregat, l';6;19;U;;1277;29;558;759;518;0;4;755;759
8;Barcelona;13;Barcelonès;08101;Hospitalet de Llobregat, l';6;2;U;;546;105;210;299;247;0;1;298;299
8;Barcelona;13;Barcelonès;08101;Hospitalet de Llobregat, l';6;20;U;;578;117;276;382;196;0;5;377;382
8;Barcelona;13;Barcelonès;08101;Hospitalet de Llobregat, l';6;21;A;;792;155;308;419;373;1;2;416;418
8;Barcelona;13;Barcelonès;08101;Hospitalet de Llobregat, l';6;21;B;;679;134;276;388;291;0;2;386;388
8;Barcelona;13;Barcelonès;08101;Hospitalet de Llobregat, l';6;22;U;;795;138;300;397;398;2;2;393;395
8;Barcelona;13;Barcelonès;08101;Hospitalet de Llobregat, l';6;23;A;;676;170;301;419;257;0;5;414;419
8;Barcelona;13;Barcelonès;08101;Hospitalet de Llobregat, l';6;23;B;;746;150;313;458;288;0;0;458;458
8;Barcelona;13;Barcelonès;08101;Hospitalet de Llobregat, l';6;24;U;;1088;139;382;555;533;4;5;546;551
8;Barcelona;13;Barcelonès;08101;Hospitalet de Llobregat, l';6;25;U;;1160;261;507;704;456;2;5;697;702
8;Barcelona;13;Barcelonès;08101;Hospitalet de Llobregat, l';6;26;U;;985;216;380;501;484;0;2;499;501
8;Barcelona;13;Barcelonès;08101;Hospitalet de Llobregat, l';6;27;U;;985;174;387;583;402;0;4;579;583
8;Barcelona;13;Barcelonès;08101;Hospitalet de Llobregat, l';6;28;U;;985;193;417;561;424;2;3;556;559
8;Barcelona;13;Barcelonès;08101;Hospitalet de Llobregat, l';6;29;U;;554;145;231;291;263;0;2;289;291
8;Barcelona;13;Barcelonès;08101;Hospitalet de Llobregat, l';6;3;U;;548;115;214;313;235;0;4;309;313
8;Barcelona;13;Barcelonès;08101;Hospitalet de Llobregat, l';6;30;U;;825;174;348;490;335;2;4;484;488
8;Barcelona;13;Barcelonès;08101;Hospitalet de Llobregat, l';6;31;U;;1093;231;470;647;446;0;4;643;647
8;Barcelona;13;Barcelonès;08101;Hospitalet de Llobregat, l';6;32;U;;921;157;307;393;528;0;7;386;393
8;Barcelona;13;Barcelonès;08101;Hospitalet de Llobregat, l';6;4;U;;643;163;293;339;304;1;2;336;338
8;Barcelona;13;Barcelonès;08101;Hospitalet de Llobregat, l';6;5;U;;669;184;338;424;245;0;3;421;424
8;Barcelona;13;Barcelonès;08101;Hospitalet de Llobregat, l';6;6;U;;888;179;348;464;424;0;5;459;464
8;Barcelona;13;Barcelonès;08101;Hospitalet de Llobregat, l';6;7;U;;931;209;401;520;411;1;4;515;519
8;Barcelona;13;Barcelonès;08101;Hospitalet de Llobregat, l';6;8;U;;842;172;291;408;434;0;4;404;408
8;Barcelona;13;Barcelonès;08101;Hospitalet de Llobregat, l';6;9;U;;823;184;340;448;375;0;4;444;448
8;Barcelona;6;Anoia;08162;Hostalets de Pierola, els;1;1;A;;483;109;225;305;178;4;5;296;301
8;Barcelona;6;Anoia;08162;Hostalets de Pierola, els;1;1;B;;545;140;267;349;196;0;2;347;349
17;Girona;34;Selva;17083;Hostalric;1;1;A;;412;94;216;269;143;1;1;267;268
17;Girona;34;Selva;17083;Hostalric;1;1;B;;479;114;267;323;156;0;2;321;323
17;Girona;34;Selva;17083;Hostalric;1;2;A;;724;153;371;469;255;4;3;462;465
17;Girona;34;Selva;17083;Hostalric;1;2;B;;790;172;368;477;313;0;5;472;477
8;Barcelona;6;Anoia;08102;Igualada;1;1;A;;410;108;209;252;158;0;4;248;252
8;Barcelona;6;Anoia;08102;Igualada;1;1;B;;549;151;268;334;215;0;7;327;334
8;Barcelona;6;Anoia;08102;Igualada;1;3;U;;482;114;204;268;214;0;1;267;268
8;Barcelona;6;Anoia;08102;Igualada;2;1;U;;526;153;263;332;194;0;5;327;332
8;Barcelona;6;Anoia;08102;Igualada;2;2;U;;860;226;417;518;342;0;8;510;518
8;Barcelona;6;Anoia;08102;Igualada;2;3;A;;669;184;355;451;218;1;6;444;450
8;Barcelona;6;Anoia;08102;Igualada;2;3;B;;779;196;357;486;293;1;4;481;485
8;Barcelona;6;Anoia;08102;Igualada;3;1;U;;954;245;492;592;362;2;6;584;590
8;Barcelona;6;Anoia;08102;Igualada;3;2;U;;880;223;418;513;367;0;7;506;513
8;Barcelona;6;Anoia;08102;Igualada;3;3;A;;586;139;304;393;193;1;4;388;392
8;Barcelona;6;Anoia;08102;Igualada;3;3;B;;656;161;328;429;227;0;6;423;429
8;Barcelona;6;Anoia;08102;Igualada;3;4;A;;681;152;304;399;282;1;4;394;398
8;Barcelona;6;Anoia;08102;Igualada;3;4;B;;858;229;407;558;300;2;4;552;556
8;Barcelona;6;Anoia;08102;Igualada;3;5;A;;438;112;208;259;179;0;3;256;259
8;Barcelona;6;Anoia;08102;Igualada;3;5;B;;568;157;292;366;202;0;2;364;366
8;Barcelona;6;Anoia;08102;Igualada;3;6;A;;906;195;437;608;298;1;8;599;607
8;Barcelona;6;Anoia;08102;Igualada;3;6;B;;993;244;506;686;307;3;9;674;683
8;Barcelona;6;Anoia;08102;Igualada;3;7;A;;588;158;305;416;172;1;6;409;415
8;Barcelona;6;Anoia;08102;Igualada;3;7;B;;697;198;390;510;187;1;6;503;509
8;Barcelona;6;Anoia;08102;Igualada;3;8;A;;639;89;263;371;268;3;2;366;368
8;Barcelona;6;Anoia;08102;Igualada;3;8;B;;649;111;288;403;246;1;2;400;402
8;Barcelona;6;Anoia;08102;Igualada;4;1;U;;696;200;346;437;259;3;0;434;434
8;Barcelona;6;Anoia;08102;Igualada;4;2;U;;748;229;384;458;290;1;6;451;457
8;Barcelona;6;Anoia;08102;Igualada;4;3;U;;798;240;440;547;251;2;4;541;545
8;Barcelona;6;Anoia;08102;Igualada;4;4;A;;496;134;232;312;184;1;4;307;311
8;Barcelona;6;Anoia;08102;Igualada;4;4;B;;541;145;266;343;198;2;3;338;341
8;Barcelona;6;Anoia;08102;Igualada;4;5;A;;606;148;304;406;200;4;3;399;402
8;Barcelona;6;Anoia;08102;Igualada;4;5;B;;818;177;377;512;306;2;5;505;510
8;Barcelona;6;Anoia;08102;Igualada;5;1;A;;533;150;259;343;190;0;0;343;343
8;Barcelona;6;Anoia;08102;Igualada;5;1;B;;601;176;319;398;203;0;5;393;398
8;Barcelona;6;Anoia;08102;Igualada;5;2;A;;550;113;243;350;200;0;2;348;350
8;Barcelona;6;Anoia;08102;Igualada;5;2;B;;780;209;391;514;266;0;9;505;514
8;Barcelona;6;Anoia;08102;Igualada;5;3;A;;782;189;373;494;288;0;10;484;494
8;Barcelona;6;Anoia;08102;Igualada;5;3;B;;1019;285;560;663;356;1;7;655;662
8;Barcelona;6;Anoia;08102;Igualada;5;4;A;;604;124;273;380;224;2;3;375;378
8;Barcelona;6;Anoia;08102;Igualada;5;4;B;;689;165;341;473;216;1;2;470;472
8;Barcelona;6;Anoia;08102;Igualada;5;5;U;;685;193;288;382;303;0;2;380;382
8;Barcelona;6;Anoia;08102;Igualada;5;6;A;;494;166;256;288;206;0;3;285;288
8;Barcelona;6;Anoia;08102;Igualada;5;6;B;;537;168;253;302;235;2;5;295;300
8;Barcelona;6;Anoia;08102;Igualada;5;7;A;;597;164;300;399;198;1;2;396;398
8;Barcelona;6;Anoia;08102;Igualada;5;7;B;;696;186;342;445;251;1;9;435;444
25;Lleida;25;Pallars Jussà;25115;Isona i Conca Dellà;1;1;A;;709;130;340;421;288;0;6;415;421
25;Lleida;25;Pallars Jussà;25115;Isona i Conca Dellà;1;1;B;;383;66;145;191;192;3;2;186;188
17;Girona;15;Cerdanya;17084;Isòvol;1;1;U;;173;46;108;121;52;1;2;118;120
25;Lleida;27;Pla d'Urgell;25113;Ivars d'Urgell;1;1;U;;693;178;390;522;171;4;1;517;518
25;Lleida;27;Pla d'Urgell;25113;Ivars d'Urgell;1;2;U;;741;185;414;566;175;1;5;560;565
25;Lleida;23;Noguera;25112;Ivars de Noguera;1;1;U;;297;68;165;237;60;3;5;229;234
25;Lleida;32;Segarra;25114;Ivorra;1;1;U;;142;53;102;122;20;0;2;120;122
17;Girona;10;Baix Empordà;17085;Jafre;1;1;U;;301;129;188;226;75;2;3;221;224
17;Girona;2;Alt Empordà;17086;Jonquera, la;1;1;A;;446;103;188;257;189;0;2;255;257
17;Girona;2;Alt Empordà;17086;Jonquera, la;1;1;B;;441;119;206;252;189;1;1;250;251
17;Girona;2;Alt Empordà;17086;Jonquera, la;1;1;C;;493;109;206;275;218;0;0;275;275
17;Girona;2;Alt Empordà;17086;Jonquera, la;1;2;A;;334;80;153;195;139;0;2;193;195
17;Girona;2;Alt Empordà;17086;Jonquera, la;1;2;B;;325;90;168;207;118;0;4;203;207
8;Barcelona;6;Anoia;08103;Jorba;1;1;U;;483;107;245;288;195;0;3;285;288
25;Lleida;4;Alt Urgell;25910;Josa i Tuixén;1;1;U;;152;32;66;91;61;0;0;91;91
17;Girona;20;Gironès;17087;Juià;1;1;U;;230;59;122;160;70;0;1;159;160
25;Lleida;18;Garrigues;25118;Juncosa;1;1;U;;479;118;244;300;179;0;0;300;300
25;Lleida;18;Garrigues;25119;Juneda;1;1;A;;777;172;384;560;217;4;5;551;556
25;Lleida;18;Garrigues;25119;Juneda;1;1;B;;735;174;348;511;224;4;5;502;507
25;Lleida;18;Garrigues;25119;Juneda;1;2;U;;942;229;536;720;222;4;8;708;716
25;Lleida;39;Consell General d'Aran;25121;Les;1;1;U;;561;161;330;413;148;2;3;408;411
25;Lleida;27;Pla d'Urgell;25122;Linyola;1;1;U;;992;189;535;703;289;3;21;679;700
25;Lleida;27;Pla d'Urgell;25122;Linyola;1;2;U;;1006;229;540;751;255;4;19;728;747
8;Barcelona;6;Anoia;08104;Llacuna, la;1;1;U;;711;180;390;507;204;2;8;497;505
17;Girona;2;Alt Empordà;17088;Lladó;1;1;U;;435;150;254;298;137;2;4;292;296
25;Lleida;26;Pallars Sobirà;25123;Lladorre;1;1;U;;214;35;89;134;80;0;0;134;134
25;Lleida;35;Solsonès;25124;Lladurs;1;1;U;;209;43;84;130;79;0;1;129;130
8;Barcelona;41;Vallès Oriental;08105;Llagosta, la;1;1;A;;483;106;185;247;236;0;2;245;247
8;Barcelona;41;Vallès Oriental;08105;Llagosta, la;1;1;B;;712;146;281;360;352;3;1;356;357
8;Barcelona;41;Vallès Oriental;08105;Llagosta, la;1;2;A;;783;158;309;432;351;0;0;432;432
8;Barcelona;41;Vallès Oriental;08105;Llagosta, la;1;2;B;;914;195;389;529;385;2;7;520;527
8;Barcelona;41;Vallès Oriental;08105;Llagosta, la;1;3;A;;789;165;337;447;342;0;4;443;447
8;Barcelona;41;Vallès Oriental;08105;Llagosta, la;1;3;B;;1009;215;408;554;455;0;5;549;554
8;Barcelona;41;Vallès Oriental;08105;Llagosta, la;1;4;A;;598;122;236;352;246;0;4;348;352
8;Barcelona;41;Vallès Oriental;08105;Llagosta, la;1;4;B;;735;165;330;424;311;1;3;420;423
8;Barcelona;41;Vallès Oriental;08105;Llagosta, la;1;5;A;;602;135;231;303;299;1;3;299;302
8;Barcelona;41;Vallès Oriental;08105;Llagosta, la;1;5;B;;656;163;272;369;287;0;4;365;369
8;Barcelona;41;Vallès Oriental;08105;Llagosta, la;1;6;A;;543;118;227;283;260;1;2;280;282
8;Barcelona;41;Vallès Oriental;08105;Llagosta, la;1;6;B;;706;164;308;378;328;2;4;372;376
8;Barcelona;41;Vallès Oriental;08105;Llagosta, la;1;7;A;;644;154;268;334;310;1;4;329;333
8;Barcelona;41;Vallès Oriental;08105;Llagosta, la;1;7;B;;750;180;307;402;348;3;5;394;399
17;Girona;20;Gironès;17089;Llagostera;1;1;A;;603;156;315;362;241;2;2;358;360
17;Girona;20;Gironès;17089;Llagostera;1;1;B;;723;186;369;448;275;2;6;440;446
17;Girona;20;Gironès;17089;Llagostera;1;2;A;;498;136;284;349;149;4;0;345;345
17;Girona;20;Gironès;17089;Llagostera;1;2;B;;633;165;345;414;219;1;1;412;413
17;Girona;20;Gironès;17089;Llagostera;1;3;U;;1118;268;504;643;475;7;6;630;636
17;Girona;20;Gironès;17089;Llagostera;1;4;U;;882;205;453;570;312;4;2;564;566
17;Girona;20;Gironès;17090;Llambilles;1;1;U;;399;123;216;272;127;0;1;271;272
17;Girona;31;Ripollès;17091;Llanars;1;1;U;;397;106;283;293;104;3;2;288;290
17;Girona;2;Alt Empordà;17092;Llançà;1;1;U;;802;241;422;512;290;0;5;507;512
17;Girona;2;Alt Empordà;17092;Llançà;1;2;A;;809;219;417;543;266;2;7;534;541
17;Girona;2;Alt Empordà;17092;Llançà;1;2;B;;675;178;352;447;228;2;1;444;445
17;Girona;2;Alt Empordà;17092;Llançà;1;3;A;;404;86;203;273;131;0;0;273;273
17;Girona;2;Alt Empordà;17092;Llançà;1;3;B;;435;115;232;296;139;2;2;292;294
25;Lleida;33;Segrià;25125;Llardecans;1;1;U;;538;117;264;352;186;2;7;343;350
25;Lleida;26;Pallars Sobirà;25126;Llavorsí;1;1;U;;253;53;135;186;67;0;2;184;186
25;Lleida;33;Segrià;25120;Lleida;1;1;U;;965;237;484;608;357;0;6;602;608
25;Lleida;33;Segrià;25120;Lleida;1;10;A;;594;113;233;316;278;0;2;314;316
25;Lleida;33;Segrià;25120;Lleida;1;10;B;;775;177;312;409;366;1;5;403;408
25;Lleida;33;Segrià;25120;Lleida;1;11;A;;544;98;212;285;259;0;2;283;285
25;Lleida;33;Segrià;25120;Lleida;1;11;B;;616;109;215;307;309;0;1;306;307
25;Lleida;33;Segrià;25120;Lleida;1;12;U;;891;192;365;502;389;2;7;493;500
25;Lleida;33;Segrià;25120;Lleida;1;13;A;;664;147;288;393;271;1;7;385;392
25;Lleida;33;Segrià;25120;Lleida;1;13;B;;712;166;314;432;280;2;8;422;430
25;Lleida;33;Segrià;25120;Lleida;1;2;U;;565;127;241;303;262;2;3;298;301
25;Lleida;33;Segrià;25120;Lleida;1;3;A;;572;152;255;333;239;0;3;330;333
25;Lleida;33;Segrià;25120;Lleida;1;3;B;;636;138;278;360;276;0;4;356;360
25;Lleida;33;Segrià;25120;Lleida;1;4;A;;694;152;280;364;330;0;5;359;364
25;Lleida;33;Segrià;25120;Lleida;1;4;B;;828;187;360;477;351;0;4;473;477
25;Lleida;33;Segrià;25120;Lleida;1;5;A;;623;103;225;312;311;0;8;304;312
25;Lleida;33;Segrià;25120;Lleida;1;5;B;;928;205;381;486;442;0;4;482;486
25;Lleida;33;Segrià;25120;Lleida;1;6;A;;905;191;357;479;426;2;5;472;477
25;Lleida;33;Segrià;25120;Lleida;1;6;B;;1061;197;414;564;497;0;9;555;564
25;Lleida;33;Segrià;25120;Lleida;1;7;A;;649;102;211;304;345;2;5;297;302
25;Lleida;33;Segrià;25120;Lleida;1;7;B;;727;116;235;331;396;0;4;327;331
25;Lleida;33;Segrià;25120;Lleida;1;8;A;;646;129;273;365;281;0;6;359;365
25;Lleida;33;Segrià;25120;Lleida;1;8;B;;781;171;318;436;345;2;7;427;434
25;Lleida;33;Segrià;25120;Lleida;1;9;U;;1017;262;460;601;416;3;1;597;598
25;Lleida;33;Segrià;25120;Lleida;2;1;U;;772;203;340;416;356;2;11;403;414
25;Lleida;33;Segrià;25120;Lleida;2;2;A;;549;130;246;323;226;2;2;319;321
25;Lleida;33;Segrià;25120;Lleida;2;2;B;;709;168;302;402;307;0;4;398;402
25;Lleida;33;Segrià;25120;Lleida;2;3;U;;827;186;322;433;394;2;3;428;431
25;Lleida;33;Segrià;25120;Lleida;2;4;U;;978;185;365;524;454;1;6;517;523
25;Lleida;33;Segrià;25120;Lleida;2;5;U;;761;151;345;420;341;2;4;414;418
25;Lleida;33;Segrià;25120;Lleida;2;6;U;;984;222;428;586;398;1;7;578;585
25;Lleida;33;Segrià;25120;Lleida;2;7;A;;887;170;355;484;403;0;3;481;484
25;Lleida;33;Segrià;25120;Lleida;2;7;B;;857;151;340;457;400;0;4;453;457
25;Lleida;33;Segrià;25120;Lleida;2;8;A;;585;135;263;358;227;0;5;353;358
25;Lleida;33;Segrià;25120;Lleida;2;8;B;;702;156;331;425;277;1;4;420;424
25;Lleida;33;Segrià;25120;Lleida;2;9;U;;788;152;350;502;286;0;7;495;502
25;Lleida;33;Segrià;25120;Lleida;3;1;U;;738;152;189;271;467;0;2;269;271
25;Lleida;33;Segrià;25120;Lleida;3;3;U;;687;210;393;465;222;4;6;455;461
25;Lleida;33;Segrià;25120;Lleida;3;4;U;;1037;237;557;683;354;2;15;666;681
25;Lleida;33;Segrià;25120;Lleida;3;5;U;;651;127;257;355;296;1;3;351;354
25;Lleida;33;Segrià;25120;Lleida;3;6;A;;516;121;234;313;203;3;3;307;310
25;Lleida;33;Segrià;25120;Lleida;3;6;B;;614;153;272;372;242;1;5;366;371
25;Lleida;33;Segrià;25120;Lleida;3;7;U;;587;137;242;316;271;4;3;309;312
25;Lleida;33;Segrià;25120;Lleida;3;8;U;;886;239;422;547;339;3;3;541;544
25;Lleida;33;Segrià;25120;Lleida;4;1;U;;698;159;229;283;415;0;3;280;283
25;Lleida;33;Segrià;25120;Lleida;4;10;A;;744;114;212;264;480;0;2;262;264
25;Lleida;33;Segrià;25120;Lleida;4;10;B;;615;121;207;261;354;1;4;256;260
25;Lleida;33;Segrià;25120;Lleida;4;11;A;;570;121;200;274;296;1;0;273;273
25;Lleida;33;Segrià;25120;Lleida;4;11;B;;575;122;140;232;343;0;3;229;232
25;Lleida;33;Segrià;25120;Lleida;4;12;U;;797;197;339;375;422;1;1;373;374
25;Lleida;33;Segrià;25120;Lleida;4;13;A;;631;113;234;320;311;1;4;315;319
25;Lleida;33;Segrià;25120;Lleida;4;13;B;;698;126;240;337;361;1;3;333;336
25;Lleida;33;Segrià;25120;Lleida;4;14;U;;704;155;278;357;347;2;5;350;355
25;Lleida;33;Segrià;25120;Lleida;4;15;A;;600;119;250;342;258;3;7;332;339
25;Lleida;33;Segrià;25120;Lleida;4;15;B;;653;140;278;347;306;0;2;345;347
25;Lleida;33;Segrià;25120;Lleida;4;16;A;;644;149;264;372;272;3;6;363;369
25;Lleida;33;Segrià;25120;Lleida;4;16;B;;753;169;336;443;310;0;9;434;443
25;Lleida;33;Segrià;25120;Lleida;4;17;A;;831;164;336;450;381;0;1;449;450
25;Lleida;33;Segrià;25120;Lleida;4;17;B;;834;166;355;473;361;1;3;469;472
25;Lleida;33;Segrià;25120;Lleida;4;2;U;;711;169;298;380;331;0;6;374;380
25;Lleida;33;Segrià;25120;Lleida;4;3;A;;809;203;390;516;293;4;6;506;512
25;Lleida;33;Segrià;25120;Lleida;4;3;B;;888;222;416;558;330;3;10;545;555
25;Lleida;33;Segrià;25120;Lleida;4;4;U;;782;175;351;490;292;1;10;479;489
25;Lleida;33;Segrià;25120;Lleida;4;5;U;;828;184;370;506;322;5;5;496;501
25;Lleida;33;Segrià;25120;Lleida;4;6;A;;622;130;261;372;250;1;9;362;371
25;Lleida;33;Segrià;25120;Lleida;4;6;B;;722;154;301;412;310;0;13;399;412
25;Lleida;33;Segrià;25120;Lleida;4;7;A;;514;142;240;299;215;0;1;298;299
25;Lleida;33;Segrià;25120;Lleida;4;7;B;;566;122;228;316;250;0;2;314;316
25;Lleida;33;Segrià;25120;Lleida;4;8;U;;1019;228;418;549;470;4;4;541;545
25;Lleida;33;Segrià;25120;Lleida;4;9;U;;501;104;159;201;300;0;2;199;201
25;Lleida;33;Segrià;25120;Lleida;5;1;U;;534;88;115;184;350;2;2;180;182
25;Lleida;33;Segrià;25120;Lleida;5;10;U;;991;243;503;627;364;1;13;613;626
25;Lleida;33;Segrià;25120;Lleida;5;11;A;;532;124;286;375;157;2;16;357;373
25;Lleida;33;Segrià;25120;Lleida;5;11;B;;568;111;266;375;193;2;6;367;373
25;Lleida;33;Segrià;25120;Lleida;5;12;U;;823;197;374;501;322;2;9;490;499
25;Lleida;33;Segrià;25120;Lleida;5;2;U;;932;335;548;573;359;0;10;563;573
25;Lleida;33;Segrià;25120;Lleida;5;3;A;;516;145;251;350;166;0;6;344;350
25;Lleida;33;Segrià;25120;Lleida;5;3;B;;569;171;282;370;199;4;4;362;366
25;Lleida;33;Segrià;25120;Lleida;5;4;U;;1013;253;524;674;339;2;13;659;672
25;Lleida;33;Segrià;25120;Lleida;5;5;U;;1045;236;479;654;391;0;17;637;654
25;Lleida;33;Segrià;25120;Lleida;5;6;A;;538;112;255;339;199;2;2;335;337
25;Lleida;33;Segrià;25120;Lleida;5;6;B;;648;140;320;420;228;0;6;414;420
25;Lleida;33;Segrià;25120;Lleida;5;7;U;;775;186;320;406;369;0;2;404;406
25;Lleida;33;Segrià;25120;Lleida;5;8;U;;970;210;464;610;360;1;8;601;609
25;Lleida;33;Segrià;25120;Lleida;5;9;U;;910;227;453;603;307;2;11;590;601
25;Lleida;33;Segrià;25120;Lleida;6;1;A;;481;83;135;172;309;0;0;172;172
25;Lleida;33;Segrià;25120;Lleida;6;1;B;;973;264;500;637;336;6;6;625;631
25;Lleida;33;Segrià;25120;Lleida;6;10;A;;651;152;296;403;248;1;7;395;402
25;Lleida;33;Segrià;25120;Lleida;6;10;B;;696;149;280;384;312;0;1;383;384
25;Lleida;33;Segrià;25120;Lleida;6;11;A;;720;172;324;426;294;1;7;418;425
25;Lleida;33;Segrià;25120;Lleida;6;11;B;;667;156;319;403;264;3;7;393;400
25;Lleida;33;Segrià;25120;Lleida;6;12;A;;661;178;309;421;240;1;5;415;420
25;Lleida;33;Segrià;25120;Lleida;6;12;B;;693;154;309;434;259;0;3;431;434
25;Lleida;33;Segrià;25120;Lleida;6;13;A;;591;150;292;396;195;4;3;389;392
25;Lleida;33;Segrià;25120;Lleida;6;13;B;;641;155;318;411;230;1;7;403;410
25;Lleida;33;Segrià;25120;Lleida;6;14;U;;599;158;259;314;285;1;3;310;313
25;Lleida;33;Segrià;25120;Lleida;6;15;U;;658;152;325;395;263;2;3;390;393
25;Lleida;33;Segrià;25120;Lleida;6;16;U;;627;145;308;412;215;4;8;400;408
25;Lleida;33;Segrià;25120;Lleida;6;2;A;;744;180;347;453;291;3;6;444;450
25;Lleida;33;Segrià;25120;Lleida;6;2;B;;762;180;363;467;295;4;7;456;463
25;Lleida;33;Segrià;25120;Lleida;6;3;A;;843;192;367;494;349;0;6;488;494
25;Lleida;33;Segrià;25120;Lleida;6;3;B;;870;216;386;521;349;0;10;511;521
25;Lleida;33;Segrià;25120;Lleida;6;4;A;;609;121;281;389;220;0;4;385;389
25;Lleida;33;Segrià;25120;Lleida;6;4;B;;620;136;306;408;212;2;8;398;406
25;Lleida;33;Segrià;25120;Lleida;6;5;U;;825;203;415;539;286;2;10;527;537
25;Lleida;33;Segrià;25120;Lleida;6;6;A;;873;135;362;446;427;0;9;437;446
25;Lleida;33;Segrià;25120;Lleida;6;6;B;;1004;209;428;521;483;1;9;511;520
25;Lleida;33;Segrià;25120;Lleida;6;7;A;;680;135;267;352;328;0;3;349;352
25;Lleida;33;Segrià;25120;Lleida;6;7;B;;837;158;307;414;423;0;8;406;414
25;Lleida;33;Segrià;25120;Lleida;6;9;U;;1039;215;417;541;498;0;12;529;541
25;Lleida;33;Segrià;25120;Lleida;7;1;A;;671;121;255;345;326;0;2;343;345
25;Lleida;33;Segrià;25120;Lleida;7;1;B;;747;132;256;362;385;0;4;358;362
25;Lleida;33;Segrià;25120;Lleida;7;2;U;;683;116;238;316;367;0;5;311;316
25;Lleida;33;Segrià;25120;Lleida;7;3;U;;1093;195;479;611;482;0;6;605;611
25;Lleida;33;Segrià;25120;Lleida;7;4;A;;884;200;396;499;385;0;2;497;499
25;Lleida;33;Segrià;25120;Lleida;7;4;B;;982;220;431;546;436;0;7;539;546
25;Lleida;33;Segrià;25120;Lleida;7;5;A;;704;138;272;379;325;0;2;377;379
25;Lleida;33;Segrià;25120;Lleida;7;5;B;;835;161;310;426;409;0;10;416;426
25;Lleida;33;Segrià;25120;Lleida;7;6;A;;881;152;344;459;422;1;8;450;458
25;Lleida;33;Segrià;25120;Lleida;7;6;B;;1001;173;356;507;494;2;6;499;505
25;Lleida;33;Segrià;25120;Lleida;7;7;A;;629;129;256;354;275;0;13;341;354
25;Lleida;33;Segrià;25120;Lleida;7;7;B;;739;128;276;369;370;2;6;361;367
25;Lleida;33;Segrià;25120;Lleida;8;1;A;;579;128;306;367;212;0;4;363;367
25;Lleida;33;Segrià;25120;Lleida;8;1;B;;894;144;344;484;410;0;5;479;484
25;Lleida;33;Segrià;25120;Lleida;8;2;A;;820;190;393;512;308;0;15;497;512
25;Lleida;33;Segrià;25120;Lleida;8;2;B;;370;72;134;197;173;0;1;196;197
25;Lleida;33;Segrià;25120;Lleida;8;2;C;;222;58;112;152;70;0;2;150;152
25;Lleida;33;Segrià;25120;Lleida;8;3;A;;353;83;173;226;127;0;3;223;226
25;Lleida;33;Segrià;25120;Lleida;8;3;B;;537;105;290;360;177;0;1;359;360
25;Lleida;33;Segrià;25120;Lleida;9;1;A;;583;105;261;358;225;0;5;353;358
25;Lleida;33;Segrià;25120;Lleida;9;1;B;;767;135;303;406;361;1;4;401;405
25;Lleida;33;Segrià;25120;Lleida;9;2;A;;773;128;331;448;325;5;5;438;443
25;Lleida;33;Segrià;25120;Lleida;9;2;B;;374;55;120;177;197;2;2;173;175
17;Girona;2;Alt Empordà;17093;Llers;1;1;A;;416;117;206;271;145;1;4;266;270
17;Girona;2;Alt Empordà;17093;Llers;1;1;B;;391;104;199;243;148;2;1;240;241
25;Lleida;15;Cerdanya;25127;Lles de Cerdanya;1;1;U;;254;48;119;160;94;2;1;157;158
8;Barcelona;41;Vallès Oriental;08107;Lliçà d'Amunt;1;1;A;;496;109;236;302;194;1;2;299;301
8;Barcelona;41;Vallès Oriental;08107;Lliçà d'Amunt;1;1;B;;681;179;340;443;238;1;4;438;442
8;Barcelona;41;Vallès Oriental;08107;Lliçà d'Amunt;1;2;A;;777;172;347;476;301;0;4;472;476
8;Barcelona;41;Vallès Oriental;08107;Lliçà d'Amunt;1;2;B;;974;228;429;585;389;3;4;578;582
8;Barcelona;41;Vallès Oriental;08107;Lliçà d'Amunt;1;3;A;;849;202;344;444;405;0;0;444;444
8;Barcelona;41;Vallès Oriental;08107;Lliçà d'Amunt;1;3;B;;1071;292;444;566;505;0;4;562;566
8;Barcelona;41;Vallès Oriental;08107;Lliçà d'Amunt;1;4;A;;458;99;167;221;237;0;1;220;221
8;Barcelona;41;Vallès Oriental;08107;Lliçà d'Amunt;1;4;B;;550;12;196;252;298;0;0;252;252
8;Barcelona;41;Vallès Oriental;08107;Lliçà d'Amunt;1;5;A;;711;176;312;383;328;0;1;382;383
8;Barcelona;41;Vallès Oriental;08107;Lliçà d'Amunt;1;5;B;;826;185;310;386;440;3;5;378;383
8;Barcelona;41;Vallès Oriental;08108;Lliçà de Vall;1;1;A;;1036;206;415;578;458;0;0;578;578
8;Barcelona;41;Vallès Oriental;08108;Lliçà de Vall;1;1;B;;1159;251;506;665;494;0;3;662;665
8;Barcelona;41;Vallès Oriental;08108;Lliçà de Vall;1;2;A;;882;203;407;564;318;1;3;560;563
8;Barcelona;41;Vallès Oriental;08108;Lliçà de Vall;1;2;B;;997;233;472;633;364;3;1;629;630
25;Lleida;25;Pallars Jussà;25128;Llimiana;1;1;U;;127;25;36;63;64;0;0;63;63
8;Barcelona;41;Vallès Oriental;08106;Llinars del Vallès;1;1;A;;490;123;236;314;176;0;4;310;314
8;Barcelona;41;Vallès Oriental;08106;Llinars del Vallès;1;1;B;;459;94;205;272;187;0;0;272;272
8;Barcelona;41;Vallès Oriental;08106;Llinars del Vallès;1;2;A;;614;153;262;341;273;1;2;338;340
8;Barcelona;41;Vallès Oriental;08106;Llinars del Vallès;1;2;B;;726;173;295;392;334;1;2;389;391
8;Barcelona;41;Vallès Oriental;08106;Llinars del Vallès;2;1;A;;819;171;366;472;347;1;1;470;471
8;Barcelona;41;Vallès Oriental;08106;Llinars del Vallès;2;1;B;;891;199;416;526;365;4;1;521;522
8;Barcelona;41;Vallès Oriental;08106;Llinars del Vallès;2;2;A;;769;150;349;455;314;1;3;451;454
8;Barcelona;41;Vallès Oriental;08106;Llinars del Vallès;2;2;B;;787;177;339;447;340;1;3;443;446
17;Girona;15;Cerdanya;17094;Llívia;1;1;U;;852;227;451;540;312;4;7;529;536
43;Tarragona;29;Priorat;43072;Lloar, el;1;1;U;;114;38;71;85;29;0;5;80;85
25;Lleida;35;Solsonès;25129;Llobera;1;1;U;;215;49;87;122;93;0;5;117;122
43;Tarragona;16;Conca de Barberà;43073;Llorac;1;1;U;;104;28;44;69;35;2;0;67;67
43;Tarragona;12;Baix Penedès;43074;Llorenç del Penedès;1;1;A;;530;63;309;390;140;3;5;382;387
43;Tarragona;12;Baix Penedès;43074;Llorenç del Penedès;1;1;B;;697;248;409;538;159;3;6;529;535
17;Girona;34;Selva;17095;Lloret de Mar;1;1;A;;884;162;309;404;480;0;2;402;404
17;Girona;34;Selva;17095;Lloret de Mar;1;1;B;;836;143;326;424;412;3;2;419;421
17;Girona;34;Selva;17095;Lloret de Mar;1;2;A;;711;156;331;401;310;0;4;397;401
17;Girona;34;Selva;17095;Lloret de Mar;1;2;B;;584;140;277;327;257;1;0;326;326
17;Girona;34;Selva;17095;Lloret de Mar;2;1;A;;738;187;359;438;300;7;4;427;431
17;Girona;34;Selva;17095;Lloret de Mar;2;1;B;;717;179;381;458;259;5;0;453;453
17;Girona;34;Selva;17095;Lloret de Mar;2;2;A;;726;149;320;406;320;0;6;400;406
17;Girona;34;Selva;17095;Lloret de Mar;2;2;B;;685;139;286;367;318;1;1;365;366
17;Girona;34;Selva;17095;Lloret de Mar;2;3;A;;626;132;259;322;304;0;1;321;322
17;Girona;34;Selva;17095;Lloret de Mar;2;3;B;;630;145;282;353;277;2;5;346;351
17;Girona;34;Selva;17095;Lloret de Mar;3;1;A;;1011;159;367;495;516;3;0;492;492
17;Girona;34;Selva;17095;Lloret de Mar;3;1;B;;1003;171;369;508;495;0;1;507;508
17;Girona;34;Selva;17095;Lloret de Mar;3;2;A;;711;148;291;389;322;0;3;386;389
17;Girona;34;Selva;17095;Lloret de Mar;3;2;B;;615;142;274;342;273;0;4;338;342
17;Girona;34;Selva;17095;Lloret de Mar;3;3;U;;1034;175;372;489;545;2;4;483;487
17;Girona;34;Selva;17095;Lloret de Mar;4;1;A;;637;102;237;313;324;0;2;311;313
17;Girona;34;Selva;17095;Lloret de Mar;4;1;B;;599;95;204;295;304;0;2;293;295
17;Girona;34;Selva;17095;Lloret de Mar;4;2;A;;457;66;166;235;222;1;0;234;234
17;Girona;34;Selva;17095;Lloret de Mar;4;2;B;;623;89;204;303;320;2;0;301;301
17;Girona;34;Selva;17095;Lloret de Mar;4;2;C;;533;78;171;261;272;1;1;259;260
17;Girona;31;Ripollès;17096;Llosses, les;1;1;U;;271;36;97;134;137;2;0;132;132
8;Barcelona;24;Osona;08109;Lluçà;1;1;U;;230;67;129;178;52;0;0;178;178
17;Girona;2;Alt Empordà;17102;Maçanet de Cabrenys;1;1;U;;573;170;316;428;145;0;5;423;428
17;Girona;34;Selva;17103;Maçanet de la Selva;1;1;A;;839;180;400;517;322;2;2;513;515
17;Girona;34;Selva;17103;Maçanet de la Selva;1;1;B;;935;187;430;557;378;0;4;553;557
17;Girona;34;Selva;17103;Maçanet de la Selva;1;2;A;;673;141;230;298;375;1;1;296;297
17;Girona;34;Selva;17103;Maçanet de la Selva;1;2;B;;666;167;265;338;328;0;0;338;338
17;Girona;20;Gironès;17097;Madremanya;1;1;U;;164;44;85;116;48;1;1;114;115
17;Girona;19;Garrotxa;17098;Maià de Montcal;1;1;U;;281;85;173;202;79;1;2;199;201
25;Lleida;33;Segrià;25133;Maials;1;1;U;;877;195;456;621;256;1;3;617;620
25;Lleida;38;Urgell;25130;Maldà;1;1;U;;243;54;128;165;78;1;0;164;164
8;Barcelona;21;Maresme;08110;Malgrat de Mar;1;1;A;;631;175;320;404;227;1;1;402;403
8;Barcelona;21;Maresme;08110;Malgrat de Mar;1;1;B;;728;157;312;420;308;0;1;419;420
8;Barcelona;21;Maresme;08110;Malgrat de Mar;1;1;C;;656;160;290;372;284;0;2;370;372
8;Barcelona;21;Maresme;08110;Malgrat de Mar;1;2;A;;601;188;320;386;215;1;4;381;385
8;Barcelona;21;Maresme;08110;Malgrat de Mar;1;2;B;;795;207;400;488;307;0;1;487;488
8;Barcelona;21;Maresme;08110;Malgrat de Mar;1;3;A;;570;126;254;326;244;0;1;325;326
8;Barcelona;21;Maresme;08110;Malgrat de Mar;1;3;B;;690;164;331;403;287;1;1;401;402
8;Barcelona;21;Maresme;08110;Malgrat de Mar;1;4;A;;720;152;309;387;333;1;5;381;386
8;Barcelona;21;Maresme;08110;Malgrat de Mar;1;4;B;;823;222;363;469;354;0;3;466;469
8;Barcelona;21;Maresme;08110;Malgrat de Mar;1;5;A;;638;142;282;363;275;0;2;361;363
8;Barcelona;21;Maresme;08110;Malgrat de Mar;1;5;B;;696;183;315;412;284;0;2;410;412
8;Barcelona;21;Maresme;08110;Malgrat de Mar;2;1;A;;561;154;272;339;222;2;4;333;337
8;Barcelona;21;Maresme;08110;Malgrat de Mar;2;1;B;;634;156;294;370;264;0;2;368;370
8;Barcelona;21;Maresme;08110;Malgrat de Mar;2;1;C;;664;171;326;408;256;1;4;403;407
8;Barcelona;21;Maresme;08110;Malgrat de Mar;2;2;A;;502;197;245;314;188;1;3;310;313
8;Barcelona;21;Maresme;08110;Malgrat de Mar;2;2;B;;485;115;229;307;178;0;1;306;307
8;Barcelona;21;Maresme;08110;Malgrat de Mar;2;2;C;;576;139;272;371;205;2;3;366;369
8;Barcelona;24;Osona;08111;Malla;1;1;U;;215;60;122;170;45;0;3;167;170
8;Barcelona;24;Osona;08112;Manlleu;1;1;A;;591;204;360;410;181;1;2;407;409
8;Barcelona;24;Osona;08112;Manlleu;1;1;B;;654;223;372;449;205;4;1;444;445
8;Barcelona;24;Osona;08112;Manlleu;1;2;U;;670;233;415;510;160;1;5;504;509
8;Barcelona;24;Osona;08112;Manlleu;2;1;A;;615;162;329;424;191;0;4;420;424
8;Barcelona;24;Osona;08112;Manlleu;2;1;B;;789;243;440;552;237;1;2;549;551
8;Barcelona;24;Osona;08112;Manlleu;2;2;A;;619;132;284;394;225;3;3;388;391
8;Barcelona;24;Osona;08112;Manlleu;2;2;B;;780;190;387;512;268;1;2;509;511
8;Barcelona;24;Osona;08112;Manlleu;2;3;A;;503;156;290;374;129;0;2;372;374
8;Barcelona;24;Osona;08112;Manlleu;2;3;B;;538;162;307;383;155;0;4;379;383
8;Barcelona;24;Osona;08112;Manlleu;2;4;A;;530;140;285;369;161;0;0;369;369
8;Barcelona;24;Osona;08112;Manlleu;2;4;B;;619;151;305;448;171;1;3;444;447
8;Barcelona;24;Osona;08112;Manlleu;3;1;A;;633;146;311;407;226;1;1;405;406
8;Barcelona;24;Osona;08112;Manlleu;3;1;B;;637;121;209;393;244;1;3;389;392
8;Barcelona;24;Osona;08112;Manlleu;3;1;C;;561;140;265;351;210;1;7;343;350
8;Barcelona;24;Osona;08112;Manlleu;3;2;A;;703;194;359;484;219;0;4;480;484
8;Barcelona;24;Osona;08112;Manlleu;3;2;B;;821;229;405;535;286;1;7;527;534
8;Barcelona;24;Osona;08112;Manlleu;3;3;A;;683;181;334;427;256;0;1;426;427
8;Barcelona;24;Osona;08112;Manlleu;3;3;B;;768;210;385;489;279;1;5;483;488
8;Barcelona;24;Osona;08112;Manlleu;4;1;U;;593;164;356;433;160;0;5;428;433
8;Barcelona;24;Osona;08112;Manlleu;4;2;A;;576;165;333;415;161;1;0;414;414
8;Barcelona;24;Osona;08112;Manlleu;4;2;B;;685;200;384;488;197;1;2;485;487
8;Barcelona;7;Bages;08113;Manresa;1;1;U;;812;227;349;435;377;1;5;429;434
8;Barcelona;7;Bages;08113;Manresa;1;2;U;;681;194;314;385;296;3;4;378;382
8;Barcelona;7;Bages;08113;Manresa;2;1;U;;816;235;446;569;247;0;10;559;569
8;Barcelona;7;Bages;08113;Manresa;2;10;A;;645;195;344;438;207;0;4;434;438
8;Barcelona;7;Bages;08113;Manresa;2;10;B;;777;227;398;517;260;1;4;512;516
8;Barcelona;7;Bages;08113;Manresa;2;11;A;;567;134;258;346;221;2;2;342;344
8;Barcelona;7;Bages;08113;Manresa;2;11;B;;697;160;316;426;271;0;12;414;426
8;Barcelona;7;Bages;08113;Manresa;2;12;U;;820;193;341;470;350;0;6;464;470
8;Barcelona;7;Bages;08113;Manresa;2;13;A;;540;115;261;348;192;0;3;345;348
8;Barcelona;7;Bages;08113;Manresa;2;13;B;;631;165;327;403;228;3;2;398;400
8;Barcelona;7;Bages;08113;Manresa;2;14;U;;559;98;189;269;290;0;2;267;269
8;Barcelona;7;Bages;08113;Manresa;2;2;A;;683;179;345;440;243;0;4;436;440
8;Barcelona;7;Bages;08113;Manresa;2;2;B;;875;254;488;597;278;3;6;588;594
8;Barcelona;7;Bages;08113;Manresa;2;3;A;;604;137;280;388;216;4;5;379;384
8;Barcelona;7;Bages;08113;Manresa;2;3;B;;863;242;434;571;292;3;9;559;568
8;Barcelona;7;Bages;08113;Manresa;2;4;A;;732;211;371;489;243;3;5;481;486
8;Barcelona;7;Bages;08113;Manresa;2;4;B;;1022;249;495;666;356;1;4;661;665
8;Barcelona;7;Bages;08113;Manresa;2;5;A;;736;230;397;497;239;0;6;491;497
8;Barcelona;7;Bages;08113;Manresa;2;5;B;;812;240;421;538;274;2;6;530;536
8;Barcelona;7;Bages;08113;Manresa;2;6;U;;655;176;293;354;301;0;8;346;354
8;Barcelona;7;Bages;08113;Manresa;2;7;A;;387;87;167;207;180;0;5;202;207
8;Barcelona;7;Bages;08113;Manresa;2;7;B;;545;159;267;332;213;1;6;325;331
8;Barcelona;7;Bages;08113;Manresa;2;8;U;;637;155;276;351;286;0;0;351;351
8;Barcelona;7;Bages;08113;Manresa;2;9;A;;676;159;296;386;290;0;1;385;386
8;Barcelona;7;Bages;08113;Manresa;2;9;B;;826;196;385;500;326;0;1;499;500
8;Barcelona;7;Bages;08113;Manresa;3;1;U;;800;220;351;439;361;3;5;431;436
8;Barcelona;7;Bages;08113;Manresa;3;2;U;;651;192;273;353;298;1;6;346;352
8;Barcelona;7;Bages;08113;Manresa;3;4;A;;441;144;238;295;146;0;5;290;295
8;Barcelona;7;Bages;08113;Manresa;3;4;B;;639;194;332;410;229;1;4;405;409
8;Barcelona;7;Bages;08113;Manresa;3;5;U;;1006;281;503;624;382;1;6;617;623
8;Barcelona;7;Bages;08113;Manresa;3;6;A;;412;99;193;257;155;2;1;254;255
8;Barcelona;7;Bages;08113;Manresa;3;6;B;;583;149;276;357;226;1;3;353;356
8;Barcelona;7;Bages;08113;Manresa;4;1;U;;463;161;256;305;158;0;3;302;305
8;Barcelona;7;Bages;08113;Manresa;4;11;U;;796;177;329;491;305;3;6;482;488
8;Barcelona;7;Bages;08113;Manresa;4;12;U;;675;167;303;395;280;0;2;393;395
8;Barcelona;7;Bages;08113;Manresa;4;13;U;;957;263;505;623;334;0;5;618;623
8;Barcelona;7;Bages;08113;Manresa;4;2;A;;552;165;301;367;185;8;2;357;359
8;Barcelona;7;Bages;08113;Manresa;4;2;B;;585;186;312;378;207;2;4;372;376
8;Barcelona;7;Bages;08113;Manresa;4;3;U;;813;248;415;512;301;0;3;509;512
8;Barcelona;7;Bages;08113;Manresa;4;4;A;;668;205;347;456;212;1;4;451;455
8;Barcelona;7;Bages;08113;Manresa;4;4;B;;929;247;489;620;309;0;9;611;620
8;Barcelona;7;Bages;08113;Manresa;4;5;A;;783;193;348;485;298;1;1;483;484
8;Barcelona;7;Bages;08113;Manresa;4;5;B;;978;230;439;580;398;2;13;565;578
8;Barcelona;7;Bages;08113;Manresa;4;6;A;;608;179;318;424;184;0;5;419;424
8;Barcelona;7;Bages;08113;Manresa;4;6;B;;741;224;380;501;240;0;4;497;501
8;Barcelona;7;Bages;08113;Manresa;4;7;A;;676;140;287;392;284;0;3;389;392
8;Barcelona;7;Bages;08113;Manresa;4;7;B;;805;177;344;461;344;1;4;456;460
8;Barcelona;7;Bages;08113;Manresa;4;8;A;;743;211;383;493;250;0;0;493;493
8;Barcelona;7;Bages;08113;Manresa;4;8;B;;933;255;483;612;321;0;9;603;612
8;Barcelona;7;Bages;08113;Manresa;4;9;A;;593;114;268;354;239;3;0;351;351
8;Barcelona;7;Bages;08113;Manresa;4;9;B;;687;127;280;382;305;0;7;375;382
8;Barcelona;7;Bages;08113;Manresa;5;1;U;;936;190;348;481;455;1;0;480;480
8;Barcelona;7;Bages;08113;Manresa;5;10;A;;505;122;223;289;216;0;4;285;289
8;Barcelona;7;Bages;08113;Manresa;5;10;B;;566;149;350;327;239;0;5;322;327
8;Barcelona;7;Bages;08113;Manresa;5;11;A;;500;127;240;312;188;0;2;310;312
8;Barcelona;7;Bages;08113;Manresa;5;11;B;;613;144;282;365;248;0;6;359;365
8;Barcelona;7;Bages;08113;Manresa;5;12;U;;785;214;372;458;327;1;2;455;457
8;Barcelona;7;Bages;08113;Manresa;5;13;A;;567;132;251;334;233;1;3;330;333
8;Barcelona;7;Bages;08113;Manresa;5;13;B;;636;177;304;403;233;3;2;398;400
8;Barcelona;7;Bages;08113;Manresa;5;14;A;;523;142;249;335;188;0;5;330;335
8;Barcelona;7;Bages;08113;Manresa;5;14;B;;655;185;337;446;209;2;4;440;444
8;Barcelona;7;Bages;08113;Manresa;5;15;A;;614;116;230;295;319;0;5;290;295
8;Barcelona;7;Bages;08113;Manresa;5;15;B;;734;155;286;370;364;0;2;368;370
8;Barcelona;7;Bages;08113;Manresa;5;16;U;;548;154;245;308;240;2;2;304;306
8;Barcelona;7;Bages;08113;Manresa;5;17;A;;478;87;208;308;170;0;4;304;308
8;Barcelona;7;Bages;08113;Manresa;5;17;B;;745;132;341;469;276;1;0;468;468
8;Barcelona;7;Bages;08113;Manresa;5;18;U;;714;91;206;335;379;1;6;328;334
8;Barcelona;7;Bages;08113;Manresa;5;2;A;;513;128;230;292;221;1;0;291;291
8;Barcelona;7;Bages;08113;Manresa;5;2;B;;581;144;247;321;260;4;3;314;317
8;Barcelona;7;Bages;08113;Manresa;5;3;U;;879;224;393;534;345;3;3;528;531
8;Barcelona;7;Bages;08113;Manresa;5;4;U;;586;216;318;410;176;0;4;406;410
8;Barcelona;7;Bages;08113;Manresa;5;5;A;;535;144;257;313;222;1;5;307;312
8;Barcelona;7;Bages;08113;Manresa;5;5;B;;598;147;276;353;245;2;4;347;351
8;Barcelona;7;Bages;08113;Manresa;5;6;A;;628;154;282;375;253;0;3;372;375
8;Barcelona;7;Bages;08113;Manresa;5;6;B;;797;208;375;500;297;2;4;494;498
8;Barcelona;7;Bages;08113;Manresa;5;7;U;;422;98;184;233;189;3;3;227;230
8;Barcelona;7;Bages;08113;Manresa;5;8;U;;569;139;262;345;224;1;1;343;344
8;Barcelona;7;Bages;08113;Manresa;6;1;A;;488;121;239;275;213;1;2;272;274
8;Barcelona;7;Bages;08113;Manresa;6;1;B;;586;138;273;324;262;1;2;321;323
8;Barcelona;7;Bages;08113;Manresa;6;2;U;;891;197;405;493;398;2;6;485;491
43;Tarragona;29;Priorat;43076;Marçà;1;1;U;;499;162;296;359;140;2;2;355;357
43;Tarragona;29;Priorat;43075;Margalef;1;1;U;;113;45;58;71;42;0;0;71;71
8;Barcelona;7;Bages;08242;Marganell;1;1;U;;223;48;120;150;73;0;0;150;150
8;Barcelona;11;Baix Llobregat;08114;Martorell;1;1;A;;445;121;223;295;150;2;3;290;293
8;Barcelona;11;Baix Llobregat;08114;Martorell;1;1;B;;432;113;206;274;158;1;2;271;273
8;Barcelona;11;Baix Llobregat;08114;Martorell;2;1;U;;600;144;274;341;259;0;3;338;341
8;Barcelona;11;Baix Llobregat;08114;Martorell;2;2;A;;469;127;237;299;170;1;6;292;298
8;Barcelona;11;Baix Llobregat;08114;Martorell;2;2;B;;518;150;268;333;185;2;1;330;331
8;Barcelona;11;Baix Llobregat;08114;Martorell;3;1;A;;648;157;274;362;286;3;4;355;359
8;Barcelona;11;Baix Llobregat;08114;Martorell;3;1;B;;593;118;228;307;286;0;2;305;307
8;Barcelona;11;Baix Llobregat;08114;Martorell;3;1;C;;685;144;280;370;315;2;6;362;368
8;Barcelona;11;Baix Llobregat;08114;Martorell;3;2;A;;416;125;198;245;171;0;0;245;245
8;Barcelona;11;Baix Llobregat;08114;Martorell;3;2;B;;411;145;214;251;160;0;0;251;251
8;Barcelona;11;Baix Llobregat;08114;Martorell;3;3;A;;365;101;163;202;163;0;1;201;202
8;Barcelona;11;Baix Llobregat;08114;Martorell;3;3;B;;440;127;227;265;175;1;0;264;264
8;Barcelona;11;Baix Llobregat;08114;Martorell;3;4;A;;508;126;245;304;204;0;2;302;304
8;Barcelona;11;Baix Llobregat;08114;Martorell;3;4;B;;601;132;245;311;290;1;3;307;310
8;Barcelona;11;Baix Llobregat;08114;Martorell;3;4;C;;570;145;269;328;242;1;1;326;327
8;Barcelona;11;Baix Llobregat;08114;Martorell;3;5;A;;545;156;248;318;227;0;0;318;318
8;Barcelona;11;Baix Llobregat;08114;Martorell;3;5;B;;589;179;293;360;229;0;3;357;360
8;Barcelona;11;Baix Llobregat;08114;Martorell;3;6;A;;579;169;272;367;212;1;1;365;366
8;Barcelona;11;Baix Llobregat;08114;Martorell;3;6;B;;561;148;255;331;230;0;2;329;331
8;Barcelona;11;Baix Llobregat;08114;Martorell;3;6;C;;582;137;260;347;235;0;0;347;347
8;Barcelona;11;Baix Llobregat;08114;Martorell;3;7;A;;812;164;386;505;307;1;5;499;504
8;Barcelona;11;Baix Llobregat;08114;Martorell;3;7;B;;886;165;358;493;393;0;5;488;493
8;Barcelona;11;Baix Llobregat;08114;Martorell;3;8;A;;736;168;349;464;272;0;9;455;464
8;Barcelona;11;Baix Llobregat;08114;Martorell;3;8;B;;871;170;386;520;351;0;6;514;520
8;Barcelona;11;Baix Llobregat;08114;Martorell;3;9;A;;897;180;375;550;347;1;3;546;549
8;Barcelona;11;Baix Llobregat;08114;Martorell;3;9;B;;1063;204;410;596;467;0;2;594;596
8;Barcelona;11;Baix Llobregat;08114;Martorell;3;9;C;;1046;215;474;643;403;9;2;632;634
8;Barcelona;41;Vallès Oriental;08115;Martorelles;1;1;A;;441;103;194;265;176;0;2;263;265
8;Barcelona;41;Vallès Oriental;08115;Martorelles;1;1;B;;570;119;227;316;254;1;2;313;315
8;Barcelona;41;Vallès Oriental;08115;Martorelles;1;1;C;;588;112;232;337;251;1;2;334;336
8;Barcelona;41;Vallès Oriental;08115;Martorelles;1;2;A;;567;120;243;335;232;1;2;332;334
8;Barcelona;41;Vallès Oriental;08115;Martorelles;1;2;B;;767;175;353;478;289;0;2;476;478
8;Barcelona;41;Vallès Oriental;08115;Martorelles;1;3;A;;492;117;223;290;202;1;1;288;289
8;Barcelona;41;Vallès Oriental;08115;Martorelles;1;3;B;;630;139;266;359;271;1;2;356;358
17;Girona;2;Alt Empordà;17100;Masarac;1;1;U;;216;72;133;154;62;0;1;153;154
43;Tarragona;22;Montsià;43077;Mas de Barberans;1;1;U;;600;215;311;375;225;1;3;371;374
43;Tarragona;22;Montsià;43078;Masdenverge;1;1;U;;739;170;404;492;247;2;6;484;490
8;Barcelona;24;Osona;08116;Masies de Roda, les;1;1;U;;519;151;311;397;122;1;2;394;396
8;Barcelona;24;Osona;08117;Masies de Voltregà, les;1;1;A;;610;169;300;399;211;1;4;394;398
8;Barcelona;24;Osona;08117;Masies de Voltregà, les;1;1;B;;509;140;281;376;133;0;1;375;376
8;Barcelona;24;Osona;08117;Masies de Voltregà, les;1;1;C;;482;145;289;377;105;2;2;373;375
8;Barcelona;24;Osona;08117;Masies de Voltregà, les;2;1;U;;578;142;271;352;226;0;2;350;352
43;Tarragona;12;Baix Penedès;43079;Masllorenç;1;1;U;;349;89;229;280;69;0;3;277;280
8;Barcelona;21;Maresme;08118;Masnou, el;1;1;A;;689;125;316;416;273;0;4;412;416
8;Barcelona;21;Maresme;08118;Masnou, el;1;1;B;;746;151;327;467;279;1;3;463;466
8;Barcelona;21;Maresme;08118;Masnou, el;1;2;A;;733;185;341;425;308;0;6;419;425
8;Barcelona;21;Maresme;08118;Masnou, el;1;2;B;;879;220;416;529;350;0;7;522;529
8;Barcelona;21;Maresme;08118;Masnou, el;1;3;A;;738;235;376;463;275;2;5;456;461
8;Barcelona;21;Maresme;08118;Masnou, el;1;3;B;;820;203;380;476;344;0;6;470;476
8;Barcelona;21;Maresme;08118;Masnou, el;1;4;A;;617;145;319;393;224;0;5;388;393
8;Barcelona;21;Maresme;08118;Masnou, el;1;4;B;;752;195;370;474;278;0;6;468;474
8;Barcelona;21;Maresme;08118;Masnou, el;1;5;A;;918;246;454;569;349;3;1;565;566
8;Barcelona;21;Maresme;08118;Masnou, el;1;5;B;;1003;275;498;632;371;1;5;626;631
8;Barcelona;21;Maresme;08118;Masnou, el;1;6;A;;715;153;319;401;314;1;2;398;400
8;Barcelona;21;Maresme;08118;Masnou, el;1;6;B;;820;175;366;441;379;0;2;439;441
8;Barcelona;21;Maresme;08118;Masnou, el;1;7;A;;645;151;316;394;251;0;4;390;394
8;Barcelona;21;Maresme;08118;Masnou, el;1;7;B;;719;163;304;420;299;1;3;416;419
8;Barcelona;21;Maresme;08118;Masnou, el;1;8;U;;1175;285;553;682;493;0;5;677;682
8;Barcelona;21;Maresme;08118;Masnou, el;1;9;U;;618;170;326;399;219;0;2;397;399
8;Barcelona;21;Maresme;08118;Masnou, el;2;1;A;;675;166;335;430;245;1;3;426;429
8;Barcelona;21;Maresme;08118;Masnou, el;2;1;B;;725;165;340;455;270;1;2;452;454
8;Barcelona;21;Maresme;08118;Masnou, el;2;2;U;;859;230;418;549;310;1;6;542;548
8;Barcelona;21;Maresme;08118;Masnou, el;2;3;A;;516;150;267;336;180;0;3;333;336
8;Barcelona;21;Maresme;08118;Masnou, el;2;3;B;;571;171;280;339;232;1;6;332;338
8;Barcelona;21;Maresme;08118;Masnou, el;2;4;A;;669;151;298;373;296;2;3;368;371
8;Barcelona;21;Maresme;08118;Masnou, el;2;4;B;;766;194;347;440;326;0;6;434;440
43;Tarragona;1;Alt Camp;43080;Masó, la;1;1;U;;234;63;133;179;55;1;3;175;178
43;Tarragona;8;Baix Camp;43081;Maspujols;1;1;U;;386;112;257;299;87;1;6;292;298
8;Barcelona;6;Anoia;08119;Masquefa;1;1;A;;573;150;296;382;191;0;3;379;382
8;Barcelona;6;Anoia;08119;Masquefa;1;1;B;;603;140;294;397;206;0;3;394;397
8;Barcelona;6;Anoia;08119;Masquefa;1;1;C;;592;134;270;357;235;0;3;354;357
8;Barcelona;6;Anoia;08119;Masquefa;1;1;D;;494;106;234;305;189;0;2;303;305
8;Barcelona;6;Anoia;08119;Masquefa;1;2;A;;801;170;317;412;389;0;1;411;412
8;Barcelona;6;Anoia;08119;Masquefa;1;2;B;;482;111;208;258;224;2;1;255;256
43;Tarragona;29;Priorat;43082;Masroig, el;1;1;U;;451;141;288;374;77;5;5;364;369
25;Lleida;33;Segrià;25131;Massalcoreig;1;1;U;;554;186;308;370;184;3;1;366;367
17;Girona;34;Selva;17101;Massanes;1;1;U;;457;130;250;293;164;1;1;291;292
25;Lleida;32;Segarra;25132;Massoteres;1;1;U;;158;48;77;106;52;0;0;106;106
8;Barcelona;40;Vallès Occidental;08120;Matadepera;1;1;A;;1141;278;610;808;333;3;2;803;805
8;Barcelona;40;Vallès Occidental;08120;Matadepera;1;1;B;;1217;293;738;766;451;2;12;752;764
8;Barcelona;40;Vallès Occidental;08120;Matadepera;1;2;A;;727;143;402;550;177;1;5;544;549
8;Barcelona;40;Vallès Occidental;08120;Matadepera;1;2;B;;756;161;405;548;208;1;6;541;547
8;Barcelona;40;Vallès Occidental;08120;Matadepera;1;3;A;;697;150;362;494;203;0;6;488;494
8;Barcelona;40;Vallès Occidental;08120;Matadepera;1;3;B;;809;196;414;559;250;0;3;556;559
8;Barcelona;21;Maresme;08121;Mataró;1;1;U;;654;229;377;454;200;0;1;453;454
8;Barcelona;21;Maresme;08121;Mataró;1;2;A;;465;161;265;309;156;0;2;307;309
8;Barcelona;21;Maresme;08121;Mataró;1;2;B;;504;200;327;370;134;0;1;369;370
8;Barcelona;21;Maresme;08121;Mataró;1;3;A;;502;191;301;366;136;0;4;362;366
8;Barcelona;21;Maresme;08121;Mataró;1;3;B;;484;180;294;350;134;0;3;347;350
8;Barcelona;21;Maresme;08121;Mataró;1;4;A;;438;164;269;324;114;0;0;324;324
8;Barcelona;21;Maresme;08121;Mataró;1;4;B;;504;212;302;364;140;1;2;361;363
8;Barcelona;21;Maresme;08121;Mataró;1;5;A;;590;184;330;424;166;0;4;420;424
8;Barcelona;21;Maresme;08121;Mataró;1;5;B;;673;221;386;492;181;3;6;483;489
8;Barcelona;21;Maresme;08121;Mataró;1;6;A;;671;218;420;510;161;2;2;506;508
8;Barcelona;21;Maresme;08121;Mataró;1;6;B;;537;163;269;355;182;1;2;352;354
8;Barcelona;21;Maresme;08121;Mataró;1;6;C;;695;254;404;491;204;1;2;488;490
8;Barcelona;21;Maresme;08121;Mataró;1;7;A;;515;168;295;370;145;0;4;366;370
8;Barcelona;21;Maresme;08121;Mataró;1;7;B;;599;189;334;421;178;0;0;421;421
8;Barcelona;21;Maresme;08121;Mataró;1;8;U;;523;221;327;375;148;2;4;369;373
8;Barcelona;21;Maresme;08121;Mataró;2;1;A;;645;193;342;435;210;2;2;431;433
8;Barcelona;21;Maresme;08121;Mataró;2;1;B;;687;204;385;466;221;2;5;459;464
8;Barcelona;21;Maresme;08121;Mataró;2;10;U;;861;291;486;574;287;1;4;569;573
8;Barcelona;21;Maresme;08121;Mataró;2;11;A;;494;144;272;327;167;1;1;325;326
8;Barcelona;21;Maresme;08121;Mataró;2;11;B;;492;132;239;300;192;0;2;298;300
8;Barcelona;21;Maresme;08121;Mataró;2;12;U;;865;266;514;615;250;0;4;611;615
8;Barcelona;21;Maresme;08121;Mataró;2;2;U;;834;254;428;515;319;0;1;514;515
8;Barcelona;21;Maresme;08121;Mataró;2;3;U;;526;155;236;303;223;0;0;303;303
8;Barcelona;21;Maresme;08121;Mataró;2;4;U;;750;202;327;401;349;3;1;397;398
8;Barcelona;21;Maresme;08121;Mataró;2;5;A;;703;178;338;433;270;1;7;425;432
8;Barcelona;21;Maresme;08121;Mataró;2;5;B;;817;215;385;493;324;0;5;488;493
8;Barcelona;21;Maresme;08121;Mataró;2;6;A;;587;246;351;358;229;0;2;356;358
8;Barcelona;21;Maresme;08121;Mataró;2;6;B;;738;192;342;421;317;0;3;418;421
8;Barcelona;21;Maresme;08121;Mataró;2;7;U;;430;125;214;284;146;0;1;283;284
8;Barcelona;21;Maresme;08121;Mataró;2;8;A;;640;189;353;443;197;0;9;434;443
8;Barcelona;21;Maresme;08121;Mataró;2;8;B;;640;196;366;454;186;0;2;452;454
8;Barcelona;21;Maresme;08121;Mataró;2;9;U;;941;297;533;661;280;4;0;657;657
8;Barcelona;21;Maresme;08121;Mataró;3;1;A;;519;167;274;333;186;0;1;332;333
8;Barcelona;21;Maresme;08121;Mataró;3;1;B;;621;204;314;391;230;0;2;389;391
8;Barcelona;21;Maresme;08121;Mataró;3;10;U;;640;199;363;454;186;5;3;446;449
8;Barcelona;21;Maresme;08121;Mataró;3;11;A;;558;183;305;370;188;0;3;367;370
8;Barcelona;21;Maresme;08121;Mataró;3;11;B;;713;205;350;431;282;2;7;422;429
8;Barcelona;21;Maresme;08121;Mataró;3;12;U;;983;226;450;614;369;2;7;605;612
8;Barcelona;21;Maresme;08121;Mataró;3;13;A;;782;180;362;470;312;2;5;463;468
8;Barcelona;21;Maresme;08121;Mataró;3;13;B;;976;240;456;597;379;1;7;589;596
8;Barcelona;21;Maresme;08121;Mataró;3;14;U;;1047;245;447;622;425;1;4;617;621
8;Barcelona;21;Maresme;08121;Mataró;3;2;A;;630;175;307;360;270;2;2;356;358
8;Barcelona;21;Maresme;08121;Mataró;3;2;B;;734;214;377;449;285;0;9;440;449
8;Barcelona;21;Maresme;08121;Mataró;3;3;A;;560;162;255;318;242;0;4;314;318
8;Barcelona;21;Maresme;08121;Mataró;3;3;B;;646;205;316;392;254;0;0;392;392
8;Barcelona;21;Maresme;08121;Mataró;3;4;A;;437;109;188;228;209;0;1;227;228
8;Barcelona;21;Maresme;08121;Mataró;3;4;B;;639;144;263;340;299;0;2;338;340
8;Barcelona;21;Maresme;08121;Mataró;3;4;C;;622;127;266;329;293;1;2;326;328
8;Barcelona;21;Maresme;08121;Mataró;3;5;A;;607;154;276;327;280;0;1;326;327
8;Barcelona;21;Maresme;08121;Mataró;3;5;B;;752;197;331;395;357;0;1;394;395
8;Barcelona;21;Maresme;08121;Mataró;3;6;A;;264;58;120;161;103;0;4;157;161
8;Barcelona;21;Maresme;08121;Mataró;3;6;B;;398;94;188;241;157;1;2;238;240
8;Barcelona;21;Maresme;08121;Mataró;3;6;C;;397;87;179;237;160;1;0;236;236
8;Barcelona;21;Maresme;08121;Mataró;3;7;A;;471;116;205;261;210;4;1;256;257
8;Barcelona;21;Maresme;08121;Mataró;3;7;B;;598;168;274;335;263;0;1;334;335
8;Barcelona;21;Maresme;08121;Mataró;3;8;A;;430;110;201;268;162;0;1;267;268
8;Barcelona;21;Maresme;08121;Mataró;3;8;B;;574;158;258;322;252;0;2;320;322
8;Barcelona;21;Maresme;08121;Mataró;3;9;A;;795;211;382;474;321;3;3;468;471
8;Barcelona;21;Maresme;08121;Mataró;3;9;B;;935;201;400;505;430;1;2;502;504
8;Barcelona;21;Maresme;08121;Mataró;4;1;A;;518;169;295;356;162;1;1;354;355
8;Barcelona;21;Maresme;08121;Mataró;4;1;B;;520;180;285;379;141;1;0;378;378
8;Barcelona;21;Maresme;08121;Mataró;4;2;A;;530;123;220;287;243;1;3;283;286
8;Barcelona;21;Maresme;08121;Mataró;4;2;B;;669;166;299;378;291;0;1;377;378
8;Barcelona;21;Maresme;08121;Mataró;4;3;U;;861;233;409;503;358;0;0;503;503
8;Barcelona;21;Maresme;08121;Mataró;4;4;U;;962;229;430;535;427;1;0;534;534
8;Barcelona;21;Maresme;08121;Mataró;4;5;U;;1217;277;550;691;526;0;4;687;691
8;Barcelona;21;Maresme;08121;Mataró;4;6;A;;539;124;243;319;220;0;3;316;319
8;Barcelona;21;Maresme;08121;Mataró;4;6;B;;668;172;325;421;247;3;2;416;418
8;Barcelona;21;Maresme;08121;Mataró;4;7;U;;975;181;414;525;450;0;3;522;525
8;Barcelona;21;Maresme;08121;Mataró;5;1;A;;672;207;346;434;238;1;4;429;433
8;Barcelona;21;Maresme;08121;Mataró;5;1;B;;720;206;358;442;278;0;1;441;442
8;Barcelona;21;Maresme;08121;Mataró;5;10;U;;448;139;201;259;189;0;0;259;259
8;Barcelona;21;Maresme;08121;Mataró;5;11;A;;646;150;281;367;279;0;5;362;367
8;Barcelona;21;Maresme;08121;Mataró;5;11;B;;742;178;353;424;318;0;5;419;424
8;Barcelona;21;Maresme;08121;Mataró;5;12;A;;537;126;262;323;214;1;2;320;322
8;Barcelona;21;Maresme;08121;Mataró;5;12;B;;598;155;280;360;238;2;4;354;358
8;Barcelona;21;Maresme;08121;Mataró;5;13;A;;506;144;246;317;189;2;2;313;315
8;Barcelona;21;Maresme;08121;Mataró;5;13;B;;600;152;278;359;241;2;3;354;357
8;Barcelona;21;Maresme;08121;Mataró;5;13;C;;612;156;283;350;262;1;1;348;349
8;Barcelona;21;Maresme;08121;Mataró;5;14;U;;614;186;284;350;264;1;3;346;349
8;Barcelona;21;Maresme;08121;Mataró;5;15;U;;905;222;387;492;413;5;6;481;487
8;Barcelona;21;Maresme;08121;Mataró;5;16;A;;499;123;214;275;224;0;4;271;275
8;Barcelona;21;Maresme;08121;Mataró;5;16;B;;515;116;209;265;250;0;4;261;265
8;Barcelona;21;Maresme;08121;Mataró;5;17;U;;730;181;335;405;325;1;1;403;404
8;Barcelona;21;Maresme;08121;Mataró;5;18;U;;457;111;195;232;225;0;0;232;232
8;Barcelona;21;Maresme;08121;Mataró;5;19;U;;762;210;335;420;342;2;2;416;418
8;Barcelona;21;Maresme;08121;Mataró;5;2;A;;703;182;306;386;317;0;2;384;386
8;Barcelona;21;Maresme;08121;Mataró;5;2;B;;719;174;299;392;327;0;1;391;392
8;Barcelona;21;Maresme;08121;Mataró;5;20;A;;552;138;227;286;266;0;5;281;286
8;Barcelona;21;Maresme;08121;Mataró;5;20;B;;662;194;280;337;325;0;5;332;337
8;Barcelona;21;Maresme;08121;Mataró;5;21;U;;676;134;274;396;280;0;5;391;396
8;Barcelona;21;Maresme;08121;Mataró;5;3;A;;622;150;263;326;296;0;4;322;326
8;Barcelona;21;Maresme;08121;Mataró;5;3;B;;756;182;321;404;352;2;2;400;402
8;Barcelona;21;Maresme;08121;Mataró;5;4;U;;1045;245;442;599;446;0;7;592;599
8;Barcelona;21;Maresme;08121;Mataró;5;5;U;;780;199;355;431;349;3;1;427;428
8;Barcelona;21;Maresme;08121;Mataró;5;6;A;;629;121;217;302;327;0;3;299;302
8;Barcelona;21;Maresme;08121;Mataró;5;6;B;;659;151;246;323;336;0;2;321;323
8;Barcelona;21;Maresme;08121;Mataró;5;7;A;;632;144;264;332;300;0;0;332;332
8;Barcelona;21;Maresme;08121;Mataró;5;7;B;;639;114;237;329;310;0;2;327;329
8;Barcelona;21;Maresme;08121;Mataró;5;8;U;;978;239;451;571;407;2;4;565;569
8;Barcelona;21;Maresme;08121;Mataró;5;9;U;;865;232;415;504;361;3;3;498;501
8;Barcelona;21;Maresme;08121;Mataró;6;1;A;;703;210;345;438;265;1;4;433;437
8;Barcelona;21;Maresme;08121;Mataró;6;1;B;;901;275;440;556;345;0;5;551;556
8;Barcelona;21;Maresme;08121;Mataró;6;10;A;;652;171;320;411;241;0;3;408;411
8;Barcelona;21;Maresme;08121;Mataró;6;10;B;;611;147;277;364;247;2;2;360;362
8;Barcelona;21;Maresme;08121;Mataró;6;10;C;;689;164;316;405;284;0;6;399;405
8;Barcelona;21;Maresme;08121;Mataró;6;11;A;;566;177;284;364;202;2;3;359;362
8;Barcelona;21;Maresme;08121;Mataró;6;11;B;;538;155;275;345;193;0;7;338;345
8;Barcelona;21;Maresme;08121;Mataró;6;11;C;;721;237;358;436;285;1;4;431;435
8;Barcelona;21;Maresme;08121;Mataró;6;12;A;;499;109;224;302;197;1;3;298;301
8;Barcelona;21;Maresme;08121;Mataró;6;12;B;;597;141;267;353;244;0;4;349;353
8;Barcelona;21;Maresme;08121;Mataró;6;12;C;;566;146;238;321;245;1;5;315;320
8;Barcelona;21;Maresme;08121;Mataró;6;13;U;;918;290;467;567;351;0;5;562;567
8;Barcelona;21;Maresme;08121;Mataró;6;2;U;;611;209;346;427;184;2;3;422;425
8;Barcelona;21;Maresme;08121;Mataró;6;3;U;;990;317;577;717;273;0;7;710;717
8;Barcelona;21;Maresme;08121;Mataró;6;4;A;;558;189;321;386;172;0;2;384;386
8;Barcelona;21;Maresme;08121;Mataró;6;4;B;;596;176;321;408;188;0;6;402;408
8;Barcelona;21;Maresme;08121;Mataró;6;5;A;;810;250;381;502;308;2;1;499;500
8;Barcelona;21;Maresme;08121;Mataró;6;5;B;;856;331;408;533;323;2;4;527;531
8;Barcelona;21;Maresme;08121;Mataró;6;6;A;;652;220;362;456;196;0;2;454;456
8;Barcelona;21;Maresme;08121;Mataró;6;6;B;;672;212;360;437;235;1;4;432;436
8;Barcelona;21;Maresme;08121;Mataró;6;7;A;;669;211;342;426;243;1;8;417;425
8;Barcelona;21;Maresme;08121;Mataró;6;7;B;;750;238;415;501;249;5;2;494;496
8;Barcelona;21;Maresme;08121;Mataró;6;8;A;;635;162;315;413;222;0;5;408;413
8;Barcelona;21;Maresme;08121;Mataró;6;8;B;;693;182;332;434;259;3;4;427;431
8;Barcelona;21;Maresme;08121;Mataró;6;9;A;;470;82;151;209;261;3;2;204;206
8;Barcelona;21;Maresme;08121;Mataró;6;9;B;;537;120;226;267;270;2;0;265;265
8;Barcelona;3;Alt Penedès;08122;Mediona;1;1;U;;1211;347;712;873;338;3;1;869;870
25;Lleida;23;Noguera;25134;Menàrguens;1;1;U;;718;183;370;469;249;0;4;465;469
17;Girona;15;Cerdanya;17099;Meranges;1;1;U;;78;11;34;50;28;0;0;50;50
17;Girona;19;Garrotxa;17105;Mieres;1;1;U;;276;70;156;185;91;1;3;181;184
43;Tarragona;1;Alt Camp;43083;Milà, el;1;1;U;;137;23;85;104;33;0;3;101;104
25;Lleida;27;Pla d'Urgell;25135;Miralcamp;1;1;U;;1039;236;585;742;297;1;16;725;741
43;Tarragona;30;Ribera d'Ebre;43084;Miravet;1;1;U;;668;167;366;476;192;3;3;470;473
8;Barcelona;;;08138;Moià;1;1;A;;583;161;326;408;175;2;4;402;406
8;Barcelona;;;08138;Moià;1;1;B;;682;182;364;452;230;1;6;445;451
8;Barcelona;;;08138;Moià;1;2;A;;946;251;494;632;314;3;8;621;629
8;Barcelona;;;08138;Moià;1;2;B;;1033;279;558;715;318;5;1;709;710
43;Tarragona;29;Priorat;43085;Molar, el;1;1;U;;257;80;185;211;46;1;3;207;210
8;Barcelona;11;Baix Llobregat;08123;Molins de Rei;1;1;A;;523;130;247;314;209;0;1;313;314
8;Barcelona;11;Baix Llobregat;08123;Molins de Rei;1;1;B;;633;151;263;349;284;0;1;348;349
8;Barcelona;11;Baix Llobregat;08123;Molins de Rei;1;2;A;;591;114;282;365;226;0;2;363;365
8;Barcelona;11;Baix Llobregat;08123;Molins de Rei;1;2;B;;737;136;301;418;319;0;5;413;418
8;Barcelona;11;Baix Llobregat;08123;Molins de Rei;1;3;A;;776;185;368;472;304;4;1;467;468
8;Barcelona;11;Baix Llobregat;08123;Molins de Rei;1;3;B;;814;170;349;480;334;0;5;475;480
8;Barcelona;11;Baix Llobregat;08123;Molins de Rei;2;1;A;;720;155;311;424;296;0;2;422;424
8;Barcelona;11;Baix Llobregat;08123;Molins de Rei;2;1;B;;795;174;351;499;296;3;5;491;496
8;Barcelona;11;Baix Llobregat;08123;Molins de Rei;2;2;A;;538;129;261;331;207;0;1;330;331
8;Barcelona;11;Baix Llobregat;08123;Molins de Rei;2;2;B;;566;142;290;351;215;0;1;350;351
8;Barcelona;11;Baix Llobregat;08123;Molins de Rei;2;3;A;;598;165;293;384;214;1;2;381;383
8;Barcelona;11;Baix Llobregat;08123;Molins de Rei;2;3;B;;687;166;326;436;251;0;5;431;436
8;Barcelona;11;Baix Llobregat;08123;Molins de Rei;2;3;C;;732;176;371;500;232;1;2;497;499
8;Barcelona;11;Baix Llobregat;08123;Molins de Rei;2;4;U;;1017;211;437;594;423;1;6;587;593
8;Barcelona;11;Baix Llobregat;08123;Molins de Rei;3;1;A;;533;124;245;334;199;0;2;332;334
8;Barcelona;11;Baix Llobregat;08123;Molins de Rei;3;1;B;;691;170;332;434;257;0;5;429;434
8;Barcelona;11;Baix Llobregat;08123;Molins de Rei;3;2;A;;953;241;504;642;311;0;9;633;642
8;Barcelona;11;Baix Llobregat;08123;Molins de Rei;3;2;B;;1078;262;573;705;373;2;3;700;703
8;Barcelona;11;Baix Llobregat;08123;Molins de Rei;3;3;A;;537;110;271;357;180;2;4;351;355
8;Barcelona;11;Baix Llobregat;08123;Molins de Rei;3;3;B;;696;148;331;438;258;0;3;435;438
8;Barcelona;11;Baix Llobregat;08123;Molins de Rei;3;4;A;;805;171;380;516;289;0;3;513;516
8;Barcelona;11;Baix Llobregat;08123;Molins de Rei;3;4;B;;931;234;440;584;347;1;6;577;583
8;Barcelona;11;Baix Llobregat;08123;Molins de Rei;4;1;U;;942;195;412;552;390;0;5;547;552
25;Lleida;27;Pla d'Urgell;25137;Mollerussa;1;1;A;;811;221;404;546;265;1;11;534;545
25;Lleida;27;Pla d'Urgell;25137;Mollerussa;1;1;B;;886;224;434;596;290;2;6;588;594
25;Lleida;27;Pla d'Urgell;25137;Mollerussa;1;2;A;;739;167;316;505;234;4;11;490;501
25;Lleida;27;Pla d'Urgell;25137;Mollerussa;1;2;B;;828;196;399;539;289;2;5;532;537
25;Lleida;27;Pla d'Urgell;25137;Mollerussa;1;3;U;;1037;270;507;652;385;1;9;642;651
25;Lleida;27;Pla d'Urgell;25137;Mollerussa;1;4;U;;1196;243;539;753;443;9;4;740;744
25;Lleida;27;Pla d'Urgell;25137;Mollerussa;1;5;U;;1136;225;500;719;417;3;8;708;716
25;Lleida;27;Pla d'Urgell;25137;Mollerussa;1;6;U;;1094;230;481;692;402;9;6;677;683
8;Barcelona;41;Vallès Oriental;08124;Mollet del Vallès;1;1;U;;672;169;266;349;323;0;6;343;349
8;Barcelona;41;Vallès Oriental;08124;Mollet del Vallès;1;2;A;;678;133;265;342;336;0;1;341;342
8;Barcelona;41;Vallès Oriental;08124;Mollet del Vallès;1;2;B;;813;173;322;411;402;0;5;406;411
8;Barcelona;41;Vallès Oriental;08124;Mollet del Vallès;1;3;A;;530;111;229;293;237;0;1;292;293
8;Barcelona;41;Vallès Oriental;08124;Mollet del Vallès;1;3;B;;549;123;232;309;240;1;1;307;308
8;Barcelona;41;Vallès Oriental;08124;Mollet del Vallès;1;3;C;;620;144;275;338;282;0;1;337;338
8;Barcelona;41;Vallès Oriental;08124;Mollet del Vallès;1;4;A;;758;183;371;468;290;0;1;467;468
8;Barcelona;41;Vallès Oriental;08124;Mollet del Vallès;1;4;B;;910;220;420;549;361;1;3;545;548
8;Barcelona;41;Vallès Oriental;08124;Mollet del Vallès;1;5;A;;686;121;253;344;342;0;1;343;344
8;Barcelona;41;Vallès Oriental;08124;Mollet del Vallès;1;5;B;;861;196;337;458;403;1;5;452;457
8;Barcelona;41;Vallès Oriental;08124;Mollet del Vallès;1;6;A;;600;145;252;312;288;2;3;307;310
8;Barcelona;41;Vallès Oriental;08124;Mollet del Vallès;1;6;B;;522;120;218;270;252;1;5;264;269
8;Barcelona;41;Vallès Oriental;08124;Mollet del Vallès;1;6;C;;582;125;238;306;276;0;2;304;306
8;Barcelona;41;Vallès Oriental;08124;Mollet del Vallès;1;7;A;;549;90;193;290;259;0;4;286;290
8;Barcelona;41;Vallès Oriental;08124;Mollet del Vallès;1;7;B;;667;113;240;337;330;0;3;334;337
8;Barcelona;41;Vallès Oriental;08124;Mollet del Vallès;2;1;A;;532;122;215;287;245;0;2;285;287
8;Barcelona;41;Vallès Oriental;08124;Mollet del Vallès;2;1;B;;584;119;237;316;268;0;1;315;316
8;Barcelona;41;Vallès Oriental;08124;Mollet del Vallès;2;1;C;;681;150;310;382;299;2;2;378;380
8;Barcelona;41;Vallès Oriental;08124;Mollet del Vallès;2;2;A;;927;209;412;550;377;3;3;544;547
8;Barcelona;41;Vallès Oriental;08124;Mollet del Vallès;2;2;B;;1132;262;527;682;450;2;5;675;680
8;Barcelona;41;Vallès Oriental;08124;Mollet del Vallès;2;3;A;;814;182;314;400;414;2;3;395;398
8;Barcelona;41;Vallès Oriental;08124;Mollet del Vallès;2;3;B;;964;200;527;491;473;1;2;488;490
8;Barcelona;41;Vallès Oriental;08124;Mollet del Vallès;2;4;A;;598;101;217;312;286;0;2;310;312
8;Barcelona;41;Vallès Oriental;08124;Mollet del Vallès;2;4;B;;652;126;253;334;318;0;0;334;334
8;Barcelona;41;Vallès Oriental;08124;Mollet del Vallès;2;5;A;;378;65;133;203;175;1;0;202;202
8;Barcelona;41;Vallès Oriental;08124;Mollet del Vallès;2;5;B;;505;91;213;284;221;0;3;281;284
8;Barcelona;41;Vallès Oriental;08124;Mollet del Vallès;2;6;U;;1153;218;443;578;575;0;4;574;578
8;Barcelona;41;Vallès Oriental;08124;Mollet del Vallès;2;7;A;;713;109;244;350;363;0;4;346;350
8;Barcelona;41;Vallès Oriental;08124;Mollet del Vallès;2;7;B;;852;142;287;384;468;0;0;384;384
8;Barcelona;41;Vallès Oriental;08124;Mollet del Vallès;3;1;A;;634;139;273;350;284;2;0;348;348
8;Barcelona;41;Vallès Oriental;08124;Mollet del Vallès;3;1;B;;637;141;278;344;293;0;4;340;344
8;Barcelona;41;Vallès Oriental;08124;Mollet del Vallès;3;1;C;;690;149;284;364;326;1;2;361;363
8;Barcelona;41;Vallès Oriental;08124;Mollet del Vallès;3;10;U;;744;141;238;335;409;0;5;330;335
8;Barcelona;41;Vallès Oriental;08124;Mollet del Vallès;3;11;A;;823;127;292;386;437;0;1;385;386
8;Barcelona;41;Vallès Oriental;08124;Mollet del Vallès;3;11;B;;974;136;335;466;508;0;1;465;466
8;Barcelona;41;Vallès Oriental;08124;Mollet del Vallès;3;12;U;;1179;259;458;620;559;0;2;618;620
8;Barcelona;41;Vallès Oriental;08124;Mollet del Vallès;3;13;A;;880;165;321;434;446;1;1;432;433
8;Barcelona;41;Vallès Oriental;08124;Mollet del Vallès;3;13;B;;1026;176;362;500;526;0;5;495;500
8;Barcelona;41;Vallès Oriental;08124;Mollet del Vallès;3;2;A;;800;156;329;442;358;0;3;439;442
8;Barcelona;41;Vallès Oriental;08124;Mollet del Vallès;3;2;B;;882;198;355;487;395;0;9;478;487
8;Barcelona;41;Vallès Oriental;08124;Mollet del Vallès;3;3;A;;496;118;245;319;177;0;1;318;319
8;Barcelona;41;Vallès Oriental;08124;Mollet del Vallès;3;3;B;;489;131;228;298;191;1;3;294;297
8;Barcelona;41;Vallès Oriental;08124;Mollet del Vallès;3;4;A;;731;160;298;394;337;0;2;392;394
8;Barcelona;41;Vallès Oriental;08124;Mollet del Vallès;3;4;B;;855;137;342;473;382;2;6;465;471
8;Barcelona;41;Vallès Oriental;08124;Mollet del Vallès;3;5;A;;664;125;288;407;257;0;6;401;407
8;Barcelona;41;Vallès Oriental;08124;Mollet del Vallès;3;5;B;;857;141;338;477;380;0;4;473;477
8;Barcelona;41;Vallès Oriental;08124;Mollet del Vallès;3;6;A;;670;149;253;335;335;0;4;331;335
8;Barcelona;41;Vallès Oriental;08124;Mollet del Vallès;3;6;B;;700;155;271;341;359;2;1;338;339
8;Barcelona;41;Vallès Oriental;08124;Mollet del Vallès;3;7;A;;496;73;166;215;281;1;0;214;214
8;Barcelona;41;Vallès Oriental;08124;Mollet del Vallès;3;7;B;;663;111;206;282;381;0;1;281;282
8;Barcelona;41;Vallès Oriental;08124;Mollet del Vallès;3;7;C;;699;106;215;293;406;0;5;288;293
8;Barcelona;41;Vallès Oriental;08124;Mollet del Vallès;3;8;U;;777;157;292;404;373;0;4;400;404
8;Barcelona;41;Vallès Oriental;08124;Mollet del Vallès;3;9;A;;409;93;166;212;197;1;1;210;211
8;Barcelona;41;Vallès Oriental;08124;Mollet del Vallès;3;9;B;;559;136;231;303;256;3;0;300;300
17;Girona;2;Alt Empordà;17106;Mollet de Peralada;1;1;U;;171;57;96;126;45;1;1;124;125
17;Girona;31;Ripollès;17107;Molló;1;1;U;;304;77;164;222;82;3;2;217;219
25;Lleida;35;Solsonès;25136;Molsosa, la;1;1;U;;112;29;69;89;23;0;0;89;89
8;Barcelona;;;08128;Monistrol de Calders;1;1;U;;490;100;242;334;156;1;9;324;333
8;Barcelona;7;Bages;08127;Monistrol de Montserrat;1;1;U;;746;190;367;490;256;0;4;486;490
8;Barcelona;7;Bages;08127;Monistrol de Montserrat;1;2;A;;627;150;290;399;228;0;4;395;399
8;Barcelona;7;Bages;08127;Monistrol de Montserrat;1;2;B;;756;204;367;492;264;2;8;482;490
17;Girona;19;Garrotxa;17109;Montagut i Oix;1;1;U;;677;182;286;348;329;2;1;345;346
43;Tarragona;16;Conca de Barberà;43086;Montblanc;1;1;U;;750;165;349;446;304;3;8;435;443
43;Tarragona;16;Conca de Barberà;43086;Montblanc;1;2;U;;657;139;306;398;259;0;8;390;398
43;Tarragona;16;Conca de Barberà;43086;Montblanc;2;1;A;;934;199;452;624;310;6;6;612;618
43;Tarragona;16;Conca de Barberà;43086;Montblanc;2;1;B;;1059;209;482;684;375;2;11;671;682
43;Tarragona;16;Conca de Barberà;43086;Montblanc;2;2;A;;663;148;308;428;235;2;4;422;426
43;Tarragona;16;Conca de Barberà;43086;Montblanc;2;2;B;;857;185;367;507;350;0;0;507;507
43;Tarragona;8;Baix Camp;43088;Montbrió del Camp;1;1;U;;1205;227;610;816;389;3;5;808;813
8;Barcelona;40;Vallès Occidental;08125;Montcada i Reixac;1;1;U;;960;255;463;592;368;0;5;587;592
8;Barcelona;40;Vallès Occidental;08125;Montcada i Reixac;1;2;A;;477;156;262;322;155;0;5;317;322
8;Barcelona;40;Vallès Occidental;08125;Montcada i Reixac;1;2;B;;681;209;370;438;243;0;3;435;438
8;Barcelona;40;Vallès Occidental;08125;Montcada i Reixac;1;4;A;;667;150;302;372;295;0;0;372;372
8;Barcelona;40;Vallès Occidental;08125;Montcada i Reixac;1;4;B;;671;154;310;382;289;5;0;377;377
8;Barcelona;40;Vallès Occidental;08125;Montcada i Reixac;1;5;A;;592;152;275;355;237;0;5;350;355
8;Barcelona;40;Vallès Occidental;08125;Montcada i Reixac;1;5;B;;690;196;336;431;259;0;4;427;431
8;Barcelona;40;Vallès Occidental;08125;Montcada i Reixac;2;1;A;;755;163;300;356;399;2;4;350;354
8;Barcelona;40;Vallès Occidental;08125;Montcada i Reixac;2;1;B;;843;167;358;427;416;2;3;422;425
8;Barcelona;40;Vallès Occidental;08125;Montcada i Reixac;2;2;A;;832;205;365;448;384;1;2;445;447
8;Barcelona;40;Vallès Occidental;08125;Montcada i Reixac;2;2;B;;912;215;403;521;391;0;2;519;521
8;Barcelona;40;Vallès Occidental;08125;Montcada i Reixac;2;3;A;;826;274;456;486;340;3;2;481;483
8;Barcelona;40;Vallès Occidental;08125;Montcada i Reixac;2;3;B;;981;244;456;585;396;1;7;577;584
8;Barcelona;40;Vallès Occidental;08125;Montcada i Reixac;3;1;A;;744;225;366;445;299;1;3;441;444
8;Barcelona;40;Vallès Occidental;08125;Montcada i Reixac;3;1;B;;872;232;404;502;370;1;2;499;501
8;Barcelona;40;Vallès Occidental;08125;Montcada i Reixac;3;2;U;;1114;287;353;603;511;0;8;595;603
8;Barcelona;40;Vallès Occidental;08125;Montcada i Reixac;3;3;A;;774;145;314;406;368;0;1;405;406
8;Barcelona;40;Vallès Occidental;08125;Montcada i Reixac;3;3;B;;1025;206;435;583;442;0;6;577;583
8;Barcelona;40;Vallès Occidental;08125;Montcada i Reixac;3;3;C;;983;234;416;590;393;4;3;583;586
8;Barcelona;40;Vallès Occidental;08125;Montcada i Reixac;4;1;A;;921;217;408;513;408;0;1;512;513
8;Barcelona;40;Vallès Occidental;08125;Montcada i Reixac;4;1;B;;1117;268;476;633;484;0;1;632;633
8;Barcelona;40;Vallès Occidental;08125;Montcada i Reixac;5;1;A;;838;201;352;445;393;3;4;438;442
8;Barcelona;40;Vallès Occidental;08125;Montcada i Reixac;5;1;B;;917;195;362;463;454;0;2;461;463
8;Barcelona;40;Vallès Occidental;08125;Montcada i Reixac;5;2;U;;1096;225;452;583;513;3;13;567;580
8;Barcelona;40;Vallès Occidental;08125;Montcada i Reixac;5;3;A;;584;113;185;240;344;1;2;237;239
8;Barcelona;40;Vallès Occidental;08125;Montcada i Reixac;5;3;B;;633;92;195;270;363;0;5;265;270
8;Barcelona;40;Vallès Occidental;08125;Montcada i Reixac;6;1;U;;1341;194;433;602;739;2;5;595;600
8;Barcelona;14;Berguedà;08130;Montclar;1;1;U;;125;23;45;61;64;0;2;59;61
25;Lleida;15;Cerdanya;25139;Montellà i Martinet;1;1;U;;460;115;244;304;156;3;4;297;301
8;Barcelona;24;Osona;08131;Montesquiu;1;1;U;;715;220;416;482;233;0;3;479;482
25;Lleida;4;Alt Urgell;25140;Montferrer i Castellbò;1;1;U;;647;170;325;396;251;1;3;392;395
43;Tarragona;1;Alt Camp;43089;Montferri;1;1;U;;140;33;74;93;47;0;0;93;93
25;Lleida;23;Noguera;25138;Montgai;1;1;A;;453;128;280;345;108;0;2;343;345
25;Lleida;23;Noguera;25138;Montgai;1;1;B;;229;62;140;168;61;0;0;168;168
8;Barcelona;21;Maresme;08126;Montgat;1;1;A;;628;127;270;373;255;0;1;372;373
8;Barcelona;21;Maresme;08126;Montgat;1;1;B;;801;155;333;445;356;0;1;444;445
8;Barcelona;21;Maresme;08126;Montgat;1;2;A;;541;118;230;316;225;2;1;313;314
8;Barcelona;21;Maresme;08126;Montgat;1;2;B;;635;147;277;372;263;2;1;369;370
8;Barcelona;21;Maresme;08126;Montgat;1;2;C;;725;172;283;395;330;2;2;391;393
8;Barcelona;21;Maresme;08126;Montgat;1;3;A;;617;155;292;378;239;0;2;376;378
8;Barcelona;21;Maresme;08126;Montgat;1;3;B;;645;150;304;390;255;1;2;387;389
8;Barcelona;21;Maresme;08126;Montgat;1;3;C;;729;170;351;439;290;2;2;435;437
8;Barcelona;21;Maresme;08126;Montgat;1;4;A;;724;145;309;421;303;0;10;411;421
8;Barcelona;21;Maresme;08126;Montgat;1;4;B;;814;135;352;495;319;0;5;490;495
8;Barcelona;14;Berguedà;08132;Montmajor;1;1;U;;423;80;198;278;145;3;1;274;275
8;Barcelona;6;Anoia;08133;Montmaneu;1;1;U;;190;51;104;122;68;0;2;120;122
43;Tarragona;12;Baix Penedès;43090;Montmell, el;1;1;U;;427;110;199;258;169;4;1;253;254
8;Barcelona;41;Vallès Oriental;08135;Montmeló;1;1;U;;1072;241;493;615;457;1;6;608;614
8;Barcelona;41;Vallès Oriental;08135;Montmeló;1;2;A;;486;133;253;298;188;2;4;292;296
8;Barcelona;41;Vallès Oriental;08135;Montmeló;1;2;B;;661;168;287;379;282;1;0;378;378
8;Barcelona;41;Vallès Oriental;08135;Montmeló;1;2;C;;989;226;463;641;348;0;7;634;641
8;Barcelona;41;Vallès Oriental;08135;Montmeló;1;3;A;;785;183;356;475;310;0;4;471;475
8;Barcelona;41;Vallès Oriental;08135;Montmeló;1;3;B;;947;229;436;579;368;2;11;566;577
8;Barcelona;41;Vallès Oriental;08135;Montmeló;1;4;U;;1007;225;444;596;411;3;5;588;593
8;Barcelona;41;Vallès Oriental;08135;Montmeló;1;5;U;;922;235;406;543;379;0;4;539;543
25;Lleida;33;Segrià;25142;Montoliu de Lleida;1;1;U;;419;107;201;253;166;0;4;249;253
25;Lleida;32;Segarra;25141;Montoliu de Segarra;1;1;U;;160;32;81;102;58;0;1;101;102
8;Barcelona;41;Vallès Oriental;08136;Montornès del Vallès;1;1;A;;505;83;193;272;233;0;1;271;272
8;Barcelona;41;Vallès Oriental;08136;Montornès del Vallès;1;1;B;;564;109;310;293;271;0;1;292;293
8;Barcelona;41;Vallès Oriental;08136;Montornès del Vallès;1;2;A;;661;129;275;384;277;3;6;375;381
8;Barcelona;41;Vallès Oriental;08136;Montornès del Vallès;1;2;B;;712;136;256;371;341;0;2;369;371
8;Barcelona;41;Vallès Oriental;08136;Montornès del Vallès;1;3;A;;801;150;323;436;365;0;9;427;436
8;Barcelona;41;Vallès Oriental;08136;Montornès del Vallès;1;3;B;;914;145;337;475;439;3;4;468;472
8;Barcelona;41;Vallès Oriental;08136;Montornès del Vallès;1;4;A;;741;141;298;401;340;0;3;398;401
8;Barcelona;41;Vallès Oriental;08136;Montornès del Vallès;1;4;B;;871;150;338;495;376;1;6;488;494
8;Barcelona;41;Vallès Oriental;08136;Montornès del Vallès;1;5;A;;770;152;310;430;340;2;4;424;428
8;Barcelona;41;Vallès Oriental;08136;Montornès del Vallès;1;5;B;;861;169;340;493;368;0;2;491;493
8;Barcelona;41;Vallès Oriental;08136;Montornès del Vallès;2;1;A;;398;74;123;163;235;1;0;162;162
8;Barcelona;41;Vallès Oriental;08136;Montornès del Vallès;2;1;B;;462;87;162;209;253;1;2;206;208
8;Barcelona;41;Vallès Oriental;08136;Montornès del Vallès;2;2;A;;395;83;162;222;173;0;2;220;222
8;Barcelona;41;Vallès Oriental;08136;Montornès del Vallès;2;2;B;;467;100;186;264;203;1;3;260;263
8;Barcelona;41;Vallès Oriental;08136;Montornès del Vallès;2;3;A;;402;84;141;200;202;1;0;199;199
8;Barcelona;41;Vallès Oriental;08136;Montornès del Vallès;2;3;B;;451;90;167;226;225;0;3;223;226
25;Lleida;32;Segarra;25143;Montornès de Segarra;1;1;U;;93;17;28;60;33;0;4;56;60
43;Tarragona;1;Alt Camp;43091;Mont-ral;1;1;U;;135;34;62;78;57;1;2;75;77
17;Girona;10;Baix Empordà;17110;Mont-ras;1;1;A;;630;143;304;408;222;4;4;400;404
17;Girona;10;Baix Empordà;17110;Mont-ras;1;1;B;;635;161;323;409;226;3;1;405;406
43;Tarragona;8;Baix Camp;43092;Mont-roig del Camp;1;1;A;;536;108;254;317;219;3;1;313;314
43;Tarragona;8;Baix Camp;43092;Mont-roig del Camp;1;1;B;;486;106;250;312;174;3;0;309;309
43;Tarragona;8;Baix Camp;43092;Mont-roig del Camp;1;2;U;;508;103;195;237;271;0;4;233;237
43;Tarragona;8;Baix Camp;43092;Mont-roig del Camp;1;3;A;;485;88;245;298;187;0;0;298;298
43;Tarragona;8;Baix Camp;43092;Mont-roig del Camp;1;3;B;;541;111;298;354;187;0;2;352;354
43;Tarragona;8;Baix Camp;43092;Mont-roig del Camp;1;4;A;;508;68;141;191;317;0;3;188;191
43;Tarragona;8;Baix Camp;43092;Mont-roig del Camp;1;4;B;;571;83;176;220;351;0;0;220;220
43;Tarragona;8;Baix Camp;43092;Mont-roig del Camp;1;5;A;;539;86;209;249;290;0;0;249;249
43;Tarragona;8;Baix Camp;43092;Mont-roig del Camp;1;5;B;;583;76;211;253;330;1;0;252;252
8;Barcelona;41;Vallès Oriental;08137;Montseny;1;1;U;;256;68;125;196;60;0;2;194;196
43;Tarragona;30;Ribera d'Ebre;43093;Móra d'Ebre;1;1;A;;681;160;325;437;244;0;4;433;437
43;Tarragona;30;Ribera d'Ebre;43093;Móra d'Ebre;1;1;B;;684;144;307;438;246;0;8;430;438
43;Tarragona;30;Ribera d'Ebre;43093;Móra d'Ebre;1;2;A;;620;113;268;424;196;0;2;422;424
43;Tarragona;30;Ribera d'Ebre;43093;Móra d'Ebre;1;2;B;;607;118;293;435;172;1;5;429;434
43;Tarragona;30;Ribera d'Ebre;43093;Móra d'Ebre;2;1;A;;643;130;297;425;218;3;4;418;422
43;Tarragona;30;Ribera d'Ebre;43093;Móra d'Ebre;2;1;B;;697;153;337;465;232;2;4;459;463
43;Tarragona;30;Ribera d'Ebre;43094;Móra la Nova;1;1;A;;553;154;280;407;146;2;1;404;405
43;Tarragona;30;Ribera d'Ebre;43094;Móra la Nova;1;1;B;;650;162;304;446;204;1;1;444;445
43;Tarragona;30;Ribera d'Ebre;43094;Móra la Nova;2;1;A;;423;111;215;294;129;1;1;292;293
43;Tarragona;30;Ribera d'Ebre;43094;Móra la Nova;2;1;B;;574;138;299;418;156;0;2;416;418
43;Tarragona;36;Tarragonès;43095;Morell, el;1;1;A;;892;201;439;579;313;2;6;571;577
43;Tarragona;36;Tarragonès;43095;Morell, el;1;1;B;;967;200;427;577;390;0;6;571;577
43;Tarragona;29;Priorat;43096;Morera de Montsant, la;1;1;U;;139;25;65;87;52;0;2;85;87
8;Barcelona;24;Osona;08129;Muntanyola;1;1;U;;240;61;108;144;96;1;2;141;143
8;Barcelona;7;Bages;08139;Mura;1;1;U;;200;49;113;150;50;0;0;150;150
25;Lleida;38;Urgell;25145;Nalec;1;1;U;;99;27;54;69;30;0;2;67;69
25;Lleida;39;Consell General d'Aran;25025;Naut Aran;1;1;A;;744;99;540;392;352;0;6;386;392
25;Lleida;39;Consell General d'Aran;25025;Naut Aran;1;1;B;;475;121;222;288;187;0;2;286;288
8;Barcelona;7;Bages;08140;Navarcles;1;1;A;;770;195;407;520;250;0;0;520;520
8;Barcelona;7;Bages;08140;Navarcles;1;1;B;;740;166;357;472;268;3;0;469;469
8;Barcelona;7;Bages;08140;Navarcles;1;1;C;;905;185;431;563;342;1;5;557;562
8;Barcelona;7;Bages;08140;Navarcles;1;2;A;;701;187;395;498;203;1;4;493;497
8;Barcelona;7;Bages;08140;Navarcles;1;2;B;;659;144;352;443;216;1;1;441;442
8;Barcelona;7;Bages;08140;Navarcles;1;2;C;;707;168;377;472;235;0;1;471;472
8;Barcelona;7;Bages;08141;Navàs;1;1;A;;522;167;308;395;127;3;5;387;392
8;Barcelona;7;Bages;08141;Navàs;1;1;B;;575;205;367;439;136;4;1;434;435
8;Barcelona;7;Bages;08141;Navàs;1;2;U;;727;231;406;504;223;2;2;500;502
8;Barcelona;7;Bages;08141;Navàs;1;3;A;;701;189;334;431;270;3;3;425;428
8;Barcelona;7;Bages;08141;Navàs;1;3;B;;846;202;394;527;319;2;2;523;525
8;Barcelona;7;Bages;08141;Navàs;1;4;U;;1064;319;614;765;299;2;6;757;763
8;Barcelona;7;Bages;08141;Navàs;2;1;U;;483;169;312;351;132;4;2;345;347
17;Girona;2;Alt Empordà;17111;Navata;1;1;U;;540;153;286;371;169;1;7;363;370
25;Lleida;35;Solsonès;25146;Navès;1;1;U;;233;71;137;176;57;2;1;173;174
8;Barcelona;14;Berguedà;08142;Nou de Berguedà, la;1;1;U;;131;34;78;106;25;1;1;104;105
43;Tarragona;36;Tarragonès;43097;Nou de Gaià, la;1;1;U;;304;104;191;223;81;1;2;220;222
43;Tarragona;1;Alt Camp;43098;Nulles;1;1;U;;313;69;183;226;87;0;1;225;226
25;Lleida;35;Solsonès;25148;Odèn;1;1;U;;243;42;92;164;79;0;0;164;164
8;Barcelona;6;Anoia;08143;Òdena;1;1;A;;700;159;314;441;259;4;4;433;437
8;Barcelona;6;Anoia;08143;Òdena;1;1;B;;782;179;378;533;249;2;6;525;531
8;Barcelona;6;Anoia;08143;Òdena;1;2;U;;753;211;360;482;271;0;5;477;482
17;Girona;31;Ripollès;17112;Ogassa;1;1;U;;226;72;129;172;54;0;0;172;172
8;Barcelona;3;Alt Penedès;08145;Olèrdola;1;1;U;;950;221;438;553;397;2;1;550;551
8;Barcelona;3;Alt Penedès;08145;Olèrdola;1;2;U;;905;255;497;666;239;2;1;663;664
8;Barcelona;3;Alt Penedès;08146;Olesa de Bonesvalls;1;1;U;;752;211;398;493;259;5;6;482;488
8;Barcelona;11;Baix Llobregat;08147;Olesa de Montserrat;1;1;A;;915;200;370;496;419;0;5;491;496
8;Barcelona;11;Baix Llobregat;08147;Olesa de Montserrat;1;1;B;;1110;265;487;620;490;0;6;614;620
8;Barcelona;11;Baix Llobregat;08147;Olesa de Montserrat;1;2;A;;669;171;305;421;248;2;0;419;419
8;Barcelona;11;Baix Llobregat;08147;Olesa de Montserrat;1;2;B;;757;155;336;471;286;2;3;466;469
8;Barcelona;11;Baix Llobregat;08147;Olesa de Montserrat;1;3;A;;419;131;229;283;136;0;2;281;283
8;Barcelona;11;Baix Llobregat;08147;Olesa de Montserrat;1;3;B;;511;153;256;325;186;2;0;323;323
8;Barcelona;11;Baix Llobregat;08147;Olesa de Montserrat;1;4;A;;780;190;386;521;259;2;5;514;519
8;Barcelona;11;Baix Llobregat;08147;Olesa de Montserrat;1;4;B;;863;193;398;544;319;1;2;541;543
8;Barcelona;11;Baix Llobregat;08147;Olesa de Montserrat;1;5;A;;945;215;436;568;377;2;3;563;566
8;Barcelona;11;Baix Llobregat;08147;Olesa de Montserrat;1;5;B;;905;175;397;527;378;0;0;527;527
8;Barcelona;11;Baix Llobregat;08147;Olesa de Montserrat;1;6;A;;795;164;333;450;345;1;6;443;449
8;Barcelona;11;Baix Llobregat;08147;Olesa de Montserrat;1;6;B;;866;156;352;464;402;2;9;453;462
8;Barcelona;11;Baix Llobregat;08147;Olesa de Montserrat;1;7;A;;607;134;297;379;228;0;3;376;379
8;Barcelona;11;Baix Llobregat;08147;Olesa de Montserrat;1;7;B;;764;163;335;459;305;0;3;456;459
8;Barcelona;11;Baix Llobregat;08147;Olesa de Montserrat;1;8;A;;700;214;375;468;232;1;2;465;467
8;Barcelona;11;Baix Llobregat;08147;Olesa de Montserrat;1;8;B;;788;197;404;524;264;2;3;519;522
8;Barcelona;11;Baix Llobregat;08147;Olesa de Montserrat;1;9;A;;570;112;249;327;243;0;1;326;327
8;Barcelona;11;Baix Llobregat;08147;Olesa de Montserrat;1;9;B;;661;130;260;356;305;0;4;352;356
25;Lleida;4;Alt Urgell;25149;Oliana;1;1;A;;744;193;413;524;220;2;1;521;522
25;Lleida;4;Alt Urgell;25149;Oliana;1;1;B;;909;231;516;666;243;0;6;660;666
25;Lleida;23;Noguera;25150;Oliola;1;1;U;;190;64;107;139;51;1;2;136;138
25;Lleida;35;Solsonès;25151;Olius;1;1;U;;418;103;218;289;129;6;4;279;283
8;Barcelona;17;Garraf;08148;Olivella;1;1;U;;1020;237;423;529;491;4;2;523;525
8;Barcelona;24;Osona;08149;Olost;1;1;A;;453;81;202;279;174;0;2;277;279
8;Barcelona;24;Osona;08149;Olost;1;1;B;;542;128;309;383;159;1;6;376;382
17;Girona;19;Garrotxa;17114;Olot;1;1;A;;529;158;247;287;242;1;1;285;286
17;Girona;19;Garrotxa;17114;Olot;1;1;B;;357;110;166;200;157;0;1;199;200
17;Girona;19;Garrotxa;17114;Olot;1;1;C;;467;153;236;278;189;3;0;275;275
17;Girona;19;Garrotxa;17114;Olot;1;2;A;;423;126;217;252;171;0;0;252;252
17;Girona;19;Garrotxa;17114;Olot;1;2;B;;405;129;236;275;130;0;3;272;275
17;Girona;19;Garrotxa;17114;Olot;1;3;A;;354;108;185;231;123;1;1;229;230
17;Girona;19;Garrotxa;17114;Olot;1;3;B;;365;92;189;243;122;3;3;237;240
17;Girona;19;Garrotxa;17114;Olot;1;4;A;;418;124;230;285;133;0;3;282;285
17;Girona;19;Garrotxa;17114;Olot;1;4;B;;363;112;202;256;107;1;0;255;255
17;Girona;19;Garrotxa;17114;Olot;1;5;U;;621;222;362;447;174;0;8;439;447
17;Girona;19;Garrotxa;17114;Olot;1;6;U;;634;236;369;436;198;0;2;434;436
17;Girona;19;Garrotxa;17114;Olot;1;7;A;;650;216;355;433;217;2;6;425;431
17;Girona;19;Garrotxa;17114;Olot;1;7;B;;611;228;336;410;201;0;3;407;410
17;Girona;19;Garrotxa;17114;Olot;2;1;A;;532;133;277;340;192;0;4;336;340
17;Girona;19;Garrotxa;17114;Olot;2;1;B;;327;75;166;201;126;0;3;198;201
17;Girona;19;Garrotxa;17114;Olot;2;1;C;;542;149;284;328;214;2;0;326;326
17;Girona;19;Garrotxa;17114;Olot;2;2;A;;535;153;276;349;186;2;3;344;347
17;Girona;19;Garrotxa;17114;Olot;2;2;B;;421;105;192;259;162;0;4;255;259
17;Girona;19;Garrotxa;17114;Olot;2;2;C;;553;153;251;339;214;1;1;337;338
17;Girona;19;Garrotxa;17114;Olot;2;3;A;;407;116;214;252;155;0;1;251;252
17;Girona;19;Garrotxa;17114;Olot;2;3;B;;436;113;221;266;170;1;2;263;265
17;Girona;19;Garrotxa;17114;Olot;2;4;A;;499;133;242;313;186;1;0;312;312
17;Girona;19;Garrotxa;17114;Olot;2;4;B;;535;127;247;321;214;1;0;320;320
17;Girona;19;Garrotxa;17114;Olot;2;5;A;;580;154;293;375;205;1;2;372;374
17;Girona;19;Garrotxa;17114;Olot;2;5;B;;514;137;295;354;160;0;0;354;354
17;Girona;19;Garrotxa;17114;Olot;3;1;U;;669;207;341;406;263;2;2;402;404
17;Girona;19;Garrotxa;17114;Olot;3;2;A;;641;211;379;451;190;1;5;445;450
17;Girona;19;Garrotxa;17114;Olot;3;2;B;;611;178;327;412;199;3;3;406;409
17;Girona;19;Garrotxa;17114;Olot;3;3;A;;692;207;390;474;218;0;2;472;474
17;Girona;19;Garrotxa;17114;Olot;3;3;B;;477;121;257;318;159;2;2;314;316
17;Girona;19;Garrotxa;17114;Olot;3;3;C;;650;206;363;436;214;2;3;431;434
17;Girona;19;Garrotxa;17114;Olot;4;1;A;;515;136;263;331;184;0;3;328;331
17;Girona;19;Garrotxa;17114;Olot;4;1;B;;520;120;316;283;237;1;4;278;282
17;Girona;19;Garrotxa;17114;Olot;4;2;A;;513;176;295;353;160;1;3;349;352
17;Girona;19;Garrotxa;17114;Olot;4;2;B;;401;107;209;254;147;1;1;252;253
17;Girona;19;Garrotxa;17114;Olot;4;2;C;;506;161;284;333;173;0;3;330;333
17;Girona;19;Garrotxa;17114;Olot;5;1;A;;447;120;219;269;178;0;0;269;269
17;Girona;19;Garrotxa;17114;Olot;5;1;B;;404;110;207;254;150;0;1;253;254
17;Girona;19;Garrotxa;17114;Olot;5;2;A;;533;164;334;391;142;2;5;384;389
17;Girona;19;Garrotxa;17114;Olot;5;2;B;;427;127;239;295;132;0;3;292;295
17;Girona;19;Garrotxa;17114;Olot;5;3;A;;759;272;431;503;256;0;5;498;503
17;Girona;19;Garrotxa;17114;Olot;5;3;B;;442;154;251;275;167;0;5;270;275
17;Girona;19;Garrotxa;17114;Olot;5;3;C;;688;230;407;459;229;4;4;451;455
17;Girona;19;Garrotxa;17114;Olot;5;4;A;;607;180;371;442;165;4;6;432;438
17;Girona;19;Garrotxa;17114;Olot;5;4;B;;509;134;265;342;167;0;5;337;342
25;Lleida;32;Segarra;25152;Oluges, les;1;1;U;;180;39;90;114;66;0;3;111;114
8;Barcelona;14;Berguedà;08144;Olvan;1;1;A;;386;77;164;231;155;1;4;226;230
8;Barcelona;14;Berguedà;08144;Olvan;1;1;B;;438;133;260;310;128;0;0;310;310
25;Lleida;18;Garrigues;25153;Omellons, els;1;1;U;;229;80;138;172;57;3;0;169;169
25;Lleida;38;Urgell;25154;Omells de na Gaia, els;1;1;U;;131;36;68;85;46;0;0;85;85
17;Girona;2;Alt Empordà;17115;Ordis;1;1;U;;248;91;159;197;51;1;3;193;196
25;Lleida;4;Alt Urgell;25155;Organyà;1;1;U;;856;347;463;578;278;0;3;575;578
8;Barcelona;24;Osona;08150;Orís;1;1;U;;199;41;112;140;59;2;1;137;138
8;Barcelona;24;Osona;08151;Oristà;1;1;U;;561;125;270;363;198;0;2;361;363
8;Barcelona;6;Anoia;08152;Orpí;1;1;U;;127;47;84;100;27;0;1;99;100
8;Barcelona;21;Maresme;08153;Òrrius;1;1;U;;398;160;251;294;104;0;2;292;294
25;Lleida;23;Noguera;25156;Os de Balaguer;1;1;A;;380;107;227;279;101;0;1;278;279
25;Lleida;23;Noguera;25156;Os de Balaguer;1;1;B;;266;75;155;188;78;6;1;181;182
17;Girona;34;Selva;17116;Osor;1;1;U;;391;111;220;276;115;1;0;275;275
25;Lleida;38;Urgell;25157;Ossó de Sió;1;1;U;;195;46;105;143;52;2;1;140;141
8;Barcelona;3;Alt Penedès;08154;Pacs del Penedès;1;1;U;;485;174;301;363;122;1;4;358;362
8;Barcelona;21;Maresme;08155;Palafolls;1;1;A;;969;176;410;557;412;1;7;549;556
8;Barcelona;21;Maresme;08155;Palafolls;1;1;B;;1277;267;568;765;512;2;4;759;763
8;Barcelona;21;Maresme;08155;Palafolls;1;2;A;;676;131;301;417;259;2;3;412;415
8;Barcelona;21;Maresme;08155;Palafolls;1;2;B;;860;175;346;471;389;1;3;467;470
8;Barcelona;21;Maresme;08155;Palafolls;1;2;C;;355;90;161;212;143;1;0;211;211
17;Girona;10;Baix Empordà;17117;Palafrugell;1;1;A;;567;140;248;335;232;1;4;330;334
17;Girona;10;Baix Empordà;17117;Palafrugell;1;1;B;;511;119;219;286;225;1;5;280;285
17;Girona;10;Baix Empordà;17117;Palafrugell;1;1;C;;537;139;238;311;226;0;4;307;311
17;Girona;10;Baix Empordà;17117;Palafrugell;1;2;A;;566;150;253;304;262;0;6;298;304
17;Girona;10;Baix Empordà;17117;Palafrugell;1;2;B;;553;150;269;330;223;0;5;325;330
17;Girona;10;Baix Empordà;17117;Palafrugell;1;2;C;;641;194;324;401;240;0;5;396;401
17;Girona;10;Baix Empordà;17117;Palafrugell;1;3;A;;442;96;200;261;181;0;2;259;261
17;Girona;10;Baix Empordà;17117;Palafrugell;1;3;B;;423;102;186;240;183;2;3;235;238
17;Girona;10;Baix Empordà;17117;Palafrugell;1;3;C;;444;89;180;255;189;2;4;249;253
17;Girona;10;Baix Empordà;17117;Palafrugell;1;4;A;;576;137;234;318;258;1;1;316;317
17;Girona;10;Baix Empordà;17117;Palafrugell;1;4;B;;637;133;288;380;257;2;7;371;378
17;Girona;10;Baix Empordà;17117;Palafrugell;2;1;A;;493;123;241;301;192;1;1;299;300
17;Girona;10;Baix Empordà;17117;Palafrugell;2;1;B;;500;139;240;292;208;1;6;285;291
17;Girona;10;Baix Empordà;17117;Palafrugell;2;1;C;;515;136;136;277;238;0;1;276;277
17;Girona;10;Baix Empordà;17117;Palafrugell;2;2;A;;462;142;235;282;180;3;1;278;279
17;Girona;10;Baix Empordà;17117;Palafrugell;2;2;B;;530;153;264;322;208;1;8;313;321
17;Girona;10;Baix Empordà;17117;Palafrugell;2;2;C;;583;163;284;351;232;1;4;346;350
17;Girona;10;Baix Empordà;17117;Palafrugell;2;3;A;;805;146;307;388;417;1;5;382;387
17;Girona;10;Baix Empordà;17117;Palafrugell;2;3;B;;854;242;405;504;350;3;5;496;501
17;Girona;10;Baix Empordà;17117;Palafrugell;3;1;A;;897;200;410;511;386;1;6;504;510
17;Girona;10;Baix Empordà;17117;Palafrugell;3;1;B;;893;200;397;537;356;0;3;534;537
17;Girona;10;Baix Empordà;17117;Palafrugell;3;2;A;;639;164;317;400;239;1;4;395;399
17;Girona;10;Baix Empordà;17117;Palafrugell;3;2;B;;660;188;362;452;208;0;1;451;452
17;Girona;10;Baix Empordà;17117;Palafrugell;3;2;C;;242;48;128;166;76;1;4;161;165
17;Girona;10;Baix Empordà;17118;Palamós;1;1;A;;714;209;331;388;326;2;7;379;386
17;Girona;10;Baix Empordà;17118;Palamós;1;1;B;;662;197;329;389;273;0;11;378;389
17;Girona;10;Baix Empordà;17118;Palamós;1;2;A;;677;196;319;383;294;0;4;379;383
17;Girona;10;Baix Empordà;17118;Palamós;1;2;B;;651;175;308;380;271;0;7;373;380
17;Girona;10;Baix Empordà;17118;Palamós;1;3;A;;667;178;330;393;274;0;4;389;393
17;Girona;10;Baix Empordà;17118;Palamós;1;3;B;;677;180;311;381;296;1;7;373;380
17;Girona;10;Baix Empordà;17118;Palamós;1;4;U;;741;170;361;457;284;1;7;449;456
17;Girona;10;Baix Empordà;17118;Palamós;2;1;A;;465;134;233;274;191;1;3;270;273
17;Girona;10;Baix Empordà;17118;Palamós;2;1;B;;396;115;195;234;162;0;4;230;234
17;Girona;10;Baix Empordà;17118;Palamós;2;2;A;;576;156;273;321;255;0;4;317;321
17;Girona;10;Baix Empordà;17118;Palamós;2;2;B;;529;164;259;308;221;1;8;299;307
17;Girona;10;Baix Empordà;17118;Palamós;3;1;A;;373;82;148;188;185;3;1;184;185
17;Girona;10;Baix Empordà;17118;Palamós;3;1;B;;918;285;454;541;377;2;3;536;539
17;Girona;10;Baix Empordà;17118;Palamós;3;1;C;;934;256;438;517;417;1;8;508;516
17;Girona;10;Baix Empordà;17118;Palamós;3;2;U;;1004;193;370;514;490;0;6;508;514
17;Girona;10;Baix Empordà;17118;Palamós;4;1;A;;701;149;322;385;316;4;0;381;381
17;Girona;10;Baix Empordà;17118;Palamós;4;1;B;;710;120;282;372;338;1;2;369;371
17;Girona;10;Baix Empordà;17118;Palamós;4;2;A;;409;81;158;216;193;0;5;211;216
17;Girona;10;Baix Empordà;17118;Palamós;4;2;B;;347;77;155;198;149;1;1;196;197
25;Lleida;27;Pla d'Urgell;25158;Palau d'Anglesola, el;1;1;U;;1363;281;692;931;432;4;17;910;927
17;Girona;2;Alt Empordà;17119;Palau de Santa Eulàlia;1;1;U;;81;25;36;54;27;0;0;54;54
17;Girona;10;Baix Empordà;17121;Palau-sator;1;1;U;;256;73;154;190;66;1;4;185;189
17;Girona;2;Alt Empordà;17120;Palau-saverdera;1;1;U;;676;196;428;534;142;7;4;523;527
8;Barcelona;40;Vallès Occidental;08156;Palau-solità i Plegamans;1;1;A;;493;95;204;265;228;1;1;263;264
8;Barcelona;40;Vallès Occidental;08156;Palau-solità i Plegamans;1;1;B;;553;119;247;310;243;2;0;308;308
8;Barcelona;40;Vallès Occidental;08156;Palau-solità i Plegamans;1;1;C;;546;141;245;325;221;1;0;324;324
8;Barcelona;40;Vallès Occidental;08156;Palau-solità i Plegamans;1;2;A;;485;109;219;283;202;1;1;281;282
8;Barcelona;40;Vallès Occidental;08156;Palau-solità i Plegamans;1;2;B;;498;83;201;260;238;0;0;260;260
8;Barcelona;40;Vallès Occidental;08156;Palau-solità i Plegamans;1;2;C;;529;103;225;296;233;0;2;294;296
8;Barcelona;40;Vallès Occidental;08156;Palau-solità i Plegamans;1;2;D;;482;95;207;266;216;2;0;264;264
8;Barcelona;40;Vallès Occidental;08156;Palau-solità i Plegamans;1;3;A;;503;104;215;284;219;2;4;278;282
8;Barcelona;40;Vallès Occidental;08156;Palau-solità i Plegamans;1;3;B;;589;136;259;340;249;1;2;337;339
8;Barcelona;40;Vallès Occidental;08156;Palau-solità i Plegamans;1;4;A;;619;139;269;365;254;0;2;363;365
8;Barcelona;40;Vallès Occidental;08156;Palau-solità i Plegamans;1;4;B;;585;133;239;331;254;0;6;325;331
8;Barcelona;40;Vallès Occidental;08156;Palau-solità i Plegamans;1;4;C;;615;146;275;355;260;1;4;350;354
8;Barcelona;40;Vallès Occidental;08156;Palau-solità i Plegamans;1;4;D;;598;162;275;387;211;2;6;379;385
8;Barcelona;40;Vallès Occidental;08156;Palau-solità i Plegamans;1;5;U;;546;153;275;356;190;0;2;354;356
8;Barcelona;40;Vallès Occidental;08156;Palau-solità i Plegamans;1;6;A;;500;85;200;276;224;0;2;274;276
8;Barcelona;40;Vallès Occidental;08156;Palau-solità i Plegamans;1;6;B;;555;99;222;311;244;1;2;308;310
43;Tarragona;36;Tarragonès;43100;Pallaresos, els;1;1;A;;877;178;373;516;361;0;4;512;516
43;Tarragona;36;Tarragonès;43100;Pallaresos, els;1;1;B;;1012;197;417;568;444;1;5;562;567
8;Barcelona;11;Baix Llobregat;08157;Pallejà;1;1;A;;653;117;278;379;274;1;2;376;378
8;Barcelona;11;Baix Llobregat;08157;Pallejà;1;1;B;;727;135;302;430;297;0;2;428;430
8;Barcelona;11;Baix Llobregat;08157;Pallejà;1;1;C;;684;115;330;415;269;0;7;408;415
8;Barcelona;11;Baix Llobregat;08157;Pallejà;1;2;A;;637;117;279;376;261;0;0;376;376
8;Barcelona;11;Baix Llobregat;08157;Pallejà;1;2;B;;831;152;335;463;368;0;2;461;463
8;Barcelona;11;Baix Llobregat;08157;Pallejà;1;3;A;;735;147;327;439;296;0;1;438;439
8;Barcelona;11;Baix Llobregat;08157;Pallejà;1;3;B;;763;152;343;475;288;3;3;469;472
8;Barcelona;11;Baix Llobregat;08157;Pallejà;1;4;U;;950;230;441;578;372;1;8;569;577
43;Tarragona;30;Ribera d'Ebre;43099;Palma d'Ebre, la;1;1;U;;370;110;250;302;68;1;4;297;301
8;Barcelona;11;Baix Llobregat;08905;Palma de Cervelló, la;1;1;A;;955;241;472;606;349;2;3;601;604
8;Barcelona;11;Baix Llobregat;08905;Palma de Cervelló, la;1;1;B;;1040;253;486;652;388;3;4;645;649
17;Girona;28;Pla de l'Estany;17123;Palol de Revardit;1;1;U;;317;101;182;235;82;0;4;231;235
17;Girona;10;Baix Empordà;17124;Pals;1;1;A;;772;228;448;540;232;1;1;538;539
17;Girona;10;Baix Empordà;17124;Pals;1;1;B;;780;230;459;584;196;4;4;576;580
8;Barcelona;11;Baix Llobregat;08158;Papiol, el;1;1;A;;734;157;344;463;271;0;5;458;463
8;Barcelona;11;Baix Llobregat;08158;Papiol, el;1;1;B;;799;159;375;498;301;4;3;491;494
8;Barcelona;11;Baix Llobregat;08158;Papiol, el;1;2;A;;589;122;275;353;236;2;2;349;351
8;Barcelona;11;Baix Llobregat;08158;Papiol, el;1;2;B;;686;150;330;415;271;0;5;410;415
17;Girona;31;Ripollès;17125;Pardines;1;1;U;;123;32;70;92;31;1;0;91;91
8;Barcelona;41;Vallès Oriental;08159;Parets del Vallès;1;1;A;;503;111;234;303;200;1;4;298;302
8;Barcelona;41;Vallès Oriental;08159;Parets del Vallès;1;1;B;;580;130;262;344;236;0;4;340;344
8;Barcelona;41;Vallès Oriental;08159;Parets del Vallès;1;2;A;;881;190;393;513;368;0;4;509;513
8;Barcelona;41;Vallès Oriental;08159;Parets del Vallès;1;2;B;;1138;273;544;695;443;0;3;692;695
8;Barcelona;41;Vallès Oriental;08159;Parets del Vallès;1;3;A;;532;122;213;309;223;0;1;308;309
8;Barcelona;41;Vallès Oriental;08159;Parets del Vallès;1;3;B;;690;159;301;406;284;1;2;403;405
8;Barcelona;41;Vallès Oriental;08159;Parets del Vallès;2;1;A;;475;96;185;260;215;0;1;259;260
8;Barcelona;41;Vallès Oriental;08159;Parets del Vallès;2;1;B;;502;119;216;283;219;0;3;280;283
8;Barcelona;41;Vallès Oriental;08159;Parets del Vallès;2;2;A;;392;68;157;196;196;0;0;196;196
8;Barcelona;41;Vallès Oriental;08159;Parets del Vallès;2;2;B;;454;93;192;266;188;0;5;261;266
8;Barcelona;41;Vallès Oriental;08159;Parets del Vallès;2;3;A;;687;146;267;357;330;2;3;352;355
8;Barcelona;41;Vallès Oriental;08159;Parets del Vallès;2;3;B;;798;159;316;417;381;4;3;410;413
8;Barcelona;41;Vallès Oriental;08159;Parets del Vallès;2;4;A;;690;143;291;390;300;0;0;390;390
8;Barcelona;41;Vallès Oriental;08159;Parets del Vallès;2;4;B;;898;167;361;475;423;2;3;470;473
8;Barcelona;41;Vallès Oriental;08159;Parets del Vallès;2;4;C;;812;172;348;450;362;2;3;445;448
8;Barcelona;41;Vallès Oriental;08159;Parets del Vallès;2;5;A;;707;107;261;374;333;1;2;371;373
8;Barcelona;41;Vallès Oriental;08159;Parets del Vallès;2;5;B;;735;121;284;410;325;0;3;407;410
17;Girona;10;Baix Empordà;17126;Parlavà;1;1;U;;280;108;196;225;55;1;4;220;224
43;Tarragona;16;Conca de Barberà;43101;Passanant i Belltall;1;1;U;;173;45;77;99;74;1;1;97;98
17;Girona;2;Alt Empordà;17128;Pau;1;1;U;;267;78;151;186;81;1;1;184;185
43;Tarragona;9;Baix Ebre;43102;Paüls;1;1;U;;557;85;300;442;115;0;0;442;442
17;Girona;2;Alt Empordà;17129;Pedret i Marzà;1;1;U;;108;32;54;76;32;3;0;73;73
25;Lleida;23;Noguera;25164;Penelles;1;1;U;;463;84;245;303;160;1;5;297;302
17;Girona;10;Baix Empordà;17130;Pera, la;1;1;U;;307;95;179;229;78;1;2;226;228
8;Barcelona;24;Osona;08160;Perafita;1;1;U;;309;129;193;224;85;0;4;220;224
43;Tarragona;36;Tarragonès;43103;Perafort;1;1;U;;498;94;239;304;194;0;1;303;304
17;Girona;2;Alt Empordà;17132;Peralada;1;1;A;;848;294;538;632;216;2;5;625;630
17;Girona;2;Alt Empordà;17132;Peralada;1;1;B;;196;66;118;138;58;1;3;134;137
25;Lleida;4;Alt Urgell;25165;Peramola;1;1;U;;349;121;228;272;77;0;0;272;272
43;Tarragona;9;Baix Ebre;43104;Perelló, el;1;1;U;;674;242;408;487;187;3;3;481;484
43;Tarragona;9;Baix Ebre;43104;Perelló, el;1;2;A;;471;146;259;340;131;0;0;340;340
43;Tarragona;9;Baix Ebre;43104;Perelló, el;1;2;B;;622;199;375;482;140;2;0;480;480
8;Barcelona;6;Anoia;08161;Piera;1;1;U;;614;117;269;350;264;1;1;348;349
8;Barcelona;6;Anoia;08161;Piera;1;2;A;;769;192;385;490;279;1;4;485;489
8;Barcelona;6;Anoia;08161;Piera;1;2;B;;714;155;365;461;253;2;1;458;459
8;Barcelona;6;Anoia;08161;Piera;1;3;A;;673;150;327;426;247;0;1;425;426
8;Barcelona;6;Anoia;08161;Piera;1;3;B;;805;162;390;514;291;0;3;511;514
8;Barcelona;6;Anoia;08161;Piera;1;4;U;;889;210;373;468;421;2;2;464;466
8;Barcelona;6;Anoia;08161;Piera;1;5;A;;766;191;325;420;346;3;4;413;417
8;Barcelona;6;Anoia;08161;Piera;1;5;B;;889;191;374;484;405;1;6;477;483
8;Barcelona;6;Anoia;08161;Piera;1;6;U;;906;170;295;362;544;0;5;357;362
43;Tarragona;16;Conca de Barberà;43105;Piles, les;1;1;U;;140;34;80;95;45;0;5;90;95
8;Barcelona;21;Maresme;08163;Pineda de Mar;1;1;A;;522;129;225;310;212;1;2;307;309
8;Barcelona;21;Maresme;08163;Pineda de Mar;1;1;B;;574;138;269;355;219;3;2;350;352
8;Barcelona;21;Maresme;08163;Pineda de Mar;1;10;U;;953;234;415;534;419;0;5;529;534
8;Barcelona;21;Maresme;08163;Pineda de Mar;1;11;U;;929;240;500;566;363;1;4;561;565
8;Barcelona;21;Maresme;08163;Pineda de Mar;1;12;U;;877;247;428;528;349;4;4;520;524
8;Barcelona;21;Maresme;08163;Pineda de Mar;1;13;A;;499;119;210;298;201;0;2;296;298
8;Barcelona;21;Maresme;08163;Pineda de Mar;1;13;B;;664;169;283;372;292;0;5;367;372
8;Barcelona;21;Maresme;08163;Pineda de Mar;1;2;A;;611;185;308;384;227;2;3;379;382
8;Barcelona;21;Maresme;08163;Pineda de Mar;1;2;B;;720;190;340;416;304;1;4;411;415
8;Barcelona;21;Maresme;08163;Pineda de Mar;1;3;A;;451;121;223;280;171;0;1;279;280
8;Barcelona;21;Maresme;08163;Pineda de Mar;1;3;B;;554;123;260;327;227;0;2;325;327
8;Barcelona;21;Maresme;08163;Pineda de Mar;1;4;A;;774;184;349;400;374;0;2;398;400
8;Barcelona;21;Maresme;08163;Pineda de Mar;1;4;B;;935;200;376;476;459;0;3;473;476
8;Barcelona;21;Maresme;08163;Pineda de Mar;1;5;A;;681;168;293;368;313;1;3;364;367
8;Barcelona;21;Maresme;08163;Pineda de Mar;1;5;B;;880;210;366;460;420;0;2;458;460
8;Barcelona;21;Maresme;08163;Pineda de Mar;1;6;U;;871;250;401;498;373;2;2;494;496
8;Barcelona;21;Maresme;08163;Pineda de Mar;1;7;A;;640;163;290;390;250;0;2;388;390
8;Barcelona;21;Maresme;08163;Pineda de Mar;1;7;B;;818;210;409;513;305;4;4;505;509
8;Barcelona;21;Maresme;08163;Pineda de Mar;1;8;A;;482;109;212;266;216;0;2;264;266
8;Barcelona;21;Maresme;08163;Pineda de Mar;1;8;B;;581;137;261;343;238;0;3;340;343
8;Barcelona;21;Maresme;08163;Pineda de Mar;1;9;A;;698;169;325;415;283;0;5;410;415
8;Barcelona;21;Maresme;08163;Pineda de Mar;1;9;B;;714;179;308;400;314;0;2;398;400
43;Tarragona;37;Terra Alta;43106;Pinell de Brai, el;1;1;U;;931;170;424;607;324;0;1;606;607
25;Lleida;35;Solsonès;25166;Pinell de Solsonès;1;1;U;;196;32;90;143;53;0;1;142;143
25;Lleida;35;Solsonès;25167;Pinós;1;1;U;;288;75;136;195;93;3;6;186;192
43;Tarragona;16;Conca de Barberà;43107;Pira;1;1;U;;346;76;186;229;117;1;0;228;228
8;Barcelona;3;Alt Penedès;08164;Pla del Penedès, el;1;1;U;;812;190;427;583;229;2;2;579;581
43;Tarragona;1;Alt Camp;43108;Pla de Santa Maria, el;1;1;A;;667;175;365;473;194;3;0;470;470
43;Tarragona;1;Alt Camp;43108;Pla de Santa Maria, el;1;1;B;;644;125;310;436;208;1;1;434;435
17;Girona;19;Garrotxa;17133;Planes d'Hostoles, les;1;1;A;;841;273;532;620;221;6;4;610;614
17;Girona;19;Garrotxa;17133;Planes d'Hostoles, les;1;1;B;;649;214;412;485;164;0;5;480;485
17;Girona;31;Ripollès;17134;Planoles;1;1;U;;270;97;150;184;86;3;4;177;181
25;Lleida;32;Segarra;25911;Plans de Sió, els;1;1;U;;555;99;316;383;172;3;2;378;380
25;Lleida;27;Pla d'Urgell;25168;Poal, el;1;1;U;;502;185;300;377;125;1;3;373;376
25;Lleida;18;Garrigues;25169;Pobla de Cérvoles, la;1;1;U;;180;67;100;125;55;0;2;123;125
8;Barcelona;6;Anoia;08165;Pobla de Claramunt, la;1;1;A;;663;175;337;452;211;1;1;450;451
8;Barcelona;6;Anoia;08165;Pobla de Claramunt, la;1;1;B;;781;212;391;521;260;0;1;520;521
8;Barcelona;14;Berguedà;08166;Pobla de Lillet, la;1;1;U;;431;140;251;301;130;0;0;301;301
8;Barcelona;14;Berguedà;08166;Pobla de Lillet, la;1;2;A;;489;160;291;344;145;1;3;340;343
8;Barcelona;14;Berguedà;08166;Pobla de Lillet, la;1;2;B;;404;134;252;300;104;2;1;297;298
43;Tarragona;36;Tarragonès;43109;Pobla de Mafumet, la;1;1;U;;897;121;364;566;331;3;6;557;563
43;Tarragona;37;Terra Alta;43110;Pobla de Massaluca, la;1;1;U;;412;93;195;246;166;2;2;242;244
43;Tarragona;36;Tarragonès;43111;Pobla de Montornès, la;1;1;U;;1089;290;531;638;451;4;3;631;634
25;Lleida;25;Pallars Jussà;25171;Pobla de Segur, la;1;1;U;;1134;259;540;742;392;0;11;731;742
25;Lleida;25;Pallars Jussà;25171;Pobla de Segur, la;1;2;A;;652;165;318;446;206;0;1;445;446
25;Lleida;25;Pallars Jussà;25171;Pobla de Segur, la;1;2;B;;702;188;339;459;243;1;3;455;458
43;Tarragona;29;Priorat;43112;Poboleda;1;1;U;;300;75;127;179;121;0;0;179;179
8;Barcelona;40;Vallès Occidental;08167;Polinyà;1;1;A;;713;148;287;379;334;0;2;377;379
8;Barcelona;40;Vallès Occidental;08167;Polinyà;1;1;B;;796;138;297;431;365;2;6;423;429
8;Barcelona;40;Vallès Occidental;08167;Polinyà;1;1;C;;807;169;350;479;328;1;2;476;478
8;Barcelona;40;Vallès Occidental;08167;Polinyà;1;2;A;;552;97;211;278;274;2;0;276;276
8;Barcelona;40;Vallès Occidental;08167;Polinyà;1;2;B;;661;119;251;333;328;2;5;326;331
43;Tarragona;1;Alt Camp;43113;Pont d'Armentera, el;1;1;U;;526;148;305;377;149;2;7;368;375
25;Lleida;4;Alt Urgell;25030;Pont de Bar, el;1;1;U;;134;45;73;82;52;0;0;82;82
17;Girona;2;Alt Empordà;17135;Pont de Molins;1;1;U;;372;98;181;226;146;0;1;225;226
25;Lleida;5;Alta Ribagorça;25173;Pont de Suert, el;1;1;U;;1078;252;469;667;411;1;0;666;666
25;Lleida;5;Alta Ribagorça;25173;Pont de Suert, el;1;2;U;;789;198;363;500;289;1;2;497;499
8;Barcelona;7;Bages;08182;Pont de Vilomara i Rocafort, el;1;1;A;;579;127;272;351;228;2;1;348;349
8;Barcelona;7;Bages;08182;Pont de Vilomara i Rocafort, el;1;1;B;;804;160;348;493;311;0;2;491;493
8;Barcelona;7;Bages;08182;Pont de Vilomara i Rocafort, el;1;1;C;;768;165;359;489;279;4;3;482;485
43;Tarragona;16;Conca de Barberà;43141;Pontils;1;1;U;;131;18;45;77;54;1;1;75;76
8;Barcelona;3;Alt Penedès;08168;Pontons;1;1;U;;323;78;164;238;85;0;2;236;238
17;Girona;2;Alt Empordà;17136;Pontós;1;1;U;;184;66;100;125;59;2;0;123;123
25;Lleida;23;Noguera;25172;Ponts;1;1;U;;885;262;551;664;221;11;7;646;653
25;Lleida;23;Noguera;25172;Ponts;1;2;U;;1077;245;564;777;300;4;5;768;773
17;Girona;28;Pla de l'Estany;17137;Porqueres;1;1;U;;824;190;399;516;308;1;3;512;515
17;Girona;28;Pla de l'Estany;17137;Porqueres;1;2;A;;699;198;413;505;194;1;6;498;504
17;Girona;28;Pla de l'Estany;17137;Porqueres;1;2;B;;604;146;332;418;186;0;3;415;418
17;Girona;28;Pla de l'Estany;17137;Porqueres;1;2;C;;741;206;413;513;228;1;3;509;512
43;Tarragona;29;Priorat;43114;Porrera;1;1;U;;398;54;157;217;181;0;2;215;217
17;Girona;2;Alt Empordà;17138;Portbou;1;1;A;;680;221;403;477;203;1;4;472;476
17;Girona;2;Alt Empordà;17138;Portbou;1;1;B;;687;236;371;476;211;1;2;473;475
17;Girona;2;Alt Empordà;17140;Port de la Selva, el;1;1;U;;747;215;412;519;228;4;6;509;515
25;Lleida;33;Segrià;25174;Portella, la;1;1;U;;500;128;297;375;125;0;0;375;375
43;Tarragona;29;Priorat;43115;Pradell de la Teixeta;1;1;U;;184;37;95;130;54;1;2;127;129
43;Tarragona;8;Baix Camp;43116;Prades;1;1;U;;463;113;231;309;154;0;1;308;309
43;Tarragona;37;Terra Alta;43117;Prat de Comte;1;1;U;;164;28;79;116;48;0;1;115;116
8;Barcelona;11;Baix Llobregat;08169;Prat de Llobregat, el;1;1;A;;631;134;274;370;261;0;2;368;370
8;Barcelona;11;Baix Llobregat;08169;Prat de Llobregat, el;1;1;B;;774;162;326;456;318;0;4;452;456
8;Barcelona;11;Baix Llobregat;08169;Prat de Llobregat, el;1;2;A;;636;147;292;370;266;0;2;368;370
8;Barcelona;11;Baix Llobregat;08169;Prat de Llobregat, el;1;2;B;;735;194;350;453;282;0;0;453;453
8;Barcelona;11;Baix Llobregat;08169;Prat de Llobregat, el;1;3;U;;1000;173;453;611;389;8;0;603;603
8;Barcelona;11;Baix Llobregat;08169;Prat de Llobregat, el;1;4;A;;725;195;363;440;285;1;1;438;439
8;Barcelona;11;Baix Llobregat;08169;Prat de Llobregat, el;1;4;B;;863;203;387;495;368;1;6;488;494
8;Barcelona;11;Baix Llobregat;08169;Prat de Llobregat, el;1;5;A;;577;140;248;316;261;2;0;314;314
8;Barcelona;11;Baix Llobregat;08169;Prat de Llobregat, el;1;5;B;;668;125;270;330;338;1;1;328;329
8;Barcelona;11;Baix Llobregat;08169;Prat de Llobregat, el;2;1;A;;710;203;374;475;235;1;4;470;474
8;Barcelona;11;Baix Llobregat;08169;Prat de Llobregat, el;2;1;B;;807;211;367;483;324;1;9;473;482
8;Barcelona;11;Baix Llobregat;08169;Prat de Llobregat, el;2;2;A;;739;184;312;410;329;0;4;406;410
8;Barcelona;11;Baix Llobregat;08169;Prat de Llobregat, el;2;2;B;;848;195;364;475;373;1;12;462;474
8;Barcelona;11;Baix Llobregat;08169;Prat de Llobregat, el;2;3;A;;535;125;213;296;239;0;6;290;296
8;Barcelona;11;Baix Llobregat;08169;Prat de Llobregat, el;2;3;B;;608;131;237;313;295;0;2;311;313
8;Barcelona;11;Baix Llobregat;08169;Prat de Llobregat, el;2;4;A;;720;155;310;403;317;0;1;402;403
8;Barcelona;11;Baix Llobregat;08169;Prat de Llobregat, el;2;4;B;;835;172;336;447;388;1;9;437;446
8;Barcelona;11;Baix Llobregat;08169;Prat de Llobregat, el;2;5;A;;752;143;299;393;359;1;2;390;392
8;Barcelona;11;Baix Llobregat;08169;Prat de Llobregat, el;2;5;B;;820;140;319;429;391;1;1;427;428
8;Barcelona;11;Baix Llobregat;08169;Prat de Llobregat, el;2;6;A;;868;180;365;509;359;1;8;500;508
8;Barcelona;11;Baix Llobregat;08169;Prat de Llobregat, el;2;6;B;;906;158;383;519;387;1;5;513;518
8;Barcelona;11;Baix Llobregat;08169;Prat de Llobregat, el;2;7;A;;635;130;262;375;260;1;3;371;374
8;Barcelona;11;Baix Llobregat;08169;Prat de Llobregat, el;2;7;B;;713;127;275;392;321;2;2;388;390
8;Barcelona;11;Baix Llobregat;08169;Prat de Llobregat, el;3;1;A;;563;132;267;351;212;0;4;347;351
8;Barcelona;11;Baix Llobregat;08169;Prat de Llobregat, el;3;1;B;;655;143;302;395;260;0;3;392;395
8;Barcelona;11;Baix Llobregat;08169;Prat de Llobregat, el;3;10;A;;769;120;265;369;400;0;0;369;369
8;Barcelona;11;Baix Llobregat;08169;Prat de Llobregat, el;3;10;B;;767;105;251;361;406;0;2;359;361
8;Barcelona;11;Baix Llobregat;08169;Prat de Llobregat, el;3;2;A;;553;80;213;288;265;0;1;287;288
8;Barcelona;11;Baix Llobregat;08169;Prat de Llobregat, el;3;2;B;;661;95;238;315;346;2;3;310;313
8;Barcelona;11;Baix Llobregat;08169;Prat de Llobregat, el;3;3;A;;686;124;250;368;318;0;5;363;368
8;Barcelona;11;Baix Llobregat;08169;Prat de Llobregat, el;3;3;B;;735;134;253;368;367;0;2;366;368
8;Barcelona;11;Baix Llobregat;08169;Prat de Llobregat, el;3;4;A;;600;110;218;329;271;0;5;324;329
8;Barcelona;11;Baix Llobregat;08169;Prat de Llobregat, el;3;4;B;;761;170;293;402;359;1;5;396;401
8;Barcelona;11;Baix Llobregat;08169;Prat de Llobregat, el;3;5;A;;821;167;357;473;348;0;3;470;473
8;Barcelona;11;Baix Llobregat;08169;Prat de Llobregat, el;3;5;B;;952;213;399;541;411;0;1;540;541
8;Barcelona;11;Baix Llobregat;08169;Prat de Llobregat, el;3;6;A;;539;70;172;287;252;2;1;284;285
8;Barcelona;11;Baix Llobregat;08169;Prat de Llobregat, el;3;6;B;;656;112;246;364;292;0;4;360;364
8;Barcelona;11;Baix Llobregat;08169;Prat de Llobregat, el;3;7;A;;862;165;364;472;390;0;4;468;472
8;Barcelona;11;Baix Llobregat;08169;Prat de Llobregat, el;3;7;B;;913;172;349;478;435;2;2;474;476
8;Barcelona;11;Baix Llobregat;08169;Prat de Llobregat, el;3;8;A;;815;152;295;416;399;0;3;413;416
8;Barcelona;11;Baix Llobregat;08169;Prat de Llobregat, el;3;8;B;;1037;170;345;481;556;1;2;478;480
8;Barcelona;11;Baix Llobregat;08169;Prat de Llobregat, el;3;9;A;;961;147;320;465;496;0;2;463;465
8;Barcelona;11;Baix Llobregat;08169;Prat de Llobregat, el;3;9;B;;949;150;325;471;478;2;6;463;469
8;Barcelona;11;Baix Llobregat;08169;Prat de Llobregat, el;4;1;U;;930;191;394;510;420;0;6;504;510
8;Barcelona;11;Baix Llobregat;08169;Prat de Llobregat, el;4;2;A;;684;107;224;296;388;1;1;294;295
8;Barcelona;11;Baix Llobregat;08169;Prat de Llobregat, el;4;2;B;;793;133;253;326;467;1;3;322;325
8;Barcelona;11;Baix Llobregat;08169;Prat de Llobregat, el;4;3;A;;587;114;196;247;340;0;4;243;247
8;Barcelona;11;Baix Llobregat;08169;Prat de Llobregat, el;4;3;B;;694;141;256;317;377;0;2;315;317
8;Barcelona;11;Baix Llobregat;08169;Prat de Llobregat, el;4;4;A;;499;94;191;234;265;0;1;233;234
8;Barcelona;11;Baix Llobregat;08169;Prat de Llobregat, el;4;4;B;;620;117;201;246;374;1;0;245;245
8;Barcelona;11;Baix Llobregat;08169;Prat de Llobregat, el;4;5;A;;568;103;193;240;328;2;3;235;238
8;Barcelona;11;Baix Llobregat;08169;Prat de Llobregat, el;4;5;B;;703;154;241;313;390;0;2;311;313
8;Barcelona;11;Baix Llobregat;08169;Prat de Llobregat, el;4;6;U;;454;38;91;115;339;0;0;115;115
8;Barcelona;11;Baix Llobregat;08169;Prat de Llobregat, el;4;7;U;;323;10;26;41;282;0;2;39;41
8;Barcelona;11;Baix Llobregat;08169;Prat de Llobregat, el;5;1;A;;606;102;236;324;282;0;4;320;324
8;Barcelona;11;Baix Llobregat;08169;Prat de Llobregat, el;5;1;B;;634;180;294;357;277;2;4;351;355
8;Barcelona;11;Baix Llobregat;08169;Prat de Llobregat, el;5;2;A;;644;121;244;330;314;0;5;325;330
8;Barcelona;11;Baix Llobregat;08169;Prat de Llobregat, el;5;2;B;;629;103;224;328;301;1;2;325;327
8;Barcelona;11;Baix Llobregat;08169;Prat de Llobregat, el;5;3;A;;556;93;184;266;290;0;1;265;266
8;Barcelona;11;Baix Llobregat;08169;Prat de Llobregat, el;5;3;B;;611;104;218;293;318;0;2;291;293
8;Barcelona;11;Baix Llobregat;08169;Prat de Llobregat, el;5;4;U;;1276;226;513;744;532;0;11;733;744
8;Barcelona;11;Baix Llobregat;08169;Prat de Llobregat, el;5;5;A;;716;142;299;414;302;3;4;407;411
8;Barcelona;11;Baix Llobregat;08169;Prat de Llobregat, el;5;5;B;;838;182;338;443;395;0;2;441;443
8;Barcelona;11;Baix Llobregat;08169;Prat de Llobregat, el;5;6;A;;705;142;278;359;346;0;2;357;359
8;Barcelona;11;Baix Llobregat;08169;Prat de Llobregat, el;5;6;B;;831;134;295;414;417;0;3;411;414
8;Barcelona;11;Baix Llobregat;08169;Prat de Llobregat, el;5;7;A;;890;190;352;468;422;0;4;464;468
8;Barcelona;11;Baix Llobregat;08169;Prat de Llobregat, el;5;7;B;;1028;145;385;528;500;1;4;523;527
8;Barcelona;11;Baix Llobregat;08169;Prat de Llobregat, el;5;8;A;;899;155;326;488;411;0;2;486;488
8;Barcelona;11;Baix Llobregat;08169;Prat de Llobregat, el;5;8;B;;1137;232;442;620;517;1;9;610;619
43;Tarragona;8;Baix Camp;43118;Pratdip;1;1;U;;419;116;260;307;112;0;1;306;307
8;Barcelona;24;Osona;08171;Prats de Lluçanès;1;1;U;;1094;415;589;719;375;0;2;717;719
8;Barcelona;24;Osona;08171;Prats de Lluçanès;1;2;U;;1101;373;573;729;372;2;8;719;727
8;Barcelona;6;Anoia;08170;Prats de Rei, els;1;1;U;;473;145;260;316;157;2;3;311;314
25;Lleida;15;Cerdanya;25175;Prats i Sansor;1;1;U;;161;32;94;110;51;0;1;109;110
25;Lleida;38;Urgell;25176;Preixana;1;1;U;;388;92;220;273;115;0;2;271;273
25;Lleida;23;Noguera;25177;Preixens;1;1;U;;467;100;232;308;159;1;8;299;307
8;Barcelona;21;Maresme;08230;Premià de Dalt;1;1;A;;651;156;371;475;176;0;5;470;475
8;Barcelona;21;Maresme;08230;Premià de Dalt;1;1;B;;661;210;406;497;164;1;4;492;496
8;Barcelona;21;Maresme;08230;Premià de Dalt;1;2;A;;629;166;320;399;230;1;7;391;398
8;Barcelona;21;Maresme;08230;Premià de Dalt;1;2;B;;784;206;393;501;283;2;11;488;499
8;Barcelona;21;Maresme;08230;Premià de Dalt;1;3;A;;598;111;248;337;261;1;1;335;336
8;Barcelona;21;Maresme;08230;Premià de Dalt;1;3;B;;714;156;306;407;307;0;4;403;407
8;Barcelona;21;Maresme;08230;Premià de Dalt;1;4;A;;589;138;305;380;209;0;5;375;380
8;Barcelona;21;Maresme;08230;Premià de Dalt;1;4;B;;626;165;331;405;221;1;1;403;404
8;Barcelona;21;Maresme;08230;Premià de Dalt;1;5;U;;725;152;296;400;325;1;1;398;399
8;Barcelona;21;Maresme;08230;Premià de Dalt;1;6;U;;917;209;490;647;270;1;8;638;646
8;Barcelona;21;Maresme;08172;Premià de Mar;1;1;A;;927;235;469;587;340;1;10;576;586
8;Barcelona;21;Maresme;08172;Premià de Mar;1;1;B;;917;227;456;575;342;2;4;569;573
8;Barcelona;21;Maresme;08172;Premià de Mar;1;2;A;;855;239;471;569;286;2;8;559;567
8;Barcelona;21;Maresme;08172;Premià de Mar;1;2;B;;944;253;506;604;340;1;4;599;603
8;Barcelona;21;Maresme;08172;Premià de Mar;1;3;A;;873;218;421;544;329;0;3;541;544
8;Barcelona;21;Maresme;08172;Premià de Mar;1;3;B;;987;240;430;564;423;1;4;559;563
8;Barcelona;21;Maresme;08172;Premià de Mar;2;1;A;;733;194;366;461;272;1;8;452;460
8;Barcelona;21;Maresme;08172;Premià de Mar;2;1;B;;904;247;500;583;321;0;6;577;583
8;Barcelona;21;Maresme;08172;Premià de Mar;2;2;A;;526;148;249;321;205;4;0;317;317
8;Barcelona;21;Maresme;08172;Premià de Mar;2;2;B;;612;143;256;337;275;0;3;334;337
8;Barcelona;21;Maresme;08172;Premià de Mar;2;2;C;;687;177;309;393;294;1;4;388;392
8;Barcelona;21;Maresme;08172;Premià de Mar;2;3;A;;609;135;253;326;283;1;1;324;325
8;Barcelona;21;Maresme;08172;Premià de Mar;2;3;B;;779;168;328;428;351;0;7;421;428
8;Barcelona;21;Maresme;08172;Premià de Mar;2;4;A;;635;134;266;359;276;1;1;357;358
8;Barcelona;21;Maresme;08172;Premià de Mar;2;4;B;;726;152;304;415;311;0;3;412;415
8;Barcelona;21;Maresme;08172;Premià de Mar;3;1;A;;967;226;434;572;395;0;11;561;572
8;Barcelona;21;Maresme;08172;Premià de Mar;3;1;B;;1175;254;522;702;473;4;7;691;698
8;Barcelona;21;Maresme;08172;Premià de Mar;3;2;A;;561;144;281;303;258;0;5;298;303
8;Barcelona;21;Maresme;08172;Premià de Mar;3;2;B;;595;169;280;326;269;0;6;320;326
8;Barcelona;21;Maresme;08172;Premià de Mar;3;3;A;;517;129;253;312;205;1;2;309;311
8;Barcelona;21;Maresme;08172;Premià de Mar;3;3;B;;556;152;281;339;217;1;3;335;338
8;Barcelona;21;Maresme;08172;Premià de Mar;3;4;U;;1061;272;521;648;413;0;3;645;648
8;Barcelona;21;Maresme;08172;Premià de Mar;3;5;A;;517;107;202;253;264;1;1;251;252
8;Barcelona;21;Maresme;08172;Premià de Mar;3;5;B;;655;134;244;324;331;0;1;323;324
8;Barcelona;21;Maresme;08172;Premià de Mar;3;6;U;;1032;222;512;678;354;0;3;675;678
8;Barcelona;21;Maresme;08172;Premià de Mar;3;7;U;;1074;207;472;629;445;1;12;616;628
8;Barcelona;21;Maresme;08172;Premià de Mar;3;8;U;;863;197;394;492;371;2;3;487;490
17;Girona;19;Garrotxa;17139;Preses, les;1;1;A;;687;214;430;497;190;0;1;496;497
17;Girona;19;Garrotxa;17139;Preses, les;1;1;B;;457;130;264;313;144;2;3;308;311
25;Lleida;15;Cerdanya;25179;Prullans;1;1;U;;195;60;121;143;52;0;0;143;143
17;Girona;15;Cerdanya;17141;Puigcerdà;1;1;A;;452;79;190;232;220;0;1;231;232
17;Girona;15;Cerdanya;17141;Puigcerdà;1;1;B;;355;82;170;194;161;1;0;193;193
17;Girona;15;Cerdanya;17141;Puigcerdà;1;2;A;;718;142;343;431;287;5;6;420;426
17;Girona;15;Cerdanya;17141;Puigcerdà;1;2;B;;716;165;366;443;273;1;4;438;442
17;Girona;15;Cerdanya;17141;Puigcerdà;1;3;A;;949;182;415;540;409;2;7;531;538
17;Girona;15;Cerdanya;17141;Puigcerdà;1;3;B;;863;175;370;463;400;0;7;456;463
17;Girona;15;Cerdanya;17141;Puigcerdà;1;4;A;;804;177;369;438;366;0;3;435;438
17;Girona;15;Cerdanya;17141;Puigcerdà;1;4;B;;670;128;307;387;283;1;4;382;386
8;Barcelona;3;Alt Penedès;08174;Puigdàlber;1;1;U;;273;94;164;214;59;0;2;212;214
25;Lleida;18;Garrigues;25180;Puiggròs;1;1;U;;230;77;119;156;74;0;0;156;156
43;Tarragona;1;Alt Camp;43119;Puigpelat;1;1;U;;461;82;175;221;240;5;0;216;216
8;Barcelona;14;Berguedà;08175;Puig-reig;1;1;A;;945;194;497;660;285;4;1;655;656
8;Barcelona;14;Berguedà;08175;Puig-reig;1;1;B;;986;211;523;693;293;7;2;684;686
8;Barcelona;14;Berguedà;08175;Puig-reig;1;2;A;;543;117;289;380;163;1;2;377;379
8;Barcelona;14;Berguedà;08175;Puig-reig;1;2;B;;624;144;312;420;204;0;2;418;420
8;Barcelona;14;Berguedà;08175;Puig-reig;2;1;A;;258;56;154;200;58;3;3;194;197
8;Barcelona;14;Berguedà;08175;Puig-reig;2;1;B;;178;47;96;106;72;1;1;104;105
8;Barcelona;14;Berguedà;08175;Puig-reig;2;1;C;;309;89;200;248;61;1;1;246;247
25;Lleida;38;Urgell;25181;Puigverd d'Agramunt;1;1;U;;205;60;122;149;56;0;6;143;149
25;Lleida;33;Segrià;25182;Puigverd de Lleida;1;1;U;;890;209;494;606;284;7;1;598;599
8;Barcelona;6;Anoia;08176;Pujalt;1;1;U;;163;38;73;108;55;0;0;108;108
8;Barcelona;14;Berguedà;08177;Quar, la;1;1;U;;63;12;23;31;32;0;0;31;31
17;Girona;20;Gironès;17142;Quart;1;1;A;;648;148;356;439;209;2;4;433;437
17;Girona;20;Gironès;17142;Quart;1;1;B;;728;174;365;483;245;2;4;477;481
17;Girona;20;Gironès;17142;Quart;1;1;C;;469;117;236;310;159;0;2;308;310
17;Girona;31;Ripollès;17043;Queralbs;1;1;U;;185;82;124;147;38;0;0;147;147
43;Tarragona;1;Alt Camp;43120;Querol;1;1;U;;284;74;100;126;158;4;0;122;122
17;Girona;2;Alt Empordà;17143;Rabós;1;1;U;;131;40;71;85;46;0;0;85;85
8;Barcelona;7;Bages;08178;Rajadell;1;1;U;;441;103;228;295;146;1;7;287;294
43;Tarragona;30;Ribera d'Ebre;43121;Rasquera;1;1;U;;728;116;301;384;344;2;3;379;382
17;Girona;10;Baix Empordà;17144;Regencós;1;1;U;;240;77;138;167;73;0;1;166;167
8;Barcelona;40;Vallès Occidental;08179;Rellinars;1;1;U;;292;102;187;245;47;0;1;244;245
43;Tarragona;36;Tarragonès;43122;Renau;1;1;U;;49;19;34;41;8;0;0;41;41
43;Tarragona;8;Baix Camp;43123;Reus;1;1;U;;498;119;192;275;223;1;0;274;274
43;Tarragona;8;Baix Camp;43123;Reus;1;2;U;;463;121;206;250;213;0;1;249;250
43;Tarragona;8;Baix Camp;43123;Reus;1;3;A;;503;126;227;290;213;1;3;286;289
43;Tarragona;8;Baix Camp;43123;Reus;1;3;B;;555;141;242;305;250;2;0;303;303
43;Tarragona;8;Baix Camp;43123;Reus;1;4;A;;409;119;215;270;139;0;3;267;270
43;Tarragona;8;Baix Camp;43123;Reus;1;4;B;;371;91;163;220;151;1;2;217;219
43;Tarragona;8;Baix Camp;43123;Reus;1;4;C;;449;123;219;282;167;1;6;275;281
43;Tarragona;8;Baix Camp;43123;Reus;10;1;U;;561;94;210;280;281;0;1;279;280
43;Tarragona;8;Baix Camp;43123;Reus;2;1;U;;650;174;284;343;307;0;2;341;343
43;Tarragona;8;Baix Camp;43123;Reus;2;10;A;;505;114;226;300;205;3;6;291;297
43;Tarragona;8;Baix Camp;43123;Reus;2;10;B;;520;109;197;283;237;2;2;279;281
43;Tarragona;8;Baix Camp;43123;Reus;2;10;C;;596;101;232;329;267;0;2;327;329
43;Tarragona;8;Baix Camp;43123;Reus;2;11;A;;441;116;189;254;187;1;8;245;253
43;Tarragona;8;Baix Camp;43123;Reus;2;11;B;;544;142;226;295;249;0;2;293;295
43;Tarragona;8;Baix Camp;43123;Reus;2;12;U;;1009;172;369;519;490;0;3;516;519
43;Tarragona;8;Baix Camp;43123;Reus;2;13;A;;442;102;186;246;196;1;1;244;245
43;Tarragona;8;Baix Camp;43123;Reus;2;13;B;;566;121;231;318;248;1;2;315;317
43;Tarragona;8;Baix Camp;43123;Reus;2;14;A;;343;84;143;197;146;0;1;196;197
43;Tarragona;8;Baix Camp;43123;Reus;2;14;B;;380;92;174;239;141;1;4;234;238
43;Tarragona;8;Baix Camp;43123;Reus;2;2;A;;532;151;240;323;209;0;5;318;323
43;Tarragona;8;Baix Camp;43123;Reus;2;2;B;;499;130;231;289;210;0;3;286;289
43;Tarragona;8;Baix Camp;43123;Reus;2;2;C;;555;132;257;284;271;3;2;279;281
43;Tarragona;8;Baix Camp;43123;Reus;2;3;A;;414;73;150;228;186;0;2;226;228
43;Tarragona;8;Baix Camp;43123;Reus;2;3;B;;458;97;188;270;188;0;2;268;270
43;Tarragona;8;Baix Camp;43123;Reus;2;4;U;;653;153;225;344;309;0;4;340;344
43;Tarragona;8;Baix Camp;43123;Reus;2;5;A;;415;105;182;230;185;0;2;228;230
43;Tarragona;8;Baix Camp;43123;Reus;2;5;B;;449;136;207;261;188;0;2;259;261
43;Tarragona;8;Baix Camp;43123;Reus;2;6;A;;523;95;184;247;276;0;7;240;247
43;Tarragona;8;Baix Camp;43123;Reus;2;6;B;;571;100;197;265;306;0;6;259;265
43;Tarragona;8;Baix Camp;43123;Reus;2;6;C;;583;120;217;293;290;1;5;287;292
43;Tarragona;8;Baix Camp;43123;Reus;2;7;A;;520;135;228;304;216;0;1;303;304
43;Tarragona;8;Baix Camp;43123;Reus;2;7;B;;602;147;258;334;268;0;3;331;334
43;Tarragona;8;Baix Camp;43123;Reus;2;8;A;;510;121;227;313;197;2;3;308;311
43;Tarragona;8;Baix Camp;43123;Reus;2;8;B;;448;106;189;265;183;2;3;260;263
43;Tarragona;8;Baix Camp;43123;Reus;2;8;C;;570;138;255;348;222;0;3;345;348
43;Tarragona;8;Baix Camp;43123;Reus;2;9;A;;490;133;263;331;159;0;3;328;331
43;Tarragona;8;Baix Camp;43123;Reus;2;9;B;;540;119;268;336;204;0;11;325;336
43;Tarragona;8;Baix Camp;43123;Reus;3;1;A;;292;101;139;174;118;0;0;174;174
43;Tarragona;8;Baix Camp;43123;Reus;3;1;B;;317;85;142;167;150;0;0;167;167
43;Tarragona;8;Baix Camp;43123;Reus;3;10;A;;446;100;153;198;248;2;3;193;196
43;Tarragona;8;Baix Camp;43123;Reus;3;10;B;;532;109;169;230;302;2;1;227;228
43;Tarragona;8;Baix Camp;43123;Reus;3;10;C;;525;101;166;231;294;2;1;228;229
43;Tarragona;8;Baix Camp;43123;Reus;3;11;A;;429;84;142;196;233;0;1;195;196
43;Tarragona;8;Baix Camp;43123;Reus;3;11;B;;455;91;152;212;243;0;0;212;212
43;Tarragona;8;Baix Camp;43123;Reus;3;11;C;;454;12;173;221;233;1;0;220;220
43;Tarragona;8;Baix Camp;43123;Reus;3;12;A;;342;88;138;176;166;0;1;175;176
43;Tarragona;8;Baix Camp;43123;Reus;3;12;B;;402;92;158;212;190;1;1;210;211
43;Tarragona;8;Baix Camp;43123;Reus;3;12;C;;385;96;144;187;198;0;6;181;187
43;Tarragona;8;Baix Camp;43123;Reus;3;13;U;;968;181;350;473;495;0;4;469;473
43;Tarragona;8;Baix Camp;43123;Reus;3;2;U;;475;139;202;235;240;0;4;231;235
43;Tarragona;8;Baix Camp;43123;Reus;3;3;A;;469;124;221;261;208;2;1;258;259
43;Tarragona;8;Baix Camp;43123;Reus;3;3;B;;503;135;227;271;232;0;0;271;271
43;Tarragona;8;Baix Camp;43123;Reus;3;4;A;;514;102;183;264;250;3;6;255;261
43;Tarragona;8;Baix Camp;43123;Reus;3;4;B;;602;117;230;299;303;1;2;296;298
43;Tarragona;8;Baix Camp;43123;Reus;3;5;A;;414;92;170;221;193;0;1;220;221
43;Tarragona;8;Baix Camp;43123;Reus;3;5;B;;478;92;184;256;222;0;2;254;256
43;Tarragona;8;Baix Camp;43123;Reus;3;6;U;;529;168;256;305;224;1;2;302;304
43;Tarragona;8;Baix Camp;43123;Reus;3;7;U;;611;139;238;286;325;0;6;280;286
43;Tarragona;8;Baix Camp;43123;Reus;3;8;A;;418;114;182;236;182;3;2;231;233
43;Tarragona;8;Baix Camp;43123;Reus;3;8;B;;421;108;190;234;187;1;3;230;233
43;Tarragona;8;Baix Camp;43123;Reus;3;8;C;;482;116;212;272;210;1;5;266;271
43;Tarragona;8;Baix Camp;43123;Reus;3;9;A;;530;142;219;290;240;1;1;288;289
43;Tarragona;8;Baix Camp;43123;Reus;3;9;B;;583;141;239;296;287;1;4;291;295
43;Tarragona;8;Baix Camp;43123;Reus;4;1;U;;477;116;200;241;236;1;0;240;240
43;Tarragona;8;Baix Camp;43123;Reus;4;2;A;;470;120;196;265;205;3;0;262;262
43;Tarragona;8;Baix Camp;43123;Reus;4;2;B;;380;96;150;194;186;1;1;192;193
43;Tarragona;8;Baix Camp;43123;Reus;4;2;C;;470;117;206;250;220;0;1;249;250
43;Tarragona;8;Baix Camp;43123;Reus;4;3;U;;535;90;160;210;325;0;1;209;210
43;Tarragona;8;Baix Camp;43123;Reus;4;4;A;;481;125;217;278;203;0;2;276;278
43;Tarragona;8;Baix Camp;43123;Reus;4;4;B;;578;145;212;296;282;1;0;295;295
43;Tarragona;8;Baix Camp;43123;Reus;4;5;A;;503;79;151;231;272;0;3;228;231
43;Tarragona;8;Baix Camp;43123;Reus;4;5;B;;423;91;142;189;234;2;0;187;187
43;Tarragona;8;Baix Camp;43123;Reus;4;5;C;;532;109;180;249;283;1;3;245;248
43;Tarragona;8;Baix Camp;43123;Reus;4;5;D;;484;75;135;204;280;0;3;201;204
43;Tarragona;8;Baix Camp;43123;Reus;4;6;A;;641;113;235;309;332;0;12;297;309
43;Tarragona;8;Baix Camp;43123;Reus;4;6;B;;610;100;213;275;335;1;2;272;274
43;Tarragona;8;Baix Camp;43123;Reus;4;6;C;;637;122;228;303;334;2;1;300;301
43;Tarragona;8;Baix Camp;43123;Reus;5;1;A;;439;93;170;226;213;3;2;221;223
43;Tarragona;8;Baix Camp;43123;Reus;5;1;B;;422;100;172;204;218;0;1;203;204
43;Tarragona;8;Baix Camp;43123;Reus;5;1;C;;416;93;170;216;200;1;0;215;215
43;Tarragona;8;Baix Camp;43123;Reus;5;2;A;;588;144;251;337;251;0;3;334;337
43;Tarragona;8;Baix Camp;43123;Reus;5;2;B;;690;157;262;359;331;0;2;357;359
43;Tarragona;8;Baix Camp;43123;Reus;5;2;C;;690;181;299;384;306;1;6;377;383
43;Tarragona;8;Baix Camp;43123;Reus;5;3;A;;487;120;178;236;251;0;1;235;236
43;Tarragona;8;Baix Camp;43123;Reus;5;3;B;;559;130;199;268;291;0;4;264;268
43;Tarragona;8;Baix Camp;43123;Reus;5;4;A;;470;97;184;242;228;1;1;240;241
43;Tarragona;8;Baix Camp;43123;Reus;5;4;B;;460;90;181;247;213;0;2;245;247
43;Tarragona;8;Baix Camp;43123;Reus;5;4;C;;506;113;211;286;220;0;1;285;286
43;Tarragona;8;Baix Camp;43123;Reus;5;5;A;;448;116;188;261;187;0;3;258;261
43;Tarragona;8;Baix Camp;43123;Reus;5;5;B;;464;111;182;235;229;1;0;234;234
43;Tarragona;8;Baix Camp;43123;Reus;5;5;C;;513;141;224;288;225;0;3;285;288
43;Tarragona;8;Baix Camp;43123;Reus;5;6;U;;545;108;221;278;267;0;1;277;278
43;Tarragona;8;Baix Camp;43123;Reus;6;1;A;;374;13;180;230;144;1;3;226;229
43;Tarragona;8;Baix Camp;43123;Reus;6;1;B;;414;102;182;235;179;1;2;232;234
43;Tarragona;8;Baix Camp;43123;Reus;6;10;U;;583;132;236;291;292;1;3;287;290
43;Tarragona;8;Baix Camp;43123;Reus;6;11;A;;484;140;274;342;142;0;3;339;342
43;Tarragona;8;Baix Camp;43123;Reus;6;11;B;;360;92;165;223;137;2;5;216;221
43;Tarragona;8;Baix Camp;43123;Reus;6;11;C;;465;112;246;310;155;0;5;305;310
43;Tarragona;8;Baix Camp;43123;Reus;6;12;A;;436;106;168;230;206;0;1;229;230
43;Tarragona;8;Baix Camp;43123;Reus;6;12;B;;528;135;233;315;213;0;1;314;315
43;Tarragona;8;Baix Camp;43123;Reus;6;13;A;;413;130;206;258;155;2;4;252;256
43;Tarragona;8;Baix Camp;43123;Reus;6;13;B;;382;116;184;223;159;0;2;221;223
43;Tarragona;8;Baix Camp;43123;Reus;6;2;A;;406;112;204;281;125;0;4;277;281
43;Tarragona;8;Baix Camp;43123;Reus;6;2;B;;341;78;163;218;123;0;0;218;218
43;Tarragona;8;Baix Camp;43123;Reus;6;2;C;;415;114;222;300;115;2;3;295;298
43;Tarragona;8;Baix Camp;43123;Reus;6;3;A;;468;94;225;307;161;1;2;304;306
43;Tarragona;8;Baix Camp;43123;Reus;6;3;B;;428;89;176;240;188;2;1;237;238
43;Tarragona;8;Baix Camp;43123;Reus;6;3;C;;509;125;258;333;176;1;3;329;332
43;Tarragona;8;Baix Camp;43123;Reus;6;4;A;;421;121;230;291;130;0;3;288;291
43;Tarragona;8;Baix Camp;43123;Reus;6;4;B;;428;124;218;295;133;0;3;292;295
43;Tarragona;8;Baix Camp;43123;Reus;6;4;C;;509;142;269;350;159;0;8;342;350
43;Tarragona;8;Baix Camp;43123;Reus;6;5;A;;336;54;106;143;193;0;0;143;143
43;Tarragona;8;Baix Camp;43123;Reus;6;5;B;;409;82;141;185;224;0;0;185;185
43;Tarragona;8;Baix Camp;43123;Reus;6;6;A;;530;111;219;327;203;0;5;322;327
43;Tarragona;8;Baix Camp;43123;Reus;6;6;B;;416;86;189;246;170;0;0;246;246
43;Tarragona;8;Baix Camp;43123;Reus;6;6;C;;485;140;248;310;175;0;3;307;310
43;Tarragona;8;Baix Camp;43123;Reus;6;7;A;;473;132;223;275;198;1;2;272;274
43;Tarragona;8;Baix Camp;43123;Reus;6;7;B;;535;142;256;334;201;0;3;331;334
43;Tarragona;8;Baix Camp;43123;Reus;6;8;A;;435;106;192;248;187;1;4;243;247
43;Tarragona;8;Baix Camp;43123;Reus;6;8;B;;500;125;213;274;226;2;2;270;272
43;Tarragona;8;Baix Camp;43123;Reus;6;9;U;;725;108;245;335;390;1;0;334;334
43;Tarragona;8;Baix Camp;43123;Reus;7;1;A;;749;87;181;253;496;0;4;249;253
43;Tarragona;8;Baix Camp;43123;Reus;7;1;B;;845;136;230;291;554;1;2;288;290
43;Tarragona;8;Baix Camp;43123;Reus;7;2;A;;586;72;122;155;431;1;3;151;154
43;Tarragona;8;Baix Camp;43123;Reus;7;2;B;;641;92;138;177;464;0;3;174;177
43;Tarragona;8;Baix Camp;43123;Reus;7;3;A;;374;74;132;166;208;0;3;163;166
43;Tarragona;8;Baix Camp;43123;Reus;7;3;B;;498;108;177;222;276;1;1;220;221
43;Tarragona;8;Baix Camp;43123;Reus;7;3;C;;444;102;176;221;223;1;3;217;220
43;Tarragona;8;Baix Camp;43123;Reus;8;1;A;;471;113;183;246;225;0;2;244;246
43;Tarragona;8;Baix Camp;43123;Reus;8;1;B;;427;72;143;213;214;0;1;212;213
43;Tarragona;8;Baix Camp;43123;Reus;8;1;C;;555;130;212;275;280;3;0;272;272
43;Tarragona;8;Baix Camp;43123;Reus;8;1;D;;447;94;167;206;241;1;0;205;205
43;Tarragona;8;Baix Camp;43123;Reus;8;2;A;;519;103;179;260;259;1;1;258;259
43;Tarragona;8;Baix Camp;43123;Reus;8;2;B;;454;96;180;226;228;1;1;224;225
43;Tarragona;8;Baix Camp;43123;Reus;8;3;U;;553;124;214;286;267;2;2;282;284
43;Tarragona;8;Baix Camp;43123;Reus;8;4;A;;470;77;161;234;236;0;1;233;234
43;Tarragona;8;Baix Camp;43123;Reus;8;4;B;;534;107;204;269;265;1;1;267;268
43;Tarragona;8;Baix Camp;43123;Reus;8;5;U;;523;114;230;286;237;1;2;283;285
43;Tarragona;8;Baix Camp;43123;Reus;8;6;A;;431;95;169;234;197;0;1;233;234
43;Tarragona;8;Baix Camp;43123;Reus;8;6;B;;535;110;178;241;294;2;0;239;239
43;Tarragona;8;Baix Camp;43123;Reus;9;1;A;;458;96;186;262;196;1;2;259;261
43;Tarragona;8;Baix Camp;43123;Reus;9;1;B;;563;119;265;354;209;1;3;350;353
43;Tarragona;8;Baix Camp;43123;Reus;9;2;A;;410;42;66;76;334;0;0;76;76
43;Tarragona;8;Baix Camp;43123;Reus;9;2;B;;415;38;61;83;332;0;1;82;83
25;Lleida;26;Pallars Sobirà;25183;Rialp;1;1;U;;438;107;203;302;136;0;1;301;302
43;Tarragona;1;Alt Camp;43124;Riba, la;1;1;U;;650;182;344;441;209;1;1;439;440
43;Tarragona;30;Ribera d'Ebre;43125;Riba-roja d'Ebre;1;1;A;;690;161;341;419;271;2;4;413;417
43;Tarragona;30;Ribera d'Ebre;43125;Riba-roja d'Ebre;1;1;B;;505;83;223;304;201;3;0;301;301
25;Lleida;32;Segarra;25905;Ribera d'Ondara;1;1;U;;453;111;227;292;161;1;1;290;291
25;Lleida;4;Alt Urgell;25185;Ribera d'Urgellet;1;1;U;;695;140;337;417;278;0;2;415;417
17;Girona;31;Ripollès;17145;Ribes de Freser;1;1;A;;386;112;218;284;102;0;2;282;284
17;Girona;31;Ripollès;17145;Ribes de Freser;1;1;B;;512;135;302;373;139;0;2;371;373
17;Girona;31;Ripollès;17145;Ribes de Freser;1;2;A;;393;129;224;293;100;1;1;291;292
17;Girona;31;Ripollès;17145;Ribes de Freser;1;2;B;;531;180;326;402;129;6;1;395;396
17;Girona;34;Selva;17146;Riells i Viabrea;1;1;U;;1480;347;738;916;564;5;1;910;911
43;Tarragona;36;Tarragonès;43126;Riera de Gaià, la;1;1;U;;737;223;442;544;193;1;5;538;543
25;Lleida;35;Solsonès;25186;Riner;1;1;U;;241;57;145;179;62;4;7;168;175
17;Girona;31;Ripollès;17147;Ripoll;1;1;U;;571;174;296;370;201;0;3;367;370
17;Girona;31;Ripollès;17147;Ripoll;1;2;U;;674;183;333;380;294;2;5;373;378
17;Girona;31;Ripollès;17147;Ripoll;2;1;U;;848;270;483;597;251;3;4;590;594
17;Girona;31;Ripollès;17147;Ripoll;2;2;A;;804;282;480;548;256;4;2;542;544
17;Girona;31;Ripollès;17147;Ripoll;2;2;B;;368;110;191;228;140;3;2;223;225
17;Girona;31;Ripollès;17147;Ripoll;3;1;U;;1024;272;534;685;339;3;3;679;682
17;Girona;31;Ripollès;17147;Ripoll;3;2;U;;746;194;386;516;230;3;4;509;513
17;Girona;31;Ripollès;17147;Ripoll;3;3;A;;789;219;444;551;238;2;6;543;549
17;Girona;31;Ripollès;17147;Ripoll;3;3;B;;837;235;484;616;221;4;4;608;612
17;Girona;31;Ripollès;17147;Ripoll;3;4;A;;763;179;401;514;249;2;7;505;512
17;Girona;31;Ripollès;17147;Ripoll;3;4;B;;792;171;382;515;277;3;6;506;512
17;Girona;31;Ripollès;17147;Ripoll;4;1;U;;931;228;473;636;295;1;3;632;635
8;Barcelona;40;Vallès Occidental;08180;Ripollet;1;1;A;;1100;212;410;553;547;7;3;543;546
8;Barcelona;40;Vallès Occidental;08180;Ripollet;1;1;B;;1265;244;515;684;581;2;2;680;682
8;Barcelona;40;Vallès Occidental;08180;Ripollet;1;2;A;;850;212;391;509;341;0;5;504;509
8;Barcelona;40;Vallès Occidental;08180;Ripollet;1;2;B;;1090;251;484;651;439;1;8;642;650
8;Barcelona;40;Vallès Occidental;08180;Ripollet;1;3;A;;581;145;255;347;234;2;5;340;345
8;Barcelona;40;Vallès Occidental;08180;Ripollet;1;3;B;;720;183;329;415;305;0;4;411;415
8;Barcelona;40;Vallès Occidental;08180;Ripollet;1;4;A;;490;123;230;289;201;0;4;285;289
8;Barcelona;40;Vallès Occidental;08180;Ripollet;1;4;B;;573;132;263;339;234;0;1;338;339
8;Barcelona;40;Vallès Occidental;08180;Ripollet;1;5;A;;725;139;266;365;360;0;3;362;365
8;Barcelona;40;Vallès Occidental;08180;Ripollet;1;5;B;;869;140;278;418;451;0;2;416;418
8;Barcelona;40;Vallès Occidental;08180;Ripollet;1;6;A;;679;127;260;361;318;0;1;360;361
8;Barcelona;40;Vallès Occidental;08180;Ripollet;1;6;B;;871;161;309;436;435;0;6;430;436
8;Barcelona;40;Vallès Occidental;08180;Ripollet;1;7;A;;848;182;338;425;423;0;6;419;425
8;Barcelona;40;Vallès Occidental;08180;Ripollet;1;7;B;;948;213;389;467;481;0;5;462;467
8;Barcelona;40;Vallès Occidental;08180;Ripollet;1;8;A;;603;124;232;299;304;1;0;298;298
8;Barcelona;40;Vallès Occidental;08180;Ripollet;1;8;B;;655;131;247;313;342;0;3;310;313
8;Barcelona;40;Vallès Occidental;08180;Ripollet;1;9;A;;782;130;285;423;359;1;5;417;422
8;Barcelona;40;Vallès Occidental;08180;Ripollet;1;9;B;;979;179;386;563;416;1;12;550;562
8;Barcelona;40;Vallès Occidental;08180;Ripollet;2;1;A;;520;137;216;259;261;1;1;257;258
8;Barcelona;40;Vallès Occidental;08180;Ripollet;2;1;B;;813;182;311;408;405;0;3;405;408
8;Barcelona;40;Vallès Occidental;08180;Ripollet;2;2;A;;693;145;257;370;323;0;0;370;370
8;Barcelona;40;Vallès Occidental;08180;Ripollet;2;2;B;;751;156;300;411;340;0;4;407;411
8;Barcelona;40;Vallès Occidental;08180;Ripollet;2;3;A;;735;160;257;365;370;2;4;359;363
8;Barcelona;40;Vallès Occidental;08180;Ripollet;2;3;B;;971;204;332;465;506;1;2;462;464
8;Barcelona;40;Vallès Occidental;08180;Ripollet;2;4;A;;646;142;260;329;317;0;3;326;329
8;Barcelona;40;Vallès Occidental;08180;Ripollet;2;4;B;;734;140;281;389;345;2;3;384;387
8;Barcelona;40;Vallès Occidental;08180;Ripollet;2;5;A;;524;116;194;263;261;1;1;261;262
8;Barcelona;40;Vallès Occidental;08180;Ripollet;2;5;B;;601;115;193;275;326;0;0;275;275
8;Barcelona;40;Vallès Occidental;08180;Ripollet;2;6;A;;657;107;226;310;347;0;6;304;310
8;Barcelona;40;Vallès Occidental;08180;Ripollet;2;6;B;;808;137;295;387;421;1;4;382;386
8;Barcelona;40;Vallès Occidental;08180;Ripollet;2;7;A;;510;89;169;248;262;2;4;242;246
8;Barcelona;40;Vallès Occidental;08180;Ripollet;2;7;B;;703;128;219;313;390;4;5;304;309
17;Girona;34;Selva;17148;Riudarenes;1;1;U;;1098;307;583;743;355;1;3;739;742
17;Girona;19;Garrotxa;17149;Riudaura;1;1;U;;354;95;197;237;117;0;0;237;237
43;Tarragona;8;Baix Camp;43127;Riudecanyes;1;1;U;;561;151;316;400;161;3;4;393;397
25;Lleida;15;Cerdanya;25913;Riu de Cerdanya;1;1;U;;65;17;39;46;19;0;1;45;46
43;Tarragona;8;Baix Camp;43128;Riudecols;1;1;U;;838;178;438;595;243;4;0;591;591
17;Girona;34;Selva;17150;Riudellots de la Selva;1;1;U;;1238;347;688;885;353;5;9;871;880
43;Tarragona;8;Baix Camp;43129;Riudoms;1;1;A;;564;103;238;332;232;1;6;325;331
43;Tarragona;8;Baix Camp;43129;Riudoms;1;1;B;;483;73;181;273;210;1;2;270;272
43;Tarragona;8;Baix Camp;43129;Riudoms;2;1;A;;409;94;183;255;154;1;2;252;254
43;Tarragona;8;Baix Camp;43129;Riudoms;2;1;B;;449;102;198;265;184;0;1;264;265
43;Tarragona;8;Baix Camp;43129;Riudoms;2;2;A;;602;105;243;375;227;1;1;373;374
43;Tarragona;8;Baix Camp;43129;Riudoms;2;2;B;;609;112;248;371;238;0;1;370;371
43;Tarragona;8;Baix Camp;43129;Riudoms;2;2;C;;606;122;262;384;222;1;1;382;383
43;Tarragona;8;Baix Camp;43129;Riudoms;2;3;U;;404;73;207;290;114;1;4;285;289
17;Girona;2;Alt Empordà;17151;Riumors;1;1;U;;174;47;106;121;53;0;1;120;121
8;Barcelona;41;Vallès Oriental;08181;Roca del Vallès, la;1;1;A;;506;114;240;309;197;2;4;303;307
8;Barcelona;41;Vallès Oriental;08181;Roca del Vallès, la;1;1;B;;549;132;236;299;250;0;1;298;299
8;Barcelona;41;Vallès Oriental;08181;Roca del Vallès, la;1;1;C;;346;71;138;183;163;2;2;179;181
8;Barcelona;41;Vallès Oriental;08181;Roca del Vallès, la;1;1;D;;394;136;236;285;109;0;4;281;285
8;Barcelona;41;Vallès Oriental;08181;Roca del Vallès, la;1;2;A;;559;136;251;331;228;1;3;327;330
8;Barcelona;41;Vallès Oriental;08181;Roca del Vallès, la;1;2;B;;620;129;304;383;237;1;4;378;382
8;Barcelona;41;Vallès Oriental;08181;Roca del Vallès, la;1;2;C;;593;128;289;377;216;0;5;372;377
8;Barcelona;41;Vallès Oriental;08181;Roca del Vallès, la;1;2;D;;536;113;238;320;216;0;1;319;320
8;Barcelona;41;Vallès Oriental;08181;Roca del Vallès, la;1;3;A;;554;134;260;349;205;0;4;345;349
8;Barcelona;41;Vallès Oriental;08181;Roca del Vallès, la;1;3;B;;676;123;286;377;299;0;4;373;377
8;Barcelona;41;Vallès Oriental;08181;Roca del Vallès, la;1;3;C;;685;139;279;378;307;1;4;373;377
43;Tarragona;16;Conca de Barberà;43130;Rocafort de Queralt;1;1;U;;246;90;167;189;57;1;0;188;188
43;Tarragona;36;Tarragonès;43131;Roda de Berà;1;1;A;;765;79;377;492;273;0;3;489;492
43;Tarragona;36;Tarragonès;43131;Roda de Berà;1;1;B;;907;227;440;584;323;1;5;578;583
43;Tarragona;36;Tarragonès;43131;Roda de Berà;1;2;U;;821;162;288;369;452;7;3;359;362
8;Barcelona;24;Osona;08183;Roda de Ter;1;1;A;;596;161;325;406;190;0;3;403;406
8;Barcelona;24;Osona;08183;Roda de Ter;1;1;B;;689;175;350;447;242;1;3;443;446
8;Barcelona;24;Osona;08183;Roda de Ter;1;2;U;;912;191;531;654;258;2;6;646;652
8;Barcelona;24;Osona;08183;Roda de Ter;1;3;A;;504;131;272;351;153;3;3;345;348
8;Barcelona;24;Osona;08183;Roda de Ter;1;3;B;;521;147;298;370;151;3;2;365;367
8;Barcelona;24;Osona;08183;Roda de Ter;2;1;U;;884;216;499;618;266;2;5;611;616
43;Tarragona;1;Alt Camp;43132;Rodonyà;1;1;U;;339;75;158;209;130;2;4;203;207
43;Tarragona;9;Baix Ebre;43133;Roquetes;1;1;A;;724;169;306;397;327;0;10;387;397
43;Tarragona;9;Baix Ebre;43133;Roquetes;1;1;B;;529;102;219;267;262;0;4;263;267
43;Tarragona;9;Baix Ebre;43133;Roquetes;1;2;U;;995;175;380;489;506;1;6;482;488
43;Tarragona;9;Baix Ebre;43133;Roquetes;2;1;A;;1027;175;409;549;478;1;4;544;548
43;Tarragona;9;Baix Ebre;43133;Roquetes;2;1;B;;851;155;344;449;402;3;6;440;446
43;Tarragona;9;Baix Ebre;43133;Roquetes;2;2;U;;1108;198;384;512;596;1;10;501;511
17;Girona;2;Alt Empordà;17152;Roses;1;1;U;;609;191;324;383;226;0;0;383;383
17;Girona;2;Alt Empordà;17152;Roses;1;2;A;;503;112;211;273;230;0;0;273;273
17;Girona;2;Alt Empordà;17152;Roses;1;2;B;;403;115;191;216;187;1;1;214;215
17;Girona;2;Alt Empordà;17152;Roses;1;3;A;;706;138;263;329;377;0;12;317;329
17;Girona;2;Alt Empordà;17152;Roses;1;3;B;;556;121;225;271;285;1;2;268;270
17;Girona;2;Alt Empordà;17152;Roses;1;4;A;;828;163;343;439;389;0;4;435;439
17;Girona;2;Alt Empordà;17152;Roses;1;4;B;;770;162;315;402;368;1;3;398;401
17;Girona;2;Alt Empordà;17152;Roses;2;1;U;;625;200;307;358;267;0;6;352;358
17;Girona;2;Alt Empordà;17152;Roses;2;2;A;;437;142;228;276;161;2;2;272;274
17;Girona;2;Alt Empordà;17152;Roses;2;2;B;;444;130;208;242;202;0;1;241;242
17;Girona;2;Alt Empordà;17152;Roses;2;2;C;;421;129;195;230;191;1;0;229;229
17;Girona;2;Alt Empordà;17152;Roses;2;3;A;;575;162;297;350;225;1;2;347;349
17;Girona;2;Alt Empordà;17152;Roses;2;3;B;;706;152;306;398;308;4;3;391;394
17;Girona;2;Alt Empordà;17152;Roses;2;3;C;;678;161;310;379;299;0;6;373;379
17;Girona;2;Alt Empordà;17152;Roses;2;4;A;;325;63;139;187;138;0;1;186;187
17;Girona;2;Alt Empordà;17152;Roses;2;4;B;;333;83;153;203;130;0;0;203;203
25;Lleida;33;Segrià;25189;Rosselló;1;1;A;;754;163;351;458;296;0;2;456;458
25;Lleida;33;Segrià;25189;Rosselló;1;1;B;;708;158;313;419;289;1;4;414;418
43;Tarragona;1;Alt Camp;43134;Rourell, el;1;1;U;;221;76;146;165;56;1;0;164;164
8;Barcelona;40;Vallès Occidental;08184;Rubí;1;1;A;;820;147;318;423;397;0;5;418;423
8;Barcelona;40;Vallès Occidental;08184;Rubí;1;1;B;;1053;199;392;506;547;1;7;498;505
8;Barcelona;40;Vallès Occidental;08184;Rubí;1;2;A;;721;150;235;338;383;0;1;337;338
8;Barcelona;40;Vallès Occidental;08184;Rubí;1;2;B;;804;155;261;364;440;0;4;360;364
8;Barcelona;40;Vallès Occidental;08184;Rubí;1;3;A;;462;85;171;251;211;1;1;249;250
8;Barcelona;40;Vallès Occidental;08184;Rubí;1;3;B;;559;94;220;291;268;0;3;288;291
8;Barcelona;40;Vallès Occidental;08184;Rubí;2;1;A;;862;133;272;358;504;2;4;352;356
8;Barcelona;40;Vallès Occidental;08184;Rubí;2;1;B;;1041;167;375;468;573;2;0;466;466
8;Barcelona;40;Vallès Occidental;08184;Rubí;2;3;A;;613;110;217;297;316;0;4;293;297
8;Barcelona;40;Vallès Occidental;08184;Rubí;2;3;B;;643;104;207;281;362;0;1;280;281
8;Barcelona;40;Vallès Occidental;08184;Rubí;2;3;C;;753;118;259;349;404;2;4;343;347
8;Barcelona;40;Vallès Occidental;08184;Rubí;3;1;A;;953;205;415;555;398;2;3;550;553
8;Barcelona;40;Vallès Occidental;08184;Rubí;3;1;B;;1047;229;469;633;414;0;6;627;633
8;Barcelona;40;Vallès Occidental;08184;Rubí;3;2;U;;619;127;240;298;321;1;6;291;297
8;Barcelona;40;Vallès Occidental;08184;Rubí;3;3;A;;502;109;199;241;261;1;2;238;240
8;Barcelona;40;Vallès Occidental;08184;Rubí;3;3;B;;614;147;246;298;316;0;4;294;298
8;Barcelona;40;Vallès Occidental;08184;Rubí;3;4;A;;807;180;327;412;395;3;1;408;409
8;Barcelona;40;Vallès Occidental;08184;Rubí;3;4;B;;884;180;362;464;420;1;5;458;463
8;Barcelona;40;Vallès Occidental;08184;Rubí;3;5;A;;751;179;362;424;327;0;4;420;424
8;Barcelona;40;Vallès Occidental;08184;Rubí;3;5;B;;961;213;420;529;432;0;5;524;529
8;Barcelona;40;Vallès Occidental;08184;Rubí;3;6;A;;765;171;331;428;337;1;11;416;427
8;Barcelona;40;Vallès Occidental;08184;Rubí;3;6;B;;859;187;359;463;396;0;2;461;463
8;Barcelona;40;Vallès Occidental;08184;Rubí;3;7;A;;495;91;173;254;241;1;2;251;253
8;Barcelona;40;Vallès Occidental;08184;Rubí;3;7;B;;586;100;202;305;281;1;4;300;304
8;Barcelona;40;Vallès Occidental;08184;Rubí;3;8;A;;607;164;265;319;288;0;1;318;319
8;Barcelona;40;Vallès Occidental;08184;Rubí;3;8;B;;715;188;316;385;330;0;3;382;385
8;Barcelona;40;Vallès Occidental;08184;Rubí;4;1;A;;537;152;248;307;230;1;4;302;306
8;Barcelona;40;Vallès Occidental;08184;Rubí;4;1;B;;656;176;311;394;262;5;8;381;389
8;Barcelona;40;Vallès Occidental;08184;Rubí;4;10;A;;596;104;188;265;331;0;4;261;265
8;Barcelona;40;Vallès Occidental;08184;Rubí;4;10;B;;813;137;290;375;438;0;0;375;375
8;Barcelona;40;Vallès Occidental;08184;Rubí;4;10;C;;753;125;252;342;411;6;0;336;336
8;Barcelona;40;Vallès Occidental;08184;Rubí;4;11;A;;535;116;226;290;245;0;8;282;290
8;Barcelona;40;Vallès Occidental;08184;Rubí;4;11;B;;625;143;259;322;303;1;5;316;321
8;Barcelona;40;Vallès Occidental;08184;Rubí;4;11;C;;686;144;300;392;294;0;4;388;392
8;Barcelona;40;Vallès Occidental;08184;Rubí;4;12;A;;643;136;231;324;319;1;5;318;323
8;Barcelona;40;Vallès Occidental;08184;Rubí;4;12;B;;790;157;291;391;399;2;2;387;389
8;Barcelona;40;Vallès Occidental;08184;Rubí;4;13;A;;616;143;260;331;285;0;4;327;331
8;Barcelona;40;Vallès Occidental;08184;Rubí;4;13;B;;710;159;285;366;344;0;1;365;366
8;Barcelona;40;Vallès Occidental;08184;Rubí;4;13;C;;668;138;242;329;339;0;5;324;329
8;Barcelona;40;Vallès Occidental;08184;Rubí;4;14;A;;759;116;238;353;406;1;3;349;352
8;Barcelona;40;Vallès Occidental;08184;Rubí;4;14;B;;876;140;300;405;471;0;4;401;405
8;Barcelona;40;Vallès Occidental;08184;Rubí;4;15;A;;489;99;193;247;242;0;1;246;247
8;Barcelona;40;Vallès Occidental;08184;Rubí;4;15;B;;636;102;214;289;347;0;4;285;289
8;Barcelona;40;Vallès Occidental;08184;Rubí;4;16;A;;775;117;289;381;394;0;2;379;381
8;Barcelona;40;Vallès Occidental;08184;Rubí;4;16;B;;936;155;335;431;505;1;2;428;430
8;Barcelona;40;Vallès Occidental;08184;Rubí;4;16;C;;441;119;177;194;247;0;3;191;194
8;Barcelona;40;Vallès Occidental;08184;Rubí;4;18;A;;498;95;200;269;229;3;6;260;266
8;Barcelona;40;Vallès Occidental;08184;Rubí;4;18;B;;556;86;199;279;277;1;3;275;278
8;Barcelona;40;Vallès Occidental;08184;Rubí;4;19;A;;509;93;175;236;273;0;7;229;236
8;Barcelona;40;Vallès Occidental;08184;Rubí;4;19;B;;564;79;180;247;317;0;3;244;247
8;Barcelona;40;Vallès Occidental;08184;Rubí;4;2;U;;896;239;622;573;323;0;7;566;573
8;Barcelona;40;Vallès Occidental;08184;Rubí;4;20;U;;944;159;356;467;477;0;3;464;467
8;Barcelona;40;Vallès Occidental;08184;Rubí;4;21;A;;556;88;192;260;296;0;2;258;260
8;Barcelona;40;Vallès Occidental;08184;Rubí;4;21;B;;609;116;225;306;303;0;2;304;306
8;Barcelona;40;Vallès Occidental;08184;Rubí;4;22;U;;643;141;243;326;317;0;4;322;326
8;Barcelona;40;Vallès Occidental;08184;Rubí;4;3;U;;989;247;446;548;441;0;9;539;548
8;Barcelona;40;Vallès Occidental;08184;Rubí;4;4;A;;644;13;269;343;301;0;2;341;343
8;Barcelona;40;Vallès Occidental;08184;Rubí;4;4;B;;766;170;297;390;376;1;2;387;389
8;Barcelona;40;Vallès Occidental;08184;Rubí;4;5;A;;612;170;317;398;214;3;4;391;395
8;Barcelona;40;Vallès Occidental;08184;Rubí;4;5;B;;661;185;318;397;264;3;2;392;394
8;Barcelona;40;Vallès Occidental;08184;Rubí;4;6;A;;564;129;242;325;239;0;1;324;325
8;Barcelona;40;Vallès Occidental;08184;Rubí;4;6;B;;607;158;293;363;244;1;3;359;362
8;Barcelona;40;Vallès Occidental;08184;Rubí;4;7;A;;561;143;256;330;231;1;4;325;329
8;Barcelona;40;Vallès Occidental;08184;Rubí;4;7;B;;656;177;300;387;269;2;3;382;385
8;Barcelona;40;Vallès Occidental;08184;Rubí;4;8;U;;943;239;406;494;449;1;5;488;493
8;Barcelona;40;Vallès Occidental;08184;Rubí;4;9;A;;565;106;203;278;287;1;6;271;277
8;Barcelona;40;Vallès Occidental;08184;Rubí;4;9;B;;729;126;244;345;384;1;1;343;344
8;Barcelona;6;Anoia;08185;Rubió;1;1;U;;99;32;45;66;33;0;1;65;66
17;Girona;10;Baix Empordà;17153;Rupià;1;1;U;;169;62;106;127;42;0;1;126;127
8;Barcelona;24;Osona;08901;Rupit i Pruit;1;1;U;;298;111;179;226;72;4;2;220;222
8;Barcelona;40;Vallès Occidental;08187;Sabadell;1;1;U;;676;200;406;503;173;3;2;498;500
8;Barcelona;40;Vallès Occidental;08187;Sabadell;1;10;U;;696;230;393;471;225;0;2;469;471
8;Barcelona;40;Vallès Occidental;08187;Sabadell;1;11;U;;889;292;534;650;239;0;11;639;650
8;Barcelona;40;Vallès Occidental;08187;Sabadell;1;12;A;;731;226;435;546;185;2;3;541;544
8;Barcelona;40;Vallès Occidental;08187;Sabadell;1;12;B;;896;242;533;651;245;0;4;647;651
8;Barcelona;40;Vallès Occidental;08187;Sabadell;1;13;A;;690;182;372;456;234;0;5;451;456
8;Barcelona;40;Vallès Occidental;08187;Sabadell;1;13;B;;761;209;394;511;250;1;1;509;510
8;Barcelona;40;Vallès Occidental;08187;Sabadell;1;14;A;;608;185;351;443;165;1;4;438;442
8;Barcelona;40;Vallès Occidental;08187;Sabadell;1;14;B;;739;202;398;534;205;1;8;525;533
8;Barcelona;40;Vallès Occidental;08187;Sabadell;1;15;A;;558;154;304;391;167;0;2;389;391
8;Barcelona;40;Vallès Occidental;08187;Sabadell;1;15;B;;714;227;414;518;196;4;1;513;514
8;Barcelona;40;Vallès Occidental;08187;Sabadell;1;16;A;;621;179;351;457;164;0;4;453;457
8;Barcelona;40;Vallès Occidental;08187;Sabadell;1;16;B;;692;196;392;499;193;0;5;494;499
8;Barcelona;40;Vallès Occidental;08187;Sabadell;1;17;A;;586;181;321;380;206;1;1;378;379
8;Barcelona;40;Vallès Occidental;08187;Sabadell;1;17;B;;739;210;373;483;256;0;0;483;483
8;Barcelona;40;Vallès Occidental;08187;Sabadell;1;18;A;;569;121;273;364;205;0;1;363;364
8;Barcelona;40;Vallès Occidental;08187;Sabadell;1;18;B;;637;128;293;396;241;0;2;394;396
8;Barcelona;40;Vallès Occidental;08187;Sabadell;1;19;A;;689;178;368;479;210;0;6;473;479
8;Barcelona;40;Vallès Occidental;08187;Sabadell;1;19;B;;731;180;388;510;221;2;3;505;508
8;Barcelona;40;Vallès Occidental;08187;Sabadell;1;2;A;;819;231;470;613;206;0;5;608;613
8;Barcelona;40;Vallès Occidental;08187;Sabadell;1;2;B;;950;284;570;739;211;0;2;737;739
8;Barcelona;40;Vallès Occidental;08187;Sabadell;1;20;A;;527;113;242;351;176;1;4;346;350
8;Barcelona;40;Vallès Occidental;08187;Sabadell;1;20;B;;584;133;269;374;210;0;0;374;374
8;Barcelona;40;Vallès Occidental;08187;Sabadell;1;21;U;;836;226;424;542;294;1;5;536;541
8;Barcelona;40;Vallès Occidental;08187;Sabadell;1;22;A;;626;198;325;432;194;0;4;428;432
8;Barcelona;40;Vallès Occidental;08187;Sabadell;1;22;B;;801;211;398;539;262;1;5;533;538
8;Barcelona;40;Vallès Occidental;08187;Sabadell;1;23;A;;588;142;271;351;237;2;0;349;349
8;Barcelona;40;Vallès Occidental;08187;Sabadell;1;23;B;;789;190;358;479;310;0;6;473;479
8;Barcelona;40;Vallès Occidental;08187;Sabadell;1;24;A;;546;96;249;336;210;0;2;334;336
8;Barcelona;40;Vallès Occidental;08187;Sabadell;1;24;B;;637;122;272;381;256;1;0;380;380
8;Barcelona;40;Vallès Occidental;08187;Sabadell;1;25;A;;587;155;293;361;226;2;2;357;359
8;Barcelona;40;Vallès Occidental;08187;Sabadell;1;25;B;;660;178;317;397;263;0;6;391;397
8;Barcelona;40;Vallès Occidental;08187;Sabadell;1;26;U;;768;237;435;536;232;2;7;527;534
8;Barcelona;40;Vallès Occidental;08187;Sabadell;1;27;U;;858;210;420;562;296;2;2;558;560
8;Barcelona;40;Vallès Occidental;08187;Sabadell;1;28;A;;741;193;363;452;289;2;2;448;450
8;Barcelona;40;Vallès Occidental;08187;Sabadell;1;28;B;;925;238;435;566;359;2;8;556;564
8;Barcelona;40;Vallès Occidental;08187;Sabadell;1;29;A;;728;223;370;467;261;5;5;457;462
8;Barcelona;40;Vallès Occidental;08187;Sabadell;1;29;B;;841;204;418;538;303;1;7;530;537
8;Barcelona;40;Vallès Occidental;08187;Sabadell;1;3;U;;847;250;491;628;219;2;4;622;626
8;Barcelona;40;Vallès Occidental;08187;Sabadell;1;4;A;;609;162;320;430;179;0;6;424;430
8;Barcelona;40;Vallès Occidental;08187;Sabadell;1;4;B;;750;223;396;529;221;0;7;522;529
8;Barcelona;40;Vallès Occidental;08187;Sabadell;1;5;A;;634;184;360;439;195;3;6;430;436
8;Barcelona;40;Vallès Occidental;08187;Sabadell;1;5;B;;649;201;379;471;178;0;3;468;471
8;Barcelona;40;Vallès Occidental;08187;Sabadell;1;6;A;;545;187;329;415;130;1;3;411;414
8;Barcelona;40;Vallès Occidental;08187;Sabadell;1;6;B;;649;196;366;471;178;0;6;465;471
8;Barcelona;40;Vallès Occidental;08187;Sabadell;1;7;U;;1061;325;712;783;278;1;15;767;782
8;Barcelona;40;Vallès Occidental;08187;Sabadell;1;8;A;;478;133;271;351;127;1;5;345;350
8;Barcelona;40;Vallès Occidental;08187;Sabadell;1;8;B;;613;196;350;453;160;0;5;448;453
8;Barcelona;40;Vallès Occidental;08187;Sabadell;1;9;A;;607;179;352;439;168;0;9;430;439
8;Barcelona;40;Vallès Occidental;08187;Sabadell;1;9;B;;656;181;353;458;198;1;4;453;457
8;Barcelona;40;Vallès Occidental;08187;Sabadell;2;1;A;;592;141;334;437;155;0;10;427;437
8;Barcelona;40;Vallès Occidental;08187;Sabadell;2;1;B;;714;179;439;533;181;2;8;523;531
8;Barcelona;40;Vallès Occidental;08187;Sabadell;2;10;U;;777;204;349;447;330;1;3;443;446
8;Barcelona;40;Vallès Occidental;08187;Sabadell;2;11;U;;748;125;212;279;469;0;0;279;279
8;Barcelona;40;Vallès Occidental;08187;Sabadell;2;12;A;;629;154;253;323;306;1;1;321;322
8;Barcelona;40;Vallès Occidental;08187;Sabadell;2;12;B;;784;199;340;405;379;3;1;401;402
8;Barcelona;40;Vallès Occidental;08187;Sabadell;2;13;U;;935;219;413;526;409;0;10;516;526
8;Barcelona;40;Vallès Occidental;08187;Sabadell;2;14;A;;652;140;241;331;321;0;3;328;331
8;Barcelona;40;Vallès Occidental;08187;Sabadell;2;14;B;;828;189;334;422;406;0;2;420;422
8;Barcelona;40;Vallès Occidental;08187;Sabadell;2;15;A;;559;128;244;311;248;0;1;310;311
8;Barcelona;40;Vallès Occidental;08187;Sabadell;2;15;B;;695;170;301;412;283;0;4;408;412
8;Barcelona;40;Vallès Occidental;08187;Sabadell;2;16;A;;706;203;400;509;197;1;6;502;508
8;Barcelona;40;Vallès Occidental;08187;Sabadell;2;16;B;;763;193;428;554;209;1;8;545;553
8;Barcelona;40;Vallès Occidental;08187;Sabadell;2;2;U;;1025;273;650;744;281;4;3;737;740
8;Barcelona;40;Vallès Occidental;08187;Sabadell;2;3;A;;542;152;272;331;211;0;1;330;331
8;Barcelona;40;Vallès Occidental;08187;Sabadell;2;3;B;;647;172;327;404;243;0;5;399;404
8;Barcelona;40;Vallès Occidental;08187;Sabadell;2;4;A;;639;177;340;433;206;0;3;430;433
8;Barcelona;40;Vallès Occidental;08187;Sabadell;2;4;B;;839;221;435;551;288;0;1;550;551
8;Barcelona;40;Vallès Occidental;08187;Sabadell;2;5;A;;655;181;341;444;211;1;2;441;443
8;Barcelona;40;Vallès Occidental;08187;Sabadell;2;5;B;;805;196;395;512;293;2;5;505;510
8;Barcelona;40;Vallès Occidental;08187;Sabadell;2;6;A;;552;185;303;378;174;2;4;372;376
8;Barcelona;40;Vallès Occidental;08187;Sabadell;2;6;B;;812;235;423;523;289;2;8;513;521
8;Barcelona;40;Vallès Occidental;08187;Sabadell;2;7;A;;567;177;301;371;196;3;5;363;368
8;Barcelona;40;Vallès Occidental;08187;Sabadell;2;7;B;;663;214;364;460;203;3;9;448;457
8;Barcelona;40;Vallès Occidental;08187;Sabadell;2;8;U;;763;160;392;504;259;0;13;491;504
8;Barcelona;40;Vallès Occidental;08187;Sabadell;2;9;A;;661;177;347;441;220;0;1;440;441
8;Barcelona;40;Vallès Occidental;08187;Sabadell;2;9;B;;831;204;439;575;256;0;5;570;575
8;Barcelona;40;Vallès Occidental;08187;Sabadell;3;1;A;;579;120;226;300;279;0;3;297;300
8;Barcelona;40;Vallès Occidental;08187;Sabadell;3;1;B;;671;140;266;335;336;2;2;331;333
8;Barcelona;40;Vallès Occidental;08187;Sabadell;3;10;U;;765;162;298;397;368;0;1;396;397
8;Barcelona;40;Vallès Occidental;08187;Sabadell;3;11;U;;1029;255;446;575;454;5;0;570;570
8;Barcelona;40;Vallès Occidental;08187;Sabadell;3;12;U;;1017;194;451;599;418;0;7;592;599
8;Barcelona;40;Vallès Occidental;08187;Sabadell;3;13;U;;1013;215;419;571;442;2;9;560;569
8;Barcelona;40;Vallès Occidental;08187;Sabadell;3;14;A;;669;202;325;407;262;2;3;402;405
8;Barcelona;40;Vallès Occidental;08187;Sabadell;3;14;B;;855;212;383;517;338;1;2;514;516
8;Barcelona;40;Vallès Occidental;08187;Sabadell;3;15;A;;588;113;242;325;263;0;0;325;325
8;Barcelona;40;Vallès Occidental;08187;Sabadell;3;15;B;;781;167;341;420;361;3;3;414;417
8;Barcelona;40;Vallès Occidental;08187;Sabadell;3;16;A;;517;116;304;260;257;2;0;258;258
8;Barcelona;40;Vallès Occidental;08187;Sabadell;3;16;B;;666;181;300;380;286;3;1;376;377
8;Barcelona;40;Vallès Occidental;08187;Sabadell;3;17;A;;418;125;193;245;173;0;1;244;245
8;Barcelona;40;Vallès Occidental;08187;Sabadell;3;17;B;;543;177;283;335;208;0;3;332;335
8;Barcelona;40;Vallès Occidental;08187;Sabadell;3;18;A;;555;130;246;309;246;0;0;309;309
8;Barcelona;40;Vallès Occidental;08187;Sabadell;3;18;B;;714;149;329;406;308;0;3;403;406
8;Barcelona;40;Vallès Occidental;08187;Sabadell;3;19;U;;940;195;379;521;419;0;1;520;521
8;Barcelona;40;Vallès Occidental;08187;Sabadell;3;2;A;;491;120;198;243;248;1;4;238;242
8;Barcelona;40;Vallès Occidental;08187;Sabadell;3;2;B;;600;110;212;269;331;1;1;267;268
8;Barcelona;40;Vallès Occidental;08187;Sabadell;3;20;A;;734;135;295;409;325;0;6;403;409
8;Barcelona;40;Vallès Occidental;08187;Sabadell;3;20;B;;860;148;344;460;400;0;1;459;460
8;Barcelona;40;Vallès Occidental;08187;Sabadell;3;21;A;;578;118;258;319;259;0;4;315;319
8;Barcelona;40;Vallès Occidental;08187;Sabadell;3;21;B;;707;166;325;392;315;1;7;384;391
8;Barcelona;40;Vallès Occidental;08187;Sabadell;3;22;U;;786;162;332;424;362;0;1;423;424
8;Barcelona;40;Vallès Occidental;08187;Sabadell;3;23;U;;730;136;298;398;332;4;0;394;394
8;Barcelona;40;Vallès Occidental;08187;Sabadell;3;24;A;;543;109;199;286;257;1;3;282;285
8;Barcelona;40;Vallès Occidental;08187;Sabadell;3;24;B;;647;136;274;365;282;0;1;364;365
8;Barcelona;40;Vallès Occidental;08187;Sabadell;3;25;U;;1026;164;405;525;501;1;6;518;524
8;Barcelona;40;Vallès Occidental;08187;Sabadell;3;26;U;;988;139;388;532;456;0;7;525;532
8;Barcelona;40;Vallès Occidental;08187;Sabadell;3;3;A;;599;126;223;289;310;1;1;287;288
8;Barcelona;40;Vallès Occidental;08187;Sabadell;3;3;B;;862;155;342;417;445;1;2;414;416
8;Barcelona;40;Vallès Occidental;08187;Sabadell;3;4;A;;620;150;259;317;303;0;3;314;317
8;Barcelona;40;Vallès Occidental;08187;Sabadell;3;4;B;;802;203;354;450;352;2;2;446;448
8;Barcelona;40;Vallès Occidental;08187;Sabadell;3;5;U;;907;206;397;499;408;0;4;495;499
8;Barcelona;40;Vallès Occidental;08187;Sabadell;3;6;A;;601;125;265;350;251;0;7;343;350
8;Barcelona;40;Vallès Occidental;08187;Sabadell;3;6;B;;705;149;310;410;295;0;1;409;410
8;Barcelona;40;Vallès Occidental;08187;Sabadell;3;7;U;;778;212;387;483;295;0;3;480;483
8;Barcelona;40;Vallès Occidental;08187;Sabadell;3;8;A;;513;104;208;280;233;0;1;279;280
8;Barcelona;40;Vallès Occidental;08187;Sabadell;3;8;B;;595;129;246;315;280;2;2;311;313
8;Barcelona;40;Vallès Occidental;08187;Sabadell;3;9;U;;782;169;290;365;417;1;3;361;364
8;Barcelona;40;Vallès Occidental;08187;Sabadell;4;1;A;;645;130;237;336;309;0;2;334;336
8;Barcelona;40;Vallès Occidental;08187;Sabadell;4;1;B;;791;159;329;450;341;1;4;445;449
8;Barcelona;40;Vallès Occidental;08187;Sabadell;4;10;A;;650;139;265;369;281;3;3;363;366
8;Barcelona;40;Vallès Occidental;08187;Sabadell;4;10;B;;711;172;323;416;295;1;1;414;415
8;Barcelona;40;Vallès Occidental;08187;Sabadell;4;11;U;;935;152;379;520;415;3;1;516;517
8;Barcelona;40;Vallès Occidental;08187;Sabadell;4;12;U;;1055;207;421;578;477;0;4;574;578
8;Barcelona;40;Vallès Occidental;08187;Sabadell;4;13;A;;609;130;243;335;274;0;6;329;335
8;Barcelona;40;Vallès Occidental;08187;Sabadell;4;13;B;;678;144;291;373;305;1;1;371;372
8;Barcelona;40;Vallès Occidental;08187;Sabadell;4;14;A;;599;133;270;384;215;1;3;380;383
8;Barcelona;40;Vallès Occidental;08187;Sabadell;4;14;B;;692;117;284;399;293;0;0;399;399
8;Barcelona;40;Vallès Occidental;08187;Sabadell;4;15;U;;890;228;400;504;386;1;3;500;503
8;Barcelona;40;Vallès Occidental;08187;Sabadell;4;16;A;;540;133;230;322;218;0;1;321;322
8;Barcelona;40;Vallès Occidental;08187;Sabadell;4;16;B;;733;196;345;433;300;2;0;431;431
8;Barcelona;40;Vallès Occidental;08187;Sabadell;4;17;A;;703;141;302;380;323;0;1;379;380
8;Barcelona;40;Vallès Occidental;08187;Sabadell;4;17;B;;911;208;407;482;429;0;0;482;482
8;Barcelona;40;Vallès Occidental;08187;Sabadell;4;18;U;;591;142;272;326;265;0;1;325;326
8;Barcelona;40;Vallès Occidental;08187;Sabadell;4;19;A;;572;137;246;301;271;2;2;297;299
8;Barcelona;40;Vallès Occidental;08187;Sabadell;4;19;B;;656;160;261;347;309;0;3;344;347
8;Barcelona;40;Vallès Occidental;08187;Sabadell;4;2;A;;462;145;227;279;183;0;2;277;279
8;Barcelona;40;Vallès Occidental;08187;Sabadell;4;2;B;;587;226;274;340;247;1;4;335;339
8;Barcelona;40;Vallès Occidental;08187;Sabadell;4;20;A;;493;110;196;263;230;2;2;259;261
8;Barcelona;40;Vallès Occidental;08187;Sabadell;4;20;B;;654;127;260;327;327;0;0;327;327
8;Barcelona;40;Vallès Occidental;08187;Sabadell;4;21;U;;1025;163;393;541;484;1;8;532;540
8;Barcelona;40;Vallès Occidental;08187;Sabadell;4;22;U;;719;131;288;425;294;2;4;419;423
8;Barcelona;40;Vallès Occidental;08187;Sabadell;4;3;U;;1006;235;459;612;394;1;0;611;611
8;Barcelona;40;Vallès Occidental;08187;Sabadell;4;4;A;;721;167;317;414;307;0;7;407;414
8;Barcelona;40;Vallès Occidental;08187;Sabadell;4;4;B;;877;220;394;511;366;3;4;504;508
8;Barcelona;40;Vallès Occidental;08187;Sabadell;4;5;A;;662;160;281;396;266;1;4;391;395
8;Barcelona;40;Vallès Occidental;08187;Sabadell;4;5;B;;802;178;365;481;321;2;4;475;479
8;Barcelona;40;Vallès Occidental;08187;Sabadell;4;6;A;;635;155;288;389;246;1;7;381;388
8;Barcelona;40;Vallès Occidental;08187;Sabadell;4;6;B;;799;183;344;469;330;0;4;465;469
8;Barcelona;40;Vallès Occidental;08187;Sabadell;4;7;U;;1040;240;446;593;447;0;7;586;593
8;Barcelona;40;Vallès Occidental;08187;Sabadell;4;8;A;;646;127;303;401;245;0;4;397;401
8;Barcelona;40;Vallès Occidental;08187;Sabadell;4;8;B;;762;162;356;475;287;0;2;473;475
8;Barcelona;40;Vallès Occidental;08187;Sabadell;4;9;U;;1008;195;476;630;378;0;8;622;630
8;Barcelona;40;Vallès Occidental;08187;Sabadell;5;1;A;;699;164;326;427;272;2;2;423;425
8;Barcelona;40;Vallès Occidental;08187;Sabadell;5;1;B;;873;240;436;577;296;3;0;574;574
8;Barcelona;40;Vallès Occidental;08187;Sabadell;5;10;U;;740;195;347;399;341;1;1;397;398
8;Barcelona;40;Vallès Occidental;08187;Sabadell;5;11;U;;620;147;247;310;310;0;1;309;310
8;Barcelona;40;Vallès Occidental;08187;Sabadell;5;12;U;;937;221;425;551;386;2;4;545;549
8;Barcelona;40;Vallès Occidental;08187;Sabadell;5;13;A;;644;137;254;342;302;0;2;340;342
8;Barcelona;40;Vallès Occidental;08187;Sabadell;5;13;B;;865;198;332;448;417;2;2;444;446
8;Barcelona;40;Vallès Occidental;08187;Sabadell;5;2;U;;877;261;517;597;280;0;6;591;597
8;Barcelona;40;Vallès Occidental;08187;Sabadell;5;3;A;;757;201;404;507;250;6;2;499;501
8;Barcelona;40;Vallès Occidental;08187;Sabadell;5;3;B;;785;205;425;524;261;6;4;514;518
8;Barcelona;40;Vallès Occidental;08187;Sabadell;5;4;U;;619;158;330;392;227;1;0;391;391
8;Barcelona;40;Vallès Occidental;08187;Sabadell;5;5;A;;520;185;281;334;186;4;3;327;330
8;Barcelona;40;Vallès Occidental;08187;Sabadell;5;5;B;;570;165;295;353;217;0;7;346;353
8;Barcelona;40;Vallès Occidental;08187;Sabadell;5;6;U;;836;290;503;586;250;1;3;582;585
8;Barcelona;40;Vallès Occidental;08187;Sabadell;5;7;A;;437;130;216;259;178;0;1;258;259
8;Barcelona;40;Vallès Occidental;08187;Sabadell;5;7;B;;584;151;251;323;261;1;0;322;322
8;Barcelona;40;Vallès Occidental;08187;Sabadell;5;8;U;;809;234;385;459;350;1;2;456;458
8;Barcelona;40;Vallès Occidental;08187;Sabadell;5;9;U;;1072;263;518;650;422;0;9;641;650
8;Barcelona;40;Vallès Occidental;08187;Sabadell;6;1;U;;468;169;233;282;186;3;0;279;279
8;Barcelona;40;Vallès Occidental;08187;Sabadell;6;10;U;;947;220;407;479;468;3;2;474;476
8;Barcelona;40;Vallès Occidental;08187;Sabadell;6;11;U;;773;151;291;370;403;1;3;366;369
8;Barcelona;40;Vallès Occidental;08187;Sabadell;6;12;U;;1068;264;476;583;485;4;2;577;579
8;Barcelona;40;Vallès Occidental;08187;Sabadell;6;13;U;;968;234;385;466;502;4;1;461;462
8;Barcelona;40;Vallès Occidental;08187;Sabadell;6;14;U;;516;118;214;282;234;0;7;275;282
8;Barcelona;40;Vallès Occidental;08187;Sabadell;6;15;A;;490;99;185;259;231;0;1;258;259
8;Barcelona;40;Vallès Occidental;08187;Sabadell;6;15;B;;736;143;266;352;384;0;5;347;352
8;Barcelona;40;Vallès Occidental;08187;Sabadell;6;16;A;;683;161;290;393;290;2;3;388;391
8;Barcelona;40;Vallès Occidental;08187;Sabadell;6;16;B;;804;194;348;439;365;1;5;433;438
8;Barcelona;40;Vallès Occidental;08187;Sabadell;6;17;A;;576;142;271;351;225;1;1;349;350
8;Barcelona;40;Vallès Occidental;08187;Sabadell;6;17;B;;796;209;353;468;328;0;6;462;468
8;Barcelona;40;Vallès Occidental;08187;Sabadell;6;18;U;;992;279;479;609;383;0;5;604;609
8;Barcelona;40;Vallès Occidental;08187;Sabadell;6;19;U;;653;154;286;355;298;0;2;353;355
8;Barcelona;40;Vallès Occidental;08187;Sabadell;6;2;A;;559;121;242;305;254;2;1;302;303
8;Barcelona;40;Vallès Occidental;08187;Sabadell;6;2;B;;702;160;316;384;318;1;3;380;383
8;Barcelona;40;Vallès Occidental;08187;Sabadell;6;20;U;;883;246;406;489;394;4;7;478;485
8;Barcelona;40;Vallès Occidental;08187;Sabadell;6;21;U;;919;219;416;535;384;7;0;528;528
8;Barcelona;40;Vallès Occidental;08187;Sabadell;6;22;A;;648;135;240;311;337;0;2;309;311
8;Barcelona;40;Vallès Occidental;08187;Sabadell;6;22;B;;828;196;382;443;385;2;5;436;441
8;Barcelona;40;Vallès Occidental;08187;Sabadell;6;23;A;;666;167;300;396;270;0;1;395;396
8;Barcelona;40;Vallès Occidental;08187;Sabadell;6;23;B;;774;184;444;471;303;1;5;465;470
8;Barcelona;40;Vallès Occidental;08187;Sabadell;6;3;U;;488;106;208;270;218;0;2;268;270
8;Barcelona;40;Vallès Occidental;08187;Sabadell;6;4;U;;1130;291;514;647;483;0;7;640;647
8;Barcelona;40;Vallès Occidental;08187;Sabadell;6;5;U;;1007;213;401;507;500;3;2;502;504
8;Barcelona;40;Vallès Occidental;08187;Sabadell;6;6;U;;923;193;393;483;440;2;0;481;481
8;Barcelona;40;Vallès Occidental;08187;Sabadell;6;7;U;;854;229;381;454;400;3;4;447;451
8;Barcelona;40;Vallès Occidental;08187;Sabadell;6;8;A;;820;205;371;499;321;0;2;497;499
8;Barcelona;40;Vallès Occidental;08187;Sabadell;6;8;B;;936;238;445;549;387;0;4;545;549
8;Barcelona;40;Vallès Occidental;08187;Sabadell;6;9;A;;769;157;327;433;336;2;0;431;431
8;Barcelona;40;Vallès Occidental;08187;Sabadell;6;9;B;;882;185;373;481;401;1;1;479;480
8;Barcelona;40;Vallès Occidental;08187;Sabadell;7;1;U;;971;248;442;561;410;2;3;556;559
8;Barcelona;40;Vallès Occidental;08187;Sabadell;7;2;A;;540;96;230;313;227;1;1;311;312
8;Barcelona;40;Vallès Occidental;08187;Sabadell;7;2;B;;739;180;368;472;267;0;2;470;472
8;Barcelona;40;Vallès Occidental;08187;Sabadell;7;3;A;;655;117;231;301;354;0;1;300;301
8;Barcelona;40;Vallès Occidental;08187;Sabadell;7;3;B;;819;164;316;389;430;1;0;388;388
8;Barcelona;40;Vallès Occidental;08187;Sabadell;7;4;U;;753;224;365;409;344;1;2;406;408
8;Barcelona;40;Vallès Occidental;08187;Sabadell;7;5;U;;724;164;334;422;302;0;0;422;422
8;Barcelona;40;Vallès Occidental;08187;Sabadell;7;6;U;;637;136;314;427;210;4;1;422;423
8;Barcelona;14;Berguedà;08188;Sagàs;1;1;U;;131;31;68;92;39;0;0;92;92
25;Lleida;25;Pallars Jussà;25190;Salàs de Pallars;1;1;U;;304;88;176;203;101;0;5;198;203
8;Barcelona;14;Berguedà;08190;Saldes;1;1;U;;281;91;134;178;103;0;1;177;178
17;Girona;19;Garrotxa;17154;Sales de Llierca;1;1;U;;54;15;26;42;12;0;2;40;42
8;Barcelona;7;Bages;08191;Sallent;1;1;U;;579;160;331;387;192;0;2;385;387
8;Barcelona;7;Bages;08191;Sallent;1;2;U;;672;186;360;438;234;0;3;435;438
8;Barcelona;7;Bages;08191;Sallent;1;3;A;;539;148;265;345;194;0;0;345;345
8;Barcelona;7;Bages;08191;Sallent;1;3;B;;547;123;257;350;197;0;2;348;350
8;Barcelona;7;Bages;08191;Sallent;1;4;A;;508;147;253;315;193;0;3;312;315
8;Barcelona;7;Bages;08191;Sallent;1;4;B;;517;135;243;314;203;0;1;313;314
8;Barcelona;7;Bages;08191;Sallent;1;5;U;;948;256;497;633;315;0;2;631;633
8;Barcelona;7;Bages;08191;Sallent;1;6;U;;720;220;373;458;262;0;8;450;458
8;Barcelona;7;Bages;08191;Sallent;1;7;U;;668;171;304;388;280;1;5;382;387
8;Barcelona;7;Bages;08191;Sallent;2;1;U;;612;160;295;374;238;0;2;372;374
43;Tarragona;36;Tarragonès;43135;Salomó;1;1;U;;341;111;215;269;72;2;2;265;267
43;Tarragona;36;Tarragonès;43905;Salou;1;1;U;;1012;209;372;486;526;2;5;479;484
43;Tarragona;36;Tarragonès;43905;Salou;1;2;A;;541;86;172;236;305;0;2;234;236
43;Tarragona;36;Tarragonès;43905;Salou;1;2;B;;607;85;178;245;362;0;5;240;245
43;Tarragona;36;Tarragonès;43905;Salou;1;3;A;;927;176;350;450;477;1;0;449;449
43;Tarragona;36;Tarragonès;43905;Salou;1;3;B;;889;156;318;421;468;0;1;420;421
43;Tarragona;36;Tarragonès;43905;Salou;1;4;U;;851;163;319;455;396;0;4;451;455
43;Tarragona;36;Tarragonès;43905;Salou;1;5;U;;935;164;327;451;484;1;4;446;450
43;Tarragona;36;Tarragonès;43905;Salou;1;6;A;;520;67;165;221;299;0;1;220;221
43;Tarragona;36;Tarragonès;43905;Salou;1;6;B;;588;100;185;246;342;0;0;246;246
43;Tarragona;36;Tarragonès;43905;Salou;1;7;A;;576;138;230;304;272;2;2;300;302
43;Tarragona;36;Tarragonès;43905;Salou;1;7;B;;667;143;231;326;341;0;5;321;326
43;Tarragona;36;Tarragonès;43905;Salou;1;8;A;;580;106;220;309;271;0;3;306;309
43;Tarragona;36;Tarragonès;43905;Salou;1;8;B;;617;99;221;291;326;0;7;284;291
17;Girona;20;Gironès;17155;Salt;1;1;A;;630;228;366;430;200;2;2;426;428
17;Girona;20;Gironès;17155;Salt;1;1;B;;579;182;330;389;190;3;8;378;386
17;Girona;20;Gironès;17155;Salt;1;2;U;;853;282;452;565;288;0;9;556;565
17;Girona;20;Gironès;17155;Salt;1;3;A;;657;149;286;356;301;1;5;350;355
17;Girona;20;Gironès;17155;Salt;1;3;B;;652;158;294;362;290;1;7;354;361
17;Girona;20;Gironès;17155;Salt;1;4;A;;803;205;400;492;311;3;3;486;489
17;Girona;20;Gironès;17155;Salt;1;4;B;;764;19;352;437;327;3;6;428;434
17;Girona;20;Gironès;17155;Salt;1;5;A;;988;223;400;526;462;0;4;522;526
17;Girona;20;Gironès;17155;Salt;1;5;B;;880;217;377;487;393;0;0;487;487
17;Girona;20;Gironès;17155;Salt;1;6;A;;682;174;260;340;342;0;2;338;340
17;Girona;20;Gironès;17155;Salt;1;6;B;;675;149;259;337;338;0;2;335;337
17;Girona;20;Gironès;17155;Salt;1;7;U;;960;221;390;485;475;0;7;478;485
17;Girona;20;Gironès;17155;Salt;1;8;U;;901;253;433;545;356;4;3;538;541
17;Girona;20;Gironès;17155;Salt;1;9;U;;650;170;352;444;206;2;1;441;442
17;Girona;20;Gironès;17155;Salt;2;1;A;;569;190;271;323;246;1;1;321;322
17;Girona;20;Gironès;17155;Salt;2;1;B;;600;148;259;347;253;1;2;344;346
17;Girona;20;Gironès;17155;Salt;2;2;U;;1099;273;491;629;470;1;8;620;628
17;Girona;20;Gironès;17155;Salt;2;3;A;;610;142;264;338;272;0;3;335;338
17;Girona;20;Gironès;17155;Salt;2;3;B;;595;131;271;330;265;0;0;330;330
17;Girona;20;Gironès;17155;Salt;2;4;U;;1288;254;417;522;766;3;5;514;519
17;Girona;20;Gironès;17155;Salt;2;5;U;;828;271;437;562;266;0;10;552;562
17;Girona;20;Gironès;17155;Salt;2;6;U;;980;232;446;577;403;1;17;559;576
25;Lleida;32;Segarra;25191;Sanaüja;1;1;U;;408;112;245;316;92;0;0;316;316
43;Tarragona;22;Montsià;43138;Santa Bàrbara;1;1;A;;535;129;281;394;141;2;5;387;392
43;Tarragona;22;Montsià;43138;Santa Bàrbara;1;1;B;;294;64;147;216;78;0;3;213;216
43;Tarragona;22;Montsià;43138;Santa Bàrbara;1;1;C;;353;76;192;267;86;0;3;264;267
43;Tarragona;22;Montsià;43138;Santa Bàrbara;1;1;D;;366;95;201;279;87;1;3;275;278
43;Tarragona;22;Montsià;43138;Santa Bàrbara;2;1;A;;594;124;308;428;166;0;1;427;428
43;Tarragona;22;Montsià;43138;Santa Bàrbara;2;1;B;;570;138;267;393;177;2;4;387;391
8;Barcelona;24;Osona;08243;Santa Cecília de Voltregà;1;1;U;;157;42;87;119;38;1;0;118;118
8;Barcelona;11;Baix Llobregat;08244;Santa Coloma de Cervelló;1;1;A;;650;143;287;371;279;1;1;369;370
8;Barcelona;11;Baix Llobregat;08244;Santa Coloma de Cervelló;1;1;B;;732;169;309;427;305;1;4;422;426
8;Barcelona;11;Baix Llobregat;08244;Santa Coloma de Cervelló;1;1;C;;749;156;319;457;292;2;2;453;455
8;Barcelona;11;Baix Llobregat;08244;Santa Coloma de Cervelló;1;2;U;;698;260;423;491;207;3;1;487;488
8;Barcelona;11;Baix Llobregat;08244;Santa Coloma de Cervelló;1;3;U;;774;160;355;476;298;1;8;467;475
17;Girona;34;Selva;17180;Santa Coloma de Farners;1;1;A;;792;163;345;480;312;4;7;469;476
17;Girona;34;Selva;17180;Santa Coloma de Farners;1;1;B;;744;161;350;456;288;3;8;445;453
17;Girona;34;Selva;17180;Santa Coloma de Farners;1;2;A;;515;111;261;367;148;2;6;359;365
17;Girona;34;Selva;17180;Santa Coloma de Farners;1;2;B;;488;123;251;339;149;3;2;334;336
17;Girona;34;Selva;17180;Santa Coloma de Farners;1;3;A;;746;195;387;506;240;1;5;500;505
17;Girona;34;Selva;17180;Santa Coloma de Farners;1;3;B;;668;189;336;424;244;1;2;421;423
17;Girona;34;Selva;17180;Santa Coloma de Farners;1;4;A;;648;126;317;415;233;1;2;412;414
17;Girona;34;Selva;17180;Santa Coloma de Farners;1;4;B;;611;123;249;340;271;2;8;330;338
17;Girona;34;Selva;17180;Santa Coloma de Farners;1;4;C;;658;130;306;427;231;0;3;424;427
17;Girona;34;Selva;17180;Santa Coloma de Farners;1;5;A;;570;112;247;339;231;1;2;336;338
17;Girona;34;Selva;17180;Santa Coloma de Farners;1;5;B;;619;118;291;389;230;3;9;377;386
8;Barcelona;13;Barcelonès;08245;Santa Coloma de Gramenet;1;1;U;;964;275;479;629;335;1;8;620;628
8;Barcelona;13;Barcelonès;08245;Santa Coloma de Gramenet;1;10;A;;575;114;210;287;288;2;0;285;285
8;Barcelona;13;Barcelonès;08245;Santa Coloma de Gramenet;1;10;B;;694;139;263;350;344;0;2;348;350
8;Barcelona;13;Barcelonès;08245;Santa Coloma de Gramenet;1;11;A;;533;111;200;295;238;0;2;293;295
8;Barcelona;13;Barcelonès;08245;Santa Coloma de Gramenet;1;11;B;;555;119;240;322;233;2;0;320;320
8;Barcelona;13;Barcelonès;08245;Santa Coloma de Gramenet;1;12;U;;852;175;347;512;340;0;3;509;512
8;Barcelona;13;Barcelonès;08245;Santa Coloma de Gramenet;1;13;A;;558;115;233;338;220;0;6;332;338
8;Barcelona;13;Barcelonès;08245;Santa Coloma de Gramenet;1;13;B;;603;142;253;338;265;2;4;332;336
8;Barcelona;13;Barcelonès;08245;Santa Coloma de Gramenet;1;13;C;;574;108;236;348;226;2;0;346;346
8;Barcelona;13;Barcelonès;08245;Santa Coloma de Gramenet;1;14;U;;847;153;352;505;342;0;9;496;505
8;Barcelona;13;Barcelonès;08245;Santa Coloma de Gramenet;1;15;U;;705;146;278;366;339;0;5;361;366
8;Barcelona;13;Barcelonès;08245;Santa Coloma de Gramenet;1;16;U;;757;177;336;449;308;0;5;444;449
8;Barcelona;13;Barcelonès;08245;Santa Coloma de Gramenet;1;17;A;;663;133;243;343;320;0;3;340;343
8;Barcelona;13;Barcelonès;08245;Santa Coloma de Gramenet;1;17;B;;829;160;327;448;381;0;6;442;448
8;Barcelona;13;Barcelonès;08245;Santa Coloma de Gramenet;1;18;A;;584;126;216;314;270;0;5;309;314
8;Barcelona;13;Barcelonès;08245;Santa Coloma de Gramenet;1;18;B;;646;131;237;341;305;0;4;337;341
8;Barcelona;13;Barcelonès;08245;Santa Coloma de Gramenet;1;19;A;;649;132;248;347;302;5;6;336;342
8;Barcelona;13;Barcelonès;08245;Santa Coloma de Gramenet;1;19;B;;738;118;268;390;348;1;3;386;389
8;Barcelona;13;Barcelonès;08245;Santa Coloma de Gramenet;1;2;U;;763;180;342;441;322;2;3;436;439
8;Barcelona;13;Barcelonès;08245;Santa Coloma de Gramenet;1;3;A;;499;129;215;305;194;0;1;304;305
8;Barcelona;13;Barcelonès;08245;Santa Coloma de Gramenet;1;3;B;;638;163;275;381;257;1;4;376;380
8;Barcelona;13;Barcelonès;08245;Santa Coloma de Gramenet;1;4;U;;696;169;300;383;313;0;6;377;383
8;Barcelona;13;Barcelonès;08245;Santa Coloma de Gramenet;1;5;U;;787;210;327;439;348;1;6;432;438
8;Barcelona;13;Barcelonès;08245;Santa Coloma de Gramenet;1;6;U;;786;159;282;382;404;6;2;374;376
8;Barcelona;13;Barcelonès;08245;Santa Coloma de Gramenet;1;7;U;;592;151;215;293;299;0;5;288;293
8;Barcelona;13;Barcelonès;08245;Santa Coloma de Gramenet;1;8;U;;616;151;277;357;259;1;6;350;356
8;Barcelona;13;Barcelonès;08245;Santa Coloma de Gramenet;1;9;A;;533;132;208;285;248;0;5;280;285
8;Barcelona;13;Barcelonès;08245;Santa Coloma de Gramenet;1;9;B;;657;126;238;350;307;0;7;343;350
8;Barcelona;13;Barcelonès;08245;Santa Coloma de Gramenet;2;1;U;;933;222;409;547;386;1;4;542;546
8;Barcelona;13;Barcelonès;08245;Santa Coloma de Gramenet;2;10;U;;786;144;263;381;405;2;1;378;379
8;Barcelona;13;Barcelonès;08245;Santa Coloma de Gramenet;2;11;A;;611;97;208;280;331;0;2;278;280
8;Barcelona;13;Barcelonès;08245;Santa Coloma de Gramenet;2;11;B;;705;122;247;330;375;1;0;329;329
8;Barcelona;13;Barcelonès;08245;Santa Coloma de Gramenet;2;2;A;;438;94;180;245;193;1;5;239;244
8;Barcelona;13;Barcelonès;08245;Santa Coloma de Gramenet;2;2;B;;512;114;209;269;243;2;7;260;267
8;Barcelona;13;Barcelonès;08245;Santa Coloma de Gramenet;2;2;C;;473;103;203;271;202;0;4;267;271
8;Barcelona;13;Barcelonès;08245;Santa Coloma de Gramenet;2;3;A;;653;98;217;289;364;0;4;285;289
8;Barcelona;13;Barcelonès;08245;Santa Coloma de Gramenet;2;3;B;;758;125;233;315;443;0;2;313;315
8;Barcelona;13;Barcelonès;08245;Santa Coloma de Gramenet;2;4;A;;501;117;215;271;230;0;1;270;271
8;Barcelona;13;Barcelonès;08245;Santa Coloma de Gramenet;2;4;B;;582;131;249;316;266;1;4;311;315
8;Barcelona;13;Barcelonès;08245;Santa Coloma de Gramenet;2;5;A;;536;136;227;313;223;0;5;308;313
8;Barcelona;13;Barcelonès;08245;Santa Coloma de Gramenet;2;5;B;;583;136;226;314;269;2;0;312;312
8;Barcelona;13;Barcelonès;08245;Santa Coloma de Gramenet;2;6;A;;559;114;235;319;240;1;2;316;318
8;Barcelona;13;Barcelonès;08245;Santa Coloma de Gramenet;2;6;B;;652;162;312;410;242;1;0;409;409
8;Barcelona;13;Barcelonès;08245;Santa Coloma de Gramenet;2;7;A;;501;89;176;245;256;1;3;241;244
8;Barcelona;13;Barcelonès;08245;Santa Coloma de Gramenet;2;7;B;;613;96;208;285;328;0;0;285;285
8;Barcelona;13;Barcelonès;08245;Santa Coloma de Gramenet;2;7;C;;579;98;200;284;295;2;2;280;282
8;Barcelona;13;Barcelonès;08245;Santa Coloma de Gramenet;2;8;A;;646;149;261;335;311;0;2;333;335
8;Barcelona;13;Barcelonès;08245;Santa Coloma de Gramenet;2;8;B;;742;221;343;390;352;0;5;385;390
8;Barcelona;13;Barcelonès;08245;Santa Coloma de Gramenet;2;9;A;;556;134;226;315;241;1;1;313;314
8;Barcelona;13;Barcelonès;08245;Santa Coloma de Gramenet;2;9;B;;605;115;263;346;259;1;5;340;345
8;Barcelona;13;Barcelonès;08245;Santa Coloma de Gramenet;3;1;U;;883;172;343;459;424;1;3;455;458
8;Barcelona;13;Barcelonès;08245;Santa Coloma de Gramenet;3;10;U;;530;110;227;282;248;1;4;277;281
8;Barcelona;13;Barcelonès;08245;Santa Coloma de Gramenet;3;11;U;;746;193;361;456;290;0;6;450;456
8;Barcelona;13;Barcelonès;08245;Santa Coloma de Gramenet;3;12;A;;636;119;248;347;289;0;2;345;347
8;Barcelona;13;Barcelonès;08245;Santa Coloma de Gramenet;3;12;B;;798;166;322;425;373;0;5;420;425
8;Barcelona;13;Barcelonès;08245;Santa Coloma de Gramenet;3;13;A;;457;95;146;249;208;0;5;244;249
8;Barcelona;13;Barcelonès;08245;Santa Coloma de Gramenet;3;13;B;;556;110;208;298;258;0;3;295;298
8;Barcelona;13;Barcelonès;08245;Santa Coloma de Gramenet;3;13;C;;611;140;244;340;271;1;3;336;339
8;Barcelona;13;Barcelonès;08245;Santa Coloma de Gramenet;3;14;A;;582;117;241;304;278;1;3;300;303
8;Barcelona;13;Barcelonès;08245;Santa Coloma de Gramenet;3;14;B;;698;145;290;371;327;3;1;367;368
8;Barcelona;13;Barcelonès;08245;Santa Coloma de Gramenet;3;15;A;;401;89;160;219;182;2;5;212;217
8;Barcelona;13;Barcelonès;08245;Santa Coloma de Gramenet;3;15;B;;407;84;155;219;188;1;6;212;218
8;Barcelona;13;Barcelonès;08245;Santa Coloma de Gramenet;3;16;U;;1003;241;436;549;454;1;8;540;548
8;Barcelona;13;Barcelonès;08245;Santa Coloma de Gramenet;3;17;U;;871;163;264;347;524;2;2;343;345
8;Barcelona;13;Barcelonès;08245;Santa Coloma de Gramenet;3;2;U;;628;130;228;315;313;1;7;307;314
8;Barcelona;13;Barcelonès;08245;Santa Coloma de Gramenet;3;3;U;;859;155;330;483;376;0;0;483;483
8;Barcelona;13;Barcelonès;08245;Santa Coloma de Gramenet;3;4;A;;524;98;180;255;269;0;3;252;255
8;Barcelona;13;Barcelonès;08245;Santa Coloma de Gramenet;3;4;B;;544;125;224;284;260;0;0;284;284
8;Barcelona;13;Barcelonès;08245;Santa Coloma de Gramenet;3;5;A;;478;83;146;197;281;0;3;194;197
8;Barcelona;13;Barcelonès;08245;Santa Coloma de Gramenet;3;5;B;;644;119;206;287;357;0;9;278;287
8;Barcelona;13;Barcelonès;08245;Santa Coloma de Gramenet;3;6;A;;422;74;145;209;213;0;2;207;209
8;Barcelona;13;Barcelonès;08245;Santa Coloma de Gramenet;3;6;B;;577;101;213;296;281;0;6;290;296
8;Barcelona;13;Barcelonès;08245;Santa Coloma de Gramenet;3;7;A;;508;124;208;286;222;1;0;285;285
8;Barcelona;13;Barcelonès;08245;Santa Coloma de Gramenet;3;7;B;;690;137;254;366;324;0;6;360;366
8;Barcelona;13;Barcelonès;08245;Santa Coloma de Gramenet;3;7;C;;549;102;197;274;275;0;3;271;274
8;Barcelona;13;Barcelonès;08245;Santa Coloma de Gramenet;3;8;U;;714;136;271;371;343;0;3;368;371
8;Barcelona;13;Barcelonès;08245;Santa Coloma de Gramenet;3;9;U;;977;207;381;524;453;1;4;519;523
8;Barcelona;13;Barcelonès;08245;Santa Coloma de Gramenet;4;1;U;;898;160;346;484;414;0;8;476;484
8;Barcelona;13;Barcelonès;08245;Santa Coloma de Gramenet;4;10;A;;520;119;216;275;245;2;3;270;273
8;Barcelona;13;Barcelonès;08245;Santa Coloma de Gramenet;4;10;B;;608;135;262;347;261;0;8;339;347
8;Barcelona;13;Barcelonès;08245;Santa Coloma de Gramenet;4;11;A;;490;114;204;277;213;1;1;275;276
8;Barcelona;13;Barcelonès;08245;Santa Coloma de Gramenet;4;11;B;;513;120;234;308;205;0;4;304;308
8;Barcelona;13;Barcelonès;08245;Santa Coloma de Gramenet;4;12;A;;416;86;183;233;183;0;3;230;233
8;Barcelona;13;Barcelonès;08245;Santa Coloma de Gramenet;4;12;B;;576;111;252;348;228;0;1;347;348
8;Barcelona;13;Barcelonès;08245;Santa Coloma de Gramenet;4;13;A;;698;133;253;364;334;0;5;359;364
8;Barcelona;13;Barcelonès;08245;Santa Coloma de Gramenet;4;13;B;;825;171;302;420;405;0;4;416;420
8;Barcelona;13;Barcelonès;08245;Santa Coloma de Gramenet;4;14;A;;524;96;211;296;228;0;2;294;296
8;Barcelona;13;Barcelonès;08245;Santa Coloma de Gramenet;4;14;B;;641;121;248;345;296;0;6;339;345
8;Barcelona;13;Barcelonès;08245;Santa Coloma de Gramenet;4;14;C;;583;118;247;329;254;1;2;326;328
8;Barcelona;13;Barcelonès;08245;Santa Coloma de Gramenet;4;15;A;;601;111;208;286;315;0;2;284;286
8;Barcelona;13;Barcelonès;08245;Santa Coloma de Gramenet;4;15;B;;733;150;264;367;366;0;8;359;367
8;Barcelona;13;Barcelonès;08245;Santa Coloma de Gramenet;4;16;A;;482;93;194;270;212;3;0;267;267
8;Barcelona;13;Barcelonès;08245;Santa Coloma de Gramenet;4;16;B;;598;116;228;319;279;0;1;318;319
8;Barcelona;13;Barcelonès;08245;Santa Coloma de Gramenet;4;2;A;;559;126;246;338;221;4;2;332;334
8;Barcelona;13;Barcelonès;08245;Santa Coloma de Gramenet;4;2;B;;580;150;272;359;221;0;3;356;359
8;Barcelona;13;Barcelonès;08245;Santa Coloma de Gramenet;4;3;A;;496;76;169;252;244;0;1;251;252
8;Barcelona;13;Barcelonès;08245;Santa Coloma de Gramenet;4;3;B;;558;122;222;288;270;0;3;285;288
8;Barcelona;13;Barcelonès;08245;Santa Coloma de Gramenet;4;4;A;;628;115;236;342;286;0;4;338;342
8;Barcelona;13;Barcelonès;08245;Santa Coloma de Gramenet;4;4;B;;728;137;287;408;320;0;1;407;408
8;Barcelona;13;Barcelonès;08245;Santa Coloma de Gramenet;4;5;U;;943;172;373;512;431;2;2;508;510
8;Barcelona;13;Barcelonès;08245;Santa Coloma de Gramenet;4;6;A;;505;96;213;289;216;0;7;282;289
8;Barcelona;13;Barcelonès;08245;Santa Coloma de Gramenet;4;6;B;;625;129;260;353;272;0;8;345;353
8;Barcelona;13;Barcelonès;08245;Santa Coloma de Gramenet;4;7;A;;632;123;224;348;284;1;7;340;347
8;Barcelona;13;Barcelonès;08245;Santa Coloma de Gramenet;4;7;B;;754;143;288;405;349;1;4;400;404
8;Barcelona;13;Barcelonès;08245;Santa Coloma de Gramenet;4;8;A;;474;88;184;267;207;1;2;264;266
8;Barcelona;13;Barcelonès;08245;Santa Coloma de Gramenet;4;8;B;;525;112;205;297;228;5;3;289;292
8;Barcelona;13;Barcelonès;08245;Santa Coloma de Gramenet;4;8;C;;580;136;273;349;231;1;4;344;348
8;Barcelona;13;Barcelonès;08245;Santa Coloma de Gramenet;4;9;A;;696;147;280;385;311;0;2;383;385
8;Barcelona;13;Barcelonès;08245;Santa Coloma de Gramenet;4;9;B;;741;160;305;419;322;0;4;415;419
8;Barcelona;13;Barcelonès;08245;Santa Coloma de Gramenet;5;1;U;;835;184;319;426;409;0;3;423;426
8;Barcelona;13;Barcelonès;08245;Santa Coloma de Gramenet;5;10;U;;703;130;228;285;418;2;3;280;283
8;Barcelona;13;Barcelonès;08245;Santa Coloma de Gramenet;5;11;A;;602;115;192;267;335;0;0;267;267
8;Barcelona;13;Barcelonès;08245;Santa Coloma de Gramenet;5;11;B;;668;104;202;289;379;0;0;289;289
8;Barcelona;13;Barcelonès;08245;Santa Coloma de Gramenet;5;12;U;;801;146;281;354;447;2;3;349;352
8;Barcelona;13;Barcelonès;08245;Santa Coloma de Gramenet;5;13;A;;570;111;196;250;320;0;2;248;250
8;Barcelona;13;Barcelonès;08245;Santa Coloma de Gramenet;5;13;B;;589;113;200;286;303;0;2;284;286
8;Barcelona;13;Barcelonès;08245;Santa Coloma de Gramenet;5;14;A;;559;100;207;278;281;0;2;276;278
8;Barcelona;13;Barcelonès;08245;Santa Coloma de Gramenet;5;14;B;;698;139;262;355;343;0;4;351;355
8;Barcelona;13;Barcelonès;08245;Santa Coloma de Gramenet;5;15;A;;532;100;172;227;305;0;1;226;227
8;Barcelona;13;Barcelonès;08245;Santa Coloma de Gramenet;5;15;B;;599;114;200;277;322;0;1;276;277
8;Barcelona;13;Barcelonès;08245;Santa Coloma de Gramenet;5;16;U;;840;149;290;412;428;1;2;409;411
8;Barcelona;13;Barcelonès;08245;Santa Coloma de Gramenet;5;17;U;;715;143;233;301;414;0;0;301;301
8;Barcelona;13;Barcelonès;08245;Santa Coloma de Gramenet;5;18;A;;444;72;120;150;294;1;6;143;149
8;Barcelona;13;Barcelonès;08245;Santa Coloma de Gramenet;5;18;B;;460;76;127;177;283;0;2;175;177
8;Barcelona;13;Barcelonès;08245;Santa Coloma de Gramenet;5;19;U;;931;227;391;483;448;0;2;481;483
8;Barcelona;13;Barcelonès;08245;Santa Coloma de Gramenet;5;2;A;;581;123;233;311;270;0;3;308;311
8;Barcelona;13;Barcelonès;08245;Santa Coloma de Gramenet;5;2;B;;691;146;250;379;312;0;4;375;379
8;Barcelona;13;Barcelonès;08245;Santa Coloma de Gramenet;5;3;U;;811;167;330;452;359;0;6;446;452
8;Barcelona;13;Barcelonès;08245;Santa Coloma de Gramenet;5;4;U;;750;152;290;396;354;1;0;395;395
8;Barcelona;13;Barcelonès;08245;Santa Coloma de Gramenet;5;5;A;;525;107;195;261;264;1;2;258;260
8;Barcelona;13;Barcelonès;08245;Santa Coloma de Gramenet;5;5;B;;498;106;181;220;278;0;0;220;220
8;Barcelona;13;Barcelonès;08245;Santa Coloma de Gramenet;5;6;U;;871;185;327;452;419;0;1;451;452
8;Barcelona;13;Barcelonès;08245;Santa Coloma de Gramenet;5;7;A;;461;113;189;259;202;1;2;256;258
8;Barcelona;13;Barcelonès;08245;Santa Coloma de Gramenet;5;7;B;;551;117;209;281;270;1;4;276;280
8;Barcelona;13;Barcelonès;08245;Santa Coloma de Gramenet;5;8;U;;796;126;262;350;446;0;0;350;350
8;Barcelona;13;Barcelonès;08245;Santa Coloma de Gramenet;5;9;U;;996;207;342;450;546;0;1;449;450
8;Barcelona;13;Barcelonès;08245;Santa Coloma de Gramenet;6;1;U;;595;148;258;348;247;0;2;346;348
8;Barcelona;13;Barcelonès;08245;Santa Coloma de Gramenet;6;10;U;;764;141;259;343;421;0;0;343;343
8;Barcelona;13;Barcelonès;08245;Santa Coloma de Gramenet;6;11;U;;780;139;256;354;426;0;3;351;354
8;Barcelona;13;Barcelonès;08245;Santa Coloma de Gramenet;6;12;U;;672;154;274;355;317;1;4;350;354
8;Barcelona;13;Barcelonès;08245;Santa Coloma de Gramenet;6;13;U;;567;101;195;290;277;0;3;287;290
8;Barcelona;13;Barcelonès;08245;Santa Coloma de Gramenet;6;14;A;;451;75;132;198;253;0;1;197;198
8;Barcelona;13;Barcelonès;08245;Santa Coloma de Gramenet;6;14;B;;591;118;198;267;324;0;4;263;267
8;Barcelona;13;Barcelonès;08245;Santa Coloma de Gramenet;6;15;U;;537;107;173;231;306;0;4;227;231
8;Barcelona;13;Barcelonès;08245;Santa Coloma de Gramenet;6;16;U;;581;84;158;218;363;0;2;216;218
8;Barcelona;13;Barcelonès;08245;Santa Coloma de Gramenet;6;17;U;;750;150;275;344;406;0;5;339;344
8;Barcelona;13;Barcelonès;08245;Santa Coloma de Gramenet;6;2;U;;882;216;380;476;406;1;4;471;475
8;Barcelona;13;Barcelonès;08245;Santa Coloma de Gramenet;6;3;A;;416;89;147;201;215;0;2;199;201
8;Barcelona;13;Barcelonès;08245;Santa Coloma de Gramenet;6;3;B;;492;102;182;246;246;0;5;241;246
8;Barcelona;13;Barcelonès;08245;Santa Coloma de Gramenet;6;4;A;;377;87;156;209;168;0;1;208;209
8;Barcelona;13;Barcelonès;08245;Santa Coloma de Gramenet;6;4;B;;499;127;212;266;233;0;1;265;266
8;Barcelona;13;Barcelonès;08245;Santa Coloma de Gramenet;6;5;U;;828;174;340;457;371;0;2;455;457
8;Barcelona;13;Barcelonès;08245;Santa Coloma de Gramenet;6;6;U;;710;171;280;364;346;0;4;360;364
8;Barcelona;13;Barcelonès;08245;Santa Coloma de Gramenet;6;7;U;;532;124;205;282;250;0;2;280;282
8;Barcelona;13;Barcelonès;08245;Santa Coloma de Gramenet;6;8;A;;491;103;193;266;225;0;0;266;266
8;Barcelona;13;Barcelonès;08245;Santa Coloma de Gramenet;6;8;B;;531;96;201;258;273;0;8;250;258
8;Barcelona;13;Barcelonès;08245;Santa Coloma de Gramenet;6;9;U;;533;102;186;255;278;0;7;248;255
43;Tarragona;16;Conca de Barberà;43139;Santa Coloma de Queralt;1;1;A;;679;168;323;447;232;2;2;443;445
43;Tarragona;16;Conca de Barberà;43139;Santa Coloma de Queralt;1;1;B;;819;200;394;548;271;4;6;538;544
43;Tarragona;16;Conca de Barberà;43139;Santa Coloma de Queralt;2;1;U;;694;127;293;452;242;3;6;443;449
17;Girona;10;Baix Empordà;17181;Santa Cristina d'Aro;1;1;A;;718;205;370;486;232;1;4;481;485
17;Girona;10;Baix Empordà;17181;Santa Cristina d'Aro;1;1;B;;602;159;297;372;230;3;4;365;369
17;Girona;10;Baix Empordà;17181;Santa Cristina d'Aro;1;1;C;;673;180;348;432;241;2;1;429;430
8;Barcelona;13;Barcelonès;08194;Sant Adrià de Besòs;1;1;A;;583;143;250;302;281;0;1;301;302
8;Barcelona;13;Barcelonès;08194;Sant Adrià de Besòs;1;1;B;;689;175;305;399;290;0;10;389;399
8;Barcelona;13;Barcelonès;08194;Sant Adrià de Besòs;1;2;A;;559;137;258;335;224;1;1;333;334
8;Barcelona;13;Barcelonès;08194;Sant Adrià de Besòs;1;2;B;;609;135;251;361;248;1;5;355;360
8;Barcelona;13;Barcelonès;08194;Sant Adrià de Besòs;1;3;A;;751;187;325;417;334;0;2;415;417
8;Barcelona;13;Barcelonès;08194;Sant Adrià de Besòs;1;3;B;;865;197;380;459;406;2;0;457;457
8;Barcelona;13;Barcelonès;08194;Sant Adrià de Besòs;1;4;A;;670;134;263;371;299;0;0;371;371
8;Barcelona;13;Barcelonès;08194;Sant Adrià de Besòs;1;4;B;;737;135;297;430;307;0;2;428;430
8;Barcelona;13;Barcelonès;08194;Sant Adrià de Besòs;1;5;A;;818;187;344;467;351;0;7;460;467
8;Barcelona;13;Barcelonès;08194;Sant Adrià de Besòs;1;5;B;;898;200;382;497;401;0;5;492;497
8;Barcelona;13;Barcelonès;08194;Sant Adrià de Besòs;1;6;A;;535;122;244;322;213;2;6;314;320
8;Barcelona;13;Barcelonès;08194;Sant Adrià de Besòs;1;6;B;;575;140;257;344;231;0;2;342;344
8;Barcelona;13;Barcelonès;08194;Sant Adrià de Besòs;2;1;A;;586;152;253;300;286;1;1;298;299
8;Barcelona;13;Barcelonès;08194;Sant Adrià de Besòs;2;1;B;;678;153;281;356;322;1;2;353;355
8;Barcelona;13;Barcelonès;08194;Sant Adrià de Besòs;2;2;A;;633;127;235;296;337;0;0;296;296
8;Barcelona;13;Barcelonès;08194;Sant Adrià de Besòs;2;2;B;;719;156;266;340;379;0;4;336;340
8;Barcelona;13;Barcelonès;08194;Sant Adrià de Besòs;2;3;A;;591;97;209;292;299;2;1;289;290
8;Barcelona;13;Barcelonès;08194;Sant Adrià de Besòs;2;3;B;;795;156;307;427;368;1;3;423;426
8;Barcelona;13;Barcelonès;08194;Sant Adrià de Besòs;2;4;A;;806;180;349;468;338;0;3;465;468
8;Barcelona;13;Barcelonès;08194;Sant Adrià de Besòs;2;4;B;;937;188;365;494;443;0;5;489;494
8;Barcelona;13;Barcelonès;08194;Sant Adrià de Besòs;3;1;U;;537;146;236;280;257;2;0;278;278
8;Barcelona;13;Barcelonès;08194;Sant Adrià de Besòs;4;1;U;;356;66;130;165;191;0;0;165;165
8;Barcelona;13;Barcelonès;08194;Sant Adrià de Besòs;5;1;A;;689;156;245;347;342;0;2;345;347
8;Barcelona;13;Barcelonès;08194;Sant Adrià de Besòs;5;1;B;;774;134;302;405;369;1;2;402;404
8;Barcelona;13;Barcelonès;08194;Sant Adrià de Besòs;5;2;A;;698;168;304;384;314;0;4;380;384
8;Barcelona;13;Barcelonès;08194;Sant Adrià de Besòs;5;2;B;;748;157;319;399;349;0;2;397;399
8;Barcelona;13;Barcelonès;08194;Sant Adrià de Besòs;5;3;U;;927;212;425;554;373;0;2;552;554
8;Barcelona;13;Barcelonès;08194;Sant Adrià de Besòs;5;4;A;;553;122;226;304;249;0;4;300;304
8;Barcelona;13;Barcelonès;08194;Sant Adrià de Besòs;5;4;B;;595;146;260;344;251;0;3;341;344
8;Barcelona;13;Barcelonès;08194;Sant Adrià de Besòs;6;1;U;;430;74;133;181;249;0;1;180;181
8;Barcelona;13;Barcelonès;08194;Sant Adrià de Besòs;6;2;A;;728;125;207;284;444;1;1;282;283
8;Barcelona;13;Barcelonès;08194;Sant Adrià de Besòs;6;2;B;;605;94;178;234;371;0;0;234;234
8;Barcelona;13;Barcelonès;08194;Sant Adrià de Besòs;6;3;U;;533;101;151;182;351;1;1;180;181
8;Barcelona;13;Barcelonès;08194;Sant Adrià de Besòs;6;4;A;;910;87;164;218;692;0;3;215;218
8;Barcelona;13;Barcelonès;08194;Sant Adrià de Besòs;6;4;B;;526;80;138;169;357;1;0;168;168
8;Barcelona;13;Barcelonès;08194;Sant Adrià de Besòs;6;5;A;;585;143;240;293;292;0;2;291;293
8;Barcelona;13;Barcelonès;08194;Sant Adrià de Besòs;6;5;B;;664;146;267;343;321;0;2;341;343
8;Barcelona;13;Barcelonès;08194;Sant Adrià de Besòs;6;6;A;;722;107;181;247;475;0;2;245;247
8;Barcelona;13;Barcelonès;08194;Sant Adrià de Besòs;6;6;B;;656;110;190;225;431;1;4;220;224
8;Barcelona;13;Barcelonès;08194;Sant Adrià de Besòs;6;7;A;;501;91;143;184;317;0;0;184;184
8;Barcelona;13;Barcelonès;08194;Sant Adrià de Besòs;6;7;B;;533;116;200;246;287;1;2;243;245
8;Barcelona;24;Osona;08246;Santa Eugènia de Berga;1;1;A;;736;155;382;520;216;0;2;518;520
8;Barcelona;24;Osona;08246;Santa Eugènia de Berga;1;1;B;;832;208;480;632;200;0;4;628;632
8;Barcelona;24;Osona;08247;Santa Eulàlia de Riuprimer;1;1;U;;713;212;385;520;193;2;6;512;518
8;Barcelona;41;Vallès Oriental;08248;Santa Eulàlia de Ronçana;1;1;A;;918;176;392;545;373;0;5;540;545
8;Barcelona;41;Vallès Oriental;08248;Santa Eulàlia de Ronçana;1;1;B;;970;215;415;545;425;1;2;542;544
8;Barcelona;41;Vallès Oriental;08248;Santa Eulàlia de Ronçana;1;2;A;;862;183;406;525;337;2;4;519;523
8;Barcelona;41;Vallès Oriental;08248;Santa Eulàlia de Ronçana;1;2;B;;927;192;427;545;382;0;7;538;545
8;Barcelona;3;Alt Penedès;08249;Santa Fe del Penedès;1;1;U;;239;33;126;191;48;1;0;190;190
8;Barcelona;24;Osona;08195;Sant Agustí de Lluçanès;1;1;U;;97;15;44;69;28;0;1;68;69
17;Girona;2;Alt Empordà;17182;Santa Llogaia d'Àlguema;1;1;U;;244;47;106;155;89;0;0;155;155
8;Barcelona;6;Anoia;08250;Santa Margarida de Montbui;1;1;U;;669;150;230;445;224;2;1;442;443
8;Barcelona;6;Anoia;08250;Santa Margarida de Montbui;1;2;A;;843;170;364;459;384;1;4;454;458
8;Barcelona;6;Anoia;08250;Santa Margarida de Montbui;1;2;B;;915;176;360;476;439;2;3;471;474
8;Barcelona;6;Anoia;08250;Santa Margarida de Montbui;1;3;U;;871;168;324;457;414;0;3;454;457
8;Barcelona;6;Anoia;08250;Santa Margarida de Montbui;1;4;A;;645;118;258;343;302;1;4;338;342
8;Barcelona;6;Anoia;08250;Santa Margarida de Montbui;1;4;B;;768;114;293;404;364;6;2;396;398
8;Barcelona;6;Anoia;08250;Santa Margarida de Montbui;1;5;A;;623;115;231;315;308;1;1;313;314
8;Barcelona;6;Anoia;08250;Santa Margarida de Montbui;1;5;B;;664;129;268;358;306;0;2;356;358
8;Barcelona;6;Anoia;08250;Santa Margarida de Montbui;1;5;C;;644;102;241;323;321;0;4;319;323
8;Barcelona;6;Anoia;08250;Santa Margarida de Montbui;1;6;U;;864;175;294;415;449;1;4;410;414
8;Barcelona;3;Alt Penedès;08251;Santa Margarida i els Monjos;1;1;A;;576;147;289;372;204;4;1;367;368
8;Barcelona;3;Alt Penedès;08251;Santa Margarida i els Monjos;1;1;B;;521;132;259;325;196;1;4;320;324
8;Barcelona;3;Alt Penedès;08251;Santa Margarida i els Monjos;1;1;C;;582;136;289;371;211;0;2;369;371
8;Barcelona;3;Alt Penedès;08251;Santa Margarida i els Monjos;1;2;U;;866;228;430;549;317;3;6;540;546
8;Barcelona;3;Alt Penedès;08251;Santa Margarida i els Monjos;1;3;A;;472;127;233;301;171;0;0;301;301
8;Barcelona;3;Alt Penedès;08251;Santa Margarida i els Monjos;1;3;B;;639;153;295;386;253;2;2;382;384
8;Barcelona;;;08258;Santa Maria d'Oló;1;1;U;;864;217;536;692;172;0;11;681;692
8;Barcelona;24;Osona;08253;Santa Maria de Besora;1;1;U;;147;37;66;86;61;1;0;85;85
8;Barcelona;41;Vallès Oriental;08256;Santa Maria de Martorelles;1;1;U;;584;167;309;399;185;2;2;395;397
8;Barcelona;14;Berguedà;08255;Santa Maria de Merlès;1;1;U;;143;22;61;78;65;0;1;77;78
8;Barcelona;6;Anoia;08257;Santa Maria de Miralles;1;1;U;;91;29;48;64;27;0;0;64;64
8;Barcelona;41;Vallès Oriental;08259;Santa Maria de Palautordera;1;1;A;;898;260;482;589;309;0;4;585;589
8;Barcelona;41;Vallès Oriental;08259;Santa Maria de Palautordera;1;1;B;;968;286;535;653;315;1;5;647;652
8;Barcelona;41;Vallès Oriental;08259;Santa Maria de Palautordera;1;2;A;;870;204;435;564;306;0;2;562;564
8;Barcelona;41;Vallès Oriental;08259;Santa Maria de Palautordera;1;2;B;;1057;255;551;692;365;2;2;688;690
8;Barcelona;41;Vallès Oriental;08259;Santa Maria de Palautordera;1;3;A;;393;95;192;257;136;0;2;255;257
8;Barcelona;41;Vallès Oriental;08259;Santa Maria de Palautordera;1;3;B;;984;224;458;631;353;0;4;627;631
8;Barcelona;11;Baix Llobregat;08196;Sant Andreu de la Barca;1;1;A;;929;189;336;475;454;2;6;467;473
8;Barcelona;11;Baix Llobregat;08196;Sant Andreu de la Barca;1;1;B;;1004;203;353;497;507;1;4;492;496
8;Barcelona;11;Baix Llobregat;08196;Sant Andreu de la Barca;1;1;C;;1013;204;359;487;526;1;6;480;486
8;Barcelona;11;Baix Llobregat;08196;Sant Andreu de la Barca;1;2;A;;848;148;285;387;461;2;1;384;385
8;Barcelona;11;Baix Llobregat;08196;Sant Andreu de la Barca;1;2;B;;937;158;321;423;514;0;4;419;423
8;Barcelona;11;Baix Llobregat;08196;Sant Andreu de la Barca;1;2;C;;943;192;308;438;505;0;3;435;438
8;Barcelona;11;Baix Llobregat;08196;Sant Andreu de la Barca;1;3;A;;636;147;246;324;312;0;0;324;324
8;Barcelona;11;Baix Llobregat;08196;Sant Andreu de la Barca;1;3;B;;836;180;343;425;411;0;0;425;425
8;Barcelona;11;Baix Llobregat;08196;Sant Andreu de la Barca;1;3;C;;692;117;244;317;375;0;3;314;317
8;Barcelona;11;Baix Llobregat;08196;Sant Andreu de la Barca;1;4;A;;613;144;257;358;255;2;3;353;356
8;Barcelona;11;Baix Llobregat;08196;Sant Andreu de la Barca;1;4;B;;805;172;311;428;377;0;0;428;428
8;Barcelona;11;Baix Llobregat;08196;Sant Andreu de la Barca;1;5;A;;800;138;305;406;394;0;1;405;406
8;Barcelona;11;Baix Llobregat;08196;Sant Andreu de la Barca;1;5;B;;1028;170;382;539;489;0;7;532;539
8;Barcelona;11;Baix Llobregat;08196;Sant Andreu de la Barca;1;5;C;;966;192;368;493;473;1;2;490;492
8;Barcelona;11;Baix Llobregat;08196;Sant Andreu de la Barca;1;6;A;;729;138;284;393;336;1;3;389;392
8;Barcelona;11;Baix Llobregat;08196;Sant Andreu de la Barca;1;6;B;;976;180;348;482;494;0;2;480;482
8;Barcelona;11;Baix Llobregat;08196;Sant Andreu de la Barca;1;6;C;;915;158;327;456;459;2;1;453;454
8;Barcelona;11;Baix Llobregat;08196;Sant Andreu de la Barca;1;7;A;;720;119;272;376;344;0;1;375;376
8;Barcelona;11;Baix Llobregat;08196;Sant Andreu de la Barca;1;7;B;;807;162;321;453;354;1;6;446;452
8;Barcelona;11;Baix Llobregat;08196;Sant Andreu de la Barca;1;8;U;;1021;140;340;537;484;0;1;536;537
8;Barcelona;21;Maresme;08197;Sant Andreu de Llavaneres;1;1;A;;564;144;294;385;179;1;3;381;384
8;Barcelona;21;Maresme;08197;Sant Andreu de Llavaneres;1;1;B;;501;126;245;316;185;0;3;313;316
8;Barcelona;21;Maresme;08197;Sant Andreu de Llavaneres;1;2;A;;589;150;301;398;191;0;2;396;398
8;Barcelona;21;Maresme;08197;Sant Andreu de Llavaneres;1;2;B;;539;139;275;366;173;1;11;354;365
8;Barcelona;21;Maresme;08197;Sant Andreu de Llavaneres;1;3;A;;634;165;336;414;220;0;1;413;414
8;Barcelona;21;Maresme;08197;Sant Andreu de Llavaneres;1;3;B;;612;155;297;393;219;1;8;384;392
8;Barcelona;21;Maresme;08197;Sant Andreu de Llavaneres;2;1;A;;1057;253;534;672;385;1;6;665;671
8;Barcelona;21;Maresme;08197;Sant Andreu de Llavaneres;2;1;B;;961;260;488;601;360;0;3;598;601
17;Girona;20;Gironès;17157;Sant Andreu Salou;1;1;U;;112;40;70;92;20;0;1;91;92
17;Girona;19;Garrotxa;17183;Sant Aniol de Finestres;1;1;U;;239;67;137;176;63;1;2;173;175
8;Barcelona;41;Vallès Oriental;08198;Sant Antoni de Vilamajor;1;1;A;;729;191;393;499;230;1;2;496;498
8;Barcelona;41;Vallès Oriental;08198;Sant Antoni de Vilamajor;1;1;B;;805;200;390;535;270;3;5;527;532
8;Barcelona;41;Vallès Oriental;08198;Sant Antoni de Vilamajor;1;2;A;;580;143;267;320;260;3;1;316;317
8;Barcelona;41;Vallès Oriental;08198;Sant Antoni de Vilamajor;1;2;B;;537;156;278;323;214;1;3;319;322
43;Tarragona;12;Baix Penedès;43140;Santa Oliva;1;1;A;;623;160;298;351;272;2;3;346;349
43;Tarragona;12;Baix Penedès;43140;Santa Oliva;1;1;B;;677;151;292;362;315;2;3;357;360
43;Tarragona;12;Baix Penedès;43140;Santa Oliva;1;1;C;;359;100;173;211;148;0;1;210;211
17;Girona;19;Garrotxa;17184;Santa Pau;1;1;A;;607;181;325;402;205;5;0;397;397
17;Girona;19;Garrotxa;17184;Santa Pau;1;1;B;;639;186;341;407;232;1;2;404;406
8;Barcelona;40;Vallès Occidental;08260;Santa Perpètua de Mogoda;1;1;U;;1201;256;492;653;548;2;4;647;651
8;Barcelona;40;Vallès Occidental;08260;Santa Perpètua de Mogoda;1;10;U;;717;165;344;449;268;1;4;444;448
8;Barcelona;40;Vallès Occidental;08260;Santa Perpètua de Mogoda;1;11;U;;919;228;388;485;434;6;6;473;479
8;Barcelona;40;Vallès Occidental;08260;Santa Perpètua de Mogoda;1;12;U;;1090;193;388;569;521;0;5;564;569
8;Barcelona;40;Vallès Occidental;08260;Santa Perpètua de Mogoda;1;2;A;;1091;190;380;544;547;4;0;540;540
8;Barcelona;40;Vallès Occidental;08260;Santa Perpètua de Mogoda;1;2;B;;934;180;354;469;465;0;2;467;469
8;Barcelona;40;Vallès Occidental;08260;Santa Perpètua de Mogoda;1;3;A;;868;175;385;517;351;0;4;513;517
8;Barcelona;40;Vallès Occidental;08260;Santa Perpètua de Mogoda;1;3;B;;741;166;337;466;275;2;6;458;464
8;Barcelona;40;Vallès Occidental;08260;Santa Perpètua de Mogoda;1;4;A;;949;158;324;414;535;0;4;410;414
8;Barcelona;40;Vallès Occidental;08260;Santa Perpètua de Mogoda;1;4;B;;715;121;238;295;420;1;2;292;294
8;Barcelona;40;Vallès Occidental;08260;Santa Perpètua de Mogoda;1;5;U;;1012;240;349;478;534;0;4;474;478
8;Barcelona;40;Vallès Occidental;08260;Santa Perpètua de Mogoda;1;6;U;;970;217;380;493;477;0;3;490;493
8;Barcelona;40;Vallès Occidental;08260;Santa Perpètua de Mogoda;1;7;U;;1019;236;421;542;477;0;0;542;542
8;Barcelona;40;Vallès Occidental;08260;Santa Perpètua de Mogoda;1;8;U;;1220;236;488;625;595;1;3;621;624
8;Barcelona;40;Vallès Occidental;08260;Santa Perpètua de Mogoda;1;9;A;;1040;181;373;539;501;1;4;534;538
8;Barcelona;40;Vallès Occidental;08260;Santa Perpètua de Mogoda;1;9;B;;932;153;317;461;471;0;8;453;461
8;Barcelona;21;Maresme;08261;Santa Susanna;1;1;A;;675;179;363;441;234;0;3;438;441
8;Barcelona;21;Maresme;08261;Santa Susanna;1;1;B;;727;173;343;454;273;0;3;451;454
8;Barcelona;24;Osona;08199;Sant Bartomeu del Grau;1;1;U;;797;135;370;495;302;0;5;490;495
8;Barcelona;11;Baix Llobregat;08200;Sant Boi de Llobregat;1;1;A;;439;113;200;241;198;0;1;240;241
8;Barcelona;11;Baix Llobregat;08200;Sant Boi de Llobregat;1;1;B;;499;123;225;276;223;0;3;273;276
8;Barcelona;11;Baix Llobregat;08200;Sant Boi de Llobregat;1;2;A;;703;193;323;416;287;0;3;413;416
8;Barcelona;11;Baix Llobregat;08200;Sant Boi de Llobregat;1;2;B;;753;181;335;412;341;1;3;408;411
8;Barcelona;11;Baix Llobregat;08200;Sant Boi de Llobregat;1;3;A;;469;131;228;299;170;3;3;293;296
8;Barcelona;11;Baix Llobregat;08200;Sant Boi de Llobregat;1;3;B;;608;160;290;360;248;0;8;352;360
8;Barcelona;11;Baix Llobregat;08200;Sant Boi de Llobregat;1;4;A;;588;131;254;321;267;1;0;320;320
8;Barcelona;11;Baix Llobregat;08200;Sant Boi de Llobregat;1;4;B;;734;155;302;377;357;1;1;375;376
8;Barcelona;11;Baix Llobregat;08200;Sant Boi de Llobregat;1;5;A;;767;96;181;245;522;0;5;240;245
8;Barcelona;11;Baix Llobregat;08200;Sant Boi de Llobregat;1;5;B;;841;110;225;306;535;1;5;300;305
8;Barcelona;11;Baix Llobregat;08200;Sant Boi de Llobregat;1;6;A;;377;105;181;222;155;1;0;221;221
8;Barcelona;11;Baix Llobregat;08200;Sant Boi de Llobregat;1;6;B;;575;164;264;314;261;2;2;310;312
8;Barcelona;11;Baix Llobregat;08200;Sant Boi de Llobregat;1;7;A;;522;120;233;301;221;2;1;298;299
8;Barcelona;11;Baix Llobregat;08200;Sant Boi de Llobregat;1;7;B;;621;149;305;400;221;1;5;394;399
8;Barcelona;11;Baix Llobregat;08200;Sant Boi de Llobregat;2;1;A;;715;141;301;422;293;0;6;416;422
8;Barcelona;11;Baix Llobregat;08200;Sant Boi de Llobregat;2;1;B;;806;169;331;433;373;0;0;433;433
8;Barcelona;11;Baix Llobregat;08200;Sant Boi de Llobregat;2;10;A;;792;164;321;445;347;0;5;440;445
8;Barcelona;11;Baix Llobregat;08200;Sant Boi de Llobregat;2;10;B;;961;196;381;537;424;1;0;536;536
8;Barcelona;11;Baix Llobregat;08200;Sant Boi de Llobregat;2;11;A;;639;104;236;338;301;0;4;334;338
8;Barcelona;11;Baix Llobregat;08200;Sant Boi de Llobregat;2;11;B;;741;129;294;414;327;0;5;409;414
8;Barcelona;11;Baix Llobregat;08200;Sant Boi de Llobregat;2;12;A;;562;89;208;292;270;0;2;290;292
8;Barcelona;11;Baix Llobregat;08200;Sant Boi de Llobregat;2;12;B;;769;129;273;376;393;1;2;373;375
8;Barcelona;11;Baix Llobregat;08200;Sant Boi de Llobregat;2;12;C;;620;118;227;319;301;1;2;316;318
8;Barcelona;11;Baix Llobregat;08200;Sant Boi de Llobregat;2;13;A;;627;131;297;395;232;0;6;389;395
8;Barcelona;11;Baix Llobregat;08200;Sant Boi de Llobregat;2;13;B;;602;139;275;385;217;1;6;378;384
8;Barcelona;11;Baix Llobregat;08200;Sant Boi de Llobregat;2;13;C;;698;141;257;423;275;0;4;419;423
8;Barcelona;11;Baix Llobregat;08200;Sant Boi de Llobregat;2;14;A;;713;124;247;360;353;2;5;353;358
8;Barcelona;11;Baix Llobregat;08200;Sant Boi de Llobregat;2;14;B;;854;141;267;400;454;0;5;395;400
8;Barcelona;11;Baix Llobregat;08200;Sant Boi de Llobregat;2;15;A;;820;111;235;329;491;0;3;326;329
8;Barcelona;11;Baix Llobregat;08200;Sant Boi de Llobregat;2;15;B;;917;148;297;397;520;2;1;394;395
8;Barcelona;11;Baix Llobregat;08200;Sant Boi de Llobregat;2;16;U;;765;169;324;455;310;0;2;453;455
8;Barcelona;11;Baix Llobregat;08200;Sant Boi de Llobregat;2;17;U;;933;195;421;563;370;0;3;560;563
8;Barcelona;11;Baix Llobregat;08200;Sant Boi de Llobregat;2;2;A;;745;176;299;384;361;0;5;379;384
8;Barcelona;11;Baix Llobregat;08200;Sant Boi de Llobregat;2;2;B;;823;173;309;403;420;0;3;400;403
8;Barcelona;11;Baix Llobregat;08200;Sant Boi de Llobregat;2;3;A;;693;157;265;351;342;0;3;348;351
8;Barcelona;11;Baix Llobregat;08200;Sant Boi de Llobregat;2;3;B;;907;183;328;430;477;0;2;428;430
8;Barcelona;11;Baix Llobregat;08200;Sant Boi de Llobregat;2;4;A;;509;93;194;270;239;0;2;268;270
8;Barcelona;11;Baix Llobregat;08200;Sant Boi de Llobregat;2;4;B;;523;99;206;273;250;1;2;270;272
8;Barcelona;11;Baix Llobregat;08200;Sant Boi de Llobregat;2;5;A;;533;113;198;266;267;0;1;265;266
8;Barcelona;11;Baix Llobregat;08200;Sant Boi de Llobregat;2;5;B;;613;132;251;321;292;0;1;320;321
8;Barcelona;11;Baix Llobregat;08200;Sant Boi de Llobregat;2;6;A;;578;105;213;286;292;0;1;285;286
8;Barcelona;11;Baix Llobregat;08200;Sant Boi de Llobregat;2;6;B;;643;109;204;308;335;0;0;308;308
8;Barcelona;11;Baix Llobregat;08200;Sant Boi de Llobregat;2;6;C;;749;147;290;384;365;1;4;379;383
8;Barcelona;11;Baix Llobregat;08200;Sant Boi de Llobregat;2;7;A;;451;103;165;230;221;1;1;228;229
8;Barcelona;11;Baix Llobregat;08200;Sant Boi de Llobregat;2;7;B;;536;135;216;281;255;0;0;281;281
8;Barcelona;11;Baix Llobregat;08200;Sant Boi de Llobregat;2;8;A;;585;120;250;332;253;0;4;328;332
8;Barcelona;11;Baix Llobregat;08200;Sant Boi de Llobregat;2;8;B;;674;150;281;385;289;1;1;383;384
8;Barcelona;11;Baix Llobregat;08200;Sant Boi de Llobregat;2;9;A;;703;141;258;353;350;1;2;350;352
8;Barcelona;11;Baix Llobregat;08200;Sant Boi de Llobregat;2;9;B;;723;153;283;370;353;0;7;363;370
8;Barcelona;11;Baix Llobregat;08200;Sant Boi de Llobregat;3;1;A;;593;144;282;340;253;0;2;338;340
8;Barcelona;11;Baix Llobregat;08200;Sant Boi de Llobregat;3;1;B;;607;151;278;355;252;1;1;353;354
8;Barcelona;11;Baix Llobregat;08200;Sant Boi de Llobregat;3;2;A;;700;151;291;381;319;1;4;376;380
8;Barcelona;11;Baix Llobregat;08200;Sant Boi de Llobregat;3;2;B;;872;177;333;448;424;0;5;443;448
8;Barcelona;11;Baix Llobregat;08200;Sant Boi de Llobregat;3;3;A;;790;163;332;429;361;0;2;427;429
8;Barcelona;11;Baix Llobregat;08200;Sant Boi de Llobregat;3;3;B;;962;189;391;532;430;0;4;528;532
8;Barcelona;11;Baix Llobregat;08200;Sant Boi de Llobregat;3;4;U;;665;165;309;386;279;3;4;379;383
8;Barcelona;11;Baix Llobregat;08200;Sant Boi de Llobregat;3;5;A;;792;181;317;398;394;0;2;396;398
8;Barcelona;11;Baix Llobregat;08200;Sant Boi de Llobregat;3;5;B;;979;228;382;523;456;3;8;512;520
8;Barcelona;11;Baix Llobregat;08200;Sant Boi de Llobregat;3;6;A;;517;152;255;297;220;2;3;292;295
8;Barcelona;11;Baix Llobregat;08200;Sant Boi de Llobregat;3;6;B;;603;143;288;376;227;2;0;374;374
8;Barcelona;11;Baix Llobregat;08200;Sant Boi de Llobregat;3;7;A;;789;171;346;444;345;1;1;442;443
8;Barcelona;11;Baix Llobregat;08200;Sant Boi de Llobregat;3;7;B;;930;192;406;519;411;0;6;513;519
8;Barcelona;11;Baix Llobregat;08200;Sant Boi de Llobregat;3;8;U;;610;152;293;352;258;0;3;349;352
8;Barcelona;11;Baix Llobregat;08200;Sant Boi de Llobregat;3;9;A;;483;137;213;270;213;2;2;266;268
8;Barcelona;11;Baix Llobregat;08200;Sant Boi de Llobregat;3;9;B;;607;176;289;360;247;0;2;358;360
8;Barcelona;11;Baix Llobregat;08200;Sant Boi de Llobregat;4;1;A;;720;123;275;390;330;0;4;386;390
8;Barcelona;11;Baix Llobregat;08200;Sant Boi de Llobregat;4;1;B;;944;189;404;517;427;0;7;510;517
8;Barcelona;11;Baix Llobregat;08200;Sant Boi de Llobregat;4;2;A;;804;188;343;461;343;0;4;457;461
8;Barcelona;11;Baix Llobregat;08200;Sant Boi de Llobregat;4;2;B;;925;194;382;511;414;0;4;507;511
8;Barcelona;11;Baix Llobregat;08200;Sant Boi de Llobregat;4;3;A;;488;88;200;264;224;0;6;258;264
8;Barcelona;11;Baix Llobregat;08200;Sant Boi de Llobregat;4;3;B;;578;99;217;323;255;0;2;321;323
8;Barcelona;11;Baix Llobregat;08200;Sant Boi de Llobregat;4;4;A;;483;127;231;272;211;0;0;272;272
8;Barcelona;11;Baix Llobregat;08200;Sant Boi de Llobregat;4;4;B;;651;137;270;358;293;1;5;352;357
8;Barcelona;11;Baix Llobregat;08200;Sant Boi de Llobregat;4;5;A;;669;129;265;353;316;0;3;350;353
8;Barcelona;11;Baix Llobregat;08200;Sant Boi de Llobregat;4;5;B;;821;143;315;414;407;1;3;410;413
8;Barcelona;11;Baix Llobregat;08200;Sant Boi de Llobregat;4;6;A;;830;163;310;393;437;1;4;388;392
8;Barcelona;11;Baix Llobregat;08200;Sant Boi de Llobregat;4;6;B;;1000;190;366;487;513;2;7;478;485
8;Barcelona;11;Baix Llobregat;08200;Sant Boi de Llobregat;4;7;A;;676;171;301;379;297;2;4;373;377
8;Barcelona;11;Baix Llobregat;08200;Sant Boi de Llobregat;4;7;B;;758;151;305;413;345;1;1;411;412
8;Barcelona;11;Baix Llobregat;08200;Sant Boi de Llobregat;4;8;A;;773;157;299;398;375;0;2;396;398
8;Barcelona;11;Baix Llobregat;08200;Sant Boi de Llobregat;4;8;B;;881;166;323;471;410;0;3;468;471
8;Barcelona;11;Baix Llobregat;08200;Sant Boi de Llobregat;4;9;A;;459;67;167;238;221;0;0;238;238
8;Barcelona;11;Baix Llobregat;08200;Sant Boi de Llobregat;4;9;B;;524;93;197;276;248;0;3;273;276
8;Barcelona;11;Baix Llobregat;08200;Sant Boi de Llobregat;5;1;A;;712;153;257;343;369;1;2;340;342
8;Barcelona;11;Baix Llobregat;08200;Sant Boi de Llobregat;5;1;B;;899;197;342;449;450;6;4;439;443
8;Barcelona;11;Baix Llobregat;08200;Sant Boi de Llobregat;5;2;A;;541;88;172;227;314;0;3;224;227
8;Barcelona;11;Baix Llobregat;08200;Sant Boi de Llobregat;5;2;B;;583;131;226;297;286;0;1;296;297
8;Barcelona;11;Baix Llobregat;08200;Sant Boi de Llobregat;5;3;U;;643;128;226;298;345;0;0;298;298
8;Barcelona;11;Baix Llobregat;08200;Sant Boi de Llobregat;5;4;A;;411;93;167;212;199;0;1;211;212
8;Barcelona;11;Baix Llobregat;08200;Sant Boi de Llobregat;5;4;B;;480;120;221;275;205;1;0;274;274
8;Barcelona;11;Baix Llobregat;08200;Sant Boi de Llobregat;6;1;A;;652;121;245;334;318;0;3;331;334
8;Barcelona;11;Baix Llobregat;08200;Sant Boi de Llobregat;6;1;B;;868;153;332;455;413;0;7;448;455
8;Barcelona;11;Baix Llobregat;08200;Sant Boi de Llobregat;6;2;A;;718;159;303;396;322;0;3;393;396
8;Barcelona;11;Baix Llobregat;08200;Sant Boi de Llobregat;6;2;B;;966;189;360;475;491;1;7;467;474
8;Barcelona;11;Baix Llobregat;08200;Sant Boi de Llobregat;6;3;A;;543;124;216;295;248;0;4;291;295
8;Barcelona;11;Baix Llobregat;08200;Sant Boi de Llobregat;6;3;B;;593;129;226;293;300;2;2;289;291
8;Barcelona;24;Osona;08201;Sant Boi de Lluçanès;1;1;U;;480;106;245;339;141;0;4;335;339
43;Tarragona;22;Montsià;43136;Sant Carles de la Ràpita;1;1;A;;582;149;242;302;280;0;0;302;302
43;Tarragona;22;Montsià;43136;Sant Carles de la Ràpita;1;1;B;;703;155;293;377;326;0;8;369;377
43;Tarragona;22;Montsià;43136;Sant Carles de la Ràpita;1;2;U;;839;147;340;436;403;0;11;425;436
43;Tarragona;22;Montsià;43136;Sant Carles de la Ràpita;1;3;A;;554;150;235;304;250;0;2;302;304
43;Tarragona;22;Montsià;43136;Sant Carles de la Ràpita;1;3;B;;540;140;247;308;232;1;3;304;307
43;Tarragona;22;Montsià;43136;Sant Carles de la Ràpita;1;4;A;;616;157;272;353;263;0;3;350;353
43;Tarragona;22;Montsià;43136;Sant Carles de la Ràpita;1;4;B;;662;135;255;349;313;0;5;344;349
43;Tarragona;22;Montsià;43136;Sant Carles de la Ràpita;1;5;U;;820;158;317;425;395;1;6;418;424
43;Tarragona;22;Montsià;43136;Sant Carles de la Ràpita;2;1;U;;729;177;306;423;306;0;4;419;423
43;Tarragona;22;Montsià;43136;Sant Carles de la Ràpita;2;2;U;;727;211;347;431;296;1;1;429;430
43;Tarragona;22;Montsià;43136;Sant Carles de la Ràpita;2;3;U;;865;224;396;483;382;2;11;470;481
43;Tarragona;22;Montsià;43136;Sant Carles de la Ràpita;2;4;A;;744;148;324;434;310;0;9;425;434
43;Tarragona;22;Montsià;43136;Sant Carles de la Ràpita;2;4;B;;744;153;300;408;336;0;3;405;408
8;Barcelona;21;Maresme;08203;Sant Cebrià de Vallalta;1;1;U;;1315;359;668;858;457;1;5;852;857
8;Barcelona;41;Vallès Oriental;08202;Sant Celoni;1;1;A;;688;230;369;480;208;3;3;474;477
8;Barcelona;41;Vallès Oriental;08202;Sant Celoni;1;1;B;;500;134;273;333;167;2;0;331;331
8;Barcelona;41;Vallès Oriental;08202;Sant Celoni;1;1;C;;399;93;207;265;134;0;1;264;265
8;Barcelona;41;Vallès Oriental;08202;Sant Celoni;1;2;A;;655;180;360;460;195;1;3;456;459
8;Barcelona;41;Vallès Oriental;08202;Sant Celoni;1;2;B;;832;230;460;585;247;0;6;579;585
8;Barcelona;41;Vallès Oriental;08202;Sant Celoni;1;3;A;;636;196;339;426;210;1;1;424;425
8;Barcelona;41;Vallès Oriental;08202;Sant Celoni;1;3;B;;926;243;473;594;332;2;8;584;592
8;Barcelona;41;Vallès Oriental;08202;Sant Celoni;1;4;A;;621;165;295;377;244;0;2;375;377
8;Barcelona;41;Vallès Oriental;08202;Sant Celoni;1;4;B;;773;210;367;448;325;0;7;441;448
8;Barcelona;41;Vallès Oriental;08202;Sant Celoni;1;5;A;;654;166;312;425;229;1;4;420;424
8;Barcelona;41;Vallès Oriental;08202;Sant Celoni;1;5;B;;828;212;398;532;296;2;2;528;530
8;Barcelona;41;Vallès Oriental;08202;Sant Celoni;1;6;A;;641;144;301;419;222;1;3;415;418
8;Barcelona;41;Vallès Oriental;08202;Sant Celoni;1;6;B;;866;192;399;512;354;0;4;508;512
8;Barcelona;41;Vallès Oriental;08202;Sant Celoni;1;7;A;;320;89;165;217;103;1;0;216;216
8;Barcelona;41;Vallès Oriental;08202;Sant Celoni;1;7;B;;402;121;210;270;132;0;0;270;270
8;Barcelona;41;Vallès Oriental;08202;Sant Celoni;2;1;A;;399;99;216;267;132;0;2;265;267
8;Barcelona;41;Vallès Oriental;08202;Sant Celoni;2;1;B;;432;119;179;227;205;0;4;223;227
8;Barcelona;11;Baix Llobregat;08204;Sant Climent de Llobregat;1;1;A;;566;140;269;365;201;0;1;364;365
8;Barcelona;11;Baix Llobregat;08204;Sant Climent de Llobregat;1;1;B;;591;143;278;370;221;1;4;365;369
8;Barcelona;11;Baix Llobregat;08204;Sant Climent de Llobregat;1;1;C;;713;166;349;464;249;3;3;458;461
8;Barcelona;11;Baix Llobregat;08204;Sant Climent de Llobregat;1;1;D;;569;149;283;373;196;3;1;369;370
17;Girona;2;Alt Empordà;17158;Sant Climent Sescebes;1;1;U;;373;126;234;279;94;1;2;276;278
8;Barcelona;40;Vallès Occidental;08205;Sant Cugat del Vallès;1;1;A;;786;184;366;480;306;2;5;473;478
8;Barcelona;40;Vallès Occidental;08205;Sant Cugat del Vallès;1;1;B;;818;179;374;469;349;1;4;464;468
8;Barcelona;40;Vallès Occidental;08205;Sant Cugat del Vallès;1;10;U;;1100;229;407;584;516;0;10;574;584
8;Barcelona;40;Vallès Occidental;08205;Sant Cugat del Vallès;1;11;A;;867;225;450;582;285;1;10;571;581
8;Barcelona;40;Vallès Occidental;08205;Sant Cugat del Vallès;1;11;B;;998;243;491;631;367;0;6;625;631
8;Barcelona;40;Vallès Occidental;08205;Sant Cugat del Vallès;1;12;A;;790;192;400;525;265;0;7;518;525
8;Barcelona;40;Vallès Occidental;08205;Sant Cugat del Vallès;1;12;B;;840;187;420;565;275;0;7;558;565
8;Barcelona;40;Vallès Occidental;08205;Sant Cugat del Vallès;1;2;A;;573;139;270;365;208;1;4;360;364
8;Barcelona;40;Vallès Occidental;08205;Sant Cugat del Vallès;1;2;B;;571;134;264;336;235;2;2;332;334
8;Barcelona;40;Vallès Occidental;08205;Sant Cugat del Vallès;1;3;A;;835;176;378;514;321;1;6;507;513
8;Barcelona;40;Vallès Occidental;08205;Sant Cugat del Vallès;1;3;B;;883;194;427;563;320;1;6;556;562
8;Barcelona;40;Vallès Occidental;08205;Sant Cugat del Vallès;1;4;A;;691;183;374;485;206;1;8;476;484
8;Barcelona;40;Vallès Occidental;08205;Sant Cugat del Vallès;1;4;B;;764;199;373;520;244;1;8;511;519
8;Barcelona;40;Vallès Occidental;08205;Sant Cugat del Vallès;1;5;A;;1321;272;659;897;424;2;13;882;895
8;Barcelona;40;Vallès Occidental;08205;Sant Cugat del Vallès;1;5;B;;1439;305;746;976;463;0;5;971;976
8;Barcelona;40;Vallès Occidental;08205;Sant Cugat del Vallès;1;6;A;;588;133;245;330;258;4;5;321;326
8;Barcelona;40;Vallès Occidental;08205;Sant Cugat del Vallès;1;6;B;;722;149;318;453;269;0;7;446;453
8;Barcelona;40;Vallès Occidental;08205;Sant Cugat del Vallès;1;6;C;;680;167;310;418;262;0;5;413;418
8;Barcelona;40;Vallès Occidental;08205;Sant Cugat del Vallès;1;7;A;;714;194;366;456;258;0;2;454;456
8;Barcelona;40;Vallès Occidental;08205;Sant Cugat del Vallès;1;7;B;;859;208;361;498;361;0;4;494;498
8;Barcelona;40;Vallès Occidental;08205;Sant Cugat del Vallès;1;8;A;;747;187;357;450;297;1;2;447;449
8;Barcelona;40;Vallès Occidental;08205;Sant Cugat del Vallès;1;8;B;;894;247;447;554;340;0;6;548;554
8;Barcelona;40;Vallès Occidental;08205;Sant Cugat del Vallès;1;9;A;;628;161;351;472;156;2;13;457;470
8;Barcelona;40;Vallès Occidental;08205;Sant Cugat del Vallès;1;9;B;;672;147;313;481;191;1;2;478;480
8;Barcelona;40;Vallès Occidental;08205;Sant Cugat del Vallès;2;1;A;;824;201;469;583;241;1;5;577;582
8;Barcelona;40;Vallès Occidental;08205;Sant Cugat del Vallès;2;1;B;;902;230;493;649;253;0;6;643;649
8;Barcelona;40;Vallès Occidental;08205;Sant Cugat del Vallès;2;2;A;;712;194;369;471;241;0;16;455;471
8;Barcelona;40;Vallès Occidental;08205;Sant Cugat del Vallès;2;2;B;;717;185;388;481;236;2;12;467;479
8;Barcelona;40;Vallès Occidental;08205;Sant Cugat del Vallès;2;3;A;;455;111;211;259;196;1;8;250;258
8;Barcelona;40;Vallès Occidental;08205;Sant Cugat del Vallès;2;3;B;;535;130;272;331;204;0;4;327;331
8;Barcelona;40;Vallès Occidental;08205;Sant Cugat del Vallès;2;4;A;;547;116;257;342;205;1;7;334;341
8;Barcelona;40;Vallès Occidental;08205;Sant Cugat del Vallès;2;4;B;;609;142;311;421;188;1;9;411;420
8;Barcelona;40;Vallès Occidental;08205;Sant Cugat del Vallès;2;5;A;;554;126;258;339;215;0;7;332;339
8;Barcelona;40;Vallès Occidental;08205;Sant Cugat del Vallès;2;5;B;;548;129;263;329;219;4;1;324;325
8;Barcelona;40;Vallès Occidental;08205;Sant Cugat del Vallès;2;6;A;;569;104;298;387;182;0;7;380;387
8;Barcelona;40;Vallès Occidental;08205;Sant Cugat del Vallès;2;6;B;;585;136;315;419;166;0;10;409;419
8;Barcelona;40;Vallès Occidental;08205;Sant Cugat del Vallès;2;6;C;;509;117;268;350;159;0;5;345;350
8;Barcelona;40;Vallès Occidental;08205;Sant Cugat del Vallès;2;7;A;;605;148;319;406;199;1;3;402;405
8;Barcelona;40;Vallès Occidental;08205;Sant Cugat del Vallès;2;7;B;;658;168;321;399;259;0;3;396;399
8;Barcelona;40;Vallès Occidental;08205;Sant Cugat del Vallès;2;8;A;;1009;242;600;758;251;1;12;745;757
8;Barcelona;40;Vallès Occidental;08205;Sant Cugat del Vallès;2;8;B;;945;230;525;687;258;0;16;671;687
8;Barcelona;40;Vallès Occidental;08205;Sant Cugat del Vallès;2;8;C;;993;252;568;744;249;0;9;735;744
8;Barcelona;40;Vallès Occidental;08205;Sant Cugat del Vallès;3;1;U;;987;213;489;640;347;1;9;630;639
8;Barcelona;40;Vallès Occidental;08205;Sant Cugat del Vallès;3;2;A;;584;155;317;405;179;1;5;399;404
8;Barcelona;40;Vallès Occidental;08205;Sant Cugat del Vallès;3;2;B;;689;166;374;475;214;1;12;462;474
8;Barcelona;40;Vallès Occidental;08205;Sant Cugat del Vallès;3;3;U;;1025;225;494;629;396;4;2;623;625
8;Barcelona;40;Vallès Occidental;08205;Sant Cugat del Vallès;3;4;U;;1168;292;584;735;433;1;9;725;734
8;Barcelona;40;Vallès Occidental;08205;Sant Cugat del Vallès;4;1;U;;942;225;440;533;409;0;4;529;533
8;Barcelona;40;Vallès Occidental;08205;Sant Cugat del Vallès;4;2;U;;868;187;340;421;447;0;7;414;421
8;Barcelona;40;Vallès Occidental;08205;Sant Cugat del Vallès;4;3;U;;1014;245;446;542;472;6;4;532;536
8;Barcelona;40;Vallès Occidental;08205;Sant Cugat del Vallès;5;1;A;;1065;278;594;739;326;0;9;730;739
8;Barcelona;40;Vallès Occidental;08205;Sant Cugat del Vallès;5;1;B;;1186;270;710;856;330;4;7;845;852
8;Barcelona;40;Vallès Occidental;08205;Sant Cugat del Vallès;5;2;A;;806;199;372;482;324;0;4;478;482
8;Barcelona;40;Vallès Occidental;08205;Sant Cugat del Vallès;5;2;B;;955;245;428;574;381;1;3;570;573
8;Barcelona;40;Vallès Occidental;08205;Sant Cugat del Vallès;6;1;U;;849;129;300;377;472;4;2;371;373
8;Barcelona;3;Alt Penedès;08206;Sant Cugat Sesgarrigues;1;1;U;;602;183;353;458;144;1;3;454;457
25;Lleida;25;Pallars Jussà;25196;Sant Esteve de la Sarga;1;1;U;;116;52;52;74;42;0;1;73;74
8;Barcelona;41;Vallès Oriental;08207;Sant Esteve de Palautordera;1;1;U;;1112;312;637;806;306;0;10;796;806
8;Barcelona;11;Baix Llobregat;08208;Sant Esteve Sesrovires;1;1;A;;940;196;390;509;431;0;1;508;509
8;Barcelona;11;Baix Llobregat;08208;Sant Esteve Sesrovires;1;1;B;;992;212;468;595;397;0;6;589;595
8;Barcelona;11;Baix Llobregat;08208;Sant Esteve Sesrovires;1;2;A;;864;217;400;537;327;0;3;534;537
8;Barcelona;11;Baix Llobregat;08208;Sant Esteve Sesrovires;1;2;B;;1003;261;478;643;360;0;4;639;643
17;Girona;34;Selva;17159;Sant Feliu de Buixalleu;1;1;U;;606;300;443;402;204;3;1;398;399
8;Barcelona;41;Vallès Oriental;08210;Sant Feliu de Codines;1;1;U;;841;201;382;527;314;1;6;520;526
8;Barcelona;41;Vallès Oriental;08210;Sant Feliu de Codines;1;2;U;;1012;209;460;626;386;6;7;613;620
8;Barcelona;41;Vallès Oriental;08210;Sant Feliu de Codines;2;1;U;;1001;236;445;616;385;0;3;613;616
8;Barcelona;41;Vallès Oriental;08210;Sant Feliu de Codines;2;2;U;;680;169;321;445;235;1;3;441;444
17;Girona;10;Baix Empordà;17160;Sant Feliu de Guíxols;1;1;A;;585;167;307;364;221;1;4;359;363
17;Girona;10;Baix Empordà;17160;Sant Feliu de Guíxols;1;1;B;;594;159;327;409;185;0;1;408;409
17;Girona;10;Baix Empordà;17160;Sant Feliu de Guíxols;1;2;A;;551;191;308;359;192;4;3;352;355
17;Girona;10;Baix Empordà;17160;Sant Feliu de Guíxols;1;2;B;;607;194;316;379;228;8;3;368;371
17;Girona;10;Baix Empordà;17160;Sant Feliu de Guíxols;2;1;A;;561;177;292;355;206;2;6;347;353
17;Girona;10;Baix Empordà;17160;Sant Feliu de Guíxols;2;1;B;;538;163;288;338;200;1;5;332;337
17;Girona;10;Baix Empordà;17160;Sant Feliu de Guíxols;2;2;A;;837;264;432;522;315;3;1;518;519
17;Girona;10;Baix Empordà;17160;Sant Feliu de Guíxols;2;2;B;;902;284;456;543;359;2;6;535;541
17;Girona;10;Baix Empordà;17160;Sant Feliu de Guíxols;2;3;A;;809;190;400;468;341;0;5;463;468
17;Girona;10;Baix Empordà;17160;Sant Feliu de Guíxols;2;3;B;;832;167;355;448;384;0;3;445;448
17;Girona;10;Baix Empordà;17160;Sant Feliu de Guíxols;2;4;A;;990;204;406;547;443;3;2;542;544
17;Girona;10;Baix Empordà;17160;Sant Feliu de Guíxols;2;4;B;;1073;224;418;566;507;0;1;565;566
17;Girona;10;Baix Empordà;17160;Sant Feliu de Guíxols;3;1;A;;881;255;464;558;323;0;3;555;558
17;Girona;10;Baix Empordà;17160;Sant Feliu de Guíxols;3;1;B;;924;245;456;550;374;3;7;540;547
17;Girona;10;Baix Empordà;17160;Sant Feliu de Guíxols;3;2;A;;500;112;248;287;213;0;0;287;287
17;Girona;10;Baix Empordà;17160;Sant Feliu de Guíxols;3;2;B;;544;137;271;321;223;0;1;320;321
17;Girona;10;Baix Empordà;17160;Sant Feliu de Guíxols;3;3;A;;522;127;256;306;216;0;0;306;306
17;Girona;10;Baix Empordà;17160;Sant Feliu de Guíxols;3;3;B;;543;124;242;319;224;1;6;312;318
17;Girona;10;Baix Empordà;17160;Sant Feliu de Guíxols;4;1;A;;927;262;483;580;347;3;5;572;577
17;Girona;10;Baix Empordà;17160;Sant Feliu de Guíxols;4;1;B;;838;203;414;519;319;4;0;515;515
8;Barcelona;11;Baix Llobregat;08211;Sant Feliu de Llobregat;1;1;A;;677;165;332;477;200;1;5;471;476
8;Barcelona;11;Baix Llobregat;08211;Sant Feliu de Llobregat;1;1;B;;671;186;355;479;192;2;2;475;477
8;Barcelona;11;Baix Llobregat;08211;Sant Feliu de Llobregat;1;2;A;;550;140;284;395;155;0;4;391;395
8;Barcelona;11;Baix Llobregat;08211;Sant Feliu de Llobregat;1;2;B;;621;153;342;446;175;0;7;439;446
8;Barcelona;11;Baix Llobregat;08211;Sant Feliu de Llobregat;1;3;A;;471;126;245;318;153;0;2;316;318
8;Barcelona;11;Baix Llobregat;08211;Sant Feliu de Llobregat;1;3;B;;556;139;290;385;171;1;3;381;384
8;Barcelona;11;Baix Llobregat;08211;Sant Feliu de Llobregat;1;4;A;;645;127;308;410;235;1;3;406;409
8;Barcelona;11;Baix Llobregat;08211;Sant Feliu de Llobregat;1;4;B;;746;125;351;481;265;0;4;477;481
8;Barcelona;11;Baix Llobregat;08211;Sant Feliu de Llobregat;2;1;A;;461;145;232;302;159;0;2;300;302
8;Barcelona;11;Baix Llobregat;08211;Sant Feliu de Llobregat;2;1;B;;563;150;283;362;201;0;1;361;362
8;Barcelona;11;Baix Llobregat;08211;Sant Feliu de Llobregat;2;2;U;;572;142;276;348;224;1;3;344;347
8;Barcelona;11;Baix Llobregat;08211;Sant Feliu de Llobregat;2;3;A;;579;110;253;344;235;2;1;341;342
8;Barcelona;11;Baix Llobregat;08211;Sant Feliu de Llobregat;2;3;B;;570;108;240;325;245;0;2;323;325
8;Barcelona;11;Baix Llobregat;08211;Sant Feliu de Llobregat;2;4;U;;695;175;316;410;285;0;3;407;410
8;Barcelona;11;Baix Llobregat;08211;Sant Feliu de Llobregat;2;5;U;;899;232;447;594;305;3;7;584;591
8;Barcelona;11;Baix Llobregat;08211;Sant Feliu de Llobregat;2;6;A;;944;206;394;557;387;0;5;552;557
8;Barcelona;11;Baix Llobregat;08211;Sant Feliu de Llobregat;2;6;B;;1129;217;452;652;477;3;5;644;649
8;Barcelona;11;Baix Llobregat;08211;Sant Feliu de Llobregat;2;7;A;;649;129;277;395;254;0;5;390;395
8;Barcelona;11;Baix Llobregat;08211;Sant Feliu de Llobregat;2;7;B;;698;132;279;389;309;0;4;385;389
8;Barcelona;11;Baix Llobregat;08211;Sant Feliu de Llobregat;3;1;A;;504;110;229;292;212;0;5;287;292
8;Barcelona;11;Baix Llobregat;08211;Sant Feliu de Llobregat;3;1;B;;605;133;280;358;247;0;6;352;358
8;Barcelona;11;Baix Llobregat;08211;Sant Feliu de Llobregat;3;1;C;;588;113;238;320;268;1;3;316;319
8;Barcelona;11;Baix Llobregat;08211;Sant Feliu de Llobregat;3;2;A;;302;74;134;180;122;0;0;180;180
8;Barcelona;11;Baix Llobregat;08211;Sant Feliu de Llobregat;3;2;B;;352;84;158;215;137;0;3;212;215
8;Barcelona;11;Baix Llobregat;08211;Sant Feliu de Llobregat;3;2;C;;411;116;194;241;170;0;1;240;241
8;Barcelona;11;Baix Llobregat;08211;Sant Feliu de Llobregat;3;3;A;;868;195;414;545;323;1;7;537;544
8;Barcelona;11;Baix Llobregat;08211;Sant Feliu de Llobregat;3;3;B;;992;249;488;658;334;4;5;649;654
8;Barcelona;11;Baix Llobregat;08211;Sant Feliu de Llobregat;3;4;A;;678;171;338;448;230;2;4;442;446
8;Barcelona;11;Baix Llobregat;08211;Sant Feliu de Llobregat;3;4;B;;800;183;376;532;268;5;5;522;527
8;Barcelona;11;Baix Llobregat;08211;Sant Feliu de Llobregat;3;5;A;;646;150;321;425;221;3;5;417;422
8;Barcelona;11;Baix Llobregat;08211;Sant Feliu de Llobregat;3;5;B;;801;198;386;488;313;0;2;486;488
8;Barcelona;11;Baix Llobregat;08211;Sant Feliu de Llobregat;4;1;U;;943;195;404;541;402;4;2;535;537
8;Barcelona;11;Baix Llobregat;08211;Sant Feliu de Llobregat;4;2;A;;440;107;198;255;185;0;2;253;255
8;Barcelona;11;Baix Llobregat;08211;Sant Feliu de Llobregat;4;2;B;;643;157;321;394;249;1;4;389;393
8;Barcelona;11;Baix Llobregat;08211;Sant Feliu de Llobregat;4;3;U;;954;171;364;492;462;1;2;489;491
8;Barcelona;11;Baix Llobregat;08211;Sant Feliu de Llobregat;4;4;A;;1139;206;455;666;473;0;12;654;666
8;Barcelona;11;Baix Llobregat;08211;Sant Feliu de Llobregat;4;4;B;;1304;260;560;775;529;3;8;764;772
8;Barcelona;11;Baix Llobregat;08211;Sant Feliu de Llobregat;4;5;U;;545;125;200;267;278;0;0;267;267
8;Barcelona;11;Baix Llobregat;08211;Sant Feliu de Llobregat;5;1;A;;511;89;171;243;268;0;2;241;243
8;Barcelona;11;Baix Llobregat;08211;Sant Feliu de Llobregat;5;1;B;;595;91;207;307;288;1;11;295;306
8;Barcelona;11;Baix Llobregat;08211;Sant Feliu de Llobregat;5;2;U;;920;124;281;433;487;0;5;428;433
8;Barcelona;11;Baix Llobregat;08211;Sant Feliu de Llobregat;6;1;A;;487;83;138;254;233;0;3;251;254
8;Barcelona;11;Baix Llobregat;08211;Sant Feliu de Llobregat;6;1;B;;681;128;234;339;342;1;5;333;338
8;Barcelona;11;Baix Llobregat;08211;Sant Feliu de Llobregat;6;1;C;;661;115;238;325;336;0;5;320;325
8;Barcelona;11;Baix Llobregat;08211;Sant Feliu de Llobregat;6;2;U;;870;166;353;493;377;0;5;488;493
8;Barcelona;11;Baix Llobregat;08211;Sant Feliu de Llobregat;6;3;U;;824;156;313;436;388;0;2;434;436
17;Girona;19;Garrotxa;17161;Sant Feliu de Pallerols;1;1;A;;470;167;304;347;123;2;2;343;345
17;Girona;19;Garrotxa;17161;Sant Feliu de Pallerols;1;1;B;;491;190;325;377;114;3;4;370;374
8;Barcelona;7;Bages;08212;Sant Feliu Sasserra;1;1;U;;533;143;315;418;115;1;3;414;417
17;Girona;19;Garrotxa;17162;Sant Ferriol;1;1;U;;163;45;74;85;78;0;0;85;85
8;Barcelona;41;Vallès Oriental;08209;Sant Fost de Campsentelles;1;1;A;;582;148;256;340;242;0;2;338;340
8;Barcelona;41;Vallès Oriental;08209;Sant Fost de Campsentelles;1;1;B;;703;163;308;395;308;3;2;390;392
8;Barcelona;41;Vallès Oriental;08209;Sant Fost de Campsentelles;1;2;A;;440;98;203;260;180;0;1;259;260
8;Barcelona;41;Vallès Oriental;08209;Sant Fost de Campsentelles;1;2;B;;656;160;316;393;263;2;1;390;391
8;Barcelona;41;Vallès Oriental;08209;Sant Fost de Campsentelles;1;3;A;;573;131;255;361;212;0;5;356;361
8;Barcelona;41;Vallès Oriental;08209;Sant Fost de Campsentelles;1;3;B;;594;124;260;371;223;0;6;365;371
8;Barcelona;41;Vallès Oriental;08209;Sant Fost de Campsentelles;1;3;C;;614;119;266;387;227;0;2;385;387
8;Barcelona;41;Vallès Oriental;08209;Sant Fost de Campsentelles;1;4;U;;783;166;316;426;357;0;4;422;426
8;Barcelona;7;Bages;08213;Sant Fruitós de Bages;1;1;A;;803;166;404;490;313;0;2;488;490
8;Barcelona;7;Bages;08213;Sant Fruitós de Bages;1;1;B;;773;144;331;430;343;1;4;425;429
8;Barcelona;7;Bages;08213;Sant Fruitós de Bages;1;1;C;;925;212;464;594;331;2;1;591;592
8;Barcelona;7;Bages;08213;Sant Fruitós de Bages;1;2;A;;653;111;280;360;293;0;3;357;360
8;Barcelona;7;Bages;08213;Sant Fruitós de Bages;1;2;B;;728;135;323;414;314;0;2;412;414
8;Barcelona;7;Bages;08213;Sant Fruitós de Bages;1;2;C;;670;174;377;489;181;0;10;479;489
17;Girona;20;Gironès;17163;Sant Gregori;1;1;A;;708;210;350;457;251;0;3;454;457
17;Girona;20;Gironès;17163;Sant Gregori;1;1;B;;838;265;497;604;234;5;5;594;599
17;Girona;20;Gironès;17163;Sant Gregori;1;1;C;;335;91;180;228;107;1;6;221;227
25;Lleida;32;Segarra;25192;Sant Guim de Freixenet;1;1;U;;885;203;442;592;293;2;14;576;590
25;Lleida;32;Segarra;25197;Sant Guim de la Plana;1;1;U;;174;42;87;112;62;2;1;109;110
17;Girona;34;Selva;17164;Sant Hilari Sacalm;1;1;A;;554;144;307;359;195;2;2;355;357
17;Girona;34;Selva;17164;Sant Hilari Sacalm;1;1;B;;719;182;394;485;234;1;3;481;484
17;Girona;34;Selva;17164;Sant Hilari Sacalm;1;2;A;;501;201;280;330;171;0;1;329;330
17;Girona;34;Selva;17164;Sant Hilari Sacalm;1;2;B;;588;152;313;373;215;1;3;369;372
17;Girona;34;Selva;17164;Sant Hilari Sacalm;1;3;A;;816;177;405;493;323;2;1;490;491
17;Girona;34;Selva;17164;Sant Hilari Sacalm;1;3;B;;797;177;419;494;303;0;3;491;494
8;Barcelona;24;Osona;08215;Sant Hipòlit de Voltregà;1;1;U;;749;243;425;491;258;3;3;485;488
8;Barcelona;24;Osona;08215;Sant Hipòlit de Voltregà;1;2;U;;878;312;550;668;210;1;1;666;667
8;Barcelona;24;Osona;08215;Sant Hipòlit de Voltregà;1;3;U;;870;298;556;650;220;12;2;636;638
8;Barcelona;21;Maresme;08193;Sant Iscle de Vallalta;1;1;U;;642;154;317;437;205;1;4;432;436
43;Tarragona;22;Montsià;43902;Sant Jaume d'Enveja;1;1;A;;803;175;345;433;370;1;7;425;432
43;Tarragona;22;Montsià;43902;Sant Jaume d'Enveja;1;1;B;;417;138;238;311;106;0;1;310;311
43;Tarragona;22;Montsià;43902;Sant Jaume d'Enveja;1;2;A;;801;246;391;478;323;2;4;472;476
43;Tarragona;22;Montsià;43902;Sant Jaume d'Enveja;1;2;B;;762;216;360;450;312;0;1;449;450
8;Barcelona;14;Berguedà;08216;Sant Jaume de Frontanyà;1;1;U;;27;9;15;22;5;0;0;22;22
17;Girona;19;Garrotxa;17165;Sant Jaume de Llierca;1;1;U;;626;239;402;454;172;0;1;453;454
43;Tarragona;12;Baix Penedès;43137;Sant Jaume dels Domenys;1;1;U;;1144;355;592;763;381;4;6;753;759
17;Girona;31;Ripollès;17167;Sant Joan de les Abadesses;1;1;A;;332;105;184;204;128;0;1;203;204
17;Girona;31;Ripollès;17167;Sant Joan de les Abadesses;1;1;B;;351;111;227;253;98;0;3;250;253
17;Girona;31;Ripollès;17167;Sant Joan de les Abadesses;1;2;A;;655;270;390;470;185;1;5;464;469
17;Girona;31;Ripollès;17167;Sant Joan de les Abadesses;1;2;B;;401;145;232;271;130;0;2;269;271
17;Girona;31;Ripollès;17167;Sant Joan de les Abadesses;1;2;C;;552;193;326;402;150;3;3;396;399
17;Girona;31;Ripollès;17167;Sant Joan de les Abadesses;1;3;A;;445;150;251;296;149;0;4;292;296
17;Girona;31;Ripollès;17167;Sant Joan de les Abadesses;1;3;B;;434;153;278;313;121;0;2;311;313
17;Girona;20;Gironès;17168;Sant Joan de Mollet;1;1;U;;323;106;182;249;74;4;3;242;245
8;Barcelona;11;Baix Llobregat;08217;Sant Joan Despí;1;1;U;;842;172;369;515;327;1;5;509;514
8;Barcelona;11;Baix Llobregat;08217;Sant Joan Despí;1;2;A;;460;84;199;285;175;2;4;279;283
8;Barcelona;11;Baix Llobregat;08217;Sant Joan Despí;1;2;B;;579;120;261;349;230;1;8;340;348
8;Barcelona;11;Baix Llobregat;08217;Sant Joan Despí;1;3;A;;567;115;258;358;209;0;6;352;358
8;Barcelona;11;Baix Llobregat;08217;Sant Joan Despí;1;3;B;;679;164;294;420;259;0;5;415;420
8;Barcelona;11;Baix Llobregat;08217;Sant Joan Despí;1;4;A;;660;128;266;416;244;0;9;407;416
8;Barcelona;11;Baix Llobregat;08217;Sant Joan Despí;1;4;B;;659;126;281;398;261;1;3;394;397
8;Barcelona;11;Baix Llobregat;08217;Sant Joan Despí;1;5;A;;397;91;189;256;141;1;1;254;255
8;Barcelona;11;Baix Llobregat;08217;Sant Joan Despí;1;5;B;;469;137;220;304;165;0;6;298;304
8;Barcelona;11;Baix Llobregat;08217;Sant Joan Despí;1;5;C;;523;131;232;321;202;0;6;315;321
8;Barcelona;11;Baix Llobregat;08217;Sant Joan Despí;1;6;A;;511;90;186;268;243;0;1;267;268
8;Barcelona;11;Baix Llobregat;08217;Sant Joan Despí;1;6;B;;538;99;201;273;265;0;0;273;273
8;Barcelona;11;Baix Llobregat;08217;Sant Joan Despí;1;7;A;;596;111;243;329;267;1;4;324;328
8;Barcelona;11;Baix Llobregat;08217;Sant Joan Despí;1;7;B;;647;105;256;361;286;0;3;358;361
8;Barcelona;11;Baix Llobregat;08217;Sant Joan Despí;1;8;A;;596;118;259;349;247;0;2;347;349
8;Barcelona;11;Baix Llobregat;08217;Sant Joan Despí;1;8;B;;698;128;274;405;293;0;4;401;405
8;Barcelona;11;Baix Llobregat;08217;Sant Joan Despí;2;2;A;;536;118;210;310;226;0;2;308;310
8;Barcelona;11;Baix Llobregat;08217;Sant Joan Despí;2;2;B;;525;109;226;296;229;1;2;293;295
8;Barcelona;11;Baix Llobregat;08217;Sant Joan Despí;2;3;U;;673;176;279;370;303;0;7;363;370
8;Barcelona;11;Baix Llobregat;08217;Sant Joan Despí;2;4;A;;499;104;212;282;217;0;1;281;282
8;Barcelona;11;Baix Llobregat;08217;Sant Joan Despí;2;4;B;;677;165;275;367;310;0;1;366;367
8;Barcelona;11;Baix Llobregat;08217;Sant Joan Despí;3;1;A;;394;100;187;251;143;0;2;249;251
8;Barcelona;11;Baix Llobregat;08217;Sant Joan Despí;3;1;B;;471;89;194;283;188;0;5;278;283
8;Barcelona;11;Baix Llobregat;08217;Sant Joan Despí;3;1;C;;440;83;179;259;181;1;5;253;258
8;Barcelona;11;Baix Llobregat;08217;Sant Joan Despí;3;2;A;;707;149;272;395;312;0;1;394;395
8;Barcelona;11;Baix Llobregat;08217;Sant Joan Despí;3;2;B;;720;169;322;416;304;0;2;414;416
8;Barcelona;11;Baix Llobregat;08217;Sant Joan Despí;3;3;A;;478;102;213;285;193;0;4;281;285
8;Barcelona;11;Baix Llobregat;08217;Sant Joan Despí;3;3;B;;412;89;200;256;156;0;1;255;256
8;Barcelona;11;Baix Llobregat;08217;Sant Joan Despí;3;4;A;;762;180;334;453;309;0;3;450;453
8;Barcelona;11;Baix Llobregat;08217;Sant Joan Despí;3;4;B;;884;221;377;514;370;2;3;509;512
8;Barcelona;11;Baix Llobregat;08217;Sant Joan Despí;3;5;A;;574;154;281;367;207;1;4;362;366
8;Barcelona;11;Baix Llobregat;08217;Sant Joan Despí;3;5;B;;583;143;309;381;202;0;2;379;381
8;Barcelona;11;Baix Llobregat;08217;Sant Joan Despí;4;1;A;;729;185;343;470;259;1;3;466;469
8;Barcelona;11;Baix Llobregat;08217;Sant Joan Despí;4;1;B;;876;209;421;569;307;0;10;559;569
8;Barcelona;11;Baix Llobregat;08217;Sant Joan Despí;5;1;A;;778;138;360;492;286;0;8;484;492
8;Barcelona;11;Baix Llobregat;08217;Sant Joan Despí;5;1;B;;925;153;400;535;390;0;12;523;535
8;Barcelona;11;Baix Llobregat;08217;Sant Joan Despí;5;1;C;;889;155;408;547;342;7;9;531;540
8;Barcelona;7;Bages;08218;Sant Joan de Vilatorrada;1;1;A;;600;154;295;375;225;0;4;371;375
8;Barcelona;7;Bages;08218;Sant Joan de Vilatorrada;1;1;B;;582;131;270;356;226;1;2;353;355
8;Barcelona;7;Bages;08218;Sant Joan de Vilatorrada;1;1;C;;702;149;369;454;248;0;0;454;454
8;Barcelona;7;Bages;08218;Sant Joan de Vilatorrada;1;2;A;;555;116;282;335;220;0;7;328;335
8;Barcelona;7;Bages;08218;Sant Joan de Vilatorrada;1;2;B;;707;143;277;377;330;0;7;370;377
8;Barcelona;7;Bages;08218;Sant Joan de Vilatorrada;1;3;A;;517;132;246;310;207;0;6;304;310
8;Barcelona;7;Bages;08218;Sant Joan de Vilatorrada;1;3;B;;628;129;271;362;266;0;0;362;362
8;Barcelona;7;Bages;08218;Sant Joan de Vilatorrada;1;3;C;;192;42;98;146;46;0;3;143;146
8;Barcelona;7;Bages;08218;Sant Joan de Vilatorrada;1;5;A;;575;153;283;368;207;0;4;364;368
8;Barcelona;7;Bages;08218;Sant Joan de Vilatorrada;1;5;B;;666;176;341;451;215;1;0;450;450
8;Barcelona;7;Bages;08218;Sant Joan de Vilatorrada;1;6;A;;479;119;209;278;201;1;4;273;277
8;Barcelona;7;Bages;08218;Sant Joan de Vilatorrada;1;6;B;;641;150;311;376;265;0;1;375;376
8;Barcelona;7;Bages;08218;Sant Joan de Vilatorrada;1;6;C;;623;144;342;368;255;0;4;364;368
17;Girona;19;Garrotxa;17185;Sant Joan les Fonts;1;1;A;;543;170;316;381;162;2;3;376;379
17;Girona;19;Garrotxa;17185;Sant Joan les Fonts;1;1;B;;553;171;331;398;155;0;0;398;398
17;Girona;19;Garrotxa;17185;Sant Joan les Fonts;1;2;U;;544;166;335;380;164;2;1;377;378
17;Girona;19;Garrotxa;17185;Sant Joan les Fonts;1;3;A;;555;152;332;389;166;3;5;381;386
17;Girona;19;Garrotxa;17185;Sant Joan les Fonts;1;3;B;;215;43;96;136;79;0;2;134;136
17;Girona;20;Gironès;17166;Sant Jordi Desvalls;1;1;U;;507;166;281;375;132;2;4;369;373
8;Barcelona;14;Berguedà;08903;Sant Julià de Cerdanyola;1;1;U;;203;93;152;170;33;0;0;170;170
17;Girona;34;Selva;17903;Sant Julià del Llor i Bonmatí;1;1;U;;768;249;453;552;216;4;2;546;548
17;Girona;20;Gironès;17169;Sant Julià de Ramis;1;1;A;;971;304;580;715;256;7;5;703;708
17;Girona;20;Gironès;17169;Sant Julià de Ramis;1;1;B;;634;174;342;423;211;1;5;417;422
8;Barcelona;24;Osona;08220;Sant Julià de Vilatorta;1;1;A;;868;243;499;647;221;2;3;642;645
8;Barcelona;24;Osona;08220;Sant Julià de Vilatorta;1;1;B;;934;278;555;712;222;3;8;701;709
8;Barcelona;11;Baix Llobregat;08221;Sant Just Desvern;1;1;A;;826;171;400;520;306;2;8;510;518
8;Barcelona;11;Baix Llobregat;08221;Sant Just Desvern;1;1;B;;865;187;442;567;298;0;6;561;567
8;Barcelona;11;Baix Llobregat;08221;Sant Just Desvern;1;2;U;;926;272;475;574;352;1;7;566;573
8;Barcelona;11;Baix Llobregat;08221;Sant Just Desvern;1;3;A;;902;231;459;566;336;5;6;555;561
8;Barcelona;11;Baix Llobregat;08221;Sant Just Desvern;1;3;B;;981;280;490;621;360;2;8;611;619
8;Barcelona;11;Baix Llobregat;08221;Sant Just Desvern;1;4;A;;704;183;339;450;254;2;2;446;448
8;Barcelona;11;Baix Llobregat;08221;Sant Just Desvern;1;4;B;;902;165;392;553;349;1;4;548;552
8;Barcelona;11;Baix Llobregat;08221;Sant Just Desvern;1;5;A;;1032;210;518;648;384;0;11;637;648
8;Barcelona;11;Baix Llobregat;08221;Sant Just Desvern;1;5;B;;1148;250;560;735;413;0;6;729;735
8;Barcelona;11;Baix Llobregat;08221;Sant Just Desvern;1;6;A;;724;164;355;471;253;0;8;463;471
8;Barcelona;11;Baix Llobregat;08221;Sant Just Desvern;1;6;B;;930;196;458;607;323;2;7;598;605
8;Barcelona;11;Baix Llobregat;08221;Sant Just Desvern;1;7;U;;695;126;343;458;237;0;5;453;458
8;Barcelona;11;Baix Llobregat;08221;Sant Just Desvern;1;8;U;;1007;230;470;658;349;2;12;644;656
8;Barcelona;3;Alt Penedès;08222;Sant Llorenç d'Hortons;1;1;A;;630;143;310;437;193;2;2;433;435
8;Barcelona;3;Alt Penedès;08222;Sant Llorenç d'Hortons;1;1;B;;586;145;305;410;176;0;3;407;410
17;Girona;2;Alt Empordà;17171;Sant Llorenç de la Muga;1;1;U;;141;50;83;103;38;0;1;102;103
25;Lleida;35;Solsonès;25193;Sant Llorenç de Morunys;1;1;U;;760;250;433;562;198;2;2;558;560
8;Barcelona;40;Vallès Occidental;08223;Sant Llorenç Savall;1;1;A;;762;168;336;507;255;1;3;503;506
8;Barcelona;40;Vallès Occidental;08223;Sant Llorenç Savall;1;1;B;;927;258;484;629;298;3;3;623;626
8;Barcelona;24;Osona;08225;Sant Martí d'Albars;1;1;U;;117;17;43;74;43;0;0;74;74
8;Barcelona;24;Osona;08224;Sant Martí de Centelles;1;1;U;;603;222;356;448;155;0;4;444;448
17;Girona;20;Gironès;17172;Sant Martí de Llémena;1;1;U;;377;117;200;245;132;0;1;244;245
25;Lleida;38;Urgell;25902;Sant Martí de Riucorb;1;1;U;;638;132;345;452;186;2;1;449;450
8;Barcelona;6;Anoia;08226;Sant Martí de Tous;1;1;U;;823;178;423;591;232;2;10;579;589
8;Barcelona;3;Alt Penedès;08227;Sant Martí Sarroca;1;1;A;;692;161;330;434;258;0;3;431;434
8;Barcelona;3;Alt Penedès;08227;Sant Martí Sarroca;1;1;B;;809;196;386;515;294;2;3;510;513
8;Barcelona;3;Alt Penedès;08227;Sant Martí Sarroca;1;2;U;;570;155;307;396;174;3;1;392;393
8;Barcelona;6;Anoia;08228;Sant Martí Sesgueioles;1;1;U;;314;71;177;225;89;2;3;220;223
17;Girona;20;Gironès;17173;Sant Martí Vell;1;1;U;;150;52;91;106;44;0;0;106;106
8;Barcelona;7;Bages;08229;Sant Mateu de Bages;1;1;A;;170;30;78;114;56;2;3;109;112
8;Barcelona;7;Bages;08229;Sant Mateu de Bages;1;1;B;;271;115;185;229;42;0;3;226;229
17;Girona;28;Pla de l'Estany;17174;Sant Miquel de Campmajor;1;1;U;;177;61;100;128;49;0;2;126;128
17;Girona;2;Alt Empordà;17175;Sant Miquel de Fluvià;1;1;U;;458;110;225;276;182;1;1;274;275
17;Girona;2;Alt Empordà;17176;Sant Mori;1;1;U;;126;40;81;99;27;0;2;97;99
17;Girona;31;Ripollès;17177;Sant Pau de Segúries;1;1;U;;554;204;371;427;127;8;3;416;419
8;Barcelona;7;Bages;08192;Santpedor;1;1;A;;527;159;312;374;153;1;0;373;373
8;Barcelona;7;Bages;08192;Santpedor;1;1;B;;623;178;328;411;212;1;4;406;410
8;Barcelona;7;Bages;08192;Santpedor;1;2;A;;743;200;351;474;269;1;2;471;473
8;Barcelona;7;Bages;08192;Santpedor;1;2;B;;858;237;386;519;339;1;1;517;518
8;Barcelona;7;Bages;08192;Santpedor;1;3;A;;815;211;423;555;260;3;4;548;552
8;Barcelona;7;Bages;08192;Santpedor;1;3;B;;874;214;443;586;288;1;2;583;585
8;Barcelona;17;Garraf;08231;Sant Pere de Ribes;1;1;A;;706;159;285;383;323;1;7;375;382
8;Barcelona;17;Garraf;08231;Sant Pere de Ribes;1;1;B;;792;185;343;434;358;0;4;430;434
8;Barcelona;17;Garraf;08231;Sant Pere de Ribes;1;10;A;;1024;187;335;448;576;3;2;443;445
8;Barcelona;17;Garraf;08231;Sant Pere de Ribes;1;10;B;;913;181;330;445;468;2;2;441;443
8;Barcelona;17;Garraf;08231;Sant Pere de Ribes;1;11;A;;461;83;176;219;242;1;1;217;218
8;Barcelona;17;Garraf;08231;Sant Pere de Ribes;1;11;B;;496;101;185;230;266;0;1;229;230
8;Barcelona;17;Garraf;08231;Sant Pere de Ribes;1;2;A;;541;113;224;279;262;0;2;277;279
8;Barcelona;17;Garraf;08231;Sant Pere de Ribes;1;2;B;;654;146;268;335;319;2;0;333;333
8;Barcelona;17;Garraf;08231;Sant Pere de Ribes;1;3;A;;881;220;393;495;386;4;4;487;491
8;Barcelona;17;Garraf;08231;Sant Pere de Ribes;1;3;B;;976;214;424;546;430;2;1;543;544
8;Barcelona;17;Garraf;08231;Sant Pere de Ribes;1;4;A;;624;117;212;273;351;1;3;269;272
8;Barcelona;17;Garraf;08231;Sant Pere de Ribes;1;4;B;;811;195;292;364;447;1;2;361;363
8;Barcelona;17;Garraf;08231;Sant Pere de Ribes;1;5;A;;873;175;300;391;482;0;3;388;391
8;Barcelona;17;Garraf;08231;Sant Pere de Ribes;1;5;B;;1079;182;354;482;597;2;4;476;480
8;Barcelona;17;Garraf;08231;Sant Pere de Ribes;1;6;A;;606;145;241;299;307;1;2;296;298
8;Barcelona;17;Garraf;08231;Sant Pere de Ribes;1;6;B;;735;182;289;372;363;1;0;371;371
8;Barcelona;17;Garraf;08231;Sant Pere de Ribes;1;7;A;;515;88;159;197;318;0;1;196;197
8;Barcelona;17;Garraf;08231;Sant Pere de Ribes;1;7;B;;719;131;273;353;366;3;2;348;350
8;Barcelona;17;Garraf;08231;Sant Pere de Ribes;1;8;A;;1061;202;421;554;507;5;5;544;549
8;Barcelona;17;Garraf;08231;Sant Pere de Ribes;1;8;B;;1071;225;430;591;480;6;9;576;585
8;Barcelona;17;Garraf;08231;Sant Pere de Ribes;1;9;A;;740;163;290;378;362;0;1;377;378
8;Barcelona;17;Garraf;08231;Sant Pere de Ribes;1;9;B;;684;151;275;345;339;1;3;341;344
8;Barcelona;3;Alt Penedès;08232;Sant Pere de Riudebitlles;1;1;A;;619;130;328;422;197;1;1;420;421
8;Barcelona;3;Alt Penedès;08232;Sant Pere de Riudebitlles;1;1;B;;572;139;294;388;184;1;5;382;387
8;Barcelona;3;Alt Penedès;08232;Sant Pere de Riudebitlles;1;1;C;;587;132;309;403;184;2;2;399;401
8;Barcelona;24;Osona;08233;Sant Pere de Torelló;1;1;U;;748;208;412;502;246;2;5;495;500
8;Barcelona;24;Osona;08233;Sant Pere de Torelló;1;2;U;;1183;267;569;746;437;8;5;733;738
8;Barcelona;41;Vallès Oriental;08234;Sant Pere de Vilamajor;1;1;A;;934;307;491;597;337;2;6;589;595
8;Barcelona;41;Vallès Oriental;08234;Sant Pere de Vilamajor;1;1;B;;1041;280;507;629;412;1;7;621;628
17;Girona;2;Alt Empordà;17178;Sant Pere Pescador;1;1;U;;1038;333;595;718;320;1;4;713;717
8;Barcelona;6;Anoia;08189;Sant Pere Sallavinera;1;1;U;;139;42;86;117;22;0;1;116;117
8;Barcelona;21;Maresme;08235;Sant Pol de Mar;1;1;A;;703;210;372;464;239;2;2;460;462
8;Barcelona;21;Maresme;08235;Sant Pol de Mar;1;1;B;;852;283;486;593;259;6;9;578;587
8;Barcelona;21;Maresme;08235;Sant Pol de Mar;1;2;A;;506;168;288;373;133;1;3;369;372
8;Barcelona;21;Maresme;08235;Sant Pol de Mar;1;2;B;;756;227;455;556;200;2;7;547;554
8;Barcelona;3;Alt Penedès;08236;Sant Quintí de Mediona;1;1;A;;680;172;367;477;203;1;6;470;476
8;Barcelona;3;Alt Penedès;08236;Sant Quintí de Mediona;1;1;B;;754;186;431;570;184;4;6;560;566
8;Barcelona;24;Osona;08237;Sant Quirze de Besora;1;1;A;;479;156;275;333;146;3;1;329;330
8;Barcelona;24;Osona;08237;Sant Quirze de Besora;1;1;B;;554;169;309;385;169;1;2;382;384
8;Barcelona;24;Osona;08237;Sant Quirze de Besora;1;2;U;;656;215;449;515;141;3;7;505;512
8;Barcelona;40;Vallès Occidental;08238;Sant Quirze del Vallès;1;1;A;;503;140;288;354;149;0;5;349;354
8;Barcelona;40;Vallès Occidental;08238;Sant Quirze del Vallès;1;1;B;;599;161;333;415;184;0;6;409;415
8;Barcelona;40;Vallès Occidental;08238;Sant Quirze del Vallès;1;2;A;;442;90;228;294;148;0;2;292;294
8;Barcelona;40;Vallès Occidental;08238;Sant Quirze del Vallès;1;2;B;;372;87;184;240;132;0;2;238;240
8;Barcelona;40;Vallès Occidental;08238;Sant Quirze del Vallès;1;2;C;;370;77;183;256;114;0;1;255;256
8;Barcelona;40;Vallès Occidental;08238;Sant Quirze del Vallès;1;3;A;;475;124;195;282;193;0;0;282;282
8;Barcelona;40;Vallès Occidental;08238;Sant Quirze del Vallès;1;3;B;;625;151;250;350;275;0;1;349;350
8;Barcelona;40;Vallès Occidental;08238;Sant Quirze del Vallès;1;4;A;;466;143;247;317;149;0;6;311;317
8;Barcelona;40;Vallès Occidental;08238;Sant Quirze del Vallès;1;4;B;;367;109;192;247;120;0;2;245;247
8;Barcelona;40;Vallès Occidental;08238;Sant Quirze del Vallès;1;4;C;;494;128;253;328;166;0;7;321;328
8;Barcelona;40;Vallès Occidental;08238;Sant Quirze del Vallès;1;4;D;;441;123;222;292;149;0;4;288;292
8;Barcelona;40;Vallès Occidental;08238;Sant Quirze del Vallès;1;5;A;;483;121;230;303;180;3;0;300;300
8;Barcelona;40;Vallès Occidental;08238;Sant Quirze del Vallès;1;5;B;;524;119;226;309;215;0;4;305;309
8;Barcelona;40;Vallès Occidental;08238;Sant Quirze del Vallès;1;5;C;;438;106;204;271;167;0;2;269;271
8;Barcelona;40;Vallès Occidental;08238;Sant Quirze del Vallès;1;6;A;;473;101;208;293;180;1;1;291;292
8;Barcelona;40;Vallès Occidental;08238;Sant Quirze del Vallès;1;6;B;;456;96;178;255;201;2;0;253;253
8;Barcelona;40;Vallès Occidental;08238;Sant Quirze del Vallès;1;6;C;;602;153;297;388;214;3;1;384;385
8;Barcelona;40;Vallès Occidental;08238;Sant Quirze del Vallès;1;6;D;;491;101;220;290;201;1;3;286;289
8;Barcelona;40;Vallès Occidental;08238;Sant Quirze del Vallès;1;7;A;;467;101;238;307;160;0;4;303;307
8;Barcelona;40;Vallès Occidental;08238;Sant Quirze del Vallès;1;7;B;;540;132;268;376;164;0;4;372;376
8;Barcelona;;;08239;Sant Quirze Safaja;1;1;U;;294;79;155;192;102;0;5;187;192
25;Lleida;32;Segarra;25194;Sant Ramon;1;1;U;;488;78;205;283;205;0;7;276;283
8;Barcelona;3;Alt Penedès;08240;Sant Sadurní d'Anoia;1;1;A;;670;171;326;444;226;0;1;443;444
8;Barcelona;3;Alt Penedès;08240;Sant Sadurní d'Anoia;1;1;B;;551;148;277;352;199;1;1;350;351
8;Barcelona;3;Alt Penedès;08240;Sant Sadurní d'Anoia;1;1;C;;812;185;391;516;296;1;1;514;515
8;Barcelona;3;Alt Penedès;08240;Sant Sadurní d'Anoia;1;2;A;;772;153;366;504;268;2;5;497;502
8;Barcelona;3;Alt Penedès;08240;Sant Sadurní d'Anoia;1;2;B;;892;187;420;583;309;1;7;575;582
8;Barcelona;3;Alt Penedès;08240;Sant Sadurní d'Anoia;1;3;A;;462;120;218;282;180;0;2;280;282
8;Barcelona;3;Alt Penedès;08240;Sant Sadurní d'Anoia;1;3;B;;479;122;213;288;191;0;2;286;288
8;Barcelona;3;Alt Penedès;08240;Sant Sadurní d'Anoia;1;4;A;;576;140;305;396;180;0;1;395;396
8;Barcelona;3;Alt Penedès;08240;Sant Sadurní d'Anoia;1;4;B;;574;112;283;390;184;1;3;386;389
8;Barcelona;3;Alt Penedès;08240;Sant Sadurní d'Anoia;2;1;A;;448;108;206;296;152;0;3;293;296
8;Barcelona;3;Alt Penedès;08240;Sant Sadurní d'Anoia;2;1;B;;530;144;277;388;142;0;0;388;388
8;Barcelona;3;Alt Penedès;08240;Sant Sadurní d'Anoia;2;2;A;;636;142;306;419;217;1;2;416;418
8;Barcelona;3;Alt Penedès;08240;Sant Sadurní d'Anoia;2;2;B;;718;155;321;459;259;0;1;458;459
8;Barcelona;24;Osona;08241;Sant Sadurní d'Osormort;1;1;U;;66;24;46;54;12;0;0;54;54
8;Barcelona;7;Bages;08098;Sant Salvador de Guardiola;1;1;A;;805;153;324;458;347;0;5;453;458
8;Barcelona;7;Bages;08098;Sant Salvador de Guardiola;1;1;B;;816;187;369;482;334;0;5;477;482
8;Barcelona;7;Bages;08262;Sant Vicenç de Castellet;1;1;A;;616;147;295;369;247;1;4;364;368
8;Barcelona;7;Bages;08262;Sant Vicenç de Castellet;1;1;B;;763;162;370;466;297;0;5;461;466
8;Barcelona;7;Bages;08262;Sant Vicenç de Castellet;1;1;C;;752;167;354;460;292;2;4;454;458
8;Barcelona;7;Bages;08262;Sant Vicenç de Castellet;1;2;A;;563;164;286;370;193;1;2;367;369
8;Barcelona;7;Bages;08262;Sant Vicenç de Castellet;1;2;B;;672;181;321;413;259;0;4;409;413
8;Barcelona;7;Bages;08262;Sant Vicenç de Castellet;2;1;A;;502;85;210;297;205;0;3;294;297
8;Barcelona;7;Bages;08262;Sant Vicenç de Castellet;2;1;B;;538;110;225;302;236;0;1;301;302
8;Barcelona;7;Bages;08262;Sant Vicenç de Castellet;2;1;C;;571;125;260;341;230;0;3;338;341
8;Barcelona;7;Bages;08262;Sant Vicenç de Castellet;2;2;A;;563;140;292;357;206;0;4;353;357
8;Barcelona;7;Bages;08262;Sant Vicenç de Castellet;2;2;B;;584;140;273;353;231;2;5;346;351
8;Barcelona;11;Baix Llobregat;08263;Sant Vicenç dels Horts;1;1;U;;691;152;344;447;244;0;3;444;447
8;Barcelona;11;Baix Llobregat;08263;Sant Vicenç dels Horts;1;10;A;;488;136;224;281;207;0;2;279;281
8;Barcelona;11;Baix Llobregat;08263;Sant Vicenç dels Horts;1;10;B;;623;113;286;368;255;0;1;367;368
8;Barcelona;11;Baix Llobregat;08263;Sant Vicenç dels Horts;1;11;U;;773;170;340;433;340;2;0;431;431
8;Barcelona;11;Baix Llobregat;08263;Sant Vicenç dels Horts;1;12;U;;920;218;368;474;446;1;2;471;473
8;Barcelona;11;Baix Llobregat;08263;Sant Vicenç dels Horts;1;2;A;;591;130;280;369;222;0;4;365;369
8;Barcelona;11;Baix Llobregat;08263;Sant Vicenç dels Horts;1;2;B;;729;155;320;412;317;3;2;407;409
8;Barcelona;11;Baix Llobregat;08263;Sant Vicenç dels Horts;1;3;A;;436;89;175;263;173;2;1;260;261
8;Barcelona;11;Baix Llobregat;08263;Sant Vicenç dels Horts;1;3;B;;494;96;194;277;217;1;2;274;276
8;Barcelona;11;Baix Llobregat;08263;Sant Vicenç dels Horts;1;4;A;;679;185;307;381;298;0;3;378;381
8;Barcelona;11;Baix Llobregat;08263;Sant Vicenç dels Horts;1;4;B;;750;195;337;430;320;1;1;428;429
8;Barcelona;11;Baix Llobregat;08263;Sant Vicenç dels Horts;1;5;A;;439;109;191;258;181;2;4;252;256
8;Barcelona;11;Baix Llobregat;08263;Sant Vicenç dels Horts;1;5;B;;475;117;220;276;199;0;0;276;276
8;Barcelona;11;Baix Llobregat;08263;Sant Vicenç dels Horts;1;6;A;;318;59;103;152;166;2;0;150;150
8;Barcelona;11;Baix Llobregat;08263;Sant Vicenç dels Horts;1;6;B;;405;84;127;175;230;1;0;174;174
8;Barcelona;11;Baix Llobregat;08263;Sant Vicenç dels Horts;1;7;A;;527;139;226;282;245;2;2;278;280
8;Barcelona;11;Baix Llobregat;08263;Sant Vicenç dels Horts;1;7;B;;582;145;250;326;256;2;2;322;324
8;Barcelona;11;Baix Llobregat;08263;Sant Vicenç dels Horts;1;8;U;;851;17;323;455;396;4;0;451;451
8;Barcelona;11;Baix Llobregat;08263;Sant Vicenç dels Horts;1;9;U;;704;180;302;373;331;1;3;369;372
8;Barcelona;11;Baix Llobregat;08263;Sant Vicenç dels Horts;2;1;A;;501;72;162;204;297;2;0;202;202
8;Barcelona;11;Baix Llobregat;08263;Sant Vicenç dels Horts;2;1;B;;561;94;182;237;324;2;1;234;235
8;Barcelona;11;Baix Llobregat;08263;Sant Vicenç dels Horts;2;2;A;;474;100;196;254;220;0;0;254;254
8;Barcelona;11;Baix Llobregat;08263;Sant Vicenç dels Horts;2;2;B;;626;112;227;297;329;0;2;295;297
8;Barcelona;11;Baix Llobregat;08263;Sant Vicenç dels Horts;2;3;U;;886;144;298;374;512;0;0;374;374
8;Barcelona;11;Baix Llobregat;08263;Sant Vicenç dels Horts;3;1;A;;621;105;214;279;342;1;3;275;278
8;Barcelona;11;Baix Llobregat;08263;Sant Vicenç dels Horts;3;1;B;;753;164;291;353;400;1;2;350;352
8;Barcelona;11;Baix Llobregat;08263;Sant Vicenç dels Horts;3;2;A;;581;108;180;257;324;0;2;255;257
8;Barcelona;11;Baix Llobregat;08263;Sant Vicenç dels Horts;3;2;B;;672;111;215;286;386;0;1;285;286
8;Barcelona;11;Baix Llobregat;08263;Sant Vicenç dels Horts;4;1;U;;1032;175;377;525;507;1;5;519;524
8;Barcelona;11;Baix Llobregat;08263;Sant Vicenç dels Horts;4;2;A;;294;82;144;186;108;0;1;185;186
8;Barcelona;11;Baix Llobregat;08263;Sant Vicenç dels Horts;4;2;B;;580;120;215;275;305;2;0;273;273
8;Barcelona;11;Baix Llobregat;08263;Sant Vicenç dels Horts;4;3;U;;737;162;314;416;321;0;2;414;416
8;Barcelona;21;Maresme;08264;Sant Vicenç de Montalt;1;1;A;;1187;246;566;762;425;2;6;754;760
8;Barcelona;21;Maresme;08264;Sant Vicenç de Montalt;1;1;B;;1194;219;573;753;441;4;10;739;749
8;Barcelona;24;Osona;08265;Sant Vicenç de Torelló;1;1;U;;1134;287;626;779;355;4;2;773;775
8;Barcelona;24;Osona;08265;Sant Vicenç de Torelló;1;2;U;;364;126;228;268;96;0;0;268;268
43;Tarragona;16;Conca de Barberà;43142;Sarral;1;1;A;;488;77;232;304;184;1;3;300;303
43;Tarragona;16;Conca de Barberà;43142;Sarral;1;1;B;;696;128;321;443;253;1;2;440;442
17;Girona;20;Gironès;17186;Sarrià de Ter;1;1;A;;821;242;444;550;271;4;4;542;546
17;Girona;20;Gironès;17186;Sarrià de Ter;1;1;B;;937;317;515;634;303;1;4;629;633
17;Girona;20;Gironès;17186;Sarrià de Ter;1;2;A;;509;176;257;314;195;1;1;312;313
17;Girona;20;Gironès;17186;Sarrià de Ter;1;2;B;;614;204;353;423;191;2;0;421;421
25;Lleida;25;Pallars Jussà;25201;Sarroca de Bellera;1;1;U;;141;28;49;83;58;0;1;82;83
25;Lleida;33;Segrià;25200;Sarroca de Lleida;1;1;U;;412;121;231;293;119;2;2;289;291
17;Girona;2;Alt Empordà;17187;Saus, Camallera i Llampaies;1;1;U;;578;154;324;416;162;9;5;402;407
43;Tarragona;16;Conca de Barberà;43143;Savallà del Comtat;1;1;U;;65;30;39;45;20;0;0;45;45
43;Tarragona;36;Tarragonès;43144;Secuita, la;1;1;U;;900;265;471;578;322;0;3;575;578
43;Tarragona;8;Baix Camp;43145;Selva del Camp, la;1;1;A;;803;169;396;552;251;1;3;548;551
43;Tarragona;8;Baix Camp;43145;Selva del Camp, la;1;1;B;;804;192;414;562;242;3;2;557;559
43;Tarragona;8;Baix Camp;43145;Selva del Camp, la;2;1;A;;723;158;368;539;184;2;5;532;537
43;Tarragona;8;Baix Camp;43145;Selva del Camp, la;2;1;B;;841;178;422;621;220;5;9;607;616
17;Girona;2;Alt Empordà;17188;Selva de Mar, la;1;1;U;;161;66;117;128;33;0;0;128;128
43;Tarragona;16;Conca de Barberà;43146;Senan;1;1;U;;29;8;20;26;3;1;0;25;25
43;Tarragona;22;Montsià;43044;Sénia, la;1;1;A;;783;171;283;417;366;1;3;413;416
43;Tarragona;22;Montsià;43044;Sénia, la;1;1;B;;882;189;338;475;407;1;8;466;474
43;Tarragona;22;Montsià;43044;Sénia, la;2;1;A;;727;156;287;419;308;1;6;412;418
43;Tarragona;22;Montsià;43044;Sénia, la;2;1;B;;798;175;321;464;334;1;4;459;463
43;Tarragona;22;Montsià;43044;Sénia, la;2;2;U;;905;176;351;512;393;0;10;502;512
25;Lleida;25;Pallars Jussà;25202;Senterada;1;1;U;;96;27;43;60;36;0;1;59;60
25;Lleida;23;Noguera;25035;Sentiu de Sió, la;1;1;U;;423;86;227;288;135;0;11;277;288
8;Barcelona;40;Vallès Occidental;08267;Sentmenat;1;1;A;;676;134;289;391;285;2;4;385;389
8;Barcelona;40;Vallès Occidental;08267;Sentmenat;1;1;B;;484;112;200;276;208;1;3;272;275
8;Barcelona;40;Vallès Occidental;08267;Sentmenat;1;1;C;;667;131;265;350;317;1;1;348;349
8;Barcelona;40;Vallès Occidental;08267;Sentmenat;1;1;D;;673;150;286;411;262;4;0;407;407
8;Barcelona;40;Vallès Occidental;08267;Sentmenat;1;2;A;;667;140;303;422;245;0;1;421;422
8;Barcelona;40;Vallès Occidental;08267;Sentmenat;1;2;B;;837;190;400;549;288;0;3;546;549
8;Barcelona;40;Vallès Occidental;08267;Sentmenat;1;2;C;;619;116;249;348;271;0;0;348;348
17;Girona;28;Pla de l'Estany;17190;Serinyà;1;1;U;;678;238;392;458;220;2;10;446;456
25;Lleida;33;Segrià;25204;Seròs;1;1;U;;635;121;292;417;218;5;1;411;412
25;Lleida;33;Segrià;25204;Seròs;1;2;U;;865;154;393;556;309;6;9;541;550
17;Girona;10;Baix Empordà;17191;Serra de Daró;1;1;U;;154;61;100;128;26;1;0;127;127
17;Girona;31;Ripollès;17192;Setcases;1;1;U;;141;55;89;110;31;0;0;110;110
25;Lleida;4;Alt Urgell;25203;Seu d'Urgell, la;1;1;U;;758;200;359;413;345;0;5;408;413
25;Lleida;4;Alt Urgell;25203;Seu d'Urgell, la;1;2;U;;1163;279;509;639;524;2;5;632;637
25;Lleida;4;Alt Urgell;25203;Seu d'Urgell, la;1;3;U;;1052;230;459;524;528;0;4;520;524
25;Lleida;4;Alt Urgell;25203;Seu d'Urgell, la;1;4;A;;813;185;393;509;304;0;6;503;509
25;Lleida;4;Alt Urgell;25203;Seu d'Urgell, la;1;4;B;;903;181;415;526;377;0;3;523;526
25;Lleida;4;Alt Urgell;25203;Seu d'Urgell, la;1;5;A;;694;175;415;407;287;0;7;400;407
25;Lleida;4;Alt Urgell;25203;Seu d'Urgell, la;1;5;B;;769;203;361;431;338;0;8;423;431
25;Lleida;4;Alt Urgell;25203;Seu d'Urgell, la;1;6;A;;896;249;470;557;339;1;3;553;556
25;Lleida;4;Alt Urgell;25203;Seu d'Urgell, la;1;6;B;;374;103;200;246;128;2;0;244;244
25;Lleida;4;Alt Urgell;25203;Seu d'Urgell, la;1;7;A;;697;152;302;404;293;0;4;400;404
25;Lleida;4;Alt Urgell;25203;Seu d'Urgell, la;1;7;B;;748;167;312;403;345;1;3;399;402
8;Barcelona;24;Osona;08269;Seva;1;1;U;;1077;305;665;833;244;0;7;826;833
8;Barcelona;24;Osona;08269;Seva;1;2;U;;933;235;530;648;285;1;14;633;647
25;Lleida;27;Pla d'Urgell;25205;Sidamon;1;1;U;;442;126;261;334;108;0;2;332;334
17;Girona;34;Selva;17193;Sils;1;1;A;;580;150;308;376;204;2;1;373;374
17;Girona;34;Selva;17193;Sils;1;1;B;;517;117;243;322;195;0;4;318;322
17;Girona;34;Selva;17193;Sils;1;1;C;;614;148;302;381;233;1;2;378;380
17;Girona;34;Selva;17193;Sils;1;2;U;;724;175;376;455;269;3;1;451;452
8;Barcelona;17;Garraf;08270;Sitges;1;1;U;;1101;342;529;661;440;0;1;660;661
8;Barcelona;17;Garraf;08270;Sitges;1;2;A;;578;176;285;353;225;0;7;346;353
8;Barcelona;17;Garraf;08270;Sitges;1;2;B;;737;245;380;468;269;1;6;461;467
8;Barcelona;17;Garraf;08270;Sitges;1;3;U;;1024;291;524;637;387;0;7;630;637
8;Barcelona;17;Garraf;08270;Sitges;1;4;U;;1237;358;600;750;487;1;4;745;749
8;Barcelona;17;Garraf;08270;Sitges;2;1;A;;738;214;387;474;264;2;2;470;472
8;Barcelona;17;Garraf;08270;Sitges;2;1;B;;977;264;481;592;385;1;5;586;591
8;Barcelona;17;Garraf;08270;Sitges;2;2;A;;952;221;457;595;357;2;1;592;593
8;Barcelona;17;Garraf;08270;Sitges;2;2;B;;1179;284;532;681;498;1;6;674;680
8;Barcelona;17;Garraf;08270;Sitges;2;3;A;;894;232;414;510;384;1;8;501;509
8;Barcelona;17;Garraf;08270;Sitges;2;3;B;;1154;332;523;647;507;0;7;640;647
8;Barcelona;17;Garraf;08270;Sitges;2;4;A;;534;132;239;310;224;0;2;308;310
8;Barcelona;17;Garraf;08270;Sitges;2;4;B;;733;171;301;391;342;3;0;388;388
8;Barcelona;17;Garraf;08270;Sitges;2;5;A;;1015;272;498;607;408;2;6;599;605
8;Barcelona;17;Garraf;08270;Sitges;2;5;B;;201;66;112;136;65;1;3;132;135
8;Barcelona;17;Garraf;08270;Sitges;2;5;C;;812;180;351;426;386;0;3;423;426
8;Barcelona;17;Garraf;08270;Sitges;2;6;U;;1522;382;672;866;656;1;14;851;865
17;Girona;2;Alt Empordà;17052;Siurana;1;1;U;;133;25;61;74;59;0;2;72;74
8;Barcelona;24;Osona;08271;Sobremunt;1;1;U;;67;14;29;37;30;0;3;34;37
25;Lleida;18;Garrigues;25206;Soleràs, el;1;1;U;;372;83;202;275;97;0;0;275;275
43;Tarragona;16;Conca de Barberà;43147;Solivella;1;1;U;;563;204;371;443;120;2;7;434;441
25;Lleida;35;Solsonès;25207;Solsona;1;1;A;;803;170;386;517;286;1;10;506;516
25;Lleida;35;Solsonès;25207;Solsona;1;1;B;;986;200;445;616;370;9;11;596;607
25;Lleida;35;Solsonès;25207;Solsona;1;2;U;;1245;278;580;720;525;8;11;701;712
25;Lleida;35;Solsonès;25207;Solsona;1;3;U;;943;224;448;586;357;2;6;578;584
25;Lleida;35;Solsonès;25207;Solsona;2;1;U;;821;232;460;593;228;2;7;584;591
25;Lleida;35;Solsonès;25207;Solsona;2;2;U;;1111;268;553;741;370;1;10;730;740
8;Barcelona;24;Osona;08272;Sora;1;1;U;;165;43;77;104;61;0;0;104;104
25;Lleida;26;Pallars Sobirà;25208;Soriguera;1;1;U;;276;40;87;151;125;0;1;150;151
25;Lleida;26;Pallars Sobirà;25209;Sort;1;1;A;;656;176;365;469;187;3;6;460;466
25;Lleida;26;Pallars Sobirà;25209;Sort;1;1;B;;797;233;423;551;246;2;5;544;549
25;Lleida;33;Segrià;25210;Soses;1;1;U;;1253;267;682;853;400;1;1;851;852
8;Barcelona;3;Alt Penedès;08273;Subirats;1;1;U;;624;154;360;435;189;5;5;425;430
8;Barcelona;3;Alt Penedès;08273;Subirats;1;2;A;;450;100;258;339;111;1;1;337;338
8;Barcelona;3;Alt Penedès;08273;Subirats;1;2;B;;388;100;182;226;162;0;0;226;226
8;Barcelona;3;Alt Penedès;08273;Subirats;1;3;U;;624;147;341;454;170;0;2;452;454
25;Lleida;33;Segrià;25211;Sudanell;1;1;U;;611;98;225;304;307;0;0;304;304
25;Lleida;33;Segrià;25212;Sunyer;1;1;U;;259;23;117;173;86;1;2;170;172
8;Barcelona;7;Bages;08274;Súria;1;1;A;;718;240;450;531;187;0;6;525;531
8;Barcelona;7;Bages;08274;Súria;1;1;B;;765;234;443;567;198;0;3;564;567
8;Barcelona;7;Bages;08274;Súria;1;2;U;;633;176;333;440;193;3;8;429;437
8;Barcelona;7;Bages;08274;Súria;1;3;U;;367;89;174;224;143;2;1;221;222
8;Barcelona;7;Bages;08274;Súria;1;4;A;;802;190;384;481;321;3;9;469;478
8;Barcelona;7;Bages;08274;Súria;1;4;B;;774;199;396;502;272;2;3;497;500
8;Barcelona;7;Bages;08274;Súria;1;5;A;;567;171;339;395;172;3;0;392;392
8;Barcelona;7;Bages;08274;Súria;1;5;B;;582;180;339;419;163;0;2;417;419
17;Girona;34;Selva;17194;Susqueda;1;1;U;;80;23;36;46;34;0;0;46;46
8;Barcelona;41;Vallès Oriental;08276;Tagamanent;1;1;U;;168;43;95;120;48;1;0;119;119
8;Barcelona;7;Bages;08277;Talamanca;1;1;U;;88;24;44;59;29;1;1;57;58
25;Lleida;25;Pallars Jussà;25215;Talarn;1;1;U;;305;88;153;211;94;1;1;209;210
25;Lleida;32;Segarra;25216;Talavera;1;1;U;;269;67;125;201;68;0;3;198;201
17;Girona;10;Baix Empordà;17195;Tallada d'Empordà, la;1;1;U;;283;102;174;195;88;0;0;195;195
8;Barcelona;24;Osona;08278;Taradell;1;1;A;;684;177;391;501;183;1;7;493;500
8;Barcelona;24;Osona;08278;Taradell;1;1;B;;748;170;400;524;224;0;4;520;524
8;Barcelona;24;Osona;08278;Taradell;1;1;C;;630;144;355;478;152;1;6;471;477
8;Barcelona;24;Osona;08278;Taradell;1;2;A;;798;183;437;550;248;1;4;545;549
8;Barcelona;24;Osona;08278;Taradell;1;2;B;;512;108;269;341;171;1;2;338;340
8;Barcelona;24;Osona;08278;Taradell;1;2;C;;588;145;324;419;169;0;3;416;419
43;Tarragona;36;Tarragonès;43148;Tarragona;1;1;U;;479;135;198;253;226;1;0;252;252
43;Tarragona;36;Tarragonès;43148;Tarragona;1;2;A;;375;138;213;245;130;0;2;243;245
43;Tarragona;36;Tarragonès;43148;Tarragona;1;2;B;;422;145;224;247;175;0;4;243;247
43;Tarragona;36;Tarragonès;43148;Tarragona;2;1;U;;461;117;197;238;223;0;2;236;238
43;Tarragona;36;Tarragonès;43148;Tarragona;2;2;U;;526;185;265;319;207;5;1;313;314
43;Tarragona;36;Tarragonès;43148;Tarragona;3;1;U;;524;193;289;335;189;0;7;328;335
43;Tarragona;36;Tarragonès;43148;Tarragona;3;2;U;;486;144;237;297;189;0;2;295;297
43;Tarragona;36;Tarragonès;43148;Tarragona;3;3;A;;571;163;332;438;133;1;1;436;437
43;Tarragona;36;Tarragonès;43148;Tarragona;3;3;B;;699;150;360;471;228;2;6;463;469
43;Tarragona;36;Tarragonès;43148;Tarragona;3;4;A;;574;146;299;379;195;0;7;372;379
43;Tarragona;36;Tarragonès;43148;Tarragona;3;4;B;;578;151;295;385;193;0;3;382;385
43;Tarragona;36;Tarragonès;43148;Tarragona;4;1;U;;642;178;325;436;206;2;9;425;434
43;Tarragona;36;Tarragonès;43148;Tarragona;4;10;A;;553;171;276;340;213;1;4;335;339
43;Tarragona;36;Tarragonès;43148;Tarragona;4;10;B;;660;200;325;400;260;2;1;397;398
43;Tarragona;36;Tarragonès;43148;Tarragona;4;11;U;;574;165;265;332;242;2;5;325;330
43;Tarragona;36;Tarragonès;43148;Tarragona;4;12;U;;726;221;375;476;250;1;10;465;475
43;Tarragona;36;Tarragonès;43148;Tarragona;4;13;U;;773;181;320;401;372;0;5;396;401
43;Tarragona;36;Tarragonès;43148;Tarragona;4;14;A;;512;136;252;324;188;0;0;324;324
43;Tarragona;36;Tarragonès;43148;Tarragona;4;14;B;;560;165;252;335;225;1;3;331;334
43;Tarragona;36;Tarragonès;43148;Tarragona;4;14;C;;577;152;288;374;203;0;1;373;374
43;Tarragona;36;Tarragonès;43148;Tarragona;4;15;U;;772;191;344;455;317;1;3;451;454
43;Tarragona;36;Tarragonès;43148;Tarragona;4;2;U;;758;219;381;473;285;2;2;469;471
43;Tarragona;36;Tarragonès;43148;Tarragona;4;3;U;;786;215;365;466;320;0;2;464;466
43;Tarragona;36;Tarragonès;43148;Tarragona;4;4;A;;473;142;241;306;167;2;2;302;304
43;Tarragona;36;Tarragonès;43148;Tarragona;4;4;B;;548;182;303;363;185;0;8;355;363
43;Tarragona;36;Tarragonès;43148;Tarragona;4;5;A;;479;121;248;319;160;0;5;314;319
43;Tarragona;36;Tarragonès;43148;Tarragona;4;5;B;;548;143;260;345;203;0;6;339;345
43;Tarragona;36;Tarragonès;43148;Tarragona;4;6;A;;618;166;297;402;216;2;4;396;400
43;Tarragona;36;Tarragonès;43148;Tarragona;4;6;B;;637;160;290;402;235;1;3;398;401
43;Tarragona;36;Tarragonès;43148;Tarragona;4;7;U;;766;263;422;515;251;0;14;501;515
43;Tarragona;36;Tarragonès;43148;Tarragona;4;8;A;;519;144;234;329;190;1;2;326;328
43;Tarragona;36;Tarragonès;43148;Tarragona;4;8;B;;443;110;200;284;159;0;4;280;284
43;Tarragona;36;Tarragonès;43148;Tarragona;4;8;C;;526;145;254;337;189;1;6;330;336
43;Tarragona;36;Tarragonès;43148;Tarragona;4;9;A;;598;173;309;407;191;1;0;406;406
43;Tarragona;36;Tarragonès;43148;Tarragona;4;9;B;;586;173;301;392;194;1;4;387;391
43;Tarragona;36;Tarragonès;43148;Tarragona;4;9;C;;651;167;320;429;222;0;9;420;429
43;Tarragona;36;Tarragonès;43148;Tarragona;5;1;A;;424;130;230;286;138;2;10;274;284
43;Tarragona;36;Tarragonès;43148;Tarragona;5;1;B;;493;156;270;329;164;2;8;319;327
43;Tarragona;36;Tarragonès;43148;Tarragona;5;2;A;;494;148;253;318;176;0;2;316;318
43;Tarragona;36;Tarragonès;43148;Tarragona;5;2;B;;511;127;238;309;202;0;2;307;309
43;Tarragona;36;Tarragonès;43148;Tarragona;5;3;A;;490;157;243;318;172;0;7;311;318
43;Tarragona;36;Tarragonès;43148;Tarragona;5;3;B;;588;181;275;368;220;4;8;356;364
43;Tarragona;36;Tarragonès;43148;Tarragona;5;4;A;;431;120;185;247;184;0;1;246;247
43;Tarragona;36;Tarragonès;43148;Tarragona;5;4;B;;525;121;208;282;243;0;2;280;282
43;Tarragona;36;Tarragonès;43148;Tarragona;5;5;A;;495;131;208;262;233;4;1;257;258
43;Tarragona;36;Tarragonès;43148;Tarragona;5;5;B;;579;150;251;339;240;1;2;336;338
43;Tarragona;36;Tarragonès;43148;Tarragona;5;6;U;;842;200;330;441;401;2;3;436;439
43;Tarragona;36;Tarragonès;43148;Tarragona;5;7;A;;400;119;181;242;158;1;5;236;241
43;Tarragona;36;Tarragonès;43148;Tarragona;5;7;B;;460;155;231;285;175;1;3;281;284
43;Tarragona;36;Tarragonès;43148;Tarragona;5;8;A;;668;173;315;402;266;1;2;399;401
43;Tarragona;36;Tarragonès;43148;Tarragona;5;8;B;;734;206;356;456;278;5;5;446;451
43;Tarragona;36;Tarragonès;43148;Tarragona;5;9;U;;617;142;319;434;183;3;8;423;431
43;Tarragona;36;Tarragonès;43148;Tarragona;6;1;A;;693;203;345;458;235;1;7;450;457
43;Tarragona;36;Tarragonès;43148;Tarragona;6;1;B;;783;203;371;513;270;3;10;500;510
43;Tarragona;36;Tarragonès;43148;Tarragona;6;10;A;;506;151;253;336;170;2;4;330;334
43;Tarragona;36;Tarragonès;43148;Tarragona;6;10;B;;465;147;231;298;167;3;4;291;295
43;Tarragona;36;Tarragonès;43148;Tarragona;6;10;C;;527;142;269;343;184;1;3;339;342
43;Tarragona;36;Tarragonès;43148;Tarragona;6;11;A;;465;114;211;288;177;0;2;286;288
43;Tarragona;36;Tarragonès;43148;Tarragona;6;11;B;;463;103;205;270;193;0;8;262;270
43;Tarragona;36;Tarragonès;43148;Tarragona;6;11;C;;542;154;264;355;187;1;3;351;354
43;Tarragona;36;Tarragonès;43148;Tarragona;6;12;A;;499;157;283;362;137;1;4;357;361
43;Tarragona;36;Tarragonès;43148;Tarragona;6;12;B;;539;159;298;382;157;0;4;378;382
43;Tarragona;36;Tarragonès;43148;Tarragona;6;13;A;;428;115;223;287;141;0;3;284;287
43;Tarragona;36;Tarragonès;43148;Tarragona;6;13;B;;448;122;218;275;173;0;1;274;275
43;Tarragona;36;Tarragonès;43148;Tarragona;6;14;U;;644;188;300;397;247;5;2;390;392
43;Tarragona;36;Tarragonès;43148;Tarragona;6;15;A;;421;92;180;248;173;0;0;248;248
43;Tarragona;36;Tarragonès;43148;Tarragona;6;15;B;;516;127;223;298;218;0;0;298;298
43;Tarragona;36;Tarragonès;43148;Tarragona;6;16;A;;594;175;314;404;190;2;3;399;402
43;Tarragona;36;Tarragonès;43148;Tarragona;6;16;B;;714;211;369;490;224;0;1;489;490
43;Tarragona;36;Tarragonès;43148;Tarragona;6;2;A;;457;119;219;291;166;2;2;287;289
43;Tarragona;36;Tarragonès;43148;Tarragona;6;2;B;;560;142;265;348;212;1;5;342;347
43;Tarragona;36;Tarragonès;43148;Tarragona;6;3;A;;569;142;251;308;261;1;2;305;307
43;Tarragona;36;Tarragonès;43148;Tarragona;6;3;B;;532;120;207;273;259;1;3;269;272
43;Tarragona;36;Tarragonès;43148;Tarragona;6;3;C;;480;137;205;253;227;4;3;246;249
43;Tarragona;36;Tarragonès;43148;Tarragona;6;4;U;;728;233;390;449;279;1;5;443;448
43;Tarragona;36;Tarragonès;43148;Tarragona;6;5;U;;445;117;195;238;207;0;1;237;238
43;Tarragona;36;Tarragonès;43148;Tarragona;6;6;U;;820;207;340;438;382;1;3;434;437
43;Tarragona;36;Tarragonès;43148;Tarragona;6;7;U;;534;120;254;308;226;1;2;305;307
43;Tarragona;36;Tarragonès;43148;Tarragona;6;8;A;;439;122;226;304;135;0;8;296;304
43;Tarragona;36;Tarragonès;43148;Tarragona;6;8;B;;521;168;283;358;163;0;3;355;358
43;Tarragona;36;Tarragonès;43148;Tarragona;6;9;A;;684;166;337;432;252;1;6;425;431
43;Tarragona;36;Tarragonès;43148;Tarragona;6;9;B;;764;194;347;449;315;0;1;448;449
43;Tarragona;36;Tarragonès;43148;Tarragona;7;1;U;;597;164;269;331;266;1;7;323;330
43;Tarragona;36;Tarragonès;43148;Tarragona;7;10;A;;652;145;264;329;323;0;2;327;329
43;Tarragona;36;Tarragonès;43148;Tarragona;7;10;B;;753;156;291;374;379;2;3;369;372
43;Tarragona;36;Tarragonès;43148;Tarragona;7;11;A;;573;117;253;319;254;2;2;315;317
43;Tarragona;36;Tarragonès;43148;Tarragona;7;11;B;;599;125;265;327;272;0;1;326;327
43;Tarragona;36;Tarragonès;43148;Tarragona;7;11;C;;596;140;271;360;236;0;2;358;360
43;Tarragona;36;Tarragonès;43148;Tarragona;7;12;A;;633;128;235;321;312;0;3;318;321
43;Tarragona;36;Tarragonès;43148;Tarragona;7;12;B;;575;107;209;286;289;2;3;281;284
43;Tarragona;36;Tarragonès;43148;Tarragona;7;13;A;;496;114;226;300;196;0;4;296;300
43;Tarragona;36;Tarragonès;43148;Tarragona;7;13;B;;524;114;252;351;173;0;7;344;351
43;Tarragona;36;Tarragonès;43148;Tarragona;7;13;C;;601;142;292;375;226;0;4;371;375
43;Tarragona;36;Tarragonès;43148;Tarragona;7;14;A;;424;114;209;297;127;1;3;293;296
43;Tarragona;36;Tarragonès;43148;Tarragona;7;14;B;;431;121;235;331;100;1;6;324;330
43;Tarragona;36;Tarragonès;43148;Tarragona;7;15;A;;586;150;262;351;235;0;4;347;351
43;Tarragona;36;Tarragonès;43148;Tarragona;7;15;B;;680;164;341;422;258;0;4;418;422
43;Tarragona;36;Tarragonès;43148;Tarragona;7;16;A;;521;131;255;335;186;0;8;327;335
43;Tarragona;36;Tarragonès;43148;Tarragona;7;16;B;;542;143;263;337;205;0;2;335;337
43;Tarragona;36;Tarragonès;43148;Tarragona;7;17;A;;462;145;231;312;150;1;2;309;311
43;Tarragona;36;Tarragonès;43148;Tarragona;7;17;B;;512;127;245;338;174;0;3;335;338
43;Tarragona;36;Tarragonès;43148;Tarragona;7;2;A;;405;102;165;217;188;0;3;214;217
43;Tarragona;36;Tarragonès;43148;Tarragona;7;2;B;;460;148;211;276;184;0;4;272;276
43;Tarragona;36;Tarragonès;43148;Tarragona;7;3;A;;476;94;175;217;259;1;0;216;216
43;Tarragona;36;Tarragonès;43148;Tarragona;7;3;B;;510;95;187;237;273;4;2;231;233
43;Tarragona;36;Tarragonès;43148;Tarragona;7;3;C;;558;121;218;270;288;0;0;270;270
43;Tarragona;36;Tarragonès;43148;Tarragona;7;4;A;;609;135;258;338;271;1;0;337;337
43;Tarragona;36;Tarragonès;43148;Tarragona;7;4;B;;620;129;307;341;279;1;4;336;340
43;Tarragona;36;Tarragonès;43148;Tarragona;7;4;C;;679;153;281;365;314;0;4;361;365
43;Tarragona;36;Tarragonès;43148;Tarragona;7;5;A;;434;123;182;222;212;0;3;219;222
43;Tarragona;36;Tarragonès;43148;Tarragona;7;5;B;;549;113;196;251;298;1;2;248;250
43;Tarragona;36;Tarragonès;43148;Tarragona;7;6;A;;586;130;255;342;244;1;3;338;341
43;Tarragona;36;Tarragonès;43148;Tarragona;7;6;B;;572;128;253;335;237;3;3;329;332
43;Tarragona;36;Tarragonès;43148;Tarragona;7;7;A;;495;114;269;331;164;1;8;322;330
43;Tarragona;36;Tarragonès;43148;Tarragona;7;7;B;;528;115;264;332;196;1;5;326;331
43;Tarragona;36;Tarragonès;43148;Tarragona;7;7;C;;323;77;135;174;149;0;1;173;174
43;Tarragona;36;Tarragonès;43148;Tarragona;7;8;A;;556;135;265;366;190;0;8;358;366
43;Tarragona;36;Tarragonès;43148;Tarragona;7;8;B;;670;149;309;431;239;1;8;422;430
43;Tarragona;36;Tarragonès;43148;Tarragona;7;9;A;;509;106;212;285;224;1;3;281;284
43;Tarragona;36;Tarragonès;43148;Tarragona;7;9;B;;582;122;223;299;283;0;1;298;299
43;Tarragona;36;Tarragonès;43148;Tarragona;7;9;C;;628;136;260;328;300;0;8;320;328
43;Tarragona;36;Tarragonès;43148;Tarragona;8;1;A;;453;96;173;235;218;0;2;233;235
43;Tarragona;36;Tarragonès;43148;Tarragona;8;1;B;;447;85;153;200;247;0;2;198;200
43;Tarragona;36;Tarragonès;43148;Tarragona;8;1;C;;527;122;208;278;249;2;2;274;276
43;Tarragona;36;Tarragonès;43148;Tarragona;8;10;A;;518;65;145;199;319;0;0;199;199
43;Tarragona;36;Tarragonès;43148;Tarragona;8;10;B;;597;101;179;253;344;0;2;251;253
43;Tarragona;36;Tarragonès;43148;Tarragona;8;11;U;;773;138;275;391;382;1;1;389;390
43;Tarragona;36;Tarragonès;43148;Tarragona;8;12;U;;703;79;170;225;478;1;1;223;224
43;Tarragona;36;Tarragonès;43148;Tarragona;8;13;U;;669;125;231;340;329;0;3;337;340
43;Tarragona;36;Tarragonès;43148;Tarragona;8;2;A;;504;127;226;264;240;0;0;264;264
43;Tarragona;36;Tarragonès;43148;Tarragona;8;2;B;;551;144;237;286;265;0;3;283;286
43;Tarragona;36;Tarragonès;43148;Tarragona;8;3;A;;560;122;214;281;279;1;0;280;280
43;Tarragona;36;Tarragonès;43148;Tarragona;8;3;B;;621;160;254;316;305;4;3;309;312
43;Tarragona;36;Tarragonès;43148;Tarragona;8;3;C;;605;153;256;320;285;2;2;316;318
43;Tarragona;36;Tarragonès;43148;Tarragona;8;4;A;;570;139;256;322;248;0;5;317;322
43;Tarragona;36;Tarragonès;43148;Tarragona;8;4;B;;583;138;253;327;256;0;2;325;327
43;Tarragona;36;Tarragonès;43148;Tarragona;8;5;A;;467;115;185;234;233;2;0;232;232
43;Tarragona;36;Tarragonès;43148;Tarragona;8;5;B;;617;140;257;327;290;3;8;316;324
43;Tarragona;36;Tarragonès;43148;Tarragona;8;6;A;;604;143;325;338;266;0;5;333;338
43;Tarragona;36;Tarragonès;43148;Tarragona;8;6;B;;702;160;309;408;294;1;6;401;407
43;Tarragona;36;Tarragonès;43148;Tarragona;8;7;A;;712;135;267;358;354;1;7;350;357
43;Tarragona;36;Tarragonès;43148;Tarragona;8;7;B;;721;151;282;377;344;0;7;370;377
43;Tarragona;36;Tarragonès;43148;Tarragona;8;8;A;;497;53;141;203;294;3;2;198;200
43;Tarragona;36;Tarragonès;43148;Tarragona;8;8;B;;643;55;167;242;401;3;1;238;239
43;Tarragona;36;Tarragonès;43148;Tarragona;8;9;A;;512;115;210;285;227;0;1;284;285
43;Tarragona;36;Tarragonès;43148;Tarragona;8;9;B;;599;100;215;304;295;0;4;300;304
43;Tarragona;36;Tarragonès;43148;Tarragona;9;1;A;;431;87;166;226;205;0;1;225;226
43;Tarragona;36;Tarragonès;43148;Tarragona;9;1;B;;516;113;187;245;271;0;0;245;245
43;Tarragona;36;Tarragonès;43148;Tarragona;9;10;A;;415;90;138;180;235;0;0;180;180
43;Tarragona;36;Tarragonès;43148;Tarragona;9;10;B;;507;101;177;243;264;0;3;240;243
43;Tarragona;36;Tarragonès;43148;Tarragona;9;2;A;;456;89;168;217;239;0;0;217;217
43;Tarragona;36;Tarragonès;43148;Tarragona;9;2;B;;479;113;198;260;219;0;1;259;260
43;Tarragona;36;Tarragonès;43148;Tarragona;9;3;A;;384;74;128;182;202;0;2;180;182
43;Tarragona;36;Tarragonès;43148;Tarragona;9;3;B;;490;127;207;257;233;0;0;257;257
43;Tarragona;36;Tarragonès;43148;Tarragona;9;4;A;;475;121;181;241;234;1;3;237;240
43;Tarragona;36;Tarragonès;43148;Tarragona;9;4;B;;602;135;230;314;288;0;0;314;314
43;Tarragona;36;Tarragonès;43148;Tarragona;9;5;A;;406;134;209;269;137;1;2;266;268
43;Tarragona;36;Tarragonès;43148;Tarragona;9;5;B;;500;125;241;290;210;0;1;289;290
43;Tarragona;36;Tarragonès;43148;Tarragona;9;6;A;;539;150;271;353;186;0;1;352;353
43;Tarragona;36;Tarragonès;43148;Tarragona;9;6;B;;641;160;300;383;258;0;1;382;383
43;Tarragona;36;Tarragonès;43148;Tarragona;9;6;C;;609;167;283;377;232;0;3;374;377
43;Tarragona;36;Tarragonès;43148;Tarragona;9;7;U;;758;182;401;498;260;1;5;492;497
43;Tarragona;36;Tarragonès;43148;Tarragona;9;8;U;;716;155;295;378;338;1;3;374;377
43;Tarragona;36;Tarragonès;43148;Tarragona;9;9;U;;646;148;250;351;295;1;2;348;350
25;Lleida;38;Urgell;25217;Tàrrega;1;1;A;;531;123;222;317;214;0;3;314;317
25;Lleida;38;Urgell;25217;Tàrrega;1;1;B;;653;145;294;400;253;2;2;396;398
25;Lleida;38;Urgell;25217;Tàrrega;1;2;U;;684;152;322;433;251;0;6;427;433
25;Lleida;38;Urgell;25217;Tàrrega;2;1;U;;891;206;445;567;324;4;10;553;563
25;Lleida;38;Urgell;25217;Tàrrega;2;2;A;;914;224;410;557;357;4;9;544;553
25;Lleida;38;Urgell;25217;Tàrrega;2;2;B;;1071;220;454;668;403;4;13;651;664
25;Lleida;38;Urgell;25217;Tàrrega;3;1;A;;528;109;209;301;227;0;3;298;301
25;Lleida;38;Urgell;25217;Tàrrega;3;1;B;;669;139;262;395;274;0;3;392;395
25;Lleida;38;Urgell;25217;Tàrrega;3;2;U;;733;169;355;467;266;2;4;461;465
25;Lleida;38;Urgell;25217;Tàrrega;3;3;U;;835;191;398;541;294;3;8;530;538
25;Lleida;38;Urgell;25217;Tàrrega;4;1;U;;743;178;358;467;276;2;7;458;465
25;Lleida;38;Urgell;25217;Tàrrega;4;2;A;;534;112;285;364;170;0;7;357;364
25;Lleida;38;Urgell;25217;Tàrrega;4;2;B;;627;152;306;432;195;2;9;421;430
25;Lleida;38;Urgell;25217;Tàrrega;5;1;A;;375;79;204;250;125;1;3;246;249
25;Lleida;38;Urgell;25217;Tàrrega;5;1;B;;208;55;99;138;70;0;6;132;138
25;Lleida;18;Garrigues;25218;Tarrés;1;1;U;;89;34;55;71;18;0;0;71;71
25;Lleida;32;Segarra;25219;Tarroja de Segarra;1;1;U;;157;31;84;112;45;4;3;105;108
8;Barcelona;24;Osona;08275;Tavèrnoles;1;1;U;;222;65;118;174;48;1;1;172;173
8;Barcelona;24;Osona;08280;Tavertet;1;1;U;;126;40;72;90;36;0;1;89;90
8;Barcelona;21;Maresme;08281;Teià;1;1;A;;677;182;371;471;206;1;5;465;470
8;Barcelona;21;Maresme;08281;Teià;1;1;B;;781;218;439;555;226;2;3;550;553
8;Barcelona;21;Maresme;08281;Teià;1;2;A;;609;157;324;443;166;0;3;440;443
8;Barcelona;21;Maresme;08281;Teià;1;2;B;;666;176;341;460;206;0;6;454;460
8;Barcelona;21;Maresme;08281;Teià;1;3;A;;646;165;316;431;215;0;3;428;431
8;Barcelona;21;Maresme;08281;Teià;1;3;B;;682;168;318;423;259;1;8;414;422
25;Lleida;23;Noguera;25220;Térmens;1;1;A;;511;98;249;335;176;2;3;330;333
25;Lleida;23;Noguera;25220;Térmens;1;1;B;;672;134;349;471;201;1;3;467;470
17;Girona;2;Alt Empordà;17196;Terrades;1;1;U;;171;55;97;114;57;2;4;108;112
8;Barcelona;40;Vallès Occidental;08279;Terrassa;1;1;A;;586;156;340;426;160;0;4;422;426
8;Barcelona;40;Vallès Occidental;08279;Terrassa;1;1;B;;571;178;339;425;146;0;7;418;425
8;Barcelona;40;Vallès Occidental;08279;Terrassa;1;10;U;;656;147;322;435;221;0;3;432;435
8;Barcelona;40;Vallès Occidental;08279;Terrassa;1;11;U;;791;183;382;487;304;1;5;481;486
8;Barcelona;40;Vallès Occidental;08279;Terrassa;1;12;A;;736;166;321;432;304;1;3;428;431
8;Barcelona;40;Vallès Occidental;08279;Terrassa;1;12;B;;859;165;367;490;369;0;0;490;490
8;Barcelona;40;Vallès Occidental;08279;Terrassa;1;12;C;;801;163;352;470;331;2;4;464;468
8;Barcelona;40;Vallès Occidental;08279;Terrassa;1;13;U;;618;161;268;357;261;0;5;352;357
8;Barcelona;40;Vallès Occidental;08279;Terrassa;1;14;A;;498;103;203;290;208;0;2;288;290
8;Barcelona;40;Vallès Occidental;08279;Terrassa;1;14;B;;621;127;265;352;269;0;8;344;352
8;Barcelona;40;Vallès Occidental;08279;Terrassa;1;14;C;;632;147;274;352;280;0;1;351;352
8;Barcelona;40;Vallès Occidental;08279;Terrassa;1;15;A;;860;215;396;529;331;1;2;526;528
8;Barcelona;40;Vallès Occidental;08279;Terrassa;1;15;B;;1154;270;502;702;452;0;4;698;702
8;Barcelona;40;Vallès Occidental;08279;Terrassa;1;16;A;;840;190;441;564;276;0;3;561;564
8;Barcelona;40;Vallès Occidental;08279;Terrassa;1;16;B;;983;235;504;648;335;1;8;639;647
8;Barcelona;40;Vallès Occidental;08279;Terrassa;1;17;A;;787;196;430;534;253;1;10;523;533
8;Barcelona;40;Vallès Occidental;08279;Terrassa;1;17;B;;991;268;555;706;285;1;7;698;705
8;Barcelona;40;Vallès Occidental;08279;Terrassa;1;18;U;;392;103;200;253;139;0;4;249;253
8;Barcelona;40;Vallès Occidental;08279;Terrassa;1;2;A;;515;147;286;368;147;0;3;365;368
8;Barcelona;40;Vallès Occidental;08279;Terrassa;1;2;B;;578;166;329;411;167;1;10;400;410
8;Barcelona;40;Vallès Occidental;08279;Terrassa;1;4;A;;534;141;300;397;137;1;1;395;396
8;Barcelona;40;Vallès Occidental;08279;Terrassa;1;4;B;;566;154;287;381;185;3;10;368;378
8;Barcelona;40;Vallès Occidental;08279;Terrassa;1;5;A;;807;197;418;543;264;0;2;541;543
8;Barcelona;40;Vallès Occidental;08279;Terrassa;1;5;B;;936;204;461;603;333;0;5;598;603
8;Barcelona;40;Vallès Occidental;08279;Terrassa;1;6;A;;754;161;386;534;220;2;7;525;532
8;Barcelona;40;Vallès Occidental;08279;Terrassa;1;6;B;;831;184;436;580;251;0;6;574;580
8;Barcelona;40;Vallès Occidental;08279;Terrassa;1;7;A;;548;128;305;388;160;1;2;385;387
8;Barcelona;40;Vallès Occidental;08279;Terrassa;1;7;B;;590;139;288;418;172;0;3;415;418
8;Barcelona;40;Vallès Occidental;08279;Terrassa;1;8;U;;883;254;439;568;315;3;3;562;565
8;Barcelona;40;Vallès Occidental;08279;Terrassa;1;9;U;;792;197;404;526;266;0;11;515;526
8;Barcelona;40;Vallès Occidental;08279;Terrassa;2;1;A;;566;151;257;339;227;0;2;337;339
8;Barcelona;40;Vallès Occidental;08279;Terrassa;2;1;B;;780;181;314;436;344;0;2;434;436
8;Barcelona;40;Vallès Occidental;08279;Terrassa;2;10;U;;524;130;239;294;230;1;3;290;293
8;Barcelona;40;Vallès Occidental;08279;Terrassa;2;11;U;;771;185;310;408;363;0;5;403;408
8;Barcelona;40;Vallès Occidental;08279;Terrassa;2;12;A;;443;106;205;269;174;1;4;264;268
8;Barcelona;40;Vallès Occidental;08279;Terrassa;2;12;B;;539;130;260;312;227;1;3;308;311
8;Barcelona;40;Vallès Occidental;08279;Terrassa;2;14;A;;555;90;203;270;285;0;1;269;270
8;Barcelona;40;Vallès Occidental;08279;Terrassa;2;14;B;;728;133;265;343;385;0;4;339;343
8;Barcelona;40;Vallès Occidental;08279;Terrassa;2;15;U;;775;107;230;303;472;0;2;301;303
8;Barcelona;40;Vallès Occidental;08279;Terrassa;2;2;A;;472;131;191;241;231;0;3;238;241
8;Barcelona;40;Vallès Occidental;08279;Terrassa;2;2;B;;584;158;233;299;285;2;1;296;297
8;Barcelona;40;Vallès Occidental;08279;Terrassa;2;3;U;;774;190;326;441;333;1;3;437;440
8;Barcelona;40;Vallès Occidental;08279;Terrassa;2;4;A;;483;137;207;252;231;1;4;247;251
8;Barcelona;40;Vallès Occidental;08279;Terrassa;2;4;B;;644;170;299;366;278;0;8;358;366
8;Barcelona;40;Vallès Occidental;08279;Terrassa;2;5;A;;469;122;208;265;204;1;4;260;264
8;Barcelona;40;Vallès Occidental;08279;Terrassa;2;5;B;;570;134;252;321;249;2;4;315;319
8;Barcelona;40;Vallès Occidental;08279;Terrassa;2;6;U;;840;230;380;502;338;5;0;497;497
8;Barcelona;40;Vallès Occidental;08279;Terrassa;2;7;U;;526;217;250;318;208;0;2;316;318
8;Barcelona;40;Vallès Occidental;08279;Terrassa;2;8;U;;857;157;352;476;381;7;9;460;469
8;Barcelona;40;Vallès Occidental;08279;Terrassa;2;9;U;;753;201;324;420;333;0;4;416;420
8;Barcelona;40;Vallès Occidental;08279;Terrassa;3;1;U;;976;255;430;599;377;2;11;586;597
8;Barcelona;40;Vallès Occidental;08279;Terrassa;3;10;A;;803;119;254;357;446;0;2;355;357
8;Barcelona;40;Vallès Occidental;08279;Terrassa;3;10;B;;1030;157;317;448;582;1;1;446;447
8;Barcelona;40;Vallès Occidental;08279;Terrassa;3;11;A;;547;99;189;254;293;0;2;252;254
8;Barcelona;40;Vallès Occidental;08279;Terrassa;3;11;B;;766;102;204;273;493;0;3;270;273
8;Barcelona;40;Vallès Occidental;08279;Terrassa;3;12;A;;705;149;265;356;349;0;2;354;356
8;Barcelona;40;Vallès Occidental;08279;Terrassa;3;12;B;;818;169;321;428;390;1;6;421;427
8;Barcelona;40;Vallès Occidental;08279;Terrassa;3;13;U;;620;124;233;314;306;3;1;310;311
8;Barcelona;40;Vallès Occidental;08279;Terrassa;3;14;A;;588;106;210;287;301;0;3;284;287
8;Barcelona;40;Vallès Occidental;08279;Terrassa;3;14;B;;744;129;251;360;384;0;2;358;360
8;Barcelona;40;Vallès Occidental;08279;Terrassa;3;15;U;;850;144;331;467;383;0;2;465;467
8;Barcelona;40;Vallès Occidental;08279;Terrassa;3;16;U;;883;157;299;443;440;0;3;440;443
8;Barcelona;40;Vallès Occidental;08279;Terrassa;3;17;A;;528;81;190;272;256;0;1;271;272
8;Barcelona;40;Vallès Occidental;08279;Terrassa;3;17;B;;645;100;222;332;313;0;3;329;332
8;Barcelona;40;Vallès Occidental;08279;Terrassa;3;18;U;;701;107;245;332;369;0;4;328;332
8;Barcelona;40;Vallès Occidental;08279;Terrassa;3;19;A;;499;113;207;266;233;0;0;266;266
8;Barcelona;40;Vallès Occidental;08279;Terrassa;3;19;B;;659;144;275;346;313;0;2;344;346
8;Barcelona;40;Vallès Occidental;08279;Terrassa;3;2;A;;622;125;265;369;253;0;1;368;369
8;Barcelona;40;Vallès Occidental;08279;Terrassa;3;2;B;;650;138;282;367;283;1;4;362;366
8;Barcelona;40;Vallès Occidental;08279;Terrassa;3;2;C;;733;180;340;456;277;1;5;450;455
8;Barcelona;40;Vallès Occidental;08279;Terrassa;3;3;A;;459;94;199;242;217;1;4;237;241
8;Barcelona;40;Vallès Occidental;08279;Terrassa;3;3;B;;611;114;224;309;302;1;4;304;308
8;Barcelona;40;Vallès Occidental;08279;Terrassa;3;4;U;;882;171;312;456;426;1;5;450;455
8;Barcelona;40;Vallès Occidental;08279;Terrassa;3;5;A;;474;126;211;270;204;0;2;268;270
8;Barcelona;40;Vallès Occidental;08279;Terrassa;3;5;B;;644;172;297;366;278;2;4;360;364
8;Barcelona;40;Vallès Occidental;08279;Terrassa;3;6;U;;838;241;466;586;252;0;1;585;586
8;Barcelona;40;Vallès Occidental;08279;Terrassa;3;7;U;;879;194;409;536;343;2;2;532;534
8;Barcelona;40;Vallès Occidental;08279;Terrassa;3;8;A;;688;165;277;361;327;4;5;352;357
8;Barcelona;40;Vallès Occidental;08279;Terrassa;3;8;B;;882;165;315;438;444;1;1;436;437
8;Barcelona;40;Vallès Occidental;08279;Terrassa;3;9;U;;1017;276;462;600;417;2;6;592;598
8;Barcelona;40;Vallès Occidental;08279;Terrassa;4;1;A;;500;128;269;351;149;5;3;343;346
8;Barcelona;40;Vallès Occidental;08279;Terrassa;4;1;B;;561;136;286;389;172;0;5;384;389
8;Barcelona;40;Vallès Occidental;08279;Terrassa;4;10;U;;667;181;294;375;292;0;1;374;375
8;Barcelona;40;Vallès Occidental;08279;Terrassa;4;11;U;;596;135;245;332;264;0;2;330;332
8;Barcelona;40;Vallès Occidental;08279;Terrassa;4;12;A;;491;117;211;281;210;0;3;278;281
8;Barcelona;40;Vallès Occidental;08279;Terrassa;4;12;B;;611;130;265;356;255;0;4;352;356
8;Barcelona;40;Vallès Occidental;08279;Terrassa;4;13;A;;500;119;213;309;191;2;3;304;307
8;Barcelona;40;Vallès Occidental;08279;Terrassa;4;13;B;;583;135;274;359;224;2;1;356;357
8;Barcelona;40;Vallès Occidental;08279;Terrassa;4;14;A;;829;230;454;585;244;1;4;580;584
8;Barcelona;40;Vallès Occidental;08279;Terrassa;4;14;B;;873;213;475;611;262;0;3;608;611
8;Barcelona;40;Vallès Occidental;08279;Terrassa;4;15;U;;950;205;458;624;326;0;6;618;624
8;Barcelona;40;Vallès Occidental;08279;Terrassa;4;16;A;;455;107;251;325;130;0;5;320;325
8;Barcelona;40;Vallès Occidental;08279;Terrassa;4;16;B;;516;135;265;366;150;0;3;363;366
8;Barcelona;40;Vallès Occidental;08279;Terrassa;4;17;U;;797;187;395;534;263;1;7;526;533
8;Barcelona;40;Vallès Occidental;08279;Terrassa;4;18;A;;632;177;298;418;214;1;4;413;417
8;Barcelona;40;Vallès Occidental;08279;Terrassa;4;18;B;;840;212;404;561;279;1;7;553;560
8;Barcelona;40;Vallès Occidental;08279;Terrassa;4;19;A;;528;108;221;302;226;0;0;302;302
8;Barcelona;40;Vallès Occidental;08279;Terrassa;4;19;B;;520;108;233;298;222;0;2;296;298
8;Barcelona;40;Vallès Occidental;08279;Terrassa;4;2;A;;591;140;288;373;218;2;4;367;371
8;Barcelona;40;Vallès Occidental;08279;Terrassa;4;2;B;;628;150;325;411;217;0;4;407;411
8;Barcelona;40;Vallès Occidental;08279;Terrassa;4;20;U;;704;155;257;348;356;0;1;347;348
8;Barcelona;40;Vallès Occidental;08279;Terrassa;4;21;A;;457;95;176;251;206;0;1;250;251
8;Barcelona;40;Vallès Occidental;08279;Terrassa;4;21;B;;584;133;238;317;267;0;1;316;317
8;Barcelona;40;Vallès Occidental;08279;Terrassa;4;3;A;;496;116;229;319;177;3;5;311;316
8;Barcelona;40;Vallès Occidental;08279;Terrassa;4;3;B;;657;154;284;416;241;2;4;410;414
8;Barcelona;40;Vallès Occidental;08279;Terrassa;4;4;A;;572;139;257;342;230;0;3;339;342
8;Barcelona;40;Vallès Occidental;08279;Terrassa;4;4;B;;592;158;295;370;222;1;4;365;369
8;Barcelona;40;Vallès Occidental;08279;Terrassa;4;5;A;;862;212;401;519;343;0;7;512;519
8;Barcelona;40;Vallès Occidental;08279;Terrassa;4;5;B;;1010;224;431;544;466;1;3;540;543
8;Barcelona;40;Vallès Occidental;08279;Terrassa;4;6;A;;459;117;203;262;197;0;1;261;262
8;Barcelona;40;Vallès Occidental;08279;Terrassa;4;6;B;;589;146;271;349;240;2;7;340;347
8;Barcelona;40;Vallès Occidental;08279;Terrassa;4;7;A;;718;118;260;348;370;0;3;345;348
8;Barcelona;40;Vallès Occidental;08279;Terrassa;4;7;B;;913;182;369;487;426;5;4;478;482
8;Barcelona;40;Vallès Occidental;08279;Terrassa;4;8;A;;1048;177;413;552;496;0;4;548;552
8;Barcelona;40;Vallès Occidental;08279;Terrassa;4;8;B;;809;134;275;400;409;2;2;396;398
8;Barcelona;40;Vallès Occidental;08279;Terrassa;4;8;C;;984;168;364;501;483;2;7;492;499
8;Barcelona;40;Vallès Occidental;08279;Terrassa;4;8;D;;889;158;317;461;428;1;1;459;460
8;Barcelona;40;Vallès Occidental;08279;Terrassa;4;9;U;;647;167;262;320;327;0;1;319;320
8;Barcelona;40;Vallès Occidental;08279;Terrassa;5;1;U;;1107;223;438;611;496;0;7;604;611
8;Barcelona;40;Vallès Occidental;08279;Terrassa;5;10;A;;903;218;396;545;358;0;5;540;545
8;Barcelona;40;Vallès Occidental;08279;Terrassa;5;10;B;;1011;240;453;593;418;0;5;588;593
8;Barcelona;40;Vallès Occidental;08279;Terrassa;5;11;A;;708;120;282;394;314;1;1;392;393
8;Barcelona;40;Vallès Occidental;08279;Terrassa;5;11;B;;881;174;352;515;366;0;4;511;515
8;Barcelona;40;Vallès Occidental;08279;Terrassa;5;12;U;;666;179;302;386;280;1;1;384;385
8;Barcelona;40;Vallès Occidental;08279;Terrassa;5;13;U;;820;177;318;384;436;0;2;382;384
8;Barcelona;40;Vallès Occidental;08279;Terrassa;5;14;A;;400;99;182;232;168;3;2;227;229
8;Barcelona;40;Vallès Occidental;08279;Terrassa;5;14;B;;562;136;267;342;220;1;4;337;341
8;Barcelona;40;Vallès Occidental;08279;Terrassa;5;14;C;;508;146;243;305;203;0;3;302;305
8;Barcelona;40;Vallès Occidental;08279;Terrassa;5;15;A;;743;128;265;382;361;0;6;376;382
8;Barcelona;40;Vallès Occidental;08279;Terrassa;5;15;B;;872;160;307;425;447;1;1;423;424
8;Barcelona;40;Vallès Occidental;08279;Terrassa;5;16;A;;706;158;295;366;340;0;0;366;366
8;Barcelona;40;Vallès Occidental;08279;Terrassa;5;16;B;;953;206;409;525;428;2;3;520;523
8;Barcelona;40;Vallès Occidental;08279;Terrassa;5;17;A;;876;159;321;441;435;0;9;432;441
8;Barcelona;40;Vallès Occidental;08279;Terrassa;5;17;B;;1058;206;380;549;509;0;3;546;549
8;Barcelona;40;Vallès Occidental;08279;Terrassa;5;18;A;;569;118;232;348;221;1;5;342;347
8;Barcelona;40;Vallès Occidental;08279;Terrassa;5;18;B;;715;151;296;418;297;0;7;411;418
8;Barcelona;40;Vallès Occidental;08279;Terrassa;5;19;U;;975;179;351;471;504;0;8;463;471
8;Barcelona;40;Vallès Occidental;08279;Terrassa;5;2;A;;608;101;214;287;321;0;3;284;287
8;Barcelona;40;Vallès Occidental;08279;Terrassa;5;2;B;;814;139;297;406;408;5;2;399;401
8;Barcelona;40;Vallès Occidental;08279;Terrassa;5;20;A;;453;89;190;271;182;0;0;271;271
8;Barcelona;40;Vallès Occidental;08279;Terrassa;5;20;B;;554;109;233;327;227;0;1;326;327
8;Barcelona;40;Vallès Occidental;08279;Terrassa;5;21;A;;649;116;237;372;277;0;3;369;372
8;Barcelona;40;Vallès Occidental;08279;Terrassa;5;21;B;;871;169;343;511;360;0;5;506;511
8;Barcelona;40;Vallès Occidental;08279;Terrassa;5;22;U;;584;149;263;324;260;1;1;322;323
8;Barcelona;40;Vallès Occidental;08279;Terrassa;5;3;A;;676;133;271;375;301;0;4;371;375
8;Barcelona;40;Vallès Occidental;08279;Terrassa;5;3;B;;870;194;374;534;336;1;5;528;533
8;Barcelona;40;Vallès Occidental;08279;Terrassa;5;4;A;;783;200;419;529;254;0;7;522;529
8;Barcelona;40;Vallès Occidental;08279;Terrassa;5;4;B;;931;241;469;623;308;0;6;617;623
8;Barcelona;40;Vallès Occidental;08279;Terrassa;5;5;U;;667;177;304;393;274;0;3;390;393
8;Barcelona;40;Vallès Occidental;08279;Terrassa;5;6;A;;731;161;344;451;280;0;6;445;451
8;Barcelona;40;Vallès Occidental;08279;Terrassa;5;6;B;;844;192;394;532;312;0;3;529;532
8;Barcelona;40;Vallès Occidental;08279;Terrassa;5;7;A;;823;178;387;518;305;1;4;513;517
8;Barcelona;40;Vallès Occidental;08279;Terrassa;5;7;B;;994;213;456;634;360;1;7;626;633
8;Barcelona;40;Vallès Occidental;08279;Terrassa;5;8;A;;671;147;342;457;214;2;9;446;455
8;Barcelona;40;Vallès Occidental;08279;Terrassa;5;8;B;;770;173;351;486;284;0;8;478;486
8;Barcelona;40;Vallès Occidental;08279;Terrassa;5;9;A;;993;236;455;601;392;1;5;595;600
8;Barcelona;40;Vallès Occidental;08279;Terrassa;5;9;B;;1057;223;471;645;412;0;8;637;645
8;Barcelona;40;Vallès Occidental;08279;Terrassa;6;1;U;;1010;253;450;583;427;0;2;581;583
8;Barcelona;40;Vallès Occidental;08279;Terrassa;6;10;A;;813;141;295;408;405;1;4;403;407
8;Barcelona;40;Vallès Occidental;08279;Terrassa;6;10;B;;1028;180;343;479;549;3;4;472;476
8;Barcelona;40;Vallès Occidental;08279;Terrassa;6;11;A;;694;84;178;263;431;1;3;259;262
8;Barcelona;40;Vallès Occidental;08279;Terrassa;6;11;B;;830;123;243;347;483;0;0;347;347
8;Barcelona;40;Vallès Occidental;08279;Terrassa;6;12;A;;444;96;179;243;201;2;1;240;241
8;Barcelona;40;Vallès Occidental;08279;Terrassa;6;12;B;;685;145;450;351;334;3;0;348;348
8;Barcelona;40;Vallès Occidental;08279;Terrassa;6;13;U;;789;192;372;491;298;1;5;485;490
8;Barcelona;40;Vallès Occidental;08279;Terrassa;6;14;U;;921;167;336;452;469;0;0;452;452
8;Barcelona;40;Vallès Occidental;08279;Terrassa;6;16;A;;462;115;186;258;204;2;1;255;256
8;Barcelona;40;Vallès Occidental;08279;Terrassa;6;16;B;;655;136;248;318;337;2;4;312;316
8;Barcelona;40;Vallès Occidental;08279;Terrassa;6;18;U;;633;156;285;358;275;0;4;354;358
8;Barcelona;40;Vallès Occidental;08279;Terrassa;6;19;U;;588;158;287;346;242;0;0;346;346
8;Barcelona;40;Vallès Occidental;08279;Terrassa;6;2;A;;541;134;208;277;264;0;1;276;277
8;Barcelona;40;Vallès Occidental;08279;Terrassa;6;2;B;;766;146;287;397;369;2;4;391;395
8;Barcelona;40;Vallès Occidental;08279;Terrassa;6;20;U;;651;147;277;361;290;0;1;360;361
8;Barcelona;40;Vallès Occidental;08279;Terrassa;6;21;U;;517;138;236;298;219;0;3;295;298
8;Barcelona;40;Vallès Occidental;08279;Terrassa;6;22;U;;482;122;208;259;223;0;0;259;259
8;Barcelona;40;Vallès Occidental;08279;Terrassa;6;23;A;;872;147;316;445;427;3;5;437;442
8;Barcelona;40;Vallès Occidental;08279;Terrassa;6;23;B;;1218;225;454;646;572;0;6;640;646
8;Barcelona;40;Vallès Occidental;08279;Terrassa;6;24;A;;708;127;272;355;353;2;1;352;353
8;Barcelona;40;Vallès Occidental;08279;Terrassa;6;24;B;;995;140;313;419;576;1;4;414;418
8;Barcelona;40;Vallès Occidental;08279;Terrassa;6;25;A;;668;101;230;312;356;0;5;307;312
8;Barcelona;40;Vallès Occidental;08279;Terrassa;6;25;B;;947;171;348;495;452;1;7;487;494
8;Barcelona;40;Vallès Occidental;08279;Terrassa;6;26;U;;862;205;343;450;412;0;5;445;450
8;Barcelona;40;Vallès Occidental;08279;Terrassa;6;27;A;;529;99;222;285;244;0;2;283;285
8;Barcelona;40;Vallès Occidental;08279;Terrassa;6;27;B;;631;113;230;303;328;1;0;302;302
8;Barcelona;40;Vallès Occidental;08279;Terrassa;6;3;A;;634;126;255;339;295;0;3;336;339
8;Barcelona;40;Vallès Occidental;08279;Terrassa;6;3;B;;937;175;348;473;464;0;10;463;473
8;Barcelona;40;Vallès Occidental;08279;Terrassa;6;4;A;;556;144;245;310;246;0;2;308;310
8;Barcelona;40;Vallès Occidental;08279;Terrassa;6;4;B;;620;158;258;329;291;2;3;324;327
8;Barcelona;40;Vallès Occidental;08279;Terrassa;6;5;U;;848;163;420;422;426;0;7;415;422
8;Barcelona;40;Vallès Occidental;08279;Terrassa;6;6;A;;703;132;256;345;358;0;3;342;345
8;Barcelona;40;Vallès Occidental;08279;Terrassa;6;6;B;;908;155;320;426;482;1;3;422;425
8;Barcelona;40;Vallès Occidental;08279;Terrassa;6;8;A;;628;148;268;371;257;0;7;364;371
8;Barcelona;40;Vallès Occidental;08279;Terrassa;6;8;B;;859;192;383;508;351;1;5;502;507
8;Barcelona;40;Vallès Occidental;08279;Terrassa;6;9;A;;407;61;134;213;194;0;1;212;213
8;Barcelona;40;Vallès Occidental;08279;Terrassa;6;9;B;;529;76;186;289;240;0;2;287;289
8;Barcelona;21;Maresme;08282;Tiana;1;1;A;;431;113;240;310;121;0;2;308;310
8;Barcelona;21;Maresme;08282;Tiana;1;1;B;;486;118;281;358;128;0;1;357;358
8;Barcelona;21;Maresme;08282;Tiana;1;2;A;;729;187;378;487;242;1;3;483;486
8;Barcelona;21;Maresme;08282;Tiana;1;2;B;;880;251;474;600;280;0;7;593;600
8;Barcelona;21;Maresme;08282;Tiana;1;3;A;;655;135;331;456;199;1;5;450;455
8;Barcelona;21;Maresme;08282;Tiana;1;3;B;;659;131;316;431;228;1;3;427;430
8;Barcelona;21;Maresme;08282;Tiana;1;3;C;;695;161;373;491;204;1;10;480;490
25;Lleida;26;Pallars Sobirà;25221;Tírvia;1;1;U;;102;21;61;78;24;0;0;78;78
25;Lleida;23;Noguera;25222;Tiurana;1;1;U;;29;12;19;27;2;0;0;27;27
43;Tarragona;9;Baix Ebre;43149;Tivenys;1;1;U;;838;223;425;550;288;0;7;543;550
43;Tarragona;30;Ribera d'Ebre;43150;Tivissa;1;1;A;;568;90;243;377;191;1;2;374;376
43;Tarragona;30;Ribera d'Ebre;43150;Tivissa;1;1;B;;661;116;284;399;262;0;0;399;399
43;Tarragona;30;Ribera d'Ebre;43150;Tivissa;1;1;C;;260;72;150;179;81;0;2;177;179
8;Barcelona;24;Osona;08283;Tona;1;1;A;;528;126;286;360;168;1;1;358;359
8;Barcelona;24;Osona;08283;Tona;1;1;B;;679;140;326;429;250;0;5;424;429
8;Barcelona;24;Osona;08283;Tona;1;2;A;;698;156;371;479;219;1;5;473;478
8;Barcelona;24;Osona;08283;Tona;1;2;B;;707;231;364;462;245;0;0;462;462
8;Barcelona;24;Osona;08283;Tona;1;2;C;;575;215;299;387;188;1;3;383;386
8;Barcelona;24;Osona;08283;Tona;1;3;A;;792;163;384;505;287;4;3;498;501
8;Barcelona;24;Osona;08283;Tona;1;3;B;;864;203;438;565;299;0;5;560;565
25;Lleida;32;Segarra;25223;Torà;1;1;U;;978;265;487;677;301;3;11;663;674
8;Barcelona;21;Maresme;08284;Tordera;1;1;A;;572;137;283;359;213;1;1;357;358
8;Barcelona;21;Maresme;08284;Tordera;1;1;B;;734;197;408;515;219;0;2;513;515
8;Barcelona;21;Maresme;08284;Tordera;1;2;A;;550;127;256;313;237;3;1;309;310
8;Barcelona;21;Maresme;08284;Tordera;1;2;B;;661;162;300;373;288;3;0;370;370
8;Barcelona;21;Maresme;08284;Tordera;1;3;A;;432;98;206;255;177;3;0;252;252
8;Barcelona;21;Maresme;08284;Tordera;1;3;B;;553;147;283;364;189;1;3;360;363
8;Barcelona;21;Maresme;08284;Tordera;1;4;A;;434;110;216;277;157;3;3;271;274
8;Barcelona;21;Maresme;08284;Tordera;1;4;B;;632;166;297;377;255;1;1;375;376
8;Barcelona;21;Maresme;08284;Tordera;2;1;A;;636;150;304;382;254;0;3;379;382
8;Barcelona;21;Maresme;08284;Tordera;2;1;B;;759;154;352;461;298;0;1;460;461
8;Barcelona;21;Maresme;08284;Tordera;2;2;A;;515;120;215;289;226;0;3;286;289
8;Barcelona;21;Maresme;08284;Tordera;2;2;B;;698;149;278;363;335;1;0;362;362
8;Barcelona;21;Maresme;08284;Tordera;2;3;A;;466;113;185;231;235;0;4;227;231
8;Barcelona;21;Maresme;08284;Tordera;2;3;B;;523;121;195;265;258;1;0;264;264
8;Barcelona;24;Osona;08285;Torelló;1;1;A;;372;94;181;238;134;0;1;237;238
8;Barcelona;24;Osona;08285;Torelló;1;1;B;;435;113;195;251;184;1;1;249;250
8;Barcelona;24;Osona;08285;Torelló;1;2;A;;760;182;380;494;266;1;2;491;493
8;Barcelona;24;Osona;08285;Torelló;1;2;B;;759;173;359;482;277;4;0;478;478
8;Barcelona;24;Osona;08285;Torelló;1;4;A;;660;146;339;402;258;0;2;400;402
8;Barcelona;24;Osona;08285;Torelló;1;4;B;;678;150;331;423;255;2;1;420;421
8;Barcelona;24;Osona;08285;Torelló;2;1;A;;647;144;304;424;223;1;5;418;423
8;Barcelona;24;Osona;08285;Torelló;2;1;B;;618;166;309;416;202;1;3;412;415
8;Barcelona;24;Osona;08285;Torelló;2;2;A;;503;127;249;327;176;0;2;325;327
8;Barcelona;24;Osona;08285;Torelló;2;2;B;;508;145;270;333;175;1;3;329;332
8;Barcelona;24;Osona;08285;Torelló;3;1;A;;562;120;273;370;192;0;1;369;370
8;Barcelona;24;Osona;08285;Torelló;3;1;B;;730;165;362;481;249;2;7;472;479
8;Barcelona;24;Osona;08285;Torelló;3;2;A;;624;190;337;406;218;0;0;406;406
8;Barcelona;24;Osona;08285;Torelló;3;2;B;;800;234;453;541;259;2;2;537;539
8;Barcelona;24;Osona;08285;Torelló;3;3;A;;611;137;301;405;206;1;2;402;404
8;Barcelona;24;Osona;08285;Torelló;3;3;B;;782;177;413;522;260;0;8;514;522
25;Lleida;18;Garrigues;25224;Torms, els;1;1;U;;178;33;101;133;45;0;2;131;133
25;Lleida;38;Urgell;25225;Tornabous;1;1;U;;687;143;301;402;285;1;5;396;401
25;Lleida;33;Segrià;25226;Torrebesses;1;1;U;;279;90;160;189;90;1;0;188;188
25;Lleida;25;Pallars Jussà;25227;Torre de Cabdella, la;1;1;U;;617;154;277;357;260;0;3;354;357
8;Barcelona;6;Anoia;08286;Torre de Claramunt, la;1;1;A;;626;146;317;408;218;0;7;401;408
8;Barcelona;6;Anoia;08286;Torre de Claramunt, la;1;1;B;;713;176;339;435;278;1;1;433;434
8;Barcelona;6;Anoia;08286;Torre de Claramunt, la;1;2;U;;523;107;200;258;265;3;1;254;255
43;Tarragona;29;Priorat;43151;Torre de Fontaubella, la;1;1;U;;121;43;74;86;35;0;3;83;86
43;Tarragona;30;Ribera d'Ebre;43152;Torre de l'Espanyol, la;1;1;U;;567;147;337;443;124;1;0;442;442
43;Tarragona;36;Tarragonès;43153;Torredembarra;1;1;A;;519;129;245;311;208;1;2;308;310
43;Tarragona;36;Tarragonès;43153;Torredembarra;1;1;B;;707;165;317;419;288;0;5;414;419
43;Tarragona;36;Tarragonès;43153;Torredembarra;1;2;A;;675;145;284;366;309;1;4;361;365
43;Tarragona;36;Tarragonès;43153;Torredembarra;1;2;B;;806;211;384;491;315;1;2;488;490
43;Tarragona;36;Tarragonès;43153;Torredembarra;1;3;A;;641;187;302;357;284;0;1;356;357
43;Tarragona;36;Tarragonès;43153;Torredembarra;1;3;B;;745;224;352;426;319;2;4;420;424
43;Tarragona;36;Tarragonès;43153;Torredembarra;1;4;A;;609;131;255;354;255;0;3;351;354
43;Tarragona;36;Tarragonès;43153;Torredembarra;1;4;B;;733;178;343;460;273;1;4;455;459
43;Tarragona;36;Tarragonès;43153;Torredembarra;1;5;A;;498;129;241;300;198;0;4;296;300
43;Tarragona;36;Tarragonès;43153;Torredembarra;1;5;B;;636;166;299;362;274;1;3;358;361
43;Tarragona;36;Tarragonès;43153;Torredembarra;1;6;A;;643;166;291;375;268;0;2;373;375
43;Tarragona;36;Tarragonès;43153;Torredembarra;1;6;B;;762;180;336;426;336;0;2;424;426
25;Lleida;33;Segrià;25228;Torrefarrera;1;1;A;;667;193;405;503;164;1;2;500;502
25;Lleida;33;Segrià;25228;Torrefarrera;1;1;B;;752;198;447;551;201;2;3;546;549
25;Lleida;32;Segarra;25907;Torrefeta i Florejacs;1;1;U;;584;106;246;356;228;2;1;353;354
25;Lleida;27;Pla d'Urgell;25230;Torregrossa;1;1;U;;608;156;387;484;124;6;5;473;478
25;Lleida;27;Pla d'Urgell;25230;Torregrossa;1;2;A;;608;154;337;443;165;3;5;435;440
25;Lleida;27;Pla d'Urgell;25230;Torregrossa;1;2;B;;667;177;391;502;165;4;7;491;498
25;Lleida;23;Noguera;25231;Torrelameu;1;1;U;;498;119;301;378;120;1;4;373;377
8;Barcelona;3;Alt Penedès;08287;Torrelavit;1;1;U;;1009;232;532;724;285;2;3;719;722
8;Barcelona;3;Alt Penedès;08288;Torrelles de Foix;1;1;A;;621;162;298;375;246;2;1;372;373
8;Barcelona;3;Alt Penedès;08288;Torrelles de Foix;1;1;B;;773;205;355;458;315;2;0;456;456
8;Barcelona;11;Baix Llobregat;08289;Torrelles de Llobregat;1;1;A;;569;153;283;379;190;0;1;378;379
8;Barcelona;11;Baix Llobregat;08289;Torrelles de Llobregat;1;1;B;;782;209;417;543;239;1;3;539;542
8;Barcelona;11;Baix Llobregat;08289;Torrelles de Llobregat;1;2;A;;662;155;277;350;312;0;1;349;350
8;Barcelona;11;Baix Llobregat;08289;Torrelles de Llobregat;1;2;B;;690;186;313;386;304;1;3;382;385
17;Girona;10;Baix Empordà;17197;Torrent;1;1;U;;130;46;68;90;40;0;0;90;90
25;Lleida;33;Segrià;25232;Torres de Segre;1;1;A;;717;156;393;515;202;1;6;508;514
25;Lleida;33;Segrià;25232;Torres de Segre;1;1;B;;808;159;409;545;263;3;2;540;542
25;Lleida;33;Segrià;25233;Torre-serona;1;1;U;;269;59;130;171;98;0;0;171;171
17;Girona;2;Alt Empordà;17198;Torroella de Fluvià;1;1;U;;245;70;140;171;74;1;2;168;170
17;Girona;10;Baix Empordà;17199;Torroella de Montgrí;1;1;A;;537;140;293;369;168;1;5;363;368
17;Girona;10;Baix Empordà;17199;Torroella de Montgrí;1;1;B;;420;101;209;273;147;1;3;269;272
17;Girona;10;Baix Empordà;17199;Torroella de Montgrí;1;1;C;;487;116;245;321;166;0;2;319;321
17;Girona;10;Baix Empordà;17199;Torroella de Montgrí;1;2;A;;704;171;335;450;254;1;5;444;449
17;Girona;10;Baix Empordà;17199;Torroella de Montgrí;1;2;B;;600;149;280;366;234;1;2;363;365
17;Girona;10;Baix Empordà;17199;Torroella de Montgrí;1;2;C;;650;156;326;423;227;1;2;420;422
17;Girona;10;Baix Empordà;17199;Torroella de Montgrí;1;3;A;;653;140;286;357;296;2;1;354;355
17;Girona;10;Baix Empordà;17199;Torroella de Montgrí;1;3;B;;719;160;282;363;356;1;5;357;362
17;Girona;10;Baix Empordà;17199;Torroella de Montgrí;1;4;A;;656;155;352;448;208;0;3;445;448
17;Girona;10;Baix Empordà;17199;Torroella de Montgrí;1;4;B;;677;145;333;447;230;1;5;441;446
43;Tarragona;29;Priorat;43154;Torroja del Priorat;1;1;U;;131;37;77;92;39;0;1;91;92
17;Girona;19;Garrotxa;17200;Tortellà;1;1;U;;612;236;376;416;196;1;2;413;415
43;Tarragona;9;Baix Ebre;43155;Tortosa;1;1;U;;720;223;328;395;325;4;2;389;391
43;Tarragona;9;Baix Ebre;43155;Tortosa;1;2;U;;413;125;179;235;178;1;3;231;234
43;Tarragona;9;Baix Ebre;43155;Tortosa;1;3;A;;604;167;300;388;216;0;3;385;388
43;Tarragona;9;Baix Ebre;43155;Tortosa;1;3;B;;581;181;272;371;210;0;12;359;371
43;Tarragona;9;Baix Ebre;43155;Tortosa;1;4;A;;682;185;313;412;270;3;4;405;409
43;Tarragona;9;Baix Ebre;43155;Tortosa;1;4;B;;647;151;272;382;265;1;9;372;381
43;Tarragona;9;Baix Ebre;43155;Tortosa;1;5;U;;480;120;176;222;258;3;4;215;219
43;Tarragona;9;Baix Ebre;43155;Tortosa;1;6;A;;526;134;228;310;216;1;4;305;309
43;Tarragona;9;Baix Ebre;43155;Tortosa;1;6;B;;465;129;216;291;174;0;4;287;291
43;Tarragona;9;Baix Ebre;43155;Tortosa;1;7;A;;740;180;337;450;290;2;8;440;448
43;Tarragona;9;Baix Ebre;43155;Tortosa;1;7;B;;743;203;349;458;285;1;4;453;457
43;Tarragona;9;Baix Ebre;43155;Tortosa;2;1;U;;630;145;249;303;327;1;1;301;302
43;Tarragona;9;Baix Ebre;43155;Tortosa;2;2;A;;655;130;260;380;275;2;7;371;378
43;Tarragona;9;Baix Ebre;43155;Tortosa;2;2;B;;565;104;236;331;234;1;5;325;330
43;Tarragona;9;Baix Ebre;43155;Tortosa;2;3;A;;723;152;320;412;311;0;7;405;412
43;Tarragona;9;Baix Ebre;43155;Tortosa;2;3;B;;738;176;306;398;340;3;8;387;395
43;Tarragona;9;Baix Ebre;43155;Tortosa;2;4;U;;814;145;330;407;407;1;11;395;406
43;Tarragona;9;Baix Ebre;43155;Tortosa;2;5;U;;920;231;490;607;313;5;2;600;602
43;Tarragona;9;Baix Ebre;43155;Tortosa;3;1;A;;493;117;176;227;266;0;2;225;227
43;Tarragona;9;Baix Ebre;43155;Tortosa;3;1;B;;381;97;151;179;202;1;1;177;178
43;Tarragona;9;Baix Ebre;43155;Tortosa;3;2;U;;991;243;438;523;468;4;4;515;519
43;Tarragona;9;Baix Ebre;43155;Tortosa;3;3;A;;509;103;194;253;256;4;4;245;249
43;Tarragona;9;Baix Ebre;43155;Tortosa;3;3;B;;447;79;176;220;227;0;1;219;220
43;Tarragona;9;Baix Ebre;43155;Tortosa;3;4;A;;627;117;224;301;326;1;6;294;300
43;Tarragona;9;Baix Ebre;43155;Tortosa;3;4;B;;617;115;211;274;343;0;4;270;274
43;Tarragona;9;Baix Ebre;43155;Tortosa;4;1;A;;839;169;334;426;413;5;1;420;421
43;Tarragona;9;Baix Ebre;43155;Tortosa;4;1;B;;706;173;311;373;333;1;2;370;372
43;Tarragona;9;Baix Ebre;43155;Tortosa;4;2;A;;501;122;218;299;202;2;7;290;297
43;Tarragona;9;Baix Ebre;43155;Tortosa;4;2;B;;392;91;177;226;166;1;6;219;225
43;Tarragona;9;Baix Ebre;43155;Tortosa;4;2;C;;429;113;193;234;195;0;4;230;234
43;Tarragona;9;Baix Ebre;43155;Tortosa;4;3;A;;661;137;242;339;322;2;1;336;337
43;Tarragona;9;Baix Ebre;43155;Tortosa;4;3;B;;609;110;205;291;318;2;6;283;289
43;Tarragona;9;Baix Ebre;43155;Tortosa;4;4;A;;525;120;204;265;260;1;4;260;264
43;Tarragona;9;Baix Ebre;43155;Tortosa;4;4;B;;489;122;190;241;248;1;3;237;240
43;Tarragona;9;Baix Ebre;43155;Tortosa;4;5;U;;1082;245;483;620;462;3;6;611;617
43;Tarragona;9;Baix Ebre;43155;Tortosa;4;6;U;;790;172;336;451;339;3;6;442;448
43;Tarragona;9;Baix Ebre;43155;Tortosa;4;7;A;;523;128;252;322;201;3;3;316;319
43;Tarragona;9;Baix Ebre;43155;Tortosa;4;7;B;;304;67;136;168;136;0;3;165;168
43;Tarragona;9;Baix Ebre;43155;Tortosa;4;8;U;;577;133;243;329;248;2;5;322;327
17;Girona;31;Ripollès;17201;Toses;1;1;U;;119;50;63;71;48;0;0;71;71
17;Girona;34;Selva;17202;Tossa de Mar;1;1;U;;799;240;412;505;294;3;1;501;502
17;Girona;34;Selva;17202;Tossa de Mar;1;2;U;;929;220;460;596;333;5;3;588;591
17;Girona;34;Selva;17202;Tossa de Mar;1;3;A;;760;203;386;501;259;1;2;498;500
17;Girona;34;Selva;17202;Tossa de Mar;1;3;B;;758;180;401;519;239;3;1;515;516
25;Lleida;25;Pallars Jussà;25234;Tremp;1;1;U;;828;160;400;520;308;3;0;517;517
25;Lleida;25;Pallars Jussà;25234;Tremp;1;2;U;;963;180;390;562;401;1;3;558;561
25;Lleida;25;Pallars Jussà;25234;Tremp;2;1;A;;529;154;264;347;182;4;0;343;343
25;Lleida;25;Pallars Jussà;25234;Tremp;2;1;B;;566;114;230;324;242;3;4;317;321
25;Lleida;25;Pallars Jussà;25234;Tremp;2;2;U;;1019;185;435;617;402;6;4;607;611
25;Lleida;25;Pallars Jussà;25234;Tremp;3;1;U;;544;83;212;271;273;0;2;269;271
17;Girona;10;Baix Empordà;17204;Ullà;1;1;A;;339;124;195;237;102;4;3;230;233
17;Girona;10;Baix Empordà;17204;Ullà;1;1;B;;297;102;142;180;117;0;0;180;180
8;Barcelona;40;Vallès Occidental;08290;Ullastrell;1;1;A;;421;126;260;318;103;1;2;315;317
8;Barcelona;40;Vallès Occidental;08290;Ullastrell;1;1;B;;496;142;304;395;101;0;4;391;395
17;Girona;10;Baix Empordà;17205;Ullastret;1;1;U;;210;74;115;145;65;0;0;145;145
43;Tarragona;22;Montsià;43156;Ulldecona;1;1;U;;843;219;403;565;278;1;5;559;564
43;Tarragona;22;Montsià;43156;Ulldecona;1;2;A;;833;235;428;570;263;8;7;555;562
43;Tarragona;22;Montsià;43156;Ulldecona;1;2;B;;937;228;449;651;286;4;4;643;647
43;Tarragona;22;Montsià;43156;Ulldecona;2;1;U;;546;129;283;384;162;1;2;381;383
43;Tarragona;22;Montsià;43156;Ulldecona;2;2;U;;631;152;326;453;178;4;1;448;449
43;Tarragona;22;Montsià;43156;Ulldecona;3;1;U;;485;107;228;294;191;0;1;293;294
43;Tarragona;29;Priorat;43157;Ulldemolins;1;1;U;;453;126;275;359;94;5;3;351;354
17;Girona;10;Baix Empordà;17203;Ultramort;1;1;U;;179;56;110;127;52;1;1;125;126
17;Girona;15;Cerdanya;17206;Urús;1;1;U;;154;48;94;108;46;0;2;106;108
8;Barcelona;40;Vallès Occidental;08291;Vacarisses;1;1;A;;700;192;346;440;260;0;10;430;440
8;Barcelona;40;Vallès Occidental;08291;Vacarisses;1;1;B;;777;173;322;410;367;2;0;408;408
8;Barcelona;40;Vallès Occidental;08291;Vacarisses;1;1;C;;679;304;317;398;281;0;3;395;398
17;Girona;2;Alt Empordà;17014;Vajol, la;1;1;U;;75;26;36;48;27;2;2;44;46
8;Barcelona;6;Anoia;08292;Vallbona d'Anoia;1;1;U;;877;264;532;655;222;0;2;653;655
25;Lleida;38;Urgell;25238;Vallbona de les Monges;1;1;U;;251;72;127;163;88;0;0;163;163
8;Barcelona;14;Berguedà;08293;Vallcebre;1;1;U;;236;53;115;145;91;0;0;145;145
43;Tarragona;16;Conca de Barberà;43158;Vallclara;1;1;U;;99;37;56;69;30;0;0;69;69
17;Girona;19;Garrotxa;17207;Vall d'en Bas, la;1;1;A;;861;273;521;634;227;1;8;625;633
17;Girona;19;Garrotxa;17207;Vall d'en Bas, la;1;1;B;;204;62;148;166;38;0;3;163;166
17;Girona;19;Garrotxa;17207;Vall d'en Bas, la;1;2;A;;830;271;486;593;237;0;3;590;593
17;Girona;19;Garrotxa;17207;Vall d'en Bas, la;1;2;B;;246;80;134;161;85;0;0;161;161
17;Girona;19;Garrotxa;17208;Vall de Bianya, la;1;1;A;;457;120;228;295;162;2;1;292;293
17;Girona;19;Garrotxa;17208;Vall de Bianya, la;1;1;B;;473;155;294;356;117;2;4;350;354
25;Lleida;5;Alta Ribagorça;25043;Vall de Boí, la;1;1;U;;726;147;291;389;337;2;5;382;387
25;Lleida;26;Pallars Sobirà;25901;Vall de Cardós;1;1;U;;269;53;123;185;84;0;4;181;185
25;Lleida;23;Noguera;25240;Vallfogona de Balaguer;1;1;A;;748;142;378;516;232;0;5;511;516
25;Lleida;23;Noguera;25240;Vallfogona de Balaguer;1;1;B;;490;85;225;313;177;1;8;304;312
17;Girona;31;Ripollès;17170;Vallfogona de Ripollès;1;1;U;;196;48;89;117;79;2;3;112;115
43;Tarragona;16;Conca de Barberà;43159;Vallfogona de Riucorb;1;1;U;;156;33;66;73;83;0;2;71;73
8;Barcelona;41;Vallès Oriental;08294;Vallgorguina;1;1;A;;700;208;399;466;234;1;7;458;465
8;Barcelona;41;Vallès Oriental;08294;Vallgorguina;1;1;B;;359;83;170;208;151;0;2;206;208
8;Barcelona;11;Baix Llobregat;08295;Vallirana;1;1;A;;643;156;319;416;227;2;2;412;414
8;Barcelona;11;Baix Llobregat;08295;Vallirana;1;1;B;;622;132;305;405;217;0;0;405;405
8;Barcelona;11;Baix Llobregat;08295;Vallirana;1;2;A;;720;159;341;428;292;2;4;422;426
8;Barcelona;11;Baix Llobregat;08295;Vallirana;1;2;B;;708;167;337;419;289;0;4;415;419
8;Barcelona;11;Baix Llobregat;08295;Vallirana;1;3;A;;585;142;279;350;235;1;2;347;349
8;Barcelona;11;Baix Llobregat;08295;Vallirana;1;3;B;;514;125;235;326;188;0;0;326;326
8;Barcelona;11;Baix Llobregat;08295;Vallirana;1;4;A;;392;66;150;218;174;0;3;215;218
8;Barcelona;11;Baix Llobregat;08295;Vallirana;1;4;B;;311;59;134;183;128;0;3;180;183
8;Barcelona;11;Baix Llobregat;08295;Vallirana;1;5;A;;632;118;245;296;336;0;5;291;296
8;Barcelona;11;Baix Llobregat;08295;Vallirana;1;5;B;;579;128;247;296;283;0;8;288;296
8;Barcelona;11;Baix Llobregat;08295;Vallirana;1;6;A;;470;108;206;258;212;0;4;254;258
8;Barcelona;11;Baix Llobregat;08295;Vallirana;1;6;B;;458;105;190;241;217;1;2;238;240
8;Barcelona;11;Baix Llobregat;08295;Vallirana;1;7;U;;730;144;274;349;381;1;1;347;348
17;Girona;10;Baix Empordà;17209;Vall-llobrega;1;1;U;;290;77;175;214;76;0;4;210;214
43;Tarragona;1;Alt Camp;43160;Vallmoll;1;1;A;;445;123;245;300;145;0;2;298;300
43;Tarragona;1;Alt Camp;43160;Vallmoll;1;1;B;;545;115;246;323;222;0;3;320;323
8;Barcelona;41;Vallès Oriental;08296;Vallromanes;1;1;U;;1059;281;541;719;340;9;2;708;710
43;Tarragona;1;Alt Camp;43161;Valls;1;1;A;;419;116;187;241;178;1;5;235;240
43;Tarragona;1;Alt Camp;43161;Valls;1;1;B;;407;108;188;233;174;0;3;230;233
43;Tarragona;1;Alt Camp;43161;Valls;2;1;A;;348;94;131;184;164;1;1;182;183
43;Tarragona;1;Alt Camp;43161;Valls;2;1;B;;485;119;195;271;214;5;1;265;266
43;Tarragona;1;Alt Camp;43161;Valls;3;1;A;;719;203;345;443;276;3;2;438;440
43;Tarragona;1;Alt Camp;43161;Valls;3;1;B;;850;216;270;502;348;2;4;496;500
43;Tarragona;1;Alt Camp;43161;Valls;4;1;U;;882;290;496;641;241;5;7;629;636
43;Tarragona;1;Alt Camp;43161;Valls;4;2;A;;934;248;431;551;383;4;3;544;547
43;Tarragona;1;Alt Camp;43161;Valls;4;2;B;;359;141;237;281;78;0;2;279;281
43;Tarragona;1;Alt Camp;43161;Valls;4;3;U;;777;175;306;401;376;0;2;399;401
43;Tarragona;1;Alt Camp;43161;Valls;5;1;A;;530;171;282;368;162;2;3;363;366
43;Tarragona;1;Alt Camp;43161;Valls;5;1;B;;532;147;259;344;188;3;0;341;341
43;Tarragona;1;Alt Camp;43161;Valls;5;1;C;;651;218;360;468;183;0;6;462;468
43;Tarragona;1;Alt Camp;43161;Valls;5;2;A;;554;152;260;350;204;0;8;342;350
43;Tarragona;1;Alt Camp;43161;Valls;5;2;B;;539;150;254;343;196;4;2;337;339
43;Tarragona;1;Alt Camp;43161;Valls;5;2;C;;650;175;318;433;217;1;5;427;432
43;Tarragona;1;Alt Camp;43161;Valls;5;3;U;;794;137;282;393;401;1;2;390;392
43;Tarragona;1;Alt Camp;43161;Valls;6;1;A;;798;168;341;473;325;1;6;466;472
43;Tarragona;1;Alt Camp;43161;Valls;6;1;B;;954;247;489;600;354;3;2;595;597
43;Tarragona;1;Alt Camp;43161;Valls;6;2;A;;553;140;292;387;166;1;4;382;386
43;Tarragona;1;Alt Camp;43161;Valls;6;2;B;;644;152;305;427;217;5;6;416;422
43;Tarragona;1;Alt Camp;43161;Valls;6;3;U;;718;207;375;503;215;1;6;496;502
43;Tarragona;1;Alt Camp;43161;Valls;6;4;U;;806;239;374;481;325;6;2;473;475
43;Tarragona;1;Alt Camp;43161;Valls;6;5;A;;741;157;321;448;293;0;4;444;448
43;Tarragona;1;Alt Camp;43161;Valls;6;5;B;;842;193;381;528;314;0;9;519;528
25;Lleida;4;Alt Urgell;25906;Valls d'Aguilar, les;1;1;U;;261;40;106;146;115;3;1;142;143
25;Lleida;4;Alt Urgell;25239;Valls de Valira, les;1;1;U;;620;102;241;299;321;0;1;298;299
43;Tarragona;8;Baix Camp;43162;Vandellòs i l'Hospitalet de l'Infant;1;1;U;;860;199;476;574;286;2;0;572;572
43;Tarragona;8;Baix Camp;43162;Vandellòs i l'Hospitalet de l'Infant;1;2;A;;623;145;265;354;269;1;2;351;353
43;Tarragona;8;Baix Camp;43162;Vandellòs i l'Hospitalet de l'Infant;1;2;B;;587;116;230;304;283;0;6;298;304
43;Tarragona;8;Baix Camp;43162;Vandellòs i l'Hospitalet de l'Infant;1;3;U;;953;235;459;562;391;3;2;557;559
43;Tarragona;8;Baix Camp;43162;Vandellòs i l'Hospitalet de l'Infant;1;4;U;;515;110;204;270;245;3;3;264;267
25;Lleida;4;Alt Urgell;25909;Vansa i Fórnols, la;1;1;U;;141;29;64;80;61;0;0;80;80
8;Barcelona;6;Anoia;08297;Veciana;1;1;U;;132;46;61;88;44;1;0;87;87
43;Tarragona;12;Baix Penedès;43163;Vendrell, el;1;1;A;;781;192;343;467;314;3;7;457;464
43;Tarragona;12;Baix Penedès;43163;Vendrell, el;1;1;B;;837;198;357;513;324;0;3;510;513
43;Tarragona;12;Baix Penedès;43163;Vendrell, el;1;2;U;;848;217;413;536;312;4;7;525;532
43;Tarragona;12;Baix Penedès;43163;Vendrell, el;2;1;U;;953;256;429;557;396;5;14;538;552
43;Tarragona;12;Baix Penedès;43163;Vendrell, el;2;2;A;;542;132;247;325;217;2;2;321;323
43;Tarragona;12;Baix Penedès;43163;Vendrell, el;2;2;B;;742;174;328;414;328;0;1;413;414
43;Tarragona;12;Baix Penedès;43163;Vendrell, el;2;3;A;;578;121;185;278;300;1;0;277;277
43;Tarragona;12;Baix Penedès;43163;Vendrell, el;2;3;B;;758;178;313;436;322;1;3;432;435
43;Tarragona;12;Baix Penedès;43163;Vendrell, el;2;4;A;;737;142;240;353;384;0;2;351;353
43;Tarragona;12;Baix Penedès;43163;Vendrell, el;2;4;B;;883;183;303;398;485;0;5;393;398
43;Tarragona;12;Baix Penedès;43163;Vendrell, el;3;1;A;;518;115;241;327;191;3;4;320;324
43;Tarragona;12;Baix Penedès;43163;Vendrell, el;3;1;B;;612;158;297;391;221;1;5;385;390
43;Tarragona;12;Baix Penedès;43163;Vendrell, el;3;2;A;;532;111;192;252;280;0;1;251;252
43;Tarragona;12;Baix Penedès;43163;Vendrell, el;3;2;B;;602;135;244;327;275;1;2;324;326
43;Tarragona;12;Baix Penedès;43163;Vendrell, el;3;3;A;;772;199;322;412;360;2;5;405;410
43;Tarragona;12;Baix Penedès;43163;Vendrell, el;3;3;B;;866;221;358;452;414;4;5;443;448
43;Tarragona;12;Baix Penedès;43163;Vendrell, el;3;4;A;;584;122;265;372;212;0;2;370;372
43;Tarragona;12;Baix Penedès;43163;Vendrell, el;3;4;B;;747;190;338;460;287;0;4;456;460
43;Tarragona;12;Baix Penedès;43163;Vendrell, el;3;5;U;;957;259;485;633;324;4;7;622;629
43;Tarragona;12;Baix Penedès;43163;Vendrell, el;3;6;A;;505;155;239;308;197;0;2;306;308
43;Tarragona;12;Baix Penedès;43163;Vendrell, el;3;6;B;;622;159;295;399;223;0;3;396;399
43;Tarragona;12;Baix Penedès;43163;Vendrell, el;3;7;A;;555;146;256;315;240;1;2;312;314
43;Tarragona;12;Baix Penedès;43163;Vendrell, el;3;7;B;;626;178;279;342;284;2;3;337;340
43;Tarragona;12;Baix Penedès;43163;Vendrell, el;3;8;U;;784;152;321;453;331;3;5;445;450
17;Girona;2;Alt Empordà;17210;Ventalló;1;1;U;;534;163;263;336;198;1;3;332;335
25;Lleida;38;Urgell;25242;Verdú;1;1;U;;894;220;420;531;363;4;6;521;527
17;Girona;10;Baix Empordà;17211;Verges;1;1;U;;911;260;500;634;277;6;7;621;628
43;Tarragona;36;Tarragonès;43164;Vespella de Gaià;1;1;U;;151;40;78;117;34;0;0;117;117
8;Barcelona;24;Osona;08298;Vic;1;1;U;;525;182;288;346;179;0;9;337;346
8;Barcelona;24;Osona;08298;Vic;1;2;U;;721;173;332;434;287;3;8;423;431
8;Barcelona;24;Osona;08298;Vic;1;3;U;;584;163;304;393;191;2;5;386;391
8;Barcelona;24;Osona;08298;Vic;2;1;U;;688;167;325;421;267;0;4;417;421
8;Barcelona;24;Osona;08298;Vic;2;2;A;;1026;201;491;700;326;3;10;687;697
8;Barcelona;24;Osona;08298;Vic;2;2;B;;1248;280;647;883;365;2;14;867;881
8;Barcelona;24;Osona;08298;Vic;2;3;A;;684;190;366;465;219;2;6;457;463
8;Barcelona;24;Osona;08298;Vic;2;3;B;;852;242;432;543;309;3;7;533;540
8;Barcelona;24;Osona;08298;Vic;2;4;A;;837;180;440;573;264;3;8;562;570
8;Barcelona;24;Osona;08298;Vic;2;4;B;;1066;252;535;712;354;2;1;709;710
8;Barcelona;24;Osona;08298;Vic;3;1;A;;581;187;332;435;146;1;5;429;434
8;Barcelona;24;Osona;08298;Vic;3;1;B;;590;150;316;414;176;1;4;409;413
8;Barcelona;24;Osona;08298;Vic;3;10;U;;576;140;281;378;198;0;3;375;378
8;Barcelona;24;Osona;08298;Vic;3;11;A;;575;141;278;354;221;1;4;349;353
8;Barcelona;24;Osona;08298;Vic;3;11;B;;538;125;253;305;233;0;5;300;305
8;Barcelona;24;Osona;08298;Vic;3;2;U;;787;261;429;512;275;0;4;508;512
8;Barcelona;24;Osona;08298;Vic;3;3;A;;710;172;352;456;254;0;1;455;456
8;Barcelona;24;Osona;08298;Vic;3;3;B;;914;220;450;590;324;0;4;586;590
8;Barcelona;24;Osona;08298;Vic;3;4;U;;889;241;437;532;357;0;3;529;532
8;Barcelona;24;Osona;08298;Vic;3;5;A;;633;138;315;407;226;1;3;403;406
8;Barcelona;24;Osona;08298;Vic;3;5;B;;738;142;327;444;294;2;4;438;442
8;Barcelona;24;Osona;08298;Vic;3;6;A;;559;138;278;357;202;0;4;353;357
8;Barcelona;24;Osona;08298;Vic;3;6;B;;642;168;316;395;247;1;1;393;394
8;Barcelona;24;Osona;08298;Vic;3;7;A;;757;228;443;543;214;1;4;538;542
8;Barcelona;24;Osona;08298;Vic;3;7;B;;859;247;491;642;217;1;2;639;641
8;Barcelona;24;Osona;08298;Vic;3;8;A;;724;141;330;417;307;1;6;410;416
8;Barcelona;24;Osona;08298;Vic;3;8;B;;760;134;319;443;317;1;6;436;442
8;Barcelona;24;Osona;08298;Vic;3;9;U;;776;196;434;553;223;3;5;545;550
8;Barcelona;24;Osona;08298;Vic;4;1;A;;587;167;314;393;194;3;2;388;390
8;Barcelona;24;Osona;08298;Vic;4;1;B;;687;200;343;434;253;1;4;429;433
8;Barcelona;24;Osona;08298;Vic;4;2;A;;625;156;346;430;195;0;5;425;430
8;Barcelona;24;Osona;08298;Vic;4;2;B;;842;176;407;555;287;1;5;549;554
8;Barcelona;24;Osona;08298;Vic;4;3;A;;738;183;358;467;271;1;5;461;466
8;Barcelona;24;Osona;08298;Vic;4;3;B;;1078;330;590;641;437;1;4;636;640
8;Barcelona;24;Osona;08298;Vic;5;1;U;;580;107;320;404;176;3;6;395;401
17;Girona;24;Osona;17212;Vidrà;1;1;U;;137;31;70;96;41;0;4;92;96
17;Girona;34;Selva;17213;Vidreres;1;1;A;;691;150;330;445;246;0;2;443;445
17;Girona;34;Selva;17213;Vidreres;1;1;B;;725;169;360;462;263;0;4;458;462
17;Girona;34;Selva;17213;Vidreres;1;2;U;;841;198;425;554;287;1;3;550;553
17;Girona;34;Selva;17213;Vidreres;1;3;A;;704;155;298;380;324;3;2;375;377
17;Girona;34;Selva;17213;Vidreres;1;3;B;;803;163;329;417;386;1;2;414;416
25;Lleida;39;Consell General d'Aran;25243;Vielha e Mijaran;1;1;A;;639;121;248;351;288;0;2;349;351
25;Lleida;39;Consell General d'Aran;25243;Vielha e Mijaran;1;1;B;;694;139;273;372;322;0;2;370;372
25;Lleida;39;Consell General d'Aran;25243;Vielha e Mijaran;1;2;A;;380;68;152;188;192;0;1;187;188
25;Lleida;39;Consell General d'Aran;25243;Vielha e Mijaran;1;2;B;;474;50;145;221;253;0;1;220;221
25;Lleida;39;Consell General d'Aran;25243;Vielha e Mijaran;1;2;C;;355;48;175;231;124;1;1;229;230
25;Lleida;39;Consell General d'Aran;25243;Vielha e Mijaran;1;3;U;;747;122;274;372;375;1;2;369;371
43;Tarragona;1;Alt Camp;43165;Vilabella;1;1;U;;654;180;388;486;168;0;3;483;486
17;Girona;2;Alt Empordà;17214;Vilabertran;1;1;U;;669;156;373;445;224;0;5;440;445
17;Girona;20;Gironès;17215;Vilablareix;1;1;A;;599;174;333;410;189;1;5;404;409
17;Girona;20;Gironès;17215;Vilablareix;1;1;B;;765;195;398;521;244;0;5;516;521
8;Barcelona;14;Berguedà;08299;Vilada;1;1;U;;494;152;269;340;154;0;4;336;340
17;Girona;2;Alt Empordà;17217;Viladamat;1;1;U;;347;130;226;272;75;0;1;271;272
17;Girona;20;Gironès;17216;Viladasens;1;1;U;;155;50;84;114;41;0;3;111;114
8;Barcelona;11;Baix Llobregat;08301;Viladecans;1;1;A;;838;178;321;423;415;2;1;420;421
8;Barcelona;11;Baix Llobregat;08301;Viladecans;1;1;B;;1025;195;405;517;508;0;8;509;517
8;Barcelona;11;Baix Llobregat;08301;Viladecans;1;10;A;;546;161;245;288;258;1;6;281;287
8;Barcelona;11;Baix Llobregat;08301;Viladecans;1;10;B;;632;164;279;339;293;2;3;334;337
8;Barcelona;11;Baix Llobregat;08301;Viladecans;1;11;U;;986;204;422;543;443;0;5;538;543
8;Barcelona;11;Baix Llobregat;08301;Viladecans;1;12;U;;842;153;308;467;375;0;3;464;467
8;Barcelona;11;Baix Llobregat;08301;Viladecans;1;13;U;;989;175;394;575;414;2;12;561;573
8;Barcelona;11;Baix Llobregat;08301;Viladecans;1;2;A;;566;131;237;286;280;0;2;284;286
8;Barcelona;11;Baix Llobregat;08301;Viladecans;1;2;B;;718;152;273;345;373;0;2;343;345
8;Barcelona;11;Baix Llobregat;08301;Viladecans;1;3;A;;681;193;333;410;271;1;4;405;409
8;Barcelona;11;Baix Llobregat;08301;Viladecans;1;3;B;;725;180;321;430;295;2;1;427;428
8;Barcelona;11;Baix Llobregat;08301;Viladecans;1;4;A;;577;107;223;314;263;0;3;311;314
8;Barcelona;11;Baix Llobregat;08301;Viladecans;1;4;B;;659;149;282;363;296;4;6;353;359
8;Barcelona;11;Baix Llobregat;08301;Viladecans;1;5;U;;592;148;267;351;241;2;3;346;349
8;Barcelona;11;Baix Llobregat;08301;Viladecans;1;6;A;;655;154;289;361;294;0;8;353;361
8;Barcelona;11;Baix Llobregat;08301;Viladecans;1;6;B;;764;161;320;428;336;0;2;426;428
8;Barcelona;11;Baix Llobregat;08301;Viladecans;1;7;A;;561;119;224;298;263;1;7;290;297
8;Barcelona;11;Baix Llobregat;08301;Viladecans;1;7;B;;562;123;214;290;272;0;1;289;290
8;Barcelona;11;Baix Llobregat;08301;Viladecans;1;8;A;;714;190;331;412;302;0;2;410;412
8;Barcelona;11;Baix Llobregat;08301;Viladecans;1;8;B;;922;197;368;470;452;3;3;464;467
8;Barcelona;11;Baix Llobregat;08301;Viladecans;1;9;U;;924;194;348;509;415;0;6;503;509
8;Barcelona;11;Baix Llobregat;08301;Viladecans;2;1;A;;528;144;225;289;239;0;0;289;289
8;Barcelona;11;Baix Llobregat;08301;Viladecans;2;1;B;;692;188;305;381;311;0;1;380;381
8;Barcelona;11;Baix Llobregat;08301;Viladecans;2;10;A;;544;115;203;267;277;0;0;267;267
8;Barcelona;11;Baix Llobregat;08301;Viladecans;2;10;B;;727;152;260;338;389;1;6;331;337
8;Barcelona;11;Baix Llobregat;08301;Viladecans;2;11;A;;930;172;340;464;466;0;4;460;464
8;Barcelona;11;Baix Llobregat;08301;Viladecans;2;11;B;;1082;187;379;508;574;1;3;504;507
8;Barcelona;11;Baix Llobregat;08301;Viladecans;2;12;A;;589;100;206;291;298;0;1;290;291
8;Barcelona;11;Baix Llobregat;08301;Viladecans;2;12;B;;646;109;226;330;316;0;5;325;330
8;Barcelona;11;Baix Llobregat;08301;Viladecans;2;13;A;;616;103;234;297;319;0;1;296;297
8;Barcelona;11;Baix Llobregat;08301;Viladecans;2;13;B;;710;147;280;378;332;0;4;374;378
8;Barcelona;11;Baix Llobregat;08301;Viladecans;2;14;U;;845;101;203;333;512;3;0;330;330
8;Barcelona;11;Baix Llobregat;08301;Viladecans;2;15;A;;758;133;283;373;385;0;3;370;373
8;Barcelona;11;Baix Llobregat;08301;Viladecans;2;15;B;;893;153;299;388;505;0;2;386;388
8;Barcelona;11;Baix Llobregat;08301;Viladecans;2;16;A;;882;151;346;476;406;0;4;472;476
8;Barcelona;11;Baix Llobregat;08301;Viladecans;2;16;B;;1123;196;415;594;529;1;9;584;593
8;Barcelona;11;Baix Llobregat;08301;Viladecans;2;17;A;;973;146;367;516;457;2;5;509;514
8;Barcelona;11;Baix Llobregat;08301;Viladecans;2;17;B;;1172;207;403;583;589;0;7;576;583
8;Barcelona;11;Baix Llobregat;08301;Viladecans;2;18;U;;921;179;331;461;460;0;3;458;461
8;Barcelona;11;Baix Llobregat;08301;Viladecans;2;19;U;;734;130;268;373;361;2;6;365;371
8;Barcelona;11;Baix Llobregat;08301;Viladecans;2;2;U;;838;138;236;344;494;2;1;341;342
8;Barcelona;11;Baix Llobregat;08301;Viladecans;2;20;A;;563;123;232;306;257;2;2;302;304
8;Barcelona;11;Baix Llobregat;08301;Viladecans;2;20;B;;769;157;300;427;342;0;5;422;427
8;Barcelona;11;Baix Llobregat;08301;Viladecans;2;21;U;;947;164;329;445;502;1;3;441;444
8;Barcelona;11;Baix Llobregat;08301;Viladecans;2;22;U;;997;196;381;530;467;0;1;529;530
8;Barcelona;11;Baix Llobregat;08301;Viladecans;2;3;A;;740;149;319;414;326;0;3;411;414
8;Barcelona;11;Baix Llobregat;08301;Viladecans;2;3;B;;867;176;376;494;373;0;5;489;494
8;Barcelona;11;Baix Llobregat;08301;Viladecans;2;4;U;;929;163;319;449;480;1;4;444;448
8;Barcelona;11;Baix Llobregat;08301;Viladecans;2;5;A;;845;154;332;474;371;0;9;465;474
8;Barcelona;11;Baix Llobregat;08301;Viladecans;2;5;B;;1096;206;447;631;465;1;9;621;630
8;Barcelona;11;Baix Llobregat;08301;Viladecans;2;6;A;;497;90;182;247;250;0;4;243;247
8;Barcelona;11;Baix Llobregat;08301;Viladecans;2;6;B;;654;151;253;343;311;1;1;341;342
8;Barcelona;11;Baix Llobregat;08301;Viladecans;2;7;A;;535;111;195;271;264;0;1;270;271
8;Barcelona;11;Baix Llobregat;08301;Viladecans;2;7;B;;643;159;523;335;308;0;3;332;335
8;Barcelona;11;Baix Llobregat;08301;Viladecans;2;8;A;;796;139;318;415;381;0;4;411;415
8;Barcelona;11;Baix Llobregat;08301;Viladecans;2;8;B;;1021;181;392;551;470;0;7;544;551
8;Barcelona;11;Baix Llobregat;08301;Viladecans;2;9;A;;624;99;224;292;332;1;2;289;291
8;Barcelona;11;Baix Llobregat;08301;Viladecans;2;9;B;;686;10;229;306;380;0;5;301;306
8;Barcelona;40;Vallès Occidental;08300;Viladecavalls;1;1;A;;663;192;351;454;209;1;5;448;453
8;Barcelona;40;Vallès Occidental;08300;Viladecavalls;1;1;B;;579;152;301;396;183;1;2;393;395
8;Barcelona;40;Vallès Occidental;08300;Viladecavalls;1;1;C;;690;180;349;446;244;0;2;444;446
8;Barcelona;40;Vallès Occidental;08300;Viladecavalls;1;2;A;;567;122;220;301;266;0;0;301;301
8;Barcelona;40;Vallès Occidental;08300;Viladecavalls;1;2;B;;739;142;290;400;339;1;5;394;399
8;Barcelona;40;Vallès Occidental;08300;Viladecavalls;1;2;C;;710;130;276;387;323;0;4;383;387
8;Barcelona;40;Vallès Occidental;08300;Viladecavalls;1;2;D;;514;102;212;280;234;0;1;279;280
17;Girona;28;Pla de l'Estany;17218;Vilademuls;1;1;A;;293;98;158;189;104;0;4;185;189
17;Girona;28;Pla de l'Estany;17218;Vilademuls;1;1;B;;331;95;205;255;76;1;1;253;254
17;Girona;24;Osona;17220;Viladrau;1;1;U;;761;210;390;522;239;3;6;513;519
17;Girona;2;Alt Empordà;17221;Vilafant;1;1;A;;819;198;429;539;280;1;6;532;538
17;Girona;2;Alt Empordà;17221;Vilafant;1;1;B;;680;144;278;373;307;0;3;370;373
17;Girona;2;Alt Empordà;17221;Vilafant;1;2;A;;673;136;316;432;241;0;1;431;432
17;Girona;2;Alt Empordà;17221;Vilafant;1;2;B;;863;176;381;541;322;0;3;538;541
8;Barcelona;3;Alt Penedès;08305;Vilafranca del Penedès;1;1;A;;735;176;310;449;286;2;1;446;447
8;Barcelona;3;Alt Penedès;08305;Vilafranca del Penedès;1;1;B;;885;231;413;541;344;0;2;539;541
8;Barcelona;3;Alt Penedès;08305;Vilafranca del Penedès;1;2;A;;928;201;426;509;419;1;4;504;508
8;Barcelona;3;Alt Penedès;08305;Vilafranca del Penedès;1;2;B;;1053;267;486;635;418;0;2;633;635
8;Barcelona;3;Alt Penedès;08305;Vilafranca del Penedès;2;1;A;;869;217;381;500;369;1;3;496;499
8;Barcelona;3;Alt Penedès;08305;Vilafranca del Penedès;2;1;B;;1059;254;449;599;460;3;2;594;596
8;Barcelona;3;Alt Penedès;08305;Vilafranca del Penedès;2;2;A;;461;118;207;274;187;2;0;272;272
8;Barcelona;3;Alt Penedès;08305;Vilafranca del Penedès;2;2;B;;650;153;272;380;270;2;2;376;378
8;Barcelona;3;Alt Penedès;08305;Vilafranca del Penedès;2;3;A;;547;150;246;322;225;0;1;321;322
8;Barcelona;3;Alt Penedès;08305;Vilafranca del Penedès;2;3;B;;619;180;294;371;248;0;4;367;371
8;Barcelona;3;Alt Penedès;08305;Vilafranca del Penedès;2;4;A;;609;161;266;355;254;0;3;352;355
8;Barcelona;3;Alt Penedès;08305;Vilafranca del Penedès;2;4;B;;741;189;347;460;281;3;4;453;457
8;Barcelona;3;Alt Penedès;08305;Vilafranca del Penedès;2;5;A;;665;144;322;429;236;0;1;428;429
8;Barcelona;3;Alt Penedès;08305;Vilafranca del Penedès;2;5;B;;862;221;418;563;299;0;6;557;563
8;Barcelona;3;Alt Penedès;08305;Vilafranca del Penedès;2;6;A;;752;188;319;409;343;1;2;406;408
8;Barcelona;3;Alt Penedès;08305;Vilafranca del Penedès;2;6;B;;939;190;367;500;439;1;7;492;499
8;Barcelona;3;Alt Penedès;08305;Vilafranca del Penedès;3;1;A;;742;207;343;477;265;0;1;476;477
8;Barcelona;3;Alt Penedès;08305;Vilafranca del Penedès;3;1;B;;677;199;321;436;241;1;0;435;435
8;Barcelona;3;Alt Penedès;08305;Vilafranca del Penedès;3;1;C;;463;98;198;265;198;2;3;260;263
8;Barcelona;3;Alt Penedès;08305;Vilafranca del Penedès;3;2;U;;985;254;497;645;340;1;10;634;644
8;Barcelona;3;Alt Penedès;08305;Vilafranca del Penedès;3;3;A;;799;176;339;468;331;1;1;466;467
8;Barcelona;3;Alt Penedès;08305;Vilafranca del Penedès;3;3;B;;969;240;404;545;424;1;0;544;544
8;Barcelona;3;Alt Penedès;08305;Vilafranca del Penedès;4;1;A;;630;165;311;417;213;1;4;412;416
8;Barcelona;3;Alt Penedès;08305;Vilafranca del Penedès;4;1;B;;701;166;337;449;252;4;6;439;445
8;Barcelona;3;Alt Penedès;08305;Vilafranca del Penedès;4;2;A;;621;203;312;405;216;1;9;395;404
8;Barcelona;3;Alt Penedès;08305;Vilafranca del Penedès;4;2;B;;717;223;373;486;231;3;1;482;483
8;Barcelona;3;Alt Penedès;08305;Vilafranca del Penedès;4;3;A;;832;206;400;544;288;1;5;538;543
8;Barcelona;3;Alt Penedès;08305;Vilafranca del Penedès;4;3;B;;904;264;475;601;303;1;5;595;600
8;Barcelona;3;Alt Penedès;08305;Vilafranca del Penedès;4;4;A;;574;163;301;384;190;1;2;381;383
8;Barcelona;3;Alt Penedès;08305;Vilafranca del Penedès;4;4;B;;733;215;370;475;258;0;7;468;475
8;Barcelona;3;Alt Penedès;08305;Vilafranca del Penedès;4;5;U;;723;219;378;506;217;2;5;499;504
8;Barcelona;3;Alt Penedès;08305;Vilafranca del Penedès;4;6;U;;1010;315;543;711;299;1;2;708;710
25;Lleida;38;Urgell;25244;Vilagrassa;1;1;U;;362;85;209;275;87;0;2;273;275
17;Girona;2;Alt Empordà;17223;Vilajuïga;1;1;U;;737;205;351;461;276;0;1;460;461
43;Tarragona;37;Terra Alta;43175;Vilalba dels Arcs;1;1;U;;663;163;315;460;203;1;1;458;459
8;Barcelona;41;Vallès Oriental;08306;Vilalba Sasserra;1;1;U;;373;95;180;246;127;1;1;244;245
25;Lleida;5;Alta Ribagorça;25245;Vilaller;1;1;U;;513;105;222;287;226;0;2;285;287
43;Tarragona;36;Tarragonès;43166;Vilallonga del Camp;1;1;U;;1012;211;517;667;345;1;4;662;666
17;Girona;31;Ripollès;17224;Vilallonga de Ter;1;1;U;;373;114;227;273;100;1;0;272;272
17;Girona;2;Alt Empordà;17225;Vilamacolum;1;1;U;;223;59;127;150;73;1;3;146;149
17;Girona;2;Alt Empordà;17226;Vilamalla;1;1;U;;708;140;304;402;306;2;3;397;400
17;Girona;2;Alt Empordà;17227;Vilamaniscle;1;1;U;;94;36;54;67;27;0;0;67;67
25;Lleida;39;Consell General d'Aran;25247;Vilamòs;1;1;U;;105;16;31;50;55;0;1;49;50
17;Girona;2;Alt Empordà;17228;Vilanant;1;1;U;;251;42;116;142;109;1;3;138;141
43;Tarragona;8;Baix Camp;43167;Vilanova d'Escornalbou;1;1;U;;375;96;199;241;134;1;2;238;240
25;Lleida;27;Pla d'Urgell;25248;Vilanova de Bellpuig;1;1;U;;1001;251;519;742;259;6;4;732;736
25;Lleida;23;Noguera;25249;Vilanova de l'Aguda;1;1;U;;234;41;130;161;73;1;1;159;160
25;Lleida;33;Segrià;25254;Vilanova de la Barca;1;1;U;;765;173;397;500;265;4;4;492;496
8;Barcelona;6;Anoia;08302;Vilanova del Camí;1;1;A;;599;153;250;331;268;0;0;331;331
8;Barcelona;6;Anoia;08302;Vilanova del Camí;1;1;B;;656;163;291;354;302;0;0;354;354
8;Barcelona;6;Anoia;08302;Vilanova del Camí;1;2;A;;775;190;349;438;337;0;3;435;438
8;Barcelona;6;Anoia;08302;Vilanova del Camí;1;2;B;;818;184;333;424;394;0;2;422;424
8;Barcelona;6;Anoia;08302;Vilanova del Camí;1;3;A;;705;120;258;366;339;1;1;364;365
8;Barcelona;6;Anoia;08302;Vilanova del Camí;1;3;B;;835;149;300;420;415;0;0;420;420
8;Barcelona;6;Anoia;08302;Vilanova del Camí;1;4;A;;898;178;342;484;414;2;0;482;482
8;Barcelona;6;Anoia;08302;Vilanova del Camí;1;4;B;;995;192;368;506;489;1;2;503;505
8;Barcelona;6;Anoia;08302;Vilanova del Camí;1;5;A;;873;179;317;446;427;1;1;444;445
8;Barcelona;6;Anoia;08302;Vilanova del Camí;1;5;B;;908;184;349;480;428;5;4;471;475
8;Barcelona;41;Vallès Oriental;08902;Vilanova del Vallès;1;1;A;;881;227;446;558;323;0;6;552;558
8;Barcelona;41;Vallès Oriental;08902;Vilanova del Vallès;1;1;B;;946;246;445;583;363;1;7;575;582
25;Lleida;23;Noguera;25250;Vilanova de Meià;1;1;U;;417;85;187;268;149;0;3;265;268
43;Tarragona;16;Conca de Barberà;43168;Vilanova de Prades;1;1;U;;144;35;71;100;44;0;0;100;100
8;Barcelona;24;Osona;08303;Vilanova de Sau;1;1;U;;271;87;158;195;76;0;6;189;195
25;Lleida;33;Segrià;25251;Vilanova de Segrià;1;1;U;;644;145;322;407;237;0;1;406;407
8;Barcelona;17;Garraf;08307;Vilanova i la Geltrú;1;1;A;;815;240;404;520;295;0;0;520;520
8;Barcelona;17;Garraf;08307;Vilanova i la Geltrú;1;1;B;;936;256;406;555;381;0;1;554;555
8;Barcelona;17;Garraf;08307;Vilanova i la Geltrú;1;2;A;;917;258;459;594;323;1;2;591;593
8;Barcelona;17;Garraf;08307;Vilanova i la Geltrú;1;2;B;;1054;281;513;672;382;5;4;663;667
8;Barcelona;17;Garraf;08307;Vilanova i la Geltrú;1;3;A;;830;216;393;521;309;3;2;516;518
8;Barcelona;17;Garraf;08307;Vilanova i la Geltrú;1;3;B;;940;244;468;596;344;0;5;591;596
8;Barcelona;17;Garraf;08307;Vilanova i la Geltrú;1;4;U;;779;234;406;498;281;1;5;492;497
8;Barcelona;17;Garraf;08307;Vilanova i la Geltrú;1;5;U;;746;260;412;507;239;0;3;504;507
8;Barcelona;17;Garraf;08307;Vilanova i la Geltrú;1;6;A;;621;188;311;386;235;1;6;379;385
8;Barcelona;17;Garraf;08307;Vilanova i la Geltrú;1;6;B;;687;194;335;426;261;2;5;419;424
8;Barcelona;17;Garraf;08307;Vilanova i la Geltrú;1;7;A;;594;163;280;340;254;0;2;338;340
8;Barcelona;17;Garraf;08307;Vilanova i la Geltrú;1;7;B;;677;186;294;383;294;1;2;380;382
8;Barcelona;17;Garraf;08307;Vilanova i la Geltrú;1;8;A;;887;220;390;501;386;1;5;495;500
8;Barcelona;17;Garraf;08307;Vilanova i la Geltrú;1;8;B;;1013;275;467;573;440;0;4;569;573
8;Barcelona;17;Garraf;08307;Vilanova i la Geltrú;1;9;A;;918;236;391;508;410;1;4;503;507
8;Barcelona;17;Garraf;08307;Vilanova i la Geltrú;1;9;B;;1040;253;464;578;462;8;1;569;570
8;Barcelona;17;Garraf;08307;Vilanova i la Geltrú;2;1;A;;758;157;332;452;306;0;4;448;452
8;Barcelona;17;Garraf;08307;Vilanova i la Geltrú;2;1;B;;832;198;408;515;317;0;2;513;515
8;Barcelona;17;Garraf;08307;Vilanova i la Geltrú;2;2;A;;854;217;403;520;334;0;2;518;520
8;Barcelona;17;Garraf;08307;Vilanova i la Geltrú;2;2;B;;923;235;413;540;383;1;0;539;539
8;Barcelona;17;Garraf;08307;Vilanova i la Geltrú;2;3;U;;927;244;464;580;347;1;7;572;579
8;Barcelona;17;Garraf;08307;Vilanova i la Geltrú;2;4;A;;775;220;377;462;313;4;6;452;458
8;Barcelona;17;Garraf;08307;Vilanova i la Geltrú;2;4;B;;894;266;468;565;329;1;2;562;564
8;Barcelona;17;Garraf;08307;Vilanova i la Geltrú;2;5;U;;542;107;197;252;290;0;1;251;252
8;Barcelona;17;Garraf;08307;Vilanova i la Geltrú;2;6;A;;644;196;319;407;237;0;2;405;407
8;Barcelona;17;Garraf;08307;Vilanova i la Geltrú;2;6;B;;727;198;309;393;334;0;4;389;393
8;Barcelona;17;Garraf;08307;Vilanova i la Geltrú;2;7;A;;797;217;356;442;355;0;2;440;442
8;Barcelona;17;Garraf;08307;Vilanova i la Geltrú;2;7;B;;935;280;489;501;434;0;3;498;501
8;Barcelona;17;Garraf;08307;Vilanova i la Geltrú;3;1;U;;526;164;263;321;205;0;3;318;321
8;Barcelona;17;Garraf;08307;Vilanova i la Geltrú;3;2;U;;794;275;411;500;294;2;4;494;498
8;Barcelona;17;Garraf;08307;Vilanova i la Geltrú;3;3;U;;748;201;335;436;312;0;0;436;436
8;Barcelona;17;Garraf;08307;Vilanova i la Geltrú;3;4;A;;557;166;260;310;247;0;3;307;310
8;Barcelona;17;Garraf;08307;Vilanova i la Geltrú;3;4;B;;612;159;263;323;289;2;2;319;321
8;Barcelona;17;Garraf;08307;Vilanova i la Geltrú;3;5;U;;1021;187;369;479;542;0;1;478;479
8;Barcelona;17;Garraf;08307;Vilanova i la Geltrú;4;1;U;;956;321;503;625;331;0;2;623;625
8;Barcelona;17;Garraf;08307;Vilanova i la Geltrú;4;10;A;;766;179;326;430;336;1;3;426;429
8;Barcelona;17;Garraf;08307;Vilanova i la Geltrú;4;10;B;;935;194;410;547;388;0;6;541;547
8;Barcelona;17;Garraf;08307;Vilanova i la Geltrú;4;11;A;;737;168;287;385;352;0;3;382;385
8;Barcelona;17;Garraf;08307;Vilanova i la Geltrú;4;11;B;;920;185;366;501;419;0;3;498;501
8;Barcelona;17;Garraf;08307;Vilanova i la Geltrú;4;2;U;;620;221;325;78;542;1;3;74;77
8;Barcelona;17;Garraf;08307;Vilanova i la Geltrú;4;3;A;;745;200;305;403;342;3;3;397;400
8;Barcelona;17;Garraf;08307;Vilanova i la Geltrú;4;3;B;;837;203;316;426;411;0;1;425;426
8;Barcelona;17;Garraf;08307;Vilanova i la Geltrú;4;4;A;;668;201;316;383;285;1;3;379;382
8;Barcelona;17;Garraf;08307;Vilanova i la Geltrú;4;4;B;;862;239;372;482;380;3;3;476;479
8;Barcelona;17;Garraf;08307;Vilanova i la Geltrú;4;5;U;;984;242;447;557;427;1;4;552;556
8;Barcelona;17;Garraf;08307;Vilanova i la Geltrú;4;6;A;;729;200;334;428;301;0;2;426;428
8;Barcelona;17;Garraf;08307;Vilanova i la Geltrú;4;6;B;;913;250;429;538;375;1;5;532;537
8;Barcelona;17;Garraf;08307;Vilanova i la Geltrú;4;7;A;;990;230;428;557;433;3;5;549;554
8;Barcelona;17;Garraf;08307;Vilanova i la Geltrú;4;7;B;;1155;250;483;651;504;2;2;647;649
8;Barcelona;17;Garraf;08307;Vilanova i la Geltrú;4;7;C;;1137;239;465;645;492;0;3;642;645
8;Barcelona;17;Garraf;08307;Vilanova i la Geltrú;4;8;U;;827;204;343;427;400;0;2;425;427
8;Barcelona;17;Garraf;08307;Vilanova i la Geltrú;4;9;U;;1009;258;445;599;410;1;1;597;598
43;Tarragona;8;Baix Camp;43169;Vilaplana;1;1;U;;458;112;276;328;130;0;2;326;328
43;Tarragona;1;Alt Camp;43170;Vila-rodona;1;1;U;;842;175;433;601;241;2;3;596;599
17;Girona;2;Alt Empordà;17230;Vila-sacra;1;1;U;;315;103;212;239;76;0;1;238;239
25;Lleida;27;Pla d'Urgell;25252;Vila-sana;1;1;U;;438;112;224;293;145;1;3;289;292
43;Tarragona;36;Tarragonès;43171;Vila-seca;1;1;A;;755;218;375;500;255;2;6;492;498
43;Tarragona;36;Tarragonès;43171;Vila-seca;1;1;B;;444;103;204;268;176;1;0;267;267
43;Tarragona;36;Tarragonès;43171;Vila-seca;1;2;A;;636;126;263;364;272;1;3;360;363
43;Tarragona;36;Tarragonès;43171;Vila-seca;1;2;B;;893;210;387;540;353;0;2;538;540
43;Tarragona;36;Tarragonès;43171;Vila-seca;1;3;A;;362;80;147;207;155;0;0;207;207
43;Tarragona;36;Tarragonès;43171;Vila-seca;1;3;B;;475;114;184;264;211;1;3;260;263
43;Tarragona;36;Tarragonès;43171;Vila-seca;1;4;A;;353;118;189;232;121;0;2;230;232
43;Tarragona;36;Tarragonès;43171;Vila-seca;1;4;B;;420;140;229;279;141;1;2;276;278
43;Tarragona;36;Tarragonès;43171;Vila-seca;1;5;A;;543;152;259;356;187;1;1;354;355
43;Tarragona;36;Tarragonès;43171;Vila-seca;1;5;B;;623;168;302;395;228;0;5;390;395
43;Tarragona;36;Tarragonès;43171;Vila-seca;1;6;A;;812;169;346;473;339;0;2;471;473
43;Tarragona;36;Tarragonès;43171;Vila-seca;1;6;B;;946;195;385;566;380;2;7;557;564
43;Tarragona;36;Tarragonès;43171;Vila-seca;1;7;U;;694;189;339;436;258;5;2;429;431
43;Tarragona;36;Tarragonès;43171;Vila-seca;1;8;U;;1043;162;312;417;626;1;5;411;416
43;Tarragona;36;Tarragonès;43171;Vila-seca;1;9;A;;499;92;192;297;202;0;1;296;297
43;Tarragona;36;Tarragonès;43171;Vila-seca;1;9;B;;667;145;290;420;247;0;5;415;420
8;Barcelona;21;Maresme;08214;Vilassar de Dalt;1;1;U;;973;316;475;638;335;0;11;627;638
8;Barcelona;21;Maresme;08214;Vilassar de Dalt;1;2;U;;854;245;441;541;313;1;0;540;540
8;Barcelona;21;Maresme;08214;Vilassar de Dalt;1;3;A;;588;148;270;355;233;2;2;351;353
8;Barcelona;21;Maresme;08214;Vilassar de Dalt;1;3;B;;545;143;266;339;206;0;2;337;339
8;Barcelona;21;Maresme;08214;Vilassar de Dalt;1;4;U;;895;236;430;587;308;3;4;580;584
8;Barcelona;21;Maresme;08214;Vilassar de Dalt;2;1;A;;768;224;419;525;243;1;4;520;524
8;Barcelona;21;Maresme;08214;Vilassar de Dalt;2;1;B;;786;227;435;537;249;0;4;533;537
8;Barcelona;21;Maresme;08214;Vilassar de Dalt;2;2;U;;946;264;447;616;330;2;4;610;614
8;Barcelona;21;Maresme;08219;Vilassar de Mar;1;1;A;;799;214;381;501;298;1;9;491;500
8;Barcelona;21;Maresme;08219;Vilassar de Mar;1;1;B;;954;273;500;628;326;1;6;621;627
8;Barcelona;21;Maresme;08219;Vilassar de Mar;1;2;A;;976;256;502;638;338;0;5;633;638
8;Barcelona;21;Maresme;08219;Vilassar de Mar;1;2;B;;1276;368;718;868;408;2;12;854;866
8;Barcelona;21;Maresme;08219;Vilassar de Mar;1;3;A;;1010;251;474;604;406;1;10;593;603
8;Barcelona;21;Maresme;08219;Vilassar de Mar;1;3;B;;1196;277;568;708;488;0;8;700;708
8;Barcelona;21;Maresme;08219;Vilassar de Mar;2;1;A;;807;209;390;491;316;0;3;488;491
8;Barcelona;21;Maresme;08219;Vilassar de Mar;2;1;B;;863;246;461;552;311;2;7;543;550
8;Barcelona;21;Maresme;08219;Vilassar de Mar;2;2;A;;1187;320;695;797;390;3;11;783;794
8;Barcelona;21;Maresme;08219;Vilassar de Mar;2;2;B;;1340;333;601;873;467;0;14;859;873
8;Barcelona;21;Maresme;08219;Vilassar de Mar;3;1;A;;488;141;268;325;163;0;1;324;325
8;Barcelona;21;Maresme;08219;Vilassar de Mar;3;1;B;;552;171;313;371;181;0;3;368;371
8;Barcelona;21;Maresme;08219;Vilassar de Mar;3;2;A;;1122;262;538;665;457;1;7;657;664
8;Barcelona;21;Maresme;08219;Vilassar de Mar;3;2;B;;1205;330;597;727;478;0;6;721;727
17;Girona;2;Alt Empordà;17222;Vilaür;1;1;U;;98;32;53;76;22;0;0;76;76
43;Tarragona;16;Conca de Barberà;43172;Vilaverd;1;1;U;;321;102;209;261;60;4;1;256;257
43;Tarragona;29;Priorat;43173;Vilella Alta, la;1;1;U;;114;25;65;91;23;0;0;91;91
43;Tarragona;29;Priorat;43174;Vilella Baixa, la;1;1;U;;148;35;64;93;55;0;2;91;93
17;Girona;34;Selva;17233;Vilobí d'Onyar;1;1;A;;629;167;320;426;203;2;3;421;424
17;Girona;34;Selva;17233;Vilobí d'Onyar;1;1;B;;722;170;323;454;268;0;1;453;454
17;Girona;34;Selva;17233;Vilobí d'Onyar;1;1;C;;451;134;247;320;131;0;3;317;320
8;Barcelona;3;Alt Penedès;08304;Vilobí del Penedès;1;1;U;;717;206;390;506;211;2;5;499;504
17;Girona;10;Baix Empordà;17232;Vilopriu;1;1;U;;153;51;85;97;56;0;0;97;97
25;Lleida;18;Garrigues;25253;Vilosell, el;1;1;U;;176;34;114;142;34;1;0;141;141
43;Tarragona;16;Conca de Barberà;43176;Vimbodí i Poblet;1;1;U;;944;200;471;633;311;2;3;628;631
25;Lleida;18;Garrigues;25255;Vinaixa;1;1;U;;544;137;285;380;164;2;3;375;378
43;Tarragona;30;Ribera d'Ebre;43177;Vinebre;1;1;U;;377;113;229;277;100;2;3;272;275
43;Tarragona;8;Baix Camp;43178;Vinyols i els Arcs;1;1;A;;623;110;343;429;194;2;5;422;427
43;Tarragona;8;Baix Camp;43178;Vinyols i els Arcs;1;1;B;;312;87;140;195;117;0;1;194;195
8;Barcelona;14;Berguedà;08308;Viver i Serrateix;1;1;U;;162;43;92;122;40;0;0;122;122
43;Tarragona;9;Baix Ebre;43052;Xerta;1;1;U;;1021;303;609;778;243;5;9;764;773
8;Barcelona;98;Residents Absents;08998;Residents Absents;1;1;U;;64615; ; ;11330;53285;84;20;11226;11246
17;Girona;98;Residents Absents;17998;Residents Absents;1;1;U;;6331; ; ;1267;5064;3;3;1261;1264
25;Lleida;98;Residents Absents;25998;Residents Absents;1;1;U;;9349; ; ;1695;7654;6;5;1684;1689
43;Tarragona;98;Residents Absents;43998;Residents Absents;1;1;U;;6943; ; ;1224;5719;4;5;1215;1220
