﻿Codi Província;Nom Província;Codi Comarca;Nom Comarca;Codi Municipi;Nom Municipi;Districte;Secció;Mesa;Població;Cens;Participació 13:00;Participació 18:00;Participació 20:00;Abstenció;Vots nuls;Vots en blanc;Vots a candidatures;Vots vàlids
25;Lleida;25;Pallars Jussà;25001;Abella de la Conca;1;1;U;;132;22;47;70;62;0;0;70;70
8;Barcelona;11;Baix Llobregat;08001;Abrera;1;1;A;;721;143;322;435;286;3;2;430;432
8;Barcelona;11;Baix Llobregat;08001;Abrera;1;1;B;;741;134;337;457;284;2;10;445;455
8;Barcelona;11;Baix Llobregat;08001;Abrera;1;1;C;;727;138;333;451;276;1;7;443;450
8;Barcelona;11;Baix Llobregat;08001;Abrera;1;2;A;;798;164;376;486;312;3;3;480;483
8;Barcelona;11;Baix Llobregat;08001;Abrera;1;2;B;;827;175;383;486;341;2;1;483;484
8;Barcelona;11;Baix Llobregat;08001;Abrera;1;3;U;;809;145;295;375;434;0;5;370;375
8;Barcelona;11;Baix Llobregat;08001;Abrera;1;4;U;;530;113;244;312;218;1;0;311;311
25;Lleida;23;Noguera;25002;Àger;1;1;U;;503;168;303;370;133;5;5;360;365
25;Lleida;38;Urgell;25003;Agramunt;1;1;U;;938;254;447;604;334;0;5;599;604
25;Lleida;38;Urgell;25003;Agramunt;1;2;U;;976;202;473;640;336;4;8;628;636
25;Lleida;38;Urgell;25003;Agramunt;1;3;U;;966;187;473;664;302;2;2;660;662
25;Lleida;38;Urgell;25003;Agramunt;1;4;U;;954;180;482;639;315;1;5;633;638
8;Barcelona;7;Bages;08002;Aguilar de Segarra;1;1;U;;182;60;102;130;52;1;0;129;129
17;Girona;2;Alt Empordà;17001;Agullana;1;1;U;;535;190;378;430;105;1;5;424;429
8;Barcelona;41;Vallès Oriental;08014;Aiguafreda;1;1;A;;713;184;432;537;176;1;5;531;536
8;Barcelona;41;Vallès Oriental;08014;Aiguafreda;1;1;B;;986;265;614;745;241;2;5;738;743
43;Tarragona;1;Alt Camp;43001;Aiguamúrcia;1;1;A;;218;50;151;171;47;4;2;165;167
43;Tarragona;1;Alt Camp;43001;Aiguamúrcia;1;1;B;;260;65;139;166;94;0;0;166;166
17;Girona;20;Gironès;17002;Aiguaviva;1;1;U;;333;108;208;246;87;0;6;240;246
25;Lleida;33;Segrià;25038;Aitona;1;1;U;;849;231;541;691;158;1;4;686;690
25;Lleida;33;Segrià;25038;Aitona;1;2;U;;955;205;549;701;254;0;7;694;701
25;Lleida;33;Segrià;25004;Alamús, els;1;1;U;;566;162;325;402;164;2;3;397;400
25;Lleida;4;Alt Urgell;25005;Alàs i Cerc;1;1;U;;340;61;176;207;133;0;0;207;207
25;Lleida;18;Garrigues;25006;Albagés, l';1;1;U;;457;108;237;317;140;1;4;312;316
17;Girona;2;Alt Empordà;17003;Albanyà;1;1;U;;101;24;55;75;26;0;1;74;75
25;Lleida;33;Segrià;25007;Albatàrrec;1;1;U;;820;185;476;573;247;1;2;570;572
25;Lleida;23;Noguera;25008;Albesa;1;1;A;;641;123;359;478;163;8;2;468;470
25;Lleida;23;Noguera;25008;Albesa;1;1;B;;604;132;355;455;149;3;3;449;452
25;Lleida;18;Garrigues;25009;Albi, l';1;1;U;;672;126;370;505;167;6;0;499;499
43;Tarragona;12;Baix Penedès;43002;Albinyana;1;1;U;;908;222;500;592;316;8;7;577;584
43;Tarragona;8;Baix Camp;43003;Albiol, l';1;1;U;;112;32;53;67;45;0;1;66;67
17;Girona;10;Baix Empordà;17004;Albons;1;1;U;;423;160;290;321;102;1;4;316;320
43;Tarragona;22;Montsià;43004;Alcanar;1;1;U;;858;191;423;536;322;2;7;527;534
43;Tarragona;22;Montsià;43004;Alcanar;1;2;A;;682;150;339;442;240;1;3;438;441
43;Tarragona;22;Montsià;43004;Alcanar;1;2;B;;365;58;179;231;134;3;4;224;228
43;Tarragona;22;Montsià;43004;Alcanar;1;2;C;;792;180;424;545;247;5;3;537;540
43;Tarragona;22;Montsià;43004;Alcanar;1;3;U;;952;228;437;552;400;1;8;543;551
43;Tarragona;22;Montsià;43004;Alcanar;2;1;A;;549;108;234;290;259;2;1;287;288
43;Tarragona;22;Montsià;43004;Alcanar;2;1;B;;584;120;260;329;255;0;2;327;329
43;Tarragona;22;Montsià;43004;Alcanar;2;2;U;;739;196;359;437;302;0;3;434;437
43;Tarragona;22;Montsià;43004;Alcanar;2;3;U;;545;141;252;294;251;2;3;289;292
25;Lleida;33;Segrià;25010;Alcanó;1;1;U;;242;26;87;141;101;0;3;138;141
25;Lleida;33;Segrià;25011;Alcarràs;1;1;A;;869;151;417;537;332;2;1;534;535
25;Lleida;33;Segrià;25011;Alcarràs;1;1;B;;713;107;287;398;315;8;1;389;390
25;Lleida;33;Segrià;25011;Alcarràs;1;2;A;;763;155;357;467;296;1;1;465;466
25;Lleida;33;Segrià;25011;Alcarràs;1;2;B;;703;140;298;389;314;1;0;388;388
25;Lleida;33;Segrià;25011;Alcarràs;1;3;U;;657;107;286;372;285;0;6;366;372
25;Lleida;33;Segrià;25012;Alcoletge;1;1;A;;575;163;344;399;176;1;0;398;398
25;Lleida;33;Segrià;25012;Alcoletge;1;1;B;;733;162;417;489;244;3;5;481;486
43;Tarragona;1;Alt Camp;43005;Alcover;1;1;A;;795;155;373;497;298;8;5;484;489
43;Tarragona;1;Alt Camp;43005;Alcover;1;1;B;;803;188;414;547;256;4;3;540;543
43;Tarragona;1;Alt Camp;43005;Alcover;2;1;A;;614;108;260;365;249;0;1;364;365
43;Tarragona;1;Alt Camp;43005;Alcover;2;1;B;;633;122;299;403;230;3;7;393;400
43;Tarragona;9;Baix Ebre;43904;Aldea, l';1;1;A;;831;206;393;499;332;2;6;491;497
43;Tarragona;9;Baix Ebre;43904;Aldea, l';1;1;B;;756;176;334;434;322;0;9;425;434
43;Tarragona;9;Baix Ebre;43904;Aldea, l';1;2;A;;770;161;372;451;319;4;2;445;447
43;Tarragona;9;Baix Ebre;43904;Aldea, l';1;2;B;;576;142;272;327;249;0;3;324;327
43;Tarragona;9;Baix Ebre;43006;Aldover;1;1;U;;714;140;404;523;191;0;2;521;523
43;Tarragona;8;Baix Camp;43007;Aleixar, l';1;1;U;;555;108;354;450;105;1;1;448;449
8;Barcelona;21;Maresme;08003;Alella;1;1;A;;775;205;462;544;231;1;7;536;543
8;Barcelona;21;Maresme;08003;Alella;1;1;B;;826;218;494;595;231;1;4;590;594
8;Barcelona;21;Maresme;08003;Alella;1;2;A;;785;164;396;510;275;0;5;505;510
8;Barcelona;21;Maresme;08003;Alella;1;2;B;;865;225;474;560;305;1;10;549;559
8;Barcelona;21;Maresme;08003;Alella;1;3;A;;762;231;481;572;190;13;1;558;559
8;Barcelona;21;Maresme;08003;Alella;1;3;B;;805;221;462;575;230;3;7;565;572
8;Barcelona;21;Maresme;08003;Alella;1;4;A;;503;148;273;356;147;0;5;351;356
8;Barcelona;21;Maresme;08003;Alella;1;4;B;;566;150;282;354;212;0;0;354;354
43;Tarragona;9;Baix Ebre;43008;Alfara de Carles;1;1;U;;328;71;192;274;54;1;2;271;273
25;Lleida;33;Segrià;25013;Alfarràs;1;1;A;;656;160;372;469;187;4;3;462;465
25;Lleida;33;Segrià;25013;Alfarràs;1;1;B;;720;173;384;491;229;1;3;487;490
25;Lleida;33;Segrià;25013;Alfarràs;1;2;A;;503;122;265;339;164;0;1;338;339
25;Lleida;33;Segrià;25013;Alfarràs;1;2;B;;609;134;311;396;213;2;8;386;394
25;Lleida;33;Segrià;25014;Alfés;1;1;U;;300;88;180;213;87;1;6;206;212
43;Tarragona;8;Baix Camp;43009;Alforja;1;1;U;;987;283;638;785;202;6;4;775;779
25;Lleida;23;Noguera;25015;Algerri;1;1;U;;465;133;300;354;111;0;9;345;354
25;Lleida;33;Segrià;25016;Alguaire;1;1;A;;693;181;408;480;213;3;3;474;477
25;Lleida;33;Segrià;25016;Alguaire;1;1;B;;773;192;396;473;300;4;1;468;469
25;Lleida;33;Segrià;25016;Alguaire;1;2;U;;871;154;426;559;312;1;3;555;558
25;Lleida;26;Pallars Sobirà;25017;Alins;1;1;U;;269;41;144;184;85;0;0;184;184
43;Tarragona;1;Alt Camp;43010;Alió;1;1;U;;278;51;151;195;83;2;2;191;193
25;Lleida;33;Segrià;25019;Almacelles;1;1;U;;716;153;362;457;259;1;4;452;456
25;Lleida;33;Segrià;25019;Almacelles;1;2;A;;611;146;275;376;235;0;6;370;376
25;Lleida;33;Segrià;25019;Almacelles;1;2;B;;733;158;325;450;283;1;3;446;449
25;Lleida;33;Segrià;25019;Almacelles;2;1;A;;554;132;270;349;205;1;3;345;348
25;Lleida;33;Segrià;25019;Almacelles;2;1;B;;670;163;320;418;252;0;7;411;418
25;Lleida;33;Segrià;25019;Almacelles;2;2;A;;580;103;248;345;235;4;3;338;341
25;Lleida;33;Segrià;25019;Almacelles;2;2;B;;653;107;260;354;299;1;6;347;353
25;Lleida;33;Segrià;25020;Almatret;1;1;U;;451;130;266;329;122;0;2;327;329
25;Lleida;33;Segrià;25021;Almenar;1;1;U;;894;200;403;507;387;1;3;503;506
25;Lleida;33;Segrià;25021;Almenar;2;1;U;;1037;230;525;690;347;0;7;683;690
25;Lleida;33;Segrià;25021;Almenar;2;2;U;;981;194;497;659;322;3;4;652;656
43;Tarragona;8;Baix Camp;43011;Almoster;1;1;U;;515;150;312;409;106;1;4;404;408
25;Lleida;23;Noguera;25022;Alòs de Balaguer;1;1;U;;162;53;119;128;34;0;0;128;128
17;Girona;15;Cerdanya;17006;Alp;1;1;U;;800;159;263;500;300;2;5;493;498
8;Barcelona;24;Osona;08004;Alpens;1;1;U;;206;55;138;166;40;0;1;165;166
25;Lleida;33;Segrià;25023;Alpicat;1;1;U;;1218;242;635;795;423;2;9;784;793
25;Lleida;33;Segrià;25023;Alpicat;1;2;U;;1240;276;606;790;450;1;5;784;789
43;Tarragona;36;Tarragonès;43012;Altafulla;1;1;A;;830;227;463;575;255;1;3;571;574
43;Tarragona;36;Tarragonès;43012;Altafulla;1;1;B;;954;274;560;676;278;2;7;667;674
25;Lleida;26;Pallars Sobirà;25024;Alt Àneu;1;1;U;;331;89;172;211;120;0;0;211;211
17;Girona;34;Selva;17007;Amer;1;1;A;;608;216;381;450;158;1;5;444;449
17;Girona;34;Selva;17007;Amer;1;1;B;;591;179;361;443;148;6;2;435;437
17;Girona;34;Selva;17007;Amer;1;1;C;;696;235;442;525;171;6;2;517;519
8;Barcelona;41;Vallès Oriental;08005;Ametlla del Vallès, l';1;1;A;;496;147;293;366;130;0;2;364;366
8;Barcelona;41;Vallès Oriental;08005;Ametlla del Vallès, l';1;1;B;;557;177;334;386;171;0;3;383;386
8;Barcelona;41;Vallès Oriental;08005;Ametlla del Vallès, l';1;2;A;;501;148;315;367;134;0;2;365;367
8;Barcelona;41;Vallès Oriental;08005;Ametlla del Vallès, l';1;2;B;;543;163;346;413;130;2;5;406;411
8;Barcelona;41;Vallès Oriental;08005;Ametlla del Vallès, l';1;3;A;;437;102;236;299;138;0;3;296;299
8;Barcelona;41;Vallès Oriental;08005;Ametlla del Vallès, l';1;3;B;;417;117;233;288;129;1;7;280;287
8;Barcelona;41;Vallès Oriental;08005;Ametlla del Vallès, l';1;3;C;;465;104;252;328;137;0;3;325;328
43;Tarragona;9;Baix Ebre;43013;Ametlla de Mar, l';1;1;A;;533;191;303;393;140;1;0;392;392
43;Tarragona;9;Baix Ebre;43013;Ametlla de Mar, l';1;1;B;;599;243;356;448;151;3;1;444;445
43;Tarragona;9;Baix Ebre;43013;Ametlla de Mar, l';1;2;A;;552;226;351;436;116;1;4;431;435
43;Tarragona;9;Baix Ebre;43013;Ametlla de Mar, l';1;2;B;;501;196;300;375;126;1;5;369;374
43;Tarragona;9;Baix Ebre;43013;Ametlla de Mar, l';1;3;A;;645;207;355;457;188;1;3;453;456
43;Tarragona;9;Baix Ebre;43013;Ametlla de Mar, l';1;3;B;;688;225;379;465;223;5;2;458;460
43;Tarragona;9;Baix Ebre;43906;Ampolla, l';1;1;A;;782;248;460;586;196;3;2;581;583
43;Tarragona;9;Baix Ebre;43906;Ampolla, l';1;1;B;;516;169;298;393;123;4;0;389;389
43;Tarragona;22;Montsià;43014;Amposta;1;1;A;;454;140;214;269;185;2;3;264;267
43;Tarragona;22;Montsià;43014;Amposta;1;1;B;;534;174;294;355;179;1;1;353;354
43;Tarragona;22;Montsià;43014;Amposta;1;2;A;;506;148;287;351;155;0;3;348;351
43;Tarragona;22;Montsià;43014;Amposta;1;2;B;;553;159;298;381;172;2;4;375;379
43;Tarragona;22;Montsià;43014;Amposta;2;1;U;;879;307;524;625;254;2;7;616;623
43;Tarragona;22;Montsià;43014;Amposta;2;2;A;;424;145;234;283;141;0;5;278;283
43;Tarragona;22;Montsià;43014;Amposta;2;2;B;;454;156;238;282;172;1;1;280;281
43;Tarragona;22;Montsià;43014;Amposta;3;1;A;;517;150;257;314;203;1;0;313;313
43;Tarragona;22;Montsià;43014;Amposta;3;1;B;;511;149;261;323;188;2;1;320;321
43;Tarragona;22;Montsià;43014;Amposta;3;2;A;;559;174;274;347;212;0;4;343;347
43;Tarragona;22;Montsià;43014;Amposta;3;2;B;;653;180;309;395;258;3;3;389;392
43;Tarragona;22;Montsià;43014;Amposta;4;1;A;;607;173;282;389;218;0;5;384;389
43;Tarragona;22;Montsià;43014;Amposta;4;1;B;;703;233;348;467;236;0;6;461;467
43;Tarragona;22;Montsià;43014;Amposta;4;2;A;;719;177;342;444;275;3;3;438;441
43;Tarragona;22;Montsià;43014;Amposta;4;2;B;;556;162;274;376;180;1;5;370;375
43;Tarragona;22;Montsià;43014;Amposta;4;2;C;;634;162;307;406;228;0;3;403;406
43;Tarragona;22;Montsià;43014;Amposta;4;3;A;;617;209;334;420;197;1;5;414;419
43;Tarragona;22;Montsià;43014;Amposta;4;3;B;;479;138;227;298;181;0;3;295;298
43;Tarragona;22;Montsià;43014;Amposta;4;3;C;;644;187;320;413;231;4;7;402;409
43;Tarragona;22;Montsià;43014;Amposta;4;4;A;;671;138;280;380;291;5;7;368;375
43;Tarragona;22;Montsià;43014;Amposta;4;4;B;;473;102;209;282;191;1;3;278;281
43;Tarragona;22;Montsià;43014;Amposta;4;4;C;;599;157;272;370;229;0;2;368;370
17;Girona;34;Selva;17008;Anglès;1;1;A;;554;124;321;387;167;2;2;383;385
17;Girona;34;Selva;17008;Anglès;1;1;B;;608;174;369;433;175;1;2;430;432
17;Girona;34;Selva;17008;Anglès;1;2;A;;774;239;488;598;176;2;0;596;596
17;Girona;34;Selva;17008;Anglès;1;2;B;;764;231;483;574;190;0;4;570;574
17;Girona;34;Selva;17008;Anglès;1;3;A;;583;169;347;424;159;0;0;424;424
17;Girona;34;Selva;17008;Anglès;1;3;B;;603;168;361;439;164;1;3;435;438
25;Lleida;38;Urgell;25027;Anglesola;1;1;U;;1047;247;578;793;254;2;3;788;791
25;Lleida;18;Garrigues;25029;Arbeca;1;1;U;;961;185;490;693;268;1;3;689;692
25;Lleida;18;Garrigues;25029;Arbeca;1;2;U;;983;170;491;685;298;0;3;682;685
43;Tarragona;12;Baix Penedès;43016;Arboç, l';1;1;A;;587;171;332;404;183;1;2;401;403
43;Tarragona;12;Baix Penedès;43016;Arboç, l';1;1;B;;883;247;487;589;294;2;6;581;587
43;Tarragona;12;Baix Penedès;43016;Arboç, l';1;2;A;;667;156;351;413;254;5;4;404;408
43;Tarragona;12;Baix Penedès;43016;Arboç, l';1;2;B;;712;159;359;434;278;3;8;423;431
43;Tarragona;8;Baix Camp;43015;Arbolí;1;1;U;;120;50;82;89;31;0;1;88;89
17;Girona;34;Selva;17009;Arbúcies;1;1;A;;759;174;446;574;185;5;1;568;569
17;Girona;34;Selva;17009;Arbúcies;1;1;B;;782;210;467;571;211;0;3;568;571
17;Girona;34;Selva;17009;Arbúcies;1;2;A;;811;228;499;607;204;0;3;604;607
17;Girona;34;Selva;17009;Arbúcies;1;2;B;;784;228;491;598;186;1;2;595;597
17;Girona;34;Selva;17009;Arbúcies;2;1;U;;759;194;418;556;203;1;5;550;555
8;Barcelona;21;Maresme;08006;Arenys de Mar;1;1;A;;663;190;366;461;202;3;1;457;458
8;Barcelona;21;Maresme;08006;Arenys de Mar;1;1;B;;834;260;485;610;224;2;4;604;608
8;Barcelona;21;Maresme;08006;Arenys de Mar;1;2;A;;729;227;445;533;196;3;6;524;530
8;Barcelona;21;Maresme;08006;Arenys de Mar;1;2;B;;930;292;535;668;262;1;3;664;667
8;Barcelona;21;Maresme;08006;Arenys de Mar;1;3;U;;1011;293;610;753;258;2;4;747;751
8;Barcelona;21;Maresme;08006;Arenys de Mar;2;1;A;;554;184;315;395;159;0;2;393;395
8;Barcelona;21;Maresme;08006;Arenys de Mar;2;1;B;;616;177;323;414;202;1;3;410;413
8;Barcelona;21;Maresme;08006;Arenys de Mar;2;2;A;;678;226;402;497;181;1;2;494;496
8;Barcelona;21;Maresme;08006;Arenys de Mar;2;2;B;;782;285;454;573;209;4;5;564;569
8;Barcelona;21;Maresme;08006;Arenys de Mar;2;3;A;;469;126;240;319;150;0;2;317;319
8;Barcelona;21;Maresme;08006;Arenys de Mar;2;3;B;;669;200;383;469;200;0;1;468;469
8;Barcelona;21;Maresme;08006;Arenys de Mar;2;4;A;;727;180;368;446;281;1;5;440;445
8;Barcelona;21;Maresme;08006;Arenys de Mar;2;4;B;;770;183;365;468;302;0;2;466;468
8;Barcelona;21;Maresme;08007;Arenys de Munt;1;1;U;;609;219;369;459;150;0;4;455;459
8;Barcelona;21;Maresme;08007;Arenys de Munt;1;2;A;;735;202;404;540;195;0;3;537;540
8;Barcelona;21;Maresme;08007;Arenys de Munt;1;2;B;;846;222;466;614;232;2;6;606;612
8;Barcelona;21;Maresme;08007;Arenys de Munt;2;1;U;;1019;297;616;762;257;0;11;751;762
8;Barcelona;21;Maresme;08007;Arenys de Munt;2;2;A;;487;125;259;320;167;1;0;319;319
8;Barcelona;21;Maresme;08007;Arenys de Munt;2;2;B;;609;222;301;403;206;0;0;403;403
17;Girona;19;Garrotxa;17010;Argelaguer;1;1;U;;289;101;153;204;85;5;0;199;199
8;Barcelona;6;Anoia;08008;Argençola;1;1;U;;163;47;65;109;54;2;0;107;107
43;Tarragona;8;Baix Camp;43017;Argentera, l';1;1;U;;126;12;65;91;35;0;1;90;91
8;Barcelona;21;Maresme;08009;Argentona;1;1;A;;829;225;451;572;257;2;2;568;570
8;Barcelona;21;Maresme;08009;Argentona;1;1;B;;902;243;500;613;289;1;6;606;612
8;Barcelona;21;Maresme;08009;Argentona;1;2;A;;900;276;537;645;255;2;7;636;643
8;Barcelona;21;Maresme;08009;Argentona;1;2;B;;949;291;553;681;268;0;9;672;681
8;Barcelona;21;Maresme;08009;Argentona;1;3;A;;472;95;233;279;193;0;3;276;279
8;Barcelona;21;Maresme;08009;Argentona;1;3;B;;584;144;318;363;221;0;2;361;363
8;Barcelona;21;Maresme;08009;Argentona;2;1;A;;628;218;400;476;152;0;6;470;476
8;Barcelona;21;Maresme;08009;Argentona;2;1;B;;626;200;396;465;161;0;1;464;465
8;Barcelona;21;Maresme;08009;Argentona;2;2;A;;450;133;285;334;116;1;1;332;333
8;Barcelona;21;Maresme;08009;Argentona;2;2;B;;489;137;291;346;143;3;1;342;343
17;Girona;2;Alt Empordà;17011;Armentera, l';1;1;U;;630;231;447;487;143;1;5;481;486
43;Tarragona;37;Terra Alta;43018;Arnes;1;1;U;;461;173;350;386;75;0;4;382;386
25;Lleida;39;Consell General d'Aran;25031;Arres;1;1;U;;63;12;33;38;25;0;1;37;38
25;Lleida;4;Alt Urgell;25032;Arsèguel;1;1;U;;89;19;53;64;25;0;0;64;64
8;Barcelona;7;Bages;08010;Artés;1;1;A;;437;109;241;308;129;0;2;306;308
8;Barcelona;7;Bages;08010;Artés;1;1;B;;563;127;302;381;182;4;0;377;377
8;Barcelona;7;Bages;08010;Artés;2;1;A;;834;217;510;640;194;0;2;638;640
8;Barcelona;7;Bages;08010;Artés;2;1;B;;1030;264;590;736;294;4;4;728;732
8;Barcelona;7;Bages;08010;Artés;2;2;U;;574;158;326;411;163;1;3;407;410
25;Lleida;33;Segrià;25033;Artesa de Lleida;1;1;U;;1046;277;600;761;285;3;5;753;758
25;Lleida;23;Noguera;25034;Artesa de Segre;1;1;U;;1189;268;682;915;274;1;8;906;914
25;Lleida;23;Noguera;25034;Artesa de Segre;1;2;U;;868;292;501;624;244;3;4;617;621
25;Lleida;23;Noguera;25034;Artesa de Segre;2;1;A;;319;84;159;203;116;0;0;203;203
25;Lleida;23;Noguera;25034;Artesa de Segre;2;1;B;;215;43;110;147;68;1;3;143;146
43;Tarragona;30;Ribera d'Ebre;43019;Ascó;1;1;A;;645;163;329;452;193;8;2;442;444
43;Tarragona;30;Ribera d'Ebre;43019;Ascó;1;1;B;;747;190;405;527;220;5;1;521;522
25;Lleida;33;Segrià;25036;Aspa;1;1;U;;226;66;143;162;64;0;9;153;162
25;Lleida;23;Noguera;25037;Avellanes i Santa Linya, les;1;1;U;;424;103;242;306;118;2;2;302;304
8;Barcelona;14;Berguedà;08011;Avià;1;1;A;;714;181;400;517;197;2;6;509;515
8;Barcelona;14;Berguedà;08011;Avià;1;1;B;;788;202;445;556;232;1;6;549;555
8;Barcelona;7;Bages;08012;Avinyó;1;1;A;;819;201;528;610;209;3;7;600;607
8;Barcelona;7;Bages;08012;Avinyó;1;1;B;;801;196;505;581;220;5;3;573;576
8;Barcelona;3;Alt Penedès;08013;Avinyonet del Penedès;1;1;U;;1040;200;566;707;333;6;1;700;701
17;Girona;2;Alt Empordà;17012;Avinyonet de Puigventós;1;1;U;;367;95;186;229;138;0;4;225;229
8;Barcelona;13;Barcelonès;08015;Badalona;1;1;U;;1050;267;594;741;309;0;6;735;741
8;Barcelona;13;Barcelonès;08015;Badalona;1;2;A;;524;150;298;367;157;1;4;362;366
8;Barcelona;13;Barcelonès;08015;Badalona;1;2;B;;621;198;358;436;185;1;1;434;435
8;Barcelona;13;Barcelonès;08015;Badalona;1;3;U;;905;278;546;647;258;0;1;646;647
8;Barcelona;13;Barcelonès;08015;Badalona;1;4;U;;767;248;469;576;191;2;4;570;574
8;Barcelona;13;Barcelonès;08015;Badalona;1;5;A;;702;200;447;537;165;1;3;533;536
8;Barcelona;13;Barcelonès;08015;Badalona;1;5;B;;784;280;515;600;184;1;12;587;599
8;Barcelona;13;Barcelonès;08015;Badalona;1;7;A;;527;164;308;383;144;0;3;380;383
8;Barcelona;13;Barcelonès;08015;Badalona;1;7;B;;590;181;353;438;152;2;3;433;436
8;Barcelona;13;Barcelonès;08015;Badalona;1;8;U;;700;196;411;524;176;1;5;518;523
8;Barcelona;13;Barcelonès;08015;Badalona;2;1;A;;611;162;282;362;249;1;4;357;361
8;Barcelona;13;Barcelonès;08015;Badalona;2;1;B;;635;172;327;386;249;0;4;382;386
8;Barcelona;13;Barcelonès;08015;Badalona;2;10;A;;644;148;284;364;280;1;2;361;363
8;Barcelona;13;Barcelonès;08015;Badalona;2;10;B;;794;204;346;427;367;0;3;424;427
8;Barcelona;13;Barcelonès;08015;Badalona;2;11;A;;661;118;272;350;311;0;4;346;350
8;Barcelona;13;Barcelonès;08015;Badalona;2;11;B;;797;153;317;419;378;0;5;414;419
8;Barcelona;13;Barcelonès;08015;Badalona;2;12;U;;1019;247;457;548;471;0;0;548;548
8;Barcelona;13;Barcelonès;08015;Badalona;2;13;A;;503;94;196;247;256;0;3;244;247
8;Barcelona;13;Barcelonès;08015;Badalona;2;13;B;;703;154;311;378;325;0;1;377;378
8;Barcelona;13;Barcelonès;08015;Badalona;2;14;U;;559;157;281;342;217;0;3;339;342
8;Barcelona;13;Barcelonès;08015;Badalona;2;15;A;;514;119;217;277;237;0;0;277;277
8;Barcelona;13;Barcelonès;08015;Badalona;2;15;B;;640;154;278;326;314;0;1;325;326
8;Barcelona;13;Barcelonès;08015;Badalona;2;2;A;;548;176;324;390;158;0;7;383;390
8;Barcelona;13;Barcelonès;08015;Badalona;2;2;B;;605;161;336;427;178;0;5;422;427
8;Barcelona;13;Barcelonès;08015;Badalona;2;3;U;;800;256;484;570;230;1;7;562;569
8;Barcelona;13;Barcelonès;08015;Badalona;2;4;A;;815;244;477;589;226;8;2;579;581
8;Barcelona;13;Barcelonès;08015;Badalona;2;4;B;;921;242;532;669;252;2;6;661;667
8;Barcelona;13;Barcelonès;08015;Badalona;2;5;U;;582;157;287;356;226;0;3;353;356
8;Barcelona;13;Barcelonès;08015;Badalona;2;6;U;;631;155;306;355;276;1;2;352;354
8;Barcelona;13;Barcelonès;08015;Badalona;2;7;U;;763;159;312;383;380;0;2;381;383
8;Barcelona;13;Barcelonès;08015;Badalona;2;8;A;;807;226;410;516;291;2;7;507;514
8;Barcelona;13;Barcelonès;08015;Badalona;2;8;B;;911;233;502;613;298;3;5;605;610
8;Barcelona;13;Barcelonès;08015;Badalona;2;9;A;;518;135;237;278;240;0;1;277;278
8;Barcelona;13;Barcelonès;08015;Badalona;2;9;B;;642;168;290;347;295;0;0;347;347
8;Barcelona;13;Barcelonès;08015;Badalona;3;1;U;;739;196;335;401;338;0;1;400;401
8;Barcelona;13;Barcelonès;08015;Badalona;3;10;A;;540;154;276;341;199;0;1;340;341
8;Barcelona;13;Barcelonès;08015;Badalona;3;10;B;;608;161;303;370;238;0;4;366;370
8;Barcelona;13;Barcelonès;08015;Badalona;3;11;U;;858;255;456;514;344;0;6;508;514
8;Barcelona;13;Barcelonès;08015;Badalona;3;12;A;;550;184;325;402;148;0;7;395;402
8;Barcelona;13;Barcelonès;08015;Badalona;3;12;B;;621;211;369;452;169;0;1;451;452
8;Barcelona;13;Barcelonès;08015;Badalona;3;2;A;;598;153;264;345;253;0;1;344;345
8;Barcelona;13;Barcelonès;08015;Badalona;3;2;B;;643;139;318;397;246;0;6;391;397
8;Barcelona;13;Barcelonès;08015;Badalona;3;3;A;;613;203;329;383;230;3;1;379;380
8;Barcelona;13;Barcelonès;08015;Badalona;3;3;B;;743;178;380;454;289;4;2;448;450
8;Barcelona;13;Barcelonès;08015;Badalona;3;4;U;;811;242;415;503;308;0;3;500;503
8;Barcelona;13;Barcelonès;08015;Badalona;3;5;A;;597;145;251;335;262;2;3;330;333
8;Barcelona;13;Barcelonès;08015;Badalona;3;5;B;;657;178;306;383;274;0;3;380;383
8;Barcelona;13;Barcelonès;08015;Badalona;3;6;U;;719;216;429;512;207;0;6;506;512
8;Barcelona;13;Barcelonès;08015;Badalona;3;7;U;;869;285;567;659;210;1;11;647;658
8;Barcelona;13;Barcelonès;08015;Badalona;3;8;U;;597;187;334;396;201;2;4;390;394
8;Barcelona;13;Barcelonès;08015;Badalona;3;9;U;;536;156;274;333;203;0;1;332;333
8;Barcelona;13;Barcelonès;08015;Badalona;4;1;U;;855;212;445;545;310;1;8;536;544
8;Barcelona;13;Barcelonès;08015;Badalona;4;10;U;;1035;256;470;554;481;1;4;549;553
8;Barcelona;13;Barcelonès;08015;Badalona;4;11;A;;488;104;205;263;225;0;3;260;263
8;Barcelona;13;Barcelonès;08015;Badalona;4;11;B;;609;131;262;328;281;0;5;323;328
8;Barcelona;13;Barcelonès;08015;Badalona;4;12;U;;918;174;390;503;415;2;5;496;501
8;Barcelona;13;Barcelonès;08015;Badalona;4;2;A;;508;148;270;312;196;1;4;307;311
8;Barcelona;13;Barcelonès;08015;Badalona;4;2;B;;660;156;327;406;254;2;4;400;404
8;Barcelona;13;Barcelonès;08015;Badalona;4;3;U;;1036;275;549;647;389;4;8;635;643
8;Barcelona;13;Barcelonès;08015;Badalona;4;4;A;;823;166;350;471;352;0;6;465;471
8;Barcelona;13;Barcelonès;08015;Badalona;4;4;B;;870;197;406;516;354;3;7;506;513
8;Barcelona;13;Barcelonès;08015;Badalona;4;5;U;;861;204;413;504;357;0;5;499;504
8;Barcelona;13;Barcelonès;08015;Badalona;4;6;A;;550;149;247;290;260;0;1;289;290
8;Barcelona;13;Barcelonès;08015;Badalona;4;6;B;;767;216;376;427;340;0;2;425;427
8;Barcelona;13;Barcelonès;08015;Badalona;4;7;A;;611;144;329;392;219;0;5;387;392
8;Barcelona;13;Barcelonès;08015;Badalona;4;7;B;;732;171;353;436;296;2;3;431;434
8;Barcelona;13;Barcelonès;08015;Badalona;4;7;C;;784;207;446;522;262;0;3;519;522
8;Barcelona;13;Barcelonès;08015;Badalona;4;8;A;;616;121;258;329;287;0;3;326;329
8;Barcelona;13;Barcelonès;08015;Badalona;4;8;B;;748;198;353;429;319;2;1;426;427
8;Barcelona;13;Barcelonès;08015;Badalona;4;9;U;;699;150;328;425;274;0;3;422;425
8;Barcelona;13;Barcelonès;08015;Badalona;5;1;A;;701;218;438;522;179;3;4;515;519
8;Barcelona;13;Barcelonès;08015;Badalona;5;1;B;;879;295;540;634;245;0;5;629;634
8;Barcelona;13;Barcelonès;08015;Badalona;5;2;U;;940;244;571;703;237;1;11;691;702
8;Barcelona;13;Barcelonès;08015;Badalona;5;3;A;;736;218;427;494;242;0;5;489;494
8;Barcelona;13;Barcelonès;08015;Badalona;5;3;B;;751;235;384;495;256;0;6;489;495
8;Barcelona;13;Barcelonès;08015;Badalona;5;4;A;;839;227;426;507;332;0;8;499;507
8;Barcelona;13;Barcelonès;08015;Badalona;5;4;B;;826;265;428;508;318;1;4;503;507
8;Barcelona;13;Barcelonès;08015;Badalona;5;5;A;;833;248;443;544;289;1;1;542;543
8;Barcelona;13;Barcelonès;08015;Badalona;5;5;B;;902;260;453;545;357;0;5;540;545
8;Barcelona;13;Barcelonès;08015;Badalona;5;6;U;;1010;326;639;753;257;1;5;747;752
8;Barcelona;13;Barcelonès;08015;Badalona;6;1;U;;1048;237;527;638;410;5;4;629;633
8;Barcelona;13;Barcelonès;08015;Badalona;6;2;A;;423;119;227;274;149;0;4;270;274
8;Barcelona;13;Barcelonès;08015;Badalona;6;2;B;;463;102;260;339;124;0;5;334;339
8;Barcelona;13;Barcelonès;08015;Badalona;6;3;A;;593;129;245;293;300;3;0;290;290
8;Barcelona;13;Barcelonès;08015;Badalona;6;3;B;;691;170;325;389;302;4;0;385;385
8;Barcelona;13;Barcelonès;08015;Badalona;6;4;A;;565;132;238;276;289;1;1;274;275
8;Barcelona;13;Barcelonès;08015;Badalona;6;4;B;;771;181;303;373;398;1;5;367;372
8;Barcelona;13;Barcelonès;08015;Badalona;6;5;A;;652;126;243;299;353;0;8;291;299
8;Barcelona;13;Barcelonès;08015;Badalona;6;5;B;;845;171;347;412;433;0;3;409;412
8;Barcelona;13;Barcelonès;08015;Badalona;6;6;A;;512;114;175;209;303;0;2;207;209
8;Barcelona;13;Barcelonès;08015;Badalona;6;6;B;;639;149;275;315;324;0;3;312;315
8;Barcelona;13;Barcelonès;08015;Badalona;7;1;A;;582;115;221;274;308;0;2;272;274
8;Barcelona;13;Barcelonès;08015;Badalona;7;1;B;;753;163;307;376;377;1;7;368;375
8;Barcelona;13;Barcelonès;08015;Badalona;7;10;U;;784;153;317;406;378;0;2;404;406
8;Barcelona;13;Barcelonès;08015;Badalona;7;11;A;;633;140;272;341;292;1;4;336;340
8;Barcelona;13;Barcelonès;08015;Badalona;7;11;B;;708;176;338;390;318;4;5;381;386
8;Barcelona;13;Barcelonès;08015;Badalona;7;12;A;;546;130;223;296;250;2;0;294;294
8;Barcelona;13;Barcelonès;08015;Badalona;7;12;B;;685;171;284;350;335;0;2;348;350
8;Barcelona;13;Barcelonès;08015;Badalona;7;13;A;;494;76;153;205;289;0;2;203;205
8;Barcelona;13;Barcelonès;08015;Badalona;7;13;B;;615;128;217;276;339;1;5;270;275
8;Barcelona;13;Barcelonès;08015;Badalona;7;14;A;;777;157;296;359;418;0;3;356;359
8;Barcelona;13;Barcelonès;08015;Badalona;7;14;B;;913;208;383;456;457;0;3;453;456
8;Barcelona;13;Barcelonès;08015;Badalona;7;15;U;;908;162;354;436;472;1;4;431;435
8;Barcelona;13;Barcelonès;08015;Badalona;7;17;U;;622;133;251;322;300;0;1;321;322
8;Barcelona;13;Barcelonès;08015;Badalona;7;18;U;;896;199;403;510;386;0;6;504;510
8;Barcelona;13;Barcelonès;08015;Badalona;7;19;U;;549;135;237;297;252;0;2;295;297
8;Barcelona;13;Barcelonès;08015;Badalona;7;2;A;;758;162;325;412;346;0;2;410;412
8;Barcelona;13;Barcelonès;08015;Badalona;7;2;B;;790;178;364;440;350;0;5;435;440
8;Barcelona;13;Barcelonès;08015;Badalona;7;20;A;;566;124;255;322;244;0;1;321;322
8;Barcelona;13;Barcelonès;08015;Badalona;7;20;B;;693;154;296;379;314;1;3;375;378
8;Barcelona;13;Barcelonès;08015;Badalona;7;21;U;;963;186;348;444;519;0;4;440;444
8;Barcelona;13;Barcelonès;08015;Badalona;7;22;U;;676;229;403;454;222;3;6;445;451
8;Barcelona;13;Barcelonès;08015;Badalona;7;23;A;;726;209;414;520;206;1;4;515;519
8;Barcelona;13;Barcelonès;08015;Badalona;7;23;B;;875;217;470;596;279;0;2;594;596
8;Barcelona;13;Barcelonès;08015;Badalona;7;24;A;;519;137;252;308;211;3;1;304;305
8;Barcelona;13;Barcelonès;08015;Badalona;7;24;B;;601;168;311;351;250;3;3;345;348
8;Barcelona;13;Barcelonès;08015;Badalona;7;25;U;;728;124;240;294;434;2;0;292;292
8;Barcelona;13;Barcelonès;08015;Badalona;7;26;U;;687;132;257;338;349;0;6;332;338
8;Barcelona;13;Barcelonès;08015;Badalona;7;27;A;;624;124;250;326;298;0;7;319;326
8;Barcelona;13;Barcelonès;08015;Badalona;7;27;B;;710;146;256;345;365;0;5;340;345
8;Barcelona;13;Barcelonès;08015;Badalona;7;28;A;;782;137;305;383;399;4;2;377;379
8;Barcelona;13;Barcelonès;08015;Badalona;7;28;B;;974;207;386;463;511;2;1;460;461
8;Barcelona;13;Barcelonès;08015;Badalona;7;29;A;;779;140;341;472;307;0;5;467;472
8;Barcelona;13;Barcelonès;08015;Badalona;7;29;B;;910;158;387;516;394;2;6;508;514
8;Barcelona;13;Barcelonès;08015;Badalona;7;3;A;;674;190;347;413;261;2;8;403;411
8;Barcelona;13;Barcelonès;08015;Badalona;7;3;B;;801;228;378;453;348;0;5;448;453
8;Barcelona;13;Barcelonès;08015;Badalona;7;30;U;;936;151;395;531;405;1;3;527;530
8;Barcelona;13;Barcelonès;08015;Badalona;7;31;A;;580;105;233;317;263;3;0;314;314
8;Barcelona;13;Barcelonès;08015;Badalona;7;31;B;;720;172;310;401;319;0;3;398;401
8;Barcelona;13;Barcelonès;08015;Badalona;7;4;U;;856;209;409;506;350;0;6;500;506
8;Barcelona;13;Barcelonès;08015;Badalona;7;5;U;;780;163;323;413;367;0;5;408;413
8;Barcelona;13;Barcelonès;08015;Badalona;7;6;U;;836;234;442;538;298;0;8;530;538
8;Barcelona;13;Barcelonès;08015;Badalona;7;7;U;;902;172;354;428;474;0;2;426;428
8;Barcelona;13;Barcelonès;08015;Badalona;7;8;A;;557;121;211;268;289;0;4;264;268
8;Barcelona;13;Barcelonès;08015;Badalona;7;8;B;;706;135;272;343;363;0;5;338;343
8;Barcelona;13;Barcelonès;08015;Badalona;7;9;U;;658;154;272;330;328;0;2;328;330
8;Barcelona;13;Barcelonès;08015;Badalona;8;1;U;;807;172;290;341;466;1;4;336;340
8;Barcelona;13;Barcelonès;08015;Badalona;8;10;A;;709;123;292;349;360;0;3;346;349
8;Barcelona;13;Barcelonès;08015;Badalona;8;10;B;;800;170;348;420;380;3;0;417;417
8;Barcelona;13;Barcelonès;08015;Badalona;8;11;U;;799;144;337;433;366;1;9;423;432
8;Barcelona;13;Barcelonès;08015;Badalona;8;2;A;;832;165;345;437;395;1;2;434;436
8;Barcelona;13;Barcelonès;08015;Badalona;8;2;B;;1043;213;464;572;471;1;4;567;571
8;Barcelona;13;Barcelonès;08015;Badalona;8;3;A;;707;117;252;342;365;0;4;338;342
8;Barcelona;13;Barcelonès;08015;Badalona;8;3;B;;896;152;346;435;461;1;5;429;434
8;Barcelona;13;Barcelonès;08015;Badalona;8;4;U;;700;115;261;349;351;1;2;346;348
8;Barcelona;13;Barcelonès;08015;Badalona;8;5;U;;972;222;447;527;445;4;8;515;523
8;Barcelona;13;Barcelonès;08015;Badalona;8;6;A;;876;146;340;476;400;0;9;467;476
8;Barcelona;13;Barcelonès;08015;Badalona;8;6;B;;1018;192;425;573;445;0;5;568;573
8;Barcelona;13;Barcelonès;08015;Badalona;8;7;A;;571;96;223;284;287;0;0;284;284
8;Barcelona;13;Barcelonès;08015;Badalona;8;7;B;;583;146;254;313;270;1;2;310;312
8;Barcelona;13;Barcelonès;08015;Badalona;8;8;A;;714;126;296;395;319;0;5;390;395
8;Barcelona;13;Barcelonès;08015;Badalona;8;8;B;;871;139;331;439;432;0;2;437;439
8;Barcelona;13;Barcelonès;08015;Badalona;8;8;C;;823;117;280;382;441;0;9;373;382
8;Barcelona;13;Barcelonès;08015;Badalona;8;9;A;;593;146;280;333;260;1;4;328;332
8;Barcelona;13;Barcelonès;08015;Badalona;8;9;B;;708;151;331;394;314;3;3;388;391
8;Barcelona;13;Barcelonès;08015;Badalona;9;1;U;;583;154;298;355;228;2;4;349;353
8;Barcelona;13;Barcelonès;08015;Badalona;9;10;A;;604;180;285;344;260;1;2;341;343
8;Barcelona;13;Barcelonès;08015;Badalona;9;10;B;;777;201;371;423;354;0;8;415;423
8;Barcelona;13;Barcelonès;08015;Badalona;9;11;U;;985;287;512;605;380;2;11;592;603
8;Barcelona;13;Barcelonès;08015;Badalona;9;12;U;;724;189;396;436;288;0;3;433;436
8;Barcelona;13;Barcelonès;08015;Badalona;9;13;U;;842;171;351;437;405;0;6;431;437
8;Barcelona;13;Barcelonès;08015;Badalona;9;14;A;;696;152;332;388;308;1;5;382;387
8;Barcelona;13;Barcelonès;08015;Badalona;9;14;B;;855;205;440;504;351;0;4;500;504
8;Barcelona;13;Barcelonès;08015;Badalona;9;15;U;;765;184;350;427;338;0;2;425;427
8;Barcelona;13;Barcelonès;08015;Badalona;9;16;A;;776;141;289;380;396;2;8;370;378
8;Barcelona;13;Barcelonès;08015;Badalona;9;16;B;;801;148;304;421;380;2;5;414;419
8;Barcelona;13;Barcelonès;08015;Badalona;9;17;U;;719;154;269;314;405;1;4;309;313
8;Barcelona;13;Barcelonès;08015;Badalona;9;18;U;;590;115;261;320;270;2;1;317;318
8;Barcelona;13;Barcelonès;08015;Badalona;9;19;A;;493;107;216;271;222;1;1;269;270
8;Barcelona;13;Barcelonès;08015;Badalona;9;19;B;;572;137;250;304;268;0;4;300;304
8;Barcelona;13;Barcelonès;08015;Badalona;9;2;U;;1051;208;430;522;529;0;3;519;522
8;Barcelona;13;Barcelonès;08015;Badalona;9;20;A;;844;184;353;466;378;0;4;462;466
8;Barcelona;13;Barcelonès;08015;Badalona;9;20;B;;993;197;418;531;462;3;4;524;528
8;Barcelona;13;Barcelonès;08015;Badalona;9;21;A;;603;120;267;321;282;0;4;317;321
8;Barcelona;13;Barcelonès;08015;Badalona;9;21;B;;714;155;326;394;320;3;2;389;391
8;Barcelona;13;Barcelonès;08015;Badalona;9;22;A;;633;174;301;355;278;0;2;353;355
8;Barcelona;13;Barcelonès;08015;Badalona;9;22;B;;793;221;356;458;335;0;5;453;458
8;Barcelona;13;Barcelonès;08015;Badalona;9;23;U;;694;163;304;380;314;1;4;375;379
8;Barcelona;13;Barcelonès;08015;Badalona;9;24;A;;812;154;354;473;339;0;1;472;473
8;Barcelona;13;Barcelonès;08015;Badalona;9;24;B;;953;155;425;567;386;0;10;557;567
8;Barcelona;13;Barcelonès;08015;Badalona;9;25;A;;555;132;236;293;262;0;4;289;293
8;Barcelona;13;Barcelonès;08015;Badalona;9;25;B;;590;118;244;312;278;1;3;308;311
8;Barcelona;13;Barcelonès;08015;Badalona;9;26;A;;520;98;212;284;236;0;0;284;284
8;Barcelona;13;Barcelonès;08015;Badalona;9;26;B;;631;114;255;332;299;0;4;328;332
8;Barcelona;13;Barcelonès;08015;Badalona;9;27;U;;834;180;367;447;387;1;3;443;446
8;Barcelona;13;Barcelonès;08015;Badalona;9;28;A;;813;100;223;300;513;0;2;298;300
8;Barcelona;13;Barcelonès;08015;Badalona;9;28;B;;854;124;253;352;502;0;0;352;352
8;Barcelona;13;Barcelonès;08015;Badalona;9;29;A;;578;127;261;325;253;1;6;318;324
8;Barcelona;13;Barcelonès;08015;Badalona;9;29;B;;687;127;279;366;321;1;1;364;365
8;Barcelona;13;Barcelonès;08015;Badalona;9;29;C;;663;168;323;413;250;2;4;407;411
8;Barcelona;13;Barcelonès;08015;Badalona;9;3;U;;715;125;249;302;413;0;2;300;302
8;Barcelona;13;Barcelonès;08015;Badalona;9;30;A;;485;103;187;242;243;0;1;241;242
8;Barcelona;13;Barcelonès;08015;Badalona;9;30;B;;597;114;206;272;325;0;5;267;272
8;Barcelona;13;Barcelonès;08015;Badalona;9;31;A;;527;93;220;278;249;1;4;273;277
8;Barcelona;13;Barcelonès;08015;Badalona;9;31;B;;606;151;271;346;260;0;5;341;346
8;Barcelona;13;Barcelonès;08015;Badalona;9;32;U;;885;207;357;445;440;0;8;437;445
8;Barcelona;13;Barcelonès;08015;Badalona;9;33;A;;680;157;305;384;296;0;6;378;384
8;Barcelona;13;Barcelonès;08015;Badalona;9;33;B;;893;171;398;481;412;6;3;472;475
8;Barcelona;13;Barcelonès;08015;Badalona;9;34;A;;715;153;339;423;292;0;6;417;423
8;Barcelona;13;Barcelonès;08015;Badalona;9;34;B;;824;187;385;482;342;0;6;476;482
8;Barcelona;13;Barcelonès;08015;Badalona;9;35;A;;604;123;219;291;313;0;2;289;291
8;Barcelona;13;Barcelonès;08015;Badalona;9;35;B;;695;105;214;288;407;1;0;287;287
8;Barcelona;13;Barcelonès;08015;Badalona;9;36;A;;577;111;207;262;315;0;3;259;262
8;Barcelona;13;Barcelonès;08015;Badalona;9;36;B;;675;137;280;345;330;0;5;340;345
8;Barcelona;13;Barcelonès;08015;Badalona;9;37;A;;467;100;168;206;261;0;3;203;206
8;Barcelona;13;Barcelonès;08015;Badalona;9;37;B;;600;122;226;278;322;1;2;275;277
8;Barcelona;13;Barcelonès;08015;Badalona;9;38;U;;1034;234;463;551;483;3;4;544;548
8;Barcelona;13;Barcelonès;08015;Badalona;9;4;A;;753;158;300;350;403;0;2;348;350
8;Barcelona;13;Barcelonès;08015;Badalona;9;4;B;;748;168;318;355;393;0;5;350;355
8;Barcelona;13;Barcelonès;08015;Badalona;9;40;U;;462;110;177;209;253;2;4;203;207
8;Barcelona;13;Barcelonès;08015;Badalona;9;42;A;;526;113;191;242;284;0;1;241;242
8;Barcelona;13;Barcelonès;08015;Badalona;9;42;B;;622;143;251;297;325;1;0;296;296
8;Barcelona;13;Barcelonès;08015;Badalona;9;43;A;;622;107;249;352;270;0;2;350;352
8;Barcelona;13;Barcelonès;08015;Badalona;9;43;B;;713;137;268;391;322;1;1;389;390
8;Barcelona;13;Barcelonès;08015;Badalona;9;44;U;;923;167;359;448;475;0;3;445;448
8;Barcelona;13;Barcelonès;08015;Badalona;9;45;A;;654;145;265;356;298;0;1;355;356
8;Barcelona;13;Barcelonès;08015;Badalona;9;45;B;;800;151;326;432;368;0;4;428;432
8;Barcelona;13;Barcelonès;08015;Badalona;9;46;U;;812;194;342;435;377;0;6;429;435
8;Barcelona;13;Barcelonès;08015;Badalona;9;47;U;;904;168;331;401;503;0;2;399;401
8;Barcelona;13;Barcelonès;08015;Badalona;9;48;U;;1037;227;439;538;499;2;5;531;536
8;Barcelona;13;Barcelonès;08015;Badalona;9;49;A;;653;146;293;365;288;0;6;359;365
8;Barcelona;13;Barcelonès;08015;Badalona;9;49;B;;712;154;298;381;331;1;9;371;380
8;Barcelona;13;Barcelonès;08015;Badalona;9;5;A;;556;139;253;289;267;0;0;289;289
8;Barcelona;13;Barcelonès;08015;Badalona;9;5;B;;701;161;303;363;338;0;4;359;363
8;Barcelona;13;Barcelonès;08015;Badalona;9;50;U;;809;142;301;395;414;2;0;393;393
8;Barcelona;13;Barcelonès;08015;Badalona;9;52;U;;878;194;362;481;397;2;1;478;479
8;Barcelona;13;Barcelonès;08015;Badalona;9;53;A;;496;116;212;263;233;0;2;261;263
8;Barcelona;13;Barcelonès;08015;Badalona;9;53;B;;586;126;251;306;280;0;4;302;306
8;Barcelona;13;Barcelonès;08015;Badalona;9;54;A;;524;95;207;292;232;0;2;290;292
8;Barcelona;13;Barcelonès;08015;Badalona;9;54;B;;675;109;273;387;288;0;3;384;387
8;Barcelona;13;Barcelonès;08015;Badalona;9;55;U;;968;211;454;577;391;2;8;567;575
8;Barcelona;13;Barcelonès;08015;Badalona;9;56;U;;637;131;224;307;330;0;5;302;307
8;Barcelona;13;Barcelonès;08015;Badalona;9;57;U;;831;152;349;434;397;1;3;430;433
8;Barcelona;13;Barcelonès;08015;Badalona;9;6;U;;975;249;402;476;499;1;0;475;475
8;Barcelona;13;Barcelonès;08015;Badalona;9;7;U;;478;105;219;263;215;0;3;260;263
8;Barcelona;13;Barcelonès;08015;Badalona;9;8;A;;755;114;289;363;392;0;5;358;363
8;Barcelona;13;Barcelonès;08015;Badalona;9;8;B;;932;173;344;414;518;1;2;411;413
8;Barcelona;13;Barcelonès;08015;Badalona;9;9;A;;538;134;276;331;207;0;4;327;331
8;Barcelona;13;Barcelonès;08015;Badalona;9;9;B;;714;199;367;447;267;1;7;439;446
8;Barcelona;40;Vallès Occidental;08904;Badia del Vallès;1;1;A;;485;90;180;237;248;1;2;234;236
8;Barcelona;40;Vallès Occidental;08904;Badia del Vallès;1;1;B;;644;136;258;338;306;0;6;332;338
8;Barcelona;40;Vallès Occidental;08904;Badia del Vallès;1;10;A;;592;84;209;273;319;1;3;269;272
8;Barcelona;40;Vallès Occidental;08904;Badia del Vallès;1;10;B;;527;89;226;275;252;1;3;271;274
8;Barcelona;40;Vallès Occidental;08904;Badia del Vallès;1;11;A;;612;133;247;319;293;0;5;314;319
8;Barcelona;40;Vallès Occidental;08904;Badia del Vallès;1;11;B;;658;136;255;324;334;0;1;323;324
8;Barcelona;40;Vallès Occidental;08904;Badia del Vallès;1;12;A;;561;113;233;284;277;0;2;282;284
8;Barcelona;40;Vallès Occidental;08904;Badia del Vallès;1;12;B;;562;93;232;287;275;0;1;286;287
8;Barcelona;40;Vallès Occidental;08904;Badia del Vallès;1;2;U;;879;169;324;411;468;1;1;409;410
8;Barcelona;40;Vallès Occidental;08904;Badia del Vallès;1;3;A;;626;103;255;328;298;3;1;324;325
8;Barcelona;40;Vallès Occidental;08904;Badia del Vallès;1;3;B;;633;90;226;308;325;2;0;306;306
8;Barcelona;40;Vallès Occidental;08904;Badia del Vallès;1;4;A;;545;114;209;264;281;2;2;260;262
8;Barcelona;40;Vallès Occidental;08904;Badia del Vallès;1;4;B;;650;138;242;315;335;0;4;311;315
8;Barcelona;40;Vallès Occidental;08904;Badia del Vallès;1;5;A;;643;105;216;270;373;1;3;266;269
8;Barcelona;40;Vallès Occidental;08904;Badia del Vallès;1;5;B;;580;111;228;309;271;2;1;306;307
8;Barcelona;40;Vallès Occidental;08904;Badia del Vallès;1;6;A;;723;120;273;359;364;1;2;356;358
8;Barcelona;40;Vallès Occidental;08904;Badia del Vallès;1;6;B;;782;131;304;377;405;1;3;373;376
8;Barcelona;40;Vallès Occidental;08904;Badia del Vallès;1;7;A;;594;103;223;290;304;4;2;284;286
8;Barcelona;40;Vallès Occidental;08904;Badia del Vallès;1;7;B;;466;82;168;233;233;0;0;233;233
8;Barcelona;40;Vallès Occidental;08904;Badia del Vallès;1;8;A;;593;116;253;307;286;1;3;303;306
8;Barcelona;40;Vallès Occidental;08904;Badia del Vallès;1;8;B;;473;88;184;233;240;0;2;231;233
8;Barcelona;40;Vallès Occidental;08904;Badia del Vallès;1;9;A;;608;100;235;291;317;0;2;289;291
8;Barcelona;40;Vallès Occidental;08904;Badia del Vallès;1;9;B;;522;79;182;241;281;2;3;236;239
8;Barcelona;14;Berguedà;08016;Bagà;1;1;A;;825;197;485;580;245;5;4;571;575
8;Barcelona;14;Berguedà;08016;Bagà;1;1;B;;908;248;546;659;249;3;8;648;656
25;Lleida;26;Pallars Sobirà;25039;Baix Pallars;1;1;U;;328;59;183;226;102;0;1;225;226
25;Lleida;23;Noguera;25040;Balaguer;1;1;A;;562;163;313;373;189;1;1;371;372
25;Lleida;23;Noguera;25040;Balaguer;1;1;B;;600;180;357;437;163;3;6;428;434
25;Lleida;23;Noguera;25040;Balaguer;1;2;U;;893;182;485;627;266;2;9;616;625
25;Lleida;23;Noguera;25040;Balaguer;2;1;A;;551;133;226;289;262;1;3;285;288
25;Lleida;23;Noguera;25040;Balaguer;2;1;B;;312;77;169;204;108;0;1;203;204
25;Lleida;23;Noguera;25040;Balaguer;2;1;C;;427;116;225;276;151;1;1;274;275
25;Lleida;23;Noguera;25040;Balaguer;3;1;A;;788;161;384;532;256;0;3;529;532
25;Lleida;23;Noguera;25040;Balaguer;3;1;B;;849;186;431;595;254;0;2;593;595
25;Lleida;23;Noguera;25040;Balaguer;3;2;U;;883;185;449;604;279;1;8;595;603
25;Lleida;23;Noguera;25040;Balaguer;4;1;A;;676;195;400;519;157;3;3;513;516
25;Lleida;23;Noguera;25040;Balaguer;4;1;B;;782;199;466;589;193;1;10;578;588
25;Lleida;23;Noguera;25040;Balaguer;4;2;A;;742;207;410;520;222;0;6;514;520
25;Lleida;23;Noguera;25040;Balaguer;4;2;B;;927;230;480;642;285;1;8;633;641
25;Lleida;23;Noguera;25040;Balaguer;4;3;A;;703;121;381;515;188;1;5;509;514
25;Lleida;23;Noguera;25040;Balaguer;4;3;B;;915;204;500;682;233;1;4;677;681
8;Barcelona;24;Osona;08017;Balenyà;1;1;A;;740;211;451;525;215;2;3;520;523
8;Barcelona;24;Osona;08017;Balenyà;1;1;B;;602;145;341;417;185;2;1;414;415
8;Barcelona;24;Osona;08017;Balenyà;1;1;C;;792;215;496;587;205;3;3;581;584
8;Barcelona;24;Osona;08017;Balenyà;1;2;U;;423;114;246;279;144;1;0;278;278
8;Barcelona;7;Bages;08018;Balsareny;1;1;A;;694;180;401;466;228;2;2;462;464
8;Barcelona;7;Bages;08018;Balsareny;1;1;B;;642;181;376;447;195;3;3;441;444
8;Barcelona;7;Bages;08018;Balsareny;1;2;U;;966;277;532;616;350;4;6;606;612
8;Barcelona;7;Bages;08018;Balsareny;1;3;A;;273;72;164;201;72;1;1;199;200
8;Barcelona;7;Bages;08018;Balsareny;1;3;B;;201;56;111;129;72;2;1;126;127
43;Tarragona;12;Baix Penedès;43020;Banyeres del Penedès;1;1;A;;615;141;362;436;179;0;8;428;436
43;Tarragona;12;Baix Penedès;43020;Banyeres del Penedès;1;1;B;;655;153;388;460;195;1;2;457;459
17;Girona;28;Pla de l'Estany;17015;Banyoles;1;1;A;;564;189;344;411;153;1;7;403;410
17;Girona;28;Pla de l'Estany;17015;Banyoles;1;1;B;;632;215;382;477;155;2;3;472;475
17;Girona;28;Pla de l'Estany;17015;Banyoles;1;2;U;;729;253;458;546;183;3;6;537;543
17;Girona;28;Pla de l'Estany;17015;Banyoles;1;3;A;;727;222;404;493;234;0;4;489;493
17;Girona;28;Pla de l'Estany;17015;Banyoles;1;3;B;;725;228;430;513;212;1;1;511;512
17;Girona;28;Pla de l'Estany;17015;Banyoles;1;4;A;;622;201;369;443;179;3;4;436;440
17;Girona;28;Pla de l'Estany;17015;Banyoles;1;4;B;;798;300;514;594;204;6;6;582;588
17;Girona;28;Pla de l'Estany;17015;Banyoles;2;1;A;;858;280;515;620;238;0;7;613;620
17;Girona;28;Pla de l'Estany;17015;Banyoles;2;1;B;;915;278;564;681;234;3;5;673;678
17;Girona;28;Pla de l'Estany;17015;Banyoles;2;2;U;;783;260;498;582;201;1;4;577;581
17;Girona;28;Pla de l'Estany;17015;Banyoles;2;3;A;;829;273;485;590;239;0;11;579;590
17;Girona;28;Pla de l'Estany;17015;Banyoles;2;3;B;;864;302;504;644;220;4;3;637;640
17;Girona;28;Pla de l'Estany;17015;Banyoles;3;1;A;;559;206;387;438;121;2;4;432;436
17;Girona;28;Pla de l'Estany;17015;Banyoles;3;1;B;;598;218;408;460;138;3;6;451;457
17;Girona;28;Pla de l'Estany;17015;Banyoles;3;2;U;;843;223;489;537;306;2;7;528;535
25;Lleida;27;Pla d'Urgell;25041;Barbens;1;1;U;;652;159;384;482;170;0;1;481;482
43;Tarragona;16;Conca de Barberà;43021;Barberà de la Conca;1;1;U;;358;110;200;255;103;0;6;249;255
8;Barcelona;40;Vallès Occidental;08252;Barberà del Vallès;1;1;A;;754;176;345;434;320;1;2;431;433
8;Barcelona;40;Vallès Occidental;08252;Barberà del Vallès;1;1;B;;729;149;321;417;312;0;3;414;417
8;Barcelona;40;Vallès Occidental;08252;Barberà del Vallès;1;10;A;;554;127;275;346;208;1;7;338;345
8;Barcelona;40;Vallès Occidental;08252;Barberà del Vallès;1;10;B;;631;134;283;376;255;2;8;366;374
8;Barcelona;40;Vallès Occidental;08252;Barberà del Vallès;1;11;A;;590;97;249;346;244;2;7;337;344
8;Barcelona;40;Vallès Occidental;08252;Barberà del Vallès;1;11;B;;536;101;219;287;249;0;0;287;287
8;Barcelona;40;Vallès Occidental;08252;Barberà del Vallès;1;18;U;;835;178;361;459;376;0;7;452;459
8;Barcelona;40;Vallès Occidental;08252;Barberà del Vallès;1;19;A;;604;110;261;335;269;3;0;332;332
8;Barcelona;40;Vallès Occidental;08252;Barberà del Vallès;1;19;B;;533;101;227;291;242;1;3;287;290
8;Barcelona;40;Vallès Occidental;08252;Barberà del Vallès;1;2;A;;809;185;366;464;345;0;2;462;464
8;Barcelona;40;Vallès Occidental;08252;Barberà del Vallès;1;2;B;;790;179;342;445;345;0;6;439;445
8;Barcelona;40;Vallès Occidental;08252;Barberà del Vallès;1;20;U;;936;202;407;533;403;0;5;528;533
8;Barcelona;40;Vallès Occidental;08252;Barberà del Vallès;1;21;U;;965;179;426;542;423;0;9;533;542
8;Barcelona;40;Vallès Occidental;08252;Barberà del Vallès;1;22;U;;1097;206;498;697;400;1;12;684;696
8;Barcelona;40;Vallès Occidental;08252;Barberà del Vallès;1;23;A;;650;165;330;420;230;3;4;413;417
8;Barcelona;40;Vallès Occidental;08252;Barberà del Vallès;1;23;B;;600;148;298;393;207;0;4;389;393
8;Barcelona;40;Vallès Occidental;08252;Barberà del Vallès;1;3;A;;692;147;310;394;298;0;4;390;394
8;Barcelona;40;Vallès Occidental;08252;Barberà del Vallès;1;3;B;;651;117;264;340;311;1;9;330;339
8;Barcelona;40;Vallès Occidental;08252;Barberà del Vallès;1;4;A;;547;150;280;343;204;3;0;340;340
8;Barcelona;40;Vallès Occidental;08252;Barberà del Vallès;1;4;B;;565;143;275;333;232;1;1;331;332
8;Barcelona;40;Vallès Occidental;08252;Barberà del Vallès;1;5;A;;587;141;268;325;262;1;5;319;324
8;Barcelona;40;Vallès Occidental;08252;Barberà del Vallès;1;5;B;;521;113;251;293;228;0;3;290;293
8;Barcelona;40;Vallès Occidental;08252;Barberà del Vallès;1;6;U;;872;165;390;484;388;1;2;481;483
8;Barcelona;40;Vallès Occidental;08252;Barberà del Vallès;1;7;U;;663;137;287;373;290;0;2;371;373
8;Barcelona;40;Vallès Occidental;08252;Barberà del Vallès;1;8;A;;876;141;343;455;421;1;12;442;454
8;Barcelona;40;Vallès Occidental;08252;Barberà del Vallès;1;8;B;;806;151;347;477;329;1;11;465;476
8;Barcelona;40;Vallès Occidental;08252;Barberà del Vallès;1;9;U;;779;147;349;455;324;2;3;450;453
8;Barcelona;13;Barcelonès;08019;Barcelona;1;1;U;;614;171;273;342;272;1;1;340;341
8;Barcelona;13;Barcelonès;08019;Barcelona;1;10;U;;529;161;258;312;217;0;1;311;312
8;Barcelona;13;Barcelonès;08019;Barcelona;1;100;U;;830;243;371;422;408;0;6;416;422
8;Barcelona;13;Barcelonès;08019;Barcelona;1;103;U;;701;169;302;359;342;3;5;351;356
8;Barcelona;13;Barcelonès;08019;Barcelona;1;104;U;;734;219;331;383;351;1;3;379;382
8;Barcelona;13;Barcelonès;08019;Barcelona;1;105;U;;597;122;208;250;347;0;0;250;250
8;Barcelona;13;Barcelonès;08019;Barcelona;1;107;U;;770;191;331;374;396;0;4;370;374
8;Barcelona;13;Barcelonès;08019;Barcelona;1;108;U;;500;124;188;213;287;1;0;212;212
8;Barcelona;13;Barcelonès;08019;Barcelona;1;109;A;;725;234;355;381;344;2;3;376;379
8;Barcelona;13;Barcelonès;08019;Barcelona;1;109;B;;778;248;355;405;373;1;4;400;404
8;Barcelona;13;Barcelonès;08019;Barcelona;1;11;U;;865;268;444;503;362;7;4;492;496
8;Barcelona;13;Barcelonès;08019;Barcelona;1;112;U;;951;248;435;512;439;1;3;508;511
8;Barcelona;13;Barcelonès;08019;Barcelona;1;114;U;;665;202;317;358;307;4;4;350;354
8;Barcelona;13;Barcelonès;08019;Barcelona;1;115;U;;543;115;217;248;295;0;0;248;248
8;Barcelona;13;Barcelonès;08019;Barcelona;1;116;U;;1053;282;473;543;510;0;9;534;543
8;Barcelona;13;Barcelonès;08019;Barcelona;1;117;U;;586;143;238;263;323;4;4;255;259
8;Barcelona;13;Barcelonès;08019;Barcelona;1;118;U;;829;318;381;438;391;0;4;434;438
8;Barcelona;13;Barcelonès;08019;Barcelona;1;120;U;;1027;276;475;569;458;5;0;564;564
8;Barcelona;13;Barcelonès;08019;Barcelona;1;122;U;;676;170;288;331;345;2;0;329;329
8;Barcelona;13;Barcelonès;08019;Barcelona;1;123;U;;653;208;377;440;213;1;5;434;439
8;Barcelona;13;Barcelonès;08019;Barcelona;1;124;U;;908;225;389;458;450;4;0;454;454
8;Barcelona;13;Barcelonès;08019;Barcelona;1;126;U;;809;228;418;486;323;0;4;482;486
8;Barcelona;13;Barcelonès;08019;Barcelona;1;127;U;;800;210;377;456;344;0;2;454;456
8;Barcelona;13;Barcelonès;08019;Barcelona;1;129;U;;536;186;315;366;170;0;4;362;366
8;Barcelona;13;Barcelonès;08019;Barcelona;1;13;U;;434;158;261;294;140;0;4;290;294
8;Barcelona;13;Barcelonès;08019;Barcelona;1;130;U;;861;285;462;538;323;1;2;535;537
8;Barcelona;13;Barcelonès;08019;Barcelona;1;132;U;;702;184;356;416;286;2;8;406;414
8;Barcelona;13;Barcelonès;08019;Barcelona;1;134;U;;801;241;410;455;346;2;5;448;453
8;Barcelona;13;Barcelonès;08019;Barcelona;1;137;U;;498;142;241;276;222;4;5;267;272
8;Barcelona;13;Barcelonès;08019;Barcelona;1;138;U;;527;161;224;267;260;0;2;265;267
8;Barcelona;13;Barcelonès;08019;Barcelona;1;139;U;;708;190;341;394;314;0;7;387;394
8;Barcelona;13;Barcelonès;08019;Barcelona;1;14;U;;934;301;478;557;377;1;4;552;556
8;Barcelona;13;Barcelonès;08019;Barcelona;1;140;U;;649;209;327;374;275;0;4;370;374
8;Barcelona;13;Barcelonès;08019;Barcelona;1;141;U;;658;194;312;379;279;1;0;378;378
8;Barcelona;13;Barcelonès;08019;Barcelona;1;142;U;;920;242;383;462;458;1;1;460;461
8;Barcelona;13;Barcelonès;08019;Barcelona;1;144;U;;613;185;333;375;238;0;0;375;375
8;Barcelona;13;Barcelonès;08019;Barcelona;1;146;U;;973;293;530;591;382;0;6;585;591
8;Barcelona;13;Barcelonès;08019;Barcelona;1;148;U;;747;269;420;504;243;1;6;497;503
8;Barcelona;13;Barcelonès;08019;Barcelona;1;15;U;;664;186;299;353;311;2;0;351;351
8;Barcelona;13;Barcelonès;08019;Barcelona;1;150;U;;615;189;323;379;236;0;0;379;379
8;Barcelona;13;Barcelonès;08019;Barcelona;1;151;U;;655;159;286;337;318;0;4;333;337
8;Barcelona;13;Barcelonès;08019;Barcelona;1;16;U;;527;133;269;331;196;0;0;331;331
8;Barcelona;13;Barcelonès;08019;Barcelona;1;18;U;;652;144;275;320;332;1;1;318;319
8;Barcelona;13;Barcelonès;08019;Barcelona;1;19;U;;782;175;352;437;345;0;2;435;437
8;Barcelona;13;Barcelonès;08019;Barcelona;1;2;U;;573;153;292;343;230;3;2;338;340
8;Barcelona;13;Barcelonès;08019;Barcelona;1;20;U;;807;258;382;422;385;2;0;420;420
8;Barcelona;13;Barcelonès;08019;Barcelona;1;22;U;;605;149;246;277;328;0;0;277;277
8;Barcelona;13;Barcelonès;08019;Barcelona;1;23;A;;663;197;337;389;274;0;4;385;389
8;Barcelona;13;Barcelonès;08019;Barcelona;1;23;B;;824;241;403;459;365;0;2;457;459
8;Barcelona;13;Barcelonès;08019;Barcelona;1;25;U;;734;211;379;451;283;1;2;448;450
8;Barcelona;13;Barcelonès;08019;Barcelona;1;27;U;;920;287;494;575;345;4;3;568;571
8;Barcelona;13;Barcelonès;08019;Barcelona;1;29;U;;624;174;268;326;298;0;3;323;326
8;Barcelona;13;Barcelonès;08019;Barcelona;1;3;U;;772;211;344;386;386;0;2;384;386
8;Barcelona;13;Barcelonès;08019;Barcelona;1;30;U;;521;166;280;328;193;0;5;323;328
8;Barcelona;13;Barcelonès;08019;Barcelona;1;31;U;;654;196;327;407;247;1;3;403;406
8;Barcelona;13;Barcelonès;08019;Barcelona;1;32;U;;585;164;258;317;268;2;0;315;315
8;Barcelona;13;Barcelonès;08019;Barcelona;1;33;U;;670;196;344;408;262;4;5;399;404
8;Barcelona;13;Barcelonès;08019;Barcelona;1;34;U;;902;243;427;530;372;0;6;524;530
8;Barcelona;13;Barcelonès;08019;Barcelona;1;36;U;;792;245;408;446;346;0;1;445;446
8;Barcelona;13;Barcelonès;08019;Barcelona;1;38;U;;696;177;330;361;335;2;4;355;359
8;Barcelona;13;Barcelonès;08019;Barcelona;1;39;U;;842;240;439;554;288;0;5;549;554
8;Barcelona;13;Barcelonès;08019;Barcelona;1;40;U;;998;295;493;548;450;2;4;542;546
8;Barcelona;13;Barcelonès;08019;Barcelona;1;43;U;;385;97;142;166;219;1;4;161;165
8;Barcelona;13;Barcelonès;08019;Barcelona;1;44;U;;509;139;218;263;246;1;2;260;262
8;Barcelona;13;Barcelonès;08019;Barcelona;1;45;U;;598;170;275;326;272;0;5;321;326
8;Barcelona;13;Barcelonès;08019;Barcelona;1;46;U;;599;101;215;248;351;0;1;247;248
8;Barcelona;13;Barcelonès;08019;Barcelona;1;47;U;;536;156;260;300;236;1;1;298;299
8;Barcelona;13;Barcelonès;08019;Barcelona;1;48;U;;599;172;305;349;250;0;2;347;349
8;Barcelona;13;Barcelonès;08019;Barcelona;1;49;U;;1039;301;490;598;441;1;5;592;597
8;Barcelona;13;Barcelonès;08019;Barcelona;1;5;U;;597;201;278;314;283;0;5;309;314
8;Barcelona;13;Barcelonès;08019;Barcelona;1;50;U;;1024;307;530;612;412;4;7;601;608
8;Barcelona;13;Barcelonès;08019;Barcelona;1;52;U;;618;226;329;386;232;0;2;384;386
8;Barcelona;13;Barcelonès;08019;Barcelona;1;53;U;;738;192;351;408;330;2;0;406;406
8;Barcelona;13;Barcelonès;08019;Barcelona;1;54;U;;558;174;289;331;227;0;4;327;331
8;Barcelona;13;Barcelonès;08019;Barcelona;1;55;U;;503;159;243;290;213;1;6;283;289
8;Barcelona;13;Barcelonès;08019;Barcelona;1;56;U;;1003;276;538;638;365;0;10;628;638
8;Barcelona;13;Barcelonès;08019;Barcelona;1;58;U;;672;210;377;446;226;1;3;442;445
8;Barcelona;13;Barcelonès;08019;Barcelona;1;59;U;;679;213;338;405;274;1;6;398;404
8;Barcelona;13;Barcelonès;08019;Barcelona;1;6;U;;766;208;340;390;376;0;1;389;390
8;Barcelona;13;Barcelonès;08019;Barcelona;1;61;U;;824;235;390;488;336;1;3;484;487
8;Barcelona;13;Barcelonès;08019;Barcelona;1;63;U;;487;157;258;334;153;0;6;328;334
8;Barcelona;13;Barcelonès;08019;Barcelona;1;64;U;;710;204;409;507;203;1;3;503;506
8;Barcelona;13;Barcelonès;08019;Barcelona;1;66;U;;789;268;420;521;268;2;9;510;519
8;Barcelona;13;Barcelonès;08019;Barcelona;1;68;U;;705;199;372;462;243;0;6;456;462
8;Barcelona;13;Barcelonès;08019;Barcelona;1;69;U;;737;265;386;451;286;0;5;446;451
8;Barcelona;13;Barcelonès;08019;Barcelona;1;7;U;;743;189;350;403;340;0;5;398;403
8;Barcelona;13;Barcelonès;08019;Barcelona;1;71;U;;704;170;347;403;301;4;3;396;399
8;Barcelona;13;Barcelonès;08019;Barcelona;1;73;U;;513;117;214;255;258;2;1;252;253
8;Barcelona;13;Barcelonès;08019;Barcelona;1;75;A;;589;169;299;341;248;0;2;339;341
8;Barcelona;13;Barcelonès;08019;Barcelona;1;75;B;;655;186;315;372;283;3;2;367;369
8;Barcelona;13;Barcelonès;08019;Barcelona;1;77;U;;928;257;476;556;372;2;4;550;554
8;Barcelona;13;Barcelonès;08019;Barcelona;1;79;U;;723;197;298;358;365;0;0;358;358
8;Barcelona;13;Barcelonès;08019;Barcelona;1;8;U;;751;241;359;405;346;0;1;404;405
8;Barcelona;13;Barcelonès;08019;Barcelona;1;82;U;;887;240;502;509;378;1;4;504;508
8;Barcelona;13;Barcelonès;08019;Barcelona;1;83;U;;524;145;216;273;251;0;6;267;273
8;Barcelona;13;Barcelonès;08019;Barcelona;1;84;U;;547;132;239;296;251;1;4;291;295
8;Barcelona;13;Barcelonès;08019;Barcelona;1;86;U;;576;139;257;292;284;2;1;289;290
8;Barcelona;13;Barcelonès;08019;Barcelona;1;87;U;;776;197;315;353;423;1;1;351;352
8;Barcelona;13;Barcelonès;08019;Barcelona;1;88;U;;670;173;315;367;303;0;0;367;367
8;Barcelona;13;Barcelonès;08019;Barcelona;1;89;U;;559;155;273;323;236;2;4;317;321
8;Barcelona;13;Barcelonès;08019;Barcelona;1;9;U;;700;210;333;401;299;0;2;399;401
8;Barcelona;13;Barcelonès;08019;Barcelona;1;90;U;;523;139;223;253;270;0;1;252;253
8;Barcelona;13;Barcelonès;08019;Barcelona;1;91;U;;981;256;415;464;517;14;4;446;450
8;Barcelona;13;Barcelonès;08019;Barcelona;1;94;U;;1007;248;451;545;462;2;4;539;543
8;Barcelona;13;Barcelonès;08019;Barcelona;1;95;U;;984;310;500;548;436;9;8;531;539
8;Barcelona;13;Barcelonès;08019;Barcelona;1;97;U;;770;216;348;385;385;0;2;383;385
8;Barcelona;13;Barcelonès;08019;Barcelona;1;99;U;;713;202;303;351;362;0;3;348;351
8;Barcelona;13;Barcelonès;08019;Barcelona;10;1;A;;566;160;319;394;172;0;6;388;394
8;Barcelona;13;Barcelonès;08019;Barcelona;10;1;B;;609;158;313;396;213;0;3;393;396
8;Barcelona;13;Barcelonès;08019;Barcelona;10;10;U;;641;209;392;454;187;0;3;451;454
8;Barcelona;13;Barcelonès;08019;Barcelona;10;100;U;;557;160;283;332;225;2;6;324;330
8;Barcelona;13;Barcelonès;08019;Barcelona;10;101;A;;853;207;407;544;309;1;3;540;543
8;Barcelona;13;Barcelonès;08019;Barcelona;10;101;B;;887;222;449;568;319;3;6;559;565
8;Barcelona;13;Barcelonès;08019;Barcelona;10;101;C;;1011;266;513;627;384;0;3;624;627
8;Barcelona;13;Barcelonès;08019;Barcelona;10;102;A;;636;167;336;436;200;1;3;432;435
8;Barcelona;13;Barcelonès;08019;Barcelona;10;102;B;;616;144;312;411;205;0;1;410;411
8;Barcelona;13;Barcelonès;08019;Barcelona;10;103;A;;758;201;387;482;276;2;5;475;480
8;Barcelona;13;Barcelonès;08019;Barcelona;10;103;B;;866;219;442;535;331;1;7;527;534
8;Barcelona;13;Barcelonès;08019;Barcelona;10;104;U;;785;252;443;532;253;0;1;531;532
8;Barcelona;13;Barcelonès;08019;Barcelona;10;105;U;;1003;262;521;656;347;1;7;648;655
8;Barcelona;13;Barcelonès;08019;Barcelona;10;106;A;;525;176;307;366;159;1;2;363;365
8;Barcelona;13;Barcelonès;08019;Barcelona;10;106;B;;641;194;344;427;214;1;3;423;426
8;Barcelona;13;Barcelonès;08019;Barcelona;10;107;U;;698;171;368;451;247;3;2;446;448
8;Barcelona;13;Barcelonès;08019;Barcelona;10;108;U;;602;179;342;410;192;0;7;403;410
8;Barcelona;13;Barcelonès;08019;Barcelona;10;109;U;;795;219;440;521;274;1;2;518;520
8;Barcelona;13;Barcelonès;08019;Barcelona;10;11;U;;988;247;502;640;348;0;7;633;640
8;Barcelona;13;Barcelonès;08019;Barcelona;10;110;U;;742;224;396;494;248;2;0;492;492
8;Barcelona;13;Barcelonès;08019;Barcelona;10;111;U;;948;285;483;620;328;3;11;606;617
8;Barcelona;13;Barcelonès;08019;Barcelona;10;113;A;;707;190;359;461;246;1;2;458;460
8;Barcelona;13;Barcelonès;08019;Barcelona;10;113;B;;726;206;378;479;247;1;9;469;478
8;Barcelona;13;Barcelonès;08019;Barcelona;10;115;U;;895;222;460;604;291;1;11;592;603
8;Barcelona;13;Barcelonès;08019;Barcelona;10;116;U;;1112;251;631;758;354;1;9;748;757
8;Barcelona;13;Barcelonès;08019;Barcelona;10;117;U;;697;302;383;453;244;3;1;449;450
8;Barcelona;13;Barcelonès;08019;Barcelona;10;118;U;;1011;302;601;712;299;0;11;701;712
8;Barcelona;13;Barcelonès;08019;Barcelona;10;120;U;;733;213;409;498;235;1;5;492;497
8;Barcelona;13;Barcelonès;08019;Barcelona;10;121;U;;933;268;543;685;248;2;9;674;683
8;Barcelona;13;Barcelonès;08019;Barcelona;10;122;U;;1105;290;588;772;333;0;15;757;772
8;Barcelona;13;Barcelonès;08019;Barcelona;10;123;A;;556;166;275;367;189;0;2;365;367
8;Barcelona;13;Barcelonès;08019;Barcelona;10;123;B;;584;157;281;370;214;3;3;364;367
8;Barcelona;13;Barcelonès;08019;Barcelona;10;125;U;;568;163;332;402;166;2;3;397;400
8;Barcelona;13;Barcelonès;08019;Barcelona;10;126;U;;558;128;251;326;232;0;7;319;326
8;Barcelona;13;Barcelonès;08019;Barcelona;10;127;U;;1078;334;612;764;314;4;8;752;760
8;Barcelona;13;Barcelonès;08019;Barcelona;10;129;U;;555;138;263;337;218;0;5;332;337
8;Barcelona;13;Barcelonès;08019;Barcelona;10;13;U;;482;147;261;318;164;0;9;309;318
8;Barcelona;13;Barcelonès;08019;Barcelona;10;130;U;;554;152;302;400;154;1;3;396;399
8;Barcelona;13;Barcelonès;08019;Barcelona;10;131;U;;522;140;271;349;173;0;8;341;349
8;Barcelona;13;Barcelonès;08019;Barcelona;10;132;U;;518;143;282;374;144;0;3;371;374
8;Barcelona;13;Barcelonès;08019;Barcelona;10;133;A;;576;182;343;439;137;0;1;438;439
8;Barcelona;13;Barcelonès;08019;Barcelona;10;133;B;;689;171;390;506;183;0;4;502;506
8;Barcelona;13;Barcelonès;08019;Barcelona;10;134;U;;790;253;486;575;215;0;6;569;575
8;Barcelona;13;Barcelonès;08019;Barcelona;10;135;U;;1012;249;538;670;342;0;4;666;670
8;Barcelona;13;Barcelonès;08019;Barcelona;10;137;U;;629;84;330;424;205;0;7;417;424
8;Barcelona;13;Barcelonès;08019;Barcelona;10;138;U;;1035;328;596;735;300;1;6;728;734
8;Barcelona;13;Barcelonès;08019;Barcelona;10;139;U;;798;243;468;559;239;2;10;547;557
8;Barcelona;13;Barcelonès;08019;Barcelona;10;14;A;;937;290;545;681;256;5;6;670;676
8;Barcelona;13;Barcelonès;08019;Barcelona;10;14;B;;654;207;396;471;183;0;6;465;471
8;Barcelona;13;Barcelonès;08019;Barcelona;10;14;C;;914;248;527;666;248;0;5;661;666
8;Barcelona;13;Barcelonès;08019;Barcelona;10;14;D;;740;207;426;527;213;2;11;514;525
8;Barcelona;13;Barcelonès;08019;Barcelona;10;140;A;;620;145;337;402;218;1;5;396;401
8;Barcelona;13;Barcelonès;08019;Barcelona;10;140;B;;675;194;377;465;210;1;7;457;464
8;Barcelona;13;Barcelonès;08019;Barcelona;10;142;U;;834;269;464;556;278;0;7;549;556
8;Barcelona;13;Barcelonès;08019;Barcelona;10;143;U;;543;149;257;330;213;0;9;321;330
8;Barcelona;13;Barcelonès;08019;Barcelona;10;144;U;;761;180;386;481;280;0;7;474;481
8;Barcelona;13;Barcelonès;08019;Barcelona;10;145;U;;950;259;480;599;351;1;5;593;598
8;Barcelona;13;Barcelonès;08019;Barcelona;10;146;U;;675;222;354;437;238;3;1;433;434
8;Barcelona;13;Barcelonès;08019;Barcelona;10;147;U;;760;232;435;533;227;1;4;528;532
8;Barcelona;13;Barcelonès;08019;Barcelona;10;149;U;;832;267;483;586;246;1;2;583;585
8;Barcelona;13;Barcelonès;08019;Barcelona;10;150;U;;1077;277;553;730;347;0;11;719;730
8;Barcelona;13;Barcelonès;08019;Barcelona;10;151;U;;640;225;370;425;215;0;0;425;425
8;Barcelona;13;Barcelonès;08019;Barcelona;10;152;A;;542;158;291;359;183;0;6;353;359
8;Barcelona;13;Barcelonès;08019;Barcelona;10;152;B;;671;202;381;455;216;2;4;449;453
8;Barcelona;13;Barcelonès;08019;Barcelona;10;154;U;;1053;323;618;724;329;0;5;719;724
8;Barcelona;13;Barcelonès;08019;Barcelona;10;155;A;;646;186;339;434;212;1;6;427;433
8;Barcelona;13;Barcelonès;08019;Barcelona;10;155;B;;801;228;437;542;259;0;8;534;542
8;Barcelona;13;Barcelonès;08019;Barcelona;10;156;A;;684;198;379;456;228;0;5;451;456
8;Barcelona;13;Barcelonès;08019;Barcelona;10;156;B;;721;212;410;503;218;0;2;501;503
8;Barcelona;13;Barcelonès;08019;Barcelona;10;158;U;;622;180;360;409;213;4;0;405;405
8;Barcelona;13;Barcelonès;08019;Barcelona;10;160;A;;542;168;302;353;189;0;6;347;353
8;Barcelona;13;Barcelonès;08019;Barcelona;10;160;B;;604;175;339;406;198;0;10;396;406
8;Barcelona;13;Barcelonès;08019;Barcelona;10;161;U;;1116;285;636;754;362;0;6;748;754
8;Barcelona;13;Barcelonès;08019;Barcelona;10;163;A;;780;165;382;489;291;1;8;480;488
8;Barcelona;13;Barcelonès;08019;Barcelona;10;163;B;;845;219;424;551;294;0;5;546;551
8;Barcelona;13;Barcelonès;08019;Barcelona;10;164;A;;551;153;299;361;190;0;4;357;361
8;Barcelona;13;Barcelonès;08019;Barcelona;10;164;B;;671;181;352;436;235;0;2;434;436
8;Barcelona;13;Barcelonès;08019;Barcelona;10;165;U;;905;266;488;608;297;0;4;604;608
8;Barcelona;13;Barcelonès;08019;Barcelona;10;166;U;;826;283;433;523;303;0;2;521;523
8;Barcelona;13;Barcelonès;08019;Barcelona;10;168;U;;891;281;462;549;342;5;1;543;544
8;Barcelona;13;Barcelonès;08019;Barcelona;10;170;U;;492;209;285;319;173;1;1;317;318
8;Barcelona;13;Barcelonès;08019;Barcelona;10;171;U;;517;169;274;344;173;0;1;343;344
8;Barcelona;13;Barcelonès;08019;Barcelona;10;172;U;;744;210;428;521;223;0;4;517;521
8;Barcelona;13;Barcelonès;08019;Barcelona;10;173;A;;652;174;346;444;208;0;4;440;444
8;Barcelona;13;Barcelonès;08019;Barcelona;10;173;B;;728;208;390;521;207;2;9;510;519
8;Barcelona;13;Barcelonès;08019;Barcelona;10;174;U;;774;212;398;493;281;0;3;490;493
8;Barcelona;13;Barcelonès;08019;Barcelona;10;175;U;;1120;321;570;765;355;0;12;753;765
8;Barcelona;13;Barcelonès;08019;Barcelona;10;176;A;;837;167;347;478;359;1;4;473;477
8;Barcelona;13;Barcelonès;08019;Barcelona;10;176;B;;949;184;395;539;410;0;4;535;539
8;Barcelona;13;Barcelonès;08019;Barcelona;10;177;U;;673;224;387;458;215;0;6;452;458
8;Barcelona;13;Barcelonès;08019;Barcelona;10;178;U;;996;301;533;616;380;0;7;609;616
8;Barcelona;13;Barcelonès;08019;Barcelona;10;18;U;;1067;289;540;619;448;4;5;610;615
8;Barcelona;13;Barcelonès;08019;Barcelona;10;180;A;;557;159;259;339;218;0;0;339;339
8;Barcelona;13;Barcelonès;08019;Barcelona;10;180;B;;668;212;357;445;223;1;6;438;444
8;Barcelona;13;Barcelonès;08019;Barcelona;10;182;U;;577;188;188;394;183;4;0;390;390
8;Barcelona;13;Barcelonès;08019;Barcelona;10;183;A;;795;205;404;515;280;4;3;508;511
8;Barcelona;13;Barcelonès;08019;Barcelona;10;183;B;;954;253;610;608;346;0;7;601;608
8;Barcelona;13;Barcelonès;08019;Barcelona;10;184;U;;530;140;280;374;156;0;3;371;374
8;Barcelona;13;Barcelonès;08019;Barcelona;10;185;U;;848;202;460;576;272;3;3;570;573
8;Barcelona;13;Barcelonès;08019;Barcelona;10;186;U;;629;163;340;434;195;0;6;428;434
8;Barcelona;13;Barcelonès;08019;Barcelona;10;187;U;;836;266;497;575;261;3;4;568;572
8;Barcelona;13;Barcelonès;08019;Barcelona;10;188;U;;787;273;464;539;248;0;2;537;539
8;Barcelona;13;Barcelonès;08019;Barcelona;10;189;U;;705;190;369;474;231;0;1;473;474
8;Barcelona;13;Barcelonès;08019;Barcelona;10;190;U;;866;228;448;562;304;5;0;557;557
8;Barcelona;13;Barcelonès;08019;Barcelona;10;191;A;;573;139;308;386;187;1;1;384;385
8;Barcelona;13;Barcelonès;08019;Barcelona;10;191;B;;598;150;349;403;195;0;4;399;403
8;Barcelona;13;Barcelonès;08019;Barcelona;10;192;A;;599;150;315;388;211;4;7;377;384
8;Barcelona;13;Barcelonès;08019;Barcelona;10;192;B;;658;150;326;410;248;0;3;407;410
8;Barcelona;13;Barcelonès;08019;Barcelona;10;193;U;;540;158;265;308;232;0;1;307;308
8;Barcelona;13;Barcelonès;08019;Barcelona;10;194;A;;682;134;300;388;294;2;6;380;386
8;Barcelona;13;Barcelonès;08019;Barcelona;10;194;B;;703;139;336;414;289;0;4;410;414
8;Barcelona;13;Barcelonès;08019;Barcelona;10;195;A;;788;209;388;490;298;0;8;482;490
8;Barcelona;13;Barcelonès;08019;Barcelona;10;195;B;;1050;274;496;653;397;0;14;639;653
8;Barcelona;13;Barcelonès;08019;Barcelona;10;197;U;;1129;350;668;775;354;0;10;765;775
8;Barcelona;13;Barcelonès;08019;Barcelona;10;198;U;;882;241;465;589;293;1;5;583;588
8;Barcelona;13;Barcelonès;08019;Barcelona;10;199;A;;607;157;318;389;218;2;3;384;387
8;Barcelona;13;Barcelonès;08019;Barcelona;10;199;B;;666;201;369;438;228;1;7;430;437
8;Barcelona;13;Barcelonès;08019;Barcelona;10;2;U;;1039;284;548;693;346;0;6;687;693
8;Barcelona;13;Barcelonès;08019;Barcelona;10;20;U;;735;178;356;409;326;2;6;401;407
8;Barcelona;13;Barcelonès;08019;Barcelona;10;200;U;;980;266;535;654;326;7;2;645;647
8;Barcelona;13;Barcelonès;08019;Barcelona;10;201;U;;550;110;268;351;199;0;3;348;351
8;Barcelona;13;Barcelonès;08019;Barcelona;10;202;A;;830;192;400;513;317;3;8;502;510
8;Barcelona;13;Barcelonès;08019;Barcelona;10;202;B;;933;222;462;580;353;0;5;575;580
8;Barcelona;13;Barcelonès;08019;Barcelona;10;203;U;;671;176;343;445;226;0;9;436;445
8;Barcelona;13;Barcelonès;08019;Barcelona;10;204;U;;725;232;408;489;236;0;7;482;489
8;Barcelona;13;Barcelonès;08019;Barcelona;10;205;U;;592;150;292;366;226;0;2;364;366
8;Barcelona;13;Barcelonès;08019;Barcelona;10;206;U;;986;187;498;630;356;0;4;626;630
8;Barcelona;13;Barcelonès;08019;Barcelona;10;207;A;;558;115;260;351;207;0;4;347;351
8;Barcelona;13;Barcelonès;08019;Barcelona;10;207;B;;697;170;350;463;234;0;8;455;463
8;Barcelona;13;Barcelonès;08019;Barcelona;10;208;U;;789;204;399;501;288;0;5;496;501
8;Barcelona;13;Barcelonès;08019;Barcelona;10;209;U;;799;247;442;533;266;1;6;526;532
8;Barcelona;13;Barcelonès;08019;Barcelona;10;21;A;;616;154;319;404;212;1;5;398;403
8;Barcelona;13;Barcelonès;08019;Barcelona;10;21;B;;681;169;360;447;234;2;1;444;445
8;Barcelona;13;Barcelonès;08019;Barcelona;10;210;U;;581;119;260;322;259;1;4;317;321
8;Barcelona;13;Barcelonès;08019;Barcelona;10;211;A;;542;164;274;348;194;0;5;343;348
8;Barcelona;13;Barcelonès;08019;Barcelona;10;211;B;;662;154;302;400;262;2;1;397;398
8;Barcelona;13;Barcelonès;08019;Barcelona;10;212;U;;937;228;445;572;365;3;10;559;569
8;Barcelona;13;Barcelonès;08019;Barcelona;10;213;U;;756;139;329;446;310;3;4;439;443
8;Barcelona;13;Barcelonès;08019;Barcelona;10;214;U;;564;125;266;330;234;0;2;328;330
8;Barcelona;13;Barcelonès;08019;Barcelona;10;215;U;;963;239;464;554;409;0;4;550;554
8;Barcelona;13;Barcelonès;08019;Barcelona;10;216;U;;681;172;345;410;271;3;2;405;407
8;Barcelona;13;Barcelonès;08019;Barcelona;10;217;U;;809;187;391;472;337;0;3;469;472
8;Barcelona;13;Barcelonès;08019;Barcelona;10;218;U;;828;238;420;487;341;3;1;483;484
8;Barcelona;13;Barcelonès;08019;Barcelona;10;22;U;;719;204;338;416;303;0;6;410;416
8;Barcelona;13;Barcelonès;08019;Barcelona;10;220;U;;1057;213;491;622;435;0;9;613;622
8;Barcelona;13;Barcelonès;08019;Barcelona;10;221;U;;808;206;392;480;328;5;8;467;475
8;Barcelona;13;Barcelonès;08019;Barcelona;10;222;U;;925;215;432;543;382;0;4;539;543
8;Barcelona;13;Barcelonès;08019;Barcelona;10;223;A;;762;215;368;430;332;0;6;424;430
8;Barcelona;13;Barcelonès;08019;Barcelona;10;223;B;;912;231;430;496;416;1;4;491;495
8;Barcelona;13;Barcelonès;08019;Barcelona;10;224;A;;757;191;365;493;264;1;6;486;492
8;Barcelona;13;Barcelonès;08019;Barcelona;10;224;B;;746;196;367;470;276;1;5;464;469
8;Barcelona;13;Barcelonès;08019;Barcelona;10;225;U;;1109;285;516;686;423;1;6;679;685
8;Barcelona;13;Barcelonès;08019;Barcelona;10;226;U;;1010;230;457;542;468;1;4;537;541
8;Barcelona;13;Barcelonès;08019;Barcelona;10;227;U;;853;245;417;470;383;1;0;469;469
8;Barcelona;13;Barcelonès;08019;Barcelona;10;229;U;;838;384;476;549;289;1;3;545;548
8;Barcelona;13;Barcelonès;08019;Barcelona;10;23;U;;1021;310;556;645;376;2;7;636;643
8;Barcelona;13;Barcelonès;08019;Barcelona;10;230;A;;753;228;381;472;281;1;6;465;471
8;Barcelona;13;Barcelonès;08019;Barcelona;10;230;B;;734;210;379;470;264;0;4;466;470
8;Barcelona;13;Barcelonès;08019;Barcelona;10;25;U;;847;231;453;541;306;2;4;535;539
8;Barcelona;13;Barcelonès;08019;Barcelona;10;26;A;;684;204;346;422;262;1;6;415;421
8;Barcelona;13;Barcelonès;08019;Barcelona;10;26;B;;676;223;352;409;267;0;3;406;409
8;Barcelona;13;Barcelonès;08019;Barcelona;10;28;U;;510;153;266;309;201;0;1;308;309
8;Barcelona;13;Barcelonès;08019;Barcelona;10;3;U;;514;150;278;352;162;0;13;339;352
8;Barcelona;13;Barcelonès;08019;Barcelona;10;30;U;;551;188;320;364;187;0;0;364;364
8;Barcelona;13;Barcelonès;08019;Barcelona;10;31;U;;727;212;431;523;204;5;0;518;518
8;Barcelona;13;Barcelonès;08019;Barcelona;10;32;U;;826;224;454;556;270;0;7;549;556
8;Barcelona;13;Barcelonès;08019;Barcelona;10;34;U;;591;209;336;408;183;0;1;407;408
8;Barcelona;13;Barcelonès;08019;Barcelona;10;35;U;;651;199;396;479;172;2;3;474;477
8;Barcelona;13;Barcelonès;08019;Barcelona;10;36;U;;779;245;420;494;285;0;6;488;494
8;Barcelona;13;Barcelonès;08019;Barcelona;10;37;U;;611;165;291;353;258;0;5;348;353
8;Barcelona;13;Barcelonès;08019;Barcelona;10;38;U;;630;185;318;362;268;0;2;360;362
8;Barcelona;13;Barcelonès;08019;Barcelona;10;39;U;;607;169;311;365;242;0;2;363;365
8;Barcelona;13;Barcelonès;08019;Barcelona;10;4;U;;833;246;425;548;285;1;9;538;547
8;Barcelona;13;Barcelonès;08019;Barcelona;10;40;A;;729;180;346;398;331;0;0;398;398
8;Barcelona;13;Barcelonès;08019;Barcelona;10;40;B;;828;208;390;470;358;0;2;468;470
8;Barcelona;13;Barcelonès;08019;Barcelona;10;41;U;;791;198;417;495;296;0;4;491;495
8;Barcelona;13;Barcelonès;08019;Barcelona;10;43;A;;664;219;364;448;216;0;3;445;448
8;Barcelona;13;Barcelonès;08019;Barcelona;10;43;B;;818;241;392;509;309;0;7;502;509
8;Barcelona;13;Barcelonès;08019;Barcelona;10;45;U;;772;216;406;476;296;4;3;469;472
8;Barcelona;13;Barcelonès;08019;Barcelona;10;46;U;;1118;300;557;696;422;8;0;688;688
8;Barcelona;13;Barcelonès;08019;Barcelona;10;47;U;;694;174;370;466;228;0;6;460;466
8;Barcelona;13;Barcelonès;08019;Barcelona;10;48;U;;737;212;411;491;246;1;5;485;490
8;Barcelona;13;Barcelonès;08019;Barcelona;10;49;A;;549;176;287;341;208;0;4;337;341
8;Barcelona;13;Barcelonès;08019;Barcelona;10;49;B;;631;223;372;420;211;1;4;415;419
8;Barcelona;13;Barcelonès;08019;Barcelona;10;5;A;;556;152;312;377;179;0;4;373;377
8;Barcelona;13;Barcelonès;08019;Barcelona;10;5;B;;624;160;434;415;209;0;5;410;415
8;Barcelona;13;Barcelonès;08019;Barcelona;10;50;U;;784;229;433;535;249;1;4;530;534
8;Barcelona;13;Barcelonès;08019;Barcelona;10;51;U;;1111;324;561;688;423;0;0;688;688
8;Barcelona;13;Barcelonès;08019;Barcelona;10;54;U;;793;220;418;456;337;3;2;451;453
8;Barcelona;13;Barcelonès;08019;Barcelona;10;56;U;;1017;329;581;704;313;3;3;698;701
8;Barcelona;13;Barcelonès;08019;Barcelona;10;57;A;;656;179;301;378;278;0;1;377;378
8;Barcelona;13;Barcelonès;08019;Barcelona;10;57;B;;737;200;336;418;319;0;3;415;418
8;Barcelona;13;Barcelonès;08019;Barcelona;10;58;U;;878;221;360;594;284;0;5;589;594
8;Barcelona;13;Barcelonès;08019;Barcelona;10;59;U;;728;185;357;472;256;2;10;460;470
8;Barcelona;13;Barcelonès;08019;Barcelona;10;6;U;;1044;298;562;710;334;4;6;700;706
8;Barcelona;13;Barcelonès;08019;Barcelona;10;60;A;;690;185;381;461;229;0;4;457;461
8;Barcelona;13;Barcelonès;08019;Barcelona;10;60;B;;745;216;432;511;234;0;10;501;511
8;Barcelona;13;Barcelonès;08019;Barcelona;10;60;C;;659;178;358;449;210;1;8;440;448
8;Barcelona;13;Barcelonès;08019;Barcelona;10;62;U;;1075;249;462;536;539;1;3;532;535
8;Barcelona;13;Barcelonès;08019;Barcelona;10;64;U;;430;122;190;226;204;0;1;225;226
8;Barcelona;13;Barcelonès;08019;Barcelona;10;65;A;;860;211;432;560;300;3;5;552;557
8;Barcelona;13;Barcelonès;08019;Barcelona;10;65;B;;920;260;490;605;315;3;3;599;602
8;Barcelona;13;Barcelonès;08019;Barcelona;10;65;C;;960;250;497;619;341;3;1;615;616
8;Barcelona;13;Barcelonès;08019;Barcelona;10;66;U;;883;260;455;518;365;1;4;513;517
8;Barcelona;13;Barcelonès;08019;Barcelona;10;68;U;;889;228;447;555;334;0;7;548;555
8;Barcelona;13;Barcelonès;08019;Barcelona;10;69;U;;584;187;310;375;209;2;4;369;373
8;Barcelona;13;Barcelonès;08019;Barcelona;10;70;U;;616;137;254;345;271;0;2;343;345
8;Barcelona;13;Barcelonès;08019;Barcelona;10;71;U;;1073;217;478;600;473;9;0;591;591
8;Barcelona;13;Barcelonès;08019;Barcelona;10;72;U;;775;214;475;503;272;3;7;493;500
8;Barcelona;13;Barcelonès;08019;Barcelona;10;73;A;;640;155;302;389;251;0;6;383;389
8;Barcelona;13;Barcelonès;08019;Barcelona;10;73;B;;658;173;320;402;256;0;2;400;402
8;Barcelona;13;Barcelonès;08019;Barcelona;10;75;U;;684;156;280;330;354;0;1;329;330
8;Barcelona;13;Barcelonès;08019;Barcelona;10;76;U;;541;192;286;343;198;2;1;340;341
8;Barcelona;13;Barcelonès;08019;Barcelona;10;77;U;;954;212;375;462;492;0;6;456;462
8;Barcelona;13;Barcelonès;08019;Barcelona;10;78;U;;613;182;313;353;260;0;3;350;353
8;Barcelona;13;Barcelonès;08019;Barcelona;10;79;U;;780;248;374;440;340;0;4;436;440
8;Barcelona;13;Barcelonès;08019;Barcelona;10;8;U;;760;181;437;542;218;2;6;534;540
8;Barcelona;13;Barcelonès;08019;Barcelona;10;80;U;;479;158;251;301;178;0;3;298;301
8;Barcelona;13;Barcelonès;08019;Barcelona;10;82;U;;1045;118;533;611;434;4;3;604;607
8;Barcelona;13;Barcelonès;08019;Barcelona;10;83;U;;835;250;413;479;356;0;0;479;479
8;Barcelona;13;Barcelonès;08019;Barcelona;10;85;U;;806;252;402;460;346;2;4;454;458
8;Barcelona;13;Barcelonès;08019;Barcelona;10;86;U;;520;520;268;305;215;0;4;301;305
8;Barcelona;13;Barcelonès;08019;Barcelona;10;87;U;;540;172;302;353;187;2;2;349;351
8;Barcelona;13;Barcelonès;08019;Barcelona;10;88;U;;827;249;430;514;313;1;3;510;513
8;Barcelona;13;Barcelonès;08019;Barcelona;10;89;U;;756;217;417;491;265;1;0;490;490
8;Barcelona;13;Barcelonès;08019;Barcelona;10;9;U;;886;268;516;611;275;0;7;604;611
8;Barcelona;13;Barcelonès;08019;Barcelona;10;90;U;;988;305;535;639;349;1;3;635;638
8;Barcelona;13;Barcelonès;08019;Barcelona;10;92;U;;569;189;311;357;212;1;4;352;356
8;Barcelona;13;Barcelonès;08019;Barcelona;10;93;A;;559;101;236;327;232;1;4;322;326
8;Barcelona;13;Barcelonès;08019;Barcelona;10;93;B;;565;111;224;328;237;0;4;324;328
8;Barcelona;13;Barcelonès;08019;Barcelona;10;94;U;;706;267;431;485;221;0;3;482;485
8;Barcelona;13;Barcelonès;08019;Barcelona;10;96;A;;587;131;266;328;259;2;5;321;326
8;Barcelona;13;Barcelonès;08019;Barcelona;10;96;B;;688;199;346;406;282;0;4;402;406
8;Barcelona;13;Barcelonès;08019;Barcelona;10;98;A;;730;192;381;445;285;0;7;438;445
8;Barcelona;13;Barcelonès;08019;Barcelona;10;98;B;;863;211;411;543;320;0;4;539;543
8;Barcelona;13;Barcelonès;08019;Barcelona;10;98;C;;808;215;400;505;303;0;3;502;505
8;Barcelona;13;Barcelonès;08019;Barcelona;10;99;U;;550;115;233;323;227;2;0;321;321
8;Barcelona;13;Barcelonès;08019;Barcelona;2;1;U;;540;169;314;364;176;7;0;357;357
8;Barcelona;13;Barcelonès;08019;Barcelona;2;10;U;;573;179;299;366;207;0;5;361;366
8;Barcelona;13;Barcelonès;08019;Barcelona;2;100;U;;535;145;312;377;158;0;4;373;377
8;Barcelona;13;Barcelonès;08019;Barcelona;2;101;U;;951;265;498;632;319;0;5;627;632
8;Barcelona;13;Barcelonès;08019;Barcelona;2;102;U;;860;256;494;603;257;1;6;596;602
8;Barcelona;13;Barcelonès;08019;Barcelona;2;103;U;;759;185;356;452;307;0;2;450;452
8;Barcelona;13;Barcelonès;08019;Barcelona;2;104;U;;646;178;374;445;201;2;11;432;443
8;Barcelona;13;Barcelonès;08019;Barcelona;2;105;U;;644;209;349;435;209;0;1;434;435
8;Barcelona;13;Barcelonès;08019;Barcelona;2;106;U;;679;182;375;465;214;1;4;460;464
8;Barcelona;13;Barcelonès;08019;Barcelona;2;107;U;;505;155;289;356;149;1;1;354;355
8;Barcelona;13;Barcelonès;08019;Barcelona;2;108;U;;601;188;349;434;167;1;4;429;433
8;Barcelona;13;Barcelonès;08019;Barcelona;2;109;U;;552;172;341;384;168;0;8;376;384
8;Barcelona;13;Barcelonès;08019;Barcelona;2;11;U;;837;243;450;527;310;2;2;523;525
8;Barcelona;13;Barcelonès;08019;Barcelona;2;110;U;;787;238;410;501;286;2;6;493;499
8;Barcelona;13;Barcelonès;08019;Barcelona;2;112;U;;827;241;500;606;221;2;6;598;604
8;Barcelona;13;Barcelonès;08019;Barcelona;2;114;U;;828;243;446;580;248;1;5;574;579
8;Barcelona;13;Barcelonès;08019;Barcelona;2;115;U;;885;268;500;607;278;0;7;600;607
8;Barcelona;13;Barcelonès;08019;Barcelona;2;117;U;;498;141;305;369;129;1;7;361;368
8;Barcelona;13;Barcelonès;08019;Barcelona;2;118;U;;485;132;339;375;110;1;4;370;374
8;Barcelona;13;Barcelonès;08019;Barcelona;2;119;U;;687;191;411;482;205;0;4;478;482
8;Barcelona;13;Barcelonès;08019;Barcelona;2;12;U;;833;263;465;587;246;0;14;573;587
8;Barcelona;13;Barcelonès;08019;Barcelona;2;120;U;;538;139;351;416;122;0;6;410;416
8;Barcelona;13;Barcelonès;08019;Barcelona;2;121;U;;512;181;331;400;112;2;5;393;398
8;Barcelona;13;Barcelonès;08019;Barcelona;2;122;U;;607;179;325;428;179;2;9;417;426
8;Barcelona;13;Barcelonès;08019;Barcelona;2;124;U;;678;216;385;489;189;1;12;476;488
8;Barcelona;13;Barcelonès;08019;Barcelona;2;125;U;;748;238;452;531;217;0;0;531;531
8;Barcelona;13;Barcelonès;08019;Barcelona;2;126;U;;553;184;348;413;140;0;7;406;413
8;Barcelona;13;Barcelonès;08019;Barcelona;2;127;U;;758;199;408;488;270;0;8;480;488
8;Barcelona;13;Barcelonès;08019;Barcelona;2;128;U;;1094;275;620;748;346;3;3;742;745
8;Barcelona;13;Barcelonès;08019;Barcelona;2;129;U;;974;294;612;717;257;2;9;706;715
8;Barcelona;13;Barcelonès;08019;Barcelona;2;13;A;;605;175;373;456;149;4;7;445;452
8;Barcelona;13;Barcelonès;08019;Barcelona;2;13;B;;643;190;388;475;168;1;3;471;474
8;Barcelona;13;Barcelonès;08019;Barcelona;2;130;U;;758;247;426;524;234;1;5;518;523
8;Barcelona;13;Barcelonès;08019;Barcelona;2;131;U;;843;272;478;569;274;1;5;563;568
8;Barcelona;13;Barcelonès;08019;Barcelona;2;132;A;;606;192;371;461;145;1;2;458;460
8;Barcelona;13;Barcelonès;08019;Barcelona;2;132;B;;558;158;318;406;152;0;6;400;406
8;Barcelona;13;Barcelonès;08019;Barcelona;2;133;A;;579;190;339;432;147;3;0;429;429
8;Barcelona;13;Barcelonès;08019;Barcelona;2;133;B;;627;197;402;490;137;2;6;482;488
8;Barcelona;13;Barcelonès;08019;Barcelona;2;134;A;;637;190;361;429;208;3;4;422;426
8;Barcelona;13;Barcelonès;08019;Barcelona;2;134;B;;654;226;388;470;184;1;10;459;469
8;Barcelona;13;Barcelonès;08019;Barcelona;2;135;U;;1037;302;604;732;305;1;5;726;731
8;Barcelona;13;Barcelonès;08019;Barcelona;2;137;A;;569;142;320;426;143;1;12;413;425
8;Barcelona;13;Barcelonès;08019;Barcelona;2;137;B;;604;157;335;438;166;1;9;428;437
8;Barcelona;13;Barcelonès;08019;Barcelona;2;138;A;;653;199;378;466;187;1;3;462;465
8;Barcelona;13;Barcelonès;08019;Barcelona;2;138;B;;797;212;429;534;263;2;3;529;532
8;Barcelona;13;Barcelonès;08019;Barcelona;2;14;U;;729;181;393;497;232;2;4;491;495
8;Barcelona;13;Barcelonès;08019;Barcelona;2;140;U;;1099;340;594;703;396;2;7;694;701
8;Barcelona;13;Barcelonès;08019;Barcelona;2;141;U;;770;187;394;478;292;0;7;471;478
8;Barcelona;13;Barcelonès;08019;Barcelona;2;142;U;;692;185;376;447;245;0;2;445;447
8;Barcelona;13;Barcelonès;08019;Barcelona;2;143;U;;838;229;473;581;257;4;3;574;577
8;Barcelona;13;Barcelonès;08019;Barcelona;2;144;U;;951;275;577;704;247;2;4;698;702
8;Barcelona;13;Barcelonès;08019;Barcelona;2;145;A;;583;155;314;409;174;2;3;404;407
8;Barcelona;13;Barcelonès;08019;Barcelona;2;145;B;;703;214;417;532;171;1;5;526;531
8;Barcelona;13;Barcelonès;08019;Barcelona;2;146;A;;700;171;399;505;195;0;3;502;505
8;Barcelona;13;Barcelonès;08019;Barcelona;2;146;B;;744;183;428;547;197;1;7;539;546
8;Barcelona;13;Barcelonès;08019;Barcelona;2;148;A;;639;157;377;470;169;1;11;458;469
8;Barcelona;13;Barcelonès;08019;Barcelona;2;148;B;;620;146;350;477;143;0;7;470;477
8;Barcelona;13;Barcelonès;08019;Barcelona;2;149;U;;871;249;471;596;275;0;3;593;596
8;Barcelona;13;Barcelonès;08019;Barcelona;2;15;U;;535;165;317;392;143;1;6;385;391
8;Barcelona;13;Barcelonès;08019;Barcelona;2;151;U;;668;191;376;466;202;0;2;464;466
8;Barcelona;13;Barcelonès;08019;Barcelona;2;152;U;;931;256;528;654;277;1;16;637;653
8;Barcelona;13;Barcelonès;08019;Barcelona;2;153;U;;642;168;375;476;166;0;10;466;476
8;Barcelona;13;Barcelonès;08019;Barcelona;2;154;U;;980;308;568;725;255;0;15;710;725
8;Barcelona;13;Barcelonès;08019;Barcelona;2;155;U;;1015;300;588;731;284;0;6;725;731
8;Barcelona;13;Barcelonès;08019;Barcelona;2;156;U;;752;205;397;496;256;0;7;489;496
8;Barcelona;13;Barcelonès;08019;Barcelona;2;157;U;;894;207;509;642;252;1;13;628;641
8;Barcelona;13;Barcelonès;08019;Barcelona;2;158;U;;905;249;573;687;218;0;19;668;687
8;Barcelona;13;Barcelonès;08019;Barcelona;2;159;U;;563;153;309;372;191;5;4;363;367
8;Barcelona;13;Barcelonès;08019;Barcelona;2;16;U;;609;206;353;431;178;3;2;426;428
8;Barcelona;13;Barcelonès;08019;Barcelona;2;160;U;;594;180;357;433;161;1;3;429;432
8;Barcelona;13;Barcelonès;08019;Barcelona;2;161;U;;806;239;454;565;241;1;9;555;564
8;Barcelona;13;Barcelonès;08019;Barcelona;2;162;U;;760;246;442;540;220;1;3;536;539
8;Barcelona;13;Barcelonès;08019;Barcelona;2;163;A;;544;153;337;400;144;1;8;391;399
8;Barcelona;13;Barcelonès;08019;Barcelona;2;163;B;;672;162;406;504;168;1;10;493;503
8;Barcelona;13;Barcelonès;08019;Barcelona;2;167;U;;930;343;579;709;221;1;15;693;708
8;Barcelona;13;Barcelonès;08019;Barcelona;2;168;U;;830;254;507;615;215;0;11;604;615
8;Barcelona;13;Barcelonès;08019;Barcelona;2;169;U;;594;150;316;428;166;0;7;421;428
8;Barcelona;13;Barcelonès;08019;Barcelona;2;17;U;;614;197;360;436;178;1;6;429;435
8;Barcelona;13;Barcelonès;08019;Barcelona;2;170;U;;926;219;537;672;254;0;7;665;672
8;Barcelona;13;Barcelonès;08019;Barcelona;2;171;U;;678;180;382;464;214;0;11;453;464
8;Barcelona;13;Barcelonès;08019;Barcelona;2;172;U;;669;201;434;522;147;1;8;513;521
8;Barcelona;13;Barcelonès;08019;Barcelona;2;173;U;;574;225;355;433;141;0;5;428;433
8;Barcelona;13;Barcelonès;08019;Barcelona;2;174;U;;572;137;307;409;163;2;4;403;407
8;Barcelona;13;Barcelonès;08019;Barcelona;2;175;U;;683;197;436;517;166;0;8;509;517
8;Barcelona;13;Barcelonès;08019;Barcelona;2;176;U;;916;253;483;590;326;2;3;585;588
8;Barcelona;13;Barcelonès;08019;Barcelona;2;177;U;;610;171;338;423;187;1;8;414;422
8;Barcelona;13;Barcelonès;08019;Barcelona;2;178;U;;702;204;416;506;196;0;7;499;506
8;Barcelona;13;Barcelonès;08019;Barcelona;2;179;U;;680;182;380;466;214;0;3;463;466
8;Barcelona;13;Barcelonès;08019;Barcelona;2;18;A;;633;192;391;460;173;0;5;455;460
8;Barcelona;13;Barcelonès;08019;Barcelona;2;18;B;;736;213;459;567;169;0;6;561;567
8;Barcelona;13;Barcelonès;08019;Barcelona;2;180;U;;921;298;528;645;276;5;9;631;640
8;Barcelona;13;Barcelonès;08019;Barcelona;2;182;U;;537;147;308;379;158;1;2;376;378
8;Barcelona;13;Barcelonès;08019;Barcelona;2;183;U;;847;239;505;637;210;2;8;627;635
8;Barcelona;13;Barcelonès;08019;Barcelona;2;184;U;;790;246;498;590;200;0;2;588;590
8;Barcelona;13;Barcelonès;08019;Barcelona;2;185;U;;1053;305;642;793;260;2;15;776;791
8;Barcelona;13;Barcelonès;08019;Barcelona;2;187;U;;688;209;421;514;174;1;7;506;513
8;Barcelona;13;Barcelonès;08019;Barcelona;2;189;U;;707;243;478;567;140;1;5;561;566
8;Barcelona;13;Barcelonès;08019;Barcelona;2;19;U;;1094;285;598;773;321;7;1;765;766
8;Barcelona;13;Barcelonès;08019;Barcelona;2;190;U;;568;174;374;434;134;0;8;426;434
8;Barcelona;13;Barcelonès;08019;Barcelona;2;191;U;;584;184;377;440;144;3;7;430;437
8;Barcelona;13;Barcelonès;08019;Barcelona;2;192;U;;800;147;447;575;225;0;6;569;575
8;Barcelona;13;Barcelonès;08019;Barcelona;2;193;U;;829;228;462;593;236;3;10;580;590
8;Barcelona;13;Barcelonès;08019;Barcelona;2;195;U;;493;165;317;378;115;1;15;362;377
8;Barcelona;13;Barcelonès;08019;Barcelona;2;196;U;;525;182;335;398;127;3;4;391;395
8;Barcelona;13;Barcelonès;08019;Barcelona;2;197;U;;955;262;528;665;290;0;6;659;665
8;Barcelona;13;Barcelonès;08019;Barcelona;2;199;U;;597;196;393;445;152;3;8;434;442
8;Barcelona;13;Barcelonès;08019;Barcelona;2;2;U;;809;268;470;565;244;1;4;560;564
8;Barcelona;13;Barcelonès;08019;Barcelona;2;20;A;;633;171;321;405;228;0;5;400;405
8;Barcelona;13;Barcelonès;08019;Barcelona;2;20;B;;656;182;346;411;245;2;6;403;409
8;Barcelona;13;Barcelonès;08019;Barcelona;2;201;U;;1033;289;737;749;284;1;8;740;748
8;Barcelona;13;Barcelonès;08019;Barcelona;2;203;U;;640;206;398;455;185;0;4;451;455
8;Barcelona;13;Barcelonès;08019;Barcelona;2;206;U;;796;167;460;560;236;1;7;552;559
8;Barcelona;13;Barcelonès;08019;Barcelona;2;207;U;;715;223;434;544;171;3;5;536;541
8;Barcelona;13;Barcelonès;08019;Barcelona;2;209;U;;535;213;347;405;130;0;3;402;405
8;Barcelona;13;Barcelonès;08019;Barcelona;2;21;A;;642;184;332;400;242;0;3;397;400
8;Barcelona;13;Barcelonès;08019;Barcelona;2;21;B;;605;156;295;388;217;0;2;386;388
8;Barcelona;13;Barcelonès;08019;Barcelona;2;210;U;;476;129;271;328;148;0;4;324;328
8;Barcelona;13;Barcelonès;08019;Barcelona;2;211;U;;713;211;400;509;204;0;12;497;509
8;Barcelona;13;Barcelonès;08019;Barcelona;2;212;U;;968;272;532;694;274;1;13;680;693
8;Barcelona;13;Barcelonès;08019;Barcelona;2;213;U;;757;219;444;546;211;6;4;536;540
8;Barcelona;13;Barcelonès;08019;Barcelona;2;214;U;;813;264;475;569;244;3;10;556;566
8;Barcelona;13;Barcelonès;08019;Barcelona;2;215;U;;988;296;581;716;272;1;12;703;715
8;Barcelona;13;Barcelonès;08019;Barcelona;2;216;U;;813;247;444;528;285;0;10;518;528
8;Barcelona;13;Barcelonès;08019;Barcelona;2;219;U;;885;266;515;635;250;0;4;631;635
8;Barcelona;13;Barcelonès;08019;Barcelona;2;220;U;;556;148;296;388;168;1;5;382;387
8;Barcelona;13;Barcelonès;08019;Barcelona;2;221;U;;1124;270;576;730;394;0;14;716;730
8;Barcelona;13;Barcelonès;08019;Barcelona;2;224;U;;637;204;379;454;183;1;3;450;453
8;Barcelona;13;Barcelonès;08019;Barcelona;2;225;U;;865;265;495;622;243;1;6;615;621
8;Barcelona;13;Barcelonès;08019;Barcelona;2;226;U;;616;172;356;439;177;1;2;436;438
8;Barcelona;13;Barcelonès;08019;Barcelona;2;229;U;;713;202;396;511;202;0;3;508;511
8;Barcelona;13;Barcelonès;08019;Barcelona;2;230;U;;914;265;472;595;319;1;13;581;594
8;Barcelona;13;Barcelonès;08019;Barcelona;2;231;U;;719;221;427;556;163;1;14;541;555
8;Barcelona;13;Barcelonès;08019;Barcelona;2;232;U;;564;196;355;400;164;0;4;396;400
8;Barcelona;13;Barcelonès;08019;Barcelona;2;233;U;;798;233;475;626;172;0;8;618;626
8;Barcelona;13;Barcelonès;08019;Barcelona;2;234;U;;752;212;477;572;180;0;7;565;572
8;Barcelona;13;Barcelonès;08019;Barcelona;2;236;U;;824;235;484;587;237;1;7;579;586
8;Barcelona;13;Barcelonès;08019;Barcelona;2;237;U;;760;230;446;547;213;2;9;536;545
8;Barcelona;13;Barcelonès;08019;Barcelona;2;238;U;;1054;300;627;759;295;1;5;753;758
8;Barcelona;13;Barcelonès;08019;Barcelona;2;239;U;;850;236;499;626;224;0;6;620;626
8;Barcelona;13;Barcelonès;08019;Barcelona;2;24;U;;750;234;432;527;223;1;5;521;526
8;Barcelona;13;Barcelonès;08019;Barcelona;2;240;A;;608;147;339;426;182;1;2;423;425
8;Barcelona;13;Barcelonès;08019;Barcelona;2;240;B;;628;158;365;435;193;0;4;431;435
8;Barcelona;13;Barcelonès;08019;Barcelona;2;241;A;;561;149;333;414;147;0;8;406;414
8;Barcelona;13;Barcelonès;08019;Barcelona;2;241;B;;583;209;360;441;142;0;5;436;441
8;Barcelona;13;Barcelonès;08019;Barcelona;2;243;U;;819;210;456;554;265;0;6;548;554
8;Barcelona;13;Barcelonès;08019;Barcelona;2;244;U;;682;198;369;474;208;8;4;462;466
8;Barcelona;13;Barcelonès;08019;Barcelona;2;246;A;;561;163;315;375;186;1;3;371;374
8;Barcelona;13;Barcelonès;08019;Barcelona;2;246;B;;613;140;327;394;219;2;9;383;392
8;Barcelona;13;Barcelonès;08019;Barcelona;2;247;U;;904;260;466;593;311;1;5;587;592
8;Barcelona;13;Barcelonès;08019;Barcelona;2;248;U;;981;271;576;696;285;0;8;688;696
8;Barcelona;13;Barcelonès;08019;Barcelona;2;249;U;;1057;320;605;708;349;5;4;699;703
8;Barcelona;13;Barcelonès;08019;Barcelona;2;25;A;;552;172;315;401;151;1;2;398;400
8;Barcelona;13;Barcelonès;08019;Barcelona;2;25;B;;595;175;363;445;150;0;3;442;445
8;Barcelona;13;Barcelonès;08019;Barcelona;2;251;U;;1118;77;563;703;415;1;5;697;702
8;Barcelona;13;Barcelonès;08019;Barcelona;2;252;U;;920;265;518;634;286;4;7;623;630
8;Barcelona;13;Barcelonès;08019;Barcelona;2;253;U;;972;250;504;586;386;1;7;578;585
8;Barcelona;13;Barcelonès;08019;Barcelona;2;255;U;;730;240;442;525;205;0;5;520;525
8;Barcelona;13;Barcelonès;08019;Barcelona;2;256;U;;757;228;419;495;262;0;4;491;495
8;Barcelona;13;Barcelonès;08019;Barcelona;2;257;U;;1062;277;613;727;335;0;9;718;727
8;Barcelona;13;Barcelonès;08019;Barcelona;2;258;A;;548;158;298;374;174;0;8;366;374
8;Barcelona;13;Barcelonès;08019;Barcelona;2;258;B;;624;128;309;404;220;1;2;401;403
8;Barcelona;13;Barcelonès;08019;Barcelona;2;259;U;;797;251;466;565;232;2;12;551;563
8;Barcelona;13;Barcelonès;08019;Barcelona;2;26;U;;869;279;529;657;212;4;12;641;653
8;Barcelona;13;Barcelonès;08019;Barcelona;2;260;U;;785;203;459;544;241;0;2;542;544
8;Barcelona;13;Barcelonès;08019;Barcelona;2;261;U;;627;184;362;429;198;1;6;422;428
8;Barcelona;13;Barcelonès;08019;Barcelona;2;262;A;;604;180;339;434;170;0;5;429;434
8;Barcelona;13;Barcelonès;08019;Barcelona;2;262;B;;677;180;381;494;183;0;2;492;494
8;Barcelona;13;Barcelonès;08019;Barcelona;2;264;U;;853;205;426;544;309;0;8;536;544
8;Barcelona;13;Barcelonès;08019;Barcelona;2;265;U;;767;231;423;511;256;5;6;500;506
8;Barcelona;13;Barcelonès;08019;Barcelona;2;266;U;;669;167;352;422;247;0;3;419;422
8;Barcelona;13;Barcelonès;08019;Barcelona;2;267;U;;722;194;392;472;250;0;5;467;472
8;Barcelona;13;Barcelonès;08019;Barcelona;2;268;U;;713;212;414;482;231;6;5;471;476
8;Barcelona;13;Barcelonès;08019;Barcelona;2;269;U;;996;276;509;658;338;0;6;652;658
8;Barcelona;13;Barcelonès;08019;Barcelona;2;27;U;;674;223;386;463;211;0;7;456;463
8;Barcelona;13;Barcelonès;08019;Barcelona;2;271;U;;936;244;477;595;341;1;3;591;594
8;Barcelona;13;Barcelonès;08019;Barcelona;2;272;U;;772;225;436;495;277;0;9;486;495
8;Barcelona;13;Barcelonès;08019;Barcelona;2;273;U;;1013;276;564;673;340;2;9;662;671
8;Barcelona;13;Barcelonès;08019;Barcelona;2;274;U;;928;244;489;612;316;1;8;603;611
8;Barcelona;13;Barcelonès;08019;Barcelona;2;275;U;;919;264;507;631;288;1;9;621;630
8;Barcelona;13;Barcelonès;08019;Barcelona;2;276;U;;1077;312;593;724;353;8;7;709;716
8;Barcelona;13;Barcelonès;08019;Barcelona;2;277;U;;1031;301;591;708;323;2;6;700;706
8;Barcelona;13;Barcelonès;08019;Barcelona;2;278;U;;778;172;394;496;282;2;3;491;494
8;Barcelona;13;Barcelonès;08019;Barcelona;2;279;U;;831;262;480;599;232;2;6;591;597
8;Barcelona;13;Barcelonès;08019;Barcelona;2;28;U;;824;273;486;578;246;2;6;570;576
8;Barcelona;13;Barcelonès;08019;Barcelona;2;280;A;;600;181;359;437;163;2;6;429;435
8;Barcelona;13;Barcelonès;08019;Barcelona;2;280;B;;700;221;398;491;209;0;1;490;491
8;Barcelona;13;Barcelonès;08019;Barcelona;2;281;U;;655;164;373;476;179;1;3;472;475
8;Barcelona;13;Barcelonès;08019;Barcelona;2;282;U;;549;158;311;379;170;1;2;376;378
8;Barcelona;13;Barcelonès;08019;Barcelona;2;283;U;;1002;263;548;678;324;0;3;675;678
8;Barcelona;13;Barcelonès;08019;Barcelona;2;284;U;;1036;295;576;682;354;0;5;677;682
8;Barcelona;13;Barcelonès;08019;Barcelona;2;285;A;;608;205;366;439;169;0;2;437;439
8;Barcelona;13;Barcelonès;08019;Barcelona;2;285;B;;656;167;355;457;199;1;5;451;456
8;Barcelona;13;Barcelonès;08019;Barcelona;2;286;U;;745;230;465;541;204;0;4;537;541
8;Barcelona;13;Barcelonès;08019;Barcelona;2;287;U;;883;267;479;603;280;4;6;593;599
8;Barcelona;13;Barcelonès;08019;Barcelona;2;288;U;;753;239;431;500;253;2;7;491;498
8;Barcelona;13;Barcelonès;08019;Barcelona;2;289;U;;963;280;522;619;344;0;3;616;619
8;Barcelona;13;Barcelonès;08019;Barcelona;2;29;U;;838;253;503;614;224;2;9;603;612
8;Barcelona;13;Barcelonès;08019;Barcelona;2;290;U;;856;234;467;576;280;1;10;565;575
8;Barcelona;13;Barcelonès;08019;Barcelona;2;292;U;;765;241;444;545;220;0;5;540;545
8;Barcelona;13;Barcelonès;08019;Barcelona;2;294;U;;590;217;374;448;142;1;9;438;447
8;Barcelona;13;Barcelonès;08019;Barcelona;2;295;U;;780;181;419;535;245;5;11;519;530
8;Barcelona;13;Barcelonès;08019;Barcelona;2;296;U;;899;311;503;613;286;0;3;610;613
8;Barcelona;13;Barcelonès;08019;Barcelona;2;297;U;;1024;255;598;716;308;0;11;705;716
8;Barcelona;13;Barcelonès;08019;Barcelona;2;298;U;;885;215;470;546;339;2;5;539;544
8;Barcelona;13;Barcelonès;08019;Barcelona;2;3;U;;677;199;363;449;228;0;1;448;449
8;Barcelona;13;Barcelonès;08019;Barcelona;2;30;A;;578;164;312;388;190;0;6;382;388
8;Barcelona;13;Barcelonès;08019;Barcelona;2;30;B;;619;180;324;413;206;3;5;405;410
8;Barcelona;13;Barcelonès;08019;Barcelona;2;300;U;;904;276;549;661;243;0;6;655;661
8;Barcelona;13;Barcelonès;08019;Barcelona;2;301;A;;629;233;401;465;164;2;2;461;463
8;Barcelona;13;Barcelonès;08019;Barcelona;2;301;B;;707;254;461;539;168;3;1;535;536
8;Barcelona;13;Barcelonès;08019;Barcelona;2;302;U;;1088;271;610;770;318;0;16;754;770
8;Barcelona;13;Barcelonès;08019;Barcelona;2;303;U;;1112;314;659;827;285;1;13;813;826
8;Barcelona;13;Barcelonès;08019;Barcelona;2;304;U;;1068;320;598;723;345;2;9;712;721
8;Barcelona;13;Barcelonès;08019;Barcelona;2;305;A;;573;179;327;416;157;1;8;407;415
8;Barcelona;13;Barcelonès;08019;Barcelona;2;305;B;;600;175;321;386;214;3;5;378;383
8;Barcelona;13;Barcelonès;08019;Barcelona;2;306;U;;1048;300;608;752;296;1;5;746;751
8;Barcelona;13;Barcelonès;08019;Barcelona;2;307;A;;747;227;434;555;192;2;5;548;553
8;Barcelona;13;Barcelonès;08019;Barcelona;2;307;B;;816;204;487;623;193;0;10;613;623
8;Barcelona;13;Barcelonès;08019;Barcelona;2;308;U;;1006;295;606;716;290;3;6;707;713
8;Barcelona;13;Barcelonès;08019;Barcelona;2;309;U;;519;178;277;309;210;4;2;303;305
8;Barcelona;13;Barcelonès;08019;Barcelona;2;31;U;;906;289;517;626;280;0;5;621;626
8;Barcelona;13;Barcelonès;08019;Barcelona;2;310;U;;503;135;243;304;199;1;4;299;303
8;Barcelona;13;Barcelonès;08019;Barcelona;2;311;U;;1015;292;581;710;305;4;8;698;706
8;Barcelona;13;Barcelonès;08019;Barcelona;2;312;U;;952;334;590;692;260;0;12;680;692
8;Barcelona;13;Barcelonès;08019;Barcelona;2;314;U;;693;210;388;494;199;0;13;481;494
8;Barcelona;13;Barcelonès;08019;Barcelona;2;315;U;;908;244;470;599;309;0;3;596;599
8;Barcelona;13;Barcelonès;08019;Barcelona;2;317;A;;637;193;353;419;218;0;7;412;419
8;Barcelona;13;Barcelonès;08019;Barcelona;2;317;B;;664;200;358;440;224;0;4;436;440
8;Barcelona;13;Barcelonès;08019;Barcelona;2;32;U;;913;285;524;664;249;2;9;653;662
8;Barcelona;13;Barcelonès;08019;Barcelona;2;33;U;;844;229;442;588;256;4;9;575;584
8;Barcelona;13;Barcelonès;08019;Barcelona;2;34;U;;1050;331;591;733;317;3;2;728;730
8;Barcelona;13;Barcelonès;08019;Barcelona;2;35;U;;730;202;420;480;250;0;6;474;480
8;Barcelona;13;Barcelonès;08019;Barcelona;2;36;U;;858;303;496;591;267;1;5;585;590
8;Barcelona;13;Barcelonès;08019;Barcelona;2;37;U;;862;471;518;616;246;4;6;606;612
8;Barcelona;13;Barcelonès;08019;Barcelona;2;39;U;;721;222;394;486;235;1;5;480;485
8;Barcelona;13;Barcelonès;08019;Barcelona;2;4;U;;695;195;372;449;246;0;7;442;449
8;Barcelona;13;Barcelonès;08019;Barcelona;2;40;U;;783;264;458;559;224;3;6;550;556
8;Barcelona;13;Barcelonès;08019;Barcelona;2;41;U;;869;228;500;600;269;3;6;591;597
8;Barcelona;13;Barcelonès;08019;Barcelona;2;42;U;;732;183;384;478;254;1;4;473;477
8;Barcelona;13;Barcelonès;08019;Barcelona;2;43;U;;860;263;460;561;299;1;7;553;560
8;Barcelona;13;Barcelonès;08019;Barcelona;2;45;U;;642;204;338;434;208;1;7;426;433
8;Barcelona;13;Barcelonès;08019;Barcelona;2;47;U;;821;249;445;545;276;1;3;541;544
8;Barcelona;13;Barcelonès;08019;Barcelona;2;48;U;;510;144;276;326;184;0;5;321;326
8;Barcelona;13;Barcelonès;08019;Barcelona;2;49;U;;1045;301;569;698;347;17;3;678;681
8;Barcelona;13;Barcelonès;08019;Barcelona;2;5;U;;633;187;379;464;169;0;7;457;464
8;Barcelona;13;Barcelonès;08019;Barcelona;2;51;U;;531;139;287;382;149;1;4;377;381
8;Barcelona;13;Barcelonès;08019;Barcelona;2;52;U;;753;217;430;522;231;0;4;518;522
8;Barcelona;13;Barcelonès;08019;Barcelona;2;53;U;;660;172;414;482;178;0;3;479;482
8;Barcelona;13;Barcelonès;08019;Barcelona;2;54;U;;778;244;474;554;224;1;5;548;553
8;Barcelona;13;Barcelonès;08019;Barcelona;2;55;U;;498;172;297;346;152;0;2;344;346
8;Barcelona;13;Barcelonès;08019;Barcelona;2;56;U;;665;187;368;465;200;0;8;457;465
8;Barcelona;13;Barcelonès;08019;Barcelona;2;57;U;;657;182;384;464;193;2;4;458;462
8;Barcelona;13;Barcelonès;08019;Barcelona;2;58;U;;630;184;336;418;212;2;1;415;416
8;Barcelona;13;Barcelonès;08019;Barcelona;2;59;U;;703;201;384;458;245;0;2;456;458
8;Barcelona;13;Barcelonès;08019;Barcelona;2;6;U;;623;162;332;385;238;0;5;380;385
8;Barcelona;13;Barcelonès;08019;Barcelona;2;60;U;;861;245;491;589;272;8;3;578;581
8;Barcelona;13;Barcelonès;08019;Barcelona;2;61;U;;891;286;516;627;264;0;6;621;627
8;Barcelona;13;Barcelonès;08019;Barcelona;2;62;U;;710;201;403;494;216;1;3;490;493
8;Barcelona;13;Barcelonès;08019;Barcelona;2;63;U;;950;290;530;660;290;3;8;649;657
8;Barcelona;13;Barcelonès;08019;Barcelona;2;65;U;;884;308;536;646;238;0;5;641;646
8;Barcelona;13;Barcelonès;08019;Barcelona;2;66;U;;889;237;492;624;265;0;7;617;624
8;Barcelona;13;Barcelonès;08019;Barcelona;2;67;U;;966;292;558;670;296;2;9;659;668
8;Barcelona;13;Barcelonès;08019;Barcelona;2;68;U;;975;283;543;661;314;0;8;653;661
8;Barcelona;13;Barcelonès;08019;Barcelona;2;7;U;;711;229;367;440;271;1;2;437;439
8;Barcelona;13;Barcelonès;08019;Barcelona;2;70;U;;687;220;388;447;240;5;0;442;442
8;Barcelona;13;Barcelonès;08019;Barcelona;2;71;U;;969;256;530;687;282;0;9;678;687
8;Barcelona;13;Barcelonès;08019;Barcelona;2;72;U;;793;232;444;547;246;0;5;542;547
8;Barcelona;13;Barcelonès;08019;Barcelona;2;73;U;;971;298;631;729;242;5;8;716;724
8;Barcelona;13;Barcelonès;08019;Barcelona;2;74;U;;908;250;551;632;276;1;6;625;631
8;Barcelona;13;Barcelonès;08019;Barcelona;2;75;A;;549;181;323;383;166;0;6;377;383
8;Barcelona;13;Barcelonès;08019;Barcelona;2;75;B;;671;258;443;502;169;0;5;497;502
8;Barcelona;13;Barcelonès;08019;Barcelona;2;77;U;;927;234;528;636;291;1;9;626;635
8;Barcelona;13;Barcelonès;08019;Barcelona;2;78;U;;676;213;373;434;242;2;7;425;432
8;Barcelona;13;Barcelonès;08019;Barcelona;2;79;U;;1060;269;582;743;317;0;5;738;743
8;Barcelona;13;Barcelonès;08019;Barcelona;2;8;U;;765;224;384;457;308;0;6;451;457
8;Barcelona;13;Barcelonès;08019;Barcelona;2;80;U;;1008;221;558;710;298;2;9;699;708
8;Barcelona;13;Barcelonès;08019;Barcelona;2;81;U;;1011;235;526;687;324;1;4;682;686
8;Barcelona;13;Barcelonès;08019;Barcelona;2;82;U;;951;275;512;635;316;0;8;627;635
8;Barcelona;13;Barcelonès;08019;Barcelona;2;83;U;;691;214;400;485;206;0;3;482;485
8;Barcelona;13;Barcelonès;08019;Barcelona;2;84;A;;632;187;362;434;198;0;4;430;434
8;Barcelona;13;Barcelonès;08019;Barcelona;2;84;B;;663;195;363;434;229;1;3;430;433
8;Barcelona;13;Barcelonès;08019;Barcelona;2;85;U;;797;231;459;571;226;2;10;559;569
8;Barcelona;13;Barcelonès;08019;Barcelona;2;86;A;;562;138;286;375;187;1;3;371;374
8;Barcelona;13;Barcelonès;08019;Barcelona;2;86;B;;588;160;331;410;178;0;3;407;410
8;Barcelona;13;Barcelonès;08019;Barcelona;2;87;U;;735;222;419;524;211;1;7;516;523
8;Barcelona;13;Barcelonès;08019;Barcelona;2;88;U;;494;164;301;350;144;0;5;345;350
8;Barcelona;13;Barcelonès;08019;Barcelona;2;89;U;;1050;319;550;777;273;0;10;767;777
8;Barcelona;13;Barcelonès;08019;Barcelona;2;9;U;;769;285;435;524;245;4;5;515;520
8;Barcelona;13;Barcelonès;08019;Barcelona;2;90;A;;533;155;320;403;130;1;4;398;402
8;Barcelona;13;Barcelonès;08019;Barcelona;2;90;B;;632;134;358;453;179;2;11;440;451
8;Barcelona;13;Barcelonès;08019;Barcelona;2;91;U;;561;160;313;395;166;1;5;389;394
8;Barcelona;13;Barcelonès;08019;Barcelona;2;92;U;;1050;298;596;755;295;2;15;738;753
8;Barcelona;13;Barcelonès;08019;Barcelona;2;93;U;;900;230;462;597;303;1;6;590;596
8;Barcelona;13;Barcelonès;08019;Barcelona;2;94;U;;1108;336;645;758;350;4;11;743;754
8;Barcelona;13;Barcelonès;08019;Barcelona;2;95;A;;571;202;370;447;124;0;6;441;447
8;Barcelona;13;Barcelonès;08019;Barcelona;2;95;B;;665;221;414;506;159;0;7;499;506
8;Barcelona;13;Barcelonès;08019;Barcelona;2;96;U;;594;192;363;435;159;0;6;429;435
8;Barcelona;13;Barcelonès;08019;Barcelona;2;97;U;;936;257;511;639;297;1;12;626;638
8;Barcelona;13;Barcelonès;08019;Barcelona;2;98;U;;751;214;450;566;185;1;15;550;565
8;Barcelona;13;Barcelonès;08019;Barcelona;2;99;U;;623;235;377;440;183;0;2;438;440
8;Barcelona;13;Barcelonès;08019;Barcelona;3;1;A;;634;171;337;412;222;0;6;406;412
8;Barcelona;13;Barcelonès;08019;Barcelona;3;1;B;;649;210;411;419;230;2;13;404;417
8;Barcelona;13;Barcelonès;08019;Barcelona;3;10;U;;1059;276;502;591;468;0;2;589;591
8;Barcelona;13;Barcelonès;08019;Barcelona;3;100;A;;571;156;297;371;200;1;4;366;370
8;Barcelona;13;Barcelonès;08019;Barcelona;3;100;B;;579;190;344;417;162;0;6;411;417
8;Barcelona;13;Barcelonès;08019;Barcelona;3;101;U;;1092;340;598;735;357;0;14;721;735
8;Barcelona;13;Barcelonès;08019;Barcelona;3;102;U;;882;238;466;560;322;1;10;549;559
8;Barcelona;13;Barcelonès;08019;Barcelona;3;103;U;;652;177;337;418;234;1;3;414;417
8;Barcelona;13;Barcelonès;08019;Barcelona;3;104;U;;999;325;552;670;329;1;4;665;669
8;Barcelona;13;Barcelonès;08019;Barcelona;3;106;U;;553;193;371;412;141;3;0;409;409
8;Barcelona;13;Barcelonès;08019;Barcelona;3;107;U;;928;290;521;626;302;1;5;620;625
8;Barcelona;13;Barcelonès;08019;Barcelona;3;109;A;;758;187;359;464;294;3;0;461;461
8;Barcelona;13;Barcelonès;08019;Barcelona;3;109;B;;929;234;446;579;350;0;6;573;579
8;Barcelona;13;Barcelonès;08019;Barcelona;3;110;A;;686;163;359;466;220;6;5;455;460
8;Barcelona;13;Barcelonès;08019;Barcelona;3;110;B;;858;213;438;562;296;0;4;558;562
8;Barcelona;13;Barcelonès;08019;Barcelona;3;111;A;;715;181;371;458;257;1;2;455;457
8;Barcelona;13;Barcelonès;08019;Barcelona;3;111;B;;856;215;215;517;339;2;1;514;515
8;Barcelona;13;Barcelonès;08019;Barcelona;3;112;U;;697;150;323;409;288;1;2;406;408
8;Barcelona;13;Barcelonès;08019;Barcelona;3;113;U;;725;190;377;476;249;0;1;475;476
8;Barcelona;13;Barcelonès;08019;Barcelona;3;114;U;;660;141;325;449;211;1;8;440;448
8;Barcelona;13;Barcelonès;08019;Barcelona;3;115;U;;1095;321;543;678;417;2;3;673;676
8;Barcelona;13;Barcelonès;08019;Barcelona;3;117;U;;658;216;364;437;221;0;1;436;437
8;Barcelona;13;Barcelonès;08019;Barcelona;3;118;U;;824;321;631;619;205;0;4;615;619
8;Barcelona;13;Barcelonès;08019;Barcelona;3;119;U;;512;144;282;334;178;0;2;332;334
8;Barcelona;13;Barcelonès;08019;Barcelona;3;12;U;;1051;271;455;527;524;0;0;527;527
8;Barcelona;13;Barcelonès;08019;Barcelona;3;120;U;;741;219;416;507;234;1;8;498;506
8;Barcelona;13;Barcelonès;08019;Barcelona;3;121;U;;605;196;345;415;190;4;3;408;411
8;Barcelona;13;Barcelonès;08019;Barcelona;3;122;U;;965;327;596;701;264;3;1;697;698
8;Barcelona;13;Barcelonès;08019;Barcelona;3;124;U;;788;254;484;552;236;1;8;543;551
8;Barcelona;13;Barcelonès;08019;Barcelona;3;125;U;;858;239;469;575;283;0;4;571;575
8;Barcelona;13;Barcelonès;08019;Barcelona;3;127;U;;683;204;386;472;211;3;4;465;469
8;Barcelona;13;Barcelonès;08019;Barcelona;3;128;U;;549;166;283;350;199;0;0;350;350
8;Barcelona;13;Barcelonès;08019;Barcelona;3;129;U;;588;147;297;381;207;1;3;377;380
8;Barcelona;13;Barcelonès;08019;Barcelona;3;130;U;;1024;286;519;663;361;0;0;663;663
8;Barcelona;13;Barcelonès;08019;Barcelona;3;132;U;;809;240;467;578;231;0;8;570;578
8;Barcelona;13;Barcelonès;08019;Barcelona;3;133;U;;554;178;302;362;192;0;1;361;362
8;Barcelona;13;Barcelonès;08019;Barcelona;3;134;A;;680;219;395;466;214;3;5;458;463
8;Barcelona;13;Barcelonès;08019;Barcelona;3;134;B;;591;190;323;395;196;1;6;388;394
8;Barcelona;13;Barcelonès;08019;Barcelona;3;134;C;;711;243;394;464;247;3;4;457;461
8;Barcelona;13;Barcelonès;08019;Barcelona;3;135;U;;1019;255;511;609;410;0;5;604;609
8;Barcelona;13;Barcelonès;08019;Barcelona;3;137;U;;1052;349;597;680;372;3;0;677;677
8;Barcelona;13;Barcelonès;08019;Barcelona;3;138;U;;862;273;495;600;262;1;9;590;599
8;Barcelona;13;Barcelonès;08019;Barcelona;3;139;U;;602;183;338;396;206;0;4;392;396
8;Barcelona;13;Barcelonès;08019;Barcelona;3;14;U;;832;217;385;437;395;1;1;435;436
8;Barcelona;13;Barcelonès;08019;Barcelona;3;140;U;;578;134;330;405;173;1;6;398;404
8;Barcelona;13;Barcelonès;08019;Barcelona;3;141;U;;676;309;398;458;218;1;2;455;457
8;Barcelona;13;Barcelonès;08019;Barcelona;3;142;U;;826;217;472;582;244;0;6;576;582
8;Barcelona;13;Barcelonès;08019;Barcelona;3;143;U;;609;165;285;344;265;1;2;341;343
8;Barcelona;13;Barcelonès;08019;Barcelona;3;144;U;;895;226;506;619;276;0;11;608;619
8;Barcelona;13;Barcelonès;08019;Barcelona;3;146;U;;724;215;436;514;210;0;9;505;514
8;Barcelona;13;Barcelonès;08019;Barcelona;3;147;A;;743;188;415;523;220;3;7;513;520
8;Barcelona;13;Barcelonès;08019;Barcelona;3;147;B;;788;221;456;579;209;0;6;573;579
8;Barcelona;13;Barcelonès;08019;Barcelona;3;148;A;;546;132;305;387;159;1;8;378;386
8;Barcelona;13;Barcelonès;08019;Barcelona;3;148;B;;615;156;323;415;200;0;5;410;415
8;Barcelona;13;Barcelonès;08019;Barcelona;3;149;U;;978;221;523;672;306;1;7;664;671
8;Barcelona;13;Barcelonès;08019;Barcelona;3;15;U;;596;164;282;337;259;0;0;337;337
8;Barcelona;13;Barcelonès;08019;Barcelona;3;150;U;;801;222;435;547;254;2;6;539;545
8;Barcelona;13;Barcelonès;08019;Barcelona;3;151;U;;855;267;493;594;261;3;4;587;591
8;Barcelona;13;Barcelonès;08019;Barcelona;3;152;U;;626;185;362;418;208;1;1;416;417
8;Barcelona;13;Barcelonès;08019;Barcelona;3;153;U;;931;287;514;606;325;1;5;600;605
8;Barcelona;13;Barcelonès;08019;Barcelona;3;154;U;;871;287;457;552;319;5;2;545;547
8;Barcelona;13;Barcelonès;08019;Barcelona;3;156;U;;502;154;278;328;174;1;2;325;327
8;Barcelona;13;Barcelonès;08019;Barcelona;3;157;U;;907;262;495;623;284;2;6;615;621
8;Barcelona;13;Barcelonès;08019;Barcelona;3;159;U;;722;231;450;504;218;0;1;503;504
8;Barcelona;13;Barcelonès;08019;Barcelona;3;16;U;;666;182;324;378;288;1;4;373;377
8;Barcelona;13;Barcelonès;08019;Barcelona;3;160;U;;1079;316;637;773;306;2;6;765;771
8;Barcelona;13;Barcelonès;08019;Barcelona;3;162;U;;933;271;521;626;307;2;5;619;624
8;Barcelona;13;Barcelonès;08019;Barcelona;3;163;U;;594;162;325;400;194;0;2;398;400
8;Barcelona;13;Barcelonès;08019;Barcelona;3;164;U;;678;221;387;490;188;5;9;476;485
8;Barcelona;13;Barcelonès;08019;Barcelona;3;165;U;;590;167;336;419;171;3;6;410;416
8;Barcelona;13;Barcelonès;08019;Barcelona;3;167;U;;793;203;417;568;225;3;3;562;565
8;Barcelona;13;Barcelonès;08019;Barcelona;3;168;A;;693;214;392;492;201;0;7;485;492
8;Barcelona;13;Barcelonès;08019;Barcelona;3;168;B;;771;252;461;558;213;0;6;552;558
8;Barcelona;13;Barcelonès;08019;Barcelona;3;169;A;;573;148;302;407;166;0;6;401;407
8;Barcelona;13;Barcelonès;08019;Barcelona;3;169;B;;678;183;365;483;195;1;4;478;482
8;Barcelona;13;Barcelonès;08019;Barcelona;3;17;U;;756;207;373;451;305;6;1;444;445
8;Barcelona;13;Barcelonès;08019;Barcelona;3;170;A;;559;173;314;361;198;1;3;357;360
8;Barcelona;13;Barcelonès;08019;Barcelona;3;170;B;;696;231;404;480;216;4;4;472;476
8;Barcelona;13;Barcelonès;08019;Barcelona;3;172;U;;848;261;452;576;272;0;4;572;576
8;Barcelona;13;Barcelonès;08019;Barcelona;3;173;U;;901;302;517;608;293;2;7;599;606
8;Barcelona;13;Barcelonès;08019;Barcelona;3;176;U;;671;197;197;469;202;0;5;464;469
8;Barcelona;13;Barcelonès;08019;Barcelona;3;177;U;;604;197;303;356;248;4;3;349;352
8;Barcelona;13;Barcelonès;08019;Barcelona;3;178;U;;755;204;407;518;237;0;4;514;518
8;Barcelona;13;Barcelonès;08019;Barcelona;3;179;U;;1002;331;560;649;353;4;5;640;645
8;Barcelona;13;Barcelonès;08019;Barcelona;3;18;U;;612;201;321;371;241;0;0;371;371
8;Barcelona;13;Barcelonès;08019;Barcelona;3;180;U;;824;231;422;502;322;0;7;495;502
8;Barcelona;13;Barcelonès;08019;Barcelona;3;182;U;;580;184;320;384;196;1;2;381;383
8;Barcelona;13;Barcelonès;08019;Barcelona;3;183;U;;830;257;472;550;280;2;8;540;548
8;Barcelona;13;Barcelonès;08019;Barcelona;3;184;U;;678;187;371;464;214;2;3;459;462
8;Barcelona;13;Barcelonès;08019;Barcelona;3;185;U;;836;207;431;508;328;0;4;504;508
8;Barcelona;13;Barcelonès;08019;Barcelona;3;186;U;;558;166;288;362;196;0;2;360;362
8;Barcelona;13;Barcelonès;08019;Barcelona;3;188;U;;602;195;334;426;176;4;3;419;422
8;Barcelona;13;Barcelonès;08019;Barcelona;3;189;U;;805;205;411;493;312;1;7;485;492
8;Barcelona;13;Barcelonès;08019;Barcelona;3;19;U;;620;181;325;394;226;0;5;389;394
8;Barcelona;13;Barcelonès;08019;Barcelona;3;191;U;;1002;335;595;719;283;1;8;710;718
8;Barcelona;13;Barcelonès;08019;Barcelona;3;192;U;;684;218;364;447;237;0;2;445;447
8;Barcelona;13;Barcelonès;08019;Barcelona;3;193;A;;744;201;383;490;254;2;6;482;488
8;Barcelona;13;Barcelonès;08019;Barcelona;3;193;B;;816;210;514;506;310;1;1;504;505
8;Barcelona;13;Barcelonès;08019;Barcelona;3;195;U;;629;201;362;435;194;0;8;427;435
8;Barcelona;13;Barcelonès;08019;Barcelona;3;196;U;;702;174;394;446;256;0;7;439;446
8;Barcelona;13;Barcelonès;08019;Barcelona;3;197;U;;568;141;285;344;224;0;2;342;344
8;Barcelona;13;Barcelonès;08019;Barcelona;3;198;A;;540;160;303;368;172;0;2;366;368
8;Barcelona;13;Barcelonès;08019;Barcelona;3;198;B;;678;197;335;420;258;1;2;417;419
8;Barcelona;13;Barcelonès;08019;Barcelona;3;199;U;;622;201;316;395;227;2;0;393;393
8;Barcelona;13;Barcelonès;08019;Barcelona;3;20;U;;722;230;420;523;199;2;1;520;521
8;Barcelona;13;Barcelonès;08019;Barcelona;3;200;U;;909;270;469;578;331;0;6;572;578
8;Barcelona;13;Barcelonès;08019;Barcelona;3;201;A;;644;161;322;414;230;1;4;409;413
8;Barcelona;13;Barcelonès;08019;Barcelona;3;201;B;;717;207;376;464;253;0;8;456;464
8;Barcelona;13;Barcelonès;08019;Barcelona;3;202;A;;574;150;295;359;215;0;7;352;359
8;Barcelona;13;Barcelonès;08019;Barcelona;3;202;B;;660;189;385;460;200;2;6;452;458
8;Barcelona;13;Barcelonès;08019;Barcelona;3;204;U;;877;210;446;557;320;0;7;550;557
8;Barcelona;13;Barcelonès;08019;Barcelona;3;205;U;;979;287;550;655;324;2;5;648;653
8;Barcelona;13;Barcelonès;08019;Barcelona;3;207;U;;851;235;471;575;276;1;2;572;574
8;Barcelona;13;Barcelonès;08019;Barcelona;3;208;U;;718;204;394;496;222;0;4;492;496
8;Barcelona;13;Barcelonès;08019;Barcelona;3;209;U;;891;218;490;634;257;2;12;620;632
8;Barcelona;13;Barcelonès;08019;Barcelona;3;210;U;;1063;270;532;665;398;0;13;652;665
8;Barcelona;13;Barcelonès;08019;Barcelona;3;22;U;;863;308;482;576;287;0;1;575;576
8;Barcelona;13;Barcelonès;08019;Barcelona;3;23;A;;574;166;309;371;203;0;9;362;371
8;Barcelona;13;Barcelonès;08019;Barcelona;3;23;B;;656;162;334;407;249;3;3;401;404
8;Barcelona;13;Barcelonès;08019;Barcelona;3;24;U;;661;196;356;416;245;0;3;413;416
8;Barcelona;13;Barcelonès;08019;Barcelona;3;25;U;;978;286;497;590;388;2;5;583;588
8;Barcelona;13;Barcelonès;08019;Barcelona;3;26;U;;555;148;325;380;175;0;4;376;380
8;Barcelona;13;Barcelonès;08019;Barcelona;3;29;U;;676;213;344;411;265;3;2;406;408
8;Barcelona;13;Barcelonès;08019;Barcelona;3;3;U;;783;229;399;483;300;0;5;478;483
8;Barcelona;13;Barcelonès;08019;Barcelona;3;30;U;;970;291;521;614;356;0;2;612;614
8;Barcelona;13;Barcelonès;08019;Barcelona;3;32;U;;974;313;514;611;363;3;6;602;608
8;Barcelona;13;Barcelonès;08019;Barcelona;3;33;U;;774;221;410;467;307;2;4;461;465
8;Barcelona;13;Barcelonès;08019;Barcelona;3;37;U;;719;204;358;428;291;1;3;424;427
8;Barcelona;13;Barcelonès;08019;Barcelona;3;38;U;;1050;291;560;668;382;0;6;662;668
8;Barcelona;13;Barcelonès;08019;Barcelona;3;39;U;;946;271;467;562;384;1;1;560;561
8;Barcelona;13;Barcelonès;08019;Barcelona;3;4;U;;1034;281;491;583;451;0;8;575;583
8;Barcelona;13;Barcelonès;08019;Barcelona;3;41;U;;647;172;345;416;231;2;0;414;414
8;Barcelona;13;Barcelonès;08019;Barcelona;3;42;U;;628;187;352;429;199;0;2;427;429
8;Barcelona;13;Barcelonès;08019;Barcelona;3;43;U;;928;234;518;602;326;0;6;596;602
8;Barcelona;13;Barcelonès;08019;Barcelona;3;45;U;;864;257;458;564;300;0;0;564;564
8;Barcelona;13;Barcelonès;08019;Barcelona;3;47;U;;757;205;401;481;276;0;1;480;481
8;Barcelona;13;Barcelonès;08019;Barcelona;3;48;U;;875;238;438;536;339;0;5;531;536
8;Barcelona;13;Barcelonès;08019;Barcelona;3;49;U;;739;185;380;457;282;1;4;452;456
8;Barcelona;13;Barcelonès;08019;Barcelona;3;50;U;;998;286;546;680;318;0;6;674;680
8;Barcelona;13;Barcelonès;08019;Barcelona;3;53;U;;544;171;308;358;186;0;4;354;358
8;Barcelona;13;Barcelonès;08019;Barcelona;3;55;U;;690;199;364;428;262;0;1;427;428
8;Barcelona;13;Barcelonès;08019;Barcelona;3;56;U;;549;206;303;370;179;0;3;367;370
8;Barcelona;13;Barcelonès;08019;Barcelona;3;57;U;;556;132;246;296;260;0;2;294;296
8;Barcelona;13;Barcelonès;08019;Barcelona;3;58;U;;494;62;133;156;338;0;1;155;156
8;Barcelona;13;Barcelonès;08019;Barcelona;3;6;U;;691;198;371;423;268;0;1;422;423
8;Barcelona;13;Barcelonès;08019;Barcelona;3;61;U;;346;29;64;82;264;1;0;81;81
8;Barcelona;13;Barcelonès;08019;Barcelona;3;62;U;;1003;180;387;455;548;1;5;449;454
8;Barcelona;13;Barcelonès;08019;Barcelona;3;65;U;;832;215;440;543;289;0;5;538;543
8;Barcelona;13;Barcelonès;08019;Barcelona;3;66;U;;951;265;515;639;312;0;6;633;639
8;Barcelona;13;Barcelonès;08019;Barcelona;3;67;U;;653;198;356;415;238;4;4;407;411
8;Barcelona;13;Barcelonès;08019;Barcelona;3;68;A;;746;207;409;496;250;2;7;487;494
8;Barcelona;13;Barcelonès;08019;Barcelona;3;68;B;;917;282;495;606;311;0;8;598;606
8;Barcelona;13;Barcelonès;08019;Barcelona;3;69;U;;1077;290;541;662;415;0;10;652;662
8;Barcelona;13;Barcelonès;08019;Barcelona;3;7;U;;593;147;261;320;273;0;3;317;320
8;Barcelona;13;Barcelonès;08019;Barcelona;3;71;A;;669;156;310;433;236;0;4;429;433
8;Barcelona;13;Barcelonès;08019;Barcelona;3;71;B;;702;205;393;469;233;0;4;465;469
8;Barcelona;13;Barcelonès;08019;Barcelona;3;72;A;;832;226;437;514;318;0;6;508;514
8;Barcelona;13;Barcelonès;08019;Barcelona;3;72;B;;859;243;430;542;317;1;7;534;541
8;Barcelona;13;Barcelonès;08019;Barcelona;3;72;C;;989;235;486;618;371;0;6;612;618
8;Barcelona;13;Barcelonès;08019;Barcelona;3;72;D;;581;130;293;356;225;1;7;348;355
8;Barcelona;13;Barcelonès;08019;Barcelona;3;72;E;;963;219;497;598;365;0;7;591;598
8;Barcelona;13;Barcelonès;08019;Barcelona;3;72;F;;963;219;450;576;387;1;6;569;575
8;Barcelona;13;Barcelonès;08019;Barcelona;3;72;G;;874;207;424;533;341;3;3;527;530
8;Barcelona;13;Barcelonès;08019;Barcelona;3;73;A;;665;152;311;371;294;5;4;362;366
8;Barcelona;13;Barcelonès;08019;Barcelona;3;73;B;;832;169;358;452;380;0;8;444;452
8;Barcelona;13;Barcelonès;08019;Barcelona;3;73;C;;776;177;332;424;352;0;7;417;424
8;Barcelona;13;Barcelonès;08019;Barcelona;3;74;A;;674;159;307;380;294;1;2;377;379
8;Barcelona;13;Barcelonès;08019;Barcelona;3;74;B;;715;173;334;413;302;0;3;410;413
8;Barcelona;13;Barcelonès;08019;Barcelona;3;74;C;;772;184;328;417;355;0;5;412;417
8;Barcelona;13;Barcelonès;08019;Barcelona;3;75;A;;830;232;394;447;383;2;4;441;445
8;Barcelona;13;Barcelonès;08019;Barcelona;3;75;B;;922;255;449;492;430;1;4;487;491
8;Barcelona;13;Barcelonès;08019;Barcelona;3;76;U;;764;187;329;408;356;1;3;404;407
8;Barcelona;13;Barcelonès;08019;Barcelona;3;77;U;;493;141;239;269;224;1;1;267;268
8;Barcelona;13;Barcelonès;08019;Barcelona;3;78;U;;845;208;381;434;411;2;3;429;432
8;Barcelona;13;Barcelonès;08019;Barcelona;3;79;U;;668;155;273;322;346;0;3;319;322
8;Barcelona;13;Barcelonès;08019;Barcelona;3;8;U;;1020;275;474;566;454;1;5;560;565
8;Barcelona;13;Barcelonès;08019;Barcelona;3;80;U;;530;110;245;242;288;0;1;241;242
8;Barcelona;13;Barcelonès;08019;Barcelona;3;81;U;;525;111;208;286;239;0;0;286;286
8;Barcelona;13;Barcelonès;08019;Barcelona;3;82;A;;651;193;337;397;254;0;4;393;397
8;Barcelona;13;Barcelonès;08019;Barcelona;3;82;B;;661;175;357;448;213;0;4;444;448
8;Barcelona;13;Barcelonès;08019;Barcelona;3;83;U;;1019;299;506;620;399;0;11;609;620
8;Barcelona;13;Barcelonès;08019;Barcelona;3;84;U;;625;193;312;383;242;2;2;379;381
8;Barcelona;13;Barcelonès;08019;Barcelona;3;85;U;;888;234;450;577;311;1;2;574;576
8;Barcelona;13;Barcelonès;08019;Barcelona;3;86;U;;723;216;379;453;270;0;4;449;453
8;Barcelona;13;Barcelonès;08019;Barcelona;3;87;U;;583;150;293;382;201;5;4;373;377
8;Barcelona;13;Barcelonès;08019;Barcelona;3;88;U;;889;274;518;626;263;2;6;618;624
8;Barcelona;13;Barcelonès;08019;Barcelona;3;89;U;;530;172;304;356;174;2;1;353;354
8;Barcelona;13;Barcelonès;08019;Barcelona;3;90;U;;541;184;301;354;187;0;3;351;354
8;Barcelona;13;Barcelonès;08019;Barcelona;3;91;U;;1013;262;541;696;317;3;12;681;693
8;Barcelona;13;Barcelonès;08019;Barcelona;3;92;U;;631;175;331;394;237;2;0;392;392
8;Barcelona;13;Barcelonès;08019;Barcelona;3;93;U;;661;193;346;421;240;1;2;418;420
8;Barcelona;13;Barcelonès;08019;Barcelona;3;94;U;;681;200;347;420;261;2;5;413;418
8;Barcelona;13;Barcelonès;08019;Barcelona;3;95;U;;728;209;366;429;299;1;5;423;428
8;Barcelona;13;Barcelonès;08019;Barcelona;3;97;U;;723;244;399;505;218;3;6;496;502
8;Barcelona;13;Barcelonès;08019;Barcelona;3;98;U;;497;158;277;321;176;0;0;321;321
8;Barcelona;13;Barcelonès;08019;Barcelona;3;99;U;;641;205;381;443;198;1;3;439;442
8;Barcelona;13;Barcelonès;08019;Barcelona;4;1;U;;765;204;443;558;207;0;8;550;558
8;Barcelona;13;Barcelonès;08019;Barcelona;4;10;A;;895;250;517;658;237;1;14;643;657
8;Barcelona;13;Barcelonès;08019;Barcelona;4;10;B;;792;212;463;590;202;1;9;580;589
8;Barcelona;13;Barcelonès;08019;Barcelona;4;10;C;;936;245;558;712;224;0;14;698;712
8;Barcelona;13;Barcelonès;08019;Barcelona;4;11;A;;813;272;474;574;239;0;5;569;574
8;Barcelona;13;Barcelonès;08019;Barcelona;4;11;B;;1049;341;630;750;299;0;6;744;750
8;Barcelona;13;Barcelonès;08019;Barcelona;4;12;U;;593;154;322;415;178;0;10;405;415
8;Barcelona;13;Barcelonès;08019;Barcelona;4;13;U;;1093;302;541;683;410;0;4;679;683
8;Barcelona;13;Barcelonès;08019;Barcelona;4;14;U;;578;178;281;358;220;1;3;354;357
8;Barcelona;13;Barcelonès;08019;Barcelona;4;15;U;;706;173;321;423;283;0;2;421;423
8;Barcelona;13;Barcelonès;08019;Barcelona;4;16;A;;709;192;377;480;229;1;3;476;479
8;Barcelona;13;Barcelonès;08019;Barcelona;4;16;B;;886;230;414;562;324;1;5;556;561
8;Barcelona;13;Barcelonès;08019;Barcelona;4;17;U;;500;130;257;311;189;3;3;305;308
8;Barcelona;13;Barcelonès;08019;Barcelona;4;18;A;;585;138;306;406;179;0;11;395;406
8;Barcelona;13;Barcelonès;08019;Barcelona;4;18;B;;611;147;339;423;188;0;12;411;423
8;Barcelona;13;Barcelonès;08019;Barcelona;4;19;A;;642;185;380;477;165;2;6;469;475
8;Barcelona;13;Barcelonès;08019;Barcelona;4;19;B;;629;168;345;443;186;2;8;433;441
8;Barcelona;13;Barcelonès;08019;Barcelona;4;19;C;;701;203;397;508;193;0;6;502;508
8;Barcelona;13;Barcelonès;08019;Barcelona;4;2;U;;699;187;387;490;209;2;4;484;488
8;Barcelona;13;Barcelonès;08019;Barcelona;4;20;A;;790;221;476;625;165;0;17;608;625
8;Barcelona;13;Barcelonès;08019;Barcelona;4;20;B;;796;221;458;586;210;0;4;582;586
8;Barcelona;13;Barcelonès;08019;Barcelona;4;21;A;;654;202;424;524;130;1;10;513;523
8;Barcelona;13;Barcelonès;08019;Barcelona;4;21;B;;660;182;416;519;141;0;11;508;519
8;Barcelona;13;Barcelonès;08019;Barcelona;4;22;U;;863;242;463;582;281;0;7;575;582
8;Barcelona;13;Barcelonès;08019;Barcelona;4;23;U;;658;202;376;475;183;0;5;470;475
8;Barcelona;13;Barcelonès;08019;Barcelona;4;24;U;;796;228;466;607;189;1;13;593;606
8;Barcelona;13;Barcelonès;08019;Barcelona;4;25;U;;651;197;370;458;193;1;5;452;457
8;Barcelona;13;Barcelonès;08019;Barcelona;4;26;U;;835;263;474;590;245;4;10;576;586
8;Barcelona;13;Barcelonès;08019;Barcelona;4;27;U;;736;218;384;493;243;0;3;490;493
8;Barcelona;13;Barcelonès;08019;Barcelona;4;28;U;;819;228;473;563;256;0;8;555;563
8;Barcelona;13;Barcelonès;08019;Barcelona;4;29;U;;1121;286;647;790;331;1;8;781;789
8;Barcelona;13;Barcelonès;08019;Barcelona;4;3;U;;523;119;255;344;179;1;5;338;343
8;Barcelona;13;Barcelonès;08019;Barcelona;4;30;U;;976;290;404;627;349;1;5;621;626
8;Barcelona;13;Barcelonès;08019;Barcelona;4;32;U;;805;236;465;588;217;2;10;576;586
8;Barcelona;13;Barcelonès;08019;Barcelona;4;33;U;;812;218;431;558;254;1;3;554;557
8;Barcelona;13;Barcelonès;08019;Barcelona;4;34;U;;869;226;472;629;240;0;8;621;629
8;Barcelona;13;Barcelonès;08019;Barcelona;4;35;U;;980;272;550;662;318;0;6;656;662
8;Barcelona;13;Barcelonès;08019;Barcelona;4;36;U;;671;147;357;456;215;0;9;447;456
8;Barcelona;13;Barcelonès;08019;Barcelona;4;37;U;;1051;292;690;760;291;0;8;752;760
8;Barcelona;13;Barcelonès;08019;Barcelona;4;38;U;;620;189;340;402;218;0;2;400;402
8;Barcelona;13;Barcelonès;08019;Barcelona;4;39;U;;768;206;487;563;205;2;10;551;561
8;Barcelona;13;Barcelonès;08019;Barcelona;4;4;U;;719;226;421;502;217;0;11;491;502
8;Barcelona;13;Barcelonès;08019;Barcelona;4;40;A;;709;175;399;509;200;1;6;502;508
8;Barcelona;13;Barcelonès;08019;Barcelona;4;40;B;;818;217;464;602;216;0;13;589;602
8;Barcelona;13;Barcelonès;08019;Barcelona;4;41;A;;649;168;375;472;177;1;7;464;471
8;Barcelona;13;Barcelonès;08019;Barcelona;4;41;B;;670;189;378;480;190;0;6;474;480
8;Barcelona;13;Barcelonès;08019;Barcelona;4;42;A;;675;187;394;497;178;0;4;493;497
8;Barcelona;13;Barcelonès;08019;Barcelona;4;42;B;;686;195;414;516;170;1;10;505;515
8;Barcelona;13;Barcelonès;08019;Barcelona;4;43;U;;622;170;368;440;182;1;3;436;439
8;Barcelona;13;Barcelonès;08019;Barcelona;4;44;U;;1016;266;579;713;303;2;11;700;711
8;Barcelona;13;Barcelonès;08019;Barcelona;4;45;U;;1060;313;589;714;346;0;3;711;714
8;Barcelona;13;Barcelonès;08019;Barcelona;4;48;U;;1121;305;640;811;310;0;13;798;811
8;Barcelona;13;Barcelonès;08019;Barcelona;4;5;U;;681;209;366;442;239;0;3;439;442
8;Barcelona;13;Barcelonès;08019;Barcelona;4;50;U;;741;214;422;529;212;3;4;522;526
8;Barcelona;13;Barcelonès;08019;Barcelona;4;51;U;;573;165;358;437;136;0;10;427;437
8;Barcelona;13;Barcelonès;08019;Barcelona;4;52;U;;879;240;516;644;235;1;11;632;643
8;Barcelona;13;Barcelonès;08019;Barcelona;4;53;U;;785;214;479;599;186;3;14;582;596
8;Barcelona;13;Barcelonès;08019;Barcelona;4;54;U;;979;284;624;764;215;2;10;752;762
8;Barcelona;13;Barcelonès;08019;Barcelona;4;55;U;;663;145;369;477;186;0;5;472;477
8;Barcelona;13;Barcelonès;08019;Barcelona;4;56;U;;512;131;272;355;157;1;5;349;354
8;Barcelona;13;Barcelonès;08019;Barcelona;4;57;U;;590;162;340;409;181;0;6;403;409
8;Barcelona;13;Barcelonès;08019;Barcelona;4;58;U;;684;203;406;503;181;0;10;493;503
8;Barcelona;13;Barcelonès;08019;Barcelona;4;6;U;;690;200;374;448;242;2;6;440;446
8;Barcelona;13;Barcelonès;08019;Barcelona;4;60;U;;676;192;404;486;190;1;5;480;485
8;Barcelona;13;Barcelonès;08019;Barcelona;4;61;U;;578;178;321;413;165;1;3;409;412
8;Barcelona;13;Barcelonès;08019;Barcelona;4;62;U;;615;206;384;467;148;0;7;460;467
8;Barcelona;13;Barcelonès;08019;Barcelona;4;63;U;;895;255;542;672;223;4;6;662;668
8;Barcelona;13;Barcelonès;08019;Barcelona;4;65;U;;1107;296;650;805;302;2;16;787;803
8;Barcelona;13;Barcelonès;08019;Barcelona;4;66;A;;558;134;327;415;143;0;10;405;415
8;Barcelona;13;Barcelonès;08019;Barcelona;4;66;B;;643;167;373;500;143;1;4;495;499
8;Barcelona;13;Barcelonès;08019;Barcelona;4;68;U;;742;256;474;545;197;5;6;534;540
8;Barcelona;13;Barcelonès;08019;Barcelona;4;69;A;;571;184;327;403;168;0;3;400;403
8;Barcelona;13;Barcelonès;08019;Barcelona;4;69;B;;630;211;381;451;179;0;5;446;451
8;Barcelona;13;Barcelonès;08019;Barcelona;4;7;A;;751;217;439;571;180;0;10;561;571
8;Barcelona;13;Barcelonès;08019;Barcelona;4;7;B;;810;245;480;609;201;1;6;602;608
8;Barcelona;13;Barcelonès;08019;Barcelona;4;70;U;;510;143;282;350;160;2;10;338;348
8;Barcelona;13;Barcelonès;08019;Barcelona;4;71;A;;842;168;474;634;208;1;10;623;633
8;Barcelona;13;Barcelonès;08019;Barcelona;4;71;B;;883;174;516;648;235;1;14;633;647
8;Barcelona;13;Barcelonès;08019;Barcelona;4;73;A;;579;139;333;442;137;0;7;435;442
8;Barcelona;13;Barcelonès;08019;Barcelona;4;73;B;;572;141;331;435;137;0;6;429;435
8;Barcelona;13;Barcelonès;08019;Barcelona;4;74;A;;783;196;452;562;221;0;9;553;562
8;Barcelona;13;Barcelonès;08019;Barcelona;4;74;B;;871;242;517;620;251;3;15;602;617
8;Barcelona;13;Barcelonès;08019;Barcelona;4;75;U;;602;126;351;458;144;1;4;453;457
8;Barcelona;13;Barcelonès;08019;Barcelona;4;76;A;;586;126;340;437;149;1;5;431;436
8;Barcelona;13;Barcelonès;08019;Barcelona;4;76;B;;649;143;393;506;143;0;12;494;506
8;Barcelona;13;Barcelonès;08019;Barcelona;4;77;A;;757;156;457;583;174;1;15;567;582
8;Barcelona;13;Barcelonès;08019;Barcelona;4;77;B;;786;179;463;594;192;0;14;580;594
8;Barcelona;13;Barcelonès;08019;Barcelona;4;78;U;;1074;285;590;740;334;0;17;723;740
8;Barcelona;13;Barcelonès;08019;Barcelona;4;79;U;;925;229;581;714;211;0;14;700;714
8;Barcelona;13;Barcelonès;08019;Barcelona;4;8;U;;978;189;515;655;323;1;15;639;654
8;Barcelona;13;Barcelonès;08019;Barcelona;4;81;U;;1002;212;573;755;247;0;17;738;755
8;Barcelona;13;Barcelonès;08019;Barcelona;4;82;U;;751;264;459;551;200;2;9;540;549
8;Barcelona;13;Barcelonès;08019;Barcelona;4;83;A;;722;185;408;528;194;5;14;509;523
8;Barcelona;13;Barcelonès;08019;Barcelona;4;83;B;;694;187;380;522;172;0;6;516;522
8;Barcelona;13;Barcelonès;08019;Barcelona;4;83;C;;736;157;394;544;192;0;14;530;544
8;Barcelona;13;Barcelonès;08019;Barcelona;5;1;U;;912;282;535;676;236;1;9;666;675
8;Barcelona;13;Barcelonès;08019;Barcelona;5;10;U;;847;244;504;619;228;2;7;610;617
8;Barcelona;13;Barcelonès;08019;Barcelona;5;100;U;;664;227;426;493;171;3;10;480;490
8;Barcelona;13;Barcelonès;08019;Barcelona;5;101;U;;670;185;322;373;297;0;4;369;373
8;Barcelona;13;Barcelonès;08019;Barcelona;5;102;U;;852;231;530;659;193;1;17;641;658
8;Barcelona;13;Barcelonès;08019;Barcelona;5;103;U;;597;176;334;430;167;0;7;423;430
8;Barcelona;13;Barcelonès;08019;Barcelona;5;104;U;;871;228;492;620;251;1;4;615;619
8;Barcelona;13;Barcelonès;08019;Barcelona;5;105;A;;638;143;368;460;178;0;13;447;460
8;Barcelona;13;Barcelonès;08019;Barcelona;5;105;B;;696;144;395;519;177;0;12;507;519
8;Barcelona;13;Barcelonès;08019;Barcelona;5;106;U;;841;188;490;625;216;1;7;617;624
8;Barcelona;13;Barcelonès;08019;Barcelona;5;107;U;;949;233;487;655;294;1;23;631;654
8;Barcelona;13;Barcelonès;08019;Barcelona;5;109;U;;734;176;478;600;134;0;3;597;600
8;Barcelona;13;Barcelonès;08019;Barcelona;5;11;U;;533;142;315;422;111;2;8;412;420
8;Barcelona;13;Barcelonès;08019;Barcelona;5;110;A;;592;165;342;434;158;0;9;425;434
8;Barcelona;13;Barcelonès;08019;Barcelona;5;110;B;;604;173;339;442;162;0;7;435;442
8;Barcelona;13;Barcelonès;08019;Barcelona;5;112;U;;820;244;515;619;201;1;11;607;618
8;Barcelona;13;Barcelonès;08019;Barcelona;5;114;U;;518;161;303;387;131;0;6;381;387
8;Barcelona;13;Barcelonès;08019;Barcelona;5;115;U;;989;237;508;657;332;1;18;638;656
8;Barcelona;13;Barcelonès;08019;Barcelona;5;117;U;;725;194;436;541;184;0;9;532;541
8;Barcelona;13;Barcelonès;08019;Barcelona;5;118;U;;1002;249;577;761;241;1;19;741;760
8;Barcelona;13;Barcelonès;08019;Barcelona;5;12;U;;711;191;395;507;204;1;7;499;506
8;Barcelona;13;Barcelonès;08019;Barcelona;5;120;U;;967;261;565;688;279;1;10;677;687
8;Barcelona;13;Barcelonès;08019;Barcelona;5;121;U;;790;205;445;569;221;1;5;563;568
8;Barcelona;13;Barcelonès;08019;Barcelona;5;122;U;;937;258;569;696;241;0;8;688;696
8;Barcelona;13;Barcelonès;08019;Barcelona;5;124;U;;586;147;327;439;147;2;8;429;437
8;Barcelona;13;Barcelonès;08019;Barcelona;5;125;U;;551;158;307;391;160;1;6;384;390
8;Barcelona;13;Barcelonès;08019;Barcelona;5;126;U;;570;119;295;418;152;0;13;405;418
8;Barcelona;13;Barcelonès;08019;Barcelona;5;127;U;;580;183;385;461;119;0;8;453;461
8;Barcelona;13;Barcelonès;08019;Barcelona;5;129;U;;592;191;390;466;126;5;10;451;461
8;Barcelona;13;Barcelonès;08019;Barcelona;5;13;U;;964;295;570;687;277;0;10;677;687
8;Barcelona;13;Barcelonès;08019;Barcelona;5;130;U;;497;162;301;375;122;0;5;370;375
8;Barcelona;13;Barcelonès;08019;Barcelona;5;131;U;;945;238;584;727;218;2;8;717;725
8;Barcelona;13;Barcelonès;08019;Barcelona;5;133;U;;1024;264;634;777;247;1;14;762;776
8;Barcelona;13;Barcelonès;08019;Barcelona;5;134;U;;619;149;373;466;153;0;6;460;466
8;Barcelona;13;Barcelonès;08019;Barcelona;5;135;U;;1088;244;646;847;241;0;24;823;847
8;Barcelona;13;Barcelonès;08019;Barcelona;5;136;U;;865;210;529;694;171;0;12;682;694
8;Barcelona;13;Barcelonès;08019;Barcelona;5;137;U;;644;150;399;500;144;0;10;490;500
8;Barcelona;13;Barcelonès;08019;Barcelona;5;138;U;;722;166;411;536;186;3;11;522;533
8;Barcelona;13;Barcelonès;08019;Barcelona;5;139;U;;843;261;530;660;183;2;18;640;658
8;Barcelona;13;Barcelonès;08019;Barcelona;5;14;U;;672;181;388;468;204;0;2;466;468
8;Barcelona;13;Barcelonès;08019;Barcelona;5;140;U;;600;156;347;450;150;0;6;444;450
8;Barcelona;13;Barcelonès;08019;Barcelona;5;141;U;;941;233;515;642;299;1;9;632;641
8;Barcelona;13;Barcelonès;08019;Barcelona;5;143;U;;504;140;372;396;108;1;10;385;395
8;Barcelona;13;Barcelonès;08019;Barcelona;5;144;U;;714;173;404;543;171;0;5;538;543
8;Barcelona;13;Barcelonès;08019;Barcelona;5;145;U;;788;185;464;614;174;0;13;601;614
8;Barcelona;13;Barcelonès;08019;Barcelona;5;146;U;;823;186;460;577;246;0;11;566;577
8;Barcelona;13;Barcelonès;08019;Barcelona;5;147;U;;672;204;398;507;165;3;5;499;504
8;Barcelona;13;Barcelonès;08019;Barcelona;5;148;A;;647;142;375;501;146;0;18;483;501
8;Barcelona;13;Barcelonès;08019;Barcelona;5;148;B;;731;180;406;559;172;2;12;545;557
8;Barcelona;13;Barcelonès;08019;Barcelona;5;149;U;;502;134;312;362;140;0;9;353;362
8;Barcelona;13;Barcelonès;08019;Barcelona;5;15;U;;496;140;313;387;109;0;9;378;387
8;Barcelona;13;Barcelonès;08019;Barcelona;5;150;U;;1128;361;678;831;297;0;18;813;831
8;Barcelona;13;Barcelonès;08019;Barcelona;5;152;U;;597;157;318;408;189;1;1;406;407
8;Barcelona;13;Barcelonès;08019;Barcelona;5;153;U;;737;192;458;556;181;2;7;547;554
8;Barcelona;13;Barcelonès;08019;Barcelona;5;154;U;;607;229;356;450;157;1;13;436;449
8;Barcelona;13;Barcelonès;08019;Barcelona;5;155;U;;560;152;345;441;119;0;9;432;441
8;Barcelona;13;Barcelonès;08019;Barcelona;5;156;U;;794;218;481;610;184;3;13;594;607
8;Barcelona;13;Barcelonès;08019;Barcelona;5;157;U;;651;195;376;489;162;2;11;476;487
8;Barcelona;13;Barcelonès;08019;Barcelona;5;158;U;;827;194;497;648;179;2;8;638;646
8;Barcelona;13;Barcelonès;08019;Barcelona;5;16;U;;547;172;333;430;117;1;8;421;429
8;Barcelona;13;Barcelonès;08019;Barcelona;5;160;U;;1022;267;592;766;256;0;14;752;766
8;Barcelona;13;Barcelonès;08019;Barcelona;5;161;U;;801;267;526;628;173;0;6;622;628
8;Barcelona;13;Barcelonès;08019;Barcelona;5;162;U;;993;268;585;711;282;1;4;706;710
8;Barcelona;13;Barcelonès;08019;Barcelona;5;164;U;;670;192;370;470;200;0;7;463;470
8;Barcelona;13;Barcelonès;08019;Barcelona;5;165;U;;659;189;402;525;134;2;9;514;523
8;Barcelona;13;Barcelonès;08019;Barcelona;5;166;U;;800;245;480;588;212;6;6;576;582
8;Barcelona;13;Barcelonès;08019;Barcelona;5;168;U;;605;162;364;450;155;1;3;446;449
8;Barcelona;13;Barcelonès;08019;Barcelona;5;169;U;;900;232;563;714;186;0;8;706;714
8;Barcelona;13;Barcelonès;08019;Barcelona;5;17;U;;488;119;296;363;125;0;8;355;363
8;Barcelona;13;Barcelonès;08019;Barcelona;5;170;U;;670;223;417;502;168;3;5;494;499
8;Barcelona;13;Barcelonès;08019;Barcelona;5;171;U;;1024;304;654;778;246;1;20;757;777
8;Barcelona;13;Barcelonès;08019;Barcelona;5;174;U;;560;148;291;339;221;0;3;336;339
8;Barcelona;13;Barcelonès;08019;Barcelona;5;175;A;;559;173;347;412;147;1;3;408;411
8;Barcelona;13;Barcelonès;08019;Barcelona;5;175;B;;575;202;343;429;146;0;2;427;429
8;Barcelona;13;Barcelonès;08019;Barcelona;5;177;U;;585;217;385;451;134;0;6;445;451
8;Barcelona;13;Barcelonès;08019;Barcelona;5;178;U;;884;266;541;647;237;0;13;634;647
8;Barcelona;13;Barcelonès;08019;Barcelona;5;18;U;;735;190;430;548;187;1;5;542;547
8;Barcelona;13;Barcelonès;08019;Barcelona;5;180;U;;592;175;339;418;174;0;4;414;418
8;Barcelona;13;Barcelonès;08019;Barcelona;5;182;U;;893;258;482;615;278;1;7;607;614
8;Barcelona;13;Barcelonès;08019;Barcelona;5;183;U;;584;150;270;339;245;1;2;336;338
8;Barcelona;13;Barcelonès;08019;Barcelona;5;19;U;;642;183;406;490;152;1;12;477;489
8;Barcelona;13;Barcelonès;08019;Barcelona;5;2;U;;642;152;376;478;164;0;11;467;478
8;Barcelona;13;Barcelonès;08019;Barcelona;5;20;U;;578;172;328;416;162;0;8;408;416
8;Barcelona;13;Barcelonès;08019;Barcelona;5;21;U;;552;154;344;431;121;0;9;422;431
8;Barcelona;13;Barcelonès;08019;Barcelona;5;22;U;;569;138;344;426;143;0;5;421;426
8;Barcelona;13;Barcelonès;08019;Barcelona;5;23;U;;643;186;393;481;162;0;4;477;481
8;Barcelona;13;Barcelonès;08019;Barcelona;5;24;U;;654;155;383;487;167;0;5;482;487
8;Barcelona;13;Barcelonès;08019;Barcelona;5;25;U;;657;197;367;473;184;0;5;468;473
8;Barcelona;13;Barcelonès;08019;Barcelona;5;27;U;;701;210;403;508;193;1;7;500;507
8;Barcelona;13;Barcelonès;08019;Barcelona;5;28;U;;644;186;379;500;144;1;11;488;499
8;Barcelona;13;Barcelonès;08019;Barcelona;5;29;U;;1093;177;638;816;277;1;17;798;815
8;Barcelona;13;Barcelonès;08019;Barcelona;5;3;A;;642;153;361;481;161;0;13;468;481
8;Barcelona;13;Barcelonès;08019;Barcelona;5;3;B;;688;141;354;494;194;1;9;484;493
8;Barcelona;13;Barcelonès;08019;Barcelona;5;31;U;;785;205;450;567;218;1;7;559;566
8;Barcelona;13;Barcelonès;08019;Barcelona;5;32;U;;580;125;335;433;147;0;6;427;433
8;Barcelona;13;Barcelonès;08019;Barcelona;5;33;U;;533;196;340;413;120;1;9;403;412
8;Barcelona;13;Barcelonès;08019;Barcelona;5;34;U;;726;201;451;538;188;0;9;529;538
8;Barcelona;13;Barcelonès;08019;Barcelona;5;35;U;;729;222;426;518;211;1;10;507;517
8;Barcelona;13;Barcelonès;08019;Barcelona;5;36;U;;482;125;260;327;155;0;6;321;327
8;Barcelona;13;Barcelonès;08019;Barcelona;5;37;U;;854;252;511;613;241;3;6;604;610
8;Barcelona;13;Barcelonès;08019;Barcelona;5;38;U;;572;169;341;423;149;0;5;418;423
8;Barcelona;13;Barcelonès;08019;Barcelona;5;39;U;;1104;330;630;812;292;3;7;802;809
8;Barcelona;13;Barcelonès;08019;Barcelona;5;4;U;;928;181;502;670;258;2;18;650;668
8;Barcelona;13;Barcelonès;08019;Barcelona;5;40;U;;576;177;378;472;104;0;8;464;472
8;Barcelona;13;Barcelonès;08019;Barcelona;5;41;U;;1115;287;664;831;284;1;13;817;830
8;Barcelona;13;Barcelonès;08019;Barcelona;5;42;U;;844;219;493;628;216;0;9;619;628
8;Barcelona;13;Barcelonès;08019;Barcelona;5;43;U;;540;141;311;411;129;1;10;400;410
8;Barcelona;13;Barcelonès;08019;Barcelona;5;44;U;;597;147;360;462;135;1;7;454;461
8;Barcelona;13;Barcelonès;08019;Barcelona;5;45;U;;523;22;309;388;135;2;8;378;386
8;Barcelona;13;Barcelonès;08019;Barcelona;5;46;U;;703;176;419;554;149;1;13;540;553
8;Barcelona;13;Barcelonès;08019;Barcelona;5;47;U;;671;165;397;511;160;0;9;502;511
8;Barcelona;13;Barcelonès;08019;Barcelona;5;48;U;;496;152;297;378;118;2;5;371;376
8;Barcelona;13;Barcelonès;08019;Barcelona;5;49;U;;690;171;396;511;179;1;8;502;510
8;Barcelona;13;Barcelonès;08019;Barcelona;5;5;U;;997;241;573;755;242;0;13;742;755
8;Barcelona;13;Barcelonès;08019;Barcelona;5;50;U;;658;155;358;451;207;0;19;432;451
8;Barcelona;13;Barcelonès;08019;Barcelona;5;51;U;;623;167;340;432;191;0;2;430;432
8;Barcelona;13;Barcelonès;08019;Barcelona;5;52;U;;731;210;464;576;155;3;10;563;573
8;Barcelona;13;Barcelonès;08019;Barcelona;5;53;U;;596;155;372;460;136;0;12;448;460
8;Barcelona;13;Barcelonès;08019;Barcelona;5;54;U;;759;151;463;574;185;0;17;557;574
8;Barcelona;13;Barcelonès;08019;Barcelona;5;55;U;;959;290;587;729;230;0;9;720;729
8;Barcelona;13;Barcelonès;08019;Barcelona;5;56;U;;679;188;392;524;155;0;20;504;524
8;Barcelona;13;Barcelonès;08019;Barcelona;5;57;U;;651;188;418;490;161;0;7;483;490
8;Barcelona;13;Barcelonès;08019;Barcelona;5;58;U;;910;240;533;664;246;0;10;654;664
8;Barcelona;13;Barcelonès;08019;Barcelona;5;59;U;;562;145;304;400;162;2;6;392;398
8;Barcelona;13;Barcelonès;08019;Barcelona;5;6;A;;577;153;378;450;127;0;6;444;450
8;Barcelona;13;Barcelonès;08019;Barcelona;5;6;B;;670;170;404;530;140;3;8;519;527
8;Barcelona;13;Barcelonès;08019;Barcelona;5;60;U;;789;199;422;549;240;0;7;542;549
8;Barcelona;13;Barcelonès;08019;Barcelona;5;61;U;;788;250;475;582;206;0;11;571;582
8;Barcelona;13;Barcelonès;08019;Barcelona;5;62;U;;810;225;498;599;211;3;6;590;596
8;Barcelona;13;Barcelonès;08019;Barcelona;5;64;U;;604;160;340;423;181;0;6;417;423
8;Barcelona;13;Barcelonès;08019;Barcelona;5;65;U;;965;253;535;685;280;2;9;674;683
8;Barcelona;13;Barcelonès;08019;Barcelona;5;67;U;;969;313;581;708;261;6;14;688;702
8;Barcelona;13;Barcelonès;08019;Barcelona;5;68;U;;586;156;318;407;179;2;6;399;405
8;Barcelona;13;Barcelonès;08019;Barcelona;5;69;A;;520;141;289;360;160;0;7;353;360
8;Barcelona;13;Barcelonès;08019;Barcelona;5;69;B;;650;193;369;462;188;0;13;449;462
8;Barcelona;13;Barcelonès;08019;Barcelona;5;70;U;;681;224;429;495;186;0;0;495;495
8;Barcelona;13;Barcelonès;08019;Barcelona;5;72;U;;721;187;409;525;196;1;10;514;524
8;Barcelona;13;Barcelonès;08019;Barcelona;5;73;U;;534;146;309;388;146;0;8;380;388
8;Barcelona;13;Barcelonès;08019;Barcelona;5;74;U;;603;216;369;469;134;1;3;465;468
8;Barcelona;13;Barcelonès;08019;Barcelona;5;75;U;;782;226;434;565;217;0;12;553;565
8;Barcelona;13;Barcelonès;08019;Barcelona;5;76;U;;648;179;388;491;157;1;6;484;490
8;Barcelona;13;Barcelonès;08019;Barcelona;5;77;U;;1076;285;641;803;273;3;8;792;800
8;Barcelona;13;Barcelonès;08019;Barcelona;5;79;U;;665;201;387;493;172;0;10;483;493
8;Barcelona;13;Barcelonès;08019;Barcelona;5;8;U;;650;180;381;460;190;4;11;445;456
8;Barcelona;13;Barcelonès;08019;Barcelona;5;80;U;;1002;325;609;746;256;0;9;737;746
8;Barcelona;13;Barcelonès;08019;Barcelona;5;81;U;;561;150;330;398;163;0;2;396;398
8;Barcelona;13;Barcelonès;08019;Barcelona;5;82;U;;794;191;474;595;199;0;10;585;595
8;Barcelona;13;Barcelonès;08019;Barcelona;5;84;U;;555;145;293;406;149;0;9;397;406
8;Barcelona;13;Barcelonès;08019;Barcelona;5;85;U;;959;315;589;717;242;0;11;706;717
8;Barcelona;13;Barcelonès;08019;Barcelona;5;86;U;;771;199;452;544;227;0;8;536;544
8;Barcelona;13;Barcelonès;08019;Barcelona;5;87;U;;604;159;344;433;171;0;10;423;433
8;Barcelona;13;Barcelonès;08019;Barcelona;5;88;U;;551;160;330;426;125;1;6;419;425
8;Barcelona;13;Barcelonès;08019;Barcelona;5;89;U;;961;252;588;729;232;0;12;717;729
8;Barcelona;13;Barcelonès;08019;Barcelona;5;90;U;;681;144;380;517;164;1;6;510;516
8;Barcelona;13;Barcelonès;08019;Barcelona;5;91;A;;783;210;474;594;189;1;11;582;593
8;Barcelona;13;Barcelonès;08019;Barcelona;5;91;B;;972;275;584;746;226;4;6;736;742
8;Barcelona;13;Barcelonès;08019;Barcelona;5;92;U;;513;121;293;390;123;0;9;381;390
8;Barcelona;13;Barcelonès;08019;Barcelona;5;93;U;;564;159;348;425;139;0;10;415;425
8;Barcelona;13;Barcelonès;08019;Barcelona;5;94;U;;553;158;308;388;165;0;5;383;388
8;Barcelona;13;Barcelonès;08019;Barcelona;5;95;U;;860;279;554;627;233;1;11;615;626
8;Barcelona;13;Barcelonès;08019;Barcelona;5;96;U;;669;180;416;505;164;1;9;495;504
8;Barcelona;13;Barcelonès;08019;Barcelona;5;97;A;;727;188;438;545;182;1;5;539;544
8;Barcelona;13;Barcelonès;08019;Barcelona;5;97;B;;772;236;464;562;210;3;9;550;559
8;Barcelona;13;Barcelonès;08019;Barcelona;5;98;U;;682;187;348;445;237;2;7;436;443
8;Barcelona;13;Barcelonès;08019;Barcelona;5;99;U;;555;167;351;429;126;0;9;420;429
8;Barcelona;13;Barcelonès;08019;Barcelona;6;1;U;;475;130;269;320;155;1;4;315;319
8;Barcelona;13;Barcelonès;08019;Barcelona;6;10;U;;841;278;567;558;283;2;3;553;556
8;Barcelona;13;Barcelonès;08019;Barcelona;6;100;U;;827;266;491;572;255;0;4;568;572
8;Barcelona;13;Barcelonès;08019;Barcelona;6;102;U;;652;193;366;451;201;0;9;442;451
8;Barcelona;13;Barcelonès;08019;Barcelona;6;103;U;;943;283;593;705;238;2;4;699;703
8;Barcelona;13;Barcelonès;08019;Barcelona;6;104;U;;694;168;400;479;215;0;9;470;479
8;Barcelona;13;Barcelonès;08019;Barcelona;6;105;U;;760;214;443;527;233;1;2;524;526
8;Barcelona;13;Barcelonès;08019;Barcelona;6;106;U;;840;221;443;541;299;1;2;538;540
8;Barcelona;13;Barcelonès;08019;Barcelona;6;107;U;;1078;333;645;767;311;5;7;755;762
8;Barcelona;13;Barcelonès;08019;Barcelona;6;109;U;;739;226;422;524;215;0;4;520;524
8;Barcelona;13;Barcelonès;08019;Barcelona;6;11;U;;1037;303;461;677;360;0;7;670;677
8;Barcelona;13;Barcelonès;08019;Barcelona;6;110;U;;488;143;268;349;139;0;2;347;349
8;Barcelona;13;Barcelonès;08019;Barcelona;6;111;U;;547;165;325;393;154;0;7;386;393
8;Barcelona;13;Barcelonès;08019;Barcelona;6;112;U;;986;300;539;686;300;3;8;675;683
8;Barcelona;13;Barcelonès;08019;Barcelona;6;113;U;;935;284;540;687;248;1;8;678;686
8;Barcelona;13;Barcelonès;08019;Barcelona;6;114;A;;765;220;458;596;169;0;15;581;596
8;Barcelona;13;Barcelonès;08019;Barcelona;6;114;B;;929;249;548;702;227;1;7;694;701
8;Barcelona;13;Barcelonès;08019;Barcelona;6;115;A;;570;157;336;425;145;0;3;422;425
8;Barcelona;13;Barcelonès;08019;Barcelona;6;115;B;;604;156;383;471;133;0;11;460;471
8;Barcelona;13;Barcelonès;08019;Barcelona;6;116;U;;559;197;337;417;142;0;7;410;417
8;Barcelona;13;Barcelonès;08019;Barcelona;6;117;U;;766;232;477;574;192;0;9;565;574
8;Barcelona;13;Barcelonès;08019;Barcelona;6;118;U;;824;242;488;624;200;0;3;621;624
8;Barcelona;13;Barcelonès;08019;Barcelona;6;119;U;;864;261;549;663;201;0;8;655;663
8;Barcelona;13;Barcelonès;08019;Barcelona;6;12;U;;571;198;316;367;204;1;4;362;366
8;Barcelona;13;Barcelonès;08019;Barcelona;6;120;U;;761;218;471;569;192;0;7;562;569
8;Barcelona;13;Barcelonès;08019;Barcelona;6;121;U;;797;233;437;537;260;2;2;533;535
8;Barcelona;13;Barcelonès;08019;Barcelona;6;122;A;;557;150;322;428;129;0;8;420;428
8;Barcelona;13;Barcelonès;08019;Barcelona;6;122;B;;612;155;355;459;153;0;11;448;459
8;Barcelona;13;Barcelonès;08019;Barcelona;6;124;U;;825;243;411;479;346;1;8;470;478
8;Barcelona;13;Barcelonès;08019;Barcelona;6;125;U;;635;170;347;424;211;0;4;420;424
8;Barcelona;13;Barcelonès;08019;Barcelona;6;127;U;;948;246;510;643;305;0;8;635;643
8;Barcelona;13;Barcelonès;08019;Barcelona;6;128;U;;926;267;542;676;250;2;10;664;674
8;Barcelona;13;Barcelonès;08019;Barcelona;6;129;U;;546;137;273;341;205;0;8;333;341
8;Barcelona;13;Barcelonès;08019;Barcelona;6;13;U;;648;174;342;431;217;0;4;427;431
8;Barcelona;13;Barcelonès;08019;Barcelona;6;130;U;;598;179;344;422;176;0;4;418;422
8;Barcelona;13;Barcelonès;08019;Barcelona;6;131;U;;849;253;480;561;288;1;4;556;560
8;Barcelona;13;Barcelonès;08019;Barcelona;6;132;U;;821;237;399;501;320;2;3;496;499
8;Barcelona;13;Barcelonès;08019;Barcelona;6;133;U;;716;158;350;441;275;0;3;438;441
8;Barcelona;13;Barcelonès;08019;Barcelona;6;134;A;;674;215;380;480;194;2;5;473;478
8;Barcelona;13;Barcelonès;08019;Barcelona;6;134;B;;826;230;473;586;240;0;6;580;586
8;Barcelona;13;Barcelonès;08019;Barcelona;6;136;A;;589;181;326;399;190;1;7;391;398
8;Barcelona;13;Barcelonès;08019;Barcelona;6;136;B;;688;195;383;489;199;0;5;484;489
8;Barcelona;13;Barcelonès;08019;Barcelona;6;137;U;;676;230;402;476;200;2;2;472;474
8;Barcelona;13;Barcelonès;08019;Barcelona;6;138;U;;915;367;509;608;307;0;10;598;608
8;Barcelona;13;Barcelonès;08019;Barcelona;6;139;U;;744;224;423;521;223;1;6;514;520
8;Barcelona;13;Barcelonès;08019;Barcelona;6;14;U;;923;287;512;594;329;1;0;593;593
8;Barcelona;13;Barcelonès;08019;Barcelona;6;140;U;;671;144;345;439;232;0;3;436;439
8;Barcelona;13;Barcelonès;08019;Barcelona;6;141;U;;637;154;340;435;202;0;3;432;435
8;Barcelona;13;Barcelonès;08019;Barcelona;6;142;U;;745;223;398;454;291;0;6;448;454
8;Barcelona;13;Barcelonès;08019;Barcelona;6;143;U;;557;161;262;331;226;1;3;327;330
8;Barcelona;13;Barcelonès;08019;Barcelona;6;144;U;;758;188;399;483;275;0;4;479;483
8;Barcelona;13;Barcelonès;08019;Barcelona;6;145;U;;529;157;275;323;206;0;0;323;323
8;Barcelona;13;Barcelonès;08019;Barcelona;6;146;U;;818;214;416;487;331;4;7;476;483
8;Barcelona;13;Barcelonès;08019;Barcelona;6;147;U;;554;109;256;340;214;2;4;334;338
8;Barcelona;13;Barcelonès;08019;Barcelona;6;148;U;;647;177;324;403;244;0;5;398;403
8;Barcelona;13;Barcelonès;08019;Barcelona;6;149;U;;672;185;367;458;214;2;9;447;456
8;Barcelona;13;Barcelonès;08019;Barcelona;6;150;A;;595;156;355;429;166;0;6;423;429
8;Barcelona;13;Barcelonès;08019;Barcelona;6;150;B;;586;154;357;458;128;1;6;451;457
8;Barcelona;13;Barcelonès;08019;Barcelona;6;152;U;;664;161;404;495;169;3;11;481;492
8;Barcelona;13;Barcelonès;08019;Barcelona;6;153;U;;766;191;415;538;228;1;8;529;537
8;Barcelona;13;Barcelonès;08019;Barcelona;6;154;U;;485;126;257;323;162;1;3;319;322
8;Barcelona;13;Barcelonès;08019;Barcelona;6;155;A;;675;182;367;450;225;0;5;445;450
8;Barcelona;13;Barcelonès;08019;Barcelona;6;155;B;;778;208;451;539;239;2;8;529;537
8;Barcelona;13;Barcelonès;08019;Barcelona;6;157;A;;821;230;466;573;248;0;14;559;573
8;Barcelona;13;Barcelonès;08019;Barcelona;6;157;B;;892;249;497;600;292;2;8;590;598
8;Barcelona;13;Barcelonès;08019;Barcelona;6;158;A;;569;162;332;389;180;1;5;383;388
8;Barcelona;13;Barcelonès;08019;Barcelona;6;158;B;;678;190;419;477;201;0;9;468;477
8;Barcelona;13;Barcelonès;08019;Barcelona;6;16;U;;717;219;382;455;262;4;0;451;451
8;Barcelona;13;Barcelonès;08019;Barcelona;6;17;U;;632;197;340;380;252;1;8;371;379
8;Barcelona;13;Barcelonès;08019;Barcelona;6;18;U;;789;243;432;514;275;1;0;513;513
8;Barcelona;13;Barcelonès;08019;Barcelona;6;19;U;;597;193;328;392;205;0;1;391;392
8;Barcelona;13;Barcelonès;08019;Barcelona;6;2;U;;892;301;569;668;224;0;8;660;668
8;Barcelona;13;Barcelonès;08019;Barcelona;6;20;U;;817;248;474;575;242;0;4;571;575
8;Barcelona;13;Barcelonès;08019;Barcelona;6;21;U;;663;221;359;470;193;0;1;469;470
8;Barcelona;13;Barcelonès;08019;Barcelona;6;22;U;;1132;367;645;775;357;1;6;768;774
8;Barcelona;13;Barcelonès;08019;Barcelona;6;23;U;;1036;305;620;777;259;1;3;773;776
8;Barcelona;13;Barcelonès;08019;Barcelona;6;26;U;;507;163;277;341;166;2;2;337;339
8;Barcelona;13;Barcelonès;08019;Barcelona;6;27;U;;712;215;440;538;174;1;5;532;537
8;Barcelona;13;Barcelonès;08019;Barcelona;6;28;U;;667;202;372;459;208;0;3;456;459
8;Barcelona;13;Barcelonès;08019;Barcelona;6;29;U;;924;289;545;646;278;4;3;639;642
8;Barcelona;13;Barcelonès;08019;Barcelona;6;30;U;;740;224;450;525;215;4;2;519;521
8;Barcelona;13;Barcelonès;08019;Barcelona;6;31;U;;852;248;460;566;286;1;5;560;565
8;Barcelona;13;Barcelonès;08019;Barcelona;6;32;U;;872;239;472;560;312;0;7;553;560
8;Barcelona;13;Barcelonès;08019;Barcelona;6;33;U;;692;220;346;456;236;1;6;449;455
8;Barcelona;13;Barcelonès;08019;Barcelona;6;34;U;;911;293;573;671;240;3;8;660;668
8;Barcelona;13;Barcelonès;08019;Barcelona;6;35;U;;981;252;518;656;325;3;5;648;653
8;Barcelona;13;Barcelonès;08019;Barcelona;6;36;U;;609;173;363;474;135;0;5;469;474
8;Barcelona;13;Barcelonès;08019;Barcelona;6;37;U;;693;227;424;528;165;2;13;513;526
8;Barcelona;13;Barcelonès;08019;Barcelona;6;38;U;;773;251;467;562;211;2;5;555;560
8;Barcelona;13;Barcelonès;08019;Barcelona;6;39;U;;632;172;388;467;165;0;6;461;467
8;Barcelona;13;Barcelonès;08019;Barcelona;6;4;U;;530;147;308;359;171;2;6;351;357
8;Barcelona;13;Barcelonès;08019;Barcelona;6;40;U;;876;253;480;644;232;0;6;638;644
8;Barcelona;13;Barcelonès;08019;Barcelona;6;41;A;;577;162;338;418;159;0;5;413;418
8;Barcelona;13;Barcelonès;08019;Barcelona;6;41;B;;689;193;393;476;213;0;6;470;476
8;Barcelona;13;Barcelonès;08019;Barcelona;6;42;U;;969;330;556;679;290;0;8;671;679
8;Barcelona;13;Barcelonès;08019;Barcelona;6;43;U;;980;261;585;731;249;1;18;712;730
8;Barcelona;13;Barcelonès;08019;Barcelona;6;44;U;;1035;326;617;736;299;0;3;733;736
8;Barcelona;13;Barcelonès;08019;Barcelona;6;45;U;;730;192;394;490;240;0;6;484;490
8;Barcelona;13;Barcelonès;08019;Barcelona;6;47;U;;573;150;296;365;208;0;4;361;365
8;Barcelona;13;Barcelonès;08019;Barcelona;6;48;U;;600;173;337;424;176;0;4;420;424
8;Barcelona;13;Barcelonès;08019;Barcelona;6;49;U;;557;130;266;332;225;1;0;331;331
8;Barcelona;13;Barcelonès;08019;Barcelona;6;5;U;;523;188;321;397;126;2;2;393;395
8;Barcelona;13;Barcelonès;08019;Barcelona;6;50;U;;885;234;501;628;257;0;5;623;628
8;Barcelona;13;Barcelonès;08019;Barcelona;6;52;U;;1005;291;538;672;333;1;7;664;671
8;Barcelona;13;Barcelonès;08019;Barcelona;6;54;U;;676;198;400;485;191;2;6;477;483
8;Barcelona;13;Barcelonès;08019;Barcelona;6;55;U;;783;221;394;522;261;1;8;513;521
8;Barcelona;13;Barcelonès;08019;Barcelona;6;56;U;;828;267;466;568;260;3;0;565;565
8;Barcelona;13;Barcelonès;08019;Barcelona;6;57;A;;532;200;351;407;125;1;2;404;406
8;Barcelona;13;Barcelonès;08019;Barcelona;6;57;B;;598;212;392;445;153;0;3;442;445
8;Barcelona;13;Barcelonès;08019;Barcelona;6;58;U;;572;173;344;439;133;0;7;432;439
8;Barcelona;13;Barcelonès;08019;Barcelona;6;59;U;;1017;292;602;733;284;0;7;726;733
8;Barcelona;13;Barcelonès;08019;Barcelona;6;6;U;;486;160;271;333;153;1;5;327;332
8;Barcelona;13;Barcelonès;08019;Barcelona;6;60;U;;593;163;312;397;196;0;2;395;397
8;Barcelona;13;Barcelonès;08019;Barcelona;6;61;U;;582;172;306;423;159;1;3;419;422
8;Barcelona;13;Barcelonès;08019;Barcelona;6;63;U;;509;170;298;353;156;0;3;350;353
8;Barcelona;13;Barcelonès;08019;Barcelona;6;64;U;;713;241;403;483;230;0;6;477;483
8;Barcelona;13;Barcelonès;08019;Barcelona;6;66;U;;514;158;260;320;194;2;2;316;318
8;Barcelona;13;Barcelonès;08019;Barcelona;6;68;U;;807;219;392;485;322;0;3;482;485
8;Barcelona;13;Barcelonès;08019;Barcelona;6;69;U;;942;274;518;630;312;0;2;628;630
8;Barcelona;13;Barcelonès;08019;Barcelona;6;7;U;;593;310;327;384;209;2;4;378;382
8;Barcelona;13;Barcelonès;08019;Barcelona;6;70;U;;798;233;435;525;273;0;16;509;525
8;Barcelona;13;Barcelonès;08019;Barcelona;6;72;U;;471;170;291;342;129;0;0;342;342
8;Barcelona;13;Barcelonès;08019;Barcelona;6;73;U;;504;161;281;344;160;0;7;337;344
8;Barcelona;13;Barcelonès;08019;Barcelona;6;74;U;;984;278;539;676;308;2;9;665;674
8;Barcelona;13;Barcelonès;08019;Barcelona;6;76;U;;623;190;362;416;207;0;6;410;416
8;Barcelona;13;Barcelonès;08019;Barcelona;6;77;U;;547;161;308;374;173;0;5;369;374
8;Barcelona;13;Barcelonès;08019;Barcelona;6;78;U;;885;255;486;585;300;0;0;585;585
8;Barcelona;13;Barcelonès;08019;Barcelona;6;8;U;;1117;327;609;729;388;1;6;722;728
8;Barcelona;13;Barcelonès;08019;Barcelona;6;80;U;;494;148;250;303;191;1;2;300;302
8;Barcelona;13;Barcelonès;08019;Barcelona;6;81;U;;613;193;358;419;194;0;5;414;419
8;Barcelona;13;Barcelonès;08019;Barcelona;6;82;U;;960;257;524;647;313;0;3;644;647
8;Barcelona;13;Barcelonès;08019;Barcelona;6;84;U;;673;220;380;455;218;0;7;448;455
8;Barcelona;13;Barcelonès;08019;Barcelona;6;85;U;;686;243;423;496;190;1;2;493;495
8;Barcelona;13;Barcelonès;08019;Barcelona;6;86;U;;521;182;317;370;151;0;7;363;370
8;Barcelona;13;Barcelonès;08019;Barcelona;6;87;U;;487;169;292;342;145;0;4;338;342
8;Barcelona;13;Barcelonès;08019;Barcelona;6;88;U;;488;121;253;330;158;0;3;327;330
8;Barcelona;13;Barcelonès;08019;Barcelona;6;89;U;;923;281;557;677;246;3;3;671;674
8;Barcelona;13;Barcelonès;08019;Barcelona;6;90;U;;625;196;361;440;185;0;10;430;440
8;Barcelona;13;Barcelonès;08019;Barcelona;6;91;U;;516;171;295;354;162;1;6;347;353
8;Barcelona;13;Barcelonès;08019;Barcelona;6;92;U;;566;208;335;393;173;1;3;389;392
8;Barcelona;13;Barcelonès;08019;Barcelona;6;93;U;;665;209;381;432;233;0;2;430;432
8;Barcelona;13;Barcelonès;08019;Barcelona;6;94;U;;769;211;400;493;276;3;1;489;490
8;Barcelona;13;Barcelonès;08019;Barcelona;6;95;U;;644;200;389;444;200;1;3;440;443
8;Barcelona;13;Barcelonès;08019;Barcelona;6;96;U;;604;155;348;423;181;0;0;423;423
8;Barcelona;13;Barcelonès;08019;Barcelona;6;97;U;;1059;250;583;733;326;0;6;727;733
8;Barcelona;13;Barcelonès;08019;Barcelona;6;98;U;;840;263;518;622;218;2;10;610;620
8;Barcelona;13;Barcelonès;08019;Barcelona;7;1;A;;763;197;419;516;247;2;10;504;514
8;Barcelona;13;Barcelonès;08019;Barcelona;7;1;B;;837;238;485;596;241;2;7;587;594
8;Barcelona;13;Barcelonès;08019;Barcelona;7;10;U;;901;227;487;616;285;3;12;601;613
8;Barcelona;13;Barcelonès;08019;Barcelona;7;100;U;;819;184;438;527;292;1;3;523;526
8;Barcelona;13;Barcelonès;08019;Barcelona;7;101;U;;677;162;362;454;223;0;4;450;454
8;Barcelona;13;Barcelonès;08019;Barcelona;7;102;U;;543;169;288;358;185;0;6;352;358
8;Barcelona;13;Barcelonès;08019;Barcelona;7;103;U;;587;158;344;430;157;0;3;427;430
8;Barcelona;13;Barcelonès;08019;Barcelona;7;104;A;;535;107;265;357;178;0;4;353;357
8;Barcelona;13;Barcelonès;08019;Barcelona;7;104;B;;636;145;324;424;212;0;10;414;424
8;Barcelona;13;Barcelonès;08019;Barcelona;7;105;U;;648;185;362;448;200;1;5;442;447
8;Barcelona;13;Barcelonès;08019;Barcelona;7;106;U;;718;205;429;529;189;0;11;518;529
8;Barcelona;13;Barcelonès;08019;Barcelona;7;107;U;;569;154;316;413;156;0;3;410;413
8;Barcelona;13;Barcelonès;08019;Barcelona;7;108;U;;638;148;334;411;227;1;9;401;410
8;Barcelona;13;Barcelonès;08019;Barcelona;7;109;U;;663;202;396;460;203;2;6;452;458
8;Barcelona;13;Barcelonès;08019;Barcelona;7;11;U;;704;185;395;482;222;1;3;478;481
8;Barcelona;13;Barcelonès;08019;Barcelona;7;110;A;;576;138;258;326;250;0;3;323;326
8;Barcelona;13;Barcelonès;08019;Barcelona;7;110;B;;647;155;313;378;269;2;0;376;376
8;Barcelona;13;Barcelonès;08019;Barcelona;7;112;U;;663;158;293;368;295;0;5;363;368
8;Barcelona;13;Barcelonès;08019;Barcelona;7;113;U;;704;184;304;373;331;0;4;369;373
8;Barcelona;13;Barcelonès;08019;Barcelona;7;114;U;;786;156;324;406;380;4;0;402;402
8;Barcelona;13;Barcelonès;08019;Barcelona;7;116;U;;954;190;390;515;439;1;13;501;514
8;Barcelona;13;Barcelonès;08019;Barcelona;7;117;U;;875;230;429;521;354;1;5;515;520
8;Barcelona;13;Barcelonès;08019;Barcelona;7;118;A;;516;125;213;269;247;0;4;265;269
8;Barcelona;13;Barcelonès;08019;Barcelona;7;118;B;;617;150;260;319;298;0;8;311;319
8;Barcelona;13;Barcelonès;08019;Barcelona;7;119;U;;975;224;434;519;456;0;7;512;519
8;Barcelona;13;Barcelonès;08019;Barcelona;7;12;U;;738;201;394;522;216;1;9;512;521
8;Barcelona;13;Barcelonès;08019;Barcelona;7;120;U;;714;198;365;435;279;2;4;429;433
8;Barcelona;13;Barcelonès;08019;Barcelona;7;121;U;;581;123;266;315;266;1;3;311;314
8;Barcelona;13;Barcelonès;08019;Barcelona;7;122;U;;1028;232;466;536;492;10;0;526;526
8;Barcelona;13;Barcelonès;08019;Barcelona;7;123;A;;698;166;326;420;278;3;10;407;417
8;Barcelona;13;Barcelonès;08019;Barcelona;7;123;B;;876;209;377;480;396;2;6;472;478
8;Barcelona;13;Barcelonès;08019;Barcelona;7;124;U;;814;184;379;441;373;10;6;425;431
8;Barcelona;13;Barcelonès;08019;Barcelona;7;125;U;;1070;255;512;612;458;0;17;595;612
8;Barcelona;13;Barcelonès;08019;Barcelona;7;127;U;;737;199;360;417;320;0;7;410;417
8;Barcelona;13;Barcelonès;08019;Barcelona;7;128;U;;808;160;336;410;398;0;2;408;410
8;Barcelona;13;Barcelonès;08019;Barcelona;7;129;U;;667;147;303;368;299;1;4;363;367
8;Barcelona;13;Barcelonès;08019;Barcelona;7;13;U;;899;248;517;659;240;0;9;650;659
8;Barcelona;13;Barcelonès;08019;Barcelona;7;130;U;;546;113;238;279;267;3;0;276;276
8;Barcelona;13;Barcelonès;08019;Barcelona;7;131;U;;840;165;338;440;400;2;3;435;438
8;Barcelona;13;Barcelonès;08019;Barcelona;7;132;U;;559;112;234;295;264;0;4;291;295
8;Barcelona;13;Barcelonès;08019;Barcelona;7;133;U;;988;260;458;573;415;0;7;566;573
8;Barcelona;13;Barcelonès;08019;Barcelona;7;134;U;;902;200;420;512;390;0;10;502;512
8;Barcelona;13;Barcelonès;08019;Barcelona;7;135;U;;500;114;210;275;225;0;3;272;275
8;Barcelona;13;Barcelonès;08019;Barcelona;7;136;U;;575;154;284;349;226;0;5;344;349
8;Barcelona;13;Barcelonès;08019;Barcelona;7;137;U;;968;286;489;596;372;1;3;592;595
8;Barcelona;13;Barcelonès;08019;Barcelona;7;138;U;;734;184;365;473;261;0;5;468;473
8;Barcelona;13;Barcelonès;08019;Barcelona;7;139;U;;1067;313;546;663;404;3;9;651;660
8;Barcelona;13;Barcelonès;08019;Barcelona;7;14;U;;558;144;291;353;205;0;2;351;353
8;Barcelona;13;Barcelonès;08019;Barcelona;7;140;U;;570;169;273;354;216;0;5;349;354
8;Barcelona;13;Barcelonès;08019;Barcelona;7;141;U;;709;169;347;448;261;3;6;439;445
8;Barcelona;13;Barcelonès;08019;Barcelona;7;142;A;;583;172;302;367;216;2;5;360;365
8;Barcelona;13;Barcelonès;08019;Barcelona;7;142;B;;623;170;316;378;245;0;3;375;378
8;Barcelona;13;Barcelonès;08019;Barcelona;7;144;U;;502;144;261;326;176;0;4;322;326
8;Barcelona;13;Barcelonès;08019;Barcelona;7;145;U;;745;205;382;473;272;6;2;465;467
8;Barcelona;13;Barcelonès;08019;Barcelona;7;147;U;;805;237;511;543;262;0;4;539;543
8;Barcelona;13;Barcelonès;08019;Barcelona;7;148;U;;682;163;329;396;286;1;8;387;395
8;Barcelona;13;Barcelonès;08019;Barcelona;7;149;U;;483;121;244;279;204;0;3;276;279
8;Barcelona;13;Barcelonès;08019;Barcelona;7;15;U;;563;158;293;371;192;0;9;362;371
8;Barcelona;13;Barcelonès;08019;Barcelona;7;150;U;;940;261;520;649;291;3;3;643;646
8;Barcelona;13;Barcelonès;08019;Barcelona;7;151;U;;619;174;337;426;193;0;5;421;426
8;Barcelona;13;Barcelonès;08019;Barcelona;7;152;U;;642;174;358;415;227;0;6;409;415
8;Barcelona;13;Barcelonès;08019;Barcelona;7;154;U;;544;146;309;376;168;0;15;361;376
8;Barcelona;13;Barcelonès;08019;Barcelona;7;155;U;;947;267;490;623;324;1;10;612;622
8;Barcelona;13;Barcelonès;08019;Barcelona;7;157;U;;772;219;428;526;246;0;4;522;526
8;Barcelona;13;Barcelonès;08019;Barcelona;7;158;U;;754;207;395;502;252;0;5;497;502
8;Barcelona;13;Barcelonès;08019;Barcelona;7;159;U;;759;196;393;498;261;1;7;490;497
8;Barcelona;13;Barcelonès;08019;Barcelona;7;16;U;;1000;290;496;618;382;1;8;609;617
8;Barcelona;13;Barcelonès;08019;Barcelona;7;160;U;;576;133;305;392;184;0;5;387;392
8;Barcelona;13;Barcelonès;08019;Barcelona;7;161;U;;539;163;309;390;149;0;1;389;390
8;Barcelona;13;Barcelonès;08019;Barcelona;7;162;U;;794;171;414;516;278;5;3;508;511
8;Barcelona;13;Barcelonès;08019;Barcelona;7;163;U;;641;183;371;454;187;0;4;450;454
8;Barcelona;13;Barcelonès;08019;Barcelona;7;164;U;;505;143;256;305;200;1;1;303;304
8;Barcelona;13;Barcelonès;08019;Barcelona;7;165;U;;656;188;367;446;210;0;4;442;446
8;Barcelona;13;Barcelonès;08019;Barcelona;7;166;A;;560;143;316;397;163;2;7;388;395
8;Barcelona;13;Barcelonès;08019;Barcelona;7;166;B;;618;163;346;433;185;0;7;426;433
8;Barcelona;13;Barcelonès;08019;Barcelona;7;167;U;;847;231;466;589;258;1;6;582;588
8;Barcelona;13;Barcelonès;08019;Barcelona;7;169;U;;773;230;429;519;254;1;5;513;518
8;Barcelona;13;Barcelonès;08019;Barcelona;7;17;U;;483;127;245;303;180;1;1;301;302
8;Barcelona;13;Barcelonès;08019;Barcelona;7;170;U;;1000;311;543;639;361;2;5;632;637
8;Barcelona;13;Barcelonès;08019;Barcelona;7;172;U;;574;173;291;365;209;0;5;360;365
8;Barcelona;13;Barcelonès;08019;Barcelona;7;173;U;;1012;290;542;636;376;5;4;627;631
8;Barcelona;13;Barcelonès;08019;Barcelona;7;174;U;;840;245;502;593;247;0;5;588;593
8;Barcelona;13;Barcelonès;08019;Barcelona;7;176;U;;538;202;323;400;138;1;1;398;399
8;Barcelona;13;Barcelonès;08019;Barcelona;7;177;A;;519;131;258;327;192;0;0;327;327
8;Barcelona;13;Barcelonès;08019;Barcelona;7;177;B;;640;166;314;400;240;0;4;396;400
8;Barcelona;13;Barcelonès;08019;Barcelona;7;179;U;;690;169;387;477;213;0;4;473;477
8;Barcelona;13;Barcelonès;08019;Barcelona;7;18;U;;563;148;293;396;167;2;4;390;394
8;Barcelona;13;Barcelonès;08019;Barcelona;7;180;U;;638;168;339;405;233;1;3;401;404
8;Barcelona;13;Barcelonès;08019;Barcelona;7;181;U;;978;263;500;577;401;3;7;567;574
8;Barcelona;13;Barcelonès;08019;Barcelona;7;183;U;;712;153;324;395;317;1;4;390;394
8;Barcelona;13;Barcelonès;08019;Barcelona;7;184;U;;1008;280;533;644;364;0;9;635;644
8;Barcelona;13;Barcelonès;08019;Barcelona;7;185;U;;877;260;507;593;284;1;2;590;592
8;Barcelona;13;Barcelonès;08019;Barcelona;7;187;U;;430;108;167;205;225;0;0;205;205
8;Barcelona;13;Barcelonès;08019;Barcelona;7;188;U;;874;211;410;485;389;0;5;480;485
8;Barcelona;13;Barcelonès;08019;Barcelona;7;189;U;;818;173;369;447;371;1;3;443;446
8;Barcelona;13;Barcelonès;08019;Barcelona;7;19;U;;945;285;580;685;260;0;8;677;685
8;Barcelona;13;Barcelonès;08019;Barcelona;7;190;A;;538;163;286;344;194;0;7;337;344
8;Barcelona;13;Barcelonès;08019;Barcelona;7;190;B;;643;191;329;395;248;0;6;389;395
8;Barcelona;13;Barcelonès;08019;Barcelona;7;191;U;;824;270;487;563;261;0;4;559;563
8;Barcelona;13;Barcelonès;08019;Barcelona;7;192;U;;921;280;497;587;334;0;9;578;587
8;Barcelona;13;Barcelonès;08019;Barcelona;7;193;U;;621;165;318;387;234;0;6;381;387
8;Barcelona;13;Barcelonès;08019;Barcelona;7;194;U;;567;185;340;425;142;0;1;424;425
8;Barcelona;13;Barcelonès;08019;Barcelona;7;195;U;;1030;223;503;631;399;1;11;619;630
8;Barcelona;13;Barcelonès;08019;Barcelona;7;196;U;;941;298;567;603;338;0;11;592;603
8;Barcelona;13;Barcelonès;08019;Barcelona;7;197;U;;837;281;472;545;292;0;4;541;545
8;Barcelona;13;Barcelonès;08019;Barcelona;7;198;U;;842;266;505;580;262;0;6;574;580
8;Barcelona;13;Barcelonès;08019;Barcelona;7;2;U;;682;182;354;460;222;4;2;454;456
8;Barcelona;13;Barcelonès;08019;Barcelona;7;20;U;;711;233;356;451;260;0;2;449;451
8;Barcelona;13;Barcelonès;08019;Barcelona;7;200;U;;1052;309;540;602;450;2;6;594;600
8;Barcelona;13;Barcelonès;08019;Barcelona;7;201;U;;808;236;456;547;261;1;8;538;546
8;Barcelona;13;Barcelonès;08019;Barcelona;7;202;U;;767;223;434;521;246;0;11;510;521
8;Barcelona;13;Barcelonès;08019;Barcelona;7;204;A;;843;211;469;572;271;0;5;567;572
8;Barcelona;13;Barcelonès;08019;Barcelona;7;204;B;;859;206;512;627;232;0;12;615;627
8;Barcelona;13;Barcelonès;08019;Barcelona;7;205;A;;655;160;339;418;237;0;7;411;418
8;Barcelona;13;Barcelonès;08019;Barcelona;7;205;B;;724;200;383;480;244;0;6;474;480
8;Barcelona;13;Barcelonès;08019;Barcelona;7;207;A;;801;177;420;492;309;0;13;479;492
8;Barcelona;13;Barcelonès;08019;Barcelona;7;207;B;;788;184;399;480;308;3;7;470;477
8;Barcelona;13;Barcelonès;08019;Barcelona;7;209;U;;984;260;481;577;407;0;9;568;577
8;Barcelona;13;Barcelonès;08019;Barcelona;7;210;A;;596;139;286;343;253;0;5;338;343
8;Barcelona;13;Barcelonès;08019;Barcelona;7;210;B;;630;158;294;363;267;0;4;359;363
8;Barcelona;13;Barcelonès;08019;Barcelona;7;211;A;;725;128;300;403;322;0;8;395;403
8;Barcelona;13;Barcelonès;08019;Barcelona;7;211;B;;809;145;288;409;400;2;8;399;407
8;Barcelona;13;Barcelonès;08019;Barcelona;7;213;U;;859;222;401;494;365;1;4;489;493
8;Barcelona;13;Barcelonès;08019;Barcelona;7;214;U;;589;138;262;336;253;2;8;326;334
8;Barcelona;13;Barcelonès;08019;Barcelona;7;215;U;;1079;258;507;603;476;3;10;590;600
8;Barcelona;13;Barcelonès;08019;Barcelona;7;217;U;;521;135;260;328;193;2;1;325;326
8;Barcelona;13;Barcelonès;08019;Barcelona;7;218;U;;781;209;374;456;325;0;6;450;456
8;Barcelona;13;Barcelonès;08019;Barcelona;7;219;U;;766;197;353;433;333;3;6;424;430
8;Barcelona;13;Barcelonès;08019;Barcelona;7;220;U;;823;217;403;485;338;0;10;475;485
8;Barcelona;13;Barcelonès;08019;Barcelona;7;221;U;;789;210;383;451;338;0;3;448;451
8;Barcelona;13;Barcelonès;08019;Barcelona;7;23;U;;600;174;346;423;177;1;5;417;422
8;Barcelona;13;Barcelonès;08019;Barcelona;7;24;U;;847;268;479;565;282;1;6;558;564
8;Barcelona;13;Barcelonès;08019;Barcelona;7;26;U;;581;162;305;385;196;0;0;385;385
8;Barcelona;13;Barcelonès;08019;Barcelona;7;27;U;;563;194;299;363;200;2;5;356;361
8;Barcelona;13;Barcelonès;08019;Barcelona;7;28;U;;544;152;312;363;181;2;5;356;361
8;Barcelona;13;Barcelonès;08019;Barcelona;7;29;U;;809;235;470;560;249;1;11;548;559
8;Barcelona;13;Barcelonès;08019;Barcelona;7;3;U;;675;214;360;459;216;1;5;453;458
8;Barcelona;13;Barcelonès;08019;Barcelona;7;31;U;;855;237;491;598;257;3;6;589;595
8;Barcelona;13;Barcelonès;08019;Barcelona;7;32;U;;581;153;337;398;183;0;4;394;398
8;Barcelona;13;Barcelonès;08019;Barcelona;7;33;U;;850;224;502;601;249;1;5;595;600
8;Barcelona;13;Barcelonès;08019;Barcelona;7;34;U;;1017;263;515;634;383;0;13;621;634
8;Barcelona;13;Barcelonès;08019;Barcelona;7;36;U;;538;146;298;363;175;1;1;361;362
8;Barcelona;13;Barcelonès;08019;Barcelona;7;37;U;;572;164;310;379;193;3;5;371;376
8;Barcelona;13;Barcelonès;08019;Barcelona;7;38;U;;745;207;430;506;239;0;8;498;506
8;Barcelona;13;Barcelonès;08019;Barcelona;7;39;U;;635;159;546;438;197;1;4;433;437
8;Barcelona;13;Barcelonès;08019;Barcelona;7;4;U;;894;275;461;579;315;0;3;576;579
8;Barcelona;13;Barcelonès;08019;Barcelona;7;40;U;;586;171;333;415;171;0;6;409;415
8;Barcelona;13;Barcelonès;08019;Barcelona;7;41;U;;526;163;333;350;176;0;3;347;350
8;Barcelona;13;Barcelonès;08019;Barcelona;7;42;U;;535;176;289;359;176;0;9;350;359
8;Barcelona;13;Barcelonès;08019;Barcelona;7;43;U;;833;267;481;575;258;1;7;567;574
8;Barcelona;13;Barcelonès;08019;Barcelona;7;44;U;;689;228;443;522;167;0;9;513;522
8;Barcelona;13;Barcelonès;08019;Barcelona;7;45;U;;890;303;525;633;257;1;4;628;632
8;Barcelona;13;Barcelonès;08019;Barcelona;7;47;U;;823;265;470;544;279;0;3;541;544
8;Barcelona;13;Barcelonès;08019;Barcelona;7;48;U;;560;156;315;370;190;0;7;363;370
8;Barcelona;13;Barcelonès;08019;Barcelona;7;49;U;;513;150;301;366;147;3;3;360;363
8;Barcelona;13;Barcelonès;08019;Barcelona;7;50;U;;687;178;378;437;250;0;6;431;437
8;Barcelona;13;Barcelonès;08019;Barcelona;7;51;U;;906;266;523;642;264;5;11;626;637
8;Barcelona;13;Barcelonès;08019;Barcelona;7;52;U;;596;173;308;382;214;0;2;380;382
8;Barcelona;13;Barcelonès;08019;Barcelona;7;53;U;;595;131;292;371;224;0;3;368;371
8;Barcelona;13;Barcelonès;08019;Barcelona;7;54;U;;589;196;335;427;162;0;4;423;427
8;Barcelona;13;Barcelonès;08019;Barcelona;7;55;U;;945;271;545;659;286;2;6;651;657
8;Barcelona;13;Barcelonès;08019;Barcelona;7;56;U;;607;181;328;401;206;1;4;396;400
8;Barcelona;13;Barcelonès;08019;Barcelona;7;57;A;;595;171;322;405;190;0;9;396;405
8;Barcelona;13;Barcelonès;08019;Barcelona;7;57;B;;569;195;309;401;168;0;7;394;401
8;Barcelona;13;Barcelonès;08019;Barcelona;7;58;U;;733;161;388;493;240;5;7;481;488
8;Barcelona;13;Barcelonès;08019;Barcelona;7;60;U;;830;191;378;501;329;0;14;487;501
8;Barcelona;13;Barcelonès;08019;Barcelona;7;61;U;;511;156;282;349;162;1;5;343;348
8;Barcelona;13;Barcelonès;08019;Barcelona;7;62;U;;944;284;513;622;322;2;7;613;620
8;Barcelona;13;Barcelonès;08019;Barcelona;7;64;U;;597;173;342;409;188;0;5;404;409
8;Barcelona;13;Barcelonès;08019;Barcelona;7;65;U;;970;297;525;620;350;2;6;612;618
8;Barcelona;13;Barcelonès;08019;Barcelona;7;66;U;;570;177;275;331;239;1;3;327;330
8;Barcelona;13;Barcelonès;08019;Barcelona;7;67;U;;621;164;330;403;218;0;8;395;403
8;Barcelona;13;Barcelonès;08019;Barcelona;7;68;U;;605;166;368;442;163;1;4;437;441
8;Barcelona;13;Barcelonès;08019;Barcelona;7;69;U;;511;174;294;340;171;0;1;339;340
8;Barcelona;13;Barcelonès;08019;Barcelona;7;7;U;;623;220;377;461;162;0;3;458;461
8;Barcelona;13;Barcelonès;08019;Barcelona;7;70;U;;600;167;300;391;209;1;7;383;390
8;Barcelona;13;Barcelonès;08019;Barcelona;7;71;U;;634;168;340;429;205;0;9;420;429
8;Barcelona;13;Barcelonès;08019;Barcelona;7;72;A;;794;227;430;555;239;1;8;546;554
8;Barcelona;13;Barcelonès;08019;Barcelona;7;72;B;;932;263;508;637;295;2;9;626;635
8;Barcelona;13;Barcelonès;08019;Barcelona;7;73;U;;863;229;470;602;261;3;2;597;599
8;Barcelona;13;Barcelonès;08019;Barcelona;7;74;U;;733;210;389;481;252;3;7;471;478
8;Barcelona;13;Barcelonès;08019;Barcelona;7;75;U;;913;234;471;576;337;0;10;566;576
8;Barcelona;13;Barcelonès;08019;Barcelona;7;76;U;;842;202;451;563;279;0;13;550;563
8;Barcelona;13;Barcelonès;08019;Barcelona;7;78;A;;722;215;416;502;220;0;6;496;502
8;Barcelona;13;Barcelonès;08019;Barcelona;7;78;B;;823;242;453;546;277;3;3;540;543
8;Barcelona;13;Barcelonès;08019;Barcelona;7;79;A;;599;176;320;392;207;0;0;392;392
8;Barcelona;13;Barcelonès;08019;Barcelona;7;79;B;;664;191;342;440;224;1;5;434;439
8;Barcelona;13;Barcelonès;08019;Barcelona;7;8;A;;689;183;398;484;205;2;8;474;482
8;Barcelona;13;Barcelonès;08019;Barcelona;7;8;B;;729;175;397;507;222;1;6;500;506
8;Barcelona;13;Barcelonès;08019;Barcelona;7;80;U;;703;215;414;492;211;3;10;479;489
8;Barcelona;13;Barcelonès;08019;Barcelona;7;81;U;;973;236;487;659;314;0;9;650;659
8;Barcelona;13;Barcelonès;08019;Barcelona;7;83;U;;599;163;279;346;253;0;3;343;346
8;Barcelona;13;Barcelonès;08019;Barcelona;7;84;U;;973;281;552;676;297;0;4;672;676
8;Barcelona;13;Barcelonès;08019;Barcelona;7;85;U;;906;274;475;634;272;0;5;629;634
8;Barcelona;13;Barcelonès;08019;Barcelona;7;86;U;;903;284;544;675;228;0;2;673;675
8;Barcelona;13;Barcelonès;08019;Barcelona;7;88;U;;962;235;521;653;309;3;15;635;650
8;Barcelona;13;Barcelonès;08019;Barcelona;7;89;U;;1036;268;496;631;405;0;13;618;631
8;Barcelona;13;Barcelonès;08019;Barcelona;7;9;U;;1047;318;561;686;361;0;8;678;686
8;Barcelona;13;Barcelonès;08019;Barcelona;7;91;U;;878;275;459;569;309;0;7;562;569
8;Barcelona;13;Barcelonès;08019;Barcelona;7;92;U;;776;188;336;407;369;1;4;402;406
8;Barcelona;13;Barcelonès;08019;Barcelona;7;93;A;;753;196;378;448;305;1;7;440;447
8;Barcelona;13;Barcelonès;08019;Barcelona;7;93;B;;758;194;391;472;286;0;11;461;472
8;Barcelona;13;Barcelonès;08019;Barcelona;7;93;C;;852;215;409;509;343;4;9;496;505
8;Barcelona;13;Barcelonès;08019;Barcelona;7;94;U;;796;177;339;418;378;1;4;413;417
8;Barcelona;13;Barcelonès;08019;Barcelona;7;95;U;;486;118;224;281;205;0;4;277;281
8;Barcelona;13;Barcelonès;08019;Barcelona;7;96;U;;853;204;389;472;381;2;1;469;470
8;Barcelona;13;Barcelonès;08019;Barcelona;7;97;U;;783;188;360;435;348;0;7;428;435
8;Barcelona;13;Barcelonès;08019;Barcelona;7;98;U;;919;232;457;568;351;0;7;561;568
8;Barcelona;13;Barcelonès;08019;Barcelona;8;1;U;;1112;332;689;744;368;1;9;734;743
8;Barcelona;13;Barcelonès;08019;Barcelona;8;10;U;;932;233;478;592;340;5;1;586;587
8;Barcelona;13;Barcelonès;08019;Barcelona;8;100;U;;895;260;452;549;346;1;3;545;548
8;Barcelona;13;Barcelonès;08019;Barcelona;8;101;U;;993;315;561;644;349;0;2;642;644
8;Barcelona;13;Barcelonès;08019;Barcelona;8;102;U;;675;185;308;369;306;1;2;366;368
8;Barcelona;13;Barcelonès;08019;Barcelona;8;103;U;;949;306;531;607;342;8;4;595;599
8;Barcelona;13;Barcelonès;08019;Barcelona;8;104;U;;833;242;369;433;400;0;4;429;433
8;Barcelona;13;Barcelonès;08019;Barcelona;8;107;U;;993;245;449;598;395;0;7;591;598
8;Barcelona;13;Barcelonès;08019;Barcelona;8;108;U;;858;217;394;476;382;0;6;470;476
8;Barcelona;13;Barcelonès;08019;Barcelona;8;109;U;;727;210;361;429;298;2;6;421;427
8;Barcelona;13;Barcelonès;08019;Barcelona;8;11;U;;885;224;484;585;300;1;3;581;584
8;Barcelona;13;Barcelonès;08019;Barcelona;8;111;U;;653;155;293;361;292;3;2;356;358
8;Barcelona;13;Barcelonès;08019;Barcelona;8;112;U;;670;141;296;375;295;1;4;370;374
8;Barcelona;13;Barcelonès;08019;Barcelona;8;113;U;;919;205;419;538;381;0;6;532;538
8;Barcelona;13;Barcelonès;08019;Barcelona;8;114;U;;986;221;495;598;388;3;7;588;595
8;Barcelona;13;Barcelonès;08019;Barcelona;8;115;U;;946;263;491;585;361;0;9;576;585
8;Barcelona;13;Barcelonès;08019;Barcelona;8;116;A;;568;139;280;347;221;0;6;341;347
8;Barcelona;13;Barcelonès;08019;Barcelona;8;116;B;;592;136;303;370;222;0;4;366;370
8;Barcelona;13;Barcelonès;08019;Barcelona;8;117;U;;667;190;349;431;236;0;5;426;431
8;Barcelona;13;Barcelonès;08019;Barcelona;8;119;U;;1000;237;443;580;420;0;5;575;580
8;Barcelona;13;Barcelonès;08019;Barcelona;8;12;U;;695;179;338;436;259;0;1;435;436
8;Barcelona;13;Barcelonès;08019;Barcelona;8;121;U;;657;156;290;373;284;3;3;367;370
8;Barcelona;13;Barcelonès;08019;Barcelona;8;122;U;;1029;256;490;616;413;1;4;611;615
8;Barcelona;13;Barcelonès;08019;Barcelona;8;123;U;;558;136;248;323;235;0;3;320;323
8;Barcelona;13;Barcelonès;08019;Barcelona;8;124;U;;979;260;400;449;530;0;0;449;449
8;Barcelona;13;Barcelonès;08019;Barcelona;8;126;U;;602;156;260;322;280;1;0;321;321
8;Barcelona;13;Barcelonès;08019;Barcelona;8;127;U;;832;228;404;492;340;1;3;488;491
8;Barcelona;13;Barcelonès;08019;Barcelona;8;128;U;;556;160;281;336;220;0;3;333;336
8;Barcelona;13;Barcelonès;08019;Barcelona;8;129;U;;1041;337;624;612;429;0;6;606;612
8;Barcelona;13;Barcelonès;08019;Barcelona;8;13;U;;922;291;491;612;310;0;7;605;612
8;Barcelona;13;Barcelonès;08019;Barcelona;8;131;U;;621;170;285;369;252;0;3;366;369
8;Barcelona;13;Barcelonès;08019;Barcelona;8;132;U;;526;127;229;301;225;4;1;296;297
8;Barcelona;13;Barcelonès;08019;Barcelona;8;133;U;;705;178;346;434;271;3;6;425;431
8;Barcelona;13;Barcelonès;08019;Barcelona;8;134;U;;534;181;290;340;194;0;6;334;340
8;Barcelona;13;Barcelonès;08019;Barcelona;8;135;A;;569;172;305;377;192;0;4;373;377
8;Barcelona;13;Barcelonès;08019;Barcelona;8;135;B;;641;163;321;399;242;0;4;395;399
8;Barcelona;13;Barcelonès;08019;Barcelona;8;136;U;;704;144;332;417;287;2;7;408;415
8;Barcelona;13;Barcelonès;08019;Barcelona;8;138;U;;878;229;419;547;331;0;8;539;547
8;Barcelona;13;Barcelonès;08019;Barcelona;8;14;U;;696;264;402;490;206;0;2;488;490
8;Barcelona;13;Barcelonès;08019;Barcelona;8;140;A;;619;172;307;385;234;1;8;376;384
8;Barcelona;13;Barcelonès;08019;Barcelona;8;140;B;;642;183;312;400;242;1;5;394;399
8;Barcelona;13;Barcelonès;08019;Barcelona;8;141;U;;953;277;500;621;332;0;7;614;621
8;Barcelona;13;Barcelonès;08019;Barcelona;8;142;A;;706;178;352;437;269;0;3;434;437
8;Barcelona;13;Barcelonès;08019;Barcelona;8;142;B;;840;198;381;507;333;0;15;492;507
8;Barcelona;13;Barcelonès;08019;Barcelona;8;143;A;;498;167;284;337;161;0;5;332;337
8;Barcelona;13;Barcelonès;08019;Barcelona;8;143;B;;682;207;388;461;221;1;4;456;460
8;Barcelona;13;Barcelonès;08019;Barcelona;8;144;A;;536;143;263;322;214;1;2;319;321
8;Barcelona;13;Barcelonès;08019;Barcelona;8;144;B;;630;180;302;364;266;0;6;358;364
8;Barcelona;13;Barcelonès;08019;Barcelona;8;145;U;;617;142;257;323;294;0;4;319;323
8;Barcelona;13;Barcelonès;08019;Barcelona;8;146;U;;493;137;241;303;190;1;6;296;302
8;Barcelona;13;Barcelonès;08019;Barcelona;8;147;U;;667;161;304;379;288;3;4;372;376
8;Barcelona;13;Barcelonès;08019;Barcelona;8;148;U;;526;116;227;291;235;2;2;287;289
8;Barcelona;13;Barcelonès;08019;Barcelona;8;149;U;;678;185;334;424;254;1;6;417;423
8;Barcelona;13;Barcelonès;08019;Barcelona;8;15;U;;919;254;477;621;298;1;7;613;620
8;Barcelona;13;Barcelonès;08019;Barcelona;8;150;U;;795;207;376;469;326;0;13;456;469
8;Barcelona;13;Barcelonès;08019;Barcelona;8;151;U;;710;155;299;402;308;1;5;396;401
8;Barcelona;13;Barcelonès;08019;Barcelona;8;152;U;;1078;264;515;610;468;0;10;600;610
8;Barcelona;13;Barcelonès;08019;Barcelona;8;153;U;;601;155;300;371;230;1;2;368;370
8;Barcelona;13;Barcelonès;08019;Barcelona;8;154;U;;689;188;355;423;266;1;5;417;422
8;Barcelona;13;Barcelonès;08019;Barcelona;8;155;U;;755;183;338;445;310;6;0;439;439
8;Barcelona;13;Barcelonès;08019;Barcelona;8;156;A;;537;154;259;309;228;1;0;308;308
8;Barcelona;13;Barcelonès;08019;Barcelona;8;156;B;;607;185;287;345;262;1;5;339;344
8;Barcelona;13;Barcelonès;08019;Barcelona;8;158;U;;972;322;462;520;452;0;5;515;520
8;Barcelona;13;Barcelonès;08019;Barcelona;8;160;U;;896;263;448;529;367;3;6;520;526
8;Barcelona;13;Barcelonès;08019;Barcelona;8;161;U;;775;238;378;442;333;1;3;438;441
8;Barcelona;13;Barcelonès;08019;Barcelona;8;162;U;;743;208;361;384;359;0;0;384;384
8;Barcelona;13;Barcelonès;08019;Barcelona;8;163;A;;514;138;239;265;249;0;3;262;265
8;Barcelona;13;Barcelonès;08019;Barcelona;8;163;B;;678;173;316;352;326;0;0;352;352
8;Barcelona;13;Barcelonès;08019;Barcelona;8;164;U;;634;178;284;327;307;1;6;320;326
8;Barcelona;13;Barcelonès;08019;Barcelona;8;166;U;;881;234;391;464;417;1;4;459;463
8;Barcelona;13;Barcelonès;08019;Barcelona;8;167;U;;790;180;333;435;355;1;2;432;434
8;Barcelona;13;Barcelonès;08019;Barcelona;8;168;U;;843;205;384;504;339;0;9;495;504
8;Barcelona;13;Barcelonès;08019;Barcelona;8;17;U;;575;137;276;365;210;0;4;361;365
8;Barcelona;13;Barcelonès;08019;Barcelona;8;170;U;;632;174;309;382;250;0;4;378;382
8;Barcelona;13;Barcelonès;08019;Barcelona;8;171;U;;941;229;431;519;422;0;8;511;519
8;Barcelona;13;Barcelonès;08019;Barcelona;8;172;U;;699;186;322;379;320;1;2;376;378
8;Barcelona;13;Barcelonès;08019;Barcelona;8;173;U;;990;270;528;657;333;1;5;651;656
8;Barcelona;13;Barcelonès;08019;Barcelona;8;174;U;;1019;277;503;606;413;11;2;593;595
8;Barcelona;13;Barcelonès;08019;Barcelona;8;176;U;;756;256;391;440;316;2;5;433;438
8;Barcelona;13;Barcelonès;08019;Barcelona;8;178;U;;803;231;401;510;293;0;7;503;510
8;Barcelona;13;Barcelonès;08019;Barcelona;8;18;U;;1101;320;634;779;322;0;15;764;779
8;Barcelona;13;Barcelonès;08019;Barcelona;8;180;U;;621;136;290;370;251;0;8;362;370
8;Barcelona;13;Barcelonès;08019;Barcelona;8;181;U;;696;158;284;371;325;0;2;369;371
8;Barcelona;13;Barcelonès;08019;Barcelona;8;182;U;;561;150;269;320;241;2;4;314;318
8;Barcelona;13;Barcelonès;08019;Barcelona;8;183;U;;832;175;360;454;378;0;4;450;454
8;Barcelona;13;Barcelonès;08019;Barcelona;8;184;U;;734;189;349;410;324;4;6;400;406
8;Barcelona;13;Barcelonès;08019;Barcelona;8;185;U;;759;181;331;394;365;0;1;393;394
8;Barcelona;13;Barcelonès;08019;Barcelona;8;186;U;;898;182;349;425;473;1;6;418;424
8;Barcelona;13;Barcelonès;08019;Barcelona;8;187;U;;567;135;231;273;294;0;3;270;273
8;Barcelona;13;Barcelonès;08019;Barcelona;8;188;U;;597;115;239;302;295;1;5;296;301
8;Barcelona;13;Barcelonès;08019;Barcelona;8;189;A;;513;139;242;296;217;0;2;294;296
8;Barcelona;13;Barcelonès;08019;Barcelona;8;189;B;;646;167;294;341;305;1;6;334;340
8;Barcelona;13;Barcelonès;08019;Barcelona;8;19;A;;539;128;293;385;154;1;4;380;384
8;Barcelona;13;Barcelonès;08019;Barcelona;8;19;B;;644;154;368;472;172;0;1;471;472
8;Barcelona;13;Barcelonès;08019;Barcelona;8;190;A;;543;104;234;320;223;2;1;317;318
8;Barcelona;13;Barcelonès;08019;Barcelona;8;190;B;;594;116;247;334;260;1;7;326;333
8;Barcelona;13;Barcelonès;08019;Barcelona;8;191;A;;661;151;301;362;299;0;8;354;362
8;Barcelona;13;Barcelonès;08019;Barcelona;8;191;B;;726;145;311;395;331;2;2;391;393
8;Barcelona;13;Barcelonès;08019;Barcelona;8;192;U;;625;129;280;336;289;0;4;332;336
8;Barcelona;13;Barcelonès;08019;Barcelona;8;193;A;;833;210;385;453;380;1;6;446;452
8;Barcelona;13;Barcelonès;08019;Barcelona;8;193;B;;952;229;390;472;480;1;2;469;471
8;Barcelona;13;Barcelonès;08019;Barcelona;8;194;U;;476;82;196;240;236;0;0;240;240
8;Barcelona;13;Barcelonès;08019;Barcelona;8;195;U;;670;133;265;316;354;0;4;312;316
8;Barcelona;13;Barcelonès;08019;Barcelona;8;196;U;;703;106;217;274;429;1;0;273;273
8;Barcelona;13;Barcelonès;08019;Barcelona;8;197;U;;1025;211;412;496;529;5;1;490;491
8;Barcelona;13;Barcelonès;08019;Barcelona;8;198;U;;596;107;233;279;317;0;5;274;279
8;Barcelona;13;Barcelonès;08019;Barcelona;8;2;U;;717;240;409;459;258;1;7;451;458
8;Barcelona;13;Barcelonès;08019;Barcelona;8;20;U;;1018;308;631;660;358;0;16;644;660
8;Barcelona;13;Barcelonès;08019;Barcelona;8;200;U;;894;176;371;443;451;0;5;438;443
8;Barcelona;13;Barcelonès;08019;Barcelona;8;201;U;;526;125;235;267;259;0;6;261;267
8;Barcelona;13;Barcelonès;08019;Barcelona;8;202;U;;990;218;395;498;492;0;5;493;498
8;Barcelona;13;Barcelonès;08019;Barcelona;8;203;U;;1104;215;459;543;561;2;7;534;541
8;Barcelona;13;Barcelonès;08019;Barcelona;8;205;A;;575;124;234;284;291;0;5;279;284
8;Barcelona;13;Barcelonès;08019;Barcelona;8;205;B;;563;109;259;305;258;0;8;297;305
8;Barcelona;13;Barcelonès;08019;Barcelona;8;207;U;;566;131;252;320;246;0;6;314;320
8;Barcelona;13;Barcelonès;08019;Barcelona;8;208;U;;941;226;467;557;384;0;7;550;557
8;Barcelona;13;Barcelonès;08019;Barcelona;8;209;A;;624;147;281;337;287;1;1;335;336
8;Barcelona;13;Barcelonès;08019;Barcelona;8;209;B;;752;184;382;455;297;1;1;453;454
8;Barcelona;13;Barcelonès;08019;Barcelona;8;21;U;;855;262;450;561;294;0;11;550;561
8;Barcelona;13;Barcelonès;08019;Barcelona;8;211;U;;770;137;262;303;467;1;4;298;302
8;Barcelona;13;Barcelonès;08019;Barcelona;8;213;A;;814;218;429;527;287;0;6;521;527
8;Barcelona;13;Barcelonès;08019;Barcelona;8;213;B;;883;231;452;550;333;0;5;545;550
8;Barcelona;13;Barcelonès;08019;Barcelona;8;214;A;;574;101;265;343;231;1;6;336;342
8;Barcelona;13;Barcelonès;08019;Barcelona;8;214;B;;626;118;300;384;242;0;0;384;384
8;Barcelona;13;Barcelonès;08019;Barcelona;8;22;U;;613;166;319;409;204;2;3;404;407
8;Barcelona;13;Barcelonès;08019;Barcelona;8;24;U;;863;212;437;547;316;4;5;538;543
8;Barcelona;13;Barcelonès;08019;Barcelona;8;27;U;;849;226;475;578;271;1;5;572;577
8;Barcelona;13;Barcelonès;08019;Barcelona;8;28;A;;594;173;323;399;195;1;7;391;398
8;Barcelona;13;Barcelonès;08019;Barcelona;8;28;B;;710;212;396;482;228;0;5;477;482
8;Barcelona;13;Barcelonès;08019;Barcelona;8;29;U;;759;233;405;496;263;4;8;484;492
8;Barcelona;13;Barcelonès;08019;Barcelona;8;3;A;;601;192;339;413;188;0;4;409;413
8;Barcelona;13;Barcelonès;08019;Barcelona;8;3;B;;620;176;342;412;208;1;2;409;411
8;Barcelona;13;Barcelonès;08019;Barcelona;8;30;A;;606;202;338;418;188;0;5;413;418
8;Barcelona;13;Barcelonès;08019;Barcelona;8;30;B;;599;183;337;403;196;2;4;397;401
8;Barcelona;13;Barcelonès;08019;Barcelona;8;33;U;;831;200;418;527;304;0;8;519;527
8;Barcelona;13;Barcelonès;08019;Barcelona;8;34;U;;965;314;527;652;313;0;5;647;652
8;Barcelona;13;Barcelonès;08019;Barcelona;8;36;U;;473;153;275;339;134;1;0;338;338
8;Barcelona;13;Barcelonès;08019;Barcelona;8;37;U;;538;158;303;383;155;0;4;379;383
8;Barcelona;13;Barcelonès;08019;Barcelona;8;39;U;;576;208;321;377;199;0;9;368;377
8;Barcelona;13;Barcelonès;08019;Barcelona;8;40;U;;592;183;337;414;178;0;7;407;414
8;Barcelona;13;Barcelonès;08019;Barcelona;8;41;U;;632;165;324;410;222;0;4;406;410
8;Barcelona;13;Barcelonès;08019;Barcelona;8;42;U;;663;145;318;405;258;0;3;402;405
8;Barcelona;13;Barcelonès;08019;Barcelona;8;43;U;;559;152;309;366;193;0;2;364;366
8;Barcelona;13;Barcelonès;08019;Barcelona;8;44;A;;532;147;275;348;184;0;6;342;348
8;Barcelona;13;Barcelonès;08019;Barcelona;8;44;B;;608;147;321;406;202;2;1;403;404
8;Barcelona;13;Barcelonès;08019;Barcelona;8;45;U;;548;145;285;344;204;0;2;342;344
8;Barcelona;13;Barcelonès;08019;Barcelona;8;46;U;;510;76;158;190;320;1;1;188;189
8;Barcelona;13;Barcelonès;08019;Barcelona;8;47;U;;710;184;361;462;248;0;6;456;462
8;Barcelona;13;Barcelonès;08019;Barcelona;8;48;U;;689;148;313;414;275;2;3;409;412
8;Barcelona;13;Barcelonès;08019;Barcelona;8;49;U;;978;210;480;602;376;16;14;572;586
8;Barcelona;13;Barcelonès;08019;Barcelona;8;5;U;;883;244;485;595;288;0;10;585;595
8;Barcelona;13;Barcelonès;08019;Barcelona;8;50;U;;613;128;265;332;281;0;4;328;332
8;Barcelona;13;Barcelonès;08019;Barcelona;8;51;U;;822;188;433;540;282;1;6;533;539
8;Barcelona;13;Barcelonès;08019;Barcelona;8;52;U;;774;161;341;437;337;0;5;432;437
8;Barcelona;13;Barcelonès;08019;Barcelona;8;53;U;;1057;274;546;680;377;0;4;676;680
8;Barcelona;13;Barcelonès;08019;Barcelona;8;54;U;;611;157;303;371;240;0;2;369;371
8;Barcelona;13;Barcelonès;08019;Barcelona;8;55;U;;516;142;269;317;199;1;1;315;316
8;Barcelona;13;Barcelonès;08019;Barcelona;8;56;A;;528;138;283;343;185;0;4;339;343
8;Barcelona;13;Barcelonès;08019;Barcelona;8;56;B;;628;185;314;388;240;2;1;385;386
8;Barcelona;13;Barcelonès;08019;Barcelona;8;57;U;;1025;211;483;614;411;0;4;610;614
8;Barcelona;13;Barcelonès;08019;Barcelona;8;58;U;;1048;257;473;554;494;0;8;546;554
8;Barcelona;13;Barcelonès;08019;Barcelona;8;6;U;;931;231;482;617;314;1;8;608;616
8;Barcelona;13;Barcelonès;08019;Barcelona;8;60;U;;1121;283;544;675;446;5;2;668;670
8;Barcelona;13;Barcelonès;08019;Barcelona;8;62;U;;509;151;291;335;174;0;2;333;335
8;Barcelona;13;Barcelonès;08019;Barcelona;8;63;U;;667;202;379;460;207;0;7;453;460
8;Barcelona;13;Barcelonès;08019;Barcelona;8;64;U;;569;154;309;392;177;1;3;388;391
8;Barcelona;13;Barcelonès;08019;Barcelona;8;65;U;;939;248;458;574;365;2;10;562;572
8;Barcelona;13;Barcelonès;08019;Barcelona;8;66;U;;660;200;339;376;284;0;5;371;376
8;Barcelona;13;Barcelonès;08019;Barcelona;8;67;U;;756;218;360;411;345;0;8;403;411
8;Barcelona;13;Barcelonès;08019;Barcelona;8;68;U;;862;251;446;531;331;1;6;524;530
8;Barcelona;13;Barcelonès;08019;Barcelona;8;69;U;;663;200;353;397;266;0;5;392;397
8;Barcelona;13;Barcelonès;08019;Barcelona;8;7;U;;818;210;450;546;272;1;7;538;545
8;Barcelona;13;Barcelonès;08019;Barcelona;8;70;U;;631;202;329;376;255;0;1;375;376
8;Barcelona;13;Barcelonès;08019;Barcelona;8;71;U;;920;261;478;599;321;3;6;590;596
8;Barcelona;13;Barcelonès;08019;Barcelona;8;72;U;;604;153;314;392;212;0;3;389;392
8;Barcelona;13;Barcelonès;08019;Barcelona;8;73;U;;785;248;416;488;297;1;3;484;487
8;Barcelona;13;Barcelonès;08019;Barcelona;8;74;U;;849;215;477;587;262;4;3;580;583
8;Barcelona;13;Barcelonès;08019;Barcelona;8;76;U;;639;188;324;395;244;0;4;391;395
8;Barcelona;13;Barcelonès;08019;Barcelona;8;77;A;;628;193;361;405;223;1;2;402;404
8;Barcelona;13;Barcelonès;08019;Barcelona;8;77;B;;662;166;328;397;265;0;0;397;397
8;Barcelona;13;Barcelonès;08019;Barcelona;8;8;A;;727;210;367;470;257;1;4;465;469
8;Barcelona;13;Barcelonès;08019;Barcelona;8;8;B;;780;176;385;492;288;1;6;485;491
8;Barcelona;13;Barcelonès;08019;Barcelona;8;80;U;;491;143;256;319;172;0;0;319;319
8;Barcelona;13;Barcelonès;08019;Barcelona;8;81;U;;983;261;489;590;393;0;6;584;590
8;Barcelona;13;Barcelonès;08019;Barcelona;8;82;U;;570;184;325;379;191;1;4;374;378
8;Barcelona;13;Barcelonès;08019;Barcelona;8;83;U;;619;182;340;381;238;0;6;375;381
8;Barcelona;13;Barcelonès;08019;Barcelona;8;84;A;;619;180;330;407;212;1;9;397;406
8;Barcelona;13;Barcelonès;08019;Barcelona;8;84;B;;684;201;363;447;237;2;3;442;445
8;Barcelona;13;Barcelonès;08019;Barcelona;8;85;U;;899;226;411;504;395;0;4;500;504
8;Barcelona;13;Barcelonès;08019;Barcelona;8;86;A;;550;150;236;275;275;0;6;269;275
8;Barcelona;13;Barcelonès;08019;Barcelona;8;86;B;;636;184;290;337;299;1;2;334;336
8;Barcelona;13;Barcelonès;08019;Barcelona;8;88;U;;738;153;361;471;267;0;3;468;471
8;Barcelona;13;Barcelonès;08019;Barcelona;8;89;U;;994;238;487;625;369;0;7;618;625
8;Barcelona;13;Barcelonès;08019;Barcelona;8;90;A;;581;145;298;392;189;0;5;387;392
8;Barcelona;13;Barcelonès;08019;Barcelona;8;90;B;;640;178;339;425;215;3;3;419;422
8;Barcelona;13;Barcelonès;08019;Barcelona;8;91;A;;856;190;418;543;313;3;9;531;540
8;Barcelona;13;Barcelonès;08019;Barcelona;8;91;B;;877;209;451;550;327;0;3;547;550
8;Barcelona;13;Barcelonès;08019;Barcelona;8;91;C;;820;197;408;517;303;0;8;509;517
8;Barcelona;13;Barcelonès;08019;Barcelona;8;92;A;;865;205;444;541;324;4;6;531;537
8;Barcelona;13;Barcelonès;08019;Barcelona;8;92;B;;1050;238;508;642;408;2;7;633;640
8;Barcelona;13;Barcelonès;08019;Barcelona;8;93;A;;861;167;455;564;297;1;9;554;563
8;Barcelona;13;Barcelonès;08019;Barcelona;8;93;B;;1031;229;518;687;344;8;2;677;679
8;Barcelona;13;Barcelonès;08019;Barcelona;8;94;U;;525;171;310;380;145;0;1;379;380
8;Barcelona;13;Barcelonès;08019;Barcelona;8;95;U;;721;244;441;520;201;0;5;515;520
8;Barcelona;13;Barcelonès;08019;Barcelona;8;96;U;;935;256;480;553;382;3;3;547;550
8;Barcelona;13;Barcelonès;08019;Barcelona;8;97;U;;958;291;548;634;324;3;6;625;631
8;Barcelona;13;Barcelonès;08019;Barcelona;8;98;U;;710;188;368;420;290;3;3;414;417
8;Barcelona;13;Barcelonès;08019;Barcelona;8;99;U;;468;161;251;296;172;0;3;293;296
8;Barcelona;13;Barcelonès;08019;Barcelona;9;10;U;;551;144;291;362;189;2;0;360;360
8;Barcelona;13;Barcelonès;08019;Barcelona;9;100;A;;605;148;279;358;247;0;3;355;358
8;Barcelona;13;Barcelonès;08019;Barcelona;9;100;B;;716;180;324;427;289;0;10;417;427
8;Barcelona;13;Barcelonès;08019;Barcelona;9;102;A;;697;175;367;445;252;4;3;438;441
8;Barcelona;13;Barcelonès;08019;Barcelona;9;102;B;;718;197;373;469;249;0;8;461;469
8;Barcelona;13;Barcelonès;08019;Barcelona;9;103;A;;705;173;326;399;306;0;6;393;399
8;Barcelona;13;Barcelonès;08019;Barcelona;9;103;B;;811;195;369;461;350;1;2;458;460
8;Barcelona;13;Barcelonès;08019;Barcelona;9;103;C;;767;176;369;440;327;0;2;438;440
8;Barcelona;13;Barcelonès;08019;Barcelona;9;104;U;;674;156;336;413;261;1;6;406;412
8;Barcelona;13;Barcelonès;08019;Barcelona;9;105;U;;516;144;267;318;198;2;4;312;316
8;Barcelona;13;Barcelonès;08019;Barcelona;9;106;U;;809;201;417;523;286;1;7;515;522
8;Barcelona;13;Barcelonès;08019;Barcelona;9;107;U;;833;245;456;540;293;1;1;538;539
8;Barcelona;13;Barcelonès;08019;Barcelona;9;108;U;;1027;280;545;634;393;3;12;619;631
8;Barcelona;13;Barcelonès;08019;Barcelona;9;109;U;;995;270;514;657;338;0;5;652;657
8;Barcelona;13;Barcelonès;08019;Barcelona;9;11;U;;579;186;329;423;156;0;1;422;423
8;Barcelona;13;Barcelonès;08019;Barcelona;9;110;A;;599;170;315;409;190;1;0;408;408
8;Barcelona;13;Barcelonès;08019;Barcelona;9;110;B;;610;175;314;403;207;0;6;397;403
8;Barcelona;13;Barcelonès;08019;Barcelona;9;111;U;;720;220;414;483;237;1;4;478;482
8;Barcelona;13;Barcelonès;08019;Barcelona;9;112;U;;572;155;303;370;202;4;1;365;366
8;Barcelona;13;Barcelonès;08019;Barcelona;9;113;U;;1099;266;519;708;391;1;5;702;707
8;Barcelona;13;Barcelonès;08019;Barcelona;9;114;U;;1124;271;594;741;383;1;8;732;740
8;Barcelona;13;Barcelonès;08019;Barcelona;9;115;U;;983;237;484;632;351;2;2;628;630
8;Barcelona;13;Barcelonès;08019;Barcelona;9;116;U;;502;137;305;377;125;2;2;373;375
8;Barcelona;13;Barcelonès;08019;Barcelona;9;118;A;;501;152;286;345;156;1;3;341;344
8;Barcelona;13;Barcelonès;08019;Barcelona;9;118;B;;650;170;329;425;225;0;6;419;425
8;Barcelona;13;Barcelonès;08019;Barcelona;9;119;U;;565;159;292;360;205;0;2;358;360
8;Barcelona;13;Barcelonès;08019;Barcelona;9;12;U;;585;140;290;379;206;0;2;377;379
8;Barcelona;13;Barcelonès;08019;Barcelona;9;120;U;;989;188;443;580;409;0;8;572;580
8;Barcelona;13;Barcelonès;08019;Barcelona;9;121;U;;877;220;437;510;367;3;5;502;507
8;Barcelona;13;Barcelonès;08019;Barcelona;9;122;U;;643;199;349;428;215;0;4;424;428
8;Barcelona;13;Barcelonès;08019;Barcelona;9;123;U;;699;196;381;485;214;0;8;477;485
8;Barcelona;13;Barcelonès;08019;Barcelona;9;124;U;;610;160;323;409;201;0;1;408;409
8;Barcelona;13;Barcelonès;08019;Barcelona;9;125;U;;784;204;444;569;215;0;8;561;569
8;Barcelona;13;Barcelonès;08019;Barcelona;9;126;A;;550;160;313;404;146;0;3;401;404
8;Barcelona;13;Barcelonès;08019;Barcelona;9;126;B;;653;177;352;440;213;3;8;429;437
8;Barcelona;13;Barcelonès;08019;Barcelona;9;128;U;;806;212;365;453;353;2;3;448;451
8;Barcelona;13;Barcelonès;08019;Barcelona;9;129;U;;638;138;302;366;272;1;4;361;365
8;Barcelona;13;Barcelonès;08019;Barcelona;9;13;U;;1133;292;647;802;331;8;6;788;794
8;Barcelona;13;Barcelonès;08019;Barcelona;9;130;U;;579;143;284;354;225;1;2;351;353
8;Barcelona;13;Barcelonès;08019;Barcelona;9;131;U;;513;114;269;326;187;0;1;325;326
8;Barcelona;13;Barcelonès;08019;Barcelona;9;132;A;;521;109;224;276;245;1;0;275;275
8;Barcelona;13;Barcelonès;08019;Barcelona;9;132;B;;656;183;316;383;273;3;0;380;380
8;Barcelona;13;Barcelonès;08019;Barcelona;9;133;U;;769;211;371;436;333;0;3;433;436
8;Barcelona;13;Barcelonès;08019;Barcelona;9;134;U;;792;148;356;466;326;1;3;462;465
8;Barcelona;13;Barcelonès;08019;Barcelona;9;136;U;;1095;277;513;655;440;1;7;647;654
8;Barcelona;13;Barcelonès;08019;Barcelona;9;137;U;;934;265;430;518;416;6;1;511;512
8;Barcelona;13;Barcelonès;08019;Barcelona;9;139;U;;710;210;370;424;286;2;2;420;422
8;Barcelona;13;Barcelonès;08019;Barcelona;9;14;U;;1017;300;580;698;319;0;4;694;698
8;Barcelona;13;Barcelonès;08019;Barcelona;9;140;U;;962;203;402;525;437;1;5;519;524
8;Barcelona;13;Barcelonès;08019;Barcelona;9;142;U;;859;205;410;473;386;0;0;473;473
8;Barcelona;13;Barcelonès;08019;Barcelona;9;144;U;;1034;209;401;507;527;0;8;499;507
8;Barcelona;13;Barcelonès;08019;Barcelona;9;145;U;;626;145;302;369;257;1;4;364;368
8;Barcelona;13;Barcelonès;08019;Barcelona;9;146;U;;782;160;330;424;358;2;1;421;422
8;Barcelona;13;Barcelonès;08019;Barcelona;9;147;U;;704;153;316;385;319;1;1;383;384
8;Barcelona;13;Barcelonès;08019;Barcelona;9;148;U;;731;138;303;405;326;1;6;398;404
8;Barcelona;13;Barcelonès;08019;Barcelona;9;149;U;;724;148;324;400;324;0;6;394;400
8;Barcelona;13;Barcelonès;08019;Barcelona;9;15;U;;1096;335;626;758;338;0;8;750;758
8;Barcelona;13;Barcelonès;08019;Barcelona;9;150;U;;1041;177;200;452;589;1;5;446;451
8;Barcelona;13;Barcelonès;08019;Barcelona;9;151;U;;1025;201;488;538;487;0;3;535;538
8;Barcelona;13;Barcelonès;08019;Barcelona;9;153;U;;546;129;249;301;245;0;3;298;301
8;Barcelona;13;Barcelonès;08019;Barcelona;9;154;U;;782;170;314;393;389;1;2;390;392
8;Barcelona;13;Barcelonès;08019;Barcelona;9;17;U;;1098;299;606;753;345;0;10;743;753
8;Barcelona;13;Barcelonès;08019;Barcelona;9;18;U;;642;200;401;474;168;2;4;468;472
8;Barcelona;13;Barcelonès;08019;Barcelona;9;19;U;;897;267;508;646;251;1;6;639;645
8;Barcelona;13;Barcelonès;08019;Barcelona;9;2;A;;688;177;360;458;230;0;2;456;458
8;Barcelona;13;Barcelonès;08019;Barcelona;9;2;B;;817;209;435;546;271;1;4;541;545
8;Barcelona;13;Barcelonès;08019;Barcelona;9;20;U;;811;292;473;552;259;0;7;545;552
8;Barcelona;13;Barcelonès;08019;Barcelona;9;21;U;;900;303;577;671;229;4;10;657;667
8;Barcelona;13;Barcelonès;08019;Barcelona;9;22;U;;626;182;397;463;163;1;5;457;462
8;Barcelona;13;Barcelonès;08019;Barcelona;9;23;U;;752;212;403;501;251;2;9;490;499
8;Barcelona;13;Barcelonès;08019;Barcelona;9;24;U;;474;112;237;296;178;0;4;292;296
8;Barcelona;13;Barcelonès;08019;Barcelona;9;25;U;;939;281;508;645;294;2;4;639;643
8;Barcelona;13;Barcelonès;08019;Barcelona;9;26;A;;854;213;473;593;261;7;1;585;586
8;Barcelona;13;Barcelonès;08019;Barcelona;9;26;B;;942;249;472;616;326;4;1;611;612
8;Barcelona;13;Barcelonès;08019;Barcelona;9;27;U;;961;278;661;677;284;0;4;673;677
8;Barcelona;13;Barcelonès;08019;Barcelona;9;28;U;;722;169;360;476;246;4;1;471;472
8;Barcelona;13;Barcelonès;08019;Barcelona;9;3;A;;662;209;371;457;205;0;3;454;457
8;Barcelona;13;Barcelonès;08019;Barcelona;9;3;B;;662;198;375;466;196;1;3;462;465
8;Barcelona;13;Barcelonès;08019;Barcelona;9;3;C;;710;209;378;473;237;0;3;470;473
8;Barcelona;13;Barcelonès;08019;Barcelona;9;30;A;;738;198;362;475;263;0;1;474;475
8;Barcelona;13;Barcelonès;08019;Barcelona;9;30;B;;866;216;412;540;326;0;9;531;540
8;Barcelona;13;Barcelonès;08019;Barcelona;9;31;U;;850;241;438;554;296;3;5;546;551
8;Barcelona;13;Barcelonès;08019;Barcelona;9;32;U;;794;211;390;487;307;0;5;482;487
8;Barcelona;13;Barcelonès;08019;Barcelona;9;33;U;;788;278;465;547;241;1;2;544;546
8;Barcelona;13;Barcelonès;08019;Barcelona;9;35;U;;604;176;327;418;186;0;0;418;418
8;Barcelona;13;Barcelonès;08019;Barcelona;9;36;U;;522;159;308;367;155;1;6;360;366
8;Barcelona;13;Barcelonès;08019;Barcelona;9;37;A;;622;137;314;402;220;4;5;393;398
8;Barcelona;13;Barcelonès;08019;Barcelona;9;37;B;;602;171;314;386;216;4;6;376;382
8;Barcelona;13;Barcelonès;08019;Barcelona;9;39;A;;858;209;463;589;269;1;7;581;588
8;Barcelona;13;Barcelonès;08019;Barcelona;9;39;B;;869;196;476;586;283;1;5;580;585
8;Barcelona;13;Barcelonès;08019;Barcelona;9;39;C;;928;241;482;616;312;1;5;610;615
8;Barcelona;13;Barcelonès;08019;Barcelona;9;4;A;;553;182;317;382;171;2;7;373;380
8;Barcelona;13;Barcelonès;08019;Barcelona;9;4;B;;645;180;355;458;187;2;1;455;456
8;Barcelona;13;Barcelonès;08019;Barcelona;9;40;U;;1086;266;587;743;343;2;6;735;741
8;Barcelona;13;Barcelonès;08019;Barcelona;9;41;U;;808;238;463;531;277;0;6;525;531
8;Barcelona;13;Barcelonès;08019;Barcelona;9;42;U;;927;273;504;629;298;0;10;619;629
8;Barcelona;13;Barcelonès;08019;Barcelona;9;43;U;;1063;283;555;687;376;3;12;672;684
8;Barcelona;13;Barcelonès;08019;Barcelona;9;44;A;;761;205;355;470;291;2;8;460;468
8;Barcelona;13;Barcelonès;08019;Barcelona;9;44;B;;857;253;433;540;317;8;10;522;532
8;Barcelona;13;Barcelonès;08019;Barcelona;9;45;A;;866;250;458;578;288;0;9;569;578
8;Barcelona;13;Barcelonès;08019;Barcelona;9;45;B;;937;274;510;621;316;1;5;615;620
8;Barcelona;13;Barcelonès;08019;Barcelona;9;46;A;;616;176;297;374;242;0;4;370;374
8;Barcelona;13;Barcelonès;08019;Barcelona;9;46;B;;735;192;351;424;311;0;2;422;424
8;Barcelona;13;Barcelonès;08019;Barcelona;9;47;A;;624;163;290;378;246;2;2;374;376
8;Barcelona;13;Barcelonès;08019;Barcelona;9;47;B;;695;172;329;449;246;0;3;446;449
8;Barcelona;13;Barcelonès;08019;Barcelona;9;48;U;;1079;262;585;748;331;2;4;742;746
8;Barcelona;13;Barcelonès;08019;Barcelona;9;49;U;;806;287;479;541;265;0;2;539;541
8;Barcelona;13;Barcelonès;08019;Barcelona;9;5;A;;567;181;318;390;177;0;0;390;390
8;Barcelona;13;Barcelonès;08019;Barcelona;9;5;B;;574;159;313;386;188;0;4;382;386
8;Barcelona;13;Barcelonès;08019;Barcelona;9;51;U;;980;253;475;616;364;2;13;601;614
8;Barcelona;13;Barcelonès;08019;Barcelona;9;52;U;;866;241;449;562;304;0;4;558;562
8;Barcelona;13;Barcelonès;08019;Barcelona;9;54;U;;574;163;305;389;185;0;0;389;389
8;Barcelona;13;Barcelonès;08019;Barcelona;9;55;U;;964;274;527;642;322;0;14;628;642
8;Barcelona;13;Barcelonès;08019;Barcelona;9;57;U;;609;160;317;396;213;0;2;394;396
8;Barcelona;13;Barcelonès;08019;Barcelona;9;59;U;;890;239;492;598;292;0;5;593;598
8;Barcelona;13;Barcelonès;08019;Barcelona;9;6;A;;572;190;343;417;155;0;14;403;417
8;Barcelona;13;Barcelonès;08019;Barcelona;9;6;B;;601;175;346;438;163;0;9;429;438
8;Barcelona;13;Barcelonès;08019;Barcelona;9;60;A;;637;199;373;453;184;0;6;447;453
8;Barcelona;13;Barcelonès;08019;Barcelona;9;60;B;;670;194;375;452;218;1;2;449;451
8;Barcelona;13;Barcelonès;08019;Barcelona;9;62;U;;569;162;300;384;185;2;13;369;382
8;Barcelona;13;Barcelonès;08019;Barcelona;9;63;U;;695;268;419;488;207;0;4;484;488
8;Barcelona;13;Barcelonès;08019;Barcelona;9;64;U;;1141;398;624;754;387;1;4;749;753
8;Barcelona;13;Barcelonès;08019;Barcelona;9;66;U;;887;304;534;615;272;0;2;613;615
8;Barcelona;13;Barcelonès;08019;Barcelona;9;67;A;;561;202;351;409;152;3;5;401;406
8;Barcelona;13;Barcelonès;08019;Barcelona;9;67;B;;656;222;391;460;196;3;8;449;457
8;Barcelona;13;Barcelonès;08019;Barcelona;9;69;U;;838;261;476;614;224;4;8;602;610
8;Barcelona;13;Barcelonès;08019;Barcelona;9;7;U;;676;204;410;485;191;0;3;482;485
8;Barcelona;13;Barcelonès;08019;Barcelona;9;70;U;;506;130;288;360;146;2;5;353;358
8;Barcelona;13;Barcelonès;08019;Barcelona;9;71;U;;554;176;309;385;169;0;2;383;385
8;Barcelona;13;Barcelonès;08019;Barcelona;9;72;U;;1001;317;600;711;290;4;4;703;707
8;Barcelona;13;Barcelonès;08019;Barcelona;9;73;U;;810;235;497;612;198;2;9;601;610
8;Barcelona;13;Barcelonès;08019;Barcelona;9;74;U;;585;139;275;378;207;0;3;375;378
8;Barcelona;13;Barcelonès;08019;Barcelona;9;75;U;;1015;300;592;697;318;2;6;689;695
8;Barcelona;13;Barcelonès;08019;Barcelona;9;77;U;;960;280;538;686;274;0;5;681;686
8;Barcelona;13;Barcelonès;08019;Barcelona;9;79;U;;890;260;499;622;268;2;6;614;620
8;Barcelona;13;Barcelonès;08019;Barcelona;9;8;U;;491;161;287;341;150;1;4;336;340
8;Barcelona;13;Barcelonès;08019;Barcelona;9;80;U;;485;159;278;336;149;0;2;334;336
8;Barcelona;13;Barcelonès;08019;Barcelona;9;81;U;;841;248;465;582;259;0;9;573;582
8;Barcelona;13;Barcelonès;08019;Barcelona;9;82;U;;999;310;579;701;298;0;8;693;701
8;Barcelona;13;Barcelonès;08019;Barcelona;9;84;U;;1048;331;592;725;323;0;10;715;725
8;Barcelona;13;Barcelonès;08019;Barcelona;9;86;A;;818;213;438;571;247;3;8;560;568
8;Barcelona;13;Barcelonès;08019;Barcelona;9;86;B;;845;232;444;577;268;2;7;568;575
8;Barcelona;13;Barcelonès;08019;Barcelona;9;87;U;;736;200;409;503;233;2;12;489;501
8;Barcelona;13;Barcelonès;08019;Barcelona;9;88;U;;543;153;292;369;174;0;1;368;369
8;Barcelona;13;Barcelonès;08019;Barcelona;9;89;A;;565;158;303;394;171;1;2;391;393
8;Barcelona;13;Barcelonès;08019;Barcelona;9;89;B;;601;172;341;418;183;1;3;414;417
8;Barcelona;13;Barcelonès;08019;Barcelona;9;9;U;;624;172;327;396;228;1;6;389;395
8;Barcelona;13;Barcelonès;08019;Barcelona;9;90;U;;600;162;298;394;206;1;1;392;393
8;Barcelona;13;Barcelonès;08019;Barcelona;9;91;U;;1012;304;590;702;310;1;7;694;701
8;Barcelona;13;Barcelonès;08019;Barcelona;9;92;U;;825;243;445;526;299;1;6;519;525
8;Barcelona;13;Barcelonès;08019;Barcelona;9;94;U;;720;225;384;487;233;1;4;482;486
8;Barcelona;13;Barcelonès;08019;Barcelona;9;95;U;;588;210;332;411;177;0;0;411;411
8;Barcelona;13;Barcelonès;08019;Barcelona;9;96;U;;547;151;294;367;180;0;3;364;367
8;Barcelona;13;Barcelonès;08019;Barcelona;9;97;U;;672;240;443;478;194;0;1;477;478
8;Barcelona;13;Barcelonès;08019;Barcelona;9;98;U;;524;147;300;359;165;1;1;357;358
8;Barcelona;13;Barcelonès;08019;Barcelona;9;99;U;;693;198;389;453;240;3;0;450;450
25;Lleida;23;Noguera;25042;Baronia de Rialb, la;1;1;U;;227;82;126;165;62;1;2;162;164
17;Girona;2;Alt Empordà;17016;Bàscara;1;1;U;;660;230;404;486;174;3;5;478;483
25;Lleida;4;Alt Urgell;25044;Bassella;1;1;U;;310;73;186;232;78;0;0;232;232
43;Tarragona;37;Terra Alta;43022;Batea;1;1;U;;1038;284;596;804;234;2;7;795;802
43;Tarragona;37;Terra Alta;43022;Batea;1;2;U;;655;169;358;484;171;4;5;475;480
25;Lleida;39;Consell General d'Aran;25045;Bausen;1;1;U;;62;23;38;48;14;0;0;48;48
8;Barcelona;11;Baix Llobregat;08020;Begues;1;1;A;;849;254;500;619;230;1;13;605;618
8;Barcelona;11;Baix Llobregat;08020;Begues;1;1;B;;712;202;430;519;193;2;8;509;517
8;Barcelona;11;Baix Llobregat;08020;Begues;1;1;C;;614;163;364;459;155;0;4;455;459
17;Girona;10;Baix Empordà;17013;Begur;1;1;A;;827;211;489;607;220;1;1;605;606
17;Girona;10;Baix Empordà;17013;Begur;1;1;B;;886;252;525;635;251;0;9;626;635
17;Girona;10;Baix Empordà;17013;Begur;1;2;U;;532;104;350;412;120;2;4;406;410
25;Lleida;38;Urgell;25046;Belianes;1;1;U;;493;135;300;362;131;1;1;360;361
25;Lleida;18;Garrigues;25170;Bellaguarda;1;1;U;;316;39;141;202;114;1;1;200;201
17;Girona;10;Baix Empordà;17018;Bellcaire d'Empordà;1;1;U;;426;119;280;327;99;0;2;325;327
25;Lleida;23;Noguera;25047;Bellcaire d'Urgell;1;1;A;;563;139;331;411;152;1;2;408;410
25;Lleida;23;Noguera;25047;Bellcaire d'Urgell;1;1;B;;641;211;400;485;156;3;1;481;482
25;Lleida;27;Pla d'Urgell;25048;Bell-lloc d'Urgell;1;1;U;;750;217;463;578;172;0;5;573;578
25;Lleida;27;Pla d'Urgell;25048;Bell-lloc d'Urgell;1;2;U;;1004;317;612;774;230;6;0;768;768
25;Lleida;23;Noguera;25049;Bellmunt d'Urgell;1;1;U;;191;68;121;139;52;0;1;138;139
43;Tarragona;29;Priorat;43023;Bellmunt del Priorat;1;1;U;;265;94;177;221;44;0;2;219;221
8;Barcelona;6;Anoia;08021;Bellprat;1;1;U;;79;26;45;56;23;1;0;55;55
25;Lleida;38;Urgell;25050;Bellpuig;1;1;U;;1191;226;750;833;358;12;5;816;821
25;Lleida;38;Urgell;25050;Bellpuig;1;2;U;;962;276;567;730;232;7;10;713;723
25;Lleida;38;Urgell;25050;Bellpuig;1;3;U;;1019;302;650;720;299;9;4;707;711
43;Tarragona;12;Baix Penedès;43024;Bellvei;1;1;U;;935;263;613;716;219;1;12;703;715
25;Lleida;15;Cerdanya;25051;Bellver de Cerdanya;1;1;U;;1377;290;735;906;471;2;2;902;904
25;Lleida;27;Pla d'Urgell;25052;Bellvís;1;1;A;;856;192;464;606;250;1;7;598;605
25;Lleida;27;Pla d'Urgell;25052;Bellvís;1;1;B;;810;195;476;611;199;0;5;606;611
25;Lleida;27;Pla d'Urgell;25052;Bellvís;1;1;C;;229;46;125;150;79;0;0;150;150
25;Lleida;33;Segrià;25053;Benavent de Segrià;1;1;U;;617;175;375;433;184;8;8;417;425
43;Tarragona;9;Baix Ebre;43025;Benifallet;1;1;U;;778;199;452;608;170;2;3;603;606
43;Tarragona;30;Ribera d'Ebre;43026;Benissanet;1;1;U;;849;180;463;645;204;1;6;638;644
8;Barcelona;14;Berguedà;08022;Berga;1;1;U;;1203;288;637;856;347;4;7;845;852
8;Barcelona;14;Berguedà;08022;Berga;1;2;U;;1186;360;722;859;327;7;7;845;852
8;Barcelona;14;Berguedà;08022;Berga;1;3;U;;808;245;481;637;171;6;6;625;631
8;Barcelona;14;Berguedà;08022;Berga;1;4;A;;821;220;467;592;229;1;3;588;591
8;Barcelona;14;Berguedà;08022;Berga;1;4;B;;922;235;493;602;320;5;13;584;597
8;Barcelona;14;Berguedà;08022;Berga;1;5;U;;1065;278;624;765;300;4;13;748;761
8;Barcelona;14;Berguedà;08022;Berga;2;1;A;;504;151;251;318;186;0;3;315;318
8;Barcelona;14;Berguedà;08022;Berga;2;1;B;;541;146;262;339;202;1;4;334;338
8;Barcelona;14;Berguedà;08022;Berga;2;2;U;;938;266;485;577;361;3;2;572;574
8;Barcelona;14;Berguedà;08022;Berga;2;3;A;;755;194;397;460;295;1;6;453;459
8;Barcelona;14;Berguedà;08022;Berga;2;3;B;;968;237;509;596;372;0;7;589;596
8;Barcelona;14;Berguedà;08022;Berga;2;4;U;;1250;352;744;878;372;1;9;868;877
8;Barcelona;14;Berguedà;08022;Berga;3;1;A;;283;83;155;178;105;0;1;177;178
8;Barcelona;14;Berguedà;08022;Berga;3;1;B;;312;97;184;248;64;0;3;245;248
8;Barcelona;14;Berguedà;08022;Berga;4;1;U;;453;113;240;307;146;0;2;305;307
17;Girona;19;Garrotxa;17019;Besalú;1;1;A;;533;149;333;389;144;2;1;386;387
17;Girona;19;Garrotxa;17019;Besalú;1;1;B;;637;185;419;486;151;2;4;480;484
17;Girona;19;Garrotxa;17019;Besalú;1;1;C;;577;177;380;451;126;3;3;445;448
17;Girona;20;Gironès;17020;Bescanó;1;1;A;;559;189;398;462;97;5;3;454;457
17;Girona;20;Gironès;17020;Bescanó;1;1;B;;622;201;427;490;132;0;3;487;490
17;Girona;20;Gironès;17020;Bescanó;1;1;C;;621;209;436;493;128;0;2;491;493
17;Girona;20;Gironès;17020;Bescanó;1;2;A;;269;72;154;176;93;0;0;176;176
17;Girona;20;Gironès;17020;Bescanó;1;2;B;;298;100;178;208;90;3;2;203;205
17;Girona;19;Garrotxa;17021;Beuda;1;1;U;;114;23;65;77;37;5;0;72;72
8;Barcelona;41;Vallès Oriental;08023;Bigues i Riells;1;1;A;;889;235;482;586;303;1;1;584;585
8;Barcelona;41;Vallès Oriental;08023;Bigues i Riells;1;1;B;;843;207;432;521;322;0;4;517;521
8;Barcelona;41;Vallès Oriental;08023;Bigues i Riells;1;1;C;;970;207;502;630;340;2;8;620;628
8;Barcelona;41;Vallès Oriental;08023;Bigues i Riells;1;1;D;;366;120;219;272;94;0;2;270;272
25;Lleida;32;Segarra;25055;Biosca;1;1;U;;233;73;141;176;57;0;2;174;176
17;Girona;10;Baix Empordà;17022;Bisbal d'Empordà, la;1;1;U;;542;143;281;346;196;2;1;343;344
17;Girona;10;Baix Empordà;17022;Bisbal d'Empordà, la;1;2;U;;1024;263;567;731;293;1;4;726;730
17;Girona;10;Baix Empordà;17022;Bisbal d'Empordà, la;1;3;U;;854;261;480;601;253;0;4;597;601
17;Girona;10;Baix Empordà;17022;Bisbal d'Empordà, la;1;4;U;;1182;271;658;837;345;3;12;822;834
17;Girona;10;Baix Empordà;17022;Bisbal d'Empordà, la;2;1;U;;482;158;289;358;124;0;4;354;358
17;Girona;10;Baix Empordà;17022;Bisbal d'Empordà, la;2;2;A;;644;215;408;470;174;2;1;467;468
17;Girona;10;Baix Empordà;17022;Bisbal d'Empordà, la;2;2;B;;628;210;375;457;171;1;2;454;456
17;Girona;10;Baix Empordà;17022;Bisbal d'Empordà, la;2;3;U;;876;246;517;616;260;0;5;611;616
43;Tarragona;29;Priorat;43027;Bisbal de Falset, la;1;1;U;;227;47;108;141;86;3;4;134;138
43;Tarragona;12;Baix Penedès;43028;Bisbal del Penedès, la;1;1;U;;1300;355;724;909;391;2;10;897;907
17;Girona;2;Alt Empordà;17234;Biure;1;1;U;;191;51;118;128;63;0;0;128;128
43;Tarragona;16;Conca de Barberà;43029;Blancafort;1;1;U;;326;67;190;233;93;6;1;226;227
17;Girona;34;Selva;17023;Blanes;1;1;U;;907;308;553;653;254;3;12;638;650
17;Girona;34;Selva;17023;Blanes;1;2;U;;1330;416;808;968;362;4;12;952;964
17;Girona;34;Selva;17023;Blanes;2;1;U;;923;295;516;611;312;1;3;607;610
17;Girona;34;Selva;17023;Blanes;2;2;U;;1177;359;516;808;369;2;3;803;806
17;Girona;34;Selva;17023;Blanes;2;3;A;;601;163;316;379;222;2;3;374;377
17;Girona;34;Selva;17023;Blanes;2;3;B;;591;165;325;382;209;1;3;378;381
17;Girona;34;Selva;17023;Blanes;2;4;U;;1332;325;654;819;513;1;6;812;818
17;Girona;34;Selva;17023;Blanes;2;5;A;;953;230;475;579;374;3;1;575;576
17;Girona;34;Selva;17023;Blanes;2;5;B;;917;313;460;562;355;3;3;556;559
17;Girona;34;Selva;17023;Blanes;2;6;A;;409;87;212;258;151;1;1;256;257
17;Girona;34;Selva;17023;Blanes;2;6;B;;499;95;240;298;201;0;1;297;298
17;Girona;34;Selva;17023;Blanes;2;6;C;;514;120;271;335;179;0;1;334;335
17;Girona;34;Selva;17023;Blanes;2;7;A;;542;117;256;308;234;2;2;304;306
17;Girona;34;Selva;17023;Blanes;2;7;B;;544;131;248;310;234;0;4;306;310
17;Girona;34;Selva;17023;Blanes;2;8;A;;966;223;500;626;340;4;4;618;622
17;Girona;34;Selva;17023;Blanes;2;8;B;;903;210;481;599;304;0;4;595;599
17;Girona;34;Selva;17023;Blanes;3;1;A;;921;277;506;582;339;2;3;577;580
17;Girona;34;Selva;17023;Blanes;3;1;B;;903;284;470;547;356;2;2;543;545
17;Girona;34;Selva;17023;Blanes;3;2;U;;577;174;328;376;201;3;1;372;373
17;Girona;34;Selva;17023;Blanes;3;3;A;;900;187;401;476;424;1;2;473;475
17;Girona;34;Selva;17023;Blanes;3;3;B;;930;196;474;519;411;1;3;515;518
17;Girona;34;Selva;17023;Blanes;3;4;A;;406;107;232;262;144;0;1;261;262
17;Girona;34;Selva;17023;Blanes;3;4;B;;680;128;299;377;303;0;3;374;377
17;Girona;34;Selva;17023;Blanes;3;5;U;;1117;283;569;665;452;3;6;656;662
17;Girona;34;Selva;17023;Blanes;3;6;A;;922;156;347;450;472;4;3;443;446
17;Girona;34;Selva;17023;Blanes;3;6;B;;914;172;340;422;492;1;2;419;421
17;Girona;2;Alt Empordà;17029;Boadella i les Escaules;1;1;U;;189;56;110;143;46;1;3;139;142
17;Girona;15;Cerdanya;17024;Bolvir;1;1;U;;198;55;113;135;63;1;1;133;134
43;Tarragona;12;Baix Penedès;43030;Bonastre;1;1;U;;250;95;162;197;53;0;3;194;197
25;Lleida;39;Consell General d'Aran;25057;Bòrdes, es;1;1;U;;170;49;91;115;55;1;0;114;114
17;Girona;20;Gironès;17025;Bordils;1;1;U;;1054;336;735;799;255;2;5;792;797
25;Lleida;18;Garrigues;25058;Borges Blanques, les;1;1;U;;832;180;452;583;249;3;1;579;580
25;Lleida;18;Garrigues;25058;Borges Blanques, les;1;2;U;;980;238;515;705;275;2;11;692;703
25;Lleida;18;Garrigues;25058;Borges Blanques, les;2;1;U;;1248;252;600;862;386;3;10;849;859
25;Lleida;18;Garrigues;25058;Borges Blanques, les;2;2;U;;1192;237;544;767;425;2;6;759;765
43;Tarragona;8;Baix Camp;43031;Borges del Camp, les;1;1;U;;1203;305;716;918;285;6;6;906;912
17;Girona;2;Alt Empordà;17026;Borrassà;1;1;U;;431;159;263;314;117;1;2;311;313
8;Barcelona;14;Berguedà;08024;Borredà;1;1;U;;386;150;267;320;66;0;3;317;320
25;Lleida;39;Consell General d'Aran;25059;Bossòst;1;1;U;;666;200;380;502;164;1;9;492;501
43;Tarragona;37;Terra Alta;43032;Bot;1;1;U;;757;223;455;581;176;6;5;570;575
43;Tarragona;8;Baix Camp;43033;Botarell;1;1;U;;405;102;258;317;88;0;1;316;317
25;Lleida;18;Garrigues;25056;Bovera;1;1;U;;368;112;209;293;75;0;0;293;293
43;Tarragona;1;Alt Camp;43034;Bràfim;1;1;U;;484;97;306;391;93;5;5;381;386
17;Girona;34;Selva;17027;Breda;1;1;A;;733;188;424;503;230;6;0;497;497
17;Girona;34;Selva;17027;Breda;1;1;B;;770;197;453;555;215;3;1;551;552
17;Girona;34;Selva;17027;Breda;1;2;A;;538;155;314;383;155;2;2;379;381
17;Girona;34;Selva;17027;Breda;1;2;B;;613;183;405;479;134;1;3;475;478
8;Barcelona;6;Anoia;08025;Bruc, el;1;1;U;;661;201;379;478;183;0;5;473;478
8;Barcelona;24;Osona;08026;Brull, el;1;1;U;;171;42;93;123;48;0;2;121;123
17;Girona;34;Selva;17028;Brunyola i Sant Martí Sapresa;1;1;U;;322;110;186;212;110;0;0;212;212
43;Tarragona;29;Priorat;43035;Cabacés;1;1;U;;285;85;188;219;66;2;0;217;217
25;Lleida;23;Noguera;25060;Cabanabona;1;1;U;;89;13;50;63;26;0;0;63;63
17;Girona;2;Alt Empordà;17031;Cabanelles;1;1;U;;182;49;101;116;66;0;0;116;116
17;Girona;2;Alt Empordà;17030;Cabanes;1;1;U;;645;645;359;426;219;4;1;421;422
8;Barcelona;3;Alt Penedès;08027;Cabanyes, les;1;1;U;;364;108;233;294;70;1;1;292;293
25;Lleida;4;Alt Urgell;25061;Cabó;1;1;U;;113;26;55;67;46;0;0;67;67
43;Tarragona;1;Alt Camp;43036;Cabra del Camp;1;1;U;;405;124;224;259;146;0;1;258;259
8;Barcelona;6;Anoia;08028;Cabrera d'Anoia;1;1;U;;310;90;172;206;104;0;1;205;206
8;Barcelona;21;Maresme;08029;Cabrera de Mar;1;1;A;;727;200;446;552;175;0;3;549;552
8;Barcelona;21;Maresme;08029;Cabrera de Mar;1;1;B;;728;200;441;559;169;4;1;554;555
8;Barcelona;21;Maresme;08029;Cabrera de Mar;1;2;A;;507;137;288;352;155;0;6;346;352
8;Barcelona;21;Maresme;08029;Cabrera de Mar;1;2;B;;568;141;321;395;173;1;1;393;394
8;Barcelona;21;Maresme;08030;Cabrils;1;1;A;;670;150;365;442;228;4;9;429;438
8;Barcelona;21;Maresme;08030;Cabrils;1;1;B;;727;183;387;496;231;3;7;486;493
8;Barcelona;21;Maresme;08030;Cabrils;1;2;A;;749;167;422;531;218;1;7;523;530
8;Barcelona;21;Maresme;08030;Cabrils;1;2;B;;693;123;364;486;207;1;8;477;485
17;Girona;2;Alt Empordà;17032;Cadaqués;1;1;A;;751;226;425;496;255;3;0;493;493
17;Girona;2;Alt Empordà;17032;Cadaqués;1;1;B;;751;229;416;503;248;0;4;499;503
8;Barcelona;6;Anoia;08031;Calaf;1;1;U;;722;180;410;507;215;0;4;503;507
8;Barcelona;6;Anoia;08031;Calaf;1;2;A;;604;148;352;462;142;2;4;456;460
8;Barcelona;6;Anoia;08031;Calaf;1;2;B;;540;105;300;402;138;0;3;399;402
8;Barcelona;6;Anoia;08031;Calaf;1;2;C;;699;168;409;536;163;1;4;531;535
43;Tarragona;12;Baix Penedès;43037;Calafell;1;1;A;;856;194;407;493;363;2;2;489;491
43;Tarragona;12;Baix Penedès;43037;Calafell;1;1;B;;1226;300;613;749;477;5;8;736;744
43;Tarragona;12;Baix Penedès;43037;Calafell;1;2;U;;681;140;361;439;242;0;3;436;439
43;Tarragona;12;Baix Penedès;43037;Calafell;2;1;A;;650;154;330;431;219;2;6;423;429
43;Tarragona;12;Baix Penedès;43037;Calafell;2;1;B;;1093;233;552;703;390;4;10;689;699
43;Tarragona;12;Baix Penedès;43037;Calafell;2;2;U;;1567;376;745;887;680;4;11;872;883
43;Tarragona;12;Baix Penedès;43037;Calafell;2;3;U;;1499;313;610;760;739;13;3;744;747
8;Barcelona;;;08034;Calders;1;1;U;;495;191;319;390;105;6;2;382;384
8;Barcelona;21;Maresme;08032;Caldes d'Estrac;1;1;A;;639;203;394;463;176;0;3;460;463
8;Barcelona;21;Maresme;08032;Caldes d'Estrac;1;1;B;;726;220;439;522;204;0;2;520;522
17;Girona;34;Selva;17033;Caldes de Malavella;1;1;A;;945;248;507;663;282;2;5;656;661
17;Girona;34;Selva;17033;Caldes de Malavella;1;1;B;;1010;311;607;712;298;7;3;702;705
17;Girona;34;Selva;17033;Caldes de Malavella;1;2;U;;932;228;396;487;445;1;4;482;486
8;Barcelona;41;Vallès Oriental;08033;Caldes de Montbui;1;1;A;;506;146;300;373;133;1;5;367;372
8;Barcelona;41;Vallès Oriental;08033;Caldes de Montbui;1;1;B;;758;227;419;519;239;2;3;514;517
8;Barcelona;41;Vallès Oriental;08033;Caldes de Montbui;1;2;A;;799;193;378;464;335;2;7;455;462
8;Barcelona;41;Vallès Oriental;08033;Caldes de Montbui;1;2;B;;868;193;400;493;375;1;9;483;492
8;Barcelona;41;Vallès Oriental;08033;Caldes de Montbui;1;3;U;;760;248;439;530;230;0;1;529;530
8;Barcelona;41;Vallès Oriental;08033;Caldes de Montbui;2;1;A;;625;170;351;448;177;2;6;440;446
8;Barcelona;41;Vallès Oriental;08033;Caldes de Montbui;2;1;B;;594;131;287;372;222;0;6;366;372
8;Barcelona;41;Vallès Oriental;08033;Caldes de Montbui;2;1;C;;629;171;361;442;187;3;1;438;439
8;Barcelona;41;Vallès Oriental;08033;Caldes de Montbui;3;1;A;;599;159;311;399;200;3;2;394;396
8;Barcelona;41;Vallès Oriental;08033;Caldes de Montbui;3;1;B;;706;155;368;473;233;2;0;471;471
8;Barcelona;41;Vallès Oriental;08033;Caldes de Montbui;3;2;U;;781;175;407;510;271;2;2;506;508
8;Barcelona;41;Vallès Oriental;08033;Caldes de Montbui;3;3;A;;537;110;206;256;281;2;2;252;254
8;Barcelona;41;Vallès Oriental;08033;Caldes de Montbui;3;3;B;;739;184;348;440;299;0;8;432;440
8;Barcelona;41;Vallès Oriental;08033;Caldes de Montbui;3;4;A;;537;126;276;347;190;0;2;345;347
8;Barcelona;41;Vallès Oriental;08033;Caldes de Montbui;3;4;B;;620;129;296;398;222;3;6;389;395
8;Barcelona;21;Maresme;08035;Calella;1;1;A;;513;157;253;323;190;3;1;319;320
8;Barcelona;21;Maresme;08035;Calella;1;1;B;;626;171;324;394;232;1;3;390;393
8;Barcelona;21;Maresme;08035;Calella;1;2;U;;731;203;408;507;224;2;4;501;505
8;Barcelona;21;Maresme;08035;Calella;1;3;A;;470;96;174;243;227;1;1;241;242
8;Barcelona;21;Maresme;08035;Calella;1;3;B;;681;139;262;333;348;3;3;327;330
8;Barcelona;21;Maresme;08035;Calella;2;1;U;;532;124;300;364;168;5;4;355;359
8;Barcelona;21;Maresme;08035;Calella;2;2;A;;681;197;372;465;216;4;6;455;461
8;Barcelona;21;Maresme;08035;Calella;2;2;B;;914;249;481;622;292;3;2;617;619
8;Barcelona;21;Maresme;08035;Calella;3;1;A;;787;201;424;518;269;3;7;508;515
8;Barcelona;21;Maresme;08035;Calella;3;1;B;;878;222;474;568;310;1;8;559;567
8;Barcelona;21;Maresme;08035;Calella;3;2;A;;662;185;307;402;260;1;5;396;401
8;Barcelona;21;Maresme;08035;Calella;3;2;B;;768;189;372;485;283;4;2;479;481
8;Barcelona;21;Maresme;08035;Calella;3;3;A;;664;157;347;445;219;1;5;439;444
8;Barcelona;21;Maresme;08035;Calella;3;3;B;;812;179;374;509;303;1;7;501;508
8;Barcelona;24;Osona;08037;Calldetenes;1;1;A;;640;137;390;495;145;2;4;489;493
8;Barcelona;24;Osona;08037;Calldetenes;1;1;B;;635;162;417;521;114;3;1;517;518
8;Barcelona;7;Bages;08038;Callús;1;1;A;;489;145;298;363;126;2;3;358;361
8;Barcelona;7;Bages;08038;Callús;1;1;B;;627;172;370;439;188;4;2;433;435
17;Girona;10;Baix Empordà;17034;Calonge i Sant Antoni;1;1;A;;733;197;376;457;276;3;5;449;454
17;Girona;10;Baix Empordà;17034;Calonge i Sant Antoni;1;1;B;;849;188;413;515;334;0;2;513;515
17;Girona;10;Baix Empordà;17034;Calonge i Sant Antoni;1;2;U;;899;261;502;595;304;0;5;590;595
17;Girona;10;Baix Empordà;17034;Calonge i Sant Antoni;1;3;U;;790;224;433;524;266;1;5;518;523
17;Girona;10;Baix Empordà;17034;Calonge i Sant Antoni;1;4;U;;1155;299;550;672;483;0;3;669;672
8;Barcelona;6;Anoia;08036;Calonge de Segarra;1;1;U;;156;37;101;133;23;0;2;131;133
25;Lleida;23;Noguera;25062;Camarasa;1;1;U;;800;258;501;611;189;0;7;604;611
43;Tarragona;9;Baix Ebre;43903;Camarles;1;1;A;;876;270;535;650;226;1;6;643;649
43;Tarragona;9;Baix Ebre;43903;Camarles;1;1;B;;716;211;449;533;183;4;12;517;529
43;Tarragona;9;Baix Ebre;43903;Camarles;1;2;U;;762;196;377;492;270;0;1;491;492
43;Tarragona;8;Baix Camp;43038;Cambrils;1;1;A;;731;168;329;396;335;7;4;385;389
43;Tarragona;8;Baix Camp;43038;Cambrils;1;1;B;;763;173;351;438;325;1;2;435;437
43;Tarragona;8;Baix Camp;43038;Cambrils;1;2;A;;653;152;309;388;265;0;12;376;388
43;Tarragona;8;Baix Camp;43038;Cambrils;1;2;B;;824;208;450;545;279;1;13;531;544
43;Tarragona;8;Baix Camp;43038;Cambrils;1;3;A;;690;198;382;444;246;4;6;434;440
43;Tarragona;8;Baix Camp;43038;Cambrils;1;3;B;;856;226;437;538;318;5;2;531;533
43;Tarragona;8;Baix Camp;43038;Cambrils;1;4;A;;493;120;204;268;225;1;2;265;267
43;Tarragona;8;Baix Camp;43038;Cambrils;1;4;B;;676;166;315;406;270;2;5;399;404
43;Tarragona;8;Baix Camp;43038;Cambrils;2;1;A;;704;203;368;450;254;2;5;443;448
43;Tarragona;8;Baix Camp;43038;Cambrils;2;1;B;;675;189;338;434;241;4;2;428;430
43;Tarragona;8;Baix Camp;43038;Cambrils;2;2;A;;701;178;311;399;302;0;1;398;399
43;Tarragona;8;Baix Camp;43038;Cambrils;2;2;B;;694;154;299;366;328;0;1;365;366
43;Tarragona;8;Baix Camp;43038;Cambrils;2;3;A;;956;212;425;533;423;2;7;524;531
43;Tarragona;8;Baix Camp;43038;Cambrils;2;3;B;;1124;227;492;619;505;3;13;603;616
43;Tarragona;8;Baix Camp;43038;Cambrils;2;4;A;;739;148;302;397;342;2;7;388;395
43;Tarragona;8;Baix Camp;43038;Cambrils;2;4;B;;829;180;363;439;390;2;7;430;437
43;Tarragona;8;Baix Camp;43038;Cambrils;2;5;U;;930;208;378;464;466;1;6;457;463
17;Girona;28;Pla de l'Estany;17035;Camós;1;1;U;;516;226;359;399;117;5;2;392;394
17;Girona;31;Ripollès;17036;Campdevànol;1;1;A;;471;132;287;363;108;0;4;359;363
17;Girona;31;Ripollès;17036;Campdevànol;1;1;B;;540;168;365;440;100;0;9;431;440
17;Girona;31;Ripollès;17036;Campdevànol;1;2;A;;488;169;316;379;109;1;6;372;378
17;Girona;31;Ripollès;17036;Campdevànol;1;2;B;;523;155;319;396;127;0;2;394;396
17;Girona;31;Ripollès;17036;Campdevànol;1;3;U;;769;211;511;587;182;4;5;578;583
17;Girona;31;Ripollès;17037;Campelles;1;1;U;;118;45;80;87;31;0;2;85;87
8;Barcelona;41;Vallès Oriental;08039;Campins;1;1;U;;190;83;104;147;43;0;2;145;147
17;Girona;20;Gironès;17038;Campllong;1;1;U;;219;70;133;168;51;1;4;163;167
17;Girona;31;Ripollès;17039;Camprodon;1;1;A;;651;165;407;516;135;4;3;509;512
17;Girona;31;Ripollès;17039;Camprodon;1;1;B;;740;227;508;584;156;2;5;577;582
17;Girona;31;Ripollès;17039;Camprodon;1;2;U;;563;174;348;420;143;3;5;412;417
25;Lleida;39;Consell General d'Aran;25063;Canejan;1;1;U;;100;30;53;65;35;0;1;64;65
17;Girona;20;Gironès;17040;Canet d'Adri;1;1;U;;409;127;217;266;143;0;3;263;266
8;Barcelona;21;Maresme;08040;Canet de Mar;1;1;A;;930;266;566;675;255;1;10;664;674
8;Barcelona;21;Maresme;08040;Canet de Mar;1;1;B;;1080;305;646;758;322;3;11;744;755
8;Barcelona;21;Maresme;08040;Canet de Mar;1;2;A;;741;215;421;511;230;3;1;507;508
8;Barcelona;21;Maresme;08040;Canet de Mar;1;2;B;;847;266;468;554;293;7;2;545;547
8;Barcelona;21;Maresme;08040;Canet de Mar;1;3;A;;766;224;428;544;222;2;7;535;542
8;Barcelona;21;Maresme;08040;Canet de Mar;1;3;B;;975;284;564;687;288;0;6;681;687
8;Barcelona;21;Maresme;08040;Canet de Mar;1;4;A;;948;254;519;620;328;3;8;609;617
8;Barcelona;21;Maresme;08040;Canet de Mar;1;4;B;;1144;283;630;778;366;0;4;774;778
8;Barcelona;41;Vallès Oriental;08041;Canovelles;1;1;U;;1091;195;467;589;502;1;6;582;588
8;Barcelona;41;Vallès Oriental;08041;Canovelles;1;2;A;;748;225;383;443;305;0;2;441;443
8;Barcelona;41;Vallès Oriental;08041;Canovelles;1;2;B;;900;240;439;522;378;3;1;518;519
8;Barcelona;41;Vallès Oriental;08041;Canovelles;1;3;A;;644;190;341;384;260;0;4;380;384
8;Barcelona;41;Vallès Oriental;08041;Canovelles;1;3;B;;870;221;422;498;372;2;1;495;496
8;Barcelona;41;Vallès Oriental;08041;Canovelles;1;4;U;;1009;240;432;533;476;2;1;530;531
8;Barcelona;41;Vallès Oriental;08041;Canovelles;1;5;A;;547;148;259;304;243;0;1;303;304
8;Barcelona;41;Vallès Oriental;08041;Canovelles;1;5;B;;763;203;376;454;309;0;5;449;454
8;Barcelona;41;Vallès Oriental;08041;Canovelles;1;6;U;;1495;389;735;932;563;1;8;923;931
8;Barcelona;41;Vallès Oriental;08041;Canovelles;1;7;U;;1453;407;843;944;509;4;8;932;940
8;Barcelona;41;Vallès Oriental;08041;Canovelles;1;8;U;;790;209;395;517;273;0;5;512;517
8;Barcelona;41;Vallès Oriental;08042;Cànoves i Samalús;1;1;U;;1176;345;722;802;374;3;7;792;799
17;Girona;2;Alt Empordà;17041;Cantallops;1;1;U;;240;60;145;176;64;1;1;174;175
8;Barcelona;17;Garraf;08043;Canyelles;1;1;U;;965;244;490;639;326;6;8;625;633
43;Tarragona;8;Baix Camp;43039;Capafonts;1;1;U;;95;20;41;64;31;0;0;64;64
43;Tarragona;29;Priorat;43040;Capçanes;1;1;U;;330;105;220;270;60;0;5;265;270
8;Barcelona;6;Anoia;08044;Capellades;1;1;A;;833;224;440;551;282;2;4;545;549
8;Barcelona;6;Anoia;08044;Capellades;1;1;B;;991;221;550;621;370;3;2;616;618
8;Barcelona;6;Anoia;08044;Capellades;2;1;A;;492;119;261;339;153;0;1;338;339
8;Barcelona;6;Anoia;08044;Capellades;2;1;B;;570;121;307;403;167;1;3;399;402
8;Barcelona;6;Anoia;08044;Capellades;2;2;A;;480;134;265;335;145;0;1;334;335
8;Barcelona;6;Anoia;08044;Capellades;2;2;B;;601;169;372;460;141;4;7;449;456
17;Girona;2;Alt Empordà;17042;Capmany;1;1;U;;352;115;236;276;76;2;2;272;274
8;Barcelona;14;Berguedà;08045;Capolat;1;1;U;;63;22;35;51;12;0;0;51;51
8;Barcelona;41;Vallès Oriental;08046;Cardedeu;1;1;A;;655;185;400;469;186;3;10;456;466
8;Barcelona;41;Vallès Oriental;08046;Cardedeu;1;1;B;;606;192;342;399;207;1;7;391;398
8;Barcelona;41;Vallès Oriental;08046;Cardedeu;1;1;C;;709;204;401;470;239;0;4;466;470
8;Barcelona;41;Vallès Oriental;08046;Cardedeu;1;2;A;;549;185;360;422;127;0;4;418;422
8;Barcelona;41;Vallès Oriental;08046;Cardedeu;1;2;B;;588;175;378;436;152;0;6;430;436
8;Barcelona;41;Vallès Oriental;08046;Cardedeu;2;1;A;;627;192;343;420;207;0;3;417;420
8;Barcelona;41;Vallès Oriental;08046;Cardedeu;2;1;B;;661;171;353;440;221;2;6;432;438
8;Barcelona;41;Vallès Oriental;08046;Cardedeu;2;2;A;;625;198;392;458;167;3;3;452;455
8;Barcelona;41;Vallès Oriental;08046;Cardedeu;2;2;B;;587;148;301;371;216;1;4;366;370
8;Barcelona;41;Vallès Oriental;08046;Cardedeu;2;2;C;;682;202;405;470;212;0;5;465;470
8;Barcelona;41;Vallès Oriental;08046;Cardedeu;2;3;U;;778;179;408;528;250;2;5;521;526
8;Barcelona;41;Vallès Oriental;08046;Cardedeu;2;4;A;;562;130;282;365;197;0;3;362;365
8;Barcelona;41;Vallès Oriental;08046;Cardedeu;2;4;B;;556;146;297;360;196;0;3;357;360
8;Barcelona;7;Bages;08047;Cardona;1;1;A;;778;195;415;537;241;1;5;531;536
8;Barcelona;7;Bages;08047;Cardona;1;1;B;;705;178;375;480;225;1;6;473;479
8;Barcelona;7;Bages;08047;Cardona;1;1;C;;790;201;433;552;238;2;7;543;550
8;Barcelona;7;Bages;08047;Cardona;1;2;A;;546;191;314;389;157;2;2;385;387
8;Barcelona;7;Bages;08047;Cardona;1;2;B;;609;201;339;406;203;4;2;400;402
8;Barcelona;7;Bages;08047;Cardona;2;1;U;;492;131;233;294;198;1;2;291;293
8;Barcelona;7;Bages;08047;Cardona;2;2;U;;606;216;325;387;219;4;5;378;383
8;Barcelona;7;Bages;08047;Cardona;2;3;U;;569;171;330;435;134;0;10;425;435
8;Barcelona;6;Anoia;08048;Carme;1;1;U;;579;138;368;464;115;0;1;463;464
43;Tarragona;37;Terra Alta;43041;Caseres;1;1;U;;291;65;167;222;69;0;2;220;222
17;Girona;20;Gironès;17044;Cassà de la Selva;1;1;A;;552;169;331;400;152;0;4;396;400
17;Girona;20;Gironès;17044;Cassà de la Selva;1;1;B;;495;167;342;379;116;0;0;379;379
17;Girona;20;Gironès;17044;Cassà de la Selva;1;2;A;;556;196;314;385;171;5;2;378;380
17;Girona;20;Gironès;17044;Cassà de la Selva;1;2;B;;561;175;306;380;181;1;4;375;379
17;Girona;20;Gironès;17044;Cassà de la Selva;2;1;A;;789;259;474;568;221;0;3;565;568
17;Girona;20;Gironès;17044;Cassà de la Selva;2;1;B;;797;280;495;573;224;0;10;563;573
17;Girona;20;Gironès;17044;Cassà de la Selva;2;2;A;;765;260;470;559;206;1;3;555;558
17;Girona;20;Gironès;17044;Cassà de la Selva;2;2;B;;753;220;434;539;214;1;2;536;538
17;Girona;20;Gironès;17044;Cassà de la Selva;2;3;U;;660;233;418;504;156;2;1;501;502
8;Barcelona;14;Berguedà;08049;Casserres;1;1;A;;1115;332;661;786;329;3;3;780;783
8;Barcelona;14;Berguedà;08049;Casserres;1;1;B;;273;86;161;190;83;0;2;188;190
25;Lleida;35;Solsonès;25064;Castellar de la Ribera;1;1;U;;133;57;87;108;25;0;0;108;108
8;Barcelona;14;Berguedà;08050;Castellar del Riu;1;1;U;;80;7;29;49;31;1;1;47;48
8;Barcelona;40;Vallès Occidental;08051;Castellar del Vallès;1;1;U;;1006;270;529;658;348;2;0;656;656
8;Barcelona;40;Vallès Occidental;08051;Castellar del Vallès;1;2;A;;601;208;352;442;159;0;4;438;442
8;Barcelona;40;Vallès Occidental;08051;Castellar del Vallès;1;2;B;;797;222;445;548;249;1;3;544;547
8;Barcelona;40;Vallès Occidental;08051;Castellar del Vallès;1;3;U;;1057;287;575;703;354;0;3;700;703
8;Barcelona;40;Vallès Occidental;08051;Castellar del Vallès;1;4;A;;810;222;454;537;273;0;1;536;537
8;Barcelona;40;Vallès Occidental;08051;Castellar del Vallès;1;4;B;;937;276;518;630;307;2;3;625;628
8;Barcelona;40;Vallès Occidental;08051;Castellar del Vallès;1;5;A;;612;178;359;450;162;0;0;450;450
8;Barcelona;40;Vallès Occidental;08051;Castellar del Vallès;1;5;B;;695;198;388;491;204;1;7;483;490
8;Barcelona;40;Vallès Occidental;08051;Castellar del Vallès;1;6;A;;933;195;430;569;364;1;11;557;568
8;Barcelona;40;Vallès Occidental;08051;Castellar del Vallès;1;6;B;;1035;235;495;632;403;0;8;624;632
8;Barcelona;40;Vallès Occidental;08051;Castellar del Vallès;1;7;A;;653;175;320;433;220;0;4;429;433
8;Barcelona;40;Vallès Occidental;08051;Castellar del Vallès;1;7;B;;684;162;326;406;278;1;2;403;405
8;Barcelona;40;Vallès Occidental;08051;Castellar del Vallès;1;8;A;;633;169;308;411;222;1;4;406;410
8;Barcelona;40;Vallès Occidental;08051;Castellar del Vallès;1;8;B;;774;210;378;497;277;1;6;490;496
8;Barcelona;40;Vallès Occidental;08051;Castellar del Vallès;1;9;U;;1017;266;514;662;355;2;5;655;660
8;Barcelona;14;Berguedà;08052;Castellar de n'Hug;1;1;U;;138;56;102;114;24;0;0;114;114
8;Barcelona;7;Bages;08053;Castellbell i el Vilar;1;1;U;;1389;356;828;972;417;2;5;965;970
8;Barcelona;7;Bages;08053;Castellbell i el Vilar;1;2;U;;1016;266;525;604;412;3;0;601;601
8;Barcelona;40;Vallès Occidental;08054;Castellbisbal;1;1;A;;874;193;450;574;300;0;7;567;574
8;Barcelona;40;Vallès Occidental;08054;Castellbisbal;1;1;B;;1006;197;504;641;365;2;6;633;639
8;Barcelona;40;Vallès Occidental;08054;Castellbisbal;1;2;A;;720;156;330;401;319;2;3;396;399
8;Barcelona;40;Vallès Occidental;08054;Castellbisbal;1;2;B;;662;122;289;385;277;3;4;378;382
8;Barcelona;40;Vallès Occidental;08054;Castellbisbal;1;3;A;;647;170;313;396;251;1;2;393;395
8;Barcelona;40;Vallès Occidental;08054;Castellbisbal;1;3;B;;736;211;406;516;220;2;6;508;514
8;Barcelona;;;08055;Castellcir;1;1;U;;229;88;150;178;51;1;2;175;177
25;Lleida;18;Garrigues;25067;Castelldans;1;1;U;;810;155;415;526;284;4;2;520;522
8;Barcelona;11;Baix Llobregat;08056;Castelldefels;1;1;U;;697;158;313;390;307;2;1;387;388
8;Barcelona;11;Baix Llobregat;08056;Castelldefels;1;2;A;;566;153;270;324;242;2;3;319;322
8;Barcelona;11;Baix Llobregat;08056;Castelldefels;1;2;B;;678;166;311;390;288;2;0;388;388
8;Barcelona;11;Baix Llobregat;08056;Castelldefels;1;3;A;;562;117;253;313;249;1;2;310;312
8;Barcelona;11;Baix Llobregat;08056;Castelldefels;1;3;B;;678;166;337;403;275;1;2;400;402
8;Barcelona;11;Baix Llobregat;08056;Castelldefels;1;4;A;;733;126;277;356;377;0;3;353;356
8;Barcelona;11;Baix Llobregat;08056;Castelldefels;1;4;B;;783;117;281;364;419;0;4;360;364
8;Barcelona;11;Baix Llobregat;08056;Castelldefels;1;5;A;;777;149;316;424;353;1;1;422;423
8;Barcelona;11;Baix Llobregat;08056;Castelldefels;1;5;B;;755;171;322;420;335;2;5;413;418
8;Barcelona;11;Baix Llobregat;08056;Castelldefels;1;6;A;;887;198;400;495;392;0;7;488;495
8;Barcelona;11;Baix Llobregat;08056;Castelldefels;1;6;B;;1039;255;513;633;406;1;16;616;632
8;Barcelona;11;Baix Llobregat;08056;Castelldefels;1;7;U;;714;166;328;415;299;1;6;408;414
8;Barcelona;11;Baix Llobregat;08056;Castelldefels;2;1;A;;630;168;306;368;262;1;5;362;367
8;Barcelona;11;Baix Llobregat;08056;Castelldefels;2;1;B;;698;193;322;399;299;1;4;394;398
8;Barcelona;11;Baix Llobregat;08056;Castelldefels;2;2;A;;956;221;397;529;427;0;7;522;529
8;Barcelona;11;Baix Llobregat;08056;Castelldefels;2;2;B;;1087;275;521;664;423;0;9;655;664
8;Barcelona;11;Baix Llobregat;08056;Castelldefels;2;3;A;;655;181;338;436;219;0;7;429;436
8;Barcelona;11;Baix Llobregat;08056;Castelldefels;2;3;B;;618;153;312;379;239;4;5;370;375
8;Barcelona;11;Baix Llobregat;08056;Castelldefels;2;4;A;;854;206;406;521;333;2;6;513;519
8;Barcelona;11;Baix Llobregat;08056;Castelldefels;2;4;B;;960;218;462;573;387;1;7;565;572
8;Barcelona;11;Baix Llobregat;08056;Castelldefels;2;5;U;;1023;250;516;612;411;1;8;603;611
8;Barcelona;11;Baix Llobregat;08056;Castelldefels;3;1;U;;978;211;449;570;408;1;5;564;569
8;Barcelona;11;Baix Llobregat;08056;Castelldefels;3;2;A;;647;151;336;428;219;0;5;423;428
8;Barcelona;11;Baix Llobregat;08056;Castelldefels;3;2;B;;646;154;330;420;226;0;11;409;420
8;Barcelona;11;Baix Llobregat;08056;Castelldefels;3;3;A;;554;105;220;273;281;3;2;268;270
8;Barcelona;11;Baix Llobregat;08056;Castelldefels;3;3;B;;747;122;280;362;385;0;5;357;362
8;Barcelona;11;Baix Llobregat;08056;Castelldefels;4;1;A;;782;202;410;514;268;0;4;510;514
8;Barcelona;11;Baix Llobregat;08056;Castelldefels;4;1;B;;894;219;463;594;300;1;14;579;593
8;Barcelona;11;Baix Llobregat;08056;Castelldefels;4;2;U;;885;204;399;496;389;0;6;490;496
8;Barcelona;11;Baix Llobregat;08056;Castelldefels;4;3;U;;1086;230;504;629;457;0;8;621;629
8;Barcelona;11;Baix Llobregat;08056;Castelldefels;4;4;U;;973;180;368;447;526;2;5;440;445
8;Barcelona;11;Baix Llobregat;08056;Castelldefels;5;1;A;;716;159;335;418;298;1;5;412;417
8;Barcelona;11;Baix Llobregat;08056;Castelldefels;5;1;B;;813;181;352;472;341;0;6;466;472
8;Barcelona;11;Baix Llobregat;08056;Castelldefels;5;2;A;;1010;207;413;491;519;0;3;488;491
8;Barcelona;11;Baix Llobregat;08056;Castelldefels;5;2;B;;1144;220;443;539;605;0;8;531;539
8;Barcelona;14;Berguedà;08057;Castell de l'Areny;1;1;U;;45;21;30;36;9;0;1;35;36
25;Lleida;25;Pallars Jussà;25904;Castell de Mur;1;1;U;;143;22;79;113;30;0;0;113;113
8;Barcelona;3;Alt Penedès;08058;Castellet i la Gornal;1;1;U;;457;101;248;307;150;3;2;302;304
8;Barcelona;3;Alt Penedès;08058;Castellet i la Gornal;1;2;U;;592;144;317;380;212;5;0;375;375
17;Girona;19;Garrotxa;17046;Castellfollit de la Roca;1;1;A;;423;161;299;335;88;3;9;323;332
17;Girona;19;Garrotxa;17046;Castellfollit de la Roca;1;1;B;;438;161;294;342;96;1;4;337;341
8;Barcelona;7;Bages;08059;Castellfollit del Boix;1;1;U;;277;60;130;174;103;0;3;171;174
8;Barcelona;6;Anoia;08060;Castellfollit de Riubregós;1;1;U;;207;70;136;159;48;1;3;155;158
8;Barcelona;7;Bages;08061;Castellgalí;1;1;U;;656;199;349;497;159;0;2;495;497
8;Barcelona;7;Bages;08062;Castellnou de Bages;1;1;U;;263;69;151;183;80;0;2;181;183
25;Lleida;27;Pla d'Urgell;25068;Castellnou de Seana;1;1;U;;620;153;345;420;200;0;7;413;420
17;Girona;2;Alt Empordà;17047;Castelló d'Empúries;1;1;A;;972;278;529;651;321;4;8;639;647
17;Girona;2;Alt Empordà;17047;Castelló d'Empúries;1;1;B;;1107;193;433;521;586;3;4;514;518
17;Girona;2;Alt Empordà;17047;Castelló d'Empúries;1;2;A;;505;150;279;354;151;3;4;347;351
17;Girona;2;Alt Empordà;17047;Castelló d'Empúries;1;2;B;;514;188;311;377;137;1;1;375;376
25;Lleida;23;Noguera;25069;Castelló de Farfanya;1;1;U;;520;104;266;338;182;0;0;338;338
8;Barcelona;6;Anoia;08063;Castellolí;1;1;U;;358;104;248;289;69;0;5;284;289
17;Girona;10;Baix Empordà;17048;Castell-Platja d'Aro;1;1;U;;723;202;432;521;202;3;4;514;518
17;Girona;10;Baix Empordà;17048;Castell-Platja d'Aro;1;2;A;;781;170;351;424;357;0;3;421;424
17;Girona;10;Baix Empordà;17048;Castell-Platja d'Aro;1;2;B;;752;160;342;423;329;2;5;416;421
17;Girona;10;Baix Empordà;17048;Castell-Platja d'Aro;1;3;A;;1013;224;472;581;432;2;10;569;579
17;Girona;10;Baix Empordà;17048;Castell-Platja d'Aro;1;3;B;;970;212;460;554;416;2;5;547;552
25;Lleida;38;Urgell;25070;Castellserà;1;1;U;;972;271;601;747;225;1;8;738;746
8;Barcelona;;;08064;Castellterçol;1;1;A;;829;278;520;656;173;5;7;644;651
8;Barcelona;;;08064;Castellterçol;1;1;B;;803;248;511;645;158;1;1;643;644
43;Tarragona;8;Baix Camp;43042;Castellvell del Camp;1;1;U;;821;249;504;606;215;1;4;601;605
8;Barcelona;3;Alt Penedès;08065;Castellví de la Marca;1;1;U;;1159;217;545;734;425;3;8;723;731
8;Barcelona;11;Baix Llobregat;08066;Castellví de Rosanes;1;1;A;;483;130;324;362;121;1;2;359;361
8;Barcelona;11;Baix Llobregat;08066;Castellví de Rosanes;1;1;B;;225;71;133;163;62;1;2;160;162
43;Tarragona;36;Tarragonès;43043;Catllar, el;1;1;A;;574;181;329;393;181;0;1;392;393
43;Tarragona;36;Tarragonès;43043;Catllar, el;1;1;B;;719;252;446;520;199;0;6;514;520
25;Lleida;4;Alt Urgell;25071;Cava;1;1;U;;55;26;36;41;14;0;0;41;41
17;Girona;34;Selva;17189;Cellera de Ter, la;1;1;U;;866;248;536;646;220;2;3;641;644
17;Girona;34;Selva;17189;Cellera de Ter, la;1;2;U;;787;243;511;614;173;3;3;608;611
17;Girona;20;Gironès;17049;Celrà;1;1;A;;1004;297;602;697;307;2;1;694;695
17;Girona;20;Gironès;17049;Celrà;1;1;B;;959;289;579;665;294;0;3;662;665
8;Barcelona;24;Osona;08067;Centelles;1;1;A;;562;228;346;399;163;0;1;398;399
8;Barcelona;24;Osona;08067;Centelles;1;1;B;;584;212;361;417;167;1;2;414;416
8;Barcelona;24;Osona;08067;Centelles;1;2;A;;466;159;269;318;148;3;8;307;315
8;Barcelona;24;Osona;08067;Centelles;1;2;B;;465;176;304;359;106;1;3;355;358
8;Barcelona;24;Osona;08067;Centelles;1;3;A;;416;134;259;297;119;1;3;293;296
8;Barcelona;24;Osona;08067;Centelles;1;3;B;;599;188;359;422;177;0;1;421;422
8;Barcelona;24;Osona;08067;Centelles;1;4;A;;669;174;413;486;183;2;4;480;484
8;Barcelona;24;Osona;08067;Centelles;1;4;B;;926;235;525;669;257;4;4;661;665
8;Barcelona;14;Berguedà;08268;Cercs;1;1;A;;372;102;236;282;90;2;2;278;280
8;Barcelona;14;Berguedà;08268;Cercs;1;1;B;;303;46;172;195;108;0;2;193;195
8;Barcelona;14;Berguedà;08268;Cercs;1;2;U;;664;237;474;534;130;2;5;527;532
8;Barcelona;40;Vallès Occidental;08266;Cerdanyola del Vallès;1;1;A;;676;170;315;416;260;3;4;409;413
8;Barcelona;40;Vallès Occidental;08266;Cerdanyola del Vallès;1;1;B;;845;179;398;506;339;0;8;498;506
8;Barcelona;40;Vallès Occidental;08266;Cerdanyola del Vallès;1;10;A;;574;162;294;354;220;1;2;351;353
8;Barcelona;40;Vallès Occidental;08266;Cerdanyola del Vallès;1;10;B;;718;177;389;453;265;0;3;450;453
8;Barcelona;40;Vallès Occidental;08266;Cerdanyola del Vallès;1;11;U;;977;187;353;420;557;0;4;416;420
8;Barcelona;40;Vallès Occidental;08266;Cerdanyola del Vallès;1;12;A;;557;139;260;331;226;0;3;328;331
8;Barcelona;40;Vallès Occidental;08266;Cerdanyola del Vallès;1;12;B;;714;160;333;412;302;1;7;404;411
8;Barcelona;40;Vallès Occidental;08266;Cerdanyola del Vallès;1;12;C;;643;136;292;362;281;2;9;351;360
8;Barcelona;40;Vallès Occidental;08266;Cerdanyola del Vallès;1;13;A;;377;86;175;246;131;0;3;243;246
8;Barcelona;40;Vallès Occidental;08266;Cerdanyola del Vallès;1;13;B;;396;97;201;245;151;3;4;238;242
8;Barcelona;40;Vallès Occidental;08266;Cerdanyola del Vallès;1;14;A;;637;141;329;411;226;0;1;410;411
8;Barcelona;40;Vallès Occidental;08266;Cerdanyola del Vallès;1;14;B;;647;146;331;410;237;0;7;403;410
8;Barcelona;40;Vallès Occidental;08266;Cerdanyola del Vallès;1;15;A;;863;182;400;501;362;0;9;492;501
8;Barcelona;40;Vallès Occidental;08266;Cerdanyola del Vallès;1;15;B;;1001;187;453;585;416;0;3;582;585
8;Barcelona;40;Vallès Occidental;08266;Cerdanyola del Vallès;1;16;A;;796;178;383;491;305;3;2;486;488
8;Barcelona;40;Vallès Occidental;08266;Cerdanyola del Vallès;1;16;B;;846;196;389;500;346;1;7;492;499
8;Barcelona;40;Vallès Occidental;08266;Cerdanyola del Vallès;1;17;A;;963;197;397;519;444;1;7;511;518
8;Barcelona;40;Vallès Occidental;08266;Cerdanyola del Vallès;1;17;B;;1066;227;410;539;527;0;6;533;539
8;Barcelona;40;Vallès Occidental;08266;Cerdanyola del Vallès;1;18;A;;845;192;436;542;303;2;6;534;540
8;Barcelona;40;Vallès Occidental;08266;Cerdanyola del Vallès;1;18;B;;940;214;459;572;368;1;3;568;571
8;Barcelona;40;Vallès Occidental;08266;Cerdanyola del Vallès;1;19;A;;817;173;370;490;327;2;5;483;488
8;Barcelona;40;Vallès Occidental;08266;Cerdanyola del Vallès;1;19;B;;1018;180;452;590;428;1;7;582;589
8;Barcelona;40;Vallès Occidental;08266;Cerdanyola del Vallès;1;2;A;;663;156;306;390;273;1;1;388;389
8;Barcelona;40;Vallès Occidental;08266;Cerdanyola del Vallès;1;2;B;;847;185;396;523;324;4;5;514;519
8;Barcelona;40;Vallès Occidental;08266;Cerdanyola del Vallès;1;20;A;;875;248;543;650;225;4;17;629;646
8;Barcelona;40;Vallès Occidental;08266;Cerdanyola del Vallès;1;20;B;;935;232;545;686;249;1;8;677;685
8;Barcelona;40;Vallès Occidental;08266;Cerdanyola del Vallès;1;27;A;;808;165;338;418;390;1;6;411;417
8;Barcelona;40;Vallès Occidental;08266;Cerdanyola del Vallès;1;27;B;;883;188;379;474;409;1;8;465;473
8;Barcelona;40;Vallès Occidental;08266;Cerdanyola del Vallès;1;28;U;;1020;301;532;694;326;0;13;681;694
8;Barcelona;40;Vallès Occidental;08266;Cerdanyola del Vallès;1;29;A;;653;174;340;427;226;0;8;419;427
8;Barcelona;40;Vallès Occidental;08266;Cerdanyola del Vallès;1;29;B;;704;156;339;427;277;1;4;422;426
8;Barcelona;40;Vallès Occidental;08266;Cerdanyola del Vallès;1;3;A;;734;160;349;462;272;0;11;451;462
8;Barcelona;40;Vallès Occidental;08266;Cerdanyola del Vallès;1;3;B;;888;192;430;528;360;0;6;522;528
8;Barcelona;40;Vallès Occidental;08266;Cerdanyola del Vallès;1;30;U;;1113;260;560;700;413;0;8;692;700
8;Barcelona;40;Vallès Occidental;08266;Cerdanyola del Vallès;1;31;A;;532;111;237;310;222;1;2;307;309
8;Barcelona;40;Vallès Occidental;08266;Cerdanyola del Vallès;1;31;B;;577;123;248;320;257;0;8;312;320
8;Barcelona;40;Vallès Occidental;08266;Cerdanyola del Vallès;1;32;U;;628;164;343;428;200;0;8;420;428
8;Barcelona;40;Vallès Occidental;08266;Cerdanyola del Vallès;1;33;A;;648;106;261;359;289;0;5;354;359
8;Barcelona;40;Vallès Occidental;08266;Cerdanyola del Vallès;1;33;B;;757;122;270;388;369;6;0;382;382
8;Barcelona;40;Vallès Occidental;08266;Cerdanyola del Vallès;1;34;U;;1132;250;500;662;470;2;2;658;660
8;Barcelona;40;Vallès Occidental;08266;Cerdanyola del Vallès;1;4;A;;861;213;411;498;363;2;2;494;496
8;Barcelona;40;Vallès Occidental;08266;Cerdanyola del Vallès;1;4;B;;951;200;425;537;414;5;6;526;532
8;Barcelona;40;Vallès Occidental;08266;Cerdanyola del Vallès;1;5;A;;568;148;281;345;223;0;3;342;345
8;Barcelona;40;Vallès Occidental;08266;Cerdanyola del Vallès;1;5;B;;566;144;285;356;210;2;2;352;354
8;Barcelona;40;Vallès Occidental;08266;Cerdanyola del Vallès;1;6;A;;575;108;276;349;226;0;5;344;349
8;Barcelona;40;Vallès Occidental;08266;Cerdanyola del Vallès;1;6;B;;637;136;335;395;242;0;5;390;395
8;Barcelona;40;Vallès Occidental;08266;Cerdanyola del Vallès;1;7;U;;548;145;306;375;173;2;3;370;373
8;Barcelona;40;Vallès Occidental;08266;Cerdanyola del Vallès;1;8;A;;704;175;329;439;265;0;6;433;439
8;Barcelona;40;Vallès Occidental;08266;Cerdanyola del Vallès;1;8;B;;856;213;425;522;334;0;5;517;522
8;Barcelona;40;Vallès Occidental;08266;Cerdanyola del Vallès;1;9;A;;679;167;337;421;258;1;5;415;420
8;Barcelona;40;Vallès Occidental;08266;Cerdanyola del Vallès;1;9;B;;807;194;392;525;282;0;10;515;525
8;Barcelona;11;Baix Llobregat;08068;Cervelló;1;1;A;;574;137;294;361;213;3;0;358;358
8;Barcelona;11;Baix Llobregat;08068;Cervelló;1;1;B;;687;188;364;446;241;0;2;444;446
8;Barcelona;11;Baix Llobregat;08068;Cervelló;1;2;U;;955;254;575;654;301;2;5;647;652
8;Barcelona;11;Baix Llobregat;08068;Cervelló;1;3;A;;983;301;560;676;307;6;6;664;670
8;Barcelona;11;Baix Llobregat;08068;Cervelló;1;3;B;;1037;315;559;701;336;1;6;694;700
8;Barcelona;11;Baix Llobregat;08068;Cervelló;1;4;A;;548;131;267;321;227;0;5;316;321
8;Barcelona;11;Baix Llobregat;08068;Cervelló;1;4;B;;617;154;307;364;253;1;6;357;363
25;Lleida;32;Segarra;25072;Cervera;1;1;A;;612;167;316;411;201;4;3;404;407
25;Lleida;32;Segarra;25072;Cervera;1;1;B;;766;198;398;504;262;2;5;497;502
25;Lleida;32;Segarra;25072;Cervera;2;1;A;;694;168;364;492;202;1;6;485;491
25;Lleida;32;Segarra;25072;Cervera;2;1;B;;829;218;450;590;239;1;5;584;589
25;Lleida;32;Segarra;25072;Cervera;2;2;A;;988;194;477;664;324;3;2;659;661
25;Lleida;32;Segarra;25072;Cervera;2;2;B;;1048;198;525;682;366;2;12;668;680
25;Lleida;32;Segarra;25072;Cervera;3;1;U;;888;174;446;578;310;3;9;566;575
25;Lleida;18;Garrigues;25073;Cervià de les Garrigues;1;1;U;;778;172;395;522;256;2;3;517;520
17;Girona;20;Gironès;17050;Cervià de Ter;1;1;U;;541;178;379;434;107;2;0;432;432
17;Girona;2;Alt Empordà;17051;Cistella;1;1;U;;170;48;98;126;44;0;0;126;126
25;Lleida;38;Urgell;25074;Ciutadilla;1;1;U;;195;76;139;158;37;0;0;158;158
25;Lleida;35;Solsonès;25075;Clariana de Cardener;1;1;U;;123;40;77;103;20;0;0;103;103
25;Lleida;18;Garrigues;25076;Cogul, el;1;1;U;;194;56;94;135;59;0;1;134;135
17;Girona;2;Alt Empordà;17054;Colera;1;1;U;;373;138;234;266;107;0;0;266;266
8;Barcelona;11;Baix Llobregat;08069;Collbató;1;1;U;;1162;360;700;827;335;2;12;813;825
43;Tarragona;8;Baix Camp;43045;Colldejou;1;1;U;;152;33;80;101;51;0;0;101;101
25;Lleida;4;Alt Urgell;25077;Coll de Nargó;1;1;U;;524;114;275;330;194;1;1;328;329
8;Barcelona;;;08070;Collsuspina;1;1;U;;211;70;132;166;45;0;2;164;166
17;Girona;10;Baix Empordà;17055;Colomers;1;1;U;;169;56;122;144;25;0;1;143;144
25;Lleida;35;Solsonès;25163;Coma i la Pedra, la;1;1;U;;218;61;117;144;74;1;0;143;143
25;Lleida;25;Pallars Jussà;25161;Conca de Dalt;1;1;U;;400;95;185;255;145;2;3;250;253
43;Tarragona;16;Conca de Barberà;43046;Conesa;1;1;U;;104;17;59;68;36;1;0;67;67
43;Tarragona;36;Tarragonès;43047;Constantí;1;1;A;;584;162;339;407;177;1;9;397;406
43;Tarragona;36;Tarragonès;43047;Constantí;1;1;B;;637;154;316;404;233;3;14;387;401
43;Tarragona;36;Tarragonès;43047;Constantí;1;2;A;;613;104;208;261;352;1;4;256;260
43;Tarragona;36;Tarragonès;43047;Constantí;1;2;B;;703;148;277;332;371;1;1;330;331
43;Tarragona;36;Tarragonès;43047;Constantí;2;1;A;;626;162;322;405;221;7;0;398;398
43;Tarragona;36;Tarragonès;43047;Constantí;2;1;B;;925;226;475;610;315;1;6;603;609
8;Barcelona;6;Anoia;08071;Copons;1;1;U;;242;72;154;188;54;1;2;185;187
43;Tarragona;37;Terra Alta;43048;Corbera d'Ebre;1;1;U;;929;231;558;676;253;0;5;671;676
8;Barcelona;11;Baix Llobregat;08072;Corbera de Llobregat;1;1;A;;643;144;324;421;222;6;1;414;415
8;Barcelona;11;Baix Llobregat;08072;Corbera de Llobregat;1;1;B;;649;163;328;400;249;1;6;393;399
8;Barcelona;11;Baix Llobregat;08072;Corbera de Llobregat;1;1;C;;681;177;360;431;250;0;8;423;431
8;Barcelona;11;Baix Llobregat;08072;Corbera de Llobregat;1;2;A;;656;160;353;442;214;1;6;435;441
8;Barcelona;11;Baix Llobregat;08072;Corbera de Llobregat;1;2;B;;668;150;336;409;259;2;4;403;407
8;Barcelona;11;Baix Llobregat;08072;Corbera de Llobregat;1;3;A;;456;102;242;303;153;1;3;299;302
8;Barcelona;11;Baix Llobregat;08072;Corbera de Llobregat;1;3;B;;527;122;281;343;184;0;1;342;343
8;Barcelona;11;Baix Llobregat;08072;Corbera de Llobregat;1;4;A;;597;142;289;341;256;2;2;337;339
8;Barcelona;11;Baix Llobregat;08072;Corbera de Llobregat;1;4;B;;608;153;281;343;265;3;2;338;340
25;Lleida;33;Segrià;25078;Corbins;1;1;U;;880;182;546;645;235;1;9;635;644
17;Girona;10;Baix Empordà;17057;Corçà;1;1;U;;954;260;559;661;293;0;3;658;661
8;Barcelona;11;Baix Llobregat;08073;Cornellà de Llobregat;1;1;A;;693;204;358;474;219;1;3;470;473
8;Barcelona;11;Baix Llobregat;08073;Cornellà de Llobregat;1;1;B;;848;210;425;560;288;1;3;556;559
8;Barcelona;11;Baix Llobregat;08073;Cornellà de Llobregat;1;10;A;;603;112;263;392;211;2;5;385;390
8;Barcelona;11;Baix Llobregat;08073;Cornellà de Llobregat;1;10;B;;707;147;335;470;237;2;3;465;468
8;Barcelona;11;Baix Llobregat;08073;Cornellà de Llobregat;1;11;U;;934;181;400;522;412;0;1;521;522
8;Barcelona;11;Baix Llobregat;08073;Cornellà de Llobregat;1;12;U;;886;173;358;466;420;0;2;464;466
8;Barcelona;11;Baix Llobregat;08073;Cornellà de Llobregat;1;13;A;;581;116;255;342;239;0;3;339;342
8;Barcelona;11;Baix Llobregat;08073;Cornellà de Llobregat;1;13;B;;583;112;248;326;257;0;4;322;326
8;Barcelona;11;Baix Llobregat;08073;Cornellà de Llobregat;1;14;U;;940;223;459;585;355;0;7;578;585
8;Barcelona;11;Baix Llobregat;08073;Cornellà de Llobregat;1;2;A;;700;166;333;452;248;0;7;445;452
8;Barcelona;11;Baix Llobregat;08073;Cornellà de Llobregat;1;2;B;;761;160;342;467;294;0;2;465;467
8;Barcelona;11;Baix Llobregat;08073;Cornellà de Llobregat;1;3;A;;593;127;256;341;252;0;5;336;341
8;Barcelona;11;Baix Llobregat;08073;Cornellà de Llobregat;1;3;B;;641;143;290;375;266;0;2;373;375
8;Barcelona;11;Baix Llobregat;08073;Cornellà de Llobregat;1;4;U;;970;243;459;571;399;0;8;563;571
8;Barcelona;11;Baix Llobregat;08073;Cornellà de Llobregat;1;5;U;;871;204;377;482;389;1;3;478;481
8;Barcelona;11;Baix Llobregat;08073;Cornellà de Llobregat;1;6;U;;535;106;255;314;221;1;3;310;313
8;Barcelona;11;Baix Llobregat;08073;Cornellà de Llobregat;1;7;A;;583;143;317;395;188;1;3;391;394
8;Barcelona;11;Baix Llobregat;08073;Cornellà de Llobregat;1;7;B;;680;193;374;485;195;1;4;480;484
8;Barcelona;11;Baix Llobregat;08073;Cornellà de Llobregat;1;8;A;;499;99;213;281;218;0;0;281;281
8;Barcelona;11;Baix Llobregat;08073;Cornellà de Llobregat;1;8;B;;492;110;224;279;213;0;1;278;279
8;Barcelona;11;Baix Llobregat;08073;Cornellà de Llobregat;1;9;A;;495;123;257;319;176;0;6;313;319
8;Barcelona;11;Baix Llobregat;08073;Cornellà de Llobregat;1;9;B;;491;145;263;325;166;0;3;322;325
8;Barcelona;11;Baix Llobregat;08073;Cornellà de Llobregat;2;1;U;;998;212;448;560;438;1;2;557;559
8;Barcelona;11;Baix Llobregat;08073;Cornellà de Llobregat;2;2;U;;1103;452;541;689;414;4;5;680;685
8;Barcelona;11;Baix Llobregat;08073;Cornellà de Llobregat;3;1;A;;470;114;239;293;177;2;4;287;291
8;Barcelona;11;Baix Llobregat;08073;Cornellà de Llobregat;3;1;B;;510;124;257;325;185;0;5;320;325
8;Barcelona;11;Baix Llobregat;08073;Cornellà de Llobregat;3;2;A;;463;112;209;262;201;1;3;258;261
8;Barcelona;11;Baix Llobregat;08073;Cornellà de Llobregat;3;2;B;;516;114;217;287;229;1;2;284;286
8;Barcelona;11;Baix Llobregat;08073;Cornellà de Llobregat;3;3;U;;752;172;331;419;333;2;4;413;417
8;Barcelona;11;Baix Llobregat;08073;Cornellà de Llobregat;3;4;U;;425;120;230;251;174;1;1;249;250
8;Barcelona;11;Baix Llobregat;08073;Cornellà de Llobregat;3;5;U;;888;170;416;520;368;3;2;515;517
8;Barcelona;11;Baix Llobregat;08073;Cornellà de Llobregat;3;6;U;;698;211;387;477;221;1;9;467;476
8;Barcelona;11;Baix Llobregat;08073;Cornellà de Llobregat;3;7;A;;443;94;230;275;168;0;0;275;275
8;Barcelona;11;Baix Llobregat;08073;Cornellà de Llobregat;3;7;B;;516;116;240;296;220;0;7;289;296
8;Barcelona;11;Baix Llobregat;08073;Cornellà de Llobregat;3;8;U;;757;170;404;418;339;0;3;415;418
8;Barcelona;11;Baix Llobregat;08073;Cornellà de Llobregat;3;9;A;;475;70;203;236;239;0;0;236;236
8;Barcelona;11;Baix Llobregat;08073;Cornellà de Llobregat;3;9;B;;544;84;212;258;286;0;2;256;258
8;Barcelona;11;Baix Llobregat;08073;Cornellà de Llobregat;4;1;A;;592;131;269;362;230;2;5;355;360
8;Barcelona;11;Baix Llobregat;08073;Cornellà de Llobregat;4;1;B;;694;126;320;457;237;0;4;453;457
8;Barcelona;11;Baix Llobregat;08073;Cornellà de Llobregat;4;10;A;;462;125;228;295;167;2;5;288;293
8;Barcelona;11;Baix Llobregat;08073;Cornellà de Llobregat;4;10;B;;536;128;267;340;196;2;4;334;338
8;Barcelona;11;Baix Llobregat;08073;Cornellà de Llobregat;4;11;A;;477;94;218;285;192;3;1;281;282
8;Barcelona;11;Baix Llobregat;08073;Cornellà de Llobregat;4;11;B;;520;109;258;315;205;0;0;315;315
8;Barcelona;11;Baix Llobregat;08073;Cornellà de Llobregat;4;12;A;;634;189;330;409;225;1;2;406;408
8;Barcelona;11;Baix Llobregat;08073;Cornellà de Llobregat;4;12;B;;694;194;350;424;270;0;2;422;424
8;Barcelona;11;Baix Llobregat;08073;Cornellà de Llobregat;4;13;A;;681;171;350;443;238;0;5;438;443
8;Barcelona;11;Baix Llobregat;08073;Cornellà de Llobregat;4;13;B;;762;197;375;476;286;3;9;464;473
8;Barcelona;11;Baix Llobregat;08073;Cornellà de Llobregat;4;14;A;;492;109;233;305;187;0;1;304;305
8;Barcelona;11;Baix Llobregat;08073;Cornellà de Llobregat;4;14;B;;552;108;221;315;237;0;5;310;315
8;Barcelona;11;Baix Llobregat;08073;Cornellà de Llobregat;4;15;A;;457;102;206;281;176;1;1;279;280
8;Barcelona;11;Baix Llobregat;08073;Cornellà de Llobregat;4;15;B;;568;118;261;350;218;0;6;344;350
8;Barcelona;11;Baix Llobregat;08073;Cornellà de Llobregat;4;16;A;;605;160;285;352;253;0;1;351;352
8;Barcelona;11;Baix Llobregat;08073;Cornellà de Llobregat;4;16;B;;669;150;298;405;264;0;2;403;405
8;Barcelona;11;Baix Llobregat;08073;Cornellà de Llobregat;4;17;A;;598;99;258;370;228;1;4;365;369
8;Barcelona;11;Baix Llobregat;08073;Cornellà de Llobregat;4;17;B;;690;117;300;408;282;1;2;405;407
8;Barcelona;11;Baix Llobregat;08073;Cornellà de Llobregat;4;18;U;;823;197;375;480;343;5;5;470;475
8;Barcelona;11;Baix Llobregat;08073;Cornellà de Llobregat;4;19;U;;831;188;395;499;332;1;0;498;498
8;Barcelona;11;Baix Llobregat;08073;Cornellà de Llobregat;4;2;U;;715;141;350;435;280;2;4;429;433
8;Barcelona;11;Baix Llobregat;08073;Cornellà de Llobregat;4;3;A;;645;147;308;416;229;0;9;407;416
8;Barcelona;11;Baix Llobregat;08073;Cornellà de Llobregat;4;3;B;;753;161;326;447;306;5;6;436;442
8;Barcelona;11;Baix Llobregat;08073;Cornellà de Llobregat;4;4;A;;477;143;266;318;159;1;5;312;317
8;Barcelona;11;Baix Llobregat;08073;Cornellà de Llobregat;4;4;B;;515;144;279;334;181;0;1;333;334
8;Barcelona;11;Baix Llobregat;08073;Cornellà de Llobregat;4;5;A;;430;83;179;265;165;1;2;262;264
8;Barcelona;11;Baix Llobregat;08073;Cornellà de Llobregat;4;5;B;;520;116;240;342;178;2;2;338;340
8;Barcelona;11;Baix Llobregat;08073;Cornellà de Llobregat;4;6;A;;694;119;309;411;283;0;14;397;411
8;Barcelona;11;Baix Llobregat;08073;Cornellà de Llobregat;4;6;B;;746;158;367;454;292;0;6;448;454
8;Barcelona;11;Baix Llobregat;08073;Cornellà de Llobregat;4;7;A;;460;112;223;276;184;0;1;275;276
8;Barcelona;11;Baix Llobregat;08073;Cornellà de Llobregat;4;7;B;;552;94;251;328;224;0;0;328;328
8;Barcelona;11;Baix Llobregat;08073;Cornellà de Llobregat;4;8;A;;665;119;294;388;277;4;0;384;384
8;Barcelona;11;Baix Llobregat;08073;Cornellà de Llobregat;4;8;B;;720;148;302;423;297;1;3;419;422
8;Barcelona;11;Baix Llobregat;08073;Cornellà de Llobregat;4;9;U;;900;214;440;572;328;2;6;564;570
8;Barcelona;11;Baix Llobregat;08073;Cornellà de Llobregat;5;1;U;;740;176;369;443;297;0;6;437;443
8;Barcelona;11;Baix Llobregat;08073;Cornellà de Llobregat;5;10;A;;560;123;240;315;245;1;1;313;314
8;Barcelona;11;Baix Llobregat;08073;Cornellà de Llobregat;5;10;B;;571;141;275;355;216;3;2;350;352
8;Barcelona;11;Baix Llobregat;08073;Cornellà de Llobregat;5;2;U;;760;158;310;405;355;1;8;396;404
8;Barcelona;11;Baix Llobregat;08073;Cornellà de Llobregat;5;3;A;;496;136;239;285;211;0;1;284;285
8;Barcelona;11;Baix Llobregat;08073;Cornellà de Llobregat;5;3;B;;487;117;227;279;208;0;2;277;279
8;Barcelona;11;Baix Llobregat;08073;Cornellà de Llobregat;5;4;U;;771;200;403;449;322;0;4;445;449
8;Barcelona;11;Baix Llobregat;08073;Cornellà de Llobregat;5;5;U;;883;244;419;504;379;3;2;499;501
8;Barcelona;11;Baix Llobregat;08073;Cornellà de Llobregat;5;6;A;;475;121;221;283;192;2;0;281;281
8;Barcelona;11;Baix Llobregat;08073;Cornellà de Llobregat;5;6;B;;539;128;266;335;204;0;2;333;335
8;Barcelona;11;Baix Llobregat;08073;Cornellà de Llobregat;5;7;A;;508;113;240;300;208;0;3;297;300
8;Barcelona;11;Baix Llobregat;08073;Cornellà de Llobregat;5;7;B;;598;163;291;361;237;0;6;355;361
8;Barcelona;11;Baix Llobregat;08073;Cornellà de Llobregat;5;8;A;;483;115;211;267;216;2;3;262;265
8;Barcelona;11;Baix Llobregat;08073;Cornellà de Llobregat;5;8;B;;452;97;205;266;186;0;4;262;266
8;Barcelona;11;Baix Llobregat;08073;Cornellà de Llobregat;5;9;U;;886;222;512;612;274;2;6;604;610
8;Barcelona;11;Baix Llobregat;08073;Cornellà de Llobregat;6;1;U;;657;131;270;344;313;0;1;343;344
8;Barcelona;11;Baix Llobregat;08073;Cornellà de Llobregat;6;10;U;;833;201;402;510;323;1;0;509;509
8;Barcelona;11;Baix Llobregat;08073;Cornellà de Llobregat;6;11;U;;507;114;228;286;221;0;0;286;286
8;Barcelona;11;Baix Llobregat;08073;Cornellà de Llobregat;6;12;U;;765;137;282;387;378;0;4;383;387
8;Barcelona;11;Baix Llobregat;08073;Cornellà de Llobregat;6;13;U;;709;182;349;422;287;7;7;408;415
8;Barcelona;11;Baix Llobregat;08073;Cornellà de Llobregat;6;14;U;;924;172;389;499;425;0;10;489;499
8;Barcelona;11;Baix Llobregat;08073;Cornellà de Llobregat;6;15;U;;783;148;358;490;293;2;8;480;488
8;Barcelona;11;Baix Llobregat;08073;Cornellà de Llobregat;6;16;U;;673;130;292;367;306;2;2;363;365
8;Barcelona;11;Baix Llobregat;08073;Cornellà de Llobregat;6;2;A;;471;99;207;279;192;2;5;272;277
8;Barcelona;11;Baix Llobregat;08073;Cornellà de Llobregat;6;2;B;;545;132;293;362;183;1;2;359;361
8;Barcelona;11;Baix Llobregat;08073;Cornellà de Llobregat;6;3;U;;550;152;281;335;215;0;8;327;335
8;Barcelona;11;Baix Llobregat;08073;Cornellà de Llobregat;6;4;U;;678;152;271;356;322;0;1;355;356
8;Barcelona;11;Baix Llobregat;08073;Cornellà de Llobregat;6;5;U;;742;167;359;447;295;6;3;438;441
8;Barcelona;11;Baix Llobregat;08073;Cornellà de Llobregat;6;6;U;;618;138;293;350;268;1;4;345;349
8;Barcelona;11;Baix Llobregat;08073;Cornellà de Llobregat;6;7;A;;471;87;211;278;193;1;4;273;277
8;Barcelona;11;Baix Llobregat;08073;Cornellà de Llobregat;6;7;B;;526;96;225;294;232;0;3;291;294
8;Barcelona;11;Baix Llobregat;08073;Cornellà de Llobregat;6;8;U;;682;138;315;380;302;0;7;373;380
8;Barcelona;11;Baix Llobregat;08073;Cornellà de Llobregat;6;9;A;;560;113;255;342;218;2;0;340;340
8;Barcelona;11;Baix Llobregat;08073;Cornellà de Llobregat;6;9;B;;724;155;349;456;268;0;4;452;456
8;Barcelona;11;Baix Llobregat;08073;Cornellà de Llobregat;6;9;C;;641;133;300;420;221;0;4;416;420
17;Girona;28;Pla de l'Estany;17056;Cornellà del Terri;1;1;A;;701;199;422;513;188;2;2;509;511
17;Girona;28;Pla de l'Estany;17056;Cornellà del Terri;1;1;B;;735;208;437;527;208;5;5;517;522
43;Tarragona;29;Priorat;43049;Cornudella de Montsant;1;1;U;;737;258;464;580;157;7;12;561;573
43;Tarragona;36;Tarragonès;43050;Creixell;1;1;A;;543;130;282;349;194;1;2;346;348
43;Tarragona;36;Tarragonès;43050;Creixell;1;1;B;;585;193;316;377;208;1;2;374;376
17;Girona;28;Pla de l'Estany;17058;Crespià;1;1;U;;174;51;98;105;69;0;0;105;105
17;Girona;10;Baix Empordà;17901;Cruïlles, Monells i Sant Sadurní;1;1;A;;468;154;279;332;136;0;4;328;332
17;Girona;10;Baix Empordà;17901;Cruïlles, Monells i Sant Sadurní;1;1;B;;190;61;130;145;45;0;1;144;145
17;Girona;10;Baix Empordà;17901;Cruïlles, Monells i Sant Sadurní;1;1;C;;197;64;122;147;50;2;1;144;145
8;Barcelona;17;Garraf;08074;Cubelles;1;1;U;;572;170;308;374;198;6;1;367;368
8;Barcelona;17;Garraf;08074;Cubelles;1;2;U;;1251;325;629;798;453;4;8;786;794
8;Barcelona;17;Garraf;08074;Cubelles;1;3;U;;1624;416;823;1004;620;2;3;999;1002
25;Lleida;23;Noguera;25079;Cubells;1;1;U;;327;89;211;264;63;2;2;260;262
43;Tarragona;12;Baix Penedès;43051;Cunit;1;1;A;;694;210;322;408;286;8;3;397;400
43;Tarragona;12;Baix Penedès;43051;Cunit;1;1;B;;762;215;380;439;323;3;6;430;436
43;Tarragona;12;Baix Penedès;43051;Cunit;1;2;A;;920;221;363;453;467;9;2;442;444
43;Tarragona;12;Baix Penedès;43051;Cunit;1;2;B;;935;260;405;508;427;4;8;496;504
17;Girona;2;Alt Empordà;17060;Darnius;1;1;U;;418;159;300;327;91;3;5;319;324
17;Girona;15;Cerdanya;17061;Das;1;1;U;;121;28;89;100;21;0;4;96;100
43;Tarragona;9;Baix Ebre;43901;Deltebre;1;1;A;;767;171;366;474;293;0;3;471;474
43;Tarragona;9;Baix Ebre;43901;Deltebre;1;1;B;;655;162;314;397;258;0;3;394;397
43;Tarragona;9;Baix Ebre;43901;Deltebre;1;2;A;;1036;245;478;611;425;1;0;610;610
43;Tarragona;9;Baix Ebre;43901;Deltebre;1;2;B;;806;201;371;479;327;1;2;476;478
43;Tarragona;9;Baix Ebre;43901;Deltebre;1;3;A;;619;180;319;398;221;0;2;396;398
43;Tarragona;9;Baix Ebre;43901;Deltebre;1;3;B;;470;136;248;293;177;2;1;290;291
43;Tarragona;9;Baix Ebre;43901;Deltebre;1;4;A;;793;200;400;488;305;5;5;478;483
43;Tarragona;9;Baix Ebre;43901;Deltebre;1;4;B;;498;119;229;291;207;1;3;287;290
43;Tarragona;9;Baix Ebre;43901;Deltebre;1;5;A;;664;132;301;414;250;0;3;411;414
43;Tarragona;9;Baix Ebre;43901;Deltebre;1;5;B;;580;128;280;356;224;1;0;355;355
43;Tarragona;9;Baix Ebre;43901;Deltebre;1;6;A;;839;190;405;527;312;2;0;525;525
43;Tarragona;9;Baix Ebre;43901;Deltebre;1;6;B;;657;146;323;407;250;1;3;403;406
8;Barcelona;21;Maresme;08075;Dosrius;1;1;A;;602;162;339;410;192;1;4;405;409
8;Barcelona;21;Maresme;08075;Dosrius;1;1;B;;537;133;305;368;169;0;2;366;368
8;Barcelona;21;Maresme;08075;Dosrius;1;1;C;;596;154;306;373;223;1;7;365;372
43;Tarragona;8;Baix Camp;43053;Duesaigües;1;1;U;;180;48;116;142;38;0;2;140;142
17;Girona;2;Alt Empordà;17062;Escala, l';1;1;U;;956;283;562;653;303;2;3;648;651
17;Girona;2;Alt Empordà;17062;Escala, l';1;2;A;;820;226;448;521;299;3;2;516;518
17;Girona;2;Alt Empordà;17062;Escala, l';1;2;B;;794;205;392;466;328;2;1;463;464
17;Girona;2;Alt Empordà;17062;Escala, l';1;3;U;;1087;310;623;712;375;2;4;706;710
17;Girona;2;Alt Empordà;17062;Escala, l';1;4;U;;762;250;443;520;242;2;2;516;518
8;Barcelona;11;Baix Llobregat;08076;Esparreguera;1;1;A;;683;181;364;452;231;0;7;445;452
8;Barcelona;11;Baix Llobregat;08076;Esparreguera;1;1;B;;727;182;355;444;283;0;0;444;444
8;Barcelona;11;Baix Llobregat;08076;Esparreguera;1;2;A;;533;147;268;358;175;0;2;356;358
8;Barcelona;11;Baix Llobregat;08076;Esparreguera;1;2;B;;694;174;356;476;218;2;6;468;474
8;Barcelona;11;Baix Llobregat;08076;Esparreguera;1;3;A;;583;150;330;412;171;1;5;406;411
8;Barcelona;11;Baix Llobregat;08076;Esparreguera;1;3;B;;802;254;473;582;220;1;3;578;581
8;Barcelona;11;Baix Llobregat;08076;Esparreguera;1;4;A;;553;155;318;388;165;1;1;386;387
8;Barcelona;11;Baix Llobregat;08076;Esparreguera;1;4;B;;674;160;349;433;241;0;4;429;433
8;Barcelona;11;Baix Llobregat;08076;Esparreguera;1;5;U;;694;158;332;425;269;2;1;422;423
8;Barcelona;11;Baix Llobregat;08076;Esparreguera;2;1;A;;623;160;320;403;220;4;5;394;399
8;Barcelona;11;Baix Llobregat;08076;Esparreguera;2;1;B;;765;188;390;485;280;2;6;477;483
8;Barcelona;11;Baix Llobregat;08076;Esparreguera;2;2;A;;890;225;443;527;363;1;3;523;526
8;Barcelona;11;Baix Llobregat;08076;Esparreguera;2;2;B;;1031;268;488;612;419;1;6;605;611
8;Barcelona;11;Baix Llobregat;08076;Esparreguera;2;3;U;;968;218;510;652;316;0;3;649;652
8;Barcelona;11;Baix Llobregat;08076;Esparreguera;2;4;U;;950;248;513;627;323;2;5;620;625
17;Girona;24;Osona;17063;Espinelves;1;1;U;;157;66;109;128;29;0;1;127;128
25;Lleida;18;Garrigues;25081;Espluga Calba, l';1;1;U;;371;68;181;255;116;1;3;251;254
43;Tarragona;16;Conca de Barberà;43054;Espluga de Francolí, l';1;1;A;;604;129;296;437;167;2;3;432;435
43;Tarragona;16;Conca de Barberà;43054;Espluga de Francolí, l';1;1;B;;421;101;218;290;131;4;2;284;286
43;Tarragona;16;Conca de Barberà;43054;Espluga de Francolí, l';1;1;C;;734;163;377;516;218;2;5;509;514
43;Tarragona;16;Conca de Barberà;43054;Espluga de Francolí, l';2;1;A;;485;97;223;317;168;1;2;314;316
43;Tarragona;16;Conca de Barberà;43054;Espluga de Francolí, l';2;1;B;;671;129;304;421;250;2;0;419;419
8;Barcelona;11;Baix Llobregat;08077;Esplugues de Llobregat;1;1;A;;629;141;286;383;246;0;6;377;383
8;Barcelona;11;Baix Llobregat;08077;Esplugues de Llobregat;1;1;B;;796;161;362;479;317;2;10;467;477
8;Barcelona;11;Baix Llobregat;08077;Esplugues de Llobregat;1;2;A;;897;224;438;567;330;1;12;554;566
8;Barcelona;11;Baix Llobregat;08077;Esplugues de Llobregat;1;2;B;;984;242;489;626;358;0;4;622;626
8;Barcelona;11;Baix Llobregat;08077;Esplugues de Llobregat;1;3;U;;1018;254;488;621;397;0;6;615;621
8;Barcelona;11;Baix Llobregat;08077;Esplugues de Llobregat;1;4;A;;569;148;310;393;176;0;8;385;393
8;Barcelona;11;Baix Llobregat;08077;Esplugues de Llobregat;1;4;B;;613;170;325;426;187;0;6;420;426
8;Barcelona;11;Baix Llobregat;08077;Esplugues de Llobregat;1;5;A;;780;192;415;563;217;0;11;552;563
8;Barcelona;11;Baix Llobregat;08077;Esplugues de Llobregat;1;5;B;;861;209;498;637;224;1;15;621;636
8;Barcelona;11;Baix Llobregat;08077;Esplugues de Llobregat;1;6;A;;576;576;288;365;211;3;2;360;362
8;Barcelona;11;Baix Llobregat;08077;Esplugues de Llobregat;1;6;B;;653;137;319;418;235;0;4;414;418
8;Barcelona;11;Baix Llobregat;08077;Esplugues de Llobregat;1;7;A;;603;136;305;399;204;0;1;398;399
8;Barcelona;11;Baix Llobregat;08077;Esplugues de Llobregat;1;7;B;;584;143;301;408;176;1;6;401;407
8;Barcelona;11;Baix Llobregat;08077;Esplugues de Llobregat;1;8;U;;695;172;344;432;263;0;3;429;432
8;Barcelona;11;Baix Llobregat;08077;Esplugues de Llobregat;2;1;U;;913;214;485;625;288;1;18;606;624
8;Barcelona;11;Baix Llobregat;08077;Esplugues de Llobregat;2;2;U;;744;139;365;513;231;0;20;493;513
8;Barcelona;11;Baix Llobregat;08077;Esplugues de Llobregat;3;1;A;;596;155;305;395;201;1;5;389;394
8;Barcelona;11;Baix Llobregat;08077;Esplugues de Llobregat;3;1;B;;744;188;360;471;273;2;3;466;469
8;Barcelona;11;Baix Llobregat;08077;Esplugues de Llobregat;3;1;C;;767;179;370;456;311;0;12;444;456
8;Barcelona;11;Baix Llobregat;08077;Esplugues de Llobregat;3;2;A;;653;113;311;389;264;0;2;387;389
8;Barcelona;11;Baix Llobregat;08077;Esplugues de Llobregat;3;2;B;;788;162;389;491;297;1;4;486;490
8;Barcelona;11;Baix Llobregat;08077;Esplugues de Llobregat;3;3;A;;676;150;297;384;292;1;4;379;383
8;Barcelona;11;Baix Llobregat;08077;Esplugues de Llobregat;3;3;B;;768;192;323;422;346;0;8;414;422
8;Barcelona;11;Baix Llobregat;08077;Esplugues de Llobregat;3;3;C;;680;171;337;433;247;0;5;428;433
8;Barcelona;11;Baix Llobregat;08077;Esplugues de Llobregat;3;4;A;;555;155;235;308;247;2;0;306;306
8;Barcelona;11;Baix Llobregat;08077;Esplugues de Llobregat;3;4;B;;723;170;306;399;324;2;3;394;397
8;Barcelona;11;Baix Llobregat;08077;Esplugues de Llobregat;3;5;A;;610;168;273;329;281;3;4;322;326
8;Barcelona;11;Baix Llobregat;08077;Esplugues de Llobregat;3;5;B;;621;150;270;341;280;3;1;337;338
8;Barcelona;11;Baix Llobregat;08077;Esplugues de Llobregat;3;6;A;;809;192;372;473;336;3;6;464;470
8;Barcelona;11;Baix Llobregat;08077;Esplugues de Llobregat;3;6;B;;890;179;390;511;379;4;6;501;507
8;Barcelona;11;Baix Llobregat;08077;Esplugues de Llobregat;3;7;A;;643;153;295;392;251;0;6;386;392
8;Barcelona;11;Baix Llobregat;08077;Esplugues de Llobregat;3;7;B;;859;173;383;497;362;1;4;492;496
8;Barcelona;11;Baix Llobregat;08077;Esplugues de Llobregat;3;7;C;;712;167;333;428;284;0;6;422;428
8;Barcelona;11;Baix Llobregat;08077;Esplugues de Llobregat;3;8;A;;504;105;239;302;202;0;3;299;302
8;Barcelona;11;Baix Llobregat;08077;Esplugues de Llobregat;3;8;B;;602;143;294;369;233;0;3;366;369
8;Barcelona;11;Baix Llobregat;08077;Esplugues de Llobregat;4;1;A;;509;116;249;326;183;0;2;324;326
8;Barcelona;11;Baix Llobregat;08077;Esplugues de Llobregat;4;1;B;;633;163;322;407;226;0;8;399;407
8;Barcelona;11;Baix Llobregat;08077;Esplugues de Llobregat;4;2;A;;970;191;440;574;396;1;10;563;573
8;Barcelona;11;Baix Llobregat;08077;Esplugues de Llobregat;4;2;B;;987;190;444;594;393;0;10;584;594
8;Barcelona;11;Baix Llobregat;08077;Esplugues de Llobregat;4;3;A;;744;138;325;438;306;0;3;435;438
8;Barcelona;11;Baix Llobregat;08077;Esplugues de Llobregat;4;3;B;;923;146;380;540;383;1;7;532;539
8;Barcelona;11;Baix Llobregat;08077;Esplugues de Llobregat;4;4;A;;932;207;438;597;335;3;6;588;594
8;Barcelona;11;Baix Llobregat;08077;Esplugues de Llobregat;4;4;B;;1083;228;488;663;420;0;7;656;663
8;Barcelona;11;Baix Llobregat;08077;Esplugues de Llobregat;4;5;A;;730;141;341;452;278;0;5;447;452
8;Barcelona;11;Baix Llobregat;08077;Esplugues de Llobregat;4;5;B;;862;170;397;534;328;2;12;520;532
8;Barcelona;11;Baix Llobregat;08077;Esplugues de Llobregat;4;6;A;;632;127;299;409;223;1;3;405;408
8;Barcelona;11;Baix Llobregat;08077;Esplugues de Llobregat;4;6;B;;676;116;319;403;273;2;11;390;401
8;Barcelona;11;Baix Llobregat;08077;Esplugues de Llobregat;4;7;A;;584;120;264;335;249;0;7;328;335
8;Barcelona;11;Baix Llobregat;08077;Esplugues de Llobregat;4;7;B;;721;131;334;439;282;3;6;430;436
8;Barcelona;11;Baix Llobregat;08077;Esplugues de Llobregat;5;1;A;;753;156;360;460;293;1;4;455;459
8;Barcelona;11;Baix Llobregat;08077;Esplugues de Llobregat;5;1;B;;777;160;348;472;305;1;6;465;471
8;Barcelona;11;Baix Llobregat;08077;Esplugues de Llobregat;5;2;A;;660;122;312;423;237;0;5;418;423
8;Barcelona;11;Baix Llobregat;08077;Esplugues de Llobregat;5;2;B;;753;145;364;482;271;1;6;475;481
17;Girona;2;Alt Empordà;17064;Espolla;1;1;U;;335;101;203;254;81;0;4;250;254
17;Girona;28;Pla de l'Estany;17065;Esponellà;1;1;U;;300;106;206;222;78;0;4;218;222
25;Lleida;26;Pallars Sobirà;25082;Espot;1;1;U;;224;42;125;150;74;0;0;150;150
8;Barcelona;14;Berguedà;08078;Espunyola, l';1;1;U;;244;69;103;140;104;0;1;139;140
8;Barcelona;24;Osona;08254;Esquirol, l';1;1;A;;1245;291;825;919;326;2;4;913;917
8;Barcelona;24;Osona;08254;Esquirol, l';1;1;B;;210;88;143;166;44;0;0;166;166
8;Barcelona;24;Osona;08254;Esquirol, l';1;1;C;;254;90;135;179;75;0;3;176;179
25;Lleida;4;Alt Urgell;25088;Estamariu;1;1;U;;115;25;84;97;18;0;0;97;97
8;Barcelona;;;08079;Estany, l';1;1;U;;327;109;243;270;57;1;7;262;269
25;Lleida;32;Segarra;25085;Estaràs;1;1;U;;142;42;69;99;43;1;2;96;98
25;Lleida;26;Pallars Sobirà;25086;Esterri d'Àneu;1;1;U;;468;147;282;345;123;1;2;342;344
25;Lleida;26;Pallars Sobirà;25087;Esterri de Cardós;1;1;U;;61;8;36;43;18;0;0;43;43
43;Tarragona;29;Priorat;43055;Falset;1;1;A;;406;118;253;322;84;0;5;317;322
43;Tarragona;29;Priorat;43055;Falset;1;1;B;;513;147;333;411;102;2;4;405;409
43;Tarragona;29;Priorat;43055;Falset;2;1;A;;505;114;299;385;120;0;5;380;385
43;Tarragona;29;Priorat;43055;Falset;2;1;B;;622;151;389;487;135;5;3;479;482
17;Girona;2;Alt Empordà;17005;Far d'Empordà, el;1;1;U;;341;92;195;227;114;1;1;225;226
25;Lleida;26;Pallars Sobirà;25089;Farrera;1;1;U;;67;8;28;42;25;0;0;42;42
43;Tarragona;37;Terra Alta;43056;Fatarella, la;1;1;U;;486;88;195;268;218;3;1;264;265
43;Tarragona;37;Terra Alta;43056;Fatarella, la;1;2;U;;654;105;268;378;276;0;4;374;378
43;Tarragona;8;Baix Camp;43057;Febró, la;1;1;U;;51;15;26;33;18;0;0;33;33
8;Barcelona;41;Vallès Oriental;08134;Figaró-Montmany;1;1;U;;544;157;361;411;133;0;1;410;411
8;Barcelona;14;Berguedà;08080;Fígols;1;1;U;;51;23;28;39;12;0;0;39;39
25;Lleida;4;Alt Urgell;25908;Fígols i Alinyà;1;1;U;;294;72;138;212;82;3;1;208;209
43;Tarragona;29;Priorat;43058;Figuera, la;1;1;U;;108;30;65;87;21;0;0;87;87
17;Girona;2;Alt Empordà;17066;Figueres;1;1;A;;638;174;285;369;269;0;5;364;369
17;Girona;2;Alt Empordà;17066;Figueres;1;1;B;;559;140;256;309;250;0;4;305;309
17;Girona;2;Alt Empordà;17066;Figueres;1;1;C;;621;147;276;341;280;1;1;339;340
17;Girona;2;Alt Empordà;17066;Figueres;1;2;A;;431;115;221;260;171;2;0;258;258
17;Girona;2;Alt Empordà;17066;Figueres;1;2;B;;474;157;271;331;143;0;9;322;331
17;Girona;2;Alt Empordà;17066;Figueres;1;3;A;;595;142;277;334;261;0;4;330;334
17;Girona;2;Alt Empordà;17066;Figueres;1;3;B;;594;150;271;328;266;1;3;324;327
17;Girona;2;Alt Empordà;17066;Figueres;1;4;A;;737;195;352;429;308;0;2;427;429
17;Girona;2;Alt Empordà;17066;Figueres;1;4;B;;689;170;325;379;310;4;6;369;375
17;Girona;2;Alt Empordà;17066;Figueres;1;5;A;;572;119;260;315;257;0;1;314;315
17;Girona;2;Alt Empordà;17066;Figueres;1;5;B;;495;116;242;291;204;0;4;287;291
17;Girona;2;Alt Empordà;17066;Figueres;1;6;U;;746;228;384;442;304;2;5;435;440
17;Girona;2;Alt Empordà;17066;Figueres;2;1;U;;711;199;356;456;255;0;8;448;456
17;Girona;2;Alt Empordà;17066;Figueres;2;2;A;;551;156;267;321;230;0;4;317;321
17;Girona;2;Alt Empordà;17066;Figueres;2;2;B;;457;138;238;284;173;0;1;283;284
17;Girona;2;Alt Empordà;17066;Figueres;2;3;A;;1030;250;487;576;454;4;5;567;572
17;Girona;2;Alt Empordà;17066;Figueres;2;3;B;;924;230;419;484;440;1;8;475;483
17;Girona;2;Alt Empordà;17066;Figueres;2;4;U;;1221;253;564;701;520;1;5;695;700
17;Girona;2;Alt Empordà;17066;Figueres;3;1;U;;746;277;375;461;285;0;7;454;461
17;Girona;2;Alt Empordà;17066;Figueres;3;2;U;;640;216;348;427;213;2;5;420;425
17;Girona;2;Alt Empordà;17066;Figueres;3;3;A;;821;216;399;494;327;3;4;487;491
17;Girona;2;Alt Empordà;17066;Figueres;3;3;B;;749;205;350;465;284;3;4;458;462
17;Girona;2;Alt Empordà;17066;Figueres;3;4;A;;754;133;295;370;384;3;4;363;367
17;Girona;2;Alt Empordà;17066;Figueres;3;4;B;;633;113;259;319;314;1;5;313;318
17;Girona;2;Alt Empordà;17066;Figueres;3;5;A;;572;165;293;367;205;3;1;363;364
17;Girona;2;Alt Empordà;17066;Figueres;3;5;B;;536;139;311;350;186;3;5;342;347
17;Girona;2;Alt Empordà;17066;Figueres;4;1;A;;650;232;371;421;229;1;2;418;420
17;Girona;2;Alt Empordà;17066;Figueres;4;1;B;;585;177;310;369;216;3;7;359;366
17;Girona;2;Alt Empordà;17066;Figueres;4;2;A;;601;171;311;392;209;1;9;382;391
17;Girona;2;Alt Empordà;17066;Figueres;4;2;B;;589;166;301;383;206;1;2;380;382
17;Girona;2;Alt Empordà;17066;Figueres;4;3;U;;632;136;274;349;283;3;5;341;346
17;Girona;2;Alt Empordà;17066;Figueres;4;4;A;;546;162;212;347;199;2;6;339;345
17;Girona;2;Alt Empordà;17066;Figueres;4;4;B;;462;139;247;287;175;0;4;283;287
17;Girona;2;Alt Empordà;17066;Figueres;4;4;C;;536;140;282;345;191;2;0;343;343
17;Girona;2;Alt Empordà;17066;Figueres;4;5;A;;825;228;428;487;338;1;3;483;486
17;Girona;2;Alt Empordà;17066;Figueres;4;5;B;;757;212;408;467;290;1;12;454;466
17;Girona;2;Alt Empordà;17066;Figueres;4;6;U;;484;116;224;283;201;0;4;279;283
17;Girona;2;Alt Empordà;17066;Figueres;4;7;U;;597;119;298;384;213;0;9;375;384
17;Girona;2;Alt Empordà;17066;Figueres;4;8;A;;751;218;381;462;289;3;7;452;459
17;Girona;2;Alt Empordà;17066;Figueres;4;8;B;;648;180;335;412;236;2;2;408;410
17;Girona;2;Alt Empordà;17066;Figueres;4;9;U;;817;228;416;535;282;1;5;529;534
43;Tarragona;1;Alt Camp;43059;Figuerola del Camp;1;1;U;;187;58;61;156;31;0;0;156;156
17;Girona;20;Gironès;17067;Flaçà;1;1;U;;732;269;491;558;174;1;4;553;557
43;Tarragona;30;Ribera d'Ebre;43060;Flix;1;1;A;;563;207;347;432;131;1;3;428;431
43;Tarragona;30;Ribera d'Ebre;43060;Flix;1;1;B;;629;209;376;457;172;0;3;454;457
43;Tarragona;30;Ribera d'Ebre;43060;Flix;1;2;A;;645;214;360;485;160;1;4;480;484
43;Tarragona;30;Ribera d'Ebre;43060;Flix;1;2;B;;694;218;391;512;182;0;4;508;512
43;Tarragona;30;Ribera d'Ebre;43060;Flix;2;1;A;;567;156;336;412;155;3;1;408;409
43;Tarragona;30;Ribera d'Ebre;43060;Flix;2;1;B;;596;162;363;450;146;1;5;444;449
25;Lleida;18;Garrigues;25092;Floresta, la;1;1;U;;170;36;102;121;49;0;0;121;121
8;Barcelona;34;Selva;08082;Fogars de la Selva;1;1;U;;458;118;210;260;198;0;1;259;260
8;Barcelona;41;Vallès Oriental;08081;Fogars de Montclús;1;1;U;;239;73;117;170;69;0;0;170;170
17;Girona;10;Baix Empordà;17068;Foixà;1;1;U;;273;98;169;198;75;1;0;197;197
8;Barcelona;24;Osona;08083;Folgueroles;1;1;U;;1010;311;705;833;177;2;5;826;831
25;Lleida;27;Pla d'Urgell;25093;Fondarella;1;1;U;;518;133;284;358;160;0;4;354;358
8;Barcelona;7;Bages;08084;Fonollosa;1;1;A;;312;69;192;243;69;1;1;241;242
8;Barcelona;7;Bages;08084;Fonollosa;1;1;B;;306;81;152;192;114;0;4;188;192
17;Girona;15;Cerdanya;17069;Fontanals de Cerdanya;1;1;U;;301;96;208;228;73;1;2;225;227
17;Girona;10;Baix Empordà;17070;Fontanilles;1;1;U;;106;28;68;82;24;0;0;82;82
17;Girona;28;Pla de l'Estany;17071;Fontcoberta;1;1;U;;786;239;516;604;182;1;9;594;603
8;Barcelona;3;Alt Penedès;08085;Font-rubí;1;1;U;;1001;186;515;717;284;2;6;709;715
25;Lleida;23;Noguera;25094;Foradada;1;1;U;;154;24;94;120;34;1;0;119;119
17;Girona;10;Baix Empordà;17902;Forallac;1;1;U;;708;237;477;535;173;0;2;533;535
17;Girona;10;Baix Empordà;17902;Forallac;1;2;A;;334;112;206;236;98;0;4;232;236
17;Girona;10;Baix Empordà;17902;Forallac;1;2;B;;261;88;174;210;51;0;1;209;210
43;Tarragona;16;Conca de Barberà;43061;Forès;1;1;U;;60;23;37;41;19;0;1;40;41
17;Girona;20;Gironès;17073;Fornells de la Selva;1;1;U;;959;267;550;751;208;2;6;743;749
17;Girona;2;Alt Empordà;17074;Fortià;1;1;U;;435;121;242;274;161;0;4;270;274
8;Barcelona;41;Vallès Oriental;08086;Franqueses del Vallès, les;1;1;A;;739;181;422;542;197;3;8;531;539
8;Barcelona;41;Vallès Oriental;08086;Franqueses del Vallès, les;1;1;B;;645;127;350;439;206;1;6;432;438
8;Barcelona;41;Vallès Oriental;08086;Franqueses del Vallès, les;1;2;A;;565;112;222;314;251;0;3;311;314
8;Barcelona;41;Vallès Oriental;08086;Franqueses del Vallès, les;1;2;B;;693;158;318;395;298;2;4;389;393
8;Barcelona;41;Vallès Oriental;08086;Franqueses del Vallès, les;1;2;C;;680;160;326;395;285;1;5;389;394
8;Barcelona;41;Vallès Oriental;08086;Franqueses del Vallès, les;1;3;A;;606;125;255;325;281;0;7;318;325
8;Barcelona;41;Vallès Oriental;08086;Franqueses del Vallès, les;1;3;B;;589;108;253;315;274;1;1;313;314
8;Barcelona;41;Vallès Oriental;08086;Franqueses del Vallès, les;1;3;C;;670;134;287;363;307;2;6;355;361
8;Barcelona;41;Vallès Oriental;08086;Franqueses del Vallès, les;1;4;A;;717;128;342;428;289;1;8;419;427
8;Barcelona;41;Vallès Oriental;08086;Franqueses del Vallès, les;1;4;B;;596;110;297;354;242;0;3;351;354
8;Barcelona;41;Vallès Oriental;08086;Franqueses del Vallès, les;1;5;U;;864;127;344;468;396;0;7;461;468
8;Barcelona;41;Vallès Oriental;08086;Franqueses del Vallès, les;2;1;A;;548;148;308;377;171;2;3;372;375
8;Barcelona;41;Vallès Oriental;08086;Franqueses del Vallès, les;2;1;B;;552;137;298;385;167;1;6;378;384
43;Tarragona;22;Montsià;43062;Freginals;1;1;U;;309;119;216;253;56;2;3;248;251
25;Lleida;38;Urgell;25096;Fuliola, la;1;1;U;;1068;235;606;759;309;2;8;749;757
25;Lleida;18;Garrigues;25097;Fulleda;1;1;U;;103;25;52;73;30;0;0;73;73
8;Barcelona;7;Bages;08090;Gaià;1;1;U;;134;40;79;98;36;0;2;96;98
43;Tarragona;22;Montsià;43063;Galera, la;1;1;U;;641;173;299;417;224;2;3;412;415
8;Barcelona;40;Vallès Occidental;08087;Gallifa;1;1;U;;105;38;75;88;17;0;1;87;88
43;Tarragona;37;Terra Alta;43064;Gandesa;1;1;A;;622;186;342;473;149;3;8;462;470
43;Tarragona;37;Terra Alta;43064;Gandesa;1;1;B;;689;161;380;519;170;2;6;511;517
43;Tarragona;37;Terra Alta;43064;Gandesa;2;1;U;;888;227;502;682;206;4;4;674;678
43;Tarragona;30;Ribera d'Ebre;43065;Garcia;1;1;U;;476;96;296;383;93;2;1;380;381
43;Tarragona;1;Alt Camp;43066;Garidells, els;1;1;U;;134;35;79;107;27;1;0;106;106
8;Barcelona;41;Vallès Oriental;08088;Garriga, la;1;1;U;;1428;393;799;1004;424;3;10;991;1001
8;Barcelona;41;Vallès Oriental;08088;Garriga, la;1;2;A;;1131;278;572;703;428;3;6;694;700
8;Barcelona;41;Vallès Oriental;08088;Garriga, la;1;2;B;;1035;222;517;641;394;1;7;633;640
8;Barcelona;41;Vallès Oriental;08088;Garriga, la;2;1;U;;1543;352;905;1153;390;5;9;1139;1148
8;Barcelona;41;Vallès Oriental;08088;Garriga, la;2;2;U;;1448;371;783;980;468;4;10;966;976
8;Barcelona;41;Vallès Oriental;08088;Garriga, la;2;3;U;;1492;344;774;989;503;3;11;975;986
17;Girona;2;Alt Empordà;17075;Garrigàs;1;1;U;;266;75;176;196;70;0;6;190;196
17;Girona;10;Baix Empordà;17076;Garrigoles;1;1;U;;119;39;68;84;35;0;2;82;84
17;Girona;2;Alt Empordà;17077;Garriguella;1;1;U;;564;172;330;391;173;3;2;386;388
8;Barcelona;11;Baix Llobregat;08089;Gavà;1;1;A;;577;151;283;344;233;2;6;336;342
8;Barcelona;11;Baix Llobregat;08089;Gavà;1;1;B;;625;142;304;374;251;0;4;370;374
8;Barcelona;11;Baix Llobregat;08089;Gavà;1;2;A;;643;157;327;403;240;1;2;400;402
8;Barcelona;11;Baix Llobregat;08089;Gavà;1;2;B;;743;188;385;478;265;0;9;469;478
8;Barcelona;11;Baix Llobregat;08089;Gavà;1;3;A;;623;185;332;395;228;0;0;395;395
8;Barcelona;11;Baix Llobregat;08089;Gavà;1;3;B;;578;169;299;354;224;4;2;348;350
8;Barcelona;11;Baix Llobregat;08089;Gavà;1;3;C;;666;190;348;427;239;0;2;425;427
8;Barcelona;11;Baix Llobregat;08089;Gavà;1;4;A;;788;182;388;478;310;0;7;471;478
8;Barcelona;11;Baix Llobregat;08089;Gavà;1;4;B;;880;200;402;511;369;0;0;511;511
8;Barcelona;11;Baix Llobregat;08089;Gavà;1;5;U;;986;208;408;547;439;1;1;545;546
8;Barcelona;11;Baix Llobregat;08089;Gavà;1;6;U;;658;151;266;344;314;0;2;342;344
8;Barcelona;11;Baix Llobregat;08089;Gavà;1;7;U;;1184;285;631;749;435;2;9;738;747
8;Barcelona;11;Baix Llobregat;08089;Gavà;2;1;A;;810;156;383;488;322;0;2;486;488
8;Barcelona;11;Baix Llobregat;08089;Gavà;2;1;B;;930;223;467;594;336;0;5;589;594
8;Barcelona;11;Baix Llobregat;08089;Gavà;2;2;U;;885;182;429;547;338;0;3;544;547
8;Barcelona;11;Baix Llobregat;08089;Gavà;2;3;A;;403;97;195;249;154;0;1;248;249
8;Barcelona;11;Baix Llobregat;08089;Gavà;2;3;B;;399;120;210;261;138;0;2;259;261
8;Barcelona;11;Baix Llobregat;08089;Gavà;2;4;A;;674;133;276;342;332;0;1;341;342
8;Barcelona;11;Baix Llobregat;08089;Gavà;2;4;B;;858;153;335;422;436;1;1;420;421
8;Barcelona;11;Baix Llobregat;08089;Gavà;2;5;U;;728;122;260;315;413;0;0;315;315
8;Barcelona;11;Baix Llobregat;08089;Gavà;2;6;A;;795;160;313;400;395;1;6;393;399
8;Barcelona;11;Baix Llobregat;08089;Gavà;2;6;B;;902;167;356;418;484;1;4;413;417
8;Barcelona;11;Baix Llobregat;08089;Gavà;2;7;U;;800;183;369;470;330;0;3;467;470
8;Barcelona;11;Baix Llobregat;08089;Gavà;2;8;A;;708;122;255;379;329;1;7;371;378
8;Barcelona;11;Baix Llobregat;08089;Gavà;2;8;B;;740;134;294;396;344;0;4;392;396
8;Barcelona;11;Baix Llobregat;08089;Gavà;2;9;A;;616;120;268;352;264;1;2;349;351
8;Barcelona;11;Baix Llobregat;08089;Gavà;2;9;B;;728;144;320;406;322;1;3;402;405
8;Barcelona;11;Baix Llobregat;08089;Gavà;3;1;A;;559;124;263;328;231;0;3;325;328
8;Barcelona;11;Baix Llobregat;08089;Gavà;3;1;B;;591;137;278;334;257;0;7;327;334
8;Barcelona;11;Baix Llobregat;08089;Gavà;3;2;U;;943;215;417;561;382;3;4;554;558
8;Barcelona;11;Baix Llobregat;08089;Gavà;3;3;A;;561;116;225;290;271;1;3;286;289
8;Barcelona;11;Baix Llobregat;08089;Gavà;3;3;B;;578;124;255;321;257;1;5;315;320
8;Barcelona;11;Baix Llobregat;08089;Gavà;3;4;A;;572;122;226;281;291;1;4;276;280
8;Barcelona;11;Baix Llobregat;08089;Gavà;3;4;B;;693;132;253;331;362;1;4;326;330
8;Barcelona;11;Baix Llobregat;08089;Gavà;3;5;A;;934;175;381;454;480;1;4;449;453
8;Barcelona;11;Baix Llobregat;08089;Gavà;3;5;B;;896;180;400;482;414;2;2;478;480
8;Barcelona;11;Baix Llobregat;08089;Gavà;3;6;U;;927;240;464;555;372;0;3;552;555
8;Barcelona;11;Baix Llobregat;08089;Gavà;4;1;A;;800;200;396;472;328;0;3;469;472
8;Barcelona;11;Baix Llobregat;08089;Gavà;4;1;B;;983;221;450;592;391;1;6;585;591
8;Barcelona;11;Baix Llobregat;08089;Gavà;4;2;A;;684;160;320;393;291;1;4;388;392
8;Barcelona;11;Baix Llobregat;08089;Gavà;4;2;B;;862;235;466;551;311;0;7;544;551
25;Lleida;25;Pallars Jussà;25098;Gavet de la Conca;1;1;U;;309;50;145;184;125;0;3;181;184
8;Barcelona;3;Alt Penedès;08091;Gelida;1;1;A;;605;143;344;458;147;1;4;453;457
8;Barcelona;3;Alt Penedès;08091;Gelida;1;1;B;;622;126;319;425;197;2;0;423;423
8;Barcelona;3;Alt Penedès;08091;Gelida;1;1;C;;765;167;411;538;227;1;4;533;537
8;Barcelona;3;Alt Penedès;08091;Gelida;2;1;A;;666;177;340;456;210;1;1;454;455
8;Barcelona;3;Alt Penedès;08091;Gelida;2;1;B;;732;146;383;487;245;1;3;483;486
17;Girona;15;Cerdanya;17078;Ger;1;1;U;;251;92;163;183;68;1;2;180;182
25;Lleida;33;Segrià;25912;Gimenells i el Pla de la Font;1;1;A;;650;177;350;406;244;0;2;404;406
25;Lleida;33;Segrià;25912;Gimenells i el Pla de la Font;1;1;B;;348;38;156;210;138;0;2;208;210
43;Tarragona;30;Ribera d'Ebre;43067;Ginestar;1;1;U;;734;164;462;583;151;5;4;574;578
17;Girona;20;Gironès;17079;Girona;1;1;U;;600;200;327;381;219;0;6;375;381
17;Girona;20;Gironès;17079;Girona;1;2;U;;706;258;455;510;196;0;4;506;510
17;Girona;20;Gironès;17079;Girona;1;3;A;;441;156;283;336;105;0;3;333;336
17;Girona;20;Gironès;17079;Girona;1;3;B;;449;162;276;323;126;1;4;318;322
17;Girona;20;Gironès;17079;Girona;1;4;A;;397;112;211;260;137;0;0;260;260
17;Girona;20;Gironès;17079;Girona;1;4;B;;433;135;236;286;147;1;1;284;285
17;Girona;20;Gironès;17079;Girona;1;5;A;;932;247;445;484;448;1;2;481;483
17;Girona;20;Gironès;17079;Girona;1;5;B;;533;138;253;288;245;1;1;286;287
17;Girona;20;Gironès;17079;Girona;1;6;A;;524;186;342;376;148;2;3;371;374
17;Girona;20;Gironès;17079;Girona;1;6;B;;613;211;408;453;160;5;2;446;448
17;Girona;20;Gironès;17079;Girona;2;1;U;;717;292;467;577;140;2;6;569;575
17;Girona;20;Gironès;17079;Girona;2;10;A;;558;149;346;409;149;3;3;403;406
17;Girona;20;Gironès;17079;Girona;2;10;B;;547;138;334;418;129;3;1;414;415
17;Girona;20;Gironès;17079;Girona;2;11;A;;601;176;344;436;165;1;6;429;435
17;Girona;20;Gironès;17079;Girona;2;11;B;;546;148;310;370;176;1;3;366;369
17;Girona;20;Gironès;17079;Girona;2;11;C;;661;201;387;470;191;3;4;463;467
17;Girona;20;Gironès;17079;Girona;2;12;A;;588;179;349;456;132;2;9;445;454
17;Girona;20;Gironès;17079;Girona;2;12;B;;622;197;362;463;159;1;6;456;462
17;Girona;20;Gironès;17079;Girona;2;13;A;;535;171;316;403;132;1;4;398;402
17;Girona;20;Gironès;17079;Girona;2;13;B;;611;182;351;455;156;3;9;443;452
17;Girona;20;Gironès;17079;Girona;2;14;U;;789;265;422;508;281;0;3;505;508
17;Girona;20;Gironès;17079;Girona;2;15;A;;564;182;375;419;145;0;8;411;419
17;Girona;20;Gironès;17079;Girona;2;15;B;;669;197;391;494;175;0;10;484;494
17;Girona;20;Gironès;17079;Girona;2;2;U;;573;219;373;443;130;2;2;439;441
17;Girona;20;Gironès;17079;Girona;2;3;A;;552;179;316;399;153;2;8;389;397
17;Girona;20;Gironès;17079;Girona;2;3;B;;548;160;323;409;139;0;4;405;409
17;Girona;20;Gironès;17079;Girona;2;4;A;;655;233;420;513;142;1;2;510;512
17;Girona;20;Gironès;17079;Girona;2;4;B;;621;192;364;469;152;2;5;462;467
17;Girona;20;Gironès;17079;Girona;2;5;U;;809;287;479;578;231;7;2;569;571
17;Girona;20;Gironès;17079;Girona;2;6;A;;589;211;363;448;141;0;3;445;448
17;Girona;20;Gironès;17079;Girona;2;6;B;;485;159;281;356;129;0;4;352;356
17;Girona;20;Gironès;17079;Girona;2;6;C;;584;215;347;437;147;1;5;431;436
17;Girona;20;Gironès;17079;Girona;2;7;A;;773;245;433;546;227;4;4;538;542
17;Girona;20;Gironès;17079;Girona;2;7;B;;692;225;396;484;208;0;3;481;484
17;Girona;20;Gironès;17079;Girona;2;8;A;;728;240;442;544;184;1;2;541;543
17;Girona;20;Gironès;17079;Girona;2;8;B;;769;251;477;574;195;1;3;570;573
17;Girona;20;Gironès;17079;Girona;2;9;A;;972;257;514;664;308;0;8;656;664
17;Girona;20;Gironès;17079;Girona;2;9;B;;929;273;551;681;248;0;4;677;681
17;Girona;20;Gironès;17079;Girona;3;1;A;;460;158;272;332;128;0;2;330;332
17;Girona;20;Gironès;17079;Girona;3;1;B;;440;169;284;344;96;1;1;342;343
17;Girona;20;Gironès;17079;Girona;3;10;U;;909;257;479;615;294;0;7;608;615
17;Girona;20;Gironès;17079;Girona;3;11;A;;648;181;351;440;208;0;5;435;440
17;Girona;20;Gironès;17079;Girona;3;11;B;;526;144;280;349;177;7;1;341;342
17;Girona;20;Gironès;17079;Girona;3;11;C;;635;181;333;441;194;0;0;441;441
17;Girona;20;Gironès;17079;Girona;3;12;A;;818;210;442;552;266;1;1;550;551
17;Girona;20;Gironès;17079;Girona;3;12;B;;851;169;429;556;295;1;6;549;555
17;Girona;20;Gironès;17079;Girona;3;13;A;;706;229;418;496;210;5;2;489;491
17;Girona;20;Gironès;17079;Girona;3;13;B;;693;212;431;509;184;0;6;503;509
17;Girona;20;Gironès;17079;Girona;3;14;A;;729;207;390;479;250;0;1;478;479
17;Girona;20;Gironès;17079;Girona;3;14;B;;696;202;385;460;236;1;2;457;459
17;Girona;20;Gironès;17079;Girona;3;15;A;;713;196;420;499;214;4;4;491;495
17;Girona;20;Gironès;17079;Girona;3;15;B;;728;215;426;499;229;2;2;495;497
17;Girona;20;Gironès;17079;Girona;3;16;A;;558;176;313;391;167;0;2;389;391
17;Girona;20;Gironès;17079;Girona;3;16;B;;617;220;376;460;157;2;6;452;458
17;Girona;20;Gironès;17079;Girona;3;17;U;;847;226;459;532;315;3;4;525;529
17;Girona;20;Gironès;17079;Girona;3;2;A;;479;186;267;374;105;0;3;371;374
17;Girona;20;Gironès;17079;Girona;3;2;B;;425;166;290;331;94;1;4;326;330
17;Girona;20;Gironès;17079;Girona;3;3;A;;494;184;309;377;117;1;4;372;376
17;Girona;20;Gironès;17079;Girona;3;3;B;;414;129;414;299;115;1;2;296;298
17;Girona;20;Gironès;17079;Girona;3;4;A;;582;200;385;457;125;1;1;455;456
17;Girona;20;Gironès;17079;Girona;3;4;B;;549;198;356;415;134;2;1;412;413
17;Girona;20;Gironès;17079;Girona;3;5;A;;546;166;331;407;139;0;4;403;407
17;Girona;20;Gironès;17079;Girona;3;5;B;;529;211;317;390;139;1;4;385;389
17;Girona;20;Gironès;17079;Girona;3;6;U;;879;310;577;663;216;2;6;655;661
17;Girona;20;Gironès;17079;Girona;3;7;A;;759;240;414;518;241;2;6;510;516
17;Girona;20;Gironès;17079;Girona;3;7;B;;730;211;394;484;246;0;3;481;484
17;Girona;20;Gironès;17079;Girona;3;8;A;;754;249;430;517;237;1;10;506;516
17;Girona;20;Gironès;17079;Girona;3;8;B;;715;234;429;511;204;1;2;508;510
17;Girona;20;Gironès;17079;Girona;3;9;A;;383;129;235;265;118;0;3;262;265
17;Girona;20;Gironès;17079;Girona;3;9;B;;379;112;207;259;120;0;1;258;259
17;Girona;20;Gironès;17079;Girona;3;9;C;;374;118;207;238;136;1;0;237;237
17;Girona;20;Gironès;17079;Girona;4;1;U;;675;224;377;475;200;3;4;468;472
17;Girona;20;Gironès;17079;Girona;4;2;U;;762;282;434;512;250;5;5;502;507
17;Girona;20;Gironès;17079;Girona;4;3;U;;588;167;297;331;257;2;2;327;329
17;Girona;20;Gironès;17079;Girona;5;1;A;;752;224;436;546;206;3;1;542;543
17;Girona;20;Gironès;17079;Girona;5;1;B;;710;237;436;542;168;0;2;540;542
17;Girona;20;Gironès;17079;Girona;5;2;U;;532;213;362;399;133;2;1;396;397
17;Girona;20;Gironès;17079;Girona;5;3;A;;553;143;312;363;190;0;0;363;363
17;Girona;20;Gironès;17079;Girona;5;3;B;;498;152;297;361;137;0;0;361;361
17;Girona;20;Gironès;17079;Girona;5;4;U;;561;196;364;399;162;3;2;394;396
17;Girona;20;Gironès;17079;Girona;5;5;A;;552;207;349;394;158;1;5;388;393
17;Girona;20;Gironès;17079;Girona;5;5;B;;543;160;304;353;190;0;3;350;353
17;Girona;20;Gironès;17079;Girona;6;1;A;;1101;224;545;697;404;1;8;688;696
17;Girona;20;Gironès;17079;Girona;6;1;B;;981;208;492;612;369;5;12;595;607
17;Girona;20;Gironès;17079;Girona;6;2;A;;586;147;337;406;180;2;1;403;404
17;Girona;20;Gironès;17079;Girona;6;2;B;;552;147;340;398;154;1;1;396;397
17;Girona;20;Gironès;17079;Girona;6;3;A;;672;173;394;461;211;4;5;452;457
17;Girona;20;Gironès;17079;Girona;6;3;B;;565;155;337;405;160;0;2;403;405
8;Barcelona;14;Berguedà;08092;Gironella;1;1;A;;602;197;368;433;169;2;1;430;431
8;Barcelona;14;Berguedà;08092;Gironella;1;1;B;;634;206;382;463;171;4;3;456;459
8;Barcelona;14;Berguedà;08092;Gironella;2;1;U;;560;165;310;374;186;6;5;363;368
8;Barcelona;14;Berguedà;08092;Gironella;2;2;A;;552;161;349;418;134;4;2;412;414
8;Barcelona;14;Berguedà;08092;Gironella;2;2;B;;652;180;423;508;144;5;5;498;503
8;Barcelona;14;Berguedà;08092;Gironella;2;3;A;;542;169;334;408;134;2;3;403;406
8;Barcelona;14;Berguedà;08092;Gironella;2;3;B;;672;213;426;501;171;4;0;497;497
8;Barcelona;14;Berguedà;08093;Gisclareny;1;1;U;;24;3;9;13;11;0;0;13;13
43;Tarragona;22;Montsià;43068;Godall;1;1;U;;676;185;418;518;158;2;1;515;516
25;Lleida;27;Pla d'Urgell;25099;Golmés;1;1;U;;1068;257;621;776;292;3;7;766;773
17;Girona;31;Ripollès;17080;Gombrèn;1;1;U;;218;82;141;173;45;2;1;170;171
25;Lleida;14;Berguedà;25100;Gósol;1;1;U;;169;60;122;138;31;3;0;135;135
8;Barcelona;3;Alt Penedès;08094;Granada, la;1;1;U;;1019;233;646;799;220;1;2;796;798
25;Lleida;18;Garrigues;25101;Granadella, la;1;1;U;;745;240;438;579;166;1;0;578;578
8;Barcelona;;;08095;Granera;1;1;U;;50;27;33;43;7;1;1;41;42
25;Lleida;33;Segrià;25102;Granja d'Escarp, la;1;1;U;;914;242;557;661;253;2;11;648;659
8;Barcelona;41;Vallès Oriental;08096;Granollers;1;1;U;;599;227;411;474;125;2;7;465;472
8;Barcelona;41;Vallès Oriental;08096;Granollers;1;10;A;;600;140;307;377;223;2;1;374;375
8;Barcelona;41;Vallès Oriental;08096;Granollers;1;10;B;;746;195;358;434;312;0;3;431;434
8;Barcelona;41;Vallès Oriental;08096;Granollers;1;11;A;;713;183;348;418;295;1;5;412;417
8;Barcelona;41;Vallès Oriental;08096;Granollers;1;11;B;;792;198;382;457;335;3;1;453;454
8;Barcelona;41;Vallès Oriental;08096;Granollers;1;2;A;;502;186;323;375;127;2;4;369;373
8;Barcelona;41;Vallès Oriental;08096;Granollers;1;2;B;;619;221;387;466;153;1;2;463;465
8;Barcelona;41;Vallès Oriental;08096;Granollers;1;3;A;;706;202;397;508;198;1;3;504;507
8;Barcelona;41;Vallès Oriental;08096;Granollers;1;3;B;;896;240;473;611;285;1;4;606;610
8;Barcelona;41;Vallès Oriental;08096;Granollers;1;4;U;;493;135;267;325;168;0;2;323;325
8;Barcelona;41;Vallès Oriental;08096;Granollers;1;5;A;;540;158;312;384;156;0;6;378;384
8;Barcelona;41;Vallès Oriental;08096;Granollers;1;5;B;;698;215;395;475;223;2;3;470;473
8;Barcelona;41;Vallès Oriental;08096;Granollers;1;6;A;;529;140;278;329;200;3;1;325;326
8;Barcelona;41;Vallès Oriental;08096;Granollers;1;6;B;;732;241;412;471;261;1;2;468;470
8;Barcelona;41;Vallès Oriental;08096;Granollers;1;7;U;;893;213;488;612;281;4;17;591;608
8;Barcelona;41;Vallès Oriental;08096;Granollers;1;8;U;;707;235;379;441;266;1;1;439;440
8;Barcelona;41;Vallès Oriental;08096;Granollers;1;9;A;;534;145;260;316;218;3;3;310;313
8;Barcelona;41;Vallès Oriental;08096;Granollers;1;9;B;;659;180;315;381;278;0;3;378;381
8;Barcelona;41;Vallès Oriental;08096;Granollers;2;1;A;;660;195;383;479;181;1;4;474;478
8;Barcelona;41;Vallès Oriental;08096;Granollers;2;1;B;;730;229;411;520;210;1;4;515;519
8;Barcelona;41;Vallès Oriental;08096;Granollers;2;2;U;;484;150;276;347;137;0;0;347;347
8;Barcelona;41;Vallès Oriental;08096;Granollers;2;3;U;;570;204;370;443;127;1;4;438;442
8;Barcelona;41;Vallès Oriental;08096;Granollers;2;4;A;;862;212;406;530;332;1;4;525;529
8;Barcelona;41;Vallès Oriental;08096;Granollers;2;4;B;;1076;261;512;651;425;1;2;648;650
8;Barcelona;41;Vallès Oriental;08096;Granollers;2;5;U;;940;224;463;574;366;4;4;566;570
8;Barcelona;41;Vallès Oriental;08096;Granollers;2;6;A;;467;149;302;340;127;0;1;339;340
8;Barcelona;41;Vallès Oriental;08096;Granollers;2;6;B;;623;148;351;434;189;5;3;426;429
8;Barcelona;41;Vallès Oriental;08096;Granollers;2;7;A;;454;106;228;286;168;1;3;282;285
8;Barcelona;41;Vallès Oriental;08096;Granollers;2;7;B;;539;133;296;353;186;2;3;348;351
8;Barcelona;41;Vallès Oriental;08096;Granollers;3;1;A;;728;210;400;484;244;2;0;482;482
8;Barcelona;41;Vallès Oriental;08096;Granollers;3;1;B;;808;252;484;585;223;2;3;580;583
8;Barcelona;41;Vallès Oriental;08096;Granollers;3;2;A;;572;132;256;337;235;3;8;326;334
8;Barcelona;41;Vallès Oriental;08096;Granollers;3;2;B;;642;148;274;360;282;1;5;354;359
8;Barcelona;41;Vallès Oriental;08096;Granollers;3;3;A;;454;117;222;275;179;0;5;270;275
8;Barcelona;41;Vallès Oriental;08096;Granollers;3;3;B;;511;134;247;305;206;1;1;303;304
8;Barcelona;41;Vallès Oriental;08096;Granollers;3;4;A;;627;177;337;432;195;1;8;423;431
8;Barcelona;41;Vallès Oriental;08096;Granollers;3;4;B;;734;196;397;497;237;1;6;490;496
8;Barcelona;41;Vallès Oriental;08096;Granollers;3;5;A;;612;143;307;388;224;1;1;386;387
8;Barcelona;41;Vallès Oriental;08096;Granollers;3;5;B;;692;193;369;453;239;3;7;443;450
8;Barcelona;41;Vallès Oriental;08096;Granollers;3;6;A;;633;140;285;364;269;0;6;358;364
8;Barcelona;41;Vallès Oriental;08096;Granollers;3;6;B;;683;154;299;393;290;0;6;387;393
8;Barcelona;41;Vallès Oriental;08096;Granollers;3;7;U;;669;152;300;396;273;1;6;389;395
8;Barcelona;41;Vallès Oriental;08096;Granollers;3;8;A;;502;98;186;257;245;1;2;254;256
8;Barcelona;41;Vallès Oriental;08096;Granollers;3;8;B;;579;102;212;262;317;2;0;260;260
8;Barcelona;41;Vallès Oriental;08096;Granollers;3;9;U;;547;132;301;370;177;1;2;367;369
8;Barcelona;41;Vallès Oriental;08096;Granollers;4;1;A;;949;253;558;663;286;0;7;656;663
8;Barcelona;41;Vallès Oriental;08096;Granollers;4;1;B;;1011;250;612;704;307;2;11;691;702
8;Barcelona;41;Vallès Oriental;08096;Granollers;4;10;A;;1241;242;387;781;460;0;5;776;781
8;Barcelona;41;Vallès Oriental;08096;Granollers;4;10;B;;352;101;185;232;120;0;1;231;232
8;Barcelona;41;Vallès Oriental;08096;Granollers;4;11;A;;419;109;250;306;113;1;3;302;305
8;Barcelona;41;Vallès Oriental;08096;Granollers;4;11;B;;554;153;307;372;182;0;4;368;372
8;Barcelona;41;Vallès Oriental;08096;Granollers;4;2;A;;819;202;399;475;344;0;2;473;475
8;Barcelona;41;Vallès Oriental;08096;Granollers;4;2;B;;866;208;457;538;328;0;6;532;538
8;Barcelona;41;Vallès Oriental;08096;Granollers;4;3;U;;729;193;366;452;277;0;2;450;452
8;Barcelona;41;Vallès Oriental;08096;Granollers;4;4;U;;844;204;391;488;356;1;5;482;487
8;Barcelona;41;Vallès Oriental;08096;Granollers;4;5;U;;592;126;291;362;230;0;2;360;362
8;Barcelona;41;Vallès Oriental;08096;Granollers;4;6;U;;858;199;400;509;349;0;4;505;509
8;Barcelona;41;Vallès Oriental;08096;Granollers;4;7;U;;642;141;333;412;230;1;1;410;411
8;Barcelona;41;Vallès Oriental;08096;Granollers;4;8;U;;646;132;314;401;245;1;6;394;400
8;Barcelona;41;Vallès Oriental;08096;Granollers;4;9;A;;554;152;299;356;198;0;5;351;356
8;Barcelona;41;Vallès Oriental;08096;Granollers;4;9;B;;630;204;365;427;203;3;2;422;424
25;Lleida;32;Segarra;25103;Granyanella;1;1;U;;123;25;45;66;57;0;1;65;66
25;Lleida;18;Garrigues;25105;Granyena de les Garrigues;1;1;U;;161;41;91;112;49;2;0;110;110
25;Lleida;32;Segarra;25104;Granyena de Segarra;1;1;U;;161;37;83;105;56;1;1;103;104
43;Tarragona;29;Priorat;43069;Gratallops;1;1;U;;201;72;132;154;47;0;2;152;154
8;Barcelona;41;Vallès Oriental;08097;Gualba;1;1;U;;561;148;325;398;163;0;2;396;398
17;Girona;10;Baix Empordà;17081;Gualta;1;1;U;;226;69;163;191;35;0;3;188;191
8;Barcelona;14;Berguedà;08099;Guardiola de Berguedà;1;1;U;;809;238;540;611;198;1;9;601;610
43;Tarragona;29;Priorat;43070;Guiamets, els;1;1;U;;244;46;140;187;57;0;3;184;187
17;Girona;15;Cerdanya;17082;Guils de Cerdanya;1;1;U;;231;54;136;166;65;1;2;163;165
25;Lleida;38;Urgell;25109;Guimerà;1;1;U;;376;60;195;247;129;0;1;246;247
25;Lleida;26;Pallars Sobirà;25903;Guingueta d'Àneu, la;1;1;U;;234;61;118;172;62;1;1;170;171
25;Lleida;32;Segarra;25110;Guissona;1;1;U;;1010;253;570;749;261;3;5;741;746
25;Lleida;32;Segarra;25110;Guissona;1;2;U;;1212;295;670;882;330;5;14;863;877
25;Lleida;35;Solsonès;25111;Guixers;1;1;U;;142;30;67;92;50;1;0;91;91
8;Barcelona;24;Osona;08100;Gurb;1;1;A;;644;174;387;483;161;0;2;481;483
8;Barcelona;24;Osona;08100;Gurb;1;1;B;;802;227;475;584;218;1;6;577;583
43;Tarragona;37;Terra Alta;43071;Horta de Sant Joan;1;1;U;;1085;152;572;733;352;2;6;725;731
8;Barcelona;13;Barcelonès;08101;Hospitalet de Llobregat, l';1;1;U;;821;151;347;438;383;1;5;432;437
8;Barcelona;13;Barcelonès;08101;Hospitalet de Llobregat, l';1;10;U;;1148;257;552;711;437;0;10;701;711
8;Barcelona;13;Barcelonès;08101;Hospitalet de Llobregat, l';1;11;U;;908;205;417;567;341;0;1;566;567
8;Barcelona;13;Barcelonès;08101;Hospitalet de Llobregat, l';1;12;U;;1277;271;616;828;449;1;7;820;827
8;Barcelona;13;Barcelonès;08101;Hospitalet de Llobregat, l';1;13;U;;1000;232;475;616;384;1;19;596;615
8;Barcelona;13;Barcelonès;08101;Hospitalet de Llobregat, l';1;14;A;;736;161;298;384;352;0;3;381;384
8;Barcelona;13;Barcelonès;08101;Hospitalet de Llobregat, l';1;14;B;;804;181;329;427;377;0;6;421;427
8;Barcelona;13;Barcelonès;08101;Hospitalet de Llobregat, l';1;15;U;;1162;276;508;666;496;1;7;658;665
8;Barcelona;13;Barcelonès;08101;Hospitalet de Llobregat, l';1;16;A;;662;117;275;390;272;0;4;386;390
8;Barcelona;13;Barcelonès;08101;Hospitalet de Llobregat, l';1;16;B;;736;144;331;434;302;0;4;430;434
8;Barcelona;13;Barcelonès;08101;Hospitalet de Llobregat, l';1;17;A;;712;185;344;420;292;1;6;413;419
8;Barcelona;13;Barcelonès;08101;Hospitalet de Llobregat, l';1;17;B;;793;176;372;482;311;1;4;477;481
8;Barcelona;13;Barcelonès;08101;Hospitalet de Llobregat, l';1;18;A;;773;186;355;475;298;0;6;469;475
8;Barcelona;13;Barcelonès;08101;Hospitalet de Llobregat, l';1;18;B;;651;175;318;425;226;6;0;419;419
8;Barcelona;13;Barcelonès;08101;Hospitalet de Llobregat, l';1;19;U;;1265;247;564;726;539;0;3;723;726
8;Barcelona;13;Barcelonès;08101;Hospitalet de Llobregat, l';1;2;A;;719;194;391;489;230;0;5;484;489
8;Barcelona;13;Barcelonès;08101;Hospitalet de Llobregat, l';1;2;B;;827;204;398;528;299;0;8;520;528
8;Barcelona;13;Barcelonès;08101;Hospitalet de Llobregat, l';1;20;U;;1261;322;614;790;471;0;17;773;790
8;Barcelona;13;Barcelonès;08101;Hospitalet de Llobregat, l';1;21;U;;783;200;373;462;321;1;5;456;461
8;Barcelona;13;Barcelonès;08101;Hospitalet de Llobregat, l';1;22;U;;832;195;388;506;326;0;2;504;506
8;Barcelona;13;Barcelonès;08101;Hospitalet de Llobregat, l';1;23;U;;1025;239;611;653;372;2;4;647;651
8;Barcelona;13;Barcelonès;08101;Hospitalet de Llobregat, l';1;24;U;;731;173;345;455;276;0;8;447;455
8;Barcelona;13;Barcelonès;08101;Hospitalet de Llobregat, l';1;25;U;;1043;241;456;570;473;2;6;562;568
8;Barcelona;13;Barcelonès;08101;Hospitalet de Llobregat, l';1;26;U;;1101;277;532;706;395;1;13;692;705
8;Barcelona;13;Barcelonès;08101;Hospitalet de Llobregat, l';1;27;U;;621;159;258;366;255;0;6;360;366
8;Barcelona;13;Barcelonès;08101;Hospitalet de Llobregat, l';1;28;U;;888;217;416;543;345;2;8;533;541
8;Barcelona;13;Barcelonès;08101;Hospitalet de Llobregat, l';1;29;U;;961;174;376;509;452;1;11;497;508
8;Barcelona;13;Barcelonès;08101;Hospitalet de Llobregat, l';1;3;U;;659;167;346;444;215;0;1;443;444
8;Barcelona;13;Barcelonès;08101;Hospitalet de Llobregat, l';1;30;U;;904;240;538;609;295;1;3;605;608
8;Barcelona;13;Barcelonès;08101;Hospitalet de Llobregat, l';1;31;U;;1298;282;570;712;586;0;8;704;712
8;Barcelona;13;Barcelonès;08101;Hospitalet de Llobregat, l';1;32;A;;786;145;357;439;347;1;2;436;438
8;Barcelona;13;Barcelonès;08101;Hospitalet de Llobregat, l';1;32;B;;903;155;371;468;435;0;0;468;468
8;Barcelona;13;Barcelonès;08101;Hospitalet de Llobregat, l';1;33;U;;816;234;454;556;260;0;12;544;556
8;Barcelona;13;Barcelonès;08101;Hospitalet de Llobregat, l';1;34;U;;1086;252;503;656;430;4;6;646;652
8;Barcelona;13;Barcelonès;08101;Hospitalet de Llobregat, l';1;35;U;;1187;278;558;718;469;1;10;707;717
8;Barcelona;13;Barcelonès;08101;Hospitalet de Llobregat, l';1;36;U;;989;261;497;613;376;2;8;603;611
8;Barcelona;13;Barcelonès;08101;Hospitalet de Llobregat, l';1;37;U;;1080;248;538;653;427;1;12;640;652
8;Barcelona;13;Barcelonès;08101;Hospitalet de Llobregat, l';1;38;U;;683;157;328;432;251;2;4;426;430
8;Barcelona;13;Barcelonès;08101;Hospitalet de Llobregat, l';1;39;U;;715;161;332;401;314;1;4;396;400
8;Barcelona;13;Barcelonès;08101;Hospitalet de Llobregat, l';1;4;U;;770;200;414;513;257;0;6;507;513
8;Barcelona;13;Barcelonès;08101;Hospitalet de Llobregat, l';1;40;U;;878;230;456;553;325;0;6;547;553
8;Barcelona;13;Barcelonès;08101;Hospitalet de Llobregat, l';1;5;U;;978;227;470;637;341;2;5;630;635
8;Barcelona;13;Barcelonès;08101;Hospitalet de Llobregat, l';1;6;A;;657;134;276;378;279;0;5;373;378
8;Barcelona;13;Barcelonès;08101;Hospitalet de Llobregat, l';1;6;B;;815;174;324;416;399;1;8;407;415
8;Barcelona;13;Barcelonès;08101;Hospitalet de Llobregat, l';1;7;A;;706;180;331;434;272;2;5;427;432
8;Barcelona;13;Barcelonès;08101;Hospitalet de Llobregat, l';1;7;B;;859;185;377;519;340;4;3;512;515
8;Barcelona;13;Barcelonès;08101;Hospitalet de Llobregat, l';1;8;U;;1152;305;625;772;380;0;8;764;772
8;Barcelona;13;Barcelonès;08101;Hospitalet de Llobregat, l';1;9;U;;959;260;500;632;327;0;3;629;632
8;Barcelona;13;Barcelonès;08101;Hospitalet de Llobregat, l';2;1;U;;590;157;301;361;229;0;5;356;361
8;Barcelona;13;Barcelonès;08101;Hospitalet de Llobregat, l';2;10;U;;843;243;457;546;297;0;3;543;546
8;Barcelona;13;Barcelonès;08101;Hospitalet de Llobregat, l';2;11;U;;1016;290;482;580;436;0;2;578;580
8;Barcelona;13;Barcelonès;08101;Hospitalet de Llobregat, l';2;12;U;;1122;252;489;610;512;1;7;602;609
8;Barcelona;13;Barcelonès;08101;Hospitalet de Llobregat, l';2;13;U;;756;213;362;451;305;5;0;446;446
8;Barcelona;13;Barcelonès;08101;Hospitalet de Llobregat, l';2;14;U;;605;148;278;340;265;2;1;337;338
8;Barcelona;13;Barcelonès;08101;Hospitalet de Llobregat, l';2;15;U;;787;230;380;465;322;0;5;460;465
8;Barcelona;13;Barcelonès;08101;Hospitalet de Llobregat, l';2;16;U;;1084;286;520;639;445;0;5;634;639
8;Barcelona;13;Barcelonès;08101;Hospitalet de Llobregat, l';2;17;U;;506;144;282;353;153;0;3;350;353
8;Barcelona;13;Barcelonès;08101;Hospitalet de Llobregat, l';2;18;U;;621;150;289;387;234;0;0;387;387
8;Barcelona;13;Barcelonès;08101;Hospitalet de Llobregat, l';2;19;U;;998;282;486;584;414;0;6;578;584
8;Barcelona;13;Barcelonès;08101;Hospitalet de Llobregat, l';2;2;U;;628;185;300;386;242;0;4;382;386
8;Barcelona;13;Barcelonès;08101;Hospitalet de Llobregat, l';2;20;U;;721;174;340;418;303;0;7;411;418
8;Barcelona;13;Barcelonès;08101;Hospitalet de Llobregat, l';2;21;U;;965;220;390;505;460;4;6;495;501
8;Barcelona;13;Barcelonès;08101;Hospitalet de Llobregat, l';2;22;U;;716;169;333;401;315;5;1;395;396
8;Barcelona;13;Barcelonès;08101;Hospitalet de Llobregat, l';2;23;U;;974;247;445;550;424;0;2;548;550
8;Barcelona;13;Barcelonès;08101;Hospitalet de Llobregat, l';2;24;U;;500;144;248;315;185;1;4;310;314
8;Barcelona;13;Barcelonès;08101;Hospitalet de Llobregat, l';2;25;U;;468;120;242;295;173;0;3;292;295
8;Barcelona;13;Barcelonès;08101;Hospitalet de Llobregat, l';2;26;U;;948;232;482;579;369;4;7;568;575
8;Barcelona;13;Barcelonès;08101;Hospitalet de Llobregat, l';2;27;U;;593;174;325;393;200;1;5;387;392
8;Barcelona;13;Barcelonès;08101;Hospitalet de Llobregat, l';2;28;U;;570;152;269;319;251;2;3;314;317
8;Barcelona;13;Barcelonès;08101;Hospitalet de Llobregat, l';2;29;U;;578;176;283;338;240;0;4;334;338
8;Barcelona;13;Barcelonès;08101;Hospitalet de Llobregat, l';2;3;U;;631;165;340;405;226;1;3;401;404
8;Barcelona;13;Barcelonès;08101;Hospitalet de Llobregat, l';2;30;U;;676;169;289;356;320;3;3;350;353
8;Barcelona;13;Barcelonès;08101;Hospitalet de Llobregat, l';2;31;U;;935;228;429;527;408;0;4;523;527
8;Barcelona;13;Barcelonès;08101;Hospitalet de Llobregat, l';2;32;U;;852;263;488;561;291;0;5;556;561
8;Barcelona;13;Barcelonès;08101;Hospitalet de Llobregat, l';2;33;U;;703;210;378;438;265;0;6;432;438
8;Barcelona;13;Barcelonès;08101;Hospitalet de Llobregat, l';2;34;U;;801;227;470;475;326;1;6;468;474
8;Barcelona;13;Barcelonès;08101;Hospitalet de Llobregat, l';2;35;A;;537;137;243;302;235;1;2;299;301
8;Barcelona;13;Barcelonès;08101;Hospitalet de Llobregat, l';2;35;B;;663;176;309;376;287;0;6;370;376
8;Barcelona;13;Barcelonès;08101;Hospitalet de Llobregat, l';2;36;U;;981;284;508;625;356;6;4;615;619
8;Barcelona;13;Barcelonès;08101;Hospitalet de Llobregat, l';2;37;U;;1088;316;545;674;414;5;11;658;669
8;Barcelona;13;Barcelonès;08101;Hospitalet de Llobregat, l';2;38;U;;661;235;354;422;239;1;3;418;421
8;Barcelona;13;Barcelonès;08101;Hospitalet de Llobregat, l';2;39;U;;974;305;521;629;345;1;11;617;628
8;Barcelona;13;Barcelonès;08101;Hospitalet de Llobregat, l';2;4;U;;470;118;222;270;200;2;4;264;268
8;Barcelona;13;Barcelonès;08101;Hospitalet de Llobregat, l';2;40;U;;595;138;280;356;239;4;1;351;352
8;Barcelona;13;Barcelonès;08101;Hospitalet de Llobregat, l';2;41;U;;534;157;286;352;182;0;1;351;352
8;Barcelona;13;Barcelonès;08101;Hospitalet de Llobregat, l';2;42;U;;924;307;543;644;280;2;3;639;642
8;Barcelona;13;Barcelonès;08101;Hospitalet de Llobregat, l';2;43;A;;586;152;304;380;206;1;7;372;379
8;Barcelona;13;Barcelonès;08101;Hospitalet de Llobregat, l';2;43;B;;672;190;332;402;270;1;2;399;401
8;Barcelona;13;Barcelonès;08101;Hospitalet de Llobregat, l';2;44;U;;551;157;306;344;207;0;0;344;344
8;Barcelona;13;Barcelonès;08101;Hospitalet de Llobregat, l';2;45;U;;835;242;417;515;320;1;4;510;514
8;Barcelona;13;Barcelonès;08101;Hospitalet de Llobregat, l';2;46;U;;904;242;428;519;385;2;8;509;517
8;Barcelona;13;Barcelonès;08101;Hospitalet de Llobregat, l';2;47;U;;1008;270;503;619;389;1;6;612;618
8;Barcelona;13;Barcelonès;08101;Hospitalet de Llobregat, l';2;48;U;;921;226;438;527;394;1;9;517;526
8;Barcelona;13;Barcelonès;08101;Hospitalet de Llobregat, l';2;49;U;;892;245;427;516;376;4;1;511;512
8;Barcelona;13;Barcelonès;08101;Hospitalet de Llobregat, l';2;5;U;;719;233;388;465;254;1;4;460;464
8;Barcelona;13;Barcelonès;08101;Hospitalet de Llobregat, l';2;6;U;;759;262;400;488;271;3;5;480;485
8;Barcelona;13;Barcelonès;08101;Hospitalet de Llobregat, l';2;7;U;;631;200;385;446;185;1;4;441;445
8;Barcelona;13;Barcelonès;08101;Hospitalet de Llobregat, l';2;8;A;;768;210;402;486;282;0;1;485;486
8;Barcelona;13;Barcelonès;08101;Hospitalet de Llobregat, l';2;8;B;;881;241;470;584;297;2;8;574;582
8;Barcelona;13;Barcelonès;08101;Hospitalet de Llobregat, l';2;9;U;;885;252;468;574;311;3;1;570;571
8;Barcelona;13;Barcelonès;08101;Hospitalet de Llobregat, l';3;1;A;;656;166;303;374;282;0;11;363;374
8;Barcelona;13;Barcelonès;08101;Hospitalet de Llobregat, l';3;1;B;;799;197;349;430;369;0;0;430;430
8;Barcelona;13;Barcelonès;08101;Hospitalet de Llobregat, l';3;10;U;;684;154;313;391;293;1;3;387;390
8;Barcelona;13;Barcelonès;08101;Hospitalet de Llobregat, l';3;11;U;;1235;338;656;793;442;6;9;778;787
8;Barcelona;13;Barcelonès;08101;Hospitalet de Llobregat, l';3;12;U;;1036;245;529;639;397;4;16;619;635
8;Barcelona;13;Barcelonès;08101;Hospitalet de Llobregat, l';3;13;A;;716;165;310;410;306;0;3;407;410
8;Barcelona;13;Barcelonès;08101;Hospitalet de Llobregat, l';3;13;B;;808;203;363;474;334;2;2;470;472
8;Barcelona;13;Barcelonès;08101;Hospitalet de Llobregat, l';3;14;A;;773;176;357;447;326;0;5;442;447
8;Barcelona;13;Barcelonès;08101;Hospitalet de Llobregat, l';3;14;B;;966;200;424;563;403;1;10;552;562
8;Barcelona;13;Barcelonès;08101;Hospitalet de Llobregat, l';3;15;U;;1174;224;532;659;515;0;0;659;659
8;Barcelona;13;Barcelonès;08101;Hospitalet de Llobregat, l';3;16;A;;782;173;391;523;259;1;8;514;522
8;Barcelona;13;Barcelonès;08101;Hospitalet de Llobregat, l';3;16;B;;909;225;459;606;303;0;9;597;606
8;Barcelona;13;Barcelonès;08101;Hospitalet de Llobregat, l';3;17;U;;654;176;306;384;270;9;0;375;375
8;Barcelona;13;Barcelonès;08101;Hospitalet de Llobregat, l';3;18;U;;658;186;353;446;212;0;0;446;446
8;Barcelona;13;Barcelonès;08101;Hospitalet de Llobregat, l';3;19;U;;656;155;331;398;258;0;4;394;398
8;Barcelona;13;Barcelonès;08101;Hospitalet de Llobregat, l';3;2;U;;1295;336;612;794;501;2;10;782;792
8;Barcelona;13;Barcelonès;08101;Hospitalet de Llobregat, l';3;20;U;;847;214;434;559;288;3;8;548;556
8;Barcelona;13;Barcelonès;08101;Hospitalet de Llobregat, l';3;21;A;;827;242;463;565;262;0;6;559;565
8;Barcelona;13;Barcelonès;08101;Hospitalet de Llobregat, l';3;21;B;;923;256;530;628;295;1;10;617;627
8;Barcelona;13;Barcelonès;08101;Hospitalet de Llobregat, l';3;22;U;;972;205;434;536;436;0;0;536;536
8;Barcelona;13;Barcelonès;08101;Hospitalet de Llobregat, l';3;23;A;;875;200;387;498;377;1;5;492;497
8;Barcelona;13;Barcelonès;08101;Hospitalet de Llobregat, l';3;23;B;;1108;265;511;617;491;1;6;610;616
8;Barcelona;13;Barcelonès;08101;Hospitalet de Llobregat, l';3;24;U;;699;194;347;421;278;3;1;417;418
8;Barcelona;13;Barcelonès;08101;Hospitalet de Llobregat, l';3;25;A;;846;226;460;581;265;0;5;576;581
8;Barcelona;13;Barcelonès;08101;Hospitalet de Llobregat, l';3;25;B;;756;222;442;545;211;0;8;537;545
8;Barcelona;13;Barcelonès;08101;Hospitalet de Llobregat, l';3;3;A;;733;194;371;467;266;0;0;467;467
8;Barcelona;13;Barcelonès;08101;Hospitalet de Llobregat, l';3;3;B;;827;216;420;522;305;1;6;515;521
8;Barcelona;13;Barcelonès;08101;Hospitalet de Llobregat, l';3;4;U;;1017;285;535;617;400;0;4;613;617
8;Barcelona;13;Barcelonès;08101;Hospitalet de Llobregat, l';3;5;U;;1158;315;625;782;376;1;5;776;781
8;Barcelona;13;Barcelonès;08101;Hospitalet de Llobregat, l';3;6;U;;1275;361;688;853;422;1;7;845;852
8;Barcelona;13;Barcelonès;08101;Hospitalet de Llobregat, l';3;7;A;;627;185;337;430;197;1;7;422;429
8;Barcelona;13;Barcelonès;08101;Hospitalet de Llobregat, l';3;7;B;;675;185;379;466;209;0;1;465;466
8;Barcelona;13;Barcelonès;08101;Hospitalet de Llobregat, l';3;8;U;;1187;308;632;781;406;0;12;769;781
8;Barcelona;13;Barcelonès;08101;Hospitalet de Llobregat, l';3;9;U;;557;145;270;356;201;0;1;355;356
8;Barcelona;13;Barcelonès;08101;Hospitalet de Llobregat, l';4;1;U;;1026;296;534;689;337;1;6;682;688
8;Barcelona;13;Barcelonès;08101;Hospitalet de Llobregat, l';4;10;A;;677;191;345;435;242;0;6;429;435
8;Barcelona;13;Barcelonès;08101;Hospitalet de Llobregat, l';4;10;B;;825;210;378;479;346;1;3;475;478
8;Barcelona;13;Barcelonès;08101;Hospitalet de Llobregat, l';4;11;U;;957;234;453;558;399;0;3;555;558
8;Barcelona;13;Barcelonès;08101;Hospitalet de Llobregat, l';4;12;A;;648;197;330;407;241;0;4;403;407
8;Barcelona;13;Barcelonès;08101;Hospitalet de Llobregat, l';4;12;B;;812;235;414;497;315;2;7;488;495
8;Barcelona;13;Barcelonès;08101;Hospitalet de Llobregat, l';4;13;U;;497;159;260;304;193;0;8;296;304
8;Barcelona;13;Barcelonès;08101;Hospitalet de Llobregat, l';4;14;U;;798;225;406;478;320;1;8;469;477
8;Barcelona;13;Barcelonès;08101;Hospitalet de Llobregat, l';4;15;U;;599;153;269;347;252;0;0;347;347
8;Barcelona;13;Barcelonès;08101;Hospitalet de Llobregat, l';4;16;U;;630;199;346;409;221;0;4;405;409
8;Barcelona;13;Barcelonès;08101;Hospitalet de Llobregat, l';4;17;U;;562;135;250;325;237;0;2;323;325
8;Barcelona;13;Barcelonès;08101;Hospitalet de Llobregat, l';4;18;U;;996;271;545;574;422;0;0;574;574
8;Barcelona;13;Barcelonès;08101;Hospitalet de Llobregat, l';4;19;U;;667;165;308;376;291;1;1;374;375
8;Barcelona;13;Barcelonès;08101;Hospitalet de Llobregat, l';4;2;U;;753;180;318;385;368;0;3;382;385
8;Barcelona;13;Barcelonès;08101;Hospitalet de Llobregat, l';4;20;U;;1082;329;556;669;413;1;6;662;668
8;Barcelona;13;Barcelonès;08101;Hospitalet de Llobregat, l';4;21;U;;1032;269;450;582;450;6;7;569;576
8;Barcelona;13;Barcelonès;08101;Hospitalet de Llobregat, l';4;22;U;;907;260;408;525;382;0;5;520;525
8;Barcelona;13;Barcelonès;08101;Hospitalet de Llobregat, l';4;23;U;;863;215;439;560;303;2;5;553;558
8;Barcelona;13;Barcelonès;08101;Hospitalet de Llobregat, l';4;24;U;;499;114;228;274;225;0;0;274;274
8;Barcelona;13;Barcelonès;08101;Hospitalet de Llobregat, l';4;25;U;;839;203;378;485;354;0;7;478;485
8;Barcelona;13;Barcelonès;08101;Hospitalet de Llobregat, l';4;26;U;;796;214;376;477;319;2;11;464;475
8;Barcelona;13;Barcelonès;08101;Hospitalet de Llobregat, l';4;27;U;;759;206;343;436;323;1;7;428;435
8;Barcelona;13;Barcelonès;08101;Hospitalet de Llobregat, l';4;28;U;;469;125;221;281;188;0;3;278;281
8;Barcelona;13;Barcelonès;08101;Hospitalet de Llobregat, l';4;29;U;;560;171;286;357;203;1;0;356;356
8;Barcelona;13;Barcelonès;08101;Hospitalet de Llobregat, l';4;3;U;;1064;281;517;654;410;2;3;649;652
8;Barcelona;13;Barcelonès;08101;Hospitalet de Llobregat, l';4;30;U;;789;203;365;432;357;0;1;431;432
8;Barcelona;13;Barcelonès;08101;Hospitalet de Llobregat, l';4;31;A;;531;136;260;316;215;2;4;310;314
8;Barcelona;13;Barcelonès;08101;Hospitalet de Llobregat, l';4;31;B;;692;200;350;430;262;1;3;426;429
8;Barcelona;13;Barcelonès;08101;Hospitalet de Llobregat, l';4;32;U;;1095;280;532;685;410;0;9;676;685
8;Barcelona;13;Barcelonès;08101;Hospitalet de Llobregat, l';4;33;U;;836;193;366;429;407;0;3;426;429
8;Barcelona;13;Barcelonès;08101;Hospitalet de Llobregat, l';4;34;U;;558;185;281;326;232;0;2;324;326
8;Barcelona;13;Barcelonès;08101;Hospitalet de Llobregat, l';4;35;U;;933;248;429;502;431;6;5;491;496
8;Barcelona;13;Barcelonès;08101;Hospitalet de Llobregat, l';4;36;U;;657;159;278;344;313;1;3;340;343
8;Barcelona;13;Barcelonès;08101;Hospitalet de Llobregat, l';4;37;U;;717;167;330;394;323;0;4;390;394
8;Barcelona;13;Barcelonès;08101;Hospitalet de Llobregat, l';4;38;U;;757;186;340;423;334;3;11;409;420
8;Barcelona;13;Barcelonès;08101;Hospitalet de Llobregat, l';4;39;U;;874;224;403;486;388;0;2;484;486
8;Barcelona;13;Barcelonès;08101;Hospitalet de Llobregat, l';4;4;U;;1138;289;552;669;469;0;10;659;669
8;Barcelona;13;Barcelonès;08101;Hospitalet de Llobregat, l';4;40;U;;1083;258;514;617;466;1;5;611;616
8;Barcelona;13;Barcelonès;08101;Hospitalet de Llobregat, l';4;41;A;;772;203;382;472;300;3;3;466;469
8;Barcelona;13;Barcelonès;08101;Hospitalet de Llobregat, l';4;41;B;;867;224;422;523;344;3;4;516;520
8;Barcelona;13;Barcelonès;08101;Hospitalet de Llobregat, l';4;42;U;;572;156;283;367;205;2;4;361;365
8;Barcelona;13;Barcelonès;08101;Hospitalet de Llobregat, l';4;5;U;;829;212;397;483;346;1;1;481;482
8;Barcelona;13;Barcelonès;08101;Hospitalet de Llobregat, l';4;6;U;;1165;274;496;652;513;6;6;640;646
8;Barcelona;13;Barcelonès;08101;Hospitalet de Llobregat, l';4;7;U;;903;209;388;512;391;0;1;511;512
8;Barcelona;13;Barcelonès;08101;Hospitalet de Llobregat, l';4;8;U;;754;187;353;444;310;0;3;441;444
8;Barcelona;13;Barcelonès;08101;Hospitalet de Llobregat, l';4;9;U;;622;143;281;374;248;1;7;366;373
8;Barcelona;13;Barcelonès;08101;Hospitalet de Llobregat, l';5;1;U;;1019;211;470;610;409;0;6;604;610
8;Barcelona;13;Barcelonès;08101;Hospitalet de Llobregat, l';5;10;U;;908;249;427;533;375;0;4;529;533
8;Barcelona;13;Barcelonès;08101;Hospitalet de Llobregat, l';5;11;U;;638;205;362;420;218;3;3;414;417
8;Barcelona;13;Barcelonès;08101;Hospitalet de Llobregat, l';5;12;U;;789;191;340;451;338;2;6;443;449
8;Barcelona;13;Barcelonès;08101;Hospitalet de Llobregat, l';5;13;U;;667;169;308;382;285;0;7;375;382
8;Barcelona;13;Barcelonès;08101;Hospitalet de Llobregat, l';5;14;U;;641;165;292;368;273;0;1;367;368
8;Barcelona;13;Barcelonès;08101;Hospitalet de Llobregat, l';5;15;U;;501;112;224;272;229;2;2;268;270
8;Barcelona;13;Barcelonès;08101;Hospitalet de Llobregat, l';5;16;U;;565;149;229;280;285;1;5;274;279
8;Barcelona;13;Barcelonès;08101;Hospitalet de Llobregat, l';5;17;U;;976;247;466;570;406;0;1;569;570
8;Barcelona;13;Barcelonès;08101;Hospitalet de Llobregat, l';5;18;U;;978;248;472;581;397;2;3;576;579
8;Barcelona;13;Barcelonès;08101;Hospitalet de Llobregat, l';5;19;U;;499;142;237;278;221;0;7;271;278
8;Barcelona;13;Barcelonès;08101;Hospitalet de Llobregat, l';5;2;A;;621;162;282;377;244;1;0;376;376
8;Barcelona;13;Barcelonès;08101;Hospitalet de Llobregat, l';5;2;B;;707;212;358;450;257;0;7;443;450
8;Barcelona;13;Barcelonès;08101;Hospitalet de Llobregat, l';5;20;U;;802;226;390;490;312;0;5;485;490
8;Barcelona;13;Barcelonès;08101;Hospitalet de Llobregat, l';5;21;U;;1131;260;537;708;423;2;5;701;706
8;Barcelona;13;Barcelonès;08101;Hospitalet de Llobregat, l';5;22;U;;642;150;292;355;287;4;2;349;351
8;Barcelona;13;Barcelonès;08101;Hospitalet de Llobregat, l';5;23;U;;1179;361;614;728;451;2;9;717;726
8;Barcelona;13;Barcelonès;08101;Hospitalet de Llobregat, l';5;24;U;;1067;270;469;609;458;0;11;598;609
8;Barcelona;13;Barcelonès;08101;Hospitalet de Llobregat, l';5;25;U;;731;182;344;451;280;0;3;448;451
8;Barcelona;13;Barcelonès;08101;Hospitalet de Llobregat, l';5;26;U;;599;149;300;356;243;1;2;353;355
8;Barcelona;13;Barcelonès;08101;Hospitalet de Llobregat, l';5;27;U;;867;220;380;458;409;0;1;457;458
8;Barcelona;13;Barcelonès;08101;Hospitalet de Llobregat, l';5;28;U;;1019;280;514;623;396;0;7;616;623
8;Barcelona;13;Barcelonès;08101;Hospitalet de Llobregat, l';5;29;U;;1015;315;516;613;402;0;9;604;613
8;Barcelona;13;Barcelonès;08101;Hospitalet de Llobregat, l';5;3;U;;741;174;372;467;274;1;1;465;466
8;Barcelona;13;Barcelonès;08101;Hospitalet de Llobregat, l';5;30;U;;1199;337;645;765;434;5;11;749;760
8;Barcelona;13;Barcelonès;08101;Hospitalet de Llobregat, l';5;31;U;;810;216;415;497;313;0;9;488;497
8;Barcelona;13;Barcelonès;08101;Hospitalet de Llobregat, l';5;32;U;;1267;363;634;778;489;4;9;765;774
8;Barcelona;13;Barcelonès;08101;Hospitalet de Llobregat, l';5;33;U;;816;246;434;510;306;2;4;504;508
8;Barcelona;13;Barcelonès;08101;Hospitalet de Llobregat, l';5;34;U;;843;203;384;494;349;3;9;482;491
8;Barcelona;13;Barcelonès;08101;Hospitalet de Llobregat, l';5;35;U;;1004;228;466;639;365;0;3;636;639
8;Barcelona;13;Barcelonès;08101;Hospitalet de Llobregat, l';5;36;U;;846;247;458;555;291;0;3;552;555
8;Barcelona;13;Barcelonès;08101;Hospitalet de Llobregat, l';5;37;U;;1124;302;572;681;443;1;13;667;680
8;Barcelona;13;Barcelonès;08101;Hospitalet de Llobregat, l';5;38;U;;1075;282;525;648;427;0;7;641;648
8;Barcelona;13;Barcelonès;08101;Hospitalet de Llobregat, l';5;4;U;;1171;300;515;659;512;2;6;651;657
8;Barcelona;13;Barcelonès;08101;Hospitalet de Llobregat, l';5;5;A;;662;137;316;418;244;1;4;413;417
8;Barcelona;13;Barcelonès;08101;Hospitalet de Llobregat, l';5;5;B;;678;150;345;439;239;4;9;426;435
8;Barcelona;13;Barcelonès;08101;Hospitalet de Llobregat, l';5;6;A;;894;194;404;521;373;0;6;515;521
8;Barcelona;13;Barcelonès;08101;Hospitalet de Llobregat, l';5;6;B;;863;189;364;482;381;0;4;478;482
8;Barcelona;13;Barcelonès;08101;Hospitalet de Llobregat, l';5;7;U;;759;200;376;457;302;0;6;451;457
8;Barcelona;13;Barcelonès;08101;Hospitalet de Llobregat, l';5;8;U;;522;171;291;334;188;0;2;332;334
8;Barcelona;13;Barcelonès;08101;Hospitalet de Llobregat, l';5;9;U;;697;153;301;410;287;0;3;407;410
8;Barcelona;13;Barcelonès;08101;Hospitalet de Llobregat, l';6;1;U;;1296;291;615;788;508;2;9;777;786
8;Barcelona;13;Barcelonès;08101;Hospitalet de Llobregat, l';6;10;A;;718;170;335;426;292;0;13;413;426
8;Barcelona;13;Barcelonès;08101;Hospitalet de Llobregat, l';6;10;B;;611;164;278;361;250;0;3;358;361
8;Barcelona;13;Barcelonès;08101;Hospitalet de Llobregat, l';6;11;A;;792;181;350;444;348;1;3;440;443
8;Barcelona;13;Barcelonès;08101;Hospitalet de Llobregat, l';6;11;B;;741;174;324;431;310;0;4;427;431
8;Barcelona;13;Barcelonès;08101;Hospitalet de Llobregat, l';6;12;U;;1114;296;564;685;429;5;15;665;680
8;Barcelona;13;Barcelonès;08101;Hospitalet de Llobregat, l';6;13;A;;721;152;313;410;311;1;2;407;409
8;Barcelona;13;Barcelonès;08101;Hospitalet de Llobregat, l';6;13;B;;649;157;313;408;241;1;4;403;407
8;Barcelona;13;Barcelonès;08101;Hospitalet de Llobregat, l';6;14;U;;968;236;494;595;373;0;8;587;595
8;Barcelona;13;Barcelonès;08101;Hospitalet de Llobregat, l';6;15;U;;946;211;465;578;368;1;6;571;577
8;Barcelona;13;Barcelonès;08101;Hospitalet de Llobregat, l';6;16;A;;565;106;215;274;291;0;1;273;274
8;Barcelona;13;Barcelonès;08101;Hospitalet de Llobregat, l';6;16;B;;699;116;257;332;367;2;3;327;330
8;Barcelona;13;Barcelonès;08101;Hospitalet de Llobregat, l';6;17;U;;1060;255;496;619;441;2;8;609;617
8;Barcelona;13;Barcelonès;08101;Hospitalet de Llobregat, l';6;18;U;;602;176;313;393;209;0;8;385;393
8;Barcelona;13;Barcelonès;08101;Hospitalet de Llobregat, l';6;19;U;;1277;301;620;805;472;2;7;796;803
8;Barcelona;13;Barcelonès;08101;Hospitalet de Llobregat, l';6;2;U;;589;143;253;351;238;2;3;346;349
8;Barcelona;13;Barcelonès;08101;Hospitalet de Llobregat, l';6;20;U;;593;117;305;396;197;2;7;387;394
8;Barcelona;13;Barcelonès;08101;Hospitalet de Llobregat, l';6;21;A;;765;175;405;441;324;0;2;439;441
8;Barcelona;13;Barcelonès;08101;Hospitalet de Llobregat, l';6;21;B;;658;161;308;413;245;1;3;409;412
8;Barcelona;13;Barcelonès;08101;Hospitalet de Llobregat, l';6;22;U;;813;164;346;431;382;2;1;428;429
8;Barcelona;13;Barcelonès;08101;Hospitalet de Llobregat, l';6;23;A;;681;168;325;422;259;0;9;413;422
8;Barcelona;13;Barcelonès;08101;Hospitalet de Llobregat, l';6;23;B;;754;171;345;468;286;0;5;463;468
8;Barcelona;13;Barcelonès;08101;Hospitalet de Llobregat, l';6;24;U;;1114;235;477;654;460;6;10;638;648
8;Barcelona;13;Barcelonès;08101;Hospitalet de Llobregat, l';6;25;U;;1122;256;525;696;426;0;6;690;696
8;Barcelona;13;Barcelonès;08101;Hospitalet de Llobregat, l';6;26;U;;1091;261;490;608;483;0;9;599;608
8;Barcelona;13;Barcelonès;08101;Hospitalet de Llobregat, l';6;27;U;;961;186;444;592;369;0;4;588;592
8;Barcelona;13;Barcelonès;08101;Hospitalet de Llobregat, l';6;28;U;;1058;257;487;621;437;2;5;614;619
8;Barcelona;13;Barcelonès;08101;Hospitalet de Llobregat, l';6;29;U;;576;127;244;307;269;0;5;302;307
8;Barcelona;13;Barcelonès;08101;Hospitalet de Llobregat, l';6;3;U;;601;131;273;365;236;0;3;362;365
8;Barcelona;13;Barcelonès;08101;Hospitalet de Llobregat, l';6;30;U;;802;205;413;510;292;2;2;506;508
8;Barcelona;13;Barcelonès;08101;Hospitalet de Llobregat, l';6;31;U;;1126;236;535;665;461;2;6;657;663
8;Barcelona;13;Barcelonès;08101;Hospitalet de Llobregat, l';6;32;U;;968;173;382;485;483;7;3;475;478
8;Barcelona;13;Barcelonès;08101;Hospitalet de Llobregat, l';6;4;U;;697;176;302;389;308;1;7;381;388
8;Barcelona;13;Barcelonès;08101;Hospitalet de Llobregat, l';6;5;U;;723;186;380;465;258;2;4;459;463
8;Barcelona;13;Barcelonès;08101;Hospitalet de Llobregat, l';6;6;U;;974;323;533;577;397;4;6;567;573
8;Barcelona;13;Barcelonès;08101;Hospitalet de Llobregat, l';6;7;U;;1010;238;459;582;428;1;5;576;581
8;Barcelona;13;Barcelonès;08101;Hospitalet de Llobregat, l';6;8;U;;889;201;376;465;424;0;1;464;465
8;Barcelona;13;Barcelonès;08101;Hospitalet de Llobregat, l';6;9;U;;919;253;430;537;382;1;3;533;536
8;Barcelona;6;Anoia;08162;Hostalets de Pierola, els;1;1;U;;932;228;534;635;297;5;5;625;630
17;Girona;34;Selva;17083;Hostalric;1;1;A;;483;154;298;349;134;2;2;345;347
17;Girona;34;Selva;17083;Hostalric;1;1;B;;579;180;368;427;152;0;6;421;427
17;Girona;34;Selva;17083;Hostalric;1;2;A;;601;157;367;424;177;0;3;421;424
17;Girona;34;Selva;17083;Hostalric;1;2;B;;655;176;378;437;218;0;2;435;437
8;Barcelona;6;Anoia;08102;Igualada;1;1;A;;437;128;229;285;152;1;3;281;284
8;Barcelona;6;Anoia;08102;Igualada;1;1;B;;596;191;341;401;195;2;3;396;399
8;Barcelona;6;Anoia;08102;Igualada;1;3;U;;516;147;227;293;223;1;6;286;292
8;Barcelona;6;Anoia;08102;Igualada;2;1;U;;571;169;324;402;169;1;3;398;401
8;Barcelona;6;Anoia;08102;Igualada;2;2;U;;823;240;474;565;258;1;7;557;564
8;Barcelona;6;Anoia;08102;Igualada;2;3;A;;691;188;400;505;186;2;8;495;503
8;Barcelona;6;Anoia;08102;Igualada;2;3;B;;754;206;391;509;245;2;9;498;507
8;Barcelona;6;Anoia;08102;Igualada;3;1;U;;982;303;521;660;322;2;10;648;658
8;Barcelona;6;Anoia;08102;Igualada;3;2;U;;757;217;386;496;261;5;2;489;491
8;Barcelona;6;Anoia;08102;Igualada;3;3;A;;592;174;340;420;172;0;4;416;420
8;Barcelona;6;Anoia;08102;Igualada;3;3;B;;690;162;340;464;226;1;5;458;463
8;Barcelona;6;Anoia;08102;Igualada;3;4;A;;662;139;317;411;251;3;3;405;408
8;Barcelona;6;Anoia;08102;Igualada;3;4;B;;817;223;453;563;254;3;8;552;560
8;Barcelona;6;Anoia;08102;Igualada;3;5;A;;446;114;226;272;174;0;2;270;272
8;Barcelona;6;Anoia;08102;Igualada;3;5;B;;582;162;317;377;205;0;2;375;377
8;Barcelona;6;Anoia;08102;Igualada;3;6;A;;690;166;359;477;213;0;2;475;477
8;Barcelona;6;Anoia;08102;Igualada;3;6;B;;736;182;409;522;214;2;4;516;520
8;Barcelona;6;Anoia;08102;Igualada;3;7;A;;794;183;384;533;261;0;5;528;533
8;Barcelona;6;Anoia;08102;Igualada;3;7;B;;910;196;463;640;270;2;11;627;638
8;Barcelona;6;Anoia;08102;Igualada;4;1;U;;712;236;404;490;222;1;4;485;489
8;Barcelona;6;Anoia;08102;Igualada;4;2;U;;814;227;438;533;281;2;5;526;531
8;Barcelona;6;Anoia;08102;Igualada;4;3;U;;747;236;431;525;222;1;10;514;524
8;Barcelona;6;Anoia;08102;Igualada;4;4;A;;458;133;243;313;145;0;2;311;313
8;Barcelona;6;Anoia;08102;Igualada;4;4;B;;516;133;273;359;157;0;3;356;359
8;Barcelona;6;Anoia;08102;Igualada;4;5;A;;647;164;359;447;200;1;7;439;446
8;Barcelona;6;Anoia;08102;Igualada;4;5;B;;797;210;442;568;229;0;8;560;568
8;Barcelona;6;Anoia;08102;Igualada;5;1;A;;548;153;276;361;187;1;7;353;360
8;Barcelona;6;Anoia;08102;Igualada;5;1;B;;579;167;332;401;178;2;5;394;399
8;Barcelona;6;Anoia;08102;Igualada;5;2;A;;557;122;287;359;198;1;0;358;358
8;Barcelona;6;Anoia;08102;Igualada;5;2;B;;715;200;409;504;211;0;5;499;504
8;Barcelona;6;Anoia;08102;Igualada;5;3;A;;815;227;437;577;238;0;7;570;577
8;Barcelona;6;Anoia;08102;Igualada;5;3;B;;1052;270;566;732;320;6;7;719;726
8;Barcelona;6;Anoia;08102;Igualada;5;4;A;;559;125;288;375;184;0;2;373;375
8;Barcelona;6;Anoia;08102;Igualada;5;4;B;;658;133;336;443;215;3;5;435;440
8;Barcelona;6;Anoia;08102;Igualada;5;5;U;;704;150;317;405;299;3;2;400;402
8;Barcelona;6;Anoia;08102;Igualada;5;6;A;;523;166;282;322;201;0;1;321;322
8;Barcelona;6;Anoia;08102;Igualada;5;6;B;;594;207;336;375;219;1;2;372;374
8;Barcelona;6;Anoia;08102;Igualada;5;7;U;;980;240;533;684;296;2;5;677;682
25;Lleida;25;Pallars Jussà;25115;Isona i Conca Dellà;1;1;A;;741;166;392;491;250;0;3;488;491
25;Lleida;25;Pallars Jussà;25115;Isona i Conca Dellà;1;1;B;;217;28;95;136;81;2;4;130;134
25;Lleida;25;Pallars Jussà;25115;Isona i Conca Dellà;1;1;C;;211;50;129;156;55;0;0;156;156
17;Girona;15;Cerdanya;17084;Isòvol;1;1;U;;150;47;111;123;27;2;2;119;121
25;Lleida;27;Pla d'Urgell;25113;Ivars d'Urgell;1;1;U;;707;179;422;534;173;0;5;529;534
25;Lleida;27;Pla d'Urgell;25113;Ivars d'Urgell;1;2;U;;741;198;460;584;157;2;3;579;582
25;Lleida;23;Noguera;25112;Ivars de Noguera;1;1;U;;286;75;198;241;45;0;5;236;241
25;Lleida;32;Segarra;25114;Ivorra;1;1;U;;131;59;109;125;6;0;0;125;125
17;Girona;10;Baix Empordà;17085;Jafre;1;1;U;;303;140;217;236;67;1;1;234;235
17;Girona;2;Alt Empordà;17086;Jonquera, la;1;1;A;;412;114;230;278;134;0;2;276;278
17;Girona;2;Alt Empordà;17086;Jonquera, la;1;1;B;;417;111;213;264;153;0;1;263;264
17;Girona;2;Alt Empordà;17086;Jonquera, la;1;1;C;;472;113;238;292;180;0;6;286;292
17;Girona;2;Alt Empordà;17086;Jonquera, la;1;2;A;;340;88;184;237;103;0;2;235;237
17;Girona;2;Alt Empordà;17086;Jonquera, la;1;2;B;;332;94;192;225;107;1;0;224;224
8;Barcelona;6;Anoia;08103;Jorba;1;1;U;;467;124;275;316;151;0;5;311;316
25;Lleida;4;Alt Urgell;25910;Josa i Tuixén;1;1;U;;134;42;70;100;34;0;2;98;100
17;Girona;20;Gironès;17087;Juià;1;1;U;;219;66;132;155;64;0;0;155;155
25;Lleida;18;Garrigues;25118;Juncosa;1;1;U;;477;105;227;323;154;2;3;318;321
25;Lleida;18;Garrigues;25119;Juneda;1;1;A;;762;141;380;556;206;1;10;545;555
25;Lleida;18;Garrigues;25119;Juneda;1;1;B;;721;130;370;536;185;3;6;527;533
25;Lleida;18;Garrigues;25119;Juneda;1;2;U;;953;216;560;748;205;2;15;731;746
25;Lleida;39;Consell General d'Aran;25121;Les;1;1;U;;541;151;298;393;148;1;4;388;392
25;Lleida;27;Pla d'Urgell;25122;Linyola;1;1;U;;987;280;616;759;228;2;10;747;757
25;Lleida;27;Pla d'Urgell;25122;Linyola;1;2;U;;959;261;577;730;229;0;8;722;730
8;Barcelona;6;Anoia;08104;Llacuna, la;1;1;U;;690;169;411;515;175;2;3;510;513
17;Girona;2;Alt Empordà;17088;Lladó;1;1;U;;415;160;270;313;102;0;3;310;313
25;Lleida;26;Pallars Sobirà;25123;Lladorre;1;1;U;;192;34;92;135;57;4;1;130;131
25;Lleida;35;Solsonès;25124;Lladurs;1;1;U;;205;40;98;121;84;0;2;119;121
8;Barcelona;41;Vallès Oriental;08105;Llagosta, la;1;1;A;;492;110;209;261;231;1;1;259;260
8;Barcelona;41;Vallès Oriental;08105;Llagosta, la;1;1;B;;737;165;315;413;324;1;4;408;412
8;Barcelona;41;Vallès Oriental;08105;Llagosta, la;1;2;A;;713;158;331;406;307;1;11;394;405
8;Barcelona;41;Vallès Oriental;08105;Llagosta, la;1;2;B;;821;185;384;486;335;3;5;478;483
8;Barcelona;41;Vallès Oriental;08105;Llagosta, la;1;3;A;;624;173;307;383;241;0;4;379;383
8;Barcelona;41;Vallès Oriental;08105;Llagosta, la;1;3;B;;764;190;353;452;312;0;5;447;452
8;Barcelona;41;Vallès Oriental;08105;Llagosta, la;1;4;A;;629;138;276;373;256;0;4;369;373
8;Barcelona;41;Vallès Oriental;08105;Llagosta, la;1;4;B;;739;190;371;453;286;0;6;447;453
8;Barcelona;41;Vallès Oriental;08105;Llagosta, la;1;5;A;;552;113;213;251;301;0;4;247;251
8;Barcelona;41;Vallès Oriental;08105;Llagosta, la;1;5;B;;670;164;284;346;324;0;4;342;346
8;Barcelona;41;Vallès Oriental;08105;Llagosta, la;1;6;A;;549;111;226;273;276;4;1;268;269
8;Barcelona;41;Vallès Oriental;08105;Llagosta, la;1;6;B;;738;193;350;433;305;0;1;432;433
8;Barcelona;41;Vallès Oriental;08105;Llagosta, la;1;7;A;;652;133;275;340;312;1;5;334;339
8;Barcelona;41;Vallès Oriental;08105;Llagosta, la;1;7;B;;695;171;306;369;326;1;3;365;368
17;Girona;20;Gironès;17089;Llagostera;1;1;A;;611;178;327;404;207;0;4;400;404
17;Girona;20;Gironès;17089;Llagostera;1;1;B;;743;213;417;524;219;1;3;520;523
17;Girona;20;Gironès;17089;Llagostera;1;2;A;;528;140;326;387;141;1;4;382;386
17;Girona;20;Gironès;17089;Llagostera;1;2;B;;667;180;406;471;196;1;7;463;470
17;Girona;20;Gironès;17089;Llagostera;1;3;U;;945;239;515;600;345;4;5;591;596
17;Girona;20;Gironès;17089;Llagostera;1;4;U;;802;222;480;572;230;4;5;563;568
17;Girona;20;Gironès;17090;Llambilles;1;1;U;;384;88;238;294;90;1;3;290;293
17;Girona;31;Ripollès;17091;Llanars;1;1;U;;363;131;242;288;75;0;4;284;288
17;Girona;2;Alt Empordà;17092;Llançà;1;1;U;;730;220;431;508;222;1;5;502;507
17;Girona;2;Alt Empordà;17092;Llançà;1;2;A;;676;194;385;481;195;1;4;476;480
17;Girona;2;Alt Empordà;17092;Llançà;1;2;B;;567;166;326;410;157;1;1;408;409
17;Girona;2;Alt Empordà;17092;Llançà;1;3;A;;448;122;268;326;122;1;2;323;325
17;Girona;2;Alt Empordà;17092;Llançà;1;3;B;;456;136;281;345;111;1;1;343;344
25;Lleida;33;Segrià;25125;Llardecans;1;1;U;;555;115;292;396;159;8;7;381;388
25;Lleida;26;Pallars Sobirà;25126;Llavorsí;1;1;U;;232;72;143;170;62;1;3;166;169
25;Lleida;33;Segrià;25120;Lleida;1;1;A;;870;251;474;605;265;1;8;596;604
25;Lleida;33;Segrià;25120;Lleida;1;1;B;;984;284;562;670;314;2;13;655;668
25;Lleida;33;Segrià;25120;Lleida;1;10;A;;550;120;253;321;229;0;2;319;321
25;Lleida;33;Segrià;25120;Lleida;1;10;B;;774;162;330;444;330;0;5;439;444
25;Lleida;33;Segrià;25120;Lleida;1;11;U;;1070;98;483;627;443;1;7;619;626
25;Lleida;33;Segrià;25120;Lleida;1;2;U;;647;146;327;418;229;0;3;415;418
25;Lleida;33;Segrià;25120;Lleida;1;3;U;;1057;243;521;682;375;1;4;677;681
25;Lleida;33;Segrià;25120;Lleida;1;4;U;;1292;299;608;788;504;1;5;782;787
25;Lleida;33;Segrià;25120;Lleida;1;5;A;;579;140;274;340;239;2;4;334;338
25;Lleida;33;Segrià;25120;Lleida;1;5;B;;830;212;397;504;326;3;9;492;501
25;Lleida;33;Segrià;25120;Lleida;1;6;A;;655;153;320;404;251;0;2;402;404
25;Lleida;33;Segrià;25120;Lleida;1;6;B;;737;172;364;440;297;0;11;429;440
25;Lleida;33;Segrià;25120;Lleida;1;7;U;;1097;220;500;631;466;4;10;617;627
25;Lleida;33;Segrià;25120;Lleida;1;8;A;;954;212;448;565;389;7;6;552;558
25;Lleida;33;Segrià;25120;Lleida;1;8;B;;1166;263;575;742;424;0;8;734;742
25;Lleida;33;Segrià;25120;Lleida;1;9;U;;1052;303;555;684;368;0;10;674;684
25;Lleida;33;Segrià;25120;Lleida;2;1;U;;898;286;483;550;348;1;6;543;549
25;Lleida;33;Segrià;25120;Lleida;2;2;U;;1206;285;610;787;419;1;5;781;786
25;Lleida;33;Segrià;25120;Lleida;2;3;A;;599;145;275;350;249;1;6;343;349
25;Lleida;33;Segrià;25120;Lleida;2;3;B;;665;150;313;391;274;0;5;386;391
25;Lleida;33;Segrià;25120;Lleida;2;4;U;;951;214;440;581;370;0;8;573;581
25;Lleida;33;Segrià;25120;Lleida;2;5;U;;517;110;250;314;203;1;1;312;313
25;Lleida;33;Segrià;25120;Lleida;2;6;A;;526;124;275;345;181;3;6;336;342
25;Lleida;33;Segrià;25120;Lleida;2;6;B;;685;164;348;423;262;3;7;413;420
25;Lleida;33;Segrià;25120;Lleida;2;7;A;;743;139;345;440;303;3;6;431;437
25;Lleida;33;Segrià;25120;Lleida;2;7;B;;776;155;333;450;326;0;4;446;450
25;Lleida;33;Segrià;25120;Lleida;2;8;A;;656;151;351;446;210;1;8;437;445
25;Lleida;33;Segrià;25120;Lleida;2;8;B;;750;167;376;479;271;1;12;466;478
25;Lleida;33;Segrià;25120;Lleida;3;1;U;;494;141;197;230;264;0;0;230;230
25;Lleida;33;Segrià;25120;Lleida;3;2;U;;496;109;199;242;254;3;3;236;239
25;Lleida;33;Segrià;25120;Lleida;3;3;U;;773;246;460;555;218;2;9;544;553
25;Lleida;33;Segrià;25120;Lleida;3;4;U;;994;262;528;717;277;1;16;700;716
25;Lleida;33;Segrià;25120;Lleida;3;5;U;;717;162;337;426;291;0;4;422;426
25;Lleida;33;Segrià;25120;Lleida;3;6;A;;569;144;280;362;207;0;4;358;362
25;Lleida;33;Segrià;25120;Lleida;3;6;B;;661;198;335;437;224;0;10;427;437
25;Lleida;33;Segrià;25120;Lleida;3;7;U;;557;142;249;331;226;1;5;325;330
25;Lleida;33;Segrià;25120;Lleida;3;8;U;;949;262;496;618;331;1;6;611;617
25;Lleida;33;Segrià;25120;Lleida;4;1;U;;840;204;357;405;435;2;4;399;403
25;Lleida;33;Segrià;25120;Lleida;4;10;A;;707;124;263;306;401;3;2;301;303
25;Lleida;33;Segrià;25120;Lleida;4;10;B;;657;106;256;313;344;4;2;307;309
25;Lleida;33;Segrià;25120;Lleida;4;11;A;;583;111;228;288;295;1;1;286;287
25;Lleida;33;Segrià;25120;Lleida;4;11;B;;620;137;262;313;307;2;1;310;311
25;Lleida;33;Segrià;25120;Lleida;4;12;U;;858;263;440;488;370;2;0;486;486
25;Lleida;33;Segrià;25120;Lleida;4;13;A;;641;116;288;372;269;1;0;371;371
25;Lleida;33;Segrià;25120;Lleida;4;13;B;;707;165;317;404;303;2;2;400;402
25;Lleida;33;Segrià;25120;Lleida;4;14;U;;770;152;341;467;303;1;2;464;466
25;Lleida;33;Segrià;25120;Lleida;4;15;A;;584;133;281;366;218;0;6;360;366
25;Lleida;33;Segrià;25120;Lleida;4;15;B;;704;158;347;426;278;1;5;420;425
25;Lleida;33;Segrià;25120;Lleida;4;16;A;;678;165;340;430;248;1;6;423;429
25;Lleida;33;Segrià;25120;Lleida;4;16;B;;773;196;386;492;281;0;8;484;492
25;Lleida;33;Segrià;25120;Lleida;4;17;A;;777;165;331;457;320;1;9;447;456
25;Lleida;33;Segrià;25120;Lleida;4;17;B;;728;143;337;428;300;0;5;423;428
25;Lleida;33;Segrià;25120;Lleida;4;2;U;;847;201;413;501;346;3;6;492;498
25;Lleida;33;Segrià;25120;Lleida;4;3;A;;774;231;434;534;240;3;11;520;531
25;Lleida;33;Segrià;25120;Lleida;4;3;B;;865;236;465;605;260;1;10;594;604
25;Lleida;33;Segrià;25120;Lleida;4;4;U;;836;212;423;541;295;5;6;530;536
25;Lleida;33;Segrià;25120;Lleida;4;5;U;;859;247;490;614;245;3;8;603;611
25;Lleida;33;Segrià;25120;Lleida;4;6;A;;607;141;306;410;197;1;7;402;409
25;Lleida;33;Segrià;25120;Lleida;4;6;B;;696;158;325;451;245;2;7;442;449
25;Lleida;33;Segrià;25120;Lleida;4;7;U;;1167;246;511;695;472;5;6;684;690
25;Lleida;33;Segrià;25120;Lleida;4;8;U;;1135;284;634;691;444;1;9;681;690
25;Lleida;33;Segrià;25120;Lleida;4;9;U;;529;109;200;237;292;0;3;234;237
25;Lleida;33;Segrià;25120;Lleida;5;1;U;;633;178;264;295;338;0;0;295;295
25;Lleida;33;Segrià;25120;Lleida;5;10;U;;1049;288;598;744;305;2;12;730;742
25;Lleida;33;Segrià;25120;Lleida;5;2;U;;1032;303;581;695;337;0;11;684;695
25;Lleida;33;Segrià;25120;Lleida;5;3;U;;1205;672;672;840;365;2;13;825;838
25;Lleida;33;Segrià;25120;Lleida;5;4;U;;1072;325;595;770;302;0;13;757;770
25;Lleida;33;Segrià;25120;Lleida;5;5;U;;1097;283;615;780;317;3;16;761;777
25;Lleida;33;Segrià;25120;Lleida;5;6;A;;877;190;458;617;260;0;11;606;617
25;Lleida;33;Segrià;25120;Lleida;5;6;B;;1096;224;552;719;377;0;9;710;719
25;Lleida;33;Segrià;25120;Lleida;5;7;U;;874;250;311;540;334;1;14;525;539
25;Lleida;33;Segrià;25120;Lleida;5;8;A;;796;189;424;541;255;1;8;532;540
25;Lleida;33;Segrià;25120;Lleida;5;8;B;;939;228;513;657;282;1;16;640;656
25;Lleida;33;Segrià;25120;Lleida;5;9;U;;901;211;458;606;295;3;11;592;603
25;Lleida;33;Segrià;25120;Lleida;6;1;U;;498;120;193;237;261;2;3;232;235
25;Lleida;33;Segrià;25120;Lleida;6;10;A;;669;170;330;430;239;1;6;423;429
25;Lleida;33;Segrià;25120;Lleida;6;10;B;;729;167;342;460;269;1;7;452;459
25;Lleida;33;Segrià;25120;Lleida;6;11;A;;803;202;404;514;289;5;6;503;509
25;Lleida;33;Segrià;25120;Lleida;6;11;B;;775;225;419;522;253;0;11;511;522
25;Lleida;33;Segrià;25120;Lleida;6;12;A;;761;182;374;511;250;0;9;502;511
25;Lleida;33;Segrià;25120;Lleida;6;12;B;;766;186;375;515;251;0;12;503;515
25;Lleida;33;Segrià;25120;Lleida;6;13;A;;578;181;332;429;149;0;5;424;429
25;Lleida;33;Segrià;25120;Lleida;6;13;B;;637;197;349;450;187;2;3;445;448
25;Lleida;33;Segrià;25120;Lleida;6;14;U;;642;150;310;396;246;0;1;395;396
25;Lleida;33;Segrià;25120;Lleida;6;15;U;;685;177;385;479;206;0;9;470;479
25;Lleida;33;Segrià;25120;Lleida;6;2;A;;792;217;408;551;241;2;8;541;549
25;Lleida;33;Segrià;25120;Lleida;6;2;B;;824;225;431;558;266;2;7;549;556
25;Lleida;33;Segrià;25120;Lleida;6;3;A;;802;165;364;509;293;0;8;501;509
25;Lleida;33;Segrià;25120;Lleida;6;3;B;;868;206;403;544;324;0;13;531;544
25;Lleida;33;Segrià;25120;Lleida;6;4;A;;593;137;299;398;195;0;6;392;398
25;Lleida;33;Segrià;25120;Lleida;6;4;B;;623;169;342;437;186;0;11;426;437
25;Lleida;33;Segrià;25120;Lleida;6;5;U;;921;264;574;675;246;1;8;666;674
25;Lleida;33;Segrià;25120;Lleida;6;6;A;;809;172;356;441;368;1;6;434;440
25;Lleida;33;Segrià;25120;Lleida;6;6;B;;930;195;406;506;424;1;10;495;505
25;Lleida;33;Segrià;25120;Lleida;6;7;A;;577;140;240;309;268;1;7;301;308
25;Lleida;33;Segrià;25120;Lleida;6;7;B;;729;186;342;420;309;0;6;414;420
25;Lleida;33;Segrià;25120;Lleida;6;8;U;;982;296;572;692;290;2;12;678;690
25;Lleida;33;Segrià;25120;Lleida;6;9;U;;1063;243;500;651;412;1;6;644;650
25;Lleida;33;Segrià;25120;Lleida;7;1;A;;981;214;467;589;392;1;3;585;588
25;Lleida;33;Segrià;25120;Lleida;7;1;B;;1080;235;489;640;440;1;14;625;639
25;Lleida;33;Segrià;25120;Lleida;7;2;A;;797;155;355;447;350;0;5;442;447
25;Lleida;33;Segrià;25120;Lleida;7;2;B;;915;180;395;505;410;1;5;499;504
25;Lleida;33;Segrià;25120;Lleida;7;4;A;;909;186;410;509;400;2;2;505;507
25;Lleida;33;Segrià;25120;Lleida;7;4;B;;988;226;466;579;409;1;1;577;578
25;Lleida;33;Segrià;25120;Lleida;7;5;U;;1248;228;553;739;509;3;7;729;736
25;Lleida;33;Segrià;25120;Lleida;7;6;A;;835;173;388;484;351;2;1;481;482
25;Lleida;33;Segrià;25120;Lleida;7;6;B;;942;188;437;554;388;0;7;547;554
25;Lleida;33;Segrià;25120;Lleida;8;1;A;;610;158;299;393;217;2;8;383;391
25;Lleida;33;Segrià;25120;Lleida;8;1;B;;851;131;263;436;415;0;5;431;436
25;Lleida;33;Segrià;25120;Lleida;8;2;A;;571;121;303;387;184;0;8;379;387
25;Lleida;33;Segrià;25120;Lleida;8;2;B;;374;60;169;217;157;0;5;212;217
25;Lleida;33;Segrià;25120;Lleida;8;2;C;;272;57;148;205;67;0;6;199;205
25;Lleida;33;Segrià;25120;Lleida;8;3;A;;358;99;207;263;95;1;2;260;262
25;Lleida;33;Segrià;25120;Lleida;8;3;B;;507;92;257;338;169;0;3;335;338
25;Lleida;33;Segrià;25120;Lleida;9;1;A;;500;93;262;316;184;5;5;306;311
25;Lleida;33;Segrià;25120;Lleida;9;1;B;;603;129;262;340;263;2;5;333;338
25;Lleida;33;Segrià;25120;Lleida;9;2;A;;748;157;343;435;313;0;4;431;435
25;Lleida;33;Segrià;25120;Lleida;9;2;B;;356;74;180;215;141;0;1;214;215
17;Girona;2;Alt Empordà;17093;Llers;1;1;U;;695;215;415;478;217;4;4;470;474
25;Lleida;15;Cerdanya;25127;Lles de Cerdanya;1;1;U;;254;58;141;173;81;1;0;172;172
8;Barcelona;41;Vallès Oriental;08107;Lliçà d'Amunt;1;1;A;;441;128;237;285;156;5;0;280;280
8;Barcelona;41;Vallès Oriental;08107;Lliçà d'Amunt;1;1;B;;612;178;345;415;197;1;3;411;414
8;Barcelona;41;Vallès Oriental;08107;Lliçà d'Amunt;1;2;A;;664;167;333;420;244;0;7;413;420
8;Barcelona;41;Vallès Oriental;08107;Lliçà d'Amunt;1;2;B;;845;217;434;526;319;1;4;521;525
8;Barcelona;41;Vallès Oriental;08107;Lliçà d'Amunt;1;3;A;;668;151;295;371;297;1;1;369;370
8;Barcelona;41;Vallès Oriental;08107;Lliçà d'Amunt;1;3;B;;862;183;347;443;419;1;3;439;442
8;Barcelona;41;Vallès Oriental;08107;Lliçà d'Amunt;1;4;A;;545;114;215;289;256;0;4;285;289
8;Barcelona;41;Vallès Oriental;08107;Lliçà d'Amunt;1;4;B;;664;143;265;330;334;0;6;324;330
8;Barcelona;41;Vallès Oriental;08107;Lliçà d'Amunt;1;4;C;;645;162;260;329;316;0;5;324;329
8;Barcelona;41;Vallès Oriental;08108;Lliçà de Vall;1;1;A;;888;226;450;537;351;2;2;533;535
8;Barcelona;41;Vallès Oriental;08108;Lliçà de Vall;1;1;B;;970;221;453;557;413;3;5;549;554
8;Barcelona;41;Vallès Oriental;08108;Lliçà de Vall;1;2;A;;701;206;385;469;232;3;4;462;466
8;Barcelona;41;Vallès Oriental;08108;Lliçà de Vall;1;2;B;;792;210;444;553;239;1;1;551;552
25;Lleida;25;Pallars Jussà;25128;Llimiana;1;1;U;;121;16;56;71;50;1;2;68;70
8;Barcelona;41;Vallès Oriental;08106;Llinars del Vallès;1;1;A;;732;182;368;452;280;2;5;445;450
8;Barcelona;41;Vallès Oriental;08106;Llinars del Vallès;1;1;B;;609;150;293;368;241;1;1;366;367
8;Barcelona;41;Vallès Oriental;08106;Llinars del Vallès;1;1;C;;774;209;382;491;283;1;4;486;490
8;Barcelona;41;Vallès Oriental;08106;Llinars del Vallès;2;1;A;;714;157;352;472;242;0;1;471;472
8;Barcelona;41;Vallès Oriental;08106;Llinars del Vallès;2;1;B;;765;170;397;493;272;1;4;488;492
8;Barcelona;41;Vallès Oriental;08106;Llinars del Vallès;2;2;A;;634;148;296;382;252;1;0;381;381
8;Barcelona;41;Vallès Oriental;08106;Llinars del Vallès;2;2;B;;658;162;309;394;264;0;2;392;394
17;Girona;15;Cerdanya;17094;Llívia;1;1;U;;759;241;451;556;203;1;10;545;555
43;Tarragona;29;Priorat;43072;Lloar, el;1;1;U;;115;40;85;99;16;2;4;93;97
25;Lleida;35;Solsonès;25129;Llobera;1;1;U;;214;52;98;145;69;1;2;142;144
43;Tarragona;16;Conca de Barberà;43073;Llorac;1;1;U;;93;27;52;75;18;1;4;70;74
43;Tarragona;12;Baix Penedès;43074;Llorenç del Penedès;1;1;U;;1123;310;691;856;267;9;3;844;847
17;Girona;34;Selva;17095;Lloret de Mar;1;1;A;;735;140;257;316;419;1;2;313;315
17;Girona;34;Selva;17095;Lloret de Mar;1;1;B;;682;126;273;352;330;0;2;350;352
17;Girona;34;Selva;17095;Lloret de Mar;1;2;A;;699;140;319;408;291;0;3;405;408
17;Girona;34;Selva;17095;Lloret de Mar;1;2;B;;617;126;288;359;258;2;3;354;357
17;Girona;34;Selva;17095;Lloret de Mar;2;1;A;;835;197;429;519;316;5;6;508;514
17;Girona;34;Selva;17095;Lloret de Mar;2;1;B;;799;206;439;531;268;1;4;526;530
17;Girona;34;Selva;17095;Lloret de Mar;2;2;A;;707;153;344;413;294;0;4;409;413
17;Girona;34;Selva;17095;Lloret de Mar;2;2;B;;640;141;284;342;298;1;1;340;341
17;Girona;34;Selva;17095;Lloret de Mar;2;3;A;;595;115;256;301;294;0;2;299;301
17;Girona;34;Selva;17095;Lloret de Mar;2;3;B;;625;147;304;370;255;0;0;370;370
17;Girona;34;Selva;17095;Lloret de Mar;3;1;A;;720;116;284;358;362;0;4;354;358
17;Girona;34;Selva;17095;Lloret de Mar;3;1;B;;698;151;279;367;331;0;1;366;367
17;Girona;34;Selva;17095;Lloret de Mar;3;2;A;;670;148;280;386;284;6;1;379;380
17;Girona;34;Selva;17095;Lloret de Mar;3;2;B;;697;143;308;378;319;1;1;376;377
17;Girona;34;Selva;17095;Lloret de Mar;3;2;C;;660;126;288;383;277;3;6;374;380
17;Girona;34;Selva;17095;Lloret de Mar;4;1;U;;744;145;303;381;363;1;0;380;380
17;Girona;34;Selva;17095;Lloret de Mar;4;2;A;;504;89;214;279;225;1;0;278;278
17;Girona;34;Selva;17095;Lloret de Mar;4;2;B;;612;95;229;310;302;1;4;305;309
17;Girona;34;Selva;17095;Lloret de Mar;4;2;C;;505;94;184;250;255;1;0;249;249
17;Girona;31;Ripollès;17096;Llosses, les;1;1;U;;302;69;146;162;140;3;1;158;159
8;Barcelona;24;Osona;08109;Lluçà;1;1;U;;220;61;132;171;49;0;2;169;171
17;Girona;2;Alt Empordà;17102;Maçanet de Cabrenys;1;1;U;;552;208;352;431;121;2;4;425;429
17;Girona;34;Selva;17103;Maçanet de la Selva;1;1;A;;819;189;404;556;263;2;5;549;554
17;Girona;34;Selva;17103;Maçanet de la Selva;1;1;B;;875;200;425;585;290;6;3;576;579
17;Girona;34;Selva;17103;Maçanet de la Selva;1;2;U;;1098;291;483;600;498;1;3;596;599
17;Girona;20;Gironès;17097;Madremanya;1;1;U;;172;56;106;129;43;0;1;128;129
17;Girona;19;Garrotxa;17098;Maià de Montcal;1;1;U;;278;71;158;192;86;2;1;189;190
25;Lleida;33;Segrià;25133;Maials;1;1;U;;902;231;514;663;239;0;3;660;663
25;Lleida;38;Urgell;25130;Maldà;1;1;U;;270;32;143;181;89;0;0;181;181
8;Barcelona;21;Maresme;08110;Malgrat de Mar;1;1;A;;820;203;383;491;329;1;3;487;490
8;Barcelona;21;Maresme;08110;Malgrat de Mar;1;1;B;;954;256;487;601;353;3;0;598;598
8;Barcelona;21;Maresme;08110;Malgrat de Mar;1;2;A;;500;162;276;341;159;0;3;338;341
8;Barcelona;21;Maresme;08110;Malgrat de Mar;1;2;B;;707;226;412;494;213;0;5;489;494
8;Barcelona;21;Maresme;08110;Malgrat de Mar;1;3;A;;537;125;267;326;211;0;4;322;326
8;Barcelona;21;Maresme;08110;Malgrat de Mar;1;3;B;;625;158;342;395;230;0;2;393;395
8;Barcelona;21;Maresme;08110;Malgrat de Mar;1;4;A;;663;145;314;385;278;1;2;382;384
8;Barcelona;21;Maresme;08110;Malgrat de Mar;1;4;B;;736;180;339;423;313;0;3;420;423
8;Barcelona;21;Maresme;08110;Malgrat de Mar;1;5;A;;618;132;306;357;261;0;2;355;357
8;Barcelona;21;Maresme;08110;Malgrat de Mar;1;5;B;;669;146;335;410;259;0;6;404;410
8;Barcelona;21;Maresme;08110;Malgrat de Mar;2;1;A;;723;182;389;473;250;0;6;467;473
8;Barcelona;21;Maresme;08110;Malgrat de Mar;2;1;B;;934;270;514;618;316;4;3;611;614
8;Barcelona;21;Maresme;08110;Malgrat de Mar;2;2;A;;498;136;290;359;139;0;3;356;359
8;Barcelona;21;Maresme;08110;Malgrat de Mar;2;2;B;;466;113;233;311;155;0;2;309;311
8;Barcelona;21;Maresme;08110;Malgrat de Mar;2;2;C;;585;144;510;384;201;0;4;380;384
8;Barcelona;24;Osona;08111;Malla;1;1;U;;207;75;136;174;33;0;2;172;174
8;Barcelona;24;Osona;08112;Manlleu;1;1;A;;549;167;336;421;128;0;2;419;421
8;Barcelona;24;Osona;08112;Manlleu;1;1;B;;648;332;501;484;164;2;3;479;482
8;Barcelona;24;Osona;08112;Manlleu;1;2;U;;734;235;486;572;162;1;2;569;571
8;Barcelona;24;Osona;08112;Manlleu;2;1;A;;593;190;356;425;168;10;5;410;415
8;Barcelona;24;Osona;08112;Manlleu;2;1;B;;777;252;512;583;194;1;4;578;582
8;Barcelona;24;Osona;08112;Manlleu;2;2;A;;589;121;342;409;180;0;3;406;409
8;Barcelona;24;Osona;08112;Manlleu;2;2;B;;737;153;426;501;236;0;1;500;501
8;Barcelona;24;Osona;08112;Manlleu;2;3;A;;513;134;308;377;136;0;2;375;377
8;Barcelona;24;Osona;08112;Manlleu;2;3;B;;558;138;330;413;145;1;2;410;412
8;Barcelona;24;Osona;08112;Manlleu;2;4;A;;516;129;278;354;162;1;1;352;353
8;Barcelona;24;Osona;08112;Manlleu;2;4;B;;608;156;373;465;143;1;1;463;464
8;Barcelona;24;Osona;08112;Manlleu;3;1;A;;878;216;485;587;291;1;3;583;586
8;Barcelona;24;Osona;08112;Manlleu;3;1;B;;856;249;508;568;288;1;4;563;567
8;Barcelona;24;Osona;08112;Manlleu;3;2;A;;666;184;416;502;164;1;2;499;501
8;Barcelona;24;Osona;08112;Manlleu;3;2;B;;762;199;456;554;208;2;10;542;552
8;Barcelona;24;Osona;08112;Manlleu;3;3;A;;625;180;350;408;217;0;1;407;408
8;Barcelona;24;Osona;08112;Manlleu;3;3;B;;793;793;446;523;270;0;4;519;523
8;Barcelona;24;Osona;08112;Manlleu;4;1;U;;643;643;412;471;172;0;4;467;471
8;Barcelona;24;Osona;08112;Manlleu;4;2;A;;569;167;371;439;130;0;0;439;439
8;Barcelona;24;Osona;08112;Manlleu;4;2;B;;672;201;412;492;180;1;6;485;491
8;Barcelona;7;Bages;08113;Manresa;1;1;U;;585;175;279;321;264;2;3;316;319
8;Barcelona;7;Bages;08113;Manresa;1;2;U;;405;104;207;252;153;0;1;251;252
8;Barcelona;7;Bages;08113;Manresa;1;3;U;;422;124;200;264;158;0;2;262;264
8;Barcelona;7;Bages;08113;Manresa;1;4;U;;415;131;221;275;140;1;3;271;274
8;Barcelona;7;Bages;08113;Manresa;2;1;U;;845;250;485;616;229;1;7;608;615
8;Barcelona;7;Bages;08113;Manresa;2;10;A;;631;195;360;462;169;1;4;457;461
8;Barcelona;7;Bages;08113;Manresa;2;10;B;;735;215;396;515;220;1;4;510;514
8;Barcelona;7;Bages;08113;Manresa;2;11;A;;553;171;291;354;199;1;1;352;353
8;Barcelona;7;Bages;08113;Manresa;2;11;B;;683;172;375;466;217;0;2;464;466
8;Barcelona;7;Bages;08113;Manresa;2;12;U;;784;227;429;543;241;3;6;534;540
8;Barcelona;7;Bages;08113;Manresa;2;13;A;;523;124;282;369;154;1;4;364;368
8;Barcelona;7;Bages;08113;Manresa;2;13;B;;672;157;374;465;207;6;0;459;459
8;Barcelona;7;Bages;08113;Manresa;2;14;U;;582;112;222;317;265;0;4;313;317
8;Barcelona;7;Bages;08113;Manresa;2;2;A;;673;175;372;482;191;1;5;476;481
8;Barcelona;7;Bages;08113;Manresa;2;2;B;;888;219;489;636;252;5;9;622;631
8;Barcelona;7;Bages;08113;Manresa;2;3;A;;605;189;334;426;179;1;2;423;425
8;Barcelona;7;Bages;08113;Manresa;2;3;B;;834;235;456;584;250;3;7;574;581
8;Barcelona;7;Bages;08113;Manresa;2;4;A;;691;184;365;489;202;1;7;481;488
8;Barcelona;7;Bages;08113;Manresa;2;4;B;;968;243;512;670;298;1;3;666;669
8;Barcelona;7;Bages;08113;Manresa;2;5;A;;730;221;406;509;221;1;3;505;508
8;Barcelona;7;Bages;08113;Manresa;2;5;B;;822;242;444;577;245;3;7;567;574
8;Barcelona;7;Bages;08113;Manresa;2;6;U;;708;192;342;415;293;0;2;413;415
8;Barcelona;7;Bages;08113;Manresa;2;7;A;;457;107;212;267;190;1;4;262;266
8;Barcelona;7;Bages;08113;Manresa;2;7;B;;561;150;289;336;225;1;5;330;335
8;Barcelona;7;Bages;08113;Manresa;2;8;U;;657;176;335;405;252;2;0;403;403
8;Barcelona;7;Bages;08113;Manresa;2;9;A;;615;155;294;383;232;0;2;381;383
8;Barcelona;7;Bages;08113;Manresa;2;9;B;;786;205;387;501;285;0;6;495;501
8;Barcelona;7;Bages;08113;Manresa;3;1;U;;497;144;226;295;202;2;5;288;293
8;Barcelona;7;Bages;08113;Manresa;3;2;U;;707;230;384;469;238;6;6;457;463
8;Barcelona;7;Bages;08113;Manresa;3;3;U;;497;145;249;308;189;2;2;304;306
8;Barcelona;7;Bages;08113;Manresa;3;4;A;;447;140;253;311;136;1;1;309;310
8;Barcelona;7;Bages;08113;Manresa;3;4;B;;637;212;364;436;201;2;6;428;434
8;Barcelona;7;Bages;08113;Manresa;3;5;U;;329;98;185;209;120;1;1;207;208
8;Barcelona;7;Bages;08113;Manresa;3;6;A;;439;120;240;302;137;0;4;298;302
8;Barcelona;7;Bages;08113;Manresa;3;6;B;;625;177;314;397;228;2;6;389;395
8;Barcelona;7;Bages;08113;Manresa;3;7;U;;648;195;353;435;213;5;3;427;430
8;Barcelona;7;Bages;08113;Manresa;4;1;U;;545;174;309;364;181;0;8;356;364
8;Barcelona;7;Bages;08113;Manresa;4;10;A;;476;132;248;316;160;0;2;314;316
8;Barcelona;7;Bages;08113;Manresa;4;10;B;;574;162;307;404;170;3;8;393;401
8;Barcelona;7;Bages;08113;Manresa;4;11;U;;834;204;429;571;263;2;4;565;569
8;Barcelona;7;Bages;08113;Manresa;4;12;U;;717;185;372;472;245;2;3;467;470
8;Barcelona;7;Bages;08113;Manresa;4;2;A;;564;164;326;406;158;0;5;401;406
8;Barcelona;7;Bages;08113;Manresa;4;2;B;;556;168;310;381;175;1;2;378;380
8;Barcelona;7;Bages;08113;Manresa;4;3;U;;865;254;466;575;290;1;3;571;574
8;Barcelona;7;Bages;08113;Manresa;4;4;A;;638;191;343;453;185;1;8;444;452
8;Barcelona;7;Bages;08113;Manresa;4;4;B;;932;275;540;675;257;4;15;656;671
8;Barcelona;7;Bages;08113;Manresa;4;5;U;;489;135;285;361;128;0;6;355;361
8;Barcelona;7;Bages;08113;Manresa;4;6;A;;582;168;322;416;166;1;5;410;415
8;Barcelona;7;Bages;08113;Manresa;4;6;B;;750;223;429;548;202;3;0;545;545
8;Barcelona;7;Bages;08113;Manresa;4;7;A;;631;144;320;417;214;0;1;416;417
8;Barcelona;7;Bages;08113;Manresa;4;7;B;;722;216;370;477;245;0;6;471;477
8;Barcelona;7;Bages;08113;Manresa;4;8;A;;662;193;366;467;195;0;4;463;467
8;Barcelona;7;Bages;08113;Manresa;4;8;B;;792;208;457;554;238;0;3;551;554
8;Barcelona;7;Bages;08113;Manresa;4;9;A;;624;159;337;430;194;1;4;425;429
8;Barcelona;7;Bages;08113;Manresa;4;9;B;;607;144;299;387;220;0;7;380;387
8;Barcelona;7;Bages;08113;Manresa;4;9;C;;847;200;454;556;291;0;8;548;556
8;Barcelona;7;Bages;08113;Manresa;5;1;U;;967;232;470;592;375;1;1;590;591
8;Barcelona;7;Bages;08113;Manresa;5;10;A;;530;124;276;319;211;0;1;318;319
8;Barcelona;7;Bages;08113;Manresa;5;10;B;;606;151;303;373;233;0;12;361;373
8;Barcelona;7;Bages;08113;Manresa;5;11;A;;490;144;258;331;159;0;1;330;331
8;Barcelona;7;Bages;08113;Manresa;5;11;B;;613;155;307;395;218;0;5;390;395
8;Barcelona;7;Bages;08113;Manresa;5;12;U;;790;211;367;458;332;3;6;449;455
8;Barcelona;7;Bages;08113;Manresa;5;13;A;;565;147;278;358;207;1;3;354;357
8;Barcelona;7;Bages;08113;Manresa;5;13;B;;637;163;323;416;221;0;6;410;416
8;Barcelona;7;Bages;08113;Manresa;5;14;A;;510;132;268;354;156;0;1;353;354
8;Barcelona;7;Bages;08113;Manresa;5;14;B;;657;163;353;469;188;1;11;457;468
8;Barcelona;7;Bages;08113;Manresa;5;15;A;;692;128;308;389;303;1;2;386;388
8;Barcelona;7;Bages;08113;Manresa;5;15;B;;884;159;368;469;415;1;3;465;468
8;Barcelona;7;Bages;08113;Manresa;5;15;C;;884;162;382;500;384;1;8;491;499
8;Barcelona;7;Bages;08113;Manresa;5;16;U;;606;157;275;354;252;2;5;347;352
8;Barcelona;7;Bages;08113;Manresa;5;2;U;;325;101;165;188;137;0;2;186;188
8;Barcelona;7;Bages;08113;Manresa;5;3;U;;897;221;466;584;313;9;4;571;575
8;Barcelona;7;Bages;08113;Manresa;5;4;U;;606;203;375;432;174;1;3;428;431
8;Barcelona;7;Bages;08113;Manresa;5;5;A;;515;140;268;346;169;2;1;343;344
8;Barcelona;7;Bages;08113;Manresa;5;5;B;;624;163;343;418;206;0;6;412;418
8;Barcelona;7;Bages;08113;Manresa;5;6;A;;625;144;304;394;231;1;6;387;393
8;Barcelona;7;Bages;08113;Manresa;5;6;B;;834;210;449;561;273;2;15;544;559
8;Barcelona;7;Bages;08113;Manresa;5;7;U;;446;109;219;271;175;1;5;265;270
8;Barcelona;7;Bages;08113;Manresa;5;8;U;;584;127;286;380;204;0;2;378;380
8;Barcelona;7;Bages;08113;Manresa;5;9;U;;889;216;432;540;349;2;8;530;538
8;Barcelona;7;Bages;08113;Manresa;6;1;A;;514;144;258;308;206;2;5;301;306
8;Barcelona;7;Bages;08113;Manresa;6;1;B;;688;183;360;405;283;1;3;401;404
8;Barcelona;7;Bages;08113;Manresa;6;2;U;;486;121;241;306;180;0;10;296;306
8;Barcelona;7;Bages;08113;Manresa;6;3;U;;408;101;216;267;141;4;4;259;263
43;Tarragona;29;Priorat;43076;Marçà;1;1;U;;490;143;322;392;98;2;4;386;390
43;Tarragona;29;Priorat;43075;Margalef;1;1;U;;130;44;70;91;39;0;2;89;91
8;Barcelona;7;Bages;08242;Marganell;1;1;U;;211;50;92;149;62;0;0;149;149
8;Barcelona;11;Baix Llobregat;08114;Martorell;1;1;A;;472;127;276;336;136;2;2;332;334
8;Barcelona;11;Baix Llobregat;08114;Martorell;1;1;B;;469;127;270;322;147;1;1;320;321
8;Barcelona;11;Baix Llobregat;08114;Martorell;2;1;U;;661;170;341;426;235;1;5;420;425
8;Barcelona;11;Baix Llobregat;08114;Martorell;2;2;A;;520;150;294;357;163;4;5;348;353
8;Barcelona;11;Baix Llobregat;08114;Martorell;2;2;B;;517;162;308;368;149;3;2;363;365
8;Barcelona;11;Baix Llobregat;08114;Martorell;3;1;A;;608;199;316;375;233;0;3;372;375
8;Barcelona;11;Baix Llobregat;08114;Martorell;3;1;B;;552;132;260;341;211;1;6;334;340
8;Barcelona;11;Baix Llobregat;08114;Martorell;3;1;C;;631;150;325;398;233;0;3;395;398
8;Barcelona;11;Baix Llobregat;08114;Martorell;3;2;A;;460;136;252;296;164;0;1;295;296
8;Barcelona;11;Baix Llobregat;08114;Martorell;3;2;B;;494;126;241;289;205;0;2;287;289
8;Barcelona;11;Baix Llobregat;08114;Martorell;3;3;A;;380;113;212;237;143;0;0;237;237
8;Barcelona;11;Baix Llobregat;08114;Martorell;3;3;B;;491;157;271;311;180;0;1;310;311
8;Barcelona;11;Baix Llobregat;08114;Martorell;3;4;A;;522;134;257;315;207;1;2;312;314
8;Barcelona;11;Baix Llobregat;08114;Martorell;3;4;B;;623;157;295;354;269;1;4;349;353
8;Barcelona;11;Baix Llobregat;08114;Martorell;3;4;C;;647;143;270;353;294;0;3;350;353
8;Barcelona;11;Baix Llobregat;08114;Martorell;3;5;A;;599;172;304;381;218;0;0;381;381
8;Barcelona;11;Baix Llobregat;08114;Martorell;3;5;B;;631;197;330;405;226;2;4;399;403
8;Barcelona;11;Baix Llobregat;08114;Martorell;3;6;A;;602;157;333;415;187;0;4;411;415
8;Barcelona;11;Baix Llobregat;08114;Martorell;3;6;B;;546;151;282;344;202;2;1;341;342
8;Barcelona;11;Baix Llobregat;08114;Martorell;3;6;C;;617;155;338;423;194;0;1;422;423
8;Barcelona;11;Baix Llobregat;08114;Martorell;3;7;A;;587;150;320;421;166;1;5;415;420
8;Barcelona;11;Baix Llobregat;08114;Martorell;3;7;B;;633;149;311;394;239;1;8;385;393
8;Barcelona;11;Baix Llobregat;08114;Martorell;3;8;A;;473;123;241;323;150;2;9;312;321
8;Barcelona;11;Baix Llobregat;08114;Martorell;3;8;B;;529;159;268;336;193;0;4;332;336
8;Barcelona;11;Baix Llobregat;08114;Martorell;3;9;A;;477;107;254;310;167;0;2;308;310
8;Barcelona;11;Baix Llobregat;08114;Martorell;3;9;B;;529;108;278;346;183;1;5;340;345
8;Barcelona;41;Vallès Oriental;08115;Martorelles;1;1;A;;447;120;206;254;193;1;2;251;253
8;Barcelona;41;Vallès Oriental;08115;Martorelles;1;1;B;;569;143;281;328;241;0;1;327;328
8;Barcelona;41;Vallès Oriental;08115;Martorelles;1;1;C;;578;156;273;343;235;0;2;341;343
8;Barcelona;41;Vallès Oriental;08115;Martorelles;1;2;A;;483;104;238;327;156;1;4;322;326
8;Barcelona;41;Vallès Oriental;08115;Martorelles;1;2;B;;711;160;379;496;215;0;2;494;496
8;Barcelona;41;Vallès Oriental;08115;Martorelles;1;3;A;;498;126;230;298;200;6;5;287;292
8;Barcelona;41;Vallès Oriental;08115;Martorelles;1;3;B;;650;154;302;386;264;3;2;381;383
17;Girona;2;Alt Empordà;17100;Masarac;1;1;U;;223;79;152;179;44;0;0;179;179
43;Tarragona;22;Montsià;43077;Mas de Barberans;1;1;U;;631;193;378;445;186;5;0;440;440
43;Tarragona;22;Montsià;43078;Masdenverge;1;1;U;;752;158;377;481;271;1;6;474;480
8;Barcelona;24;Osona;08116;Masies de Roda, les;1;1;U;;507;144;346;407;100;1;1;405;406
8;Barcelona;24;Osona;08117;Masies de Voltregà, les;1;1;A;;572;182;346;425;147;1;4;420;424
8;Barcelona;24;Osona;08117;Masies de Voltregà, les;1;1;B;;913;270;568;701;212;2;5;694;699
8;Barcelona;24;Osona;08117;Masies de Voltregà, les;2;1;U;;627;172;350;412;215;2;3;407;410
43;Tarragona;12;Baix Penedès;43079;Masllorenç;1;1;U;;338;97;251;288;50;1;3;284;287
8;Barcelona;21;Maresme;08118;Masnou, el;1;1;A;;644;143;318;409;235;1;3;405;408
8;Barcelona;21;Maresme;08118;Masnou, el;1;1;B;;620;142;328;423;197;0;7;416;423
8;Barcelona;21;Maresme;08118;Masnou, el;1;2;A;;954;282;533;639;315;0;3;636;639
8;Barcelona;21;Maresme;08118;Masnou, el;1;2;B;;1061;260;560;696;365;0;2;694;696
8;Barcelona;21;Maresme;08118;Masnou, el;1;3;A;;762;210;404;507;255;1;5;501;506
8;Barcelona;21;Maresme;08118;Masnou, el;1;3;B;;771;205;374;478;293;0;16;462;478
8;Barcelona;21;Maresme;08118;Masnou, el;1;4;A;;530;145;300;371;159;0;6;365;371
8;Barcelona;21;Maresme;08118;Masnou, el;1;4;B;;622;158;333;424;198;0;12;412;424
8;Barcelona;21;Maresme;08118;Masnou, el;1;5;A;;802;226;424;527;275;0;1;526;527
8;Barcelona;21;Maresme;08118;Masnou, el;1;5;B;;888;251;469;577;311;0;6;571;577
8;Barcelona;21;Maresme;08118;Masnou, el;1;6;A;;689;179;334;389;300;0;7;382;389
8;Barcelona;21;Maresme;08118;Masnou, el;1;6;B;;792;195;389;466;326;0;9;457;466
8;Barcelona;21;Maresme;08118;Masnou, el;1;7;A;;634;167;340;405;229;0;1;404;405
8;Barcelona;21;Maresme;08118;Masnou, el;1;7;B;;722;190;367;446;276;2;8;436;444
8;Barcelona;21;Maresme;08118;Masnou, el;1;8;U;;1047;251;537;628;419;0;3;625;628
8;Barcelona;21;Maresme;08118;Masnou, el;2;1;A;;636;168;343;433;203;1;3;429;432
8;Barcelona;21;Maresme;08118;Masnou, el;2;1;B;;676;187;386;465;211;2;7;456;463
8;Barcelona;21;Maresme;08118;Masnou, el;2;2;U;;740;194;410;498;242;1;10;487;497
8;Barcelona;21;Maresme;08118;Masnou, el;2;3;A;;499;151;288;356;143;0;6;350;356
8;Barcelona;21;Maresme;08118;Masnou, el;2;3;B;;587;149;315;382;205;0;2;380;382
8;Barcelona;21;Maresme;08118;Masnou, el;2;4;A;;646;176;331;401;245;0;7;394;401
8;Barcelona;21;Maresme;08118;Masnou, el;2;4;B;;703;177;360;452;251;0;5;447;452
43;Tarragona;1;Alt Camp;43080;Masó, la;1;1;U;;220;74;147;175;45;0;7;168;175
43;Tarragona;8;Baix Camp;43081;Maspujols;1;1;U;;359;105;242;286;73;0;1;285;286
8;Barcelona;6;Anoia;08119;Masquefa;1;1;A;;452;115;251;319;133;6;1;312;313
8;Barcelona;6;Anoia;08119;Masquefa;1;1;B;;476;127;261;324;152;2;7;315;322
8;Barcelona;6;Anoia;08119;Masquefa;1;1;C;;462;116;261;326;136;6;1;319;320
8;Barcelona;6;Anoia;08119;Masquefa;1;1;D;;388;85;202;268;120;4;1;263;264
8;Barcelona;6;Anoia;08119;Masquefa;1;2;A;;523;137;250;295;228;1;5;289;294
8;Barcelona;6;Anoia;08119;Masquefa;1;2;B;;299;96;151;181;118;0;2;179;181
43;Tarragona;29;Priorat;43082;Masroig, el;1;1;U;;474;140;314;395;79;3;2;390;392
25;Lleida;33;Segrià;25131;Massalcoreig;1;1;U;;549;232;415;460;89;1;1;458;459
17;Girona;34;Selva;17101;Massanes;1;1;U;;455;131;258;299;156;1;1;297;298
25;Lleida;32;Segarra;25132;Massoteres;1;1;U;;146;54;96;109;37;0;1;108;109
8;Barcelona;40;Vallès Occidental;08120;Matadepera;1;1;A;;945;238;583;740;205;0;7;733;740
8;Barcelona;40;Vallès Occidental;08120;Matadepera;1;1;B;;935;247;554;704;231;0;5;699;704
8;Barcelona;40;Vallès Occidental;08120;Matadepera;1;2;A;;622;146;377;502;120;1;7;494;501
8;Barcelona;40;Vallès Occidental;08120;Matadepera;1;2;B;;670;152;403;509;161;0;10;499;509
8;Barcelona;40;Vallès Occidental;08120;Matadepera;1;3;A;;632;165;374;485;147;1;7;477;484
8;Barcelona;40;Vallès Occidental;08120;Matadepera;1;3;B;;715;182;398;502;213;1;9;492;501
8;Barcelona;21;Maresme;08121;Mataró;1;1;U;;649;233;402;473;176;0;5;468;473
8;Barcelona;21;Maresme;08121;Mataró;1;2;A;;497;196;337;371;126;0;4;367;371
8;Barcelona;21;Maresme;08121;Mataró;1;2;B;;515;179;313;366;149;1;6;359;365
8;Barcelona;21;Maresme;08121;Mataró;1;3;A;;477;190;315;372;105;0;5;367;372
8;Barcelona;21;Maresme;08121;Mataró;1;3;B;;508;184;331;397;111;1;1;395;396
8;Barcelona;21;Maresme;08121;Mataró;1;4;A;;453;195;311;359;94;0;0;359;359
8;Barcelona;21;Maresme;08121;Mataró;1;4;B;;515;205;318;379;136;0;5;374;379
8;Barcelona;21;Maresme;08121;Mataró;1;5;A;;523;172;348;416;107;1;4;411;415
8;Barcelona;21;Maresme;08121;Mataró;1;5;B;;650;229;401;500;150;1;3;496;499
8;Barcelona;21;Maresme;08121;Mataró;1;6;A;;657;231;425;510;147;0;5;505;510
8;Barcelona;21;Maresme;08121;Mataró;1;6;B;;512;172;320;379;133;1;1;377;378
8;Barcelona;21;Maresme;08121;Mataró;1;6;C;;660;224;435;510;150;0;2;508;510
8;Barcelona;21;Maresme;08121;Mataró;1;7;A;;501;172;314;387;114;0;4;383;387
8;Barcelona;21;Maresme;08121;Mataró;1;7;B;;599;208;391;461;138;2;7;452;459
8;Barcelona;21;Maresme;08121;Mataró;1;8;U;;547;216;366;422;125;0;1;421;422
8;Barcelona;21;Maresme;08121;Mataró;2;1;A;;561;194;338;408;153;4;2;402;404
8;Barcelona;21;Maresme;08121;Mataró;2;1;B;;631;198;394;471;160;3;7;461;468
8;Barcelona;21;Maresme;08121;Mataró;2;10;U;;931;328;576;674;257;0;6;668;674
8;Barcelona;21;Maresme;08121;Mataró;2;11;A;;516;179;313;381;135;1;5;375;380
8;Barcelona;21;Maresme;08121;Mataró;2;11;B;;512;172;305;369;143;2;2;365;367
8;Barcelona;21;Maresme;08121;Mataró;2;12;U;;886;309;559;650;236;0;2;648;650
8;Barcelona;21;Maresme;08121;Mataró;2;2;U;;842;222;460;559;283;3;5;551;556
8;Barcelona;21;Maresme;08121;Mataró;2;3;U;;571;211;346;392;179;2;4;386;390
8;Barcelona;21;Maresme;08121;Mataró;2;4;U;;828;228;373;452;376;4;0;448;448
8;Barcelona;21;Maresme;08121;Mataró;2;5;A;;705;218;400;490;215;2;1;487;488
8;Barcelona;21;Maresme;08121;Mataró;2;5;B;;788;240;440;548;240;0;6;542;548
8;Barcelona;21;Maresme;08121;Mataró;2;6;A;;614;198;343;418;196;3;4;411;415
8;Barcelona;21;Maresme;08121;Mataró;2;6;B;;742;230;382;464;278;2;1;461;462
8;Barcelona;21;Maresme;08121;Mataró;2;7;U;;481;174;302;344;137;0;1;343;344
8;Barcelona;21;Maresme;08121;Mataró;2;8;A;;624;180;360;454;170;0;9;445;454
8;Barcelona;21;Maresme;08121;Mataró;2;8;B;;645;185;373;474;171;0;3;471;474
8;Barcelona;21;Maresme;08121;Mataró;2;9;U;;858;285;539;637;221;5;6;626;632
8;Barcelona;21;Maresme;08121;Mataró;3;1;A;;550;180;300;352;198;1;0;351;351
8;Barcelona;21;Maresme;08121;Mataró;3;1;B;;683;209;367;439;244;2;2;435;437
8;Barcelona;21;Maresme;08121;Mataró;3;10;U;;657;214;392;474;183;0;5;469;474
8;Barcelona;21;Maresme;08121;Mataró;3;11;A;;556;211;325;385;171;0;2;383;385
8;Barcelona;21;Maresme;08121;Mataró;3;11;B;;676;227;394;475;201;0;0;475;475
8;Barcelona;21;Maresme;08121;Mataró;3;12;U;;877;221;488;619;258;0;4;615;619
8;Barcelona;21;Maresme;08121;Mataró;3;2;A;;639;196;339;401;238;0;0;401;401
8;Barcelona;21;Maresme;08121;Mataró;3;2;B;;747;216;408;487;260;1;3;483;486
8;Barcelona;21;Maresme;08121;Mataró;3;3;A;;556;155;275;340;216;0;0;340;340
8;Barcelona;21;Maresme;08121;Mataró;3;3;B;;696;228;375;445;251;2;3;440;443
8;Barcelona;21;Maresme;08121;Mataró;3;4;A;;464;114;212;275;189;1;1;273;274
8;Barcelona;21;Maresme;08121;Mataró;3;4;B;;677;173;336;409;268;1;4;404;408
8;Barcelona;21;Maresme;08121;Mataró;3;4;C;;651;154;291;390;261;0;4;386;390
8;Barcelona;21;Maresme;08121;Mataró;3;5;A;;588;173;288;345;243;0;4;341;345
8;Barcelona;21;Maresme;08121;Mataró;3;5;B;;766;200;348;435;331;0;4;431;435
8;Barcelona;21;Maresme;08121;Mataró;3;6;A;;453;102;235;294;159;0;5;289;294
8;Barcelona;21;Maresme;08121;Mataró;3;6;B;;613;147;307;390;223;0;4;386;390
8;Barcelona;21;Maresme;08121;Mataró;3;6;C;;615;148;317;375;240;1;2;372;374
8;Barcelona;21;Maresme;08121;Mataró;3;7;A;;464;133;244;287;177;1;4;282;286
8;Barcelona;21;Maresme;08121;Mataró;3;7;B;;600;164;341;374;226;3;0;371;371
8;Barcelona;21;Maresme;08121;Mataró;3;8;A;;453;109;230;271;182;3;0;268;268
8;Barcelona;21;Maresme;08121;Mataró;3;8;B;;587;157;292;351;236;1;5;345;350
8;Barcelona;21;Maresme;08121;Mataró;3;9;A;;721;203;400;472;249;1;5;466;471
8;Barcelona;21;Maresme;08121;Mataró;3;9;B;;887;244;444;537;350;3;2;532;534
8;Barcelona;21;Maresme;08121;Mataró;4;1;A;;510;173;302;371;139;0;4;367;371
8;Barcelona;21;Maresme;08121;Mataró;4;1;B;;539;165;297;372;167;0;7;365;372
8;Barcelona;21;Maresme;08121;Mataró;4;2;A;;536;141;262;304;232;0;2;302;304
8;Barcelona;21;Maresme;08121;Mataró;4;2;B;;680;178;348;431;249;1;3;427;430
8;Barcelona;21;Maresme;08121;Mataró;4;3;U;;866;261;435;532;334;0;4;528;532
8;Barcelona;21;Maresme;08121;Mataró;4;4;U;;791;220;431;509;282;4;2;503;505
8;Barcelona;21;Maresme;08121;Mataró;4;5;U;;941;242;480;573;368;1;5;567;572
8;Barcelona;21;Maresme;08121;Mataró;4;6;A;;490;149;273;329;161;2;1;326;327
8;Barcelona;21;Maresme;08121;Mataró;4;6;B;;618;184;325;394;224;0;2;392;394
8;Barcelona;21;Maresme;08121;Mataró;4;7;U;;939;175;450;543;396;0;4;539;543
8;Barcelona;21;Maresme;08121;Mataró;5;1;U;;895;228;430;521;374;0;6;515;521
8;Barcelona;21;Maresme;08121;Mataró;5;10;U;;491;151;251;306;185;1;4;301;305
8;Barcelona;21;Maresme;08121;Mataró;5;11;A;;730;200;350;431;299;2;5;424;429
8;Barcelona;21;Maresme;08121;Mataró;5;11;B;;797;200;370;483;314;0;2;481;483
8;Barcelona;21;Maresme;08121;Mataró;5;12;A;;529;137;260;342;187;0;2;340;342
8;Barcelona;21;Maresme;08121;Mataró;5;12;B;;579;147;290;373;206;1;5;367;372
8;Barcelona;21;Maresme;08121;Mataró;5;13;A;;487;124;243;308;179;1;1;306;307
8;Barcelona;21;Maresme;08121;Mataró;5;13;B;;641;193;331;399;242;0;7;392;399
8;Barcelona;21;Maresme;08121;Mataró;5;13;C;;656;194;352;405;251;1;3;401;404
8;Barcelona;21;Maresme;08121;Mataró;5;14;U;;714;199;357;419;295;2;4;413;417
8;Barcelona;21;Maresme;08121;Mataró;5;15;U;;880;235;431;511;369;1;3;507;510
8;Barcelona;21;Maresme;08121;Mataró;5;16;A;;504;147;239;300;204;0;2;298;300
8;Barcelona;21;Maresme;08121;Mataró;5;16;B;;510;199;235;294;216;0;1;293;294
8;Barcelona;21;Maresme;08121;Mataró;5;17;U;;757;226;389;458;299;0;1;457;458
8;Barcelona;21;Maresme;08121;Mataró;5;18;U;;504;133;239;289;215;4;1;284;285
8;Barcelona;21;Maresme;08121;Mataró;5;19;U;;751;203;384;466;285;0;3;463;466
8;Barcelona;21;Maresme;08121;Mataró;5;2;A;;675;196;355;420;255;2;4;414;418
8;Barcelona;21;Maresme;08121;Mataró;5;2;B;;715;170;330;423;292;1;4;418;422
8;Barcelona;21;Maresme;08121;Mataró;5;20;A;;561;156;259;323;238;0;1;322;323
8;Barcelona;21;Maresme;08121;Mataró;5;20;B;;675;203;336;397;278;0;1;396;397
8;Barcelona;21;Maresme;08121;Mataró;5;3;A;;920;224;452;570;350;4;8;558;566
8;Barcelona;21;Maresme;08121;Mataró;5;3;B;;1098;262;515;658;440;2;8;648;656
8;Barcelona;21;Maresme;08121;Mataró;5;4;U;;976;266;482;592;384;0;6;586;592
8;Barcelona;21;Maresme;08121;Mataró;5;5;U;;766;199;364;451;315;0;1;450;451
8;Barcelona;21;Maresme;08121;Mataró;5;6;A;;624;123;250;323;301;5;6;312;318
8;Barcelona;21;Maresme;08121;Mataró;5;6;B;;628;157;284;361;267;2;2;357;359
8;Barcelona;21;Maresme;08121;Mataró;5;7;A;;558;132;240;309;249;0;0;309;309
8;Barcelona;21;Maresme;08121;Mataró;5;7;B;;613;124;242;316;297;0;3;313;316
8;Barcelona;21;Maresme;08121;Mataró;5;8;U;;941;270;475;577;364;3;4;570;574
8;Barcelona;21;Maresme;08121;Mataró;5;9;U;;948;371;467;559;389;0;9;550;559
8;Barcelona;21;Maresme;08121;Mataró;6;1;A;;745;241;413;490;255;0;2;488;490
8;Barcelona;21;Maresme;08121;Mataró;6;1;B;;883;277;454;576;307;4;9;563;572
8;Barcelona;21;Maresme;08121;Mataró;6;10;A;;640;171;337;401;239;2;5;394;399
8;Barcelona;21;Maresme;08121;Mataró;6;10;B;;540;155;279;354;186;0;4;350;354
8;Barcelona;21;Maresme;08121;Mataró;6;10;C;;620;143;307;376;244;0;6;370;376
8;Barcelona;21;Maresme;08121;Mataró;6;11;A;;575;182;332;401;174;0;0;401;401
8;Barcelona;21;Maresme;08121;Mataró;6;11;B;;536;152;307;379;157;0;4;375;379
8;Barcelona;21;Maresme;08121;Mataró;6;11;C;;717;207;392;496;221;1;2;493;495
8;Barcelona;21;Maresme;08121;Mataró;6;12;A;;520;132;248;314;206;1;3;310;313
8;Barcelona;21;Maresme;08121;Mataró;6;12;B;;624;158;295;365;259;0;5;360;365
8;Barcelona;21;Maresme;08121;Mataró;6;12;C;;558;170;293;350;208;0;2;348;350
8;Barcelona;21;Maresme;08121;Mataró;6;13;U;;940;322;545;629;311;0;9;620;629
8;Barcelona;21;Maresme;08121;Mataró;6;2;U;;625;214;375;454;171;1;4;449;453
8;Barcelona;21;Maresme;08121;Mataró;6;3;U;;939;349;611;712;227;1;8;703;711
8;Barcelona;21;Maresme;08121;Mataró;6;4;A;;496;171;288;369;127;1;3;365;368
8;Barcelona;21;Maresme;08121;Mataró;6;4;B;;570;187;354;417;153;2;3;412;415
8;Barcelona;21;Maresme;08121;Mataró;6;5;A;;787;227;395;516;271;0;0;516;516
8;Barcelona;21;Maresme;08121;Mataró;6;5;B;;896;205;418;546;350;4;5;537;542
8;Barcelona;21;Maresme;08121;Mataró;6;6;A;;626;217;384;471;155;3;3;465;468
8;Barcelona;21;Maresme;08121;Mataró;6;6;B;;661;228;396;483;178;0;5;478;483
8;Barcelona;21;Maresme;08121;Mataró;6;7;A;;633;181;347;427;206;0;4;423;427
8;Barcelona;21;Maresme;08121;Mataró;6;7;B;;737;229;408;510;227;5;1;504;505
8;Barcelona;21;Maresme;08121;Mataró;6;8;A;;605;171;315;404;201;0;2;402;404
8;Barcelona;21;Maresme;08121;Mataró;6;8;B;;661;171;336;443;218;0;3;440;443
8;Barcelona;21;Maresme;08121;Mataró;6;9;A;;500;113;217;260;240;1;0;259;259
8;Barcelona;21;Maresme;08121;Mataró;6;9;B;;557;119;238;299;258;0;1;298;299
8;Barcelona;3;Alt Penedès;08122;Mediona;1;1;U;;1050;300;632;747;303;1;7;739;746
25;Lleida;23;Noguera;25134;Menàrguens;1;1;U;;724;187;446;529;195;0;2;527;529
17;Girona;15;Cerdanya;17099;Meranges;1;1;U;;69;18;41;50;19;0;2;48;50
17;Girona;19;Garrotxa;17105;Mieres;1;1;U;;278;97;172;190;88;2;3;185;188
43;Tarragona;1;Alt Camp;43083;Milà, el;1;1;U;;138;32;94;114;24;0;2;112;114
25;Lleida;27;Pla d'Urgell;25135;Miralcamp;1;1;U;;1007;259;608;747;260;7;10;730;740
43;Tarragona;30;Ribera d'Ebre;43084;Miravet;1;1;U;;680;155;373;490;190;1;5;484;489
8;Barcelona;;;08138;Moià;1;1;A;;536;141;315;400;136;1;5;394;399
8;Barcelona;;;08138;Moià;1;1;B;;613;184;374;455;158;0;7;448;455
8;Barcelona;;;08138;Moià;1;2;A;;827;202;485;573;254;2;12;559;571
8;Barcelona;;;08138;Moià;1;2;B;;959;250;511;658;301;2;5;651;656
43;Tarragona;29;Priorat;43085;Molar, el;1;1;U;;274;79;167;207;67;1;2;204;206
8;Barcelona;11;Baix Llobregat;08123;Molins de Rei;1;1;A;;547;144;276;354;193;1;3;350;353
8;Barcelona;11;Baix Llobregat;08123;Molins de Rei;1;1;B;;650;186;342;423;227;6;5;412;417
8;Barcelona;11;Baix Llobregat;08123;Molins de Rei;1;2;A;;496;110;275;349;147;1;2;346;348
8;Barcelona;11;Baix Llobregat;08123;Molins de Rei;1;2;B;;619;134;315;393;226;0;2;391;393
8;Barcelona;11;Baix Llobregat;08123;Molins de Rei;1;3;A;;759;209;414;516;243;1;0;515;515
8;Barcelona;11;Baix Llobregat;08123;Molins de Rei;1;3;B;;775;173;384;493;282;0;1;492;493
8;Barcelona;11;Baix Llobregat;08123;Molins de Rei;2;1;A;;612;147;325;401;211;1;4;396;400
8;Barcelona;11;Baix Llobregat;08123;Molins de Rei;2;1;B;;666;183;349;437;229;0;2;435;437
8;Barcelona;11;Baix Llobregat;08123;Molins de Rei;2;2;U;;998;305;561;681;317;0;2;679;681
8;Barcelona;11;Baix Llobregat;08123;Molins de Rei;2;3;A;;578;163;322;401;177;0;2;399;401
8;Barcelona;11;Baix Llobregat;08123;Molins de Rei;2;3;B;;697;173;348;454;243;0;1;453;454
8;Barcelona;11;Baix Llobregat;08123;Molins de Rei;2;3;C;;746;219;410;495;251;1;4;490;494
8;Barcelona;11;Baix Llobregat;08123;Molins de Rei;2;4;U;;990;252;502;615;375;0;4;611;615
8;Barcelona;11;Baix Llobregat;08123;Molins de Rei;3;1;A;;512;142;300;366;146;0;7;359;366
8;Barcelona;11;Baix Llobregat;08123;Molins de Rei;3;1;B;;652;200;392;461;191;1;3;457;460
8;Barcelona;11;Baix Llobregat;08123;Molins de Rei;3;2;A;;923;236;532;637;286;0;7;630;637
8;Barcelona;11;Baix Llobregat;08123;Molins de Rei;3;2;B;;1041;258;625;729;312;1;5;723;728
8;Barcelona;11;Baix Llobregat;08123;Molins de Rei;3;3;U;;892;232;469;589;303;2;4;583;587
8;Barcelona;11;Baix Llobregat;08123;Molins de Rei;3;4;A;;717;180;388;460;257;2;6;452;458
8;Barcelona;11;Baix Llobregat;08123;Molins de Rei;3;4;B;;806;205;415;499;307;0;6;493;499
8;Barcelona;11;Baix Llobregat;08123;Molins de Rei;4;1;U;;864;245;445;546;318;0;3;543;546
25;Lleida;27;Pla d'Urgell;25137;Mollerussa;1;1;A;;775;172;407;555;220;4;8;543;551
25;Lleida;27;Pla d'Urgell;25137;Mollerussa;1;1;B;;837;208;445;591;246;1;9;581;590
25;Lleida;27;Pla d'Urgell;25137;Mollerussa;1;2;A;;726;164;370;501;225;2;10;489;499
25;Lleida;27;Pla d'Urgell;25137;Mollerussa;1;2;B;;811;172;406;554;257;1;6;547;553
25;Lleida;27;Pla d'Urgell;25137;Mollerussa;1;3;A;;943;226;494;645;298;1;7;637;644
25;Lleida;27;Pla d'Urgell;25137;Mollerussa;1;3;B;;1075;266;564;716;359;1;12;703;715
25;Lleida;27;Pla d'Urgell;25137;Mollerussa;1;4;U;;1186;253;602;792;394;3;10;779;789
25;Lleida;27;Pla d'Urgell;25137;Mollerussa;1;5;U;;1009;191;493;684;325;3;16;665;681
8;Barcelona;41;Vallès Oriental;08124;Mollet del Vallès;1;1;U;;649;145;286;360;289;1;5;354;359
8;Barcelona;41;Vallès Oriental;08124;Mollet del Vallès;1;2;A;;673;151;300;368;305;0;7;361;368
8;Barcelona;41;Vallès Oriental;08124;Mollet del Vallès;1;2;B;;815;190;366;463;352;0;0;463;463
8;Barcelona;41;Vallès Oriental;08124;Mollet del Vallès;1;3;A;;549;140;266;322;227;0;1;321;322
8;Barcelona;41;Vallès Oriental;08124;Mollet del Vallès;1;3;B;;562;127;255;308;254;0;2;306;308
8;Barcelona;41;Vallès Oriental;08124;Mollet del Vallès;1;3;C;;659;136;308;360;299;0;5;355;360
8;Barcelona;41;Vallès Oriental;08124;Mollet del Vallès;1;4;A;;566;151;323;361;205;3;1;357;358
8;Barcelona;41;Vallès Oriental;08124;Mollet del Vallès;1;4;B;;695;190;386;453;242;0;3;450;453
8;Barcelona;41;Vallès Oriental;08124;Mollet del Vallès;1;5;A;;685;130;288;350;335;3;2;345;347
8;Barcelona;41;Vallès Oriental;08124;Mollet del Vallès;1;5;B;;824;186;350;441;383;1;1;439;440
8;Barcelona;41;Vallès Oriental;08124;Mollet del Vallès;1;6;A;;593;163;323;365;228;1;2;362;364
8;Barcelona;41;Vallès Oriental;08124;Mollet del Vallès;1;6;B;;543;142;265;318;225;1;4;313;317
8;Barcelona;41;Vallès Oriental;08124;Mollet del Vallès;1;6;C;;632;165;306;367;265;1;0;366;366
8;Barcelona;41;Vallès Oriental;08124;Mollet del Vallès;1;7;A;;517;100;200;266;251;0;1;265;266
8;Barcelona;41;Vallès Oriental;08124;Mollet del Vallès;1;7;B;;628;117;251;306;322;0;2;304;306
8;Barcelona;41;Vallès Oriental;08124;Mollet del Vallès;2;1;A;;545;137;264;321;224;1;3;317;320
8;Barcelona;41;Vallès Oriental;08124;Mollet del Vallès;2;1;B;;577;107;256;337;240;0;1;336;337
8;Barcelona;41;Vallès Oriental;08124;Mollet del Vallès;2;1;C;;661;141;331;417;244;2;6;409;415
8;Barcelona;41;Vallès Oriental;08124;Mollet del Vallès;2;2;U;;999;240;507;611;388;1;2;608;610
8;Barcelona;41;Vallès Oriental;08124;Mollet del Vallès;2;3;A;;737;172;341;420;317;1;0;419;419
8;Barcelona;41;Vallès Oriental;08124;Mollet del Vallès;2;3;B;;939;186;402;501;438;0;2;499;501
8;Barcelona;41;Vallès Oriental;08124;Mollet del Vallès;2;4;A;;940;170;376;471;469;1;2;468;470
8;Barcelona;41;Vallès Oriental;08124;Mollet del Vallès;2;4;B;;1040;181;433;556;484;4;5;547;552
8;Barcelona;41;Vallès Oriental;08124;Mollet del Vallès;2;5;A;;802;151;330;412;390;0;5;407;412
8;Barcelona;41;Vallès Oriental;08124;Mollet del Vallès;2;5;B;;1036;180;392;508;528;0;5;503;508
8;Barcelona;41;Vallès Oriental;08124;Mollet del Vallès;3;1;A;;647;160;301;388;259;1;1;386;387
8;Barcelona;41;Vallès Oriental;08124;Mollet del Vallès;3;1;B;;648;135;298;374;274;0;4;370;374
8;Barcelona;41;Vallès Oriental;08124;Mollet del Vallès;3;1;C;;681;168;313;402;279;0;1;401;402
8;Barcelona;41;Vallès Oriental;08124;Mollet del Vallès;3;10;U;;690;125;257;335;355;3;1;331;332
8;Barcelona;41;Vallès Oriental;08124;Mollet del Vallès;3;2;A;;770;171;346;433;337;0;5;428;433
8;Barcelona;41;Vallès Oriental;08124;Mollet del Vallès;3;2;B;;851;190;378;464;387;0;8;456;464
8;Barcelona;41;Vallès Oriental;08124;Mollet del Vallès;3;3;A;;498;132;263;324;174;1;4;319;323
8;Barcelona;41;Vallès Oriental;08124;Mollet del Vallès;3;3;B;;528;179;295;344;184;0;2;342;344
8;Barcelona;41;Vallès Oriental;08124;Mollet del Vallès;3;4;A;;686;157;312;386;300;0;5;381;386
8;Barcelona;41;Vallès Oriental;08124;Mollet del Vallès;3;4;B;;857;203;385;486;371;1;6;479;485
8;Barcelona;41;Vallès Oriental;08124;Mollet del Vallès;3;5;A;;941;196;390;491;450;0;6;485;491
8;Barcelona;41;Vallès Oriental;08124;Mollet del Vallès;3;5;B;;1013;181;414;512;501;0;4;508;512
8;Barcelona;41;Vallès Oriental;08124;Mollet del Vallès;3;5;C;;1124;219;507;606;518;0;3;603;606
8;Barcelona;41;Vallès Oriental;08124;Mollet del Vallès;3;6;A;;709;182;297;367;342;0;2;365;367
8;Barcelona;41;Vallès Oriental;08124;Mollet del Vallès;3;6;B;;772;190;333;411;361;0;1;410;411
8;Barcelona;41;Vallès Oriental;08124;Mollet del Vallès;3;7;A;;536;107;207;253;283;2;3;248;251
8;Barcelona;41;Vallès Oriental;08124;Mollet del Vallès;3;7;B;;648;130;240;308;340;0;1;307;308
8;Barcelona;41;Vallès Oriental;08124;Mollet del Vallès;3;7;C;;686;137;272;355;331;2;8;345;353
8;Barcelona;41;Vallès Oriental;08124;Mollet del Vallès;3;8;U;;768;167;354;412;356;0;3;409;412
8;Barcelona;41;Vallès Oriental;08124;Mollet del Vallès;3;9;A;;447;124;229;282;165;2;3;277;280
8;Barcelona;41;Vallès Oriental;08124;Mollet del Vallès;3;9;B;;595;139;283;357;238;0;3;354;357
17;Girona;2;Alt Empordà;17106;Mollet de Peralada;1;1;U;;163;57;110;129;34;2;0;127;127
17;Girona;31;Ripollès;17107;Molló;1;1;U;;295;81;189;223;72;1;0;222;222
25;Lleida;35;Solsonès;25136;Molsosa, la;1;1;U;;109;37;61;89;20;0;3;86;89
8;Barcelona;;;08128;Monistrol de Calders;1;1;U;;491;133;310;380;111;1;3;376;379
8;Barcelona;7;Bages;08127;Monistrol de Montserrat;1;1;U;;760;206;406;524;236;2;5;517;522
8;Barcelona;7;Bages;08127;Monistrol de Montserrat;1;2;A;;604;164;319;417;187;0;3;414;417
8;Barcelona;7;Bages;08127;Monistrol de Montserrat;1;2;B;;689;182;347;459;230;1;5;453;458
17;Girona;19;Garrotxa;17109;Montagut i Oix;1;1;U;;658;169;292;382;276;2;2;378;380
43;Tarragona;16;Conca de Barberà;43086;Montblanc;1;1;U;;750;164;393;486;264;0;5;481;486
43;Tarragona;16;Conca de Barberà;43086;Montblanc;1;2;U;;666;147;320;440;226;3;9;428;437
43;Tarragona;16;Conca de Barberà;43086;Montblanc;2;1;A;;853;161;441;609;244;2;10;597;607
43;Tarragona;16;Conca de Barberà;43086;Montblanc;2;1;B;;1001;229;580;740;261;2;10;728;738
43;Tarragona;16;Conca de Barberà;43086;Montblanc;2;2;A;;664;140;354;456;208;5;6;445;451
43;Tarragona;16;Conca de Barberà;43086;Montblanc;2;2;B;;823;823;438;552;271;3;3;546;549
43;Tarragona;8;Baix Camp;43088;Montbrió del Camp;1;1;U;;1184;347;717;927;257;14;4;909;913
8;Barcelona;40;Vallès Occidental;08125;Montcada i Reixac;1;1;U;;971;280;550;652;319;0;6;646;652
8;Barcelona;40;Vallès Occidental;08125;Montcada i Reixac;1;2;A;;526;190;303;365;161;1;4;360;364
8;Barcelona;40;Vallès Occidental;08125;Montcada i Reixac;1;2;B;;703;229;423;485;218;1;1;483;484
8;Barcelona;40;Vallès Occidental;08125;Montcada i Reixac;1;4;A;;690;197;361;420;270;0;2;418;420
8;Barcelona;40;Vallès Occidental;08125;Montcada i Reixac;1;4;B;;697;189;335;402;295;2;4;396;400
8;Barcelona;40;Vallès Occidental;08125;Montcada i Reixac;1;5;A;;604;159;277;354;250;0;2;352;354
8;Barcelona;40;Vallès Occidental;08125;Montcada i Reixac;1;5;B;;692;192;333;414;278;1;3;410;413
8;Barcelona;40;Vallès Occidental;08125;Montcada i Reixac;2;1;A;;806;193;350;416;390;2;3;411;414
8;Barcelona;40;Vallès Occidental;08125;Montcada i Reixac;2;1;B;;947;227;432;497;450;1;5;491;496
8;Barcelona;40;Vallès Occidental;08125;Montcada i Reixac;2;2;A;;805;222;400;474;331;1;1;472;473
8;Barcelona;40;Vallès Occidental;08125;Montcada i Reixac;2;2;B;;902;234;428;527;375;1;3;523;526
8;Barcelona;40;Vallès Occidental;08125;Montcada i Reixac;2;3;A;;878;250;464;571;307;0;4;567;571
8;Barcelona;40;Vallès Occidental;08125;Montcada i Reixac;2;3;B;;972;256;514;643;329;1;8;634;642
8;Barcelona;40;Vallès Occidental;08125;Montcada i Reixac;3;1;A;;712;198;370;429;283;0;2;427;429
8;Barcelona;40;Vallès Occidental;08125;Montcada i Reixac;3;1;B;;840;244;422;501;339;4;3;494;497
8;Barcelona;40;Vallès Occidental;08125;Montcada i Reixac;3;2;U;;1128;280;528;619;509;2;4;613;617
8;Barcelona;40;Vallès Occidental;08125;Montcada i Reixac;3;3;A;;835;194;400;459;376;0;2;457;459
8;Barcelona;40;Vallès Occidental;08125;Montcada i Reixac;3;3;B;;1062;255;540;622;440;0;5;617;622
8;Barcelona;40;Vallès Occidental;08125;Montcada i Reixac;4;1;A;;830;186;382;469;361;0;5;464;469
8;Barcelona;40;Vallès Occidental;08125;Montcada i Reixac;4;1;B;;1055;259;520;618;437;1;6;611;617
8;Barcelona;40;Vallès Occidental;08125;Montcada i Reixac;5;1;A;;871;205;404;494;377;0;4;490;494
8;Barcelona;40;Vallès Occidental;08125;Montcada i Reixac;5;1;B;;959;191;420;522;437;0;5;517;522
8;Barcelona;40;Vallès Occidental;08125;Montcada i Reixac;5;2;U;;1102;244;467;578;524;3;7;568;575
8;Barcelona;40;Vallès Occidental;08125;Montcada i Reixac;5;3;A;;637;109;217;274;363;0;3;271;274
8;Barcelona;40;Vallès Occidental;08125;Montcada i Reixac;5;3;B;;676;144;290;348;328;1;2;345;347
8;Barcelona;40;Vallès Occidental;08125;Montcada i Reixac;6;1;U;;1015;143;347;447;568;2;5;440;445
8;Barcelona;14;Berguedà;08130;Montclar;1;1;U;;140;11;51;66;74;0;0;66;66
25;Lleida;15;Cerdanya;25139;Montellà i Martinet;1;1;U;;450;133;248;336;114;0;2;334;336
8;Barcelona;24;Osona;08131;Montesquiu;1;1;U;;709;248;475;530;179;6;3;521;524
25;Lleida;4;Alt Urgell;25140;Montferrer i Castellbò;1;1;U;;602;134;317;384;218;3;2;379;381
43;Tarragona;1;Alt Camp;43089;Montferri;1;1;U;;140;44;75;98;42;0;3;95;98
25;Lleida;23;Noguera;25138;Montgai;1;1;A;;467;132;304;365;102;1;3;361;364
25;Lleida;23;Noguera;25138;Montgai;1;1;B;;240;79;148;176;64;0;0;176;176
8;Barcelona;21;Maresme;08126;Montgat;1;1;A;;594;163;330;395;199;1;4;390;394
8;Barcelona;21;Maresme;08126;Montgat;1;1;B;;733;156;366;453;280;0;2;451;453
8;Barcelona;21;Maresme;08126;Montgat;1;2;A;;554;129;237;293;261;0;0;293;293
8;Barcelona;21;Maresme;08126;Montgat;1;2;B;;627;153;282;353;274;1;0;352;352
8;Barcelona;21;Maresme;08126;Montgat;1;2;C;;770;196;366;445;325;2;2;441;443
8;Barcelona;21;Maresme;08126;Montgat;1;3;A;;698;224;402;479;219;1;3;475;478
8;Barcelona;21;Maresme;08126;Montgat;1;3;B;;893;243;475;569;324;2;3;564;567
8;Barcelona;21;Maresme;08126;Montgat;1;4;A;;652;147;320;408;244;1;5;402;407
8;Barcelona;21;Maresme;08126;Montgat;1;4;B;;739;162;377;475;264;2;5;468;473
8;Barcelona;14;Berguedà;08132;Montmajor;1;1;U;;414;124;217;333;81;0;0;333;333
8;Barcelona;6;Anoia;08133;Montmaneu;1;1;U;;190;68;115;133;57;4;2;127;129
43;Tarragona;12;Baix Penedès;43090;Montmell, el;1;1;U;;311;107;165;208;103;4;2;202;204
8;Barcelona;41;Vallès Oriental;08135;Montmeló;1;1;U;;1053;245;487;588;465;0;6;582;588
8;Barcelona;41;Vallès Oriental;08135;Montmeló;1;2;A;;692;173;368;437;255;1;4;432;436
8;Barcelona;41;Vallès Oriental;08135;Montmeló;1;2;B;;905;204;423;530;375;4;9;517;526
8;Barcelona;41;Vallès Oriental;08135;Montmeló;1;3;A;;824;191;412;507;317;1;5;501;506
8;Barcelona;41;Vallès Oriental;08135;Montmeló;1;3;B;;984;225;481;590;394;0;9;581;590
8;Barcelona;41;Vallès Oriental;08135;Montmeló;1;4;U;;964;200;432;523;441;1;3;519;522
8;Barcelona;41;Vallès Oriental;08135;Montmeló;1;5;U;;748;188;380;469;279;3;8;458;466
25;Lleida;33;Segrià;25142;Montoliu de Lleida;1;1;U;;397;107;216;263;134;2;3;258;261
25;Lleida;32;Segarra;25141;Montoliu de Segarra;1;1;U;;177;63;109;134;43;0;3;131;134
8;Barcelona;41;Vallès Oriental;08136;Montornès del Vallès;1;1;A;;434;88;202;257;177;0;2;255;257
8;Barcelona;41;Vallès Oriental;08136;Montornès del Vallès;1;1;B;;530;126;242;314;216;0;4;310;314
8;Barcelona;41;Vallès Oriental;08136;Montornès del Vallès;1;2;A;;627;144;311;390;237;1;1;388;389
8;Barcelona;41;Vallès Oriental;08136;Montornès del Vallès;1;2;B;;683;150;328;431;252;0;0;431;431
8;Barcelona;41;Vallès Oriental;08136;Montornès del Vallès;1;3;A;;734;181;364;439;295;1;3;435;438
8;Barcelona;41;Vallès Oriental;08136;Montornès del Vallès;1;3;B;;836;196;389;480;356;2;7;471;478
8;Barcelona;41;Vallès Oriental;08136;Montornès del Vallès;1;4;A;;482;113;219;290;192;2;1;287;288
8;Barcelona;41;Vallès Oriental;08136;Montornès del Vallès;1;4;B;;555;129;272;348;207;0;7;341;348
8;Barcelona;41;Vallès Oriental;08136;Montornès del Vallès;1;5;A;;655;137;293;381;274;2;11;368;379
8;Barcelona;41;Vallès Oriental;08136;Montornès del Vallès;1;5;B;;746;161;344;447;299;0;11;436;447
8;Barcelona;41;Vallès Oriental;08136;Montornès del Vallès;2;1;A;;466;95;176;217;249;0;1;216;217
8;Barcelona;41;Vallès Oriental;08136;Montornès del Vallès;2;1;B;;516;105;231;268;248;1;1;266;267
8;Barcelona;41;Vallès Oriental;08136;Montornès del Vallès;2;2;A;;365;90;170;212;153;2;1;209;210
8;Barcelona;41;Vallès Oriental;08136;Montornès del Vallès;2;2;B;;394;76;167;224;170;0;6;218;224
8;Barcelona;41;Vallès Oriental;08136;Montornès del Vallès;2;3;A;;401;115;205;235;166;1;3;231;234
8;Barcelona;41;Vallès Oriental;08136;Montornès del Vallès;2;3;B;;488;112;236;283;205;1;1;281;282
25;Lleida;32;Segarra;25143;Montornès de Segarra;1;1;U;;99;20;36;63;36;0;1;62;63
43;Tarragona;1;Alt Camp;43091;Mont-ral;1;1;U;;122;23;60;75;47;0;0;75;75
17;Girona;10;Baix Empordà;17110;Mont-ras;1;1;U;;1137;321;656;788;349;5;7;776;783
43;Tarragona;8;Baix Camp;43092;Mont-roig del Camp;1;1;U;;1100;254;607;798;302;2;9;787;796
43;Tarragona;8;Baix Camp;43092;Mont-roig del Camp;1;2;A;;826;135;333;419;407;2;4;413;417
43;Tarragona;8;Baix Camp;43092;Mont-roig del Camp;1;2;B;;902;127;338;428;474;0;6;422;428
43;Tarragona;8;Baix Camp;43092;Mont-roig del Camp;1;2;C;;368;91;170;219;149;1;0;218;218
43;Tarragona;8;Baix Camp;43092;Mont-roig del Camp;1;3;U;;843;185;461;584;259;1;8;575;583
8;Barcelona;41;Vallès Oriental;08137;Montseny;1;1;U;;238;58;107;173;65;1;0;172;172
43;Tarragona;30;Ribera d'Ebre;43093;Móra d'Ebre;1;1;A;;782;167;433;570;212;1;5;564;569
43;Tarragona;30;Ribera d'Ebre;43093;Móra d'Ebre;1;1;B;;829;151;412;589;240;1;7;581;588
43;Tarragona;30;Ribera d'Ebre;43093;Móra d'Ebre;1;2;U;;1018;223;550;754;264;3;7;744;751
43;Tarragona;30;Ribera d'Ebre;43093;Móra d'Ebre;2;1;A;;528;123;276;380;148;2;1;377;378
43;Tarragona;30;Ribera d'Ebre;43093;Móra d'Ebre;2;1;B;;578;132;290;413;165;3;6;404;410
43;Tarragona;30;Ribera d'Ebre;43094;Móra la Nova;1;1;A;;543;175;318;422;121;2;5;415;420
43;Tarragona;30;Ribera d'Ebre;43094;Móra la Nova;1;1;B;;597;141;333;459;138;6;10;443;453
43;Tarragona;30;Ribera d'Ebre;43094;Móra la Nova;2;1;U;;984;214;518;723;261;2;3;718;721
43;Tarragona;36;Tarragonès;43095;Morell, el;1;1;A;;896;197;490;629;267;7;4;618;622
43;Tarragona;36;Tarragonès;43095;Morell, el;1;1;B;;968;213;517;685;283;6;2;677;679
43;Tarragona;29;Priorat;43096;Morera de Montsant, la;1;1;U;;117;18;74;104;13;1;0;103;103
8;Barcelona;24;Osona;08129;Muntanyola;1;1;U;;190;62;106;131;59;0;1;130;131
8;Barcelona;7;Bages;08139;Mura;1;1;U;;177;49;119;145;32;0;0;145;145
25;Lleida;38;Urgell;25145;Nalec;1;1;U;;94;23;56;76;18;0;1;75;76
25;Lleida;39;Consell General d'Aran;25025;Naut Aran;1;1;A;;452;106;240;304;148;0;1;303;304
25;Lleida;39;Consell General d'Aran;25025;Naut Aran;1;1;B;;666;138;300;389;277;1;3;385;388
8;Barcelona;7;Bages;08140;Navarcles;1;1;A;;724;216;438;495;229;1;3;491;494
8;Barcelona;7;Bages;08140;Navarcles;1;1;B;;678;198;408;460;218;0;1;459;460
8;Barcelona;7;Bages;08140;Navarcles;1;1;C;;861;213;505;586;275;1;6;579;585
8;Barcelona;7;Bages;08140;Navarcles;1;2;A;;672;198;430;501;171;2;3;496;499
8;Barcelona;7;Bages;08140;Navarcles;1;2;B;;623;174;419;444;179;3;2;439;441
8;Barcelona;7;Bages;08140;Navarcles;1;2;C;;700;192;402;479;221;0;0;479;479
8;Barcelona;7;Bages;08141;Navàs;1;1;A;;531;144;325;405;126;1;3;401;404
8;Barcelona;7;Bages;08141;Navàs;1;1;B;;589;180;368;447;142;3;2;442;444
8;Barcelona;7;Bages;08141;Navàs;1;2;U;;718;186;427;526;192;1;1;524;525
8;Barcelona;7;Bages;08141;Navàs;1;3;A;;599;150;316;402;197;1;0;401;401
8;Barcelona;7;Bages;08141;Navàs;1;3;B;;744;177;408;509;235;2;4;503;507
8;Barcelona;7;Bages;08141;Navàs;1;4;U;;1041;302;668;779;262;1;5;773;778
8;Barcelona;7;Bages;08141;Navàs;2;1;U;;494;196;318;358;136;0;2;356;358
17;Girona;2;Alt Empordà;17111;Navata;1;1;U;;545;141;318;379;166;4;1;374;375
25;Lleida;35;Solsonès;25146;Navès;1;1;U;;249;77;145;184;65;1;4;179;183
8;Barcelona;14;Berguedà;08142;Nou de Berguedà, la;1;1;U;;134;47;84;103;31;0;1;102;103
43;Tarragona;36;Tarragonès;43097;Nou de Gaià, la;1;1;U;;323;99;207;246;77;1;2;243;245
43;Tarragona;1;Alt Camp;43098;Nulles;1;1;U;;300;65;190;230;70;0;3;227;230
25;Lleida;35;Solsonès;25148;Odèn;1;1;U;;242;56;108;164;78;0;0;164;164
8;Barcelona;6;Anoia;08143;Òdena;1;1;A;;670;126;332;459;211;4;3;452;455
8;Barcelona;6;Anoia;08143;Òdena;1;1;B;;775;172;385;526;249;0;2;524;526
8;Barcelona;6;Anoia;08143;Òdena;1;2;U;;695;198;373;470;225;2;3;465;468
17;Girona;31;Ripollès;17112;Ogassa;1;1;U;;244;76;141;177;67;0;2;175;177
8;Barcelona;3;Alt Penedès;08145;Olèrdola;1;1;U;;783;210;432;527;256;6;3;518;521
8;Barcelona;3;Alt Penedès;08145;Olèrdola;1;2;U;;811;264;479;631;180;1;3;627;630
8;Barcelona;3;Alt Penedès;08146;Olesa de Bonesvalls;1;1;U;;531;162;301;373;158;0;4;369;373
8;Barcelona;11;Baix Llobregat;08147;Olesa de Montserrat;1;1;A;;782;208;399;487;295;6;4;477;481
8;Barcelona;11;Baix Llobregat;08147;Olesa de Montserrat;1;1;B;;912;257;485;587;325;0;7;580;587
8;Barcelona;11;Baix Llobregat;08147;Olesa de Montserrat;1;2;A;;646;163;348;441;205;0;1;440;441
8;Barcelona;11;Baix Llobregat;08147;Olesa de Montserrat;1;2;B;;740;174;378;475;265;2;4;469;473
8;Barcelona;11;Baix Llobregat;08147;Olesa de Montserrat;1;3;A;;422;109;239;301;121;0;0;301;301
8;Barcelona;11;Baix Llobregat;08147;Olesa de Montserrat;1;3;B;;509;135;294;374;135;1;0;373;373
8;Barcelona;11;Baix Llobregat;08147;Olesa de Montserrat;1;4;A;;756;212;400;523;233;4;3;516;519
8;Barcelona;11;Baix Llobregat;08147;Olesa de Montserrat;1;4;B;;809;195;430;573;236;0;9;564;573
8;Barcelona;11;Baix Llobregat;08147;Olesa de Montserrat;1;5;A;;823;190;435;544;279;0;8;536;544
8;Barcelona;11;Baix Llobregat;08147;Olesa de Montserrat;1;5;B;;782;169;394;500;282;1;5;494;499
8;Barcelona;11;Baix Llobregat;08147;Olesa de Montserrat;1;6;A;;662;167;342;434;228;3;5;426;431
8;Barcelona;11;Baix Llobregat;08147;Olesa de Montserrat;1;6;B;;671;135;319;418;253;0;4;414;418
8;Barcelona;11;Baix Llobregat;08147;Olesa de Montserrat;1;7;A;;596;156;316;404;192;0;2;402;404
8;Barcelona;11;Baix Llobregat;08147;Olesa de Montserrat;1;7;B;;743;168;382;506;237;2;2;502;504
8;Barcelona;11;Baix Llobregat;08147;Olesa de Montserrat;1;8;A;;730;197;420;514;216;4;3;507;510
8;Barcelona;11;Baix Llobregat;08147;Olesa de Montserrat;1;8;B;;781;220;474;569;212;0;1;568;569
8;Barcelona;11;Baix Llobregat;08147;Olesa de Montserrat;1;9;A;;544;108;255;316;228;0;1;315;316
8;Barcelona;11;Baix Llobregat;08147;Olesa de Montserrat;1;9;B;;652;126;277;379;273;1;1;377;378
25;Lleida;4;Alt Urgell;25149;Oliana;1;1;A;;714;211;471;557;157;3;2;552;554
25;Lleida;4;Alt Urgell;25149;Oliana;1;1;B;;872;290;617;725;147;2;5;718;723
25;Lleida;23;Noguera;25150;Oliola;1;1;U;;164;41;88;114;50;1;0;113;113
25;Lleida;35;Solsonès;25151;Olius;1;1;U;;387;93;211;277;110;2;5;270;275
8;Barcelona;17;Garraf;08148;Olivella;1;1;U;;669;150;303;356;313;3;3;350;353
8;Barcelona;24;Osona;08149;Olost;1;1;A;;445;109;273;317;128;0;3;314;317
8;Barcelona;24;Osona;08149;Olost;1;1;B;;540;143;355;418;122;1;3;414;417
17;Girona;19;Garrotxa;17114;Olot;1;1;U;;690;266;394;483;207;1;7;475;482
17;Girona;19;Garrotxa;17114;Olot;1;2;A;;569;182;320;390;179;4;1;385;386
17;Girona;19;Garrotxa;17114;Olot;1;2;B;;491;159;287;357;134;0;2;355;357
17;Girona;19;Garrotxa;17114;Olot;1;3;U;;920;287;489;581;339;1;3;577;580
17;Girona;19;Garrotxa;17114;Olot;1;4;A;;705;206;454;520;185;1;8;511;519
17;Girona;19;Garrotxa;17114;Olot;1;4;B;;584;170;367;419;165;1;3;415;418
17;Girona;19;Garrotxa;17114;Olot;2;1;A;;479;169;299;348;131;1;1;346;347
17;Girona;19;Garrotxa;17114;Olot;2;1;B;;440;150;242;293;147;2;2;289;291
17;Girona;19;Garrotxa;17114;Olot;2;2;U;;805;256;472;560;245;6;0;554;554
17;Girona;19;Garrotxa;17114;Olot;2;3;A;;490;157;288;350;140;2;4;344;348
17;Girona;19;Garrotxa;17114;Olot;2;3;B;;348;98;196;236;112;1;1;234;235
17;Girona;19;Garrotxa;17114;Olot;2;3;C;;458;134;264;315;143;0;5;310;315
17;Girona;19;Garrotxa;17114;Olot;2;4;A;;651;161;371;427;224;4;5;418;423
17;Girona;19;Garrotxa;17114;Olot;2;4;B;;645;163;362;435;210;0;6;429;435
17;Girona;19;Garrotxa;17114;Olot;2;5;U;;670;224;373;440;230;2;7;431;438
17;Girona;19;Garrotxa;17114;Olot;3;1;A;;532;182;300;367;165;1;9;357;366
17;Girona;19;Garrotxa;17114;Olot;3;1;B;;397;122;225;265;132;2;2;261;263
17;Girona;19;Garrotxa;17114;Olot;3;1;C;;559;184;329;397;162;0;1;396;397
17;Girona;19;Garrotxa;17114;Olot;3;2;A;;690;220;428;505;185;3;3;499;502
17;Girona;19;Garrotxa;17114;Olot;3;2;B;;592;175;345;406;186;2;4;400;404
17;Girona;19;Garrotxa;17114;Olot;4;1;U;;693;219;356;411;282;0;5;406;411
17;Girona;19;Garrotxa;17114;Olot;4;2;A;;884;239;536;638;246;2;6;630;636
17;Girona;19;Garrotxa;17114;Olot;4;2;B;;860;254;523;605;255;1;5;599;604
17;Girona;19;Garrotxa;17114;Olot;4;3;A;;607;149;341;398;209;6;2;390;392
17;Girona;19;Garrotxa;17114;Olot;4;3;B;;621;142;321;402;219;0;0;402;402
17;Girona;19;Garrotxa;17114;Olot;4;4;A;;572;140;345;402;170;0;6;396;402
17;Girona;19;Garrotxa;17114;Olot;4;4;B;;530;164;334;388;142;1;6;381;387
17;Girona;19;Garrotxa;17114;Olot;5;1;A;;780;249;434;539;241;2;4;533;537
17;Girona;19;Garrotxa;17114;Olot;5;1;B;;722;225;407;491;231;4;5;482;487
17;Girona;19;Garrotxa;17114;Olot;5;2;A;;663;202;404;490;173;0;1;489;490
17;Girona;19;Garrotxa;17114;Olot;5;2;B;;409;121;240;285;124;0;7;278;285
17;Girona;19;Garrotxa;17114;Olot;5;2;C;;602;162;344;428;174;4;5;419;424
17;Girona;19;Garrotxa;17114;Olot;5;3;U;;638;175;347;417;221;0;0;417;417
17;Girona;19;Garrotxa;17114;Olot;5;4;A;;386;111;251;265;121;0;2;263;265
17;Girona;19;Garrotxa;17114;Olot;5;4;B;;348;75;189;225;123;0;1;224;225
17;Girona;19;Garrotxa;17114;Olot;5;4;C;;378;105;227;259;119;1;0;258;258
17;Girona;19;Garrotxa;17114;Olot;5;5;U;;944;240;542;606;338;0;6;600;606
25;Lleida;32;Segarra;25152;Oluges, les;1;1;U;;195;51;102;125;70;0;3;122;125
8;Barcelona;14;Berguedà;08144;Olvan;1;1;A;;388;96;202;242;146;8;4;230;234
8;Barcelona;14;Berguedà;08144;Olvan;1;1;B;;446;150;288;330;116;2;1;327;328
25;Lleida;18;Garrigues;25153;Omellons, els;1;1;U;;230;56;96;181;49;0;2;179;181
25;Lleida;38;Urgell;25154;Omells de na Gaia, els;1;1;U;;134;29;68;92;42;0;0;92;92
17;Girona;2;Alt Empordà;17115;Ordis;1;1;U;;244;83;163;183;61;1;3;179;182
25;Lleida;4;Alt Urgell;25155;Organyà;1;1;U;;861;282;529;642;219;0;2;640;642
8;Barcelona;24;Osona;08150;Orís;1;1;U;;185;57;122;147;38;0;0;147;147
8;Barcelona;24;Osona;08151;Oristà;1;1;U;;546;128;329;375;171;0;1;374;375
8;Barcelona;6;Anoia;08152;Orpí;1;1;U;;122;36;79;97;25;0;0;97;97
8;Barcelona;21;Maresme;08153;Òrrius;1;1;U;;330;126;204;254;76;0;3;251;254
25;Lleida;23;Noguera;25156;Os de Balaguer;1;1;A;;413;103;245;294;119;2;1;291;292
25;Lleida;23;Noguera;25156;Os de Balaguer;1;1;B;;266;61;129;184;82;1;2;181;183
17;Girona;34;Selva;17116;Osor;1;1;U;;406;126;250;311;95;4;2;305;307
25;Lleida;38;Urgell;25157;Ossó de Sió;1;1;U;;201;66;126;153;48;2;5;146;151
8;Barcelona;3;Alt Penedès;08154;Pacs del Penedès;1;1;U;;436;122;264;336;100;0;2;334;336
8;Barcelona;21;Maresme;08155;Palafolls;1;1;A;;774;171;360;455;319;1;4;450;454
8;Barcelona;21;Maresme;08155;Palafolls;1;1;B;;1032;271;541;657;375;1;7;649;656
8;Barcelona;21;Maresme;08155;Palafolls;1;2;A;;492;124;249;312;180;1;0;311;311
8;Barcelona;21;Maresme;08155;Palafolls;1;2;B;;617;143;313;374;243;0;3;371;374
8;Barcelona;21;Maresme;08155;Palafolls;1;2;C;;296;91;166;202;94;4;1;197;198
17;Girona;10;Baix Empordà;17117;Palafrugell;1;1;A;;549;179;311;375;174;0;2;373;375
17;Girona;10;Baix Empordà;17117;Palafrugell;1;1;B;;503;121;224;291;212;3;6;282;288
17;Girona;10;Baix Empordà;17117;Palafrugell;1;1;C;;555;178;310;370;185;1;2;367;369
17;Girona;10;Baix Empordà;17117;Palafrugell;1;2;A;;563;182;320;386;177;1;3;382;385
17;Girona;10;Baix Empordà;17117;Palafrugell;1;2;B;;542;158;276;338;204;1;5;332;337
17;Girona;10;Baix Empordà;17117;Palafrugell;1;2;C;;641;223;367;443;198;2;3;438;441
17;Girona;10;Baix Empordà;17117;Palafrugell;1;3;A;;400;107;223;276;124;3;4;269;273
17;Girona;10;Baix Empordà;17117;Palafrugell;1;3;B;;445;120;228;275;170;1;2;272;274
17;Girona;10;Baix Empordà;17117;Palafrugell;1;3;C;;418;93;231;272;146;2;3;267;270
17;Girona;10;Baix Empordà;17117;Palafrugell;1;4;A;;538;136;275;354;184;0;6;348;354
17;Girona;10;Baix Empordà;17117;Palafrugell;1;4;B;;526;132;290;344;182;2;2;340;342
17;Girona;10;Baix Empordà;17117;Palafrugell;2;1;A;;484;151;275;328;156;3;5;320;325
17;Girona;10;Baix Empordà;17117;Palafrugell;2;1;B;;504;168;278;341;163;2;1;338;339
17;Girona;10;Baix Empordà;17117;Palafrugell;2;1;C;;489;149;261;333;156;3;3;327;330
17;Girona;10;Baix Empordà;17117;Palafrugell;2;2;A;;481;149;261;319;162;1;4;314;318
17;Girona;10;Baix Empordà;17117;Palafrugell;2;2;B;;563;165;315;364;199;3;3;358;361
17;Girona;10;Baix Empordà;17117;Palafrugell;2;2;C;;636;201;359;426;210;2;2;422;424
17;Girona;10;Baix Empordà;17117;Palafrugell;2;3;A;;690;135;342;410;280;3;6;401;407
17;Girona;10;Baix Empordà;17117;Palafrugell;2;3;B;;701;201;450;448;253;1;6;441;447
17;Girona;10;Baix Empordà;17117;Palafrugell;3;1;A;;915;209;500;582;333;1;5;576;581
17;Girona;10;Baix Empordà;17117;Palafrugell;3;1;B;;828;201;472;545;283;1;2;542;544
17;Girona;10;Baix Empordà;17117;Palafrugell;3;2;A;;550;179;322;377;173;1;1;375;376
17;Girona;10;Baix Empordà;17117;Palafrugell;3;2;B;;600;187;350;433;167;0;1;432;433
17;Girona;10;Baix Empordà;17117;Palafrugell;3;2;C;;261;65;147;174;87;2;1;171;172
17;Girona;10;Baix Empordà;17118;Palamós;1;1;A;;710;213;407;462;248;2;6;454;460
17;Girona;10;Baix Empordà;17118;Palamós;1;1;B;;669;197;377;440;229;1;5;434;439
17;Girona;10;Baix Empordà;17118;Palamós;1;2;A;;691;197;388;450;241;1;5;444;449
17;Girona;10;Baix Empordà;17118;Palamós;1;2;B;;699;201;404;461;238;2;6;453;459
17;Girona;10;Baix Empordà;17118;Palamós;1;3;A;;731;219;400;469;262;0;0;469;469
17;Girona;10;Baix Empordà;17118;Palamós;1;3;B;;717;213;400;458;259;1;2;455;457
17;Girona;10;Baix Empordà;17118;Palamós;1;4;U;;760;221;417;499;261;4;5;490;495
17;Girona;10;Baix Empordà;17118;Palamós;2;1;A;;497;169;266;321;176;0;1;320;321
17;Girona;10;Baix Empordà;17118;Palamós;2;1;B;;422;100;211;254;168;0;0;254;254
17;Girona;10;Baix Empordà;17118;Palamós;2;1;C;;496;138;274;314;182;1;4;309;313
17;Girona;10;Baix Empordà;17118;Palamós;2;1;D;;471;129;255;293;178;0;1;292;293
17;Girona;10;Baix Empordà;17118;Palamós;3;1;A;;371;86;198;246;125;1;2;243;245
17;Girona;10;Baix Empordà;17118;Palamós;3;1;B;;597;163;323;375;222;0;3;372;375
17;Girona;10;Baix Empordà;17118;Palamós;3;1;C;;660;177;349;408;252;0;6;402;408
17;Girona;10;Baix Empordà;17118;Palamós;3;2;U;;884;189;435;529;355;1;5;523;528
17;Girona;10;Baix Empordà;17118;Palamós;4;1;A;;1054;293;548;661;393;3;2;656;658
17;Girona;10;Baix Empordà;17118;Palamós;4;1;B;;950;265;502;595;355;1;2;592;594
25;Lleida;27;Pla d'Urgell;25158;Palau d'Anglesola, el;1;1;U;;1321;285;770;981;340;5;10;966;976
17;Girona;2;Alt Empordà;17119;Palau de Santa Eulàlia;1;1;U;;83;15;40;59;24;0;0;59;59
17;Girona;10;Baix Empordà;17121;Palau-sator;1;1;U;;245;63;153;184;61;0;2;182;184
17;Girona;2;Alt Empordà;17120;Palau-saverdera;1;1;U;;610;211;405;483;127;6;4;473;477
8;Barcelona;40;Vallès Occidental;08156;Palau-solità i Plegamans;1;1;A;;517;134;266;320;197;0;3;317;320
8;Barcelona;40;Vallès Occidental;08156;Palau-solità i Plegamans;1;1;B;;474;103;225;287;187;0;2;285;287
8;Barcelona;40;Vallès Occidental;08156;Palau-solità i Plegamans;1;1;C;;462;127;247;302;160;2;1;299;300
8;Barcelona;40;Vallès Occidental;08156;Palau-solità i Plegamans;1;1;D;;477;130;252;301;176;0;4;297;301
8;Barcelona;40;Vallès Occidental;08156;Palau-solità i Plegamans;1;2;A;;524;112;257;316;208;0;5;311;316
8;Barcelona;40;Vallès Occidental;08156;Palau-solità i Plegamans;1;2;B;;511;109;216;286;225;0;0;286;286
8;Barcelona;40;Vallès Occidental;08156;Palau-solità i Plegamans;1;2;C;;578;122;256;314;264;0;1;313;314
8;Barcelona;40;Vallès Occidental;08156;Palau-solità i Plegamans;1;2;D;;494;113;255;315;179;2;1;312;313
8;Barcelona;40;Vallès Occidental;08156;Palau-solità i Plegamans;1;3;A;;416;112;208;250;166;0;2;248;250
8;Barcelona;40;Vallès Occidental;08156;Palau-solità i Plegamans;1;3;B;;472;109;200;253;219;2;2;249;251
8;Barcelona;40;Vallès Occidental;08156;Palau-solità i Plegamans;1;3;C;;437;122;253;286;151;1;4;281;285
8;Barcelona;40;Vallès Occidental;08156;Palau-solità i Plegamans;1;4;A;;482;121;244;304;178;2;2;300;302
8;Barcelona;40;Vallès Occidental;08156;Palau-solità i Plegamans;1;4;B;;472;119;226;277;195;0;2;275;277
8;Barcelona;40;Vallès Occidental;08156;Palau-solità i Plegamans;1;4;C;;491;122;247;289;202;0;3;286;289
8;Barcelona;40;Vallès Occidental;08156;Palau-solità i Plegamans;1;4;D;;515;135;272;326;189;0;3;323;326
43;Tarragona;36;Tarragonès;43100;Pallaresos, els;1;1;U;;1187;260;600;792;395;1;7;784;791
8;Barcelona;11;Baix Llobregat;08157;Pallejà;1;1;A;;503;102;265;325;178;0;3;322;325
8;Barcelona;11;Baix Llobregat;08157;Pallejà;1;1;B;;598;130;299;364;234;1;3;360;363
8;Barcelona;11;Baix Llobregat;08157;Pallejà;1;1;C;;565;132;270;347;218;1;1;345;346
8;Barcelona;11;Baix Llobregat;08157;Pallejà;1;2;A;;658;145;316;397;261;2;3;392;395
8;Barcelona;11;Baix Llobregat;08157;Pallejà;1;2;B;;783;168;366;459;324;0;2;457;459
8;Barcelona;11;Baix Llobregat;08157;Pallejà;1;3;A;;761;149;362;439;322;0;9;430;439
8;Barcelona;11;Baix Llobregat;08157;Pallejà;1;3;B;;773;167;367;459;314;0;2;457;459
8;Barcelona;11;Baix Llobregat;08157;Pallejà;1;4;U;;822;222;455;543;279;0;5;538;543
43;Tarragona;30;Ribera d'Ebre;43099;Palma d'Ebre, la;1;1;U;;386;104;256;312;74;2;1;309;310
17;Girona;28;Pla de l'Estany;17123;Palol de Revardit;1;1;U;;301;94;171;216;85;0;1;215;216
17;Girona;10;Baix Empordà;17124;Pals;1;1;A;;692;188;438;508;184;1;4;503;507
17;Girona;10;Baix Empordà;17124;Pals;1;1;B;;733;189;470;551;182;2;0;549;549
8;Barcelona;11;Baix Llobregat;08158;Papiol, el;1;1;A;;663;156;361;447;216;8;4;435;439
8;Barcelona;11;Baix Llobregat;08158;Papiol, el;1;1;B;;762;201;408;510;252;0;7;503;510
8;Barcelona;11;Baix Llobregat;08158;Papiol, el;1;2;A;;607;147;310;379;228;2;5;372;377
8;Barcelona;11;Baix Llobregat;08158;Papiol, el;1;2;B;;668;169;357;438;230;2;1;435;436
17;Girona;31;Ripollès;17125;Pardines;1;1;U;;121;32;82;92;29;0;1;91;92
8;Barcelona;41;Vallès Oriental;08159;Parets del Vallès;1;1;A;;505;122;234;300;205;1;0;299;299
8;Barcelona;41;Vallès Oriental;08159;Parets del Vallès;1;1;B;;611;146;324;417;194;1;1;415;416
8;Barcelona;41;Vallès Oriental;08159;Parets del Vallès;1;2;A;;638;173;360;418;220;0;3;415;418
8;Barcelona;41;Vallès Oriental;08159;Parets del Vallès;1;2;B;;820;200;439;536;284;1;3;532;535
8;Barcelona;41;Vallès Oriental;08159;Parets del Vallès;1;3;U;;1065;291;570;691;374;0;3;688;691
8;Barcelona;41;Vallès Oriental;08159;Parets del Vallès;2;1;U;;900;180;376;479;421;1;5;473;478
8;Barcelona;41;Vallès Oriental;08159;Parets del Vallès;2;2;U;;832;185;425;522;310;1;1;520;521
8;Barcelona;41;Vallès Oriental;08159;Parets del Vallès;2;3;A;;609;112;253;319;290;0;0;319;319
8;Barcelona;41;Vallès Oriental;08159;Parets del Vallès;2;3;B;;716;164;339;407;309;2;7;398;405
8;Barcelona;41;Vallès Oriental;08159;Parets del Vallès;2;4;A;;798;185;401;477;321;1;0;476;476
8;Barcelona;41;Vallès Oriental;08159;Parets del Vallès;2;4;B;;985;218;438;560;425;2;5;553;558
8;Barcelona;41;Vallès Oriental;08159;Parets del Vallès;2;5;U;;1235;203;528;681;554;0;8;673;681
17;Girona;10;Baix Empordà;17126;Parlavà;1;1;U;;280;102;194;231;49;0;3;228;231
43;Tarragona;16;Conca de Barberà;43101;Passanant i Belltall;1;1;U;;174;70;98;122;52;0;1;121;122
17;Girona;2;Alt Empordà;17128;Pau;1;1;U;;261;75;158;182;79;0;0;182;182
43;Tarragona;9;Baix Ebre;43102;Paüls;1;1;U;;556;130;359;457;99;2;1;454;455
17;Girona;2;Alt Empordà;17129;Pedret i Marzà;1;1;U;;111;31;62;78;33;0;0;78;78
25;Lleida;23;Noguera;25164;Penelles;1;1;U;;477;113;275;350;127;0;4;346;350
17;Girona;10;Baix Empordà;17130;Pera, la;1;1;U;;313;81;193;242;71;0;3;239;242
8;Barcelona;24;Osona;08160;Perafita;1;1;U;;285;101;174;205;80;0;0;205;205
43;Tarragona;36;Tarragonès;43103;Perafort;1;1;U;;422;84;231;284;138;0;4;280;284
17;Girona;2;Alt Empordà;17132;Peralada;1;1;A;;815;254;578;647;168;2;10;635;645
17;Girona;2;Alt Empordà;17132;Peralada;1;1;B;;175;66;117;130;45;0;3;127;130
25;Lleida;4;Alt Urgell;25165;Peramola;1;1;U;;336;167;232;266;70;0;0;266;266
43;Tarragona;9;Baix Ebre;43104;Perelló, el;1;1;U;;706;259;384;506;200;1;1;504;505
43;Tarragona;9;Baix Ebre;43104;Perelló, el;1;2;A;;449;122;222;324;125;2;1;321;322
43;Tarragona;9;Baix Ebre;43104;Perelló, el;1;2;B;;608;145;288;452;156;0;0;452;452
8;Barcelona;6;Anoia;08161;Piera;1;1;U;;525;133;305;371;154;0;1;370;371
8;Barcelona;6;Anoia;08161;Piera;1;2;A;;708;195;416;504;204;5;3;496;499
8;Barcelona;6;Anoia;08161;Piera;1;2;B;;672;179;367;449;223;0;2;447;449
8;Barcelona;6;Anoia;08161;Piera;1;3;A;;889;184;422;549;340;2;5;542;547
8;Barcelona;6;Anoia;08161;Piera;1;3;B;;987;217;450;608;379;1;6;601;607
8;Barcelona;6;Anoia;08161;Piera;1;4;U;;651;155;322;390;261;2;4;384;388
8;Barcelona;6;Anoia;08161;Piera;1;5;A;;621;148;303;376;245;1;3;372;375
8;Barcelona;6;Anoia;08161;Piera;1;5;B;;665;154;308;388;277;2;2;384;386
43;Tarragona;16;Conca de Barberà;43105;Piles, les;1;1;U;;119;33;76;86;33;1;1;84;85
8;Barcelona;21;Maresme;08163;Pineda de Mar;1;1;A;;446;91;216;280;166;1;5;274;279
8;Barcelona;21;Maresme;08163;Pineda de Mar;1;1;B;;516;115;252;320;196;0;2;318;320
8;Barcelona;21;Maresme;08163;Pineda de Mar;1;10;U;;861;229;418;510;351;0;4;506;510
8;Barcelona;21;Maresme;08163;Pineda de Mar;1;11;U;;841;250;465;572;269;1;3;568;571
8;Barcelona;21;Maresme;08163;Pineda de Mar;1;12;U;;794;202;400;492;302;5;3;484;487
8;Barcelona;21;Maresme;08163;Pineda de Mar;1;2;A;;563;152;304;398;165;3;10;385;395
8;Barcelona;21;Maresme;08163;Pineda de Mar;1;2;B;;624;163;330;406;218;4;5;397;402
8;Barcelona;21;Maresme;08163;Pineda de Mar;1;3;U;;854;230;452;545;309;0;3;542;545
8;Barcelona;21;Maresme;08163;Pineda de Mar;1;4;A;;701;170;354;415;286;0;1;414;415
8;Barcelona;21;Maresme;08163;Pineda de Mar;1;4;B;;803;181;366;440;363;2;1;437;438
8;Barcelona;21;Maresme;08163;Pineda de Mar;1;5;A;;522;124;262;305;217;0;1;304;305
8;Barcelona;21;Maresme;08163;Pineda de Mar;1;5;B;;730;184;345;423;307;0;3;420;423
8;Barcelona;21;Maresme;08163;Pineda de Mar;1;6;U;;814;220;380;449;365;0;4;445;449
8;Barcelona;21;Maresme;08163;Pineda de Mar;1;7;A;;660;165;330;425;235;3;5;417;422
8;Barcelona;21;Maresme;08163;Pineda de Mar;1;7;B;;851;245;455;563;288;5;2;556;558
8;Barcelona;21;Maresme;08163;Pineda de Mar;1;8;A;;533;158;271;329;204;2;3;324;327
8;Barcelona;21;Maresme;08163;Pineda de Mar;1;8;B;;643;161;309;398;245;2;7;389;396
8;Barcelona;21;Maresme;08163;Pineda de Mar;1;8;C;;722;163;350;443;279;3;5;435;440
8;Barcelona;21;Maresme;08163;Pineda de Mar;1;9;A;;587;145;301;373;214;0;3;370;373
8;Barcelona;21;Maresme;08163;Pineda de Mar;1;9;B;;658;174;353;425;233;0;0;425;425
43;Tarragona;37;Terra Alta;43106;Pinell de Brai, el;1;1;U;;941;177;465;627;314;0;3;624;627
25;Lleida;35;Solsonès;25166;Pinell de Solsonès;1;1;U;;216;57;128;145;71;0;2;143;145
25;Lleida;35;Solsonès;25167;Pinós;1;1;U;;295;83;152;203;92;0;5;198;203
43;Tarragona;16;Conca de Barberà;43107;Pira;1;1;U;;295;86;192;212;83;1;3;208;211
8;Barcelona;3;Alt Penedès;08164;Pla del Penedès, el;1;1;U;;814;189;466;588;226;3;2;583;585
43;Tarragona;1;Alt Camp;43108;Pla de Santa Maria, el;1;1;A;;684;145;588;504;180;4;3;497;500
43;Tarragona;1;Alt Camp;43108;Pla de Santa Maria, el;1;1;B;;659;163;372;472;187;6;2;464;466
17;Girona;19;Garrotxa;17133;Planes d'Hostoles, les;1;1;A;;835;225;551;648;187;3;6;639;645
17;Girona;19;Garrotxa;17133;Planes d'Hostoles, les;1;1;B;;634;276;441;509;125;3;3;503;506
17;Girona;31;Ripollès;17134;Planoles;1;1;U;;243;99;159;183;60;1;1;181;182
25;Lleida;32;Segarra;25911;Plans de Sió, els;1;1;U;;546;143;322;393;153;3;1;389;390
25;Lleida;27;Pla d'Urgell;25168;Poal, el;1;1;U;;537;200;370;434;103;0;4;430;434
25;Lleida;18;Garrigues;25169;Pobla de Cérvoles, la;1;1;U;;188;48;119;143;45;0;0;143;143
8;Barcelona;6;Anoia;08165;Pobla de Claramunt, la;1;1;A;;618;175;331;424;194;3;1;420;421
8;Barcelona;6;Anoia;08165;Pobla de Claramunt, la;1;1;B;;735;182;416;530;205;1;0;529;529
8;Barcelona;14;Berguedà;08166;Pobla de Lillet, la;1;1;U;;479;173;324;361;118;0;6;355;361
8;Barcelona;14;Berguedà;08166;Pobla de Lillet, la;1;2;A;;505;152;330;367;138;1;5;361;366
8;Barcelona;14;Berguedà;08166;Pobla de Lillet, la;1;2;B;;447;137;293;326;121;1;2;323;325
43;Tarragona;36;Tarragonès;43109;Pobla de Mafumet, la;1;1;U;;748;211;414;498;250;2;2;494;496
43;Tarragona;37;Terra Alta;43110;Pobla de Massaluca, la;1;1;U;;397;67;206;243;154;1;3;239;242
43;Tarragona;36;Tarragonès;43111;Pobla de Montornès, la;1;1;U;;931;228;477;562;369;2;6;554;560
25;Lleida;25;Pallars Jussà;25171;Pobla de Segur, la;1;1;U;;1087;324;627;779;308;0;4;775;779
25;Lleida;25;Pallars Jussà;25171;Pobla de Segur, la;1;2;A;;715;192;426;508;207;0;2;506;508
25;Lleida;25;Pallars Jussà;25171;Pobla de Segur, la;1;2;B;;758;192;426;529;229;4;4;521;525
43;Tarragona;29;Priorat;43112;Poboleda;1;1;U;;299;66;136;210;89;0;0;210;210
8;Barcelona;40;Vallès Occidental;08167;Polinyà;1;1;A;;977;190;438;531;446;3;4;524;528
8;Barcelona;40;Vallès Occidental;08167;Polinyà;1;1;B;;944;224;525;606;338;1;8;597;605
8;Barcelona;40;Vallès Occidental;08167;Polinyà;1;2;A;;444;89;181;221;223;1;1;219;220
8;Barcelona;40;Vallès Occidental;08167;Polinyà;1;2;B;;552;108;240;288;264;3;1;284;285
43;Tarragona;1;Alt Camp;43113;Pont d'Armentera, el;1;1;U;;513;165;340;415;98;5;7;403;410
25;Lleida;4;Alt Urgell;25030;Pont de Bar, el;1;1;U;;145;34;78;96;49;0;0;96;96
17;Girona;2;Alt Empordà;17135;Pont de Molins;1;1;U;;345;108;183;218;127;0;3;215;218
25;Lleida;5;Alta Ribagorça;25173;Pont de Suert, el;1;1;U;;1030;243;481;676;354;4;4;668;672
25;Lleida;5;Alta Ribagorça;25173;Pont de Suert, el;1;2;U;;881;231;475;584;297;4;7;573;580
8;Barcelona;7;Bages;08182;Pont de Vilomara i Rocafort, el;1;1;A;;832;175;411;535;297;1;7;527;534
8;Barcelona;7;Bages;08182;Pont de Vilomara i Rocafort, el;1;1;B;;1108;236;591;730;378;0;5;725;730
43;Tarragona;16;Conca de Barberà;43141;Pontils;1;1;U;;106;21;45;65;41;0;0;65;65
8;Barcelona;3;Alt Penedès;08168;Pontons;1;1;U;;249;68;148;194;55;0;0;194;194
17;Girona;2;Alt Empordà;17136;Pontós;1;1;U;;175;52;112;125;50;0;1;124;125
25;Lleida;23;Noguera;25172;Ponts;1;1;U;;878;307;589;679;199;7;2;670;672
25;Lleida;23;Noguera;25172;Ponts;1;2;U;;994;256;580;733;261;1;4;728;732
17;Girona;28;Pla de l'Estany;17137;Porqueres;1;1;U;;775;173;412;545;230;5;6;534;540
17;Girona;28;Pla de l'Estany;17137;Porqueres;1;2;A;;619;168;407;478;141;6;2;470;472
17;Girona;28;Pla de l'Estany;17137;Porqueres;1;2;B;;518;130;330;403;115;5;4;394;398
17;Girona;28;Pla de l'Estany;17137;Porqueres;1;2;C;;652;177;423;501;151;4;2;495;497
43;Tarragona;29;Priorat;43114;Porrera;1;1;U;;397;66;181;235;162;3;2;230;232
17;Girona;2;Alt Empordà;17138;Portbou;1;1;A;;724;250;457;518;206;1;3;514;517
17;Girona;2;Alt Empordà;17138;Portbou;1;1;B;;755;254;444;514;241;2;5;507;512
17;Girona;2;Alt Empordà;17140;Port de la Selva, el;1;1;U;;703;231;475;544;159;8;5;531;536
25;Lleida;33;Segrià;25174;Portella, la;1;1;U;;493;142;320;390;103;0;1;389;390
43;Tarragona;29;Priorat;43115;Pradell de la Teixeta;1;1;U;;210;50;112;143;67;1;3;139;142
43;Tarragona;8;Baix Camp;43116;Prades;1;1;U;;443;118;276;338;105;5;1;332;333
43;Tarragona;37;Terra Alta;43117;Prat de Comte;1;1;U;;188;61;112;142;46;0;0;142;142
8;Barcelona;11;Baix Llobregat;08169;Prat de Llobregat, el;1;1;A;;655;140;308;404;251;0;2;402;404
8;Barcelona;11;Baix Llobregat;08169;Prat de Llobregat, el;1;1;B;;803;191;375;491;312;3;3;485;488
8;Barcelona;11;Baix Llobregat;08169;Prat de Llobregat, el;1;2;A;;639;156;319;408;231;0;6;402;408
8;Barcelona;11;Baix Llobregat;08169;Prat de Llobregat, el;1;2;B;;755;195;393;469;286;0;5;464;469
8;Barcelona;11;Baix Llobregat;08169;Prat de Llobregat, el;1;3;U;;983;233;497;623;360;1;5;617;622
8;Barcelona;11;Baix Llobregat;08169;Prat de Llobregat, el;1;4;A;;754;208;369;469;285;1;6;462;468
8;Barcelona;11;Baix Llobregat;08169;Prat de Llobregat, el;1;4;B;;901;216;443;551;350;0;7;544;551
8;Barcelona;11;Baix Llobregat;08169;Prat de Llobregat, el;1;5;A;;589;128;290;341;248;0;0;341;341
8;Barcelona;11;Baix Llobregat;08169;Prat de Llobregat, el;1;5;B;;648;143;306;393;255;1;1;391;392
8;Barcelona;11;Baix Llobregat;08169;Prat de Llobregat, el;2;1;A;;747;226;413;500;247;0;2;498;500
8;Barcelona;11;Baix Llobregat;08169;Prat de Llobregat, el;2;1;B;;858;230;436;541;317;0;8;533;541
8;Barcelona;11;Baix Llobregat;08169;Prat de Llobregat, el;2;2;A;;734;181;350;437;297;0;5;432;437
8;Barcelona;11;Baix Llobregat;08169;Prat de Llobregat, el;2;2;B;;825;190;391;488;337;0;3;485;488
8;Barcelona;11;Baix Llobregat;08169;Prat de Llobregat, el;2;3;A;;588;132;265;345;243;3;2;340;342
8;Barcelona;11;Baix Llobregat;08169;Prat de Llobregat, el;2;3;B;;601;140;272;355;246;1;3;351;354
8;Barcelona;11;Baix Llobregat;08169;Prat de Llobregat, el;2;4;A;;747;145;313;419;328;3;1;415;416
8;Barcelona;11;Baix Llobregat;08169;Prat de Llobregat, el;2;4;B;;905;193;377;510;395;2;3;505;508
8;Barcelona;11;Baix Llobregat;08169;Prat de Llobregat, el;2;5;A;;738;173;340;423;315;0;2;421;423
8;Barcelona;11;Baix Llobregat;08169;Prat de Llobregat, el;2;5;B;;838;176;377;501;337;2;1;498;499
8;Barcelona;11;Baix Llobregat;08169;Prat de Llobregat, el;2;6;A;;766;162;353;463;303;0;9;454;463
8;Barcelona;11;Baix Llobregat;08169;Prat de Llobregat, el;2;6;B;;821;173;379;517;304;0;3;514;517
8;Barcelona;11;Baix Llobregat;08169;Prat de Llobregat, el;2;7;A;;605;130;283;382;223;1;3;378;381
8;Barcelona;11;Baix Llobregat;08169;Prat de Llobregat, el;2;7;B;;642;108;264;368;274;0;3;365;368
8;Barcelona;11;Baix Llobregat;08169;Prat de Llobregat, el;3;1;A;;590;146;300;383;207;2;5;376;381
8;Barcelona;11;Baix Llobregat;08169;Prat de Llobregat, el;3;1;B;;671;150;340;421;250;4;2;415;417
8;Barcelona;11;Baix Llobregat;08169;Prat de Llobregat, el;3;10;A;;723;117;244;333;390;0;5;328;333
8;Barcelona;11;Baix Llobregat;08169;Prat de Llobregat, el;3;10;B;;798;121;262;353;445;0;4;349;353
8;Barcelona;11;Baix Llobregat;08169;Prat de Llobregat, el;3;2;A;;486;85;186;251;235;0;1;250;251
8;Barcelona;11;Baix Llobregat;08169;Prat de Llobregat, el;3;2;B;;574;84;208;283;291;4;2;277;279
8;Barcelona;11;Baix Llobregat;08169;Prat de Llobregat, el;3;3;A;;705;146;292;401;304;0;5;396;401
8;Barcelona;11;Baix Llobregat;08169;Prat de Llobregat, el;3;3;B;;719;165;348;426;293;0;5;421;426
8;Barcelona;11;Baix Llobregat;08169;Prat de Llobregat, el;3;4;A;;637;141;297;373;264;1;3;369;372
8;Barcelona;11;Baix Llobregat;08169;Prat de Llobregat, el;3;4;B;;799;175;368;450;349;1;4;445;449
8;Barcelona;11;Baix Llobregat;08169;Prat de Llobregat, el;3;5;A;;899;213;430;538;361;0;5;533;538
8;Barcelona;11;Baix Llobregat;08169;Prat de Llobregat, el;3;5;B;;961;242;442;555;406;1;3;551;554
8;Barcelona;11;Baix Llobregat;08169;Prat de Llobregat, el;3;6;A;;486;103;200;268;218;0;0;268;268
8;Barcelona;11;Baix Llobregat;08169;Prat de Llobregat, el;3;6;B;;667;143;273;356;311;2;4;350;354
8;Barcelona;11;Baix Llobregat;08169;Prat de Llobregat, el;3;7;A;;801;162;315;441;360;1;2;438;440
8;Barcelona;11;Baix Llobregat;08169;Prat de Llobregat, el;3;7;B;;869;162;348;450;419;0;1;449;450
8;Barcelona;11;Baix Llobregat;08169;Prat de Llobregat, el;3;8;A;;729;117;252;355;374;0;9;346;355
8;Barcelona;11;Baix Llobregat;08169;Prat de Llobregat, el;3;8;B;;927;145;330;440;487;1;7;432;439
8;Barcelona;11;Baix Llobregat;08169;Prat de Llobregat, el;3;9;A;;917;180;366;484;433;0;3;481;484
8;Barcelona;11;Baix Llobregat;08169;Prat de Llobregat, el;3;9;B;;969;190;357;473;496;0;7;466;473
8;Barcelona;11;Baix Llobregat;08169;Prat de Llobregat, el;4;1;U;;926;227;461;547;379;5;4;538;542
8;Barcelona;11;Baix Llobregat;08169;Prat de Llobregat, el;4;2;U;;779;149;299;360;419;0;0;360;360
8;Barcelona;11;Baix Llobregat;08169;Prat de Llobregat, el;4;3;A;;617;115;235;277;340;0;0;277;277
8;Barcelona;11;Baix Llobregat;08169;Prat de Llobregat, el;4;3;B;;742;143;296;371;371;0;0;371;371
8;Barcelona;11;Baix Llobregat;08169;Prat de Llobregat, el;4;4;A;;528;108;189;241;287;1;0;240;240
8;Barcelona;11;Baix Llobregat;08169;Prat de Llobregat, el;4;4;B;;627;102;210;270;357;0;2;268;270
8;Barcelona;11;Baix Llobregat;08169;Prat de Llobregat, el;4;5;A;;735;141;267;319;416;0;0;319;319
8;Barcelona;11;Baix Llobregat;08169;Prat de Llobregat, el;4;5;B;;915;191;347;425;490;0;0;425;425
8;Barcelona;11;Baix Llobregat;08169;Prat de Llobregat, el;4;6;U;;452;33;95;134;318;0;0;134;134
8;Barcelona;11;Baix Llobregat;08169;Prat de Llobregat, el;4;7;U;;721;72;135;172;549;2;0;170;170
8;Barcelona;11;Baix Llobregat;08169;Prat de Llobregat, el;5;1;A;;636;134;281;361;275;5;3;353;356
8;Barcelona;11;Baix Llobregat;08169;Prat de Llobregat, el;5;1;B;;619;151;287;376;243;1;1;374;375
8;Barcelona;11;Baix Llobregat;08169;Prat de Llobregat, el;5;2;A;;629;143;278;374;255;0;2;372;374
8;Barcelona;11;Baix Llobregat;08169;Prat de Llobregat, el;5;2;B;;651;136;283;376;275;0;8;368;376
8;Barcelona;11;Baix Llobregat;08169;Prat de Llobregat, el;5;3;A;;544;82;182;260;284;1;5;254;259
8;Barcelona;11;Baix Llobregat;08169;Prat de Llobregat, el;5;3;B;;610;93;187;254;356;0;0;254;254
8;Barcelona;11;Baix Llobregat;08169;Prat de Llobregat, el;5;4;U;;1029;182;422;562;467;0;5;557;562
8;Barcelona;11;Baix Llobregat;08169;Prat de Llobregat, el;5;5;A;;751;173;345;453;298;0;9;444;453
8;Barcelona;11;Baix Llobregat;08169;Prat de Llobregat, el;5;5;B;;820;211;414;510;310;0;5;505;510
8;Barcelona;11;Baix Llobregat;08169;Prat de Llobregat, el;5;6;A;;677;141;270;354;323;0;3;351;354
8;Barcelona;11;Baix Llobregat;08169;Prat de Llobregat, el;5;6;B;;759;166;305;419;340;2;3;414;417
8;Barcelona;11;Baix Llobregat;08169;Prat de Llobregat, el;5;7;A;;852;182;350;480;372;2;3;475;478
8;Barcelona;11;Baix Llobregat;08169;Prat de Llobregat, el;5;7;B;;1006;207;437;516;490;1;6;509;515
8;Barcelona;11;Baix Llobregat;08169;Prat de Llobregat, el;5;8;A;;656;156;289;390;266;0;2;388;390
8;Barcelona;11;Baix Llobregat;08169;Prat de Llobregat, el;5;8;B;;889;193;392;503;386;3;7;493;500
43;Tarragona;8;Baix Camp;43118;Pratdip;1;1;U;;369;109;243;294;75;3;0;291;291
8;Barcelona;24;Osona;08171;Prats de Lluçanès;1;1;U;;1042;291;570;678;364;4;2;672;674
8;Barcelona;24;Osona;08171;Prats de Lluçanès;1;2;U;;1121;315;633;743;378;0;7;736;743
8;Barcelona;6;Anoia;08170;Prats de Rei, els;1;1;U;;473;121;331;384;89;4;8;372;380
25;Lleida;15;Cerdanya;25175;Prats i Sansor;1;1;U;;152;34;79;102;50;0;2;100;102
25;Lleida;38;Urgell;25176;Preixana;1;1;U;;396;100;255;309;87;2;4;303;307
25;Lleida;23;Noguera;25177;Preixens;1;1;U;;455;133;264;335;120;3;4;328;332
8;Barcelona;21;Maresme;08230;Premià de Dalt;1;1;A;;962;251;576;697;265;1;5;691;696
8;Barcelona;21;Maresme;08230;Premià de Dalt;1;1;B;;1066;329;639;777;289;0;6;771;777
8;Barcelona;21;Maresme;08230;Premià de Dalt;1;2;A;;789;206;423;517;272;0;7;510;517
8;Barcelona;21;Maresme;08230;Premià de Dalt;1;2;B;;1053;261;543;668;385;3;1;664;665
8;Barcelona;21;Maresme;08230;Premià de Dalt;1;3;A;;582;106;278;357;225;0;2;355;357
8;Barcelona;21;Maresme;08230;Premià de Dalt;1;3;B;;693;162;330;416;277;0;2;414;416
8;Barcelona;21;Maresme;08230;Premià de Dalt;1;4;U;;809;238;470;570;239;1;10;559;569
8;Barcelona;21;Maresme;08172;Premià de Mar;1;1;A;;727;172;382;486;241;0;2;484;486
8;Barcelona;21;Maresme;08172;Premià de Mar;1;1;B;;763;196;400;501;262;0;4;497;501
8;Barcelona;21;Maresme;08172;Premià de Mar;1;2;A;;825;225;460;555;270;1;5;549;554
8;Barcelona;21;Maresme;08172;Premià de Mar;1;2;B;;892;240;465;579;313;3;4;572;576
8;Barcelona;21;Maresme;08172;Premià de Mar;1;3;A;;855;205;431;533;322;0;4;529;533
8;Barcelona;21;Maresme;08172;Premià de Mar;1;3;B;;988;241;486;604;384;0;8;596;604
8;Barcelona;21;Maresme;08172;Premià de Mar;2;1;A;;684;200;379;480;204;0;5;475;480
8;Barcelona;21;Maresme;08172;Premià de Mar;2;1;B;;847;247;477;582;265;4;5;573;578
8;Barcelona;21;Maresme;08172;Premià de Mar;2;2;A;;521;152;253;320;201;1;0;319;319
8;Barcelona;21;Maresme;08172;Premià de Mar;2;2;B;;645;162;324;370;275;1;2;367;369
8;Barcelona;21;Maresme;08172;Premià de Mar;2;2;C;;701;163;319;397;304;0;2;395;397
8;Barcelona;21;Maresme;08172;Premià de Mar;2;3;A;;613;127;282;351;262;0;4;347;351
8;Barcelona;21;Maresme;08172;Premià de Mar;2;3;B;;782;162;385;460;322;0;3;457;460
8;Barcelona;21;Maresme;08172;Premià de Mar;2;4;A;;628;137;310;373;255;1;0;372;372
8;Barcelona;21;Maresme;08172;Premià de Mar;2;4;B;;707;159;340;409;298;1;6;402;408
8;Barcelona;21;Maresme;08172;Premià de Mar;3;1;A;;795;207;424;506;289;1;7;498;505
8;Barcelona;21;Maresme;08172;Premià de Mar;3;1;B;;1000;266;533;637;363;0;8;629;637
8;Barcelona;21;Maresme;08172;Premià de Mar;3;2;A;;976;223;450;575;401;1;8;566;574
8;Barcelona;21;Maresme;08172;Premià de Mar;3;2;B;;1027;237;506;626;401;0;11;615;626
8;Barcelona;21;Maresme;08172;Premià de Mar;3;3;A;;846;239;427;529;317;1;5;523;528
8;Barcelona;21;Maresme;08172;Premià de Mar;3;3;B;;1009;260;503;622;387;1;10;611;621
8;Barcelona;21;Maresme;08172;Premià de Mar;3;4;U;;949;247;483;589;360;0;5;584;589
8;Barcelona;21;Maresme;08172;Premià de Mar;3;5;A;;565;129;255;294;271;2;1;291;292
8;Barcelona;21;Maresme;08172;Premià de Mar;3;5;B;;690;146;313;380;310;1;1;378;379
8;Barcelona;21;Maresme;08172;Premià de Mar;3;6;U;;997;239;505;642;355;0;8;634;642
17;Girona;19;Garrotxa;17139;Preses, les;1;1;A;;633;236;439;488;145;2;4;482;486
17;Girona;19;Garrotxa;17139;Preses, les;1;1;B;;430;142;278;308;122;0;2;306;308
25;Lleida;15;Cerdanya;25179;Prullans;1;1;U;;191;69;124;143;48;3;1;139;140
17;Girona;15;Cerdanya;17141;Puigcerdà;1;1;A;;537;111;274;312;225;2;3;307;310
17;Girona;15;Cerdanya;17141;Puigcerdà;1;1;B;;444;84;223;270;174;0;2;268;270
17;Girona;15;Cerdanya;17141;Puigcerdà;1;2;A;;694;157;373;465;229;0;9;456;465
17;Girona;15;Cerdanya;17141;Puigcerdà;1;2;B;;688;190;388;463;225;1;2;460;462
17;Girona;15;Cerdanya;17141;Puigcerdà;1;3;A;;767;165;356;432;335;1;8;423;431
17;Girona;15;Cerdanya;17141;Puigcerdà;1;3;B;;706;171;343;391;315;3;4;384;388
17;Girona;15;Cerdanya;17141;Puigcerdà;1;4;A;;774;185;362;481;293;1;6;474;480
17;Girona;15;Cerdanya;17141;Puigcerdà;1;4;B;;640;133;348;416;224;1;4;411;415
8;Barcelona;3;Alt Penedès;08174;Puigdàlber;1;1;U;;250;87;175;221;29;1;0;220;220
25;Lleida;18;Garrigues;25180;Puiggròs;1;1;U;;224;71;126;160;64;0;0;160;160
43;Tarragona;1;Alt Camp;43119;Puigpelat;1;1;U;;396;79;202;257;139;2;0;255;255
8;Barcelona;14;Berguedà;08175;Puig-reig;1;1;A;;906;253;572;721;185;4;8;709;717
8;Barcelona;14;Berguedà;08175;Puig-reig;1;1;B;;963;262;562;712;251;9;9;694;703
8;Barcelona;14;Berguedà;08175;Puig-reig;1;2;A;;553;150;335;419;134;1;5;413;418
8;Barcelona;14;Berguedà;08175;Puig-reig;1;2;B;;658;175;402;500;158;0;4;496;500
8;Barcelona;14;Berguedà;08175;Puig-reig;2;1;A;;268;102;186;219;49;2;5;212;217
8;Barcelona;14;Berguedà;08175;Puig-reig;2;1;B;;235;63;117;130;105;1;1;128;129
8;Barcelona;14;Berguedà;08175;Puig-reig;2;1;C;;341;108;239;284;57;3;2;279;281
25;Lleida;38;Urgell;25181;Puigverd d'Agramunt;1;1;U;;185;53;115;141;44;0;0;141;141
25;Lleida;33;Segrià;25182;Puigverd de Lleida;1;1;U;;841;206;523;616;225;0;8;608;616
8;Barcelona;6;Anoia;08176;Pujalt;1;1;U;;147;49;101;118;29;1;0;117;117
8;Barcelona;14;Berguedà;08177;Quar, la;1;1;U;;44;9;22;32;12;0;0;32;32
17;Girona;20;Gironès;17142;Quart;1;1;A;;518;151;351;410;108;1;2;407;409
17;Girona;20;Gironès;17142;Quart;1;1;B;;609;179;419;454;155;0;6;448;454
17;Girona;20;Gironès;17142;Quart;1;1;C;;467;108;259;316;151;3;2;311;313
17;Girona;31;Ripollès;17043;Queralbs;1;1;U;;197;92;124;161;36;0;0;161;161
43;Tarragona;1;Alt Camp;43120;Querol;1;1;U;;206;59;88;113;93;3;0;110;110
17;Girona;2;Alt Empordà;17143;Rabós;1;1;U;;130;51;89;110;20;1;2;107;109
8;Barcelona;7;Bages;08178;Rajadell;1;1;U;;290;81;175;223;67;3;0;220;220
43;Tarragona;30;Ribera d'Ebre;43121;Rasquera;1;1;U;;722;159;337;429;293;1;5;423;428
17;Girona;10;Baix Empordà;17144;Regencós;1;1;U;;225;67;154;180;45;0;1;179;180
8;Barcelona;40;Vallès Occidental;08179;Rellinars;1;1;U;;267;79;171;220;47;0;0;220;220
43;Tarragona;36;Tarragonès;43122;Renau;1;1;U;;52;17;25;35;17;0;0;35;35
43;Tarragona;8;Baix Camp;43123;Reus;1;1;U;;623;172;295;376;247;1;1;374;375
43;Tarragona;8;Baix Camp;43123;Reus;1;2;U;;590;160;290;338;252;1;1;336;337
43;Tarragona;8;Baix Camp;43123;Reus;1;3;A;;579;172;295;373;206;0;3;370;373
43;Tarragona;8;Baix Camp;43123;Reus;1;3;B;;657;190;351;423;234;2;12;409;421
43;Tarragona;8;Baix Camp;43123;Reus;1;4;A;;468;161;290;341;127;0;8;333;341
43;Tarragona;8;Baix Camp;43123;Reus;1;4;B;;411;108;222;273;138;0;2;271;273
43;Tarragona;8;Baix Camp;43123;Reus;1;4;C;;489;138;278;352;137;1;1;350;351
43;Tarragona;8;Baix Camp;43123;Reus;10;1;U;;582;145;266;321;261;0;4;317;321
43;Tarragona;8;Baix Camp;43123;Reus;2;1;U;;627;183;295;356;271;1;5;350;355
43;Tarragona;8;Baix Camp;43123;Reus;2;10;A;;531;127;261;350;181;0;1;349;350
43;Tarragona;8;Baix Camp;43123;Reus;2;10;B;;528;118;221;318;210;1;5;312;317
43;Tarragona;8;Baix Camp;43123;Reus;2;10;C;;579;123;249;361;218;0;1;360;361
43;Tarragona;8;Baix Camp;43123;Reus;2;11;A;;474;131;257;329;145;0;3;326;329
43;Tarragona;8;Baix Camp;43123;Reus;2;11;B;;628;168;306;382;246;1;3;378;381
43;Tarragona;8;Baix Camp;43123;Reus;2;12;U;;790;158;302;441;349;0;1;440;441
43;Tarragona;8;Baix Camp;43123;Reus;2;2;A;;579;167;290;399;180;1;6;392;398
43;Tarragona;8;Baix Camp;43123;Reus;2;2;B;;481;152;253;321;160;1;3;317;320
43;Tarragona;8;Baix Camp;43123;Reus;2;2;C;;587;143;271;350;237;3;4;343;347
43;Tarragona;8;Baix Camp;43123;Reus;2;3;A;;585;156;290;375;210;0;9;366;375
43;Tarragona;8;Baix Camp;43123;Reus;2;3;B;;639;175;337;409;230;0;4;405;409
43;Tarragona;8;Baix Camp;43123;Reus;2;3;C;;651;171;314;406;245;4;4;398;402
43;Tarragona;8;Baix Camp;43123;Reus;2;4;U;;690;208;324;402;288;6;2;394;396
43;Tarragona;8;Baix Camp;43123;Reus;2;5;U;;840;245;461;548;292;2;6;540;546
43;Tarragona;8;Baix Camp;43123;Reus;2;6;A;;632;153;294;373;259;0;2;371;373
43;Tarragona;8;Baix Camp;43123;Reus;2;6;B;;791;197;368;482;309;0;2;480;482
43;Tarragona;8;Baix Camp;43123;Reus;2;7;A;;517;161;274;351;166;2;3;346;349
43;Tarragona;8;Baix Camp;43123;Reus;2;7;B;;585;146;293;370;215;2;1;367;368
43;Tarragona;8;Baix Camp;43123;Reus;2;8;A;;537;155;280;363;174;0;2;361;363
43;Tarragona;8;Baix Camp;43123;Reus;2;8;B;;454;122;229;289;165;0;4;285;289
43;Tarragona;8;Baix Camp;43123;Reus;2;8;C;;568;142;283;385;183;0;6;379;385
43;Tarragona;8;Baix Camp;43123;Reus;2;9;A;;604;183;349;430;174;2;3;425;428
43;Tarragona;8;Baix Camp;43123;Reus;2;9;B;;509;129;263;337;172;2;6;329;335
43;Tarragona;8;Baix Camp;43123;Reus;2;9;C;;654;172;353;451;203;3;6;442;448
43;Tarragona;8;Baix Camp;43123;Reus;3;1;A;;387;95;166;213;174;3;0;210;210
43;Tarragona;8;Baix Camp;43123;Reus;3;1;B;;385;115;188;218;167;3;0;215;215
43;Tarragona;8;Baix Camp;43123;Reus;3;10;A;;422;117;186;236;186;3;0;233;233
43;Tarragona;8;Baix Camp;43123;Reus;3;10;B;;499;127;199;259;240;0;5;254;259
43;Tarragona;8;Baix Camp;43123;Reus;3;10;C;;500;121;200;264;236;2;3;259;262
43;Tarragona;8;Baix Camp;43123;Reus;3;11;A;;462;103;182;238;224;5;0;233;233
43;Tarragona;8;Baix Camp;43123;Reus;3;11;B;;450;145;180;232;218;1;4;227;231
43;Tarragona;8;Baix Camp;43123;Reus;3;11;C;;456;94;189;260;196;1;4;255;259
43;Tarragona;8;Baix Camp;43123;Reus;3;12;A;;371;111;168;216;155;2;2;212;214
43;Tarragona;8;Baix Camp;43123;Reus;3;12;B;;406;128;179;226;180;4;1;221;222
43;Tarragona;8;Baix Camp;43123;Reus;3;12;C;;406;131;207;245;161;2;5;238;243
43;Tarragona;8;Baix Camp;43123;Reus;3;13;U;;749;164;290;397;352;2;3;392;395
43;Tarragona;8;Baix Camp;43123;Reus;3;2;U;;547;172;290;333;214;1;4;328;332
43;Tarragona;8;Baix Camp;43123;Reus;3;3;A;;475;142;230;285;190;1;1;283;284
43;Tarragona;8;Baix Camp;43123;Reus;3;3;B;;547;138;247;323;224;1;0;322;322
43;Tarragona;8;Baix Camp;43123;Reus;3;4;A;;471;119;202;261;210;1;4;256;260
43;Tarragona;8;Baix Camp;43123;Reus;3;4;B;;577;138;244;325;252;0;5;320;325
43;Tarragona;8;Baix Camp;43123;Reus;3;5;A;;408;124;220;275;133;0;0;275;275
43;Tarragona;8;Baix Camp;43123;Reus;3;5;B;;471;154;264;333;138;0;6;327;333
43;Tarragona;8;Baix Camp;43123;Reus;3;6;U;;565;203;329;379;186;4;4;371;375
43;Tarragona;8;Baix Camp;43123;Reus;3;7;U;;537;145;258;296;241;2;2;292;294
43;Tarragona;8;Baix Camp;43123;Reus;3;8;A;;445;137;214;289;156;0;2;287;289
43;Tarragona;8;Baix Camp;43123;Reus;3;8;B;;433;138;228;288;145;1;4;283;287
43;Tarragona;8;Baix Camp;43123;Reus;3;8;C;;483;142;266;341;142;0;6;335;341
43;Tarragona;8;Baix Camp;43123;Reus;3;9;A;;372;105;173;229;143;0;2;227;229
43;Tarragona;8;Baix Camp;43123;Reus;3;9;B;;393;104;175;232;161;1;1;230;231
43;Tarragona;8;Baix Camp;43123;Reus;3;9;C;;454;128;234;278;176;2;3;273;276
43;Tarragona;8;Baix Camp;43123;Reus;4;1;U;;634;151;292;348;286;0;3;345;348
43;Tarragona;8;Baix Camp;43123;Reus;4;2;A;;493;124;229;295;198;0;4;291;295
43;Tarragona;8;Baix Camp;43123;Reus;4;2;B;;404;104;184;239;165;1;0;238;238
43;Tarragona;8;Baix Camp;43123;Reus;4;2;C;;476;130;213;285;191;0;7;278;285
43;Tarragona;8;Baix Camp;43123;Reus;4;3;U;;626;156;262;315;311;2;2;311;313
43;Tarragona;8;Baix Camp;43123;Reus;4;4;A;;444;130;230;274;170;0;1;273;274
43;Tarragona;8;Baix Camp;43123;Reus;4;4;B;;536;163;267;334;202;3;2;329;331
43;Tarragona;8;Baix Camp;43123;Reus;4;5;A;;537;117;229;306;231;0;6;300;306
43;Tarragona;8;Baix Camp;43123;Reus;4;5;B;;531;124;219;300;231;1;6;293;299
43;Tarragona;8;Baix Camp;43123;Reus;4;5;C;;584;131;237;294;290;2;2;290;292
43;Tarragona;8;Baix Camp;43123;Reus;4;6;A;;556;140;272;332;224;0;5;327;332
43;Tarragona;8;Baix Camp;43123;Reus;4;6;B;;549;121;245;308;241;2;5;301;306
43;Tarragona;8;Baix Camp;43123;Reus;4;6;C;;565;121;245;311;254;0;0;311;311
43;Tarragona;8;Baix Camp;43123;Reus;5;1;A;;458;102;205;264;194;0;3;261;264
43;Tarragona;8;Baix Camp;43123;Reus;5;1;B;;446;120;216;260;186;0;0;260;260
43;Tarragona;8;Baix Camp;43123;Reus;5;1;C;;480;141;235;283;197;1;5;277;282
43;Tarragona;8;Baix Camp;43123;Reus;5;2;A;;506;141;260;321;185;0;0;321;321
43;Tarragona;8;Baix Camp;43123;Reus;5;2;B;;580;152;280;357;223;2;1;354;355
43;Tarragona;8;Baix Camp;43123;Reus;5;2;C;;600;128;257;349;251;0;0;349;349
43;Tarragona;8;Baix Camp;43123;Reus;5;3;A;;520;158;260;321;199;0;0;321;321
43;Tarragona;8;Baix Camp;43123;Reus;5;3;B;;600;150;255;339;261;3;2;334;336
43;Tarragona;8;Baix Camp;43123;Reus;5;4;A;;612;150;276;370;242;1;1;368;369
43;Tarragona;8;Baix Camp;43123;Reus;5;4;B;;691;187;315;417;274;1;3;413;416
43;Tarragona;8;Baix Camp;43123;Reus;5;5;A;;468;126;213;288;180;2;3;283;286
43;Tarragona;8;Baix Camp;43123;Reus;5;5;B;;506;150;240;308;198;1;3;304;307
43;Tarragona;8;Baix Camp;43123;Reus;5;5;C;;571;172;277;357;214;3;2;352;354
43;Tarragona;8;Baix Camp;43123;Reus;5;6;U;;553;160;270;337;216;3;1;333;334
43;Tarragona;8;Baix Camp;43123;Reus;6;1;U;;812;237;388;511;301;5;3;503;506
43;Tarragona;8;Baix Camp;43123;Reus;6;10;U;;646;190;300;370;276;0;3;367;370
43;Tarragona;8;Baix Camp;43123;Reus;6;11;A;;607;197;352;437;170;0;9;428;437
43;Tarragona;8;Baix Camp;43123;Reus;6;11;B;;616;191;345;423;193;1;7;415;422
43;Tarragona;8;Baix Camp;43123;Reus;6;2;A;;518;155;285;359;159;1;5;353;358
43;Tarragona;8;Baix Camp;43123;Reus;6;2;B;;373;115;230;278;95;0;5;273;278
43;Tarragona;8;Baix Camp;43123;Reus;6;2;C;;514;150;304;366;148;1;5;360;365
43;Tarragona;8;Baix Camp;43123;Reus;6;2;D;;435;124;268;328;107;1;5;322;327
43;Tarragona;8;Baix Camp;43123;Reus;6;3;A;;655;160;338;440;215;2;6;432;438
43;Tarragona;8;Baix Camp;43123;Reus;6;3;B;;717;200;378;481;236;1;7;473;480
43;Tarragona;8;Baix Camp;43123;Reus;6;4;A;;522;153;286;364;158;0;2;362;364
43;Tarragona;8;Baix Camp;43123;Reus;6;4;B;;419;152;239;301;118;0;4;297;301
43;Tarragona;8;Baix Camp;43123;Reus;6;4;C;;595;174;341;433;162;2;4;427;431
43;Tarragona;8;Baix Camp;43123;Reus;6;4;D;;485;157;263;338;147;1;3;334;337
43;Tarragona;8;Baix Camp;43123;Reus;6;5;A;;332;63;157;183;149;1;1;181;182
43;Tarragona;8;Baix Camp;43123;Reus;6;5;B;;378;68;157;198;180;1;0;197;197
43;Tarragona;8;Baix Camp;43123;Reus;6;6;A;;707;208;387;499;208;1;1;497;498
43;Tarragona;8;Baix Camp;43123;Reus;6;6;B;;720;227;400;525;195;0;6;519;525
43;Tarragona;8;Baix Camp;43123;Reus;6;7;A;;503;158;286;329;174;2;0;327;327
43;Tarragona;8;Baix Camp;43123;Reus;6;7;B;;616;183;325;399;217;2;2;395;397
43;Tarragona;8;Baix Camp;43123;Reus;6;8;A;;456;129;249;292;164;1;2;289;291
43;Tarragona;8;Baix Camp;43123;Reus;6;8;B;;488;129;232;294;194;0;3;291;294
43;Tarragona;8;Baix Camp;43123;Reus;6;9;U;;745;141;390;382;363;1;3;378;381
43;Tarragona;8;Baix Camp;43123;Reus;7;1;A;;727;135;225;308;419;0;4;304;308
43;Tarragona;8;Baix Camp;43123;Reus;7;1;B;;820;158;272;359;461;3;2;354;356
43;Tarragona;8;Baix Camp;43123;Reus;7;2;A;;603;88;146;175;428;0;1;174;175
43;Tarragona;8;Baix Camp;43123;Reus;7;2;B;;685;102;169;204;481;1;2;201;203
43;Tarragona;8;Baix Camp;43123;Reus;7;3;A;;551;111;226;281;270;5;4;272;276
43;Tarragona;8;Baix Camp;43123;Reus;7;3;B;;658;165;280;352;306;1;2;349;351
43;Tarragona;8;Baix Camp;43123;Reus;8;1;A;;497;120;227;287;210;0;2;285;287
43;Tarragona;8;Baix Camp;43123;Reus;8;1;B;;604;152;280;349;255;0;5;344;349
43;Tarragona;8;Baix Camp;43123;Reus;8;1;C;;545;140;265;326;219;1;2;323;325
43;Tarragona;8;Baix Camp;43123;Reus;8;2;A;;502;122;204;271;231;1;0;270;270
43;Tarragona;8;Baix Camp;43123;Reus;8;2;B;;435;115;203;252;183;0;0;252;252
43;Tarragona;8;Baix Camp;43123;Reus;8;3;U;;531;183;282;333;198;0;0;333;333
43;Tarragona;8;Baix Camp;43123;Reus;8;4;A;;416;104;202;240;176;1;3;236;239
43;Tarragona;8;Baix Camp;43123;Reus;8;4;B;;504;129;247;292;212;0;1;291;292
43;Tarragona;8;Baix Camp;43123;Reus;8;5;U;;619;183;304;394;225;4;1;389;390
43;Tarragona;8;Baix Camp;43123;Reus;8;6;A;;430;136;223;285;145;1;5;279;284
43;Tarragona;8;Baix Camp;43123;Reus;8;6;B;;518;130;215;286;232;2;5;279;284
43;Tarragona;8;Baix Camp;43123;Reus;9;1;A;;421;115;216;272;149;0;1;271;272
43;Tarragona;8;Baix Camp;43123;Reus;9;1;B;;516;123;268;338;178;1;1;336;337
43;Tarragona;8;Baix Camp;43123;Reus;9;2;A;;440;36;91;105;335;0;0;105;105
43;Tarragona;8;Baix Camp;43123;Reus;9;2;B;;429;36;65;85;344;0;1;84;85
25;Lleida;26;Pallars Sobirà;25183;Rialp;1;1;U;;447;137;248;314;133;0;2;312;314
43;Tarragona;1;Alt Camp;43124;Riba, la;1;1;U;;683;217;476;553;130;1;2;550;552
43;Tarragona;30;Ribera d'Ebre;43125;Riba-roja d'Ebre;1;1;A;;733;168;408;496;237;1;1;494;495
43;Tarragona;30;Ribera d'Ebre;43125;Riba-roja d'Ebre;1;1;B;;548;96;289;355;193;6;0;349;349
25;Lleida;32;Segarra;25905;Ribera d'Ondara;1;1;U;;427;138;264;317;110;2;4;311;315
25;Lleida;4;Alt Urgell;25185;Ribera d'Urgellet;1;1;U;;667;131;370;427;240;3;2;422;424
17;Girona;31;Ripollès;17145;Ribes de Freser;1;1;A;;420;132;259;323;97;0;2;321;323
17;Girona;31;Ripollès;17145;Ribes de Freser;1;1;B;;567;157;376;451;116;2;1;448;449
17;Girona;31;Ripollès;17145;Ribes de Freser;1;2;A;;393;120;252;300;93;2;1;297;298
17;Girona;31;Ripollès;17145;Ribes de Freser;1;2;B;;526;163;331;391;135;0;7;384;391
17;Girona;34;Selva;17146;Riells i Viabrea;1;1;U;;1091;272;575;714;377;6;3;705;708
43;Tarragona;36;Tarragonès;43126;Riera de Gaià, la;1;1;U;;751;151;475;576;175;0;4;572;576
25;Lleida;35;Solsonès;25186;Riner;1;1;U;;232;83;156;177;55;1;0;176;176
17;Girona;31;Ripollès;17147;Ripoll;1;1;U;;603;207;361;426;177;1;0;425;425
17;Girona;31;Ripollès;17147;Ripoll;1;2;U;;775;248;452;525;250;5;6;514;520
17;Girona;31;Ripollès;17147;Ripoll;2;1;U;;921;921;577;701;220;3;2;696;698
17;Girona;31;Ripollès;17147;Ripoll;2;2;A;;837;271;533;613;224;2;6;605;611
17;Girona;31;Ripollès;17147;Ripoll;2;2;B;;435;435;242;278;157;1;3;274;277
17;Girona;31;Ripollès;17147;Ripoll;3;1;U;;971;275;594;723;248;2;5;716;721
17;Girona;31;Ripollès;17147;Ripoll;3;2;U;;852;232;509;632;220;1;3;628;631
17;Girona;31;Ripollès;17147;Ripoll;3;3;A;;696;198;404;509;187;2;3;504;507
17;Girona;31;Ripollès;17147;Ripoll;3;3;B;;697;206;440;543;154;4;10;529;539
17;Girona;31;Ripollès;17147;Ripoll;3;4;A;;746;205;440;544;202;4;4;536;540
17;Girona;31;Ripollès;17147;Ripoll;3;4;B;;777;185;450;559;218;0;5;554;559
17;Girona;31;Ripollès;17147;Ripoll;4;1;U;;886;240;558;659;227;3;7;649;656
8;Barcelona;40;Vallès Occidental;08180;Ripollet;1;1;A;;717;157;275;365;352;2;2;361;363
8;Barcelona;40;Vallès Occidental;08180;Ripollet;1;1;B;;787;189;350;443;344;2;3;438;441
8;Barcelona;40;Vallès Occidental;08180;Ripollet;1;2;A;;785;220;390;516;269;0;1;515;516
8;Barcelona;40;Vallès Occidental;08180;Ripollet;1;2;B;;1011;260;530;659;352;0;9;650;659
8;Barcelona;40;Vallès Occidental;08180;Ripollet;1;3;A;;601;137;261;353;248;1;2;350;352
8;Barcelona;40;Vallès Occidental;08180;Ripollet;1;3;B;;781;183;325;449;332;3;6;440;446
8;Barcelona;40;Vallès Occidental;08180;Ripollet;1;4;A;;503;135;246;305;198;0;4;301;305
8;Barcelona;40;Vallès Occidental;08180;Ripollet;1;4;B;;584;158;296;374;210;1;3;370;373
8;Barcelona;40;Vallès Occidental;08180;Ripollet;1;5;A;;676;132;299;360;316;1;3;356;359
8;Barcelona;40;Vallès Occidental;08180;Ripollet;1;5;B;;795;150;331;436;359;1;5;430;435
8;Barcelona;40;Vallès Occidental;08180;Ripollet;1;6;A;;708;134;289;360;348;0;5;355;360
8;Barcelona;40;Vallès Occidental;08180;Ripollet;1;6;B;;884;176;360;456;428;1;6;449;455
8;Barcelona;40;Vallès Occidental;08180;Ripollet;1;7;A;;825;185;351;443;382;3;11;429;440
8;Barcelona;40;Vallès Occidental;08180;Ripollet;1;7;B;;959;228;446;530;429;4;7;519;526
8;Barcelona;40;Vallès Occidental;08180;Ripollet;1;8;A;;634;145;279;334;300;1;4;329;333
8;Barcelona;40;Vallès Occidental;08180;Ripollet;1;8;B;;725;155;321;371;354;1;3;367;370
8;Barcelona;40;Vallès Occidental;08180;Ripollet;1;9;A;;574;101;249;343;231;1;5;337;342
8;Barcelona;40;Vallès Occidental;08180;Ripollet;1;9;B;;736;146;335;456;280;0;6;450;456
8;Barcelona;40;Vallès Occidental;08180;Ripollet;2;1;A;;498;104;199;261;237;1;8;252;260
8;Barcelona;40;Vallès Occidental;08180;Ripollet;2;1;B;;710;142;273;349;361;1;4;344;348
8;Barcelona;40;Vallès Occidental;08180;Ripollet;2;2;A;;640;131;255;340;300;0;2;338;340
8;Barcelona;40;Vallès Occidental;08180;Ripollet;2;2;B;;747;144;305;398;349;0;6;392;398
8;Barcelona;40;Vallès Occidental;08180;Ripollet;2;3;A;;688;134;283;360;328;2;4;354;358
8;Barcelona;40;Vallès Occidental;08180;Ripollet;2;3;B;;862;176;348;452;410;3;7;442;449
8;Barcelona;40;Vallès Occidental;08180;Ripollet;2;4;A;;650;136;276;367;283;5;4;358;362
8;Barcelona;40;Vallès Occidental;08180;Ripollet;2;4;B;;728;154;319;414;314;2;5;407;412
8;Barcelona;40;Vallès Occidental;08180;Ripollet;2;5;A;;579;113;240;311;268;0;2;309;311
8;Barcelona;40;Vallès Occidental;08180;Ripollet;2;5;B;;640;118;251;326;314;2;4;320;324
8;Barcelona;40;Vallès Occidental;08180;Ripollet;2;6;A;;632;93;211;312;320;3;4;305;309
8;Barcelona;40;Vallès Occidental;08180;Ripollet;2;6;B;;820;123;297;411;409;3;6;402;408
8;Barcelona;40;Vallès Occidental;08180;Ripollet;2;7;A;;561;122;235;311;250;0;3;308;311
8;Barcelona;40;Vallès Occidental;08180;Ripollet;2;7;B;;702;134;270;373;329;0;2;371;373
17;Girona;34;Selva;17148;Riudarenes;1;1;U;;1011;341;639;732;279;5;4;723;727
17;Girona;19;Garrotxa;17149;Riudaura;1;1;U;;336;99;194;250;86;0;3;247;250
43;Tarragona;8;Baix Camp;43127;Riudecanyes;1;1;U;;504;113;295;365;139;2;5;358;363
43;Tarragona;8;Baix Camp;43128;Riudecols;1;1;U;;824;162;445;635;189;3;0;632;632
17;Girona;34;Selva;17150;Riudellots de la Selva;1;1;U;;1128;302;699;850;278;8;10;832;842
43;Tarragona;8;Baix Camp;43129;Riudoms;1;1;A;;571;131;261;377;194;5;3;369;372
43;Tarragona;8;Baix Camp;43129;Riudoms;1;1;B;;499;98;229;333;166;2;0;331;331
43;Tarragona;8;Baix Camp;43129;Riudoms;2;1;A;;468;113;229;301;167;6;2;293;295
43;Tarragona;8;Baix Camp;43129;Riudoms;2;1;B;;456;114;235;308;148;0;1;307;308
43;Tarragona;8;Baix Camp;43129;Riudoms;2;2;A;;621;110;272;407;214;0;2;405;407
43;Tarragona;8;Baix Camp;43129;Riudoms;2;2;B;;635;123;302;435;200;3;3;429;432
43;Tarragona;8;Baix Camp;43129;Riudoms;2;2;C;;600;127;294;404;196;1;4;399;403
17;Girona;2;Alt Empordà;17151;Riumors;1;1;U;;163;47;94;108;55;3;1;104;105
8;Barcelona;41;Vallès Oriental;08181;Roca del Vallès, la;1;1;A;;598;129;293;362;236;2;4;356;360
8;Barcelona;41;Vallès Oriental;08181;Roca del Vallès, la;1;1;B;;639;126;283;348;291;3;3;342;345
8;Barcelona;41;Vallès Oriental;08181;Roca del Vallès, la;1;1;C;;384;76;225;282;102;0;3;279;282
8;Barcelona;41;Vallès Oriental;08181;Roca del Vallès, la;1;2;A;;870;181;429;528;342;2;6;520;526
8;Barcelona;41;Vallès Oriental;08181;Roca del Vallès, la;1;2;B;;987;202;477;586;401;2;5;579;584
8;Barcelona;41;Vallès Oriental;08181;Roca del Vallès, la;1;3;A;;782;173;386;480;302;2;5;473;478
8;Barcelona;41;Vallès Oriental;08181;Roca del Vallès, la;1;3;B;;967;186;463;583;384;1;2;580;582
43;Tarragona;16;Conca de Barberà;43130;Rocafort de Queralt;1;1;U;;229;69;141;171;58;0;0;171;171
43;Tarragona;36;Tarragonès;43131;Roda de Berà;1;1;A;;662;175;366;453;209;1;4;448;452
43;Tarragona;36;Tarragonès;43131;Roda de Berà;1;1;B;;811;219;423;547;264;0;0;547;547
43;Tarragona;36;Tarragonès;43131;Roda de Berà;1;2;U;;654;130;244;325;329;8;6;311;317
8;Barcelona;24;Osona;08183;Roda de Ter;1;1;A;;635;164;355;443;192;0;4;439;443
8;Barcelona;24;Osona;08183;Roda de Ter;1;1;B;;696;210;418;500;196;0;2;498;500
8;Barcelona;24;Osona;08183;Roda de Ter;1;2;U;;860;227;549;661;199;0;2;659;661
8;Barcelona;24;Osona;08183;Roda de Ter;1;3;U;;898;279;600;679;219;0;6;673;679
8;Barcelona;24;Osona;08183;Roda de Ter;2;1;U;;815;251;547;620;195;0;0;620;620
43;Tarragona;1;Alt Camp;43132;Rodonyà;1;1;U;;339;84;183;254;85;1;7;246;253
43;Tarragona;9;Baix Ebre;43133;Roquetes;1;1;A;;746;198;372;499;247;3;5;491;496
43;Tarragona;9;Baix Ebre;43133;Roquetes;1;1;B;;564;133;270;356;208;0;2;354;356
43;Tarragona;9;Baix Ebre;43133;Roquetes;1;2;U;;900;200;426;553;347;1;11;541;552
43;Tarragona;9;Baix Ebre;43133;Roquetes;2;1;A;;946;216;435;583;363;1;9;573;582
43;Tarragona;9;Baix Ebre;43133;Roquetes;2;1;B;;779;186;395;494;285;5;3;486;489
43;Tarragona;9;Baix Ebre;43133;Roquetes;2;2;U;;943;195;429;552;391;2;4;546;550
17;Girona;2;Alt Empordà;17152;Roses;1;1;U;;643;226;383;438;205;0;3;435;438
17;Girona;2;Alt Empordà;17152;Roses;1;2;A;;306;68;129;161;145;0;2;159;161
17;Girona;2;Alt Empordà;17152;Roses;1;2;B;;358;86;175;214;144;0;0;214;214
17;Girona;2;Alt Empordà;17152;Roses;1;2;C;;303;73;129;158;145;0;5;153;158
17;Girona;2;Alt Empordà;17152;Roses;1;3;U;;1008;221;412;527;481;0;3;524;527
17;Girona;2;Alt Empordà;17152;Roses;1;4;A;;646;148;304;375;271;0;4;371;375
17;Girona;2;Alt Empordà;17152;Roses;1;4;B;;569;128;253;309;260;0;1;308;309
17;Girona;2;Alt Empordà;17152;Roses;2;1;U;;676;240;361;399;277;2;4;393;397
17;Girona;2;Alt Empordà;17152;Roses;2;2;A;;603;180;330;383;220;1;0;382;382
17;Girona;2;Alt Empordà;17152;Roses;2;2;B;;639;179;297;357;282;0;3;354;357
17;Girona;2;Alt Empordà;17152;Roses;2;2;C;;665;207;355;404;261;3;2;399;401
17;Girona;2;Alt Empordà;17152;Roses;2;3;A;;899;230;459;549;350;1;4;544;548
17;Girona;2;Alt Empordà;17152;Roses;2;3;B;;939;228;467;560;379;1;11;548;559
25;Lleida;33;Segrià;25189;Rosselló;1;1;A;;715;167;394;497;218;0;2;495;497
25;Lleida;33;Segrià;25189;Rosselló;1;1;B;;663;166;354;428;235;2;5;421;426
43;Tarragona;1;Alt Camp;43134;Rourell, el;1;1;U;;233;59;130;159;74;0;0;159;159
8;Barcelona;40;Vallès Occidental;08184;Rubí;1;1;A;;652;164;314;367;285;0;3;364;367
8;Barcelona;40;Vallès Occidental;08184;Rubí;1;1;B;;859;200;386;456;403;1;4;451;455
8;Barcelona;40;Vallès Occidental;08184;Rubí;1;2;A;;717;129;272;345;372;0;1;344;345
8;Barcelona;40;Vallès Occidental;08184;Rubí;1;2;B;;784;176;321;373;411;1;5;367;372
8;Barcelona;40;Vallès Occidental;08184;Rubí;1;3;U;;865;159;388;482;383;1;4;477;481
8;Barcelona;40;Vallès Occidental;08184;Rubí;2;1;A;;550;124;221;268;282;0;2;266;268
8;Barcelona;40;Vallès Occidental;08184;Rubí;2;1;B;;706;145;301;369;337;0;7;362;369
8;Barcelona;40;Vallès Occidental;08184;Rubí;2;3;A;;529;75;172;207;322;0;2;205;207
8;Barcelona;40;Vallès Occidental;08184;Rubí;2;3;B;;648;95;201;245;403;0;2;243;245
8;Barcelona;40;Vallès Occidental;08184;Rubí;3;1;A;;509;118;239;288;221;0;3;285;288
8;Barcelona;40;Vallès Occidental;08184;Rubí;3;1;B;;579;122;276;329;250;0;3;326;329
8;Barcelona;40;Vallès Occidental;08184;Rubí;3;2;U;;635;139;261;332;303;0;4;328;332
8;Barcelona;40;Vallès Occidental;08184;Rubí;3;3;A;;507;121;210;268;239;2;2;264;266
8;Barcelona;40;Vallès Occidental;08184;Rubí;3;3;B;;644;147;272;352;292;2;5;345;350
8;Barcelona;40;Vallès Occidental;08184;Rubí;3;4;A;;765;187;328;400;365;0;1;399;400
8;Barcelona;40;Vallès Occidental;08184;Rubí;3;4;B;;852;198;400;473;379;0;3;470;473
8;Barcelona;40;Vallès Occidental;08184;Rubí;3;5;A;;724;178;341;410;314;1;3;406;409
8;Barcelona;40;Vallès Occidental;08184;Rubí;3;5;B;;936;202;419;514;422;0;6;508;514
8;Barcelona;40;Vallès Occidental;08184;Rubí;3;6;A;;718;153;313;392;326;1;8;383;391
8;Barcelona;40;Vallès Occidental;08184;Rubí;3;6;B;;769;161;340;433;336;0;6;427;433
8;Barcelona;40;Vallès Occidental;08184;Rubí;3;7;A;;483;98;211;267;216;0;5;262;267
8;Barcelona;40;Vallès Occidental;08184;Rubí;3;7;B;;524;95;235;305;219;0;2;303;305
8;Barcelona;40;Vallès Occidental;08184;Rubí;3;8;A;;667;166;318;371;296;0;3;368;371
8;Barcelona;40;Vallès Occidental;08184;Rubí;3;8;B;;795;211;395;445;350;0;3;442;445
8;Barcelona;40;Vallès Occidental;08184;Rubí;4;1;A;;552;180;285;344;208;1;3;340;343
8;Barcelona;40;Vallès Occidental;08184;Rubí;4;1;B;;621;160;326;386;235;0;4;382;386
8;Barcelona;40;Vallès Occidental;08184;Rubí;4;10;A;;700;139;272;328;372;1;6;321;327
8;Barcelona;40;Vallès Occidental;08184;Rubí;4;10;B;;925;188;329;416;509;0;3;413;416
8;Barcelona;40;Vallès Occidental;08184;Rubí;4;11;A;;521;125;264;315;206;2;3;310;313
8;Barcelona;40;Vallès Occidental;08184;Rubí;4;11;B;;599;127;278;327;272;0;0;327;327
8;Barcelona;40;Vallès Occidental;08184;Rubí;4;11;C;;677;160;320;383;294;0;7;376;383
8;Barcelona;40;Vallès Occidental;08184;Rubí;4;12;A;;555;111;209;278;277;1;2;275;277
8;Barcelona;40;Vallès Occidental;08184;Rubí;4;12;B;;675;147;293;370;305;0;2;368;370
8;Barcelona;40;Vallès Occidental;08184;Rubí;4;12;C;;681;170;297;372;309;0;5;367;372
8;Barcelona;40;Vallès Occidental;08184;Rubí;4;13;A;;572;142;255;312;260;0;2;310;312
8;Barcelona;40;Vallès Occidental;08184;Rubí;4;13;B;;659;148;290;358;301;1;1;356;357
8;Barcelona;40;Vallès Occidental;08184;Rubí;4;13;C;;631;156;277;326;305;0;1;325;326
8;Barcelona;40;Vallès Occidental;08184;Rubí;4;14;A;;546;102;212;274;272;2;3;269;272
8;Barcelona;40;Vallès Occidental;08184;Rubí;4;14;B;;676;122;254;316;360;0;4;312;316
8;Barcelona;40;Vallès Occidental;08184;Rubí;4;15;A;;523;113;317;267;256;1;4;262;266
8;Barcelona;40;Vallès Occidental;08184;Rubí;4;15;B;;717;163;308;371;346;0;1;370;371
8;Barcelona;40;Vallès Occidental;08184;Rubí;4;15;C;;737;161;291;354;383;0;4;350;354
8;Barcelona;40;Vallès Occidental;08184;Rubí;4;16;A;;946;180;398;477;469;0;1;476;477
8;Barcelona;40;Vallès Occidental;08184;Rubí;4;16;B;;1134;251;490;569;565;2;2;565;567
8;Barcelona;40;Vallès Occidental;08184;Rubí;4;16;C;;479;102;175;200;279;0;2;198;200
8;Barcelona;40;Vallès Occidental;08184;Rubí;4;18;A;;506;121;253;302;204;1;2;299;301
8;Barcelona;40;Vallès Occidental;08184;Rubí;4;18;B;;535;103;245;309;226;0;5;304;309
8;Barcelona;40;Vallès Occidental;08184;Rubí;4;2;A;;410;121;220;254;156;0;3;251;254
8;Barcelona;40;Vallès Occidental;08184;Rubí;4;2;B;;507;146;282;326;181;0;3;323;326
8;Barcelona;40;Vallès Occidental;08184;Rubí;4;3;U;;829;181;358;459;370;0;0;459;459
8;Barcelona;40;Vallès Occidental;08184;Rubí;4;4;A;;691;181;316;379;312;0;3;376;379
8;Barcelona;40;Vallès Occidental;08184;Rubí;4;4;B;;766;207;364;432;334;1;2;429;431
8;Barcelona;40;Vallès Occidental;08184;Rubí;4;5;A;;642;186;363;436;206;0;2;434;436
8;Barcelona;40;Vallès Occidental;08184;Rubí;4;5;B;;662;200;348;427;235;1;4;422;426
8;Barcelona;40;Vallès Occidental;08184;Rubí;4;6;A;;552;136;292;342;210;2;5;335;340
8;Barcelona;40;Vallès Occidental;08184;Rubí;4;6;B;;637;166;338;390;247;3;3;384;387
8;Barcelona;40;Vallès Occidental;08184;Rubí;4;7;A;;532;119;250;299;233;1;1;297;298
8;Barcelona;40;Vallès Occidental;08184;Rubí;4;7;B;;678;190;361;427;251;1;2;424;426
8;Barcelona;40;Vallès Occidental;08184;Rubí;4;8;A;;923;199;371;449;474;2;0;447;447
8;Barcelona;40;Vallès Occidental;08184;Rubí;4;8;B;;1042;247;446;539;503;1;5;533;538
8;Barcelona;40;Vallès Occidental;08184;Rubí;4;9;A;;501;100;199;245;256;0;2;243;245
8;Barcelona;40;Vallès Occidental;08184;Rubí;4;9;B;;672;131;270;348;324;0;4;344;348
8;Barcelona;6;Anoia;08185;Rubió;1;1;U;;92;23;43;60;32;0;1;59;60
17;Girona;10;Baix Empordà;17153;Rupià;1;1;U;;169;71;111;135;34;0;0;135;135
8;Barcelona;24;Osona;08901;Rupit i Pruit;1;1;U;;282;105;162;225;57;0;1;224;225
8;Barcelona;40;Vallès Occidental;08187;Sabadell;1;1;U;;745;225;487;590;155;0;7;583;590
8;Barcelona;40;Vallès Occidental;08187;Sabadell;1;10;U;;651;241;432;495;156;0;9;486;495
8;Barcelona;40;Vallès Occidental;08187;Sabadell;1;11;U;;917;291;552;689;228;0;10;679;689
8;Barcelona;40;Vallès Occidental;08187;Sabadell;1;12;A;;749;224;474;594;155;0;3;591;594
8;Barcelona;40;Vallès Occidental;08187;Sabadell;1;12;B;;910;261;540;664;246;1;2;661;663
8;Barcelona;40;Vallès Occidental;08187;Sabadell;1;13;U;;1164;288;650;809;355;3;7;799;806
8;Barcelona;40;Vallès Occidental;08187;Sabadell;1;14;A;;658;183;381;494;164;1;10;483;493
8;Barcelona;40;Vallès Occidental;08187;Sabadell;1;14;B;;735;112;462;575;160;4;2;569;571
8;Barcelona;40;Vallès Occidental;08187;Sabadell;1;15;A;;567;151;336;419;148;1;2;416;418
8;Barcelona;40;Vallès Occidental;08187;Sabadell;1;15;B;;722;313;453;543;179;0;7;536;543
8;Barcelona;40;Vallès Occidental;08187;Sabadell;1;16;A;;627;157;396;484;143;0;4;480;484
8;Barcelona;40;Vallès Occidental;08187;Sabadell;1;16;B;;671;181;433;522;149;1;2;519;521
8;Barcelona;40;Vallès Occidental;08187;Sabadell;1;17;A;;535;223;302;370;165;1;0;369;369
8;Barcelona;40;Vallès Occidental;08187;Sabadell;1;17;B;;732;224;391;497;235;4;1;492;493
8;Barcelona;40;Vallès Occidental;08187;Sabadell;1;18;U;;980;246;500;620;360;1;5;614;619
8;Barcelona;40;Vallès Occidental;08187;Sabadell;1;19;A;;666;205;388;493;173;3;8;482;490
8;Barcelona;40;Vallès Occidental;08187;Sabadell;1;19;B;;708;215;426;525;183;3;4;518;522
8;Barcelona;40;Vallès Occidental;08187;Sabadell;1;2;A;;795;244;481;617;178;0;4;613;617
8;Barcelona;40;Vallès Occidental;08187;Sabadell;1;2;B;;942;271;609;747;195;0;10;737;747
8;Barcelona;40;Vallès Occidental;08187;Sabadell;1;20;A;;530;107;265;352;178;0;3;349;352
8;Barcelona;40;Vallès Occidental;08187;Sabadell;1;20;B;;593;139;331;411;182;1;4;406;410
8;Barcelona;40;Vallès Occidental;08187;Sabadell;1;21;U;;867;241;500;639;228;0;7;632;639
8;Barcelona;40;Vallès Occidental;08187;Sabadell;1;22;A;;565;172;312;347;218;0;6;341;347
8;Barcelona;40;Vallès Occidental;08187;Sabadell;1;22;B;;769;230;419;515;254;0;2;513;515
8;Barcelona;40;Vallès Occidental;08187;Sabadell;1;23;A;;580;141;288;358;222;1;1;356;357
8;Barcelona;40;Vallès Occidental;08187;Sabadell;1;23;B;;743;189;385;490;253;0;4;486;490
8;Barcelona;40;Vallès Occidental;08187;Sabadell;1;24;A;;542;132;281;355;187;0;4;351;355
8;Barcelona;40;Vallès Occidental;08187;Sabadell;1;24;B;;628;158;319;399;229;2;0;397;397
8;Barcelona;40;Vallès Occidental;08187;Sabadell;1;25;A;;627;163;301;382;245;0;5;377;382
8;Barcelona;40;Vallès Occidental;08187;Sabadell;1;25;B;;700;135;349;424;276;3;3;418;421
8;Barcelona;40;Vallès Occidental;08187;Sabadell;1;26;U;;818;229;470;577;241;3;5;569;574
8;Barcelona;40;Vallès Occidental;08187;Sabadell;1;27;U;;857;218;452;584;273;4;12;568;580
8;Barcelona;40;Vallès Occidental;08187;Sabadell;1;28;A;;602;176;347;421;181;0;0;421;421
8;Barcelona;40;Vallès Occidental;08187;Sabadell;1;28;B;;764;229;427;515;249;2;7;506;513
8;Barcelona;40;Vallès Occidental;08187;Sabadell;1;29;A;;671;205;351;444;227;0;4;440;444
8;Barcelona;40;Vallès Occidental;08187;Sabadell;1;29;B;;812;211;422;528;284;1;9;518;527
8;Barcelona;40;Vallès Occidental;08187;Sabadell;1;3;U;;864;279;555;676;188;0;5;671;676
8;Barcelona;40;Vallès Occidental;08187;Sabadell;1;4;A;;580;149;329;430;150;0;2;428;430
8;Barcelona;40;Vallès Occidental;08187;Sabadell;1;4;B;;663;178;383;485;178;0;6;479;485
8;Barcelona;40;Vallès Occidental;08187;Sabadell;1;5;A;;628;205;401;470;158;0;10;460;470
8;Barcelona;40;Vallès Occidental;08187;Sabadell;1;5;B;;639;200;403;494;145;9;3;482;485
8;Barcelona;40;Vallès Occidental;08187;Sabadell;1;6;A;;519;179;339;408;111;1;6;401;407
8;Barcelona;40;Vallès Occidental;08187;Sabadell;1;6;B;;590;183;374;457;133;1;6;450;456
8;Barcelona;40;Vallès Occidental;08187;Sabadell;1;7;U;;915;320;545;659;256;6;3;650;653
8;Barcelona;40;Vallès Occidental;08187;Sabadell;1;8;U;;1029;245;632;768;261;2;8;758;766
8;Barcelona;40;Vallès Occidental;08187;Sabadell;1;9;A;;629;139;373;477;152;2;5;470;475
8;Barcelona;40;Vallès Occidental;08187;Sabadell;1;9;B;;655;154;400;493;162;0;4;489;493
8;Barcelona;40;Vallès Occidental;08187;Sabadell;2;1;A;;579;171;349;455;124;0;4;451;455
8;Barcelona;40;Vallès Occidental;08187;Sabadell;2;1;B;;683;194;462;553;130;2;6;545;551
8;Barcelona;40;Vallès Occidental;08187;Sabadell;2;10;U;;307;95;132;153;154;1;4;148;152
8;Barcelona;40;Vallès Occidental;08187;Sabadell;2;11;U;;764;127;260;328;436;1;0;327;327
8;Barcelona;40;Vallès Occidental;08187;Sabadell;2;12;A;;666;166;307;372;294;0;1;371;372
8;Barcelona;40;Vallès Occidental;08187;Sabadell;2;12;B;;860;199;371;450;410;2;5;443;448
8;Barcelona;40;Vallès Occidental;08187;Sabadell;2;13;U;;969;233;476;559;410;1;4;554;558
8;Barcelona;40;Vallès Occidental;08187;Sabadell;2;14;A;;752;184;317;392;360;0;2;390;392
8;Barcelona;40;Vallès Occidental;08187;Sabadell;2;14;B;;925;200;396;495;430;0;4;491;495
8;Barcelona;40;Vallès Occidental;08187;Sabadell;2;15;A;;544;137;264;322;222;0;1;321;322
8;Barcelona;40;Vallès Occidental;08187;Sabadell;2;15;B;;737;188;378;469;268;1;5;463;468
8;Barcelona;40;Vallès Occidental;08187;Sabadell;2;16;A;;705;174;413;524;181;1;7;516;523
8;Barcelona;40;Vallès Occidental;08187;Sabadell;2;16;B;;739;205;460;552;187;2;2;548;550
8;Barcelona;40;Vallès Occidental;08187;Sabadell;2;2;U;;1011;296;638;766;245;0;7;759;766
8;Barcelona;40;Vallès Occidental;08187;Sabadell;2;3;A;;573;167;295;365;208;1;1;363;364
8;Barcelona;40;Vallès Occidental;08187;Sabadell;2;3;B;;679;189;365;437;242;1;2;434;436
8;Barcelona;40;Vallès Occidental;08187;Sabadell;2;4;A;;640;196;376;457;183;2;6;449;455
8;Barcelona;40;Vallès Occidental;08187;Sabadell;2;4;B;;856;236;500;616;240;5;4;607;611
8;Barcelona;40;Vallès Occidental;08187;Sabadell;2;5;A;;678;203;412;495;183;1;2;492;494
8;Barcelona;40;Vallès Occidental;08187;Sabadell;2;5;B;;768;212;442;549;219;0;9;540;549
8;Barcelona;40;Vallès Occidental;08187;Sabadell;2;6;A;;589;185;353;411;178;2;2;407;409
8;Barcelona;40;Vallès Occidental;08187;Sabadell;2;6;B;;813;248;473;567;246;2;4;561;565
8;Barcelona;40;Vallès Occidental;08187;Sabadell;2;7;A;;556;186;320;391;165;3;2;386;388
8;Barcelona;40;Vallès Occidental;08187;Sabadell;2;7;B;;652;210;377;482;170;1;5;476;481
8;Barcelona;40;Vallès Occidental;08187;Sabadell;2;8;A;;573;160;319;398;175;0;9;389;398
8;Barcelona;40;Vallès Occidental;08187;Sabadell;2;8;B;;611;171;374;457;154;1;2;454;456
8;Barcelona;40;Vallès Occidental;08187;Sabadell;2;9;A;;606;189;352;433;173;4;6;423;429
8;Barcelona;40;Vallès Occidental;08187;Sabadell;2;9;B;;726;196;417;509;217;0;3;506;509
8;Barcelona;40;Vallès Occidental;08187;Sabadell;3;1;A;;595;108;256;342;253;2;0;340;340
8;Barcelona;40;Vallès Occidental;08187;Sabadell;3;1;B;;660;147;322;364;296;0;4;360;364
8;Barcelona;40;Vallès Occidental;08187;Sabadell;3;10;U;;711;190;350;426;285;2;0;424;424
8;Barcelona;40;Vallès Occidental;08187;Sabadell;3;11;U;;1045;255;500;615;430;0;5;610;615
8;Barcelona;40;Vallès Occidental;08187;Sabadell;3;12;U;;1026;237;490;640;386;1;6;633;639
8;Barcelona;40;Vallès Occidental;08187;Sabadell;3;13;U;;1046;255;482;616;430;2;6;608;614
8;Barcelona;40;Vallès Occidental;08187;Sabadell;3;14;A;;713;229;385;449;264;1;1;447;448
8;Barcelona;40;Vallès Occidental;08187;Sabadell;3;14;B;;879;268;470;560;319;3;2;555;557
8;Barcelona;40;Vallès Occidental;08187;Sabadell;3;15;A;;584;133;290;347;237;3;0;344;344
8;Barcelona;40;Vallès Occidental;08187;Sabadell;3;15;B;;759;176;366;432;327;3;1;428;429
8;Barcelona;40;Vallès Occidental;08187;Sabadell;3;16;A;;561;138;297;340;221;0;2;338;340
8;Barcelona;40;Vallès Occidental;08187;Sabadell;3;16;B;;740;231;395;447;293;0;1;446;447
8;Barcelona;40;Vallès Occidental;08187;Sabadell;3;17;A;;475;110;214;283;192;0;2;281;283
8;Barcelona;40;Vallès Occidental;08187;Sabadell;3;17;B;;612;172;252;381;231;0;0;381;381
8;Barcelona;40;Vallès Occidental;08187;Sabadell;3;18;A;;581;127;274;334;247;0;3;331;334
8;Barcelona;40;Vallès Occidental;08187;Sabadell;3;18;B;;795;162;352;448;347;0;1;447;448
8;Barcelona;40;Vallès Occidental;08187;Sabadell;3;19;A;;969;165;432;552;417;0;3;549;552
8;Barcelona;40;Vallès Occidental;08187;Sabadell;3;19;B;;1240;241;550;705;535;0;8;697;705
8;Barcelona;40;Vallès Occidental;08187;Sabadell;3;2;A;;486;114;216;261;225;2;0;259;259
8;Barcelona;40;Vallès Occidental;08187;Sabadell;3;2;B;;635;172;305;310;325;0;3;307;310
8;Barcelona;40;Vallès Occidental;08187;Sabadell;3;20;U;;1086;233;506;615;471;4;7;604;611
8;Barcelona;40;Vallès Occidental;08187;Sabadell;3;21;A;;625;152;296;361;264;2;1;358;359
8;Barcelona;40;Vallès Occidental;08187;Sabadell;3;21;B;;727;143;324;392;335;2;1;389;390
8;Barcelona;40;Vallès Occidental;08187;Sabadell;3;22;U;;840;174;366;459;381;4;5;450;455
8;Barcelona;40;Vallès Occidental;08187;Sabadell;3;23;U;;767;154;360;443;324;0;4;439;443
8;Barcelona;40;Vallès Occidental;08187;Sabadell;3;3;A;;622;135;293;346;276;0;1;345;346
8;Barcelona;40;Vallès Occidental;08187;Sabadell;3;3;B;;872;192;428;488;384;6;5;477;482
8;Barcelona;40;Vallès Occidental;08187;Sabadell;3;4;A;;625;150;325;373;252;0;1;372;373
8;Barcelona;40;Vallès Occidental;08187;Sabadell;3;4;B;;829;268;430;515;314;2;6;507;513
8;Barcelona;40;Vallès Occidental;08187;Sabadell;3;5;A;;865;205;437;516;349;0;10;506;516
8;Barcelona;40;Vallès Occidental;08187;Sabadell;3;5;B;;1161;278;604;725;436;3;8;714;722
8;Barcelona;40;Vallès Occidental;08187;Sabadell;3;6;A;;597;128;295;371;226;0;9;362;371
8;Barcelona;40;Vallès Occidental;08187;Sabadell;3;6;B;;726;159;325;407;319;0;1;406;407
8;Barcelona;40;Vallès Occidental;08187;Sabadell;3;7;U;;797;218;443;512;285;0;4;508;512
8;Barcelona;40;Vallès Occidental;08187;Sabadell;3;8;U;;1066;231;460;570;496;0;4;566;570
8;Barcelona;40;Vallès Occidental;08187;Sabadell;3;9;U;;771;174;335;407;364;0;2;405;407
8;Barcelona;40;Vallès Occidental;08187;Sabadell;4;1;A;;550;122;210;300;250;2;4;294;298
8;Barcelona;40;Vallès Occidental;08187;Sabadell;4;1;B;;693;155;320;423;270;3;0;420;420
8;Barcelona;40;Vallès Occidental;08187;Sabadell;4;10;A;;642;148;307;385;257;1;2;382;384
8;Barcelona;40;Vallès Occidental;08187;Sabadell;4;10;B;;709;181;317;413;296;0;3;410;413
8;Barcelona;40;Vallès Occidental;08187;Sabadell;4;11;A;;835;152;348;428;407;0;0;428;428
8;Barcelona;40;Vallès Occidental;08187;Sabadell;4;11;B;;941;154;375;467;474;0;7;460;467
8;Barcelona;40;Vallès Occidental;08187;Sabadell;4;12;A;;802;167;364;467;335;1;6;460;466
8;Barcelona;40;Vallès Occidental;08187;Sabadell;4;12;B;;1043;208;475;591;452;0;7;584;591
8;Barcelona;40;Vallès Occidental;08187;Sabadell;4;13;A;;558;103;211;286;272;1;4;281;285
8;Barcelona;40;Vallès Occidental;08187;Sabadell;4;13;B;;602;111;274;334;268;0;3;331;334
8;Barcelona;40;Vallès Occidental;08187;Sabadell;4;14;A;;591;210;294;369;222;4;1;364;365
8;Barcelona;40;Vallès Occidental;08187;Sabadell;4;14;B;;686;146;326;411;275;2;3;406;409
8;Barcelona;40;Vallès Occidental;08187;Sabadell;4;15;U;;941;229;442;519;422;1;6;512;518
8;Barcelona;40;Vallès Occidental;08187;Sabadell;4;16;A;;537;132;259;312;225;0;0;312;312
8;Barcelona;40;Vallès Occidental;08187;Sabadell;4;16;B;;720;157;344;430;290;1;2;427;429
8;Barcelona;40;Vallès Occidental;08187;Sabadell;4;17;A;;736;157;334;402;334;0;8;394;402
8;Barcelona;40;Vallès Occidental;08187;Sabadell;4;17;B;;947;219;436;533;414;0;5;528;533
8;Barcelona;40;Vallès Occidental;08187;Sabadell;4;18;U;;618;132;312;389;229;0;3;386;389
8;Barcelona;40;Vallès Occidental;08187;Sabadell;4;19;A;;602;148;276;340;262;0;1;339;340
8;Barcelona;40;Vallès Occidental;08187;Sabadell;4;19;B;;732;145;321;420;312;0;3;417;420
8;Barcelona;40;Vallès Occidental;08187;Sabadell;4;2;A;;506;144;261;320;186;1;4;315;319
8;Barcelona;40;Vallès Occidental;08187;Sabadell;4;2;B;;641;159;308;367;274;1;3;363;366
8;Barcelona;40;Vallès Occidental;08187;Sabadell;4;20;A;;550;110;225;287;263;2;2;283;285
8;Barcelona;40;Vallès Occidental;08187;Sabadell;4;20;B;;678;139;279;361;317;1;1;359;360
8;Barcelona;40;Vallès Occidental;08187;Sabadell;4;3;U;;1011;222;471;583;428;2;7;574;581
8;Barcelona;40;Vallès Occidental;08187;Sabadell;4;4;A;;720;165;319;427;293;0;4;423;427
8;Barcelona;40;Vallès Occidental;08187;Sabadell;4;4;B;;891;229;427;552;339;0;8;544;552
8;Barcelona;40;Vallès Occidental;08187;Sabadell;4;5;A;;673;159;347;409;264;0;2;407;409
8;Barcelona;40;Vallès Occidental;08187;Sabadell;4;5;B;;825;189;415;506;319;0;4;502;506
8;Barcelona;40;Vallès Occidental;08187;Sabadell;4;6;A;;498;131;244;306;192;1;3;302;305
8;Barcelona;40;Vallès Occidental;08187;Sabadell;4;6;B;;595;133;286;364;231;3;1;360;361
8;Barcelona;40;Vallès Occidental;08187;Sabadell;4;7;U;;1037;214;478;632;405;2;4;626;630
8;Barcelona;40;Vallès Occidental;08187;Sabadell;4;8;A;;671;151;334;438;233;2;8;428;436
8;Barcelona;40;Vallès Occidental;08187;Sabadell;4;8;B;;748;168;372;491;257;8;0;483;483
8;Barcelona;40;Vallès Occidental;08187;Sabadell;4;9;U;;990;197;475;632;358;0;6;626;632
8;Barcelona;40;Vallès Occidental;08187;Sabadell;5;1;A;;545;140;298;362;183;0;2;360;362
8;Barcelona;40;Vallès Occidental;08187;Sabadell;5;1;B;;715;187;383;469;246;2;1;466;467
8;Barcelona;40;Vallès Occidental;08187;Sabadell;5;10;U;;792;223;386;451;341;2;7;442;449
8;Barcelona;40;Vallès Occidental;08187;Sabadell;5;11;U;;665;179;326;381;284;0;5;376;381
8;Barcelona;40;Vallès Occidental;08187;Sabadell;5;12;U;;980;239;514;602;378;2;2;598;600
8;Barcelona;40;Vallès Occidental;08187;Sabadell;5;13;A;;542;155;282;345;197;1;1;343;344
8;Barcelona;40;Vallès Occidental;08187;Sabadell;5;13;B;;717;165;338;422;295;3;6;413;419
8;Barcelona;40;Vallès Occidental;08187;Sabadell;5;2;U;;894;262;524;629;265;0;3;626;629
8;Barcelona;40;Vallès Occidental;08187;Sabadell;5;3;A;;703;240;443;524;179;4;3;517;520
8;Barcelona;40;Vallès Occidental;08187;Sabadell;5;3;B;;704;218;419;500;204;1;9;490;499
8;Barcelona;40;Vallès Occidental;08187;Sabadell;5;4;U;;624;160;347;428;196;0;1;427;428
8;Barcelona;40;Vallès Occidental;08187;Sabadell;5;5;U;;1002;266;528;652;350;3;7;642;649
8;Barcelona;40;Vallès Occidental;08187;Sabadell;5;6;U;;903;267;547;666;237;0;9;657;666
8;Barcelona;40;Vallès Occidental;08187;Sabadell;5;7;A;;460;144;245;286;174;0;1;285;286
8;Barcelona;40;Vallès Occidental;08187;Sabadell;5;7;B;;635;169;312;379;256;0;3;376;379
8;Barcelona;40;Vallès Occidental;08187;Sabadell;5;8;U;;884;282;490;568;316;4;6;558;564
8;Barcelona;40;Vallès Occidental;08187;Sabadell;5;9;U;;1089;301;612;697;392;3;3;691;694
8;Barcelona;40;Vallès Occidental;08187;Sabadell;6;1;U;;517;173;279;324;193;2;2;320;322
8;Barcelona;40;Vallès Occidental;08187;Sabadell;6;10;U;;1017;255;443;551;466;4;0;547;547
8;Barcelona;40;Vallès Occidental;08187;Sabadell;6;11;A;;533;137;230;279;254;0;3;276;279
8;Barcelona;40;Vallès Occidental;08187;Sabadell;6;11;B;;614;166;286;348;266;1;5;342;347
8;Barcelona;40;Vallès Occidental;08187;Sabadell;6;12;U;;1086;280;528;644;442;0;7;637;644
8;Barcelona;40;Vallès Occidental;08187;Sabadell;6;13;U;;1071;224;463;565;506;3;4;558;562
8;Barcelona;40;Vallès Occidental;08187;Sabadell;6;14;U;;502;169;256;301;201;0;1;300;301
8;Barcelona;40;Vallès Occidental;08187;Sabadell;6;15;A;;519;106;215;279;240;2;3;274;277
8;Barcelona;40;Vallès Occidental;08187;Sabadell;6;15;B;;741;138;293;380;361;1;5;374;379
8;Barcelona;40;Vallès Occidental;08187;Sabadell;6;16;A;;704;164;384;457;247;0;8;449;457
8;Barcelona;40;Vallès Occidental;08187;Sabadell;6;16;B;;831;190;445;510;321;0;6;504;510
8;Barcelona;40;Vallès Occidental;08187;Sabadell;6;17;A;;638;147;300;397;241;1;4;392;396
8;Barcelona;40;Vallès Occidental;08187;Sabadell;6;17;B;;852;253;447;546;306;2;9;535;544
8;Barcelona;40;Vallès Occidental;08187;Sabadell;6;18;U;;1070;317;572;671;399;1;6;664;670
8;Barcelona;40;Vallès Occidental;08187;Sabadell;6;19;U;;704;187;333;416;288;2;3;411;414
8;Barcelona;40;Vallès Occidental;08187;Sabadell;6;2;A;;610;154;286;362;248;0;3;359;362
8;Barcelona;40;Vallès Occidental;08187;Sabadell;6;2;B;;764;179;373;474;290;0;2;472;474
8;Barcelona;40;Vallès Occidental;08187;Sabadell;6;20;U;;987;266;473;567;420;3;0;564;564
8;Barcelona;40;Vallès Occidental;08187;Sabadell;6;21;U;;936;211;466;542;394;2;2;538;540
8;Barcelona;40;Vallès Occidental;08187;Sabadell;6;22;A;;645;142;300;354;291;4;3;347;350
8;Barcelona;40;Vallès Occidental;08187;Sabadell;6;22;B;;758;214;411;452;306;3;1;448;449
8;Barcelona;40;Vallès Occidental;08187;Sabadell;6;23;A;;665;206;375;436;229;2;4;430;434
8;Barcelona;40;Vallès Occidental;08187;Sabadell;6;23;B;;769;219;412;479;290;1;4;474;478
8;Barcelona;40;Vallès Occidental;08187;Sabadell;6;3;U;;504;224;241;298;206;2;2;294;296
8;Barcelona;40;Vallès Occidental;08187;Sabadell;6;4;U;;786;208;395;468;318;1;4;463;467
8;Barcelona;40;Vallès Occidental;08187;Sabadell;6;5;U;;1108;212;451;584;524;0;5;579;584
8;Barcelona;40;Vallès Occidental;08187;Sabadell;6;6;U;;909;202;395;502;407;0;6;496;502
8;Barcelona;40;Vallès Occidental;08187;Sabadell;6;7;U;;919;289;480;557;362;1;3;553;556
8;Barcelona;40;Vallès Occidental;08187;Sabadell;6;8;A;;751;191;365;475;276;3;1;471;472
8;Barcelona;40;Vallès Occidental;08187;Sabadell;6;8;B;;838;228;427;528;310;4;3;521;524
8;Barcelona;40;Vallès Occidental;08187;Sabadell;6;9;A;;786;183;368;462;324;1;4;457;461
8;Barcelona;40;Vallès Occidental;08187;Sabadell;6;9;B;;918;213;412;496;422;1;2;493;495
8;Barcelona;40;Vallès Occidental;08187;Sabadell;7;1;U;;1018;205;532;613;405;0;4;609;613
8;Barcelona;40;Vallès Occidental;08187;Sabadell;7;2;A;;522;135;278;325;197;0;1;324;325
8;Barcelona;40;Vallès Occidental;08187;Sabadell;7;2;B;;726;197;400;481;245;1;7;473;480
8;Barcelona;40;Vallès Occidental;08187;Sabadell;7;3;A;;614;123;262;307;307;0;0;307;307
8;Barcelona;40;Vallès Occidental;08187;Sabadell;7;3;B;;794;180;315;425;369;0;3;422;425
8;Barcelona;40;Vallès Occidental;08187;Sabadell;7;4;U;;771;237;415;494;277;4;0;490;490
8;Barcelona;40;Vallès Occidental;08187;Sabadell;7;5;U;;721;199;393;438;283;0;1;437;438
8;Barcelona;40;Vallès Occidental;08187;Sabadell;7;6;U;;647;171;348;421;226;0;1;420;421
8;Barcelona;14;Berguedà;08188;Sagàs;1;1;U;;145;46;89;109;36;4;1;104;105
25;Lleida;25;Pallars Jussà;25190;Salàs de Pallars;1;1;U;;317;125;192;246;71;0;1;245;246
8;Barcelona;14;Berguedà;08190;Saldes;1;1;U;;252;104;156;184;68;0;2;182;184
17;Girona;19;Garrotxa;17154;Sales de Llierca;1;1;U;;42;7;23;30;12;0;0;30;30
8;Barcelona;7;Bages;08191;Sallent;1;1;U;;603;155;360;430;173;1;3;426;429
8;Barcelona;7;Bages;08191;Sallent;1;2;U;;699;194;405;488;211;0;4;484;488
8;Barcelona;7;Bages;08191;Sallent;1;3;A;;533;133;316;376;157;0;1;375;376
8;Barcelona;7;Bages;08191;Sallent;1;3;B;;596;136;370;425;171;1;5;419;424
8;Barcelona;7;Bages;08191;Sallent;1;4;A;;483;121;252;311;172;0;1;310;311
8;Barcelona;7;Bages;08191;Sallent;1;4;B;;508;151;278;339;169;0;9;330;339
8;Barcelona;7;Bages;08191;Sallent;1;5;U;;858;238;491;622;236;0;3;619;622
8;Barcelona;7;Bages;08191;Sallent;1;6;U;;713;191;400;492;221;7;0;485;485
8;Barcelona;7;Bages;08191;Sallent;1;7;U;;659;184;330;405;254;3;1;401;402
8;Barcelona;7;Bages;08191;Sallent;2;1;U;;661;197;378;419;242;3;4;412;416
43;Tarragona;36;Tarragonès;43135;Salomó;1;1;U;;383;146;247;303;80;0;2;301;303
43;Tarragona;36;Tarragonès;43905;Salou;1;1;U;;856;196;358;463;393;1;7;455;462
43;Tarragona;36;Tarragonès;43905;Salou;1;2;U;;1046;202;406;526;520;4;4;518;522
43;Tarragona;36;Tarragonès;43905;Salou;1;3;A;;734;155;304;406;328;1;3;402;405
43;Tarragona;36;Tarragonès;43905;Salou;1;3;B;;736;138;298;391;345;1;1;389;390
43;Tarragona;36;Tarragonès;43905;Salou;1;4;A;;868;226;414;500;368;4;5;491;496
43;Tarragona;36;Tarragonès;43905;Salou;1;4;B;;941;199;403;511;430;1;3;507;510
43;Tarragona;36;Tarragonès;43905;Salou;1;5;A;;830;178;344;447;383;0;1;446;447
43;Tarragona;36;Tarragonès;43905;Salou;1;5;B;;882;116;360;488;394;1;6;481;487
43;Tarragona;36;Tarragonès;43905;Salou;1;6;U;;984;152;344;434;550;1;5;428;433
17;Girona;20;Gironès;17155;Salt;1;1;U;;1241;377;738;882;359;2;6;874;880
17;Girona;20;Gironès;17155;Salt;1;2;U;;898;318;557;659;239;3;3;653;656
17;Girona;20;Gironès;17155;Salt;1;3;U;;1270;312;665;804;466;3;4;797;801
17;Girona;20;Gironès;17155;Salt;1;4;A;;1012;300;611;701;311;1;2;698;700
17;Girona;20;Gironès;17155;Salt;1;4;B;;1029;303;593;695;334;2;7;686;693
17;Girona;20;Gironès;17155;Salt;1;5;A;;911;227;443;540;371;4;4;532;536
17;Girona;20;Gironès;17155;Salt;1;5;B;;851;195;412;530;321;2;3;525;528
17;Girona;20;Gironès;17155;Salt;1;6;A;;708;196;355;415;293;0;4;411;415
17;Girona;20;Gironès;17155;Salt;1;6;B;;689;217;355;416;273;3;1;412;413
17;Girona;20;Gironès;17155;Salt;1;7;U;;1044;284;546;653;391;2;6;645;651
17;Girona;20;Gironès;17155;Salt;1;8;U;;830;262;489;566;264;2;7;557;564
17;Girona;20;Gironès;17155;Salt;2;1;A;;602;190;330;387;215;2;0;385;385
17;Girona;20;Gironès;17155;Salt;2;1;B;;598;172;319;388;210;0;4;384;388
17;Girona;20;Gironès;17155;Salt;2;2;U;;1126;298;581;726;400;2;4;720;724
17;Girona;20;Gironès;17155;Salt;2;3;U;;1228;340;618;801;427;1;5;795;800
17;Girona;20;Gironès;17155;Salt;2;4;U;;1127;196;406;493;634;6;0;487;487
17;Girona;20;Gironès;17155;Salt;2;5;U;;804;225;487;611;193;0;6;605;611
17;Girona;20;Gironès;17155;Salt;2;6;U;;870;241;443;551;319;0;7;544;551
25;Lleida;32;Segarra;25191;Sanaüja;1;1;U;;404;101;255;322;82;0;1;321;322
43;Tarragona;22;Montsià;43138;Santa Bàrbara;1;1;A;;694;150;366;543;151;7;5;531;536
43;Tarragona;22;Montsià;43138;Santa Bàrbara;1;1;B;;394;76;206;274;120;0;3;271;274
43;Tarragona;22;Montsià;43138;Santa Bàrbara;1;1;C;;518;112;280;378;140;2;4;372;376
43;Tarragona;22;Montsià;43138;Santa Bàrbara;2;1;A;;590;115;302;417;173;0;3;414;417
43;Tarragona;22;Montsià;43138;Santa Bàrbara;2;1;B;;540;114;256;366;174;2;2;362;364
8;Barcelona;24;Osona;08243;Santa Cecília de Voltregà;1;1;U;;150;42;93;110;40;0;2;108;110
8;Barcelona;11;Baix Llobregat;08244;Santa Coloma de Cervelló;1;1;A;;690;143;327;414;276;0;1;413;414
8;Barcelona;11;Baix Llobregat;08244;Santa Coloma de Cervelló;1;1;B;;917;211;476;577;340;0;5;572;577
8;Barcelona;11;Baix Llobregat;08244;Santa Coloma de Cervelló;1;2;U;;710;240;465;523;187;0;9;514;523
8;Barcelona;11;Baix Llobregat;08244;Santa Coloma de Cervelló;1;3;U;;365;90;194;252;113;0;4;248;252
17;Girona;34;Selva;17180;Santa Coloma de Farners;1;1;A;;742;158;405;512;230;4;4;504;508
17;Girona;34;Selva;17180;Santa Coloma de Farners;1;1;B;;713;166;356;446;267;2;3;441;444
17;Girona;34;Selva;17180;Santa Coloma de Farners;1;2;A;;543;118;300;394;149;2;2;390;392
17;Girona;34;Selva;17180;Santa Coloma de Farners;1;2;B;;514;118;270;340;174;0;6;334;340
17;Girona;34;Selva;17180;Santa Coloma de Farners;1;3;A;;700;191;426;513;187;0;6;507;513
17;Girona;34;Selva;17180;Santa Coloma de Farners;1;3;B;;642;180;263;436;206;1;2;433;435
17;Girona;34;Selva;17180;Santa Coloma de Farners;1;4;A;;866;187;426;558;308;2;2;554;556
17;Girona;34;Selva;17180;Santa Coloma de Farners;1;4;B;;834;195;406;545;289;2;8;535;543
17;Girona;34;Selva;17180;Santa Coloma de Farners;1;5;A;;562;109;257;349;213;3;3;343;346
17;Girona;34;Selva;17180;Santa Coloma de Farners;1;5;B;;621;132;319;418;203;2;3;413;416
8;Barcelona;13;Barcelonès;08245;Santa Coloma de Gramenet;1;1;U;;989;276;507;634;355;3;8;623;631
8;Barcelona;13;Barcelonès;08245;Santa Coloma de Gramenet;1;10;A;;630;130;256;339;291;0;4;335;339
8;Barcelona;13;Barcelonès;08245;Santa Coloma de Gramenet;1;10;B;;766;139;298;376;390;0;4;372;376
8;Barcelona;13;Barcelonès;08245;Santa Coloma de Gramenet;1;11;A;;534;101;222;302;232;1;5;296;301
8;Barcelona;13;Barcelonès;08245;Santa Coloma de Gramenet;1;11;B;;600;139;283;355;245;2;5;348;353
8;Barcelona;13;Barcelonès;08245;Santa Coloma de Gramenet;1;12;U;;838;194;348;487;351;0;3;484;487
8;Barcelona;13;Barcelonès;08245;Santa Coloma de Gramenet;1;13;A;;541;111;248;307;234;0;3;304;307
8;Barcelona;13;Barcelonès;08245;Santa Coloma de Gramenet;1;13;B;;564;112;239;330;234;1;13;316;329
8;Barcelona;13;Barcelonès;08245;Santa Coloma de Gramenet;1;13;C;;546;114;257;337;209;0;5;332;337
8;Barcelona;13;Barcelonès;08245;Santa Coloma de Gramenet;1;14;U;;797;169;393;512;285;0;4;508;512
8;Barcelona;13;Barcelonès;08245;Santa Coloma de Gramenet;1;15;U;;770;151;334;446;324;0;2;444;446
8;Barcelona;13;Barcelonès;08245;Santa Coloma de Gramenet;1;16;U;;767;161;343;437;330;1;5;431;436
8;Barcelona;13;Barcelonès;08245;Santa Coloma de Gramenet;1;17;A;;685;131;270;355;330;0;1;354;355
8;Barcelona;13;Barcelonès;08245;Santa Coloma de Gramenet;1;17;B;;839;168;347;458;381;0;3;455;458
8;Barcelona;13;Barcelonès;08245;Santa Coloma de Gramenet;1;18;A;;601;129;268;347;254;1;4;342;346
8;Barcelona;13;Barcelonès;08245;Santa Coloma de Gramenet;1;18;B;;656;135;296;390;266;0;3;387;390
8;Barcelona;13;Barcelonès;08245;Santa Coloma de Gramenet;1;19;A;;657;153;266;353;304;2;2;349;351
8;Barcelona;13;Barcelonès;08245;Santa Coloma de Gramenet;1;19;B;;734;144;304;399;335;2;5;392;397
8;Barcelona;13;Barcelonès;08245;Santa Coloma de Gramenet;1;2;U;;759;184;360;468;291;0;9;459;468
8;Barcelona;13;Barcelonès;08245;Santa Coloma de Gramenet;1;3;A;;544;133;231;305;239;4;0;301;301
8;Barcelona;13;Barcelonès;08245;Santa Coloma de Gramenet;1;3;B;;676;160;300;388;288;1;4;383;387
8;Barcelona;13;Barcelonès;08245;Santa Coloma de Gramenet;1;4;U;;762;169;330;419;343;2;2;415;417
8;Barcelona;13;Barcelonès;08245;Santa Coloma de Gramenet;1;5;U;;813;189;388;488;325;0;3;485;488
8;Barcelona;13;Barcelonès;08245;Santa Coloma de Gramenet;1;6;U;;851;174;323;415;436;1;1;413;414
8;Barcelona;13;Barcelonès;08245;Santa Coloma de Gramenet;1;7;U;;662;151;304;362;300;1;4;357;361
8;Barcelona;13;Barcelonès;08245;Santa Coloma de Gramenet;1;8;U;;632;160;294;372;260;0;5;367;372
8;Barcelona;13;Barcelonès;08245;Santa Coloma de Gramenet;1;9;A;;548;136;251;315;233;1;7;307;314
8;Barcelona;13;Barcelonès;08245;Santa Coloma de Gramenet;1;9;B;;653;136;244;342;311;0;1;341;342
8;Barcelona;13;Barcelonès;08245;Santa Coloma de Gramenet;2;1;U;;967;206;633;555;412;0;4;551;555
8;Barcelona;13;Barcelonès;08245;Santa Coloma de Gramenet;2;10;U;;822;156;314;411;411;1;2;408;410
8;Barcelona;13;Barcelonès;08245;Santa Coloma de Gramenet;2;11;A;;609;110;213;279;330;0;3;276;279
8;Barcelona;13;Barcelonès;08245;Santa Coloma de Gramenet;2;11;B;;759;135;283;368;391;0;3;365;368
8;Barcelona;13;Barcelonès;08245;Santa Coloma de Gramenet;2;2;A;;462;104;210;282;180;0;3;279;282
8;Barcelona;13;Barcelonès;08245;Santa Coloma de Gramenet;2;2;B;;540;131;229;305;235;0;0;305;305
8;Barcelona;13;Barcelonès;08245;Santa Coloma de Gramenet;2;2;C;;486;84;218;287;199;0;4;283;287
8;Barcelona;13;Barcelonès;08245;Santa Coloma de Gramenet;2;3;A;;642;117;289;359;283;1;8;350;358
8;Barcelona;13;Barcelonès;08245;Santa Coloma de Gramenet;2;3;B;;786;149;325;388;398;0;4;384;388
8;Barcelona;13;Barcelonès;08245;Santa Coloma de Gramenet;2;4;A;;546;135;246;316;230;0;6;310;316
8;Barcelona;13;Barcelonès;08245;Santa Coloma de Gramenet;2;4;B;;669;163;311;393;276;2;6;385;391
8;Barcelona;13;Barcelonès;08245;Santa Coloma de Gramenet;2;5;A;;579;163;273;329;250;0;4;325;329
8;Barcelona;13;Barcelonès;08245;Santa Coloma de Gramenet;2;5;B;;636;146;277;346;290;0;2;344;346
8;Barcelona;13;Barcelonès;08245;Santa Coloma de Gramenet;2;6;A;;593;125;242;323;270;1;3;319;322
8;Barcelona;13;Barcelonès;08245;Santa Coloma de Gramenet;2;6;B;;694;149;314;382;312;2;0;380;380
8;Barcelona;13;Barcelonès;08245;Santa Coloma de Gramenet;2;7;A;;513;84;205;255;258;1;3;251;254
8;Barcelona;13;Barcelonès;08245;Santa Coloma de Gramenet;2;7;B;;610;125;248;304;306;1;1;302;303
8;Barcelona;13;Barcelonès;08245;Santa Coloma de Gramenet;2;7;C;;568;105;230;286;282;0;2;284;286
8;Barcelona;13;Barcelonès;08245;Santa Coloma de Gramenet;2;8;A;;640;114;252;336;304;0;2;334;336
8;Barcelona;13;Barcelonès;08245;Santa Coloma de Gramenet;2;8;B;;738;134;295;390;348;0;3;387;390
8;Barcelona;13;Barcelonès;08245;Santa Coloma de Gramenet;2;9;A;;563;129;258;327;236;0;4;323;327
8;Barcelona;13;Barcelonès;08245;Santa Coloma de Gramenet;2;9;B;;602;124;247;325;277;2;3;320;323
8;Barcelona;13;Barcelonès;08245;Santa Coloma de Gramenet;3;1;U;;911;160;367;481;430;0;3;478;481
8;Barcelona;13;Barcelonès;08245;Santa Coloma de Gramenet;3;10;U;;511;119;202;275;236;0;2;273;275
8;Barcelona;13;Barcelonès;08245;Santa Coloma de Gramenet;3;11;U;;786;186;352;426;360;0;5;421;426
8;Barcelona;13;Barcelonès;08245;Santa Coloma de Gramenet;3;12;A;;644;134;271;360;284;2;4;354;358
8;Barcelona;13;Barcelonès;08245;Santa Coloma de Gramenet;3;12;B;;868;184;378;491;377;1;2;488;490
8;Barcelona;13;Barcelonès;08245;Santa Coloma de Gramenet;3;13;A;;463;97;194;265;198;0;5;260;265
8;Barcelona;13;Barcelonès;08245;Santa Coloma de Gramenet;3;13;B;;570;120;223;312;258;0;4;308;312
8;Barcelona;13;Barcelonès;08245;Santa Coloma de Gramenet;3;13;C;;629;132;280;352;277;0;3;349;352
8;Barcelona;13;Barcelonès;08245;Santa Coloma de Gramenet;3;14;A;;641;132;295;360;281;2;1;357;358
8;Barcelona;13;Barcelonès;08245;Santa Coloma de Gramenet;3;14;B;;716;146;293;365;351;0;5;360;365
8;Barcelona;13;Barcelonès;08245;Santa Coloma de Gramenet;3;15;A;;392;84;166;204;188;2;9;193;202
8;Barcelona;13;Barcelonès;08245;Santa Coloma de Gramenet;3;15;B;;378;92;172;215;163;5;3;207;210
8;Barcelona;13;Barcelonès;08245;Santa Coloma de Gramenet;3;16;U;;1041;240;470;581;460;0;6;575;581
8;Barcelona;13;Barcelonès;08245;Santa Coloma de Gramenet;3;17;U;;954;186;332;394;560;2;5;387;392
8;Barcelona;13;Barcelonès;08245;Santa Coloma de Gramenet;3;2;U;;648;160;291;358;290;4;3;351;354
8;Barcelona;13;Barcelonès;08245;Santa Coloma de Gramenet;3;3;U;;947;188;434;525;422;2;4;519;523
8;Barcelona;13;Barcelonès;08245;Santa Coloma de Gramenet;3;4;A;;561;106;232;285;276;1;2;282;284
8;Barcelona;13;Barcelonès;08245;Santa Coloma de Gramenet;3;4;B;;610;139;275;324;286;1;3;320;323
8;Barcelona;13;Barcelonès;08245;Santa Coloma de Gramenet;3;5;A;;545;89;187;246;299;0;4;242;246
8;Barcelona;13;Barcelonès;08245;Santa Coloma de Gramenet;3;5;B;;667;144;265;317;350;0;2;315;317
8;Barcelona;13;Barcelonès;08245;Santa Coloma de Gramenet;3;6;A;;434;74;162;223;211;0;2;221;223
8;Barcelona;13;Barcelonès;08245;Santa Coloma de Gramenet;3;6;B;;591;116;243;312;279;0;0;312;312
8;Barcelona;13;Barcelonès;08245;Santa Coloma de Gramenet;3;7;A;;515;112;227;289;226;0;2;287;289
8;Barcelona;13;Barcelonès;08245;Santa Coloma de Gramenet;3;7;B;;684;129;281;364;320;0;2;362;364
8;Barcelona;13;Barcelonès;08245;Santa Coloma de Gramenet;3;7;C;;558;107;219;289;269;0;3;286;289
8;Barcelona;13;Barcelonès;08245;Santa Coloma de Gramenet;3;8;U;;759;163;330;426;333;0;2;424;426
8;Barcelona;13;Barcelonès;08245;Santa Coloma de Gramenet;3;9;U;;1000;210;423;560;440;2;7;551;558
8;Barcelona;13;Barcelonès;08245;Santa Coloma de Gramenet;4;1;U;;939;206;391;493;446;0;4;489;493
8;Barcelona;13;Barcelonès;08245;Santa Coloma de Gramenet;4;10;A;;538;101;237;296;242;0;3;293;296
8;Barcelona;13;Barcelonès;08245;Santa Coloma de Gramenet;4;10;B;;617;149;293;377;240;0;5;372;377
8;Barcelona;13;Barcelonès;08245;Santa Coloma de Gramenet;4;11;A;;534;101;233;311;223;2;4;305;309
8;Barcelona;13;Barcelonès;08245;Santa Coloma de Gramenet;4;11;B;;547;117;248;329;218;2;2;325;327
8;Barcelona;13;Barcelonès;08245;Santa Coloma de Gramenet;4;12;A;;453;115;218;272;181;1;2;269;271
8;Barcelona;13;Barcelonès;08245;Santa Coloma de Gramenet;4;12;B;;611;146;297;383;228;0;6;377;383
8;Barcelona;13;Barcelonès;08245;Santa Coloma de Gramenet;4;13;A;;512;108;194;269;243;1;4;264;268
8;Barcelona;13;Barcelonès;08245;Santa Coloma de Gramenet;4;13;B;;588;123;218;300;288;0;4;296;300
8;Barcelona;13;Barcelonès;08245;Santa Coloma de Gramenet;4;14;A;;542;115;239;322;220;2;4;316;320
8;Barcelona;13;Barcelonès;08245;Santa Coloma de Gramenet;4;14;B;;663;132;278;357;306;1;5;351;356
8;Barcelona;13;Barcelonès;08245;Santa Coloma de Gramenet;4;14;C;;642;133;275;364;278;1;4;359;363
8;Barcelona;13;Barcelonès;08245;Santa Coloma de Gramenet;4;15;A;;630;144;249;323;307;0;0;323;323
8;Barcelona;13;Barcelonès;08245;Santa Coloma de Gramenet;4;15;B;;797;156;302;412;385;3;8;401;409
8;Barcelona;13;Barcelonès;08245;Santa Coloma de Gramenet;4;16;A;;728;166;314;417;311;4;0;413;413
8;Barcelona;13;Barcelonès;08245;Santa Coloma de Gramenet;4;16;B;;908;203;395;519;389;1;2;516;518
8;Barcelona;13;Barcelonès;08245;Santa Coloma de Gramenet;4;2;A;;571;147;292;358;213;0;3;355;358
8;Barcelona;13;Barcelonès;08245;Santa Coloma de Gramenet;4;2;B;;593;146;279;363;230;1;3;359;362
8;Barcelona;13;Barcelonès;08245;Santa Coloma de Gramenet;4;3;A;;492;96;188;253;239;3;3;247;250
8;Barcelona;13;Barcelonès;08245;Santa Coloma de Gramenet;4;3;B;;575;101;236;285;290;2;2;281;283
8;Barcelona;13;Barcelonès;08245;Santa Coloma de Gramenet;4;4;A;;576;115;253;324;252;0;6;318;324
8;Barcelona;13;Barcelonès;08245;Santa Coloma de Gramenet;4;4;B;;696;128;311;392;304;1;1;390;391
8;Barcelona;13;Barcelonès;08245;Santa Coloma de Gramenet;4;5;U;;966;180;422;553;413;0;8;545;553
8;Barcelona;13;Barcelonès;08245;Santa Coloma de Gramenet;4;6;A;;552;122;251;325;227;0;1;324;325
8;Barcelona;13;Barcelonès;08245;Santa Coloma de Gramenet;4;6;B;;670;139;301;384;286;1;8;375;383
8;Barcelona;13;Barcelonès;08245;Santa Coloma de Gramenet;4;7;A;;674;139;290;387;287;1;2;384;386
8;Barcelona;13;Barcelonès;08245;Santa Coloma de Gramenet;4;7;B;;743;175;355;443;300;0;1;442;443
8;Barcelona;13;Barcelonès;08245;Santa Coloma de Gramenet;4;8;A;;457;106;210;274;183;0;4;270;274
8;Barcelona;13;Barcelonès;08245;Santa Coloma de Gramenet;4;8;B;;541;132;248;315;226;0;2;313;315
8;Barcelona;13;Barcelonès;08245;Santa Coloma de Gramenet;4;8;C;;571;143;290;355;216;1;6;348;354
8;Barcelona;13;Barcelonès;08245;Santa Coloma de Gramenet;4;9;A;;716;183;301;407;309;2;5;400;405
8;Barcelona;13;Barcelonès;08245;Santa Coloma de Gramenet;4;9;B;;774;188;343;460;314;1;1;458;459
8;Barcelona;13;Barcelonès;08245;Santa Coloma de Gramenet;5;1;U;;904;176;347;446;458;2;1;443;444
8;Barcelona;13;Barcelonès;08245;Santa Coloma de Gramenet;5;10;U;;758;153;311;380;378;0;3;377;380
8;Barcelona;13;Barcelonès;08245;Santa Coloma de Gramenet;5;11;A;;590;105;213;287;303;1;1;285;286
8;Barcelona;13;Barcelonès;08245;Santa Coloma de Gramenet;5;11;B;;697;114;211;294;403;0;1;293;294
8;Barcelona;13;Barcelonès;08245;Santa Coloma de Gramenet;5;12;U;;885;181;341;413;472;2;4;407;411
8;Barcelona;13;Barcelonès;08245;Santa Coloma de Gramenet;5;13;A;;573;110;220;285;288;0;2;283;285
8;Barcelona;13;Barcelonès;08245;Santa Coloma de Gramenet;5;13;B;;611;125;237;298;313;0;1;297;298
8;Barcelona;13;Barcelonès;08245;Santa Coloma de Gramenet;5;14;A;;594;109;223;294;300;0;1;293;294
8;Barcelona;13;Barcelonès;08245;Santa Coloma de Gramenet;5;14;B;;702;136;254;340;362;0;0;340;340
8;Barcelona;13;Barcelonès;08245;Santa Coloma de Gramenet;5;15;A;;527;117;210;262;265;0;6;256;262
8;Barcelona;13;Barcelonès;08245;Santa Coloma de Gramenet;5;15;B;;651;148;258;324;327;1;3;320;323
8;Barcelona;13;Barcelonès;08245;Santa Coloma de Gramenet;5;16;U;;840;152;322;420;420;0;4;416;420
8;Barcelona;13;Barcelonès;08245;Santa Coloma de Gramenet;5;17;U;;765;126;250;326;439;0;6;320;326
8;Barcelona;13;Barcelonès;08245;Santa Coloma de Gramenet;5;18;A;;447;65;131;172;275;1;0;171;171
8;Barcelona;13;Barcelonès;08245;Santa Coloma de Gramenet;5;18;B;;511;89;171;234;277;0;0;234;234
8;Barcelona;13;Barcelonès;08245;Santa Coloma de Gramenet;5;19;U;;980;243;455;523;457;1;4;518;522
8;Barcelona;13;Barcelonès;08245;Santa Coloma de Gramenet;5;2;A;;620;130;256;355;265;0;5;350;355
8;Barcelona;13;Barcelonès;08245;Santa Coloma de Gramenet;5;2;B;;742;135;300;407;335;1;7;399;406
8;Barcelona;13;Barcelonès;08245;Santa Coloma de Gramenet;5;3;U;;839;176;381;482;357;0;2;480;482
8;Barcelona;13;Barcelonès;08245;Santa Coloma de Gramenet;5;4;U;;774;163;350;420;354;2;6;412;418
8;Barcelona;13;Barcelonès;08245;Santa Coloma de Gramenet;5;5;A;;550;99;200;267;283;0;6;261;267
8;Barcelona;13;Barcelonès;08245;Santa Coloma de Gramenet;5;5;B;;545;85;178;221;324;0;1;220;221
8;Barcelona;13;Barcelonès;08245;Santa Coloma de Gramenet;5;6;U;;899;168;335;425;474;2;7;416;423
8;Barcelona;13;Barcelonès;08245;Santa Coloma de Gramenet;5;7;A;;484;98;207;285;199;0;4;281;285
8;Barcelona;13;Barcelonès;08245;Santa Coloma de Gramenet;5;7;B;;553;111;227;292;261;1;10;281;291
8;Barcelona;13;Barcelonès;08245;Santa Coloma de Gramenet;5;8;U;;872;137;313;417;455;0;4;413;417
8;Barcelona;13;Barcelonès;08245;Santa Coloma de Gramenet;5;9;U;;1063;189;379;495;568;1;8;486;494
8;Barcelona;13;Barcelonès;08245;Santa Coloma de Gramenet;6;1;U;;573;135;263;328;245;2;2;324;326
8;Barcelona;13;Barcelonès;08245;Santa Coloma de Gramenet;6;10;U;;812;162;300;404;408;0;3;401;404
8;Barcelona;13;Barcelonès;08245;Santa Coloma de Gramenet;6;11;U;;826;174;336;424;402;0;2;422;424
8;Barcelona;13;Barcelonès;08245;Santa Coloma de Gramenet;6;12;U;;760;158;325;412;348;0;0;412;412
8;Barcelona;13;Barcelonès;08245;Santa Coloma de Gramenet;6;13;U;;603;118;234;311;292;1;3;307;310
8;Barcelona;13;Barcelonès;08245;Santa Coloma de Gramenet;6;14;A;;510;110;213;265;245;0;1;264;265
8;Barcelona;13;Barcelonès;08245;Santa Coloma de Gramenet;6;14;B;;618;121;235;300;318;0;4;296;300
8;Barcelona;13;Barcelonès;08245;Santa Coloma de Gramenet;6;15;U;;619;130;228;293;326;1;1;291;292
8;Barcelona;13;Barcelonès;08245;Santa Coloma de Gramenet;6;16;U;;640;117;204;251;389;1;0;250;250
8;Barcelona;13;Barcelonès;08245;Santa Coloma de Gramenet;6;17;U;;801;146;306;374;427;0;2;372;374
8;Barcelona;13;Barcelonès;08245;Santa Coloma de Gramenet;6;2;U;;827;191;382;470;357;0;7;463;470
8;Barcelona;13;Barcelonès;08245;Santa Coloma de Gramenet;6;3;A;;478;95;205;273;205;0;5;268;273
8;Barcelona;13;Barcelonès;08245;Santa Coloma de Gramenet;6;3;B;;565;127;238;329;236;0;6;323;329
8;Barcelona;13;Barcelonès;08245;Santa Coloma de Gramenet;6;4;A;;433;96;186;240;193;2;3;235;238
8;Barcelona;13;Barcelonès;08245;Santa Coloma de Gramenet;6;4;B;;568;127;243;324;244;1;7;316;323
8;Barcelona;13;Barcelonès;08245;Santa Coloma de Gramenet;6;5;U;;892;206;417;544;348;0;7;537;544
8;Barcelona;13;Barcelonès;08245;Santa Coloma de Gramenet;6;6;U;;736;188;346;414;322;0;3;411;414
8;Barcelona;13;Barcelonès;08245;Santa Coloma de Gramenet;6;7;U;;540;117;221;305;235;0;1;304;305
8;Barcelona;13;Barcelonès;08245;Santa Coloma de Gramenet;6;8;A;;497;98;208;269;228;1;5;263;268
8;Barcelona;13;Barcelonès;08245;Santa Coloma de Gramenet;6;8;B;;585;123;247;310;275;1;3;306;309
8;Barcelona;13;Barcelonès;08245;Santa Coloma de Gramenet;6;9;U;;544;113;220;292;252;1;3;288;291
43;Tarragona;16;Conca de Barberà;43139;Santa Coloma de Queralt;1;1;A;;690;180;382;493;197;3;2;488;490
43;Tarragona;16;Conca de Barberà;43139;Santa Coloma de Queralt;1;1;B;;780;196;443;562;218;3;7;552;559
43;Tarragona;16;Conca de Barberà;43139;Santa Coloma de Queralt;2;1;U;;624;161;342;455;169;0;7;448;455
17;Girona;10;Baix Empordà;17181;Santa Cristina d'Aro;1;1;A;;782;234;481;574;208;1;9;564;573
17;Girona;10;Baix Empordà;17181;Santa Cristina d'Aro;1;1;B;;858;228;512;594;264;3;2;589;591
8;Barcelona;13;Barcelonès;08194;Sant Adrià de Besòs;1;1;A;;517;125;251;318;199;3;8;307;315
8;Barcelona;13;Barcelonès;08194;Sant Adrià de Besòs;1;1;B;;612;146;288;357;255;0;12;345;357
8;Barcelona;13;Barcelonès;08194;Sant Adrià de Besòs;1;2;A;;530;146;271;329;201;5;4;320;324
8;Barcelona;13;Barcelonès;08194;Sant Adrià de Besòs;1;2;B;;603;171;297;362;241;2;3;357;360
8;Barcelona;13;Barcelonès;08194;Sant Adrià de Besòs;1;3;A;;678;162;325;396;282;1;0;395;395
8;Barcelona;13;Barcelonès;08194;Sant Adrià de Besòs;1;3;B;;860;190;393;467;393;0;5;462;467
8;Barcelona;13;Barcelonès;08194;Sant Adrià de Besòs;1;4;A;;681;120;283;377;304;1;2;374;376
8;Barcelona;13;Barcelonès;08194;Sant Adrià de Besòs;1;4;B;;743;160;313;447;296;1;6;440;446
8;Barcelona;13;Barcelonès;08194;Sant Adrià de Besòs;1;5;A;;794;196;349;465;329;0;11;454;465
8;Barcelona;13;Barcelonès;08194;Sant Adrià de Besòs;1;5;B;;932;218;459;554;378;5;7;542;549
8;Barcelona;13;Barcelonès;08194;Sant Adrià de Besòs;1;6;A;;560;120;270;343;217;0;7;336;343
8;Barcelona;13;Barcelonès;08194;Sant Adrià de Besòs;1;6;B;;598;143;307;373;225;0;10;363;373
8;Barcelona;13;Barcelonès;08194;Sant Adrià de Besòs;2;1;A;;562;134;274;316;246;0;3;313;316
8;Barcelona;13;Barcelonès;08194;Sant Adrià de Besòs;2;1;B;;675;157;308;379;296;2;2;375;377
8;Barcelona;13;Barcelonès;08194;Sant Adrià de Besòs;2;2;A;;642;123;223;279;363;0;1;278;279
8;Barcelona;13;Barcelonès;08194;Sant Adrià de Besòs;2;2;B;;763;157;275;362;401;2;10;350;360
8;Barcelona;13;Barcelonès;08194;Sant Adrià de Besòs;2;3;A;;599;124;262;332;267;2;7;323;330
8;Barcelona;13;Barcelonès;08194;Sant Adrià de Besòs;2;3;B;;805;150;346;443;362;5;6;432;438
8;Barcelona;13;Barcelonès;08194;Sant Adrià de Besòs;2;4;A;;714;172;334;428;286;1;8;419;427
8;Barcelona;13;Barcelonès;08194;Sant Adrià de Besòs;2;4;B;;859;182;363;465;394;3;3;459;462
8;Barcelona;13;Barcelonès;08194;Sant Adrià de Besòs;3;1;U;;602;187;304;337;265;0;0;337;337
8;Barcelona;13;Barcelonès;08194;Sant Adrià de Besòs;4;1;U;;393;94;178;207;186;0;0;207;207
8;Barcelona;13;Barcelonès;08194;Sant Adrià de Besòs;5;1;A;;703;161;285;360;343;1;3;356;359
8;Barcelona;13;Barcelonès;08194;Sant Adrià de Besòs;5;1;B;;793;175;333;428;365;1;2;425;427
8;Barcelona;13;Barcelonès;08194;Sant Adrià de Besòs;5;2;A;;729;181;341;423;306;0;7;416;423
8;Barcelona;13;Barcelonès;08194;Sant Adrià de Besòs;5;2;B;;768;204;340;439;329;0;3;436;439
8;Barcelona;13;Barcelonès;08194;Sant Adrià de Besòs;5;3;U;;959;214;469;592;367;4;6;582;588
8;Barcelona;13;Barcelonès;08194;Sant Adrià de Besòs;5;4;A;;590;136;290;351;239;0;5;346;351
8;Barcelona;13;Barcelonès;08194;Sant Adrià de Besòs;5;4;B;;624;156;312;384;240;1;4;379;383
8;Barcelona;13;Barcelonès;08194;Sant Adrià de Besòs;6;1;U;;447;99;168;195;252;0;0;195;195
8;Barcelona;13;Barcelonès;08194;Sant Adrià de Besòs;6;2;A;;772;123;252;300;472;0;4;296;300
8;Barcelona;13;Barcelonès;08194;Sant Adrià de Besòs;6;2;B;;624;117;210;257;367;0;2;255;257
8;Barcelona;13;Barcelonès;08194;Sant Adrià de Besòs;6;3;U;;563;108;186;218;345;0;1;217;218
8;Barcelona;13;Barcelonès;08194;Sant Adrià de Besòs;6;4;A;;930;116;203;256;674;1;1;254;255
8;Barcelona;13;Barcelonès;08194;Sant Adrià de Besòs;6;4;B;;516;91;151;186;330;0;1;185;186
8;Barcelona;13;Barcelonès;08194;Sant Adrià de Besòs;6;5;A;;624;138;230;299;325;0;0;299;299
8;Barcelona;13;Barcelonès;08194;Sant Adrià de Besòs;6;5;B;;730;177;306;376;354;3;1;372;373
8;Barcelona;13;Barcelonès;08194;Sant Adrià de Besòs;6;6;A;;762;111;222;269;493;4;5;260;265
8;Barcelona;13;Barcelonès;08194;Sant Adrià de Besòs;6;6;B;;704;106;214;271;433;1;2;268;270
8;Barcelona;13;Barcelonès;08194;Sant Adrià de Besòs;6;7;A;;515;88;173;215;300;0;0;215;215
8;Barcelona;13;Barcelonès;08194;Sant Adrià de Besòs;6;7;B;;571;114;217;266;305;0;1;265;266
8;Barcelona;24;Osona;08246;Santa Eugènia de Berga;1;1;A;;755;238;468;595;160;6;7;582;589
8;Barcelona;24;Osona;08246;Santa Eugènia de Berga;1;1;B;;854;302;532;675;179;1;2;672;674
8;Barcelona;24;Osona;08247;Santa Eulàlia de Riuprimer;1;1;U;;692;227;414;515;177;2;6;507;513
8;Barcelona;41;Vallès Oriental;08248;Santa Eulàlia de Ronçana;1;1;A;;841;194;435;538;303;3;1;534;535
8;Barcelona;41;Vallès Oriental;08248;Santa Eulàlia de Ronçana;1;1;B;;864;213;456;549;315;5;3;541;544
8;Barcelona;41;Vallès Oriental;08248;Santa Eulàlia de Ronçana;1;2;A;;720;214;414;508;212;1;2;505;507
8;Barcelona;41;Vallès Oriental;08248;Santa Eulàlia de Ronçana;1;2;B;;775;166;377;470;305;1;6;463;469
8;Barcelona;3;Alt Penedès;08249;Santa Fe del Penedès;1;1;U;;179;66;121;152;27;0;0;152;152
8;Barcelona;24;Osona;08195;Sant Agustí de Lluçanès;1;1;U;;88;23;50;69;19;0;0;69;69
17;Girona;2;Alt Empordà;17182;Santa Llogaia d'Àlguema;1;1;U;;256;62;150;175;81;0;1;174;175
8;Barcelona;6;Anoia;08250;Santa Margarida de Montbui;1;1;U;;659;180;379;482;177;0;3;479;482
8;Barcelona;6;Anoia;08250;Santa Margarida de Montbui;1;2;A;;789;124;300;388;401;0;6;382;388
8;Barcelona;6;Anoia;08250;Santa Margarida de Montbui;1;2;B;;876;159;340;449;427;2;2;445;447
8;Barcelona;6;Anoia;08250;Santa Margarida de Montbui;1;3;U;;868;166;349;459;409;3;8;448;456
8;Barcelona;6;Anoia;08250;Santa Margarida de Montbui;1;4;A;;595;116;256;344;251;1;0;343;343
8;Barcelona;6;Anoia;08250;Santa Margarida de Montbui;1;4;B;;685;104;280;363;322;0;1;362;363
8;Barcelona;6;Anoia;08250;Santa Margarida de Montbui;1;5;A;;616;120;256;312;304;2;4;306;310
8;Barcelona;6;Anoia;08250;Santa Margarida de Montbui;1;5;B;;657;132;286;367;290;0;4;363;367
8;Barcelona;6;Anoia;08250;Santa Margarida de Montbui;1;5;C;;613;83;240;328;285;2;3;323;326
8;Barcelona;6;Anoia;08250;Santa Margarida de Montbui;1;6;U;;870;173;357;446;424;0;1;445;446
8;Barcelona;3;Alt Penedès;08251;Santa Margarida i els Monjos;1;1;A;;791;216;424;542;249;1;3;538;541
8;Barcelona;3;Alt Penedès;08251;Santa Margarida i els Monjos;1;1;B;;802;234;435;554;248;1;3;550;553
8;Barcelona;3;Alt Penedès;08251;Santa Margarida i els Monjos;1;2;U;;808;205;459;560;248;3;2;555;557
8;Barcelona;3;Alt Penedès;08251;Santa Margarida i els Monjos;1;3;U;;884;251;468;598;286;2;6;590;596
8;Barcelona;;;08258;Santa Maria d'Oló;1;1;U;;821;200;540;632;189;2;3;627;630
8;Barcelona;24;Osona;08253;Santa Maria de Besora;1;1;U;;159;47;95;115;44;0;2;113;115
8;Barcelona;41;Vallès Oriental;08256;Santa Maria de Martorelles;1;1;U;;514;167;325;389;125;2;2;385;387
8;Barcelona;14;Berguedà;08255;Santa Maria de Merlès;1;1;U;;155;45;77;92;63;0;2;90;92
8;Barcelona;6;Anoia;08257;Santa Maria de Miralles;1;1;U;;95;23;48;69;26;0;1;68;69
8;Barcelona;41;Vallès Oriental;08259;Santa Maria de Palautordera;1;1;A;;835;263;523;617;218;3;4;610;614
8;Barcelona;41;Vallès Oriental;08259;Santa Maria de Palautordera;1;1;B;;846;270;547;630;216;4;3;623;626
8;Barcelona;41;Vallès Oriental;08259;Santa Maria de Palautordera;1;2;A;;707;213;459;527;180;1;8;518;526
8;Barcelona;41;Vallès Oriental;08259;Santa Maria de Palautordera;1;2;B;;850;204;491;596;254;1;6;589;595
8;Barcelona;41;Vallès Oriental;08259;Santa Maria de Palautordera;1;3;A;;357;101;193;234;123;0;1;233;234
8;Barcelona;41;Vallès Oriental;08259;Santa Maria de Palautordera;1;3;B;;677;162;396;483;194;0;1;482;483
8;Barcelona;11;Baix Llobregat;08196;Sant Andreu de la Barca;1;1;A;;760;145;330;400;360;1;6;393;399
8;Barcelona;11;Baix Llobregat;08196;Sant Andreu de la Barca;1;1;B;;802;188;355;443;359;1;7;435;442
8;Barcelona;11;Baix Llobregat;08196;Sant Andreu de la Barca;1;1;C;;790;203;380;459;331;0;6;453;459
8;Barcelona;11;Baix Llobregat;08196;Sant Andreu de la Barca;1;2;A;;833;180;362;437;396;1;3;433;436
8;Barcelona;11;Baix Llobregat;08196;Sant Andreu de la Barca;1;2;B;;970;195;378;475;495;7;1;467;468
8;Barcelona;11;Baix Llobregat;08196;Sant Andreu de la Barca;1;3;A;;896;176;371;484;412;1;7;476;483
8;Barcelona;11;Baix Llobregat;08196;Sant Andreu de la Barca;1;3;B;;1034;197;420;539;495;2;1;536;537
8;Barcelona;11;Baix Llobregat;08196;Sant Andreu de la Barca;1;4;A;;613;161;309;380;233;2;3;375;378
8;Barcelona;11;Baix Llobregat;08196;Sant Andreu de la Barca;1;4;B;;787;207;383;479;308;1;3;475;478
8;Barcelona;11;Baix Llobregat;08196;Sant Andreu de la Barca;1;5;A;;772;162;323;426;346;1;2;423;425
8;Barcelona;11;Baix Llobregat;08196;Sant Andreu de la Barca;1;5;B;;1006;172;282;522;484;0;7;515;522
8;Barcelona;11;Baix Llobregat;08196;Sant Andreu de la Barca;1;5;C;;953;190;375;491;462;0;5;486;491
8;Barcelona;11;Baix Llobregat;08196;Sant Andreu de la Barca;1;6;A;;622;139;279;356;266;2;5;349;354
8;Barcelona;11;Baix Llobregat;08196;Sant Andreu de la Barca;1;6;B;;807;181;370;462;345;1;6;455;461
8;Barcelona;11;Baix Llobregat;08196;Sant Andreu de la Barca;1;6;C;;781;181;340;421;360;2;4;415;419
8;Barcelona;11;Baix Llobregat;08196;Sant Andreu de la Barca;1;7;A;;573;128;271;346;227;0;5;341;346
8;Barcelona;11;Baix Llobregat;08196;Sant Andreu de la Barca;1;7;B;;688;147;315;399;289;3;2;394;396
8;Barcelona;21;Maresme;08197;Sant Andreu de Llavaneres;1;1;A;;513;139;306;362;151;2;3;357;360
8;Barcelona;21;Maresme;08197;Sant Andreu de Llavaneres;1;1;B;;414;105;252;303;111;0;4;299;303
8;Barcelona;21;Maresme;08197;Sant Andreu de Llavaneres;1;2;U;;864;215;474;619;245;0;11;608;619
8;Barcelona;21;Maresme;08197;Sant Andreu de Llavaneres;1;3;A;;626;180;353;437;189;0;2;435;437
8;Barcelona;21;Maresme;08197;Sant Andreu de Llavaneres;1;3;B;;577;170;336;394;183;0;3;391;394
8;Barcelona;21;Maresme;08197;Sant Andreu de Llavaneres;2;1;A;;705;188;406;496;209;1;3;492;495
8;Barcelona;21;Maresme;08197;Sant Andreu de Llavaneres;2;1;B;;727;192;404;493;234;0;8;485;493
17;Girona;20;Gironès;17157;Sant Andreu Salou;1;1;U;;108;37;64;89;19;0;0;89;89
17;Girona;19;Garrotxa;17183;Sant Aniol de Finestres;1;1;U;;233;77;132;161;72;0;2;159;161
8;Barcelona;41;Vallès Oriental;08198;Sant Antoni de Vilamajor;1;1;A;;987;263;543;666;321;2;2;662;664
8;Barcelona;41;Vallès Oriental;08198;Sant Antoni de Vilamajor;1;1;B;;1103;280;591;734;369;2;3;729;732
43;Tarragona;12;Baix Penedès;43140;Santa Oliva;1;1;A;;1075;247;537;632;443;4;5;623;628
43;Tarragona;12;Baix Penedès;43140;Santa Oliva;1;1;B;;324;105;175;203;121;0;5;198;203
17;Girona;19;Garrotxa;17184;Santa Pau;1;1;A;;573;168;324;377;196;0;1;376;377
17;Girona;19;Garrotxa;17184;Santa Pau;1;1;B;;598;180;341;390;208;0;3;387;390
8;Barcelona;40;Vallès Occidental;08260;Santa Perpètua de Mogoda;1;1;U;;1143;294;530;634;509;5;5;624;629
8;Barcelona;40;Vallès Occidental;08260;Santa Perpètua de Mogoda;1;10;U;;702;169;393;459;243;6;2;451;453
8;Barcelona;40;Vallès Occidental;08260;Santa Perpètua de Mogoda;1;11;U;;864;213;418;537;327;2;8;527;535
8;Barcelona;40;Vallès Occidental;08260;Santa Perpètua de Mogoda;1;2;A;;1041;219;468;611;430;6;2;603;605
8;Barcelona;40;Vallès Occidental;08260;Santa Perpètua de Mogoda;1;2;B;;815;188;397;469;346;1;3;465;468
8;Barcelona;40;Vallès Occidental;08260;Santa Perpètua de Mogoda;1;3;A;;685;142;363;442;243;1;4;437;441
8;Barcelona;40;Vallès Occidental;08260;Santa Perpètua de Mogoda;1;3;B;;582;133;321;387;195;1;1;385;386
8;Barcelona;40;Vallès Occidental;08260;Santa Perpètua de Mogoda;1;4;A;;1079;180;382;486;593;2;2;482;484
8;Barcelona;40;Vallès Occidental;08260;Santa Perpètua de Mogoda;1;4;B;;871;145;300;380;491;2;4;374;378
8;Barcelona;40;Vallès Occidental;08260;Santa Perpètua de Mogoda;1;5;U;;691;114;247;321;370;0;3;318;321
8;Barcelona;40;Vallès Occidental;08260;Santa Perpètua de Mogoda;1;6;U;;988;203;441;538;450;1;2;535;537
8;Barcelona;40;Vallès Occidental;08260;Santa Perpètua de Mogoda;1;7;U;;935;193;404;505;430;1;4;500;504
8;Barcelona;40;Vallès Occidental;08260;Santa Perpètua de Mogoda;1;8;U;;1160;262;628;605;555;1;8;596;604
8;Barcelona;40;Vallès Occidental;08260;Santa Perpètua de Mogoda;1;9;A;;1046;160;376;537;509;2;8;527;535
8;Barcelona;40;Vallès Occidental;08260;Santa Perpètua de Mogoda;1;9;B;;922;189;386;524;398;0;11;513;524
8;Barcelona;21;Maresme;08261;Santa Susanna;1;1;U;;1077;290;580;709;368;2;7;700;707
8;Barcelona;24;Osona;08199;Sant Bartomeu del Grau;1;1;U;;829;170;451;554;275;1;0;553;553
8;Barcelona;11;Baix Llobregat;08200;Sant Boi de Llobregat;1;1;A;;492;140;245;293;199;0;3;290;293
8;Barcelona;11;Baix Llobregat;08200;Sant Boi de Llobregat;1;1;B;;552;154;290;344;208;1;2;341;343
8;Barcelona;11;Baix Llobregat;08200;Sant Boi de Llobregat;1;2;A;;759;196;381;459;300;3;3;453;456
8;Barcelona;11;Baix Llobregat;08200;Sant Boi de Llobregat;1;2;B;;834;198;393;471;363;1;1;469;470
8;Barcelona;11;Baix Llobregat;08200;Sant Boi de Llobregat;1;3;A;;517;130;251;308;209;5;4;299;303
8;Barcelona;11;Baix Llobregat;08200;Sant Boi de Llobregat;1;3;B;;638;163;331;390;248;0;2;388;390
8;Barcelona;11;Baix Llobregat;08200;Sant Boi de Llobregat;1;4;A;;627;144;294;360;267;0;3;357;360
8;Barcelona;11;Baix Llobregat;08200;Sant Boi de Llobregat;1;4;B;;819;170;365;450;369;0;0;450;450
8;Barcelona;11;Baix Llobregat;08200;Sant Boi de Llobregat;1;5;A;;668;108;209;261;407;0;3;258;261
8;Barcelona;11;Baix Llobregat;08200;Sant Boi de Llobregat;1;5;B;;723;133;263;326;397;0;1;325;326
8;Barcelona;11;Baix Llobregat;08200;Sant Boi de Llobregat;1;6;A;;408;131;211;255;153;0;0;255;255
8;Barcelona;11;Baix Llobregat;08200;Sant Boi de Llobregat;1;6;B;;643;191;326;382;261;0;2;380;382
8;Barcelona;11;Baix Llobregat;08200;Sant Boi de Llobregat;1;7;A;;563;127;282;348;215;0;5;343;348
8;Barcelona;11;Baix Llobregat;08200;Sant Boi de Llobregat;1;7;B;;659;170;337;422;237;0;6;416;422
8;Barcelona;11;Baix Llobregat;08200;Sant Boi de Llobregat;2;1;A;;311;71;138;177;134;1;2;174;176
8;Barcelona;11;Baix Llobregat;08200;Sant Boi de Llobregat;2;1;B;;370;76;145;187;183;1;1;185;186
8;Barcelona;11;Baix Llobregat;08200;Sant Boi de Llobregat;2;10;A;;771;172;331;459;312;0;5;454;459
8;Barcelona;11;Baix Llobregat;08200;Sant Boi de Llobregat;2;10;B;;947;214;422;542;405;0;5;537;542
8;Barcelona;11;Baix Llobregat;08200;Sant Boi de Llobregat;2;11;A;;395;85;169;221;174;0;1;220;221
8;Barcelona;11;Baix Llobregat;08200;Sant Boi de Llobregat;2;11;B;;555;112;231;304;251;0;2;302;304
8;Barcelona;11;Baix Llobregat;08200;Sant Boi de Llobregat;2;12;A;;596;122;238;320;276;0;3;317;320
8;Barcelona;11;Baix Llobregat;08200;Sant Boi de Llobregat;2;12;B;;746;133;283;380;366;0;4;376;380
8;Barcelona;11;Baix Llobregat;08200;Sant Boi de Llobregat;2;12;C;;664;126;267;361;303;0;5;356;361
8;Barcelona;11;Baix Llobregat;08200;Sant Boi de Llobregat;2;13;A;;957;194;465;584;373;1;6;577;583
8;Barcelona;11;Baix Llobregat;08200;Sant Boi de Llobregat;2;13;B;;1141;220;536;693;448;0;4;689;693
8;Barcelona;11;Baix Llobregat;08200;Sant Boi de Llobregat;2;14;A;;702;130;296;376;326;0;9;367;376
8;Barcelona;11;Baix Llobregat;08200;Sant Boi de Llobregat;2;14;B;;773;131;307;393;380;0;4;389;393
8;Barcelona;11;Baix Llobregat;08200;Sant Boi de Llobregat;2;15;A;;728;120;250;330;398;1;1;328;329
8;Barcelona;11;Baix Llobregat;08200;Sant Boi de Llobregat;2;15;B;;848;151;290;387;461;0;3;384;387
8;Barcelona;11;Baix Llobregat;08200;Sant Boi de Llobregat;2;16;U;;344;81;153;201;143;0;3;198;201
8;Barcelona;11;Baix Llobregat;08200;Sant Boi de Llobregat;2;2;A;;678;158;286;368;310;0;3;365;368
8;Barcelona;11;Baix Llobregat;08200;Sant Boi de Llobregat;2;2;B;;784;175;327;407;377;0;2;405;407
8;Barcelona;11;Baix Llobregat;08200;Sant Boi de Llobregat;2;3;A;;744;136;298;384;360;0;2;382;384
8;Barcelona;11;Baix Llobregat;08200;Sant Boi de Llobregat;2;3;B;;929;176;368;469;460;0;2;467;469
8;Barcelona;11;Baix Llobregat;08200;Sant Boi de Llobregat;2;4;U;;1025;175;335;488;537;0;5;483;488
8;Barcelona;11;Baix Llobregat;08200;Sant Boi de Llobregat;2;5;A;;519;111;220;299;220;0;4;295;299
8;Barcelona;11;Baix Llobregat;08200;Sant Boi de Llobregat;2;5;B;;642;127;277;371;271;1;2;368;370
8;Barcelona;11;Baix Llobregat;08200;Sant Boi de Llobregat;2;6;A;;561;123;241;309;252;0;3;306;309
8;Barcelona;11;Baix Llobregat;08200;Sant Boi de Llobregat;2;6;B;;620;129;258;335;285;0;1;334;335
8;Barcelona;11;Baix Llobregat;08200;Sant Boi de Llobregat;2;6;C;;760;138;330;438;322;0;5;433;438
8;Barcelona;11;Baix Llobregat;08200;Sant Boi de Llobregat;2;7;U;;1045;222;454;575;470;0;2;573;575
8;Barcelona;11;Baix Llobregat;08200;Sant Boi de Llobregat;2;8;A;;517;130;260;312;205;2;2;308;310
8;Barcelona;11;Baix Llobregat;08200;Sant Boi de Llobregat;2;8;B;;661;155;321;399;262;0;8;391;399
8;Barcelona;11;Baix Llobregat;08200;Sant Boi de Llobregat;2;9;A;;747;160;299;405;342;0;3;402;405
8;Barcelona;11;Baix Llobregat;08200;Sant Boi de Llobregat;2;9;B;;765;165;320;409;356;0;5;404;409
8;Barcelona;11;Baix Llobregat;08200;Sant Boi de Llobregat;3;1;A;;583;163;336;383;200;0;2;381;383
8;Barcelona;11;Baix Llobregat;08200;Sant Boi de Llobregat;3;1;B;;553;158;294;346;207;1;3;342;345
8;Barcelona;11;Baix Llobregat;08200;Sant Boi de Llobregat;3;2;A;;695;158;314;391;304;0;4;387;391
8;Barcelona;11;Baix Llobregat;08200;Sant Boi de Llobregat;3;2;B;;824;187;394;485;339;0;6;479;485
8;Barcelona;11;Baix Llobregat;08200;Sant Boi de Llobregat;3;3;A;;806;166;375;482;324;2;3;477;480
8;Barcelona;11;Baix Llobregat;08200;Sant Boi de Llobregat;3;3;B;;950;192;422;544;406;0;2;542;544
8;Barcelona;11;Baix Llobregat;08200;Sant Boi de Llobregat;3;4;U;;656;189;332;406;250;1;7;398;405
8;Barcelona;11;Baix Llobregat;08200;Sant Boi de Llobregat;3;5;A;;755;162;340;434;321;5;3;426;429
8;Barcelona;11;Baix Llobregat;08200;Sant Boi de Llobregat;3;5;B;;996;233;465;568;428;1;4;563;567
8;Barcelona;11;Baix Llobregat;08200;Sant Boi de Llobregat;3;6;U;;1026;269;535;643;383;1;6;636;642
8;Barcelona;11;Baix Llobregat;08200;Sant Boi de Llobregat;3;7;A;;798;198;370;497;301;3;4;490;494
8;Barcelona;11;Baix Llobregat;08200;Sant Boi de Llobregat;3;7;B;;926;205;435;557;369;0;8;549;557
8;Barcelona;11;Baix Llobregat;08200;Sant Boi de Llobregat;3;8;U;;654;157;338;401;253;1;1;399;400
8;Barcelona;11;Baix Llobregat;08200;Sant Boi de Llobregat;3;9;A;;507;133;260;316;191;1;2;313;315
8;Barcelona;11;Baix Llobregat;08200;Sant Boi de Llobregat;3;9;B;;647;170;323;398;249;2;3;393;396
8;Barcelona;11;Baix Llobregat;08200;Sant Boi de Llobregat;4;1;A;;691;133;284;375;316;0;3;372;375
8;Barcelona;11;Baix Llobregat;08200;Sant Boi de Llobregat;4;1;B;;902;188;362;469;433;0;6;463;469
8;Barcelona;11;Baix Llobregat;08200;Sant Boi de Llobregat;4;2;A;;755;150;332;431;324;2;2;427;429
8;Barcelona;11;Baix Llobregat;08200;Sant Boi de Llobregat;4;2;B;;885;218;445;553;332;0;7;546;553
8;Barcelona;11;Baix Llobregat;08200;Sant Boi de Llobregat;4;3;A;;503;120;233;296;207;0;5;291;296
8;Barcelona;11;Baix Llobregat;08200;Sant Boi de Llobregat;4;3;B;;613;121;268;345;268;1;6;338;344
8;Barcelona;11;Baix Llobregat;08200;Sant Boi de Llobregat;4;4;A;;516;123;233;307;209;0;4;303;307
8;Barcelona;11;Baix Llobregat;08200;Sant Boi de Llobregat;4;4;B;;625;143;295;366;259;0;3;363;366
8;Barcelona;11;Baix Llobregat;08200;Sant Boi de Llobregat;4;5;A;;665;135;286;374;291;0;3;371;374
8;Barcelona;11;Baix Llobregat;08200;Sant Boi de Llobregat;4;5;B;;828;152;324;426;402;3;0;423;423
8;Barcelona;11;Baix Llobregat;08200;Sant Boi de Llobregat;4;6;A;;875;183;359;443;432;0;11;432;443
8;Barcelona;11;Baix Llobregat;08200;Sant Boi de Llobregat;4;6;B;;1014;225;443;525;489;0;7;518;525
8;Barcelona;11;Baix Llobregat;08200;Sant Boi de Llobregat;4;7;A;;668;156;310;384;284;1;5;378;383
8;Barcelona;11;Baix Llobregat;08200;Sant Boi de Llobregat;4;7;B;;728;153;306;400;328;4;5;391;396
8;Barcelona;11;Baix Llobregat;08200;Sant Boi de Llobregat;4;8;A;;774;134;296;399;375;2;1;396;397
8;Barcelona;11;Baix Llobregat;08200;Sant Boi de Llobregat;4;8;B;;819;155;351;459;360;1;0;458;458
8;Barcelona;11;Baix Llobregat;08200;Sant Boi de Llobregat;4;9;U;;952;162;390;542;410;0;1;541;542
8;Barcelona;11;Baix Llobregat;08200;Sant Boi de Llobregat;5;1;A;;712;153;304;369;343;1;2;366;368
8;Barcelona;11;Baix Llobregat;08200;Sant Boi de Llobregat;5;1;B;;928;220;383;442;486;0;0;442;442
8;Barcelona;11;Baix Llobregat;08200;Sant Boi de Llobregat;5;2;A;;574;121;222;282;292;1;3;278;281
8;Barcelona;11;Baix Llobregat;08200;Sant Boi de Llobregat;5;2;B;;645;162;283;340;305;0;3;337;340
8;Barcelona;11;Baix Llobregat;08200;Sant Boi de Llobregat;5;3;U;;725;127;221;282;443;1;2;279;281
8;Barcelona;11;Baix Llobregat;08200;Sant Boi de Llobregat;5;4;A;;444;90;180;236;208;0;1;235;236
8;Barcelona;11;Baix Llobregat;08200;Sant Boi de Llobregat;5;4;B;;534;132;305;315;219;0;2;313;315
8;Barcelona;11;Baix Llobregat;08200;Sant Boi de Llobregat;6;1;U;;819;170;362;451;368;0;0;451;451
8;Barcelona;11;Baix Llobregat;08200;Sant Boi de Llobregat;6;2;A;;685;134;308;377;308;1;6;370;376
8;Barcelona;11;Baix Llobregat;08200;Sant Boi de Llobregat;6;2;B;;938;163;380;495;443;0;8;487;495
8;Barcelona;11;Baix Llobregat;08200;Sant Boi de Llobregat;6;3;A;;573;146;256;313;260;2;1;310;311
8;Barcelona;11;Baix Llobregat;08200;Sant Boi de Llobregat;6;3;B;;605;136;265;340;265;0;4;336;340
8;Barcelona;24;Osona;08201;Sant Boi de Lluçanès;1;1;U;;437;133;280;337;100;3;6;328;334
43;Tarragona;22;Montsià;43136;Sant Carles de la Ràpita;1;1;U;;1269;331;600;766;503;1;3;762;765
43;Tarragona;22;Montsià;43136;Sant Carles de la Ràpita;1;2;U;;880;205;401;504;376;1;5;498;503
43;Tarragona;22;Montsià;43136;Sant Carles de la Ràpita;1;3;U;;1076;260;494;637;439;9;3;625;628
43;Tarragona;22;Montsià;43136;Sant Carles de la Ràpita;1;4;U;;1180;308;531;689;491;4;7;678;685
43;Tarragona;22;Montsià;43136;Sant Carles de la Ràpita;1;5;U;;816;188;356;467;349;2;2;463;465
43;Tarragona;22;Montsià;43136;Sant Carles de la Ràpita;2;1;U;;776;201;402;498;278;2;6;490;496
43;Tarragona;22;Montsià;43136;Sant Carles de la Ràpita;2;2;U;;802;249;422;512;290;3;4;505;509
43;Tarragona;22;Montsià;43136;Sant Carles de la Ràpita;2;3;U;;943;265;471;589;354;0;9;580;589
43;Tarragona;22;Montsià;43136;Sant Carles de la Ràpita;2;4;U;;974;245;465;607;367;4;11;592;603
8;Barcelona;21;Maresme;08203;Sant Cebrià de Vallalta;1;1;U;;957;312;547;704;253;4;7;693;700
8;Barcelona;41;Vallès Oriental;08202;Sant Celoni;1;1;A;;784;220;464;571;213;7;0;564;564
8;Barcelona;41;Vallès Oriental;08202;Sant Celoni;1;1;B;;561;164;560;413;148;0;1;412;413
8;Barcelona;41;Vallès Oriental;08202;Sant Celoni;1;1;C;;398;103;236;286;112;0;1;285;286
8;Barcelona;41;Vallès Oriental;08202;Sant Celoni;1;2;A;;569;162;338;419;150;2;1;416;417
8;Barcelona;41;Vallès Oriental;08202;Sant Celoni;1;2;B;;725;221;443;544;181;0;6;538;544
8;Barcelona;41;Vallès Oriental;08202;Sant Celoni;1;3;A;;603;168;339;433;170;1;3;429;432
8;Barcelona;41;Vallès Oriental;08202;Sant Celoni;1;3;B;;880;238;475;606;274;2;3;601;604
8;Barcelona;41;Vallès Oriental;08202;Sant Celoni;1;4;A;;656;191;378;450;206;0;3;447;450
8;Barcelona;41;Vallès Oriental;08202;Sant Celoni;1;4;B;;781;197;398;470;311;2;1;467;468
8;Barcelona;41;Vallès Oriental;08202;Sant Celoni;1;5;A;;584;150;330;411;173;0;5;406;411
8;Barcelona;41;Vallès Oriental;08202;Sant Celoni;1;5;B;;822;194;429;539;283;3;5;531;536
8;Barcelona;41;Vallès Oriental;08202;Sant Celoni;1;6;A;;598;156;328;428;170;0;1;427;428
8;Barcelona;41;Vallès Oriental;08202;Sant Celoni;1;6;B;;834;228;440;544;290;1;2;541;543
8;Barcelona;41;Vallès Oriental;08202;Sant Celoni;1;7;A;;335;78;178;224;111;0;0;224;224
8;Barcelona;41;Vallès Oriental;08202;Sant Celoni;1;7;B;;404;107;214;269;135;1;3;265;268
8;Barcelona;41;Vallès Oriental;08202;Sant Celoni;2;1;A;;387;120;248;281;106;0;0;281;281
8;Barcelona;41;Vallès Oriental;08202;Sant Celoni;2;1;B;;346;87;175;218;128;0;1;217;218
8;Barcelona;11;Baix Llobregat;08204;Sant Climent de Llobregat;1;1;A;;743;174;392;488;255;1;3;484;487
8;Barcelona;11;Baix Llobregat;08204;Sant Climent de Llobregat;1;1;B;;604;141;347;418;186;0;4;414;418
8;Barcelona;11;Baix Llobregat;08204;Sant Climent de Llobregat;1;1;C;;655;145;396;437;218;0;8;429;437
17;Girona;2;Alt Empordà;17158;Sant Climent Sescebes;1;1;U;;454;147;261;300;154;2;2;296;298
8;Barcelona;40;Vallès Occidental;08205;Sant Cugat del Vallès;1;1;A;;778;222;402;489;289;0;4;485;489
8;Barcelona;40;Vallès Occidental;08205;Sant Cugat del Vallès;1;1;B;;775;217;416;527;248;3;6;518;524
8;Barcelona;40;Vallès Occidental;08205;Sant Cugat del Vallès;1;10;U;;980;174;417;578;402;0;2;576;578
8;Barcelona;40;Vallès Occidental;08205;Sant Cugat del Vallès;1;11;U;;1186;305;615;776;410;0;10;766;776
8;Barcelona;40;Vallès Occidental;08205;Sant Cugat del Vallès;1;12;U;;1192;327;667;865;327;3;11;851;862
8;Barcelona;40;Vallès Occidental;08205;Sant Cugat del Vallès;1;2;A;;516;137;295;352;164;1;2;349;351
8;Barcelona;40;Vallès Occidental;08205;Sant Cugat del Vallès;1;2;B;;501;130;273;327;174;1;1;325;326
8;Barcelona;40;Vallès Occidental;08205;Sant Cugat del Vallès;1;3;A;;771;194;405;510;261;1;8;501;509
8;Barcelona;40;Vallès Occidental;08205;Sant Cugat del Vallès;1;3;B;;816;191;451;577;239;2;7;568;575
8;Barcelona;40;Vallès Occidental;08205;Sant Cugat del Vallès;1;4;A;;657;186;401;507;150;0;8;499;507
8;Barcelona;40;Vallès Occidental;08205;Sant Cugat del Vallès;1;4;B;;709;217;424;522;187;2;7;513;520
8;Barcelona;40;Vallès Occidental;08205;Sant Cugat del Vallès;1;5;U;;909;220;460;573;336;2;7;564;571
8;Barcelona;40;Vallès Occidental;08205;Sant Cugat del Vallès;1;6;A;;556;153;288;354;202;3;8;343;351
8;Barcelona;40;Vallès Occidental;08205;Sant Cugat del Vallès;1;6;B;;693;163;392;482;211;0;6;476;482
8;Barcelona;40;Vallès Occidental;08205;Sant Cugat del Vallès;1;6;C;;675;181;374;470;205;1;4;465;469
8;Barcelona;40;Vallès Occidental;08205;Sant Cugat del Vallès;1;7;A;;681;156;346;429;252;3;6;420;426
8;Barcelona;40;Vallès Occidental;08205;Sant Cugat del Vallès;1;7;B;;843;209;424;519;324;1;4;514;518
8;Barcelona;40;Vallès Occidental;08205;Sant Cugat del Vallès;1;8;A;;611;152;289;380;231;3;1;376;377
8;Barcelona;40;Vallès Occidental;08205;Sant Cugat del Vallès;1;8;B;;748;212;391;503;245;4;5;494;499
8;Barcelona;40;Vallès Occidental;08205;Sant Cugat del Vallès;1;9;A;;539;157;324;409;130;0;9;400;409
8;Barcelona;40;Vallès Occidental;08205;Sant Cugat del Vallès;1;9;B;;596;154;370;466;130;0;20;446;466
8;Barcelona;40;Vallès Occidental;08205;Sant Cugat del Vallès;2;1;A;;649;181;408;499;150;1;16;482;498
8;Barcelona;40;Vallès Occidental;08205;Sant Cugat del Vallès;2;1;B;;738;164;425;553;185;0;12;541;553
8;Barcelona;40;Vallès Occidental;08205;Sant Cugat del Vallès;2;2;A;;646;156;357;467;179;0;3;464;467
8;Barcelona;40;Vallès Occidental;08205;Sant Cugat del Vallès;2;2;B;;654;172;370;477;177;0;5;472;477
8;Barcelona;40;Vallès Occidental;08205;Sant Cugat del Vallès;2;3;A;;438;125;250;314;124;0;3;311;314
8;Barcelona;40;Vallès Occidental;08205;Sant Cugat del Vallès;2;3;B;;548;176;322;394;154;1;9;384;393
8;Barcelona;40;Vallès Occidental;08205;Sant Cugat del Vallès;2;4;A;;550;176;344;398;152;0;8;390;398
8;Barcelona;40;Vallès Occidental;08205;Sant Cugat del Vallès;2;4;B;;636;185;386;470;166;0;12;458;470
8;Barcelona;40;Vallès Occidental;08205;Sant Cugat del Vallès;2;5;A;;571;153;307;389;182;6;3;380;383
8;Barcelona;40;Vallès Occidental;08205;Sant Cugat del Vallès;2;5;B;;557;145;291;361;196;0;0;361;361
8;Barcelona;40;Vallès Occidental;08205;Sant Cugat del Vallès;2;6;A;;514;141;316;387;127;0;9;378;387
8;Barcelona;40;Vallès Occidental;08205;Sant Cugat del Vallès;2;6;B;;541;167;342;416;125;0;11;405;416
8;Barcelona;40;Vallès Occidental;08205;Sant Cugat del Vallès;2;6;C;;359;94;200;263;96;0;3;260;263
8;Barcelona;40;Vallès Occidental;08205;Sant Cugat del Vallès;2;7;A;;560;157;306;391;169;1;5;385;390
8;Barcelona;40;Vallès Occidental;08205;Sant Cugat del Vallès;2;7;B;;643;184;366;450;193;0;5;445;450
8;Barcelona;40;Vallès Occidental;08205;Sant Cugat del Vallès;2;8;A;;657;195;424;530;127;1;8;521;529
8;Barcelona;40;Vallès Occidental;08205;Sant Cugat del Vallès;2;8;B;;730;206;451;570;160;0;15;555;570
8;Barcelona;40;Vallès Occidental;08205;Sant Cugat del Vallès;3;1;U;;762;191;432;517;245;0;6;511;517
8;Barcelona;40;Vallès Occidental;08205;Sant Cugat del Vallès;3;2;A;;579;153;307;402;177;0;8;394;402
8;Barcelona;40;Vallès Occidental;08205;Sant Cugat del Vallès;3;2;B;;623;176;335;415;208;4;12;399;411
8;Barcelona;40;Vallès Occidental;08205;Sant Cugat del Vallès;3;3;U;;776;195;453;543;233;2;4;537;541
8;Barcelona;40;Vallès Occidental;08205;Sant Cugat del Vallès;3;4;U;;977;232;504;621;356;1;13;607;620
8;Barcelona;40;Vallès Occidental;08205;Sant Cugat del Vallès;4;1;U;;785;228;441;525;260;0;4;521;525
8;Barcelona;40;Vallès Occidental;08205;Sant Cugat del Vallès;4;2;U;;742;176;346;408;334;4;3;401;404
8;Barcelona;40;Vallès Occidental;08205;Sant Cugat del Vallès;4;3;U;;783;210;361;442;341;0;4;438;442
8;Barcelona;40;Vallès Occidental;08205;Sant Cugat del Vallès;5;1;A;;656;189;384;451;205;0;9;442;451
8;Barcelona;40;Vallès Occidental;08205;Sant Cugat del Vallès;5;1;B;;725;203;457;544;181;1;8;535;543
8;Barcelona;40;Vallès Occidental;08205;Sant Cugat del Vallès;5;2;A;;667;667;331;416;251;0;1;415;416
8;Barcelona;40;Vallès Occidental;08205;Sant Cugat del Vallès;5;2;B;;757;186;421;486;271;0;14;472;486
8;Barcelona;40;Vallès Occidental;08205;Sant Cugat del Vallès;6;1;U;;805;159;325;396;409;5;2;389;391
8;Barcelona;3;Alt Penedès;08206;Sant Cugat Sesgarrigues;1;1;U;;599;168;364;445;154;3;3;439;442
25;Lleida;25;Pallars Jussà;25196;Sant Esteve de la Sarga;1;1;U;;104;29;60;74;30;0;0;74;74
8;Barcelona;41;Vallès Oriental;08207;Sant Esteve de Palautordera;1;1;U;;1010;346;625;762;248;0;6;756;762
8;Barcelona;11;Baix Llobregat;08208;Sant Esteve Sesrovires;1;1;A;;697;177;382;457;240;4;4;449;453
8;Barcelona;11;Baix Llobregat;08208;Sant Esteve Sesrovires;1;1;B;;732;200;408;496;236;1;7;488;495
8;Barcelona;11;Baix Llobregat;08208;Sant Esteve Sesrovires;1;2;A;;588;171;316;383;205;1;8;374;382
8;Barcelona;11;Baix Llobregat;08208;Sant Esteve Sesrovires;1;2;B;;691;166;359;443;248;0;7;436;443
17;Girona;34;Selva;17159;Sant Feliu de Buixalleu;1;1;U;;556;156;314;384;172;1;6;377;383
8;Barcelona;41;Vallès Oriental;08210;Sant Feliu de Codines;1;1;U;;639;167;343;438;201;7;3;428;431
8;Barcelona;41;Vallès Oriental;08210;Sant Feliu de Codines;1;2;U;;914;228;505;617;297;3;7;607;614
8;Barcelona;41;Vallès Oriental;08210;Sant Feliu de Codines;2;1;U;;958;239;497;649;309;7;6;636;642
8;Barcelona;41;Vallès Oriental;08210;Sant Feliu de Codines;2;2;U;;765;204;398;518;247;14;6;498;504
17;Girona;10;Baix Empordà;17160;Sant Feliu de Guíxols;1;1;A;;571;176;325;381;190;1;0;380;380
17;Girona;10;Baix Empordà;17160;Sant Feliu de Guíxols;1;1;B;;586;159;337;390;196;0;2;388;390
17;Girona;10;Baix Empordà;17160;Sant Feliu de Guíxols;1;2;A;;519;174;306;363;156;4;2;357;359
17;Girona;10;Baix Empordà;17160;Sant Feliu de Guíxols;1;2;B;;562;184;322;395;167;4;6;385;391
17;Girona;10;Baix Empordà;17160;Sant Feliu de Guíxols;2;1;A;;557;178;321;383;174;2;4;377;381
17;Girona;10;Baix Empordà;17160;Sant Feliu de Guíxols;2;1;B;;559;181;329;382;177;1;3;378;381
17;Girona;10;Baix Empordà;17160;Sant Feliu de Guíxols;2;2;A;;829;296;505;565;264;1;7;557;564
17;Girona;10;Baix Empordà;17160;Sant Feliu de Guíxols;2;2;B;;912;310;545;625;287;0;5;620;625
17;Girona;10;Baix Empordà;17160;Sant Feliu de Guíxols;2;3;A;;741;193;408;460;281;0;5;455;460
17;Girona;10;Baix Empordà;17160;Sant Feliu de Guíxols;2;3;B;;752;177;388;453;299;0;9;444;453
17;Girona;10;Baix Empordà;17160;Sant Feliu de Guíxols;2;4;A;;852;206;431;503;349;1;2;500;502
17;Girona;10;Baix Empordà;17160;Sant Feliu de Guíxols;2;4;B;;988;238;472;564;424;1;6;557;563
17;Girona;10;Baix Empordà;17160;Sant Feliu de Guíxols;3;1;A;;899;315;532;618;281;1;3;614;617
17;Girona;10;Baix Empordà;17160;Sant Feliu de Guíxols;3;1;B;;882;293;512;591;291;1;4;586;590
17;Girona;10;Baix Empordà;17160;Sant Feliu de Guíxols;3;2;A;;428;110;240;273;155;0;2;271;273
17;Girona;10;Baix Empordà;17160;Sant Feliu de Guíxols;3;2;B;;470;117;248;289;181;0;0;289;289
17;Girona;10;Baix Empordà;17160;Sant Feliu de Guíxols;3;3;A;;521;159;301;345;176;1;4;340;344
17;Girona;10;Baix Empordà;17160;Sant Feliu de Guíxols;3;3;B;;538;154;296;360;178;1;1;358;359
17;Girona;10;Baix Empordà;17160;Sant Feliu de Guíxols;4;1;A;;785;238;450;542;243;2;4;536;540
17;Girona;10;Baix Empordà;17160;Sant Feliu de Guíxols;4;1;B;;676;202;297;445;231;3;0;442;442
8;Barcelona;11;Baix Llobregat;08211;Sant Feliu de Llobregat;1;1;A;;700;170;394;515;185;2;8;505;513
8;Barcelona;11;Baix Llobregat;08211;Sant Feliu de Llobregat;1;1;B;;713;168;382;507;206;1;3;503;506
8;Barcelona;11;Baix Llobregat;08211;Sant Feliu de Llobregat;1;2;A;;512;113;275;358;154;0;2;356;358
8;Barcelona;11;Baix Llobregat;08211;Sant Feliu de Llobregat;1;2;B;;626;144;356;454;172;0;9;445;454
8;Barcelona;11;Baix Llobregat;08211;Sant Feliu de Llobregat;1;3;A;;466;120;265;327;139;1;5;321;326
8;Barcelona;11;Baix Llobregat;08211;Sant Feliu de Llobregat;1;3;B;;572;144;317;397;175;4;7;386;393
8;Barcelona;11;Baix Llobregat;08211;Sant Feliu de Llobregat;1;4;U;;1051;215;478;639;412;1;12;626;638
8;Barcelona;11;Baix Llobregat;08211;Sant Feliu de Llobregat;2;1;A;;467;135;274;324;143;1;1;322;323
8;Barcelona;11;Baix Llobregat;08211;Sant Feliu de Llobregat;2;1;B;;582;148;321;398;184;0;4;394;398
8;Barcelona;11;Baix Llobregat;08211;Sant Feliu de Llobregat;2;2;U;;594;155;315;369;225;0;9;360;369
8;Barcelona;11;Baix Llobregat;08211;Sant Feliu de Llobregat;2;3;A;;609;122;279;344;265;0;0;344;344
8;Barcelona;11;Baix Llobregat;08211;Sant Feliu de Llobregat;2;3;B;;609;106;287;349;260;1;1;347;348
8;Barcelona;11;Baix Llobregat;08211;Sant Feliu de Llobregat;2;4;U;;702;163;382;462;240;0;4;458;462
8;Barcelona;11;Baix Llobregat;08211;Sant Feliu de Llobregat;2;5;U;;835;275;503;583;252;1;6;576;582
8;Barcelona;11;Baix Llobregat;08211;Sant Feliu de Llobregat;2;6;A;;765;170;348;449;316;2;6;441;447
8;Barcelona;11;Baix Llobregat;08211;Sant Feliu de Llobregat;2;6;B;;895;190;458;572;323;0;8;564;572
8;Barcelona;11;Baix Llobregat;08211;Sant Feliu de Llobregat;2;7;A;;659;162;359;432;227;0;6;426;432
8;Barcelona;11;Baix Llobregat;08211;Sant Feliu de Llobregat;2;7;B;;672;158;332;422;250;2;1;419;420
8;Barcelona;11;Baix Llobregat;08211;Sant Feliu de Llobregat;3;1;A;;527;126;259;328;199;5;7;316;323
8;Barcelona;11;Baix Llobregat;08211;Sant Feliu de Llobregat;3;1;B;;620;126;284;391;229;2;6;383;389
8;Barcelona;11;Baix Llobregat;08211;Sant Feliu de Llobregat;3;1;C;;582;118;280;381;201;1;10;370;380
8;Barcelona;11;Baix Llobregat;08211;Sant Feliu de Llobregat;3;2;A;;304;68;151;196;108;2;5;189;194
8;Barcelona;11;Baix Llobregat;08211;Sant Feliu de Llobregat;3;2;B;;348;77;175;213;135;0;2;211;213
8;Barcelona;11;Baix Llobregat;08211;Sant Feliu de Llobregat;3;2;C;;391;88;196;237;154;0;7;230;237
8;Barcelona;11;Baix Llobregat;08211;Sant Feliu de Llobregat;3;3;A;;595;137;307;389;206;0;2;387;389
8;Barcelona;11;Baix Llobregat;08211;Sant Feliu de Llobregat;3;3;B;;665;173;352;453;212;5;4;444;448
8;Barcelona;11;Baix Llobregat;08211;Sant Feliu de Llobregat;3;4;A;;668;155;357;444;224;0;3;441;444
8;Barcelona;11;Baix Llobregat;08211;Sant Feliu de Llobregat;3;4;B;;800;180;431;559;241;0;9;550;559
8;Barcelona;11;Baix Llobregat;08211;Sant Feliu de Llobregat;3;5;A;;652;157;351;442;210;0;5;437;442
8;Barcelona;11;Baix Llobregat;08211;Sant Feliu de Llobregat;3;5;B;;758;187;392;501;257;1;6;494;500
8;Barcelona;11;Baix Llobregat;08211;Sant Feliu de Llobregat;4;1;U;;957;215;455;558;399;4;2;552;554
8;Barcelona;11;Baix Llobregat;08211;Sant Feliu de Llobregat;4;2;A;;462;101;225;280;182;0;2;278;280
8;Barcelona;11;Baix Llobregat;08211;Sant Feliu de Llobregat;4;2;B;;661;152;302;387;274;1;0;386;386
8;Barcelona;11;Baix Llobregat;08211;Sant Feliu de Llobregat;4;3;U;;959;176;395;502;457;1;3;498;501
8;Barcelona;11;Baix Llobregat;08211;Sant Feliu de Llobregat;4;4;A;;659;133;296;381;278;1;4;376;380
8;Barcelona;11;Baix Llobregat;08211;Sant Feliu de Llobregat;4;4;B;;744;140;315;408;336;0;4;404;408
8;Barcelona;11;Baix Llobregat;08211;Sant Feliu de Llobregat;4;5;U;;618;147;278;328;290;0;2;326;328
8;Barcelona;11;Baix Llobregat;08211;Sant Feliu de Llobregat;5;1;A;;521;109;182;245;276;0;5;240;245
8;Barcelona;11;Baix Llobregat;08211;Sant Feliu de Llobregat;5;1;B;;630;113;229;302;328;4;5;293;298
8;Barcelona;11;Baix Llobregat;08211;Sant Feliu de Llobregat;5;2;U;;855;136;297;391;464;0;1;390;391
8;Barcelona;11;Baix Llobregat;08211;Sant Feliu de Llobregat;6;1;A;;510;100;207;274;236;0;3;271;274
8;Barcelona;11;Baix Llobregat;08211;Sant Feliu de Llobregat;6;1;B;;739;130;293;375;364;0;1;374;375
8;Barcelona;11;Baix Llobregat;08211;Sant Feliu de Llobregat;6;1;C;;702;138;288;372;330;2;2;368;370
8;Barcelona;11;Baix Llobregat;08211;Sant Feliu de Llobregat;6;2;U;;874;198;406;516;358;1;7;508;515
8;Barcelona;11;Baix Llobregat;08211;Sant Feliu de Llobregat;6;3;U;;816;172;370;483;333;5;2;476;478
17;Girona;19;Garrotxa;17161;Sant Feliu de Pallerols;1;1;A;;452;174;317;361;91;1;2;358;360
17;Girona;19;Garrotxa;17161;Sant Feliu de Pallerols;1;1;B;;469;187;338;385;84;0;6;379;385
8;Barcelona;7;Bages;08212;Sant Feliu Sasserra;1;1;U;;509;127;347;419;90;0;7;412;419
17;Girona;19;Garrotxa;17162;Sant Ferriol;1;1;U;;162;52;70;85;77;1;0;84;84
8;Barcelona;41;Vallès Oriental;08209;Sant Fost de Campsentelles;1;1;A;;549;137;282;336;213;1;3;332;335
8;Barcelona;41;Vallès Oriental;08209;Sant Fost de Campsentelles;1;1;B;;654;176;325;390;264;0;2;388;390
8;Barcelona;41;Vallès Oriental;08209;Sant Fost de Campsentelles;1;2;A;;483;118;253;314;169;4;5;305;310
8;Barcelona;41;Vallès Oriental;08209;Sant Fost de Campsentelles;1;2;B;;677;165;345;430;247;1;5;424;429
8;Barcelona;41;Vallès Oriental;08209;Sant Fost de Campsentelles;1;3;A;;690;149;347;440;250;0;8;432;440
8;Barcelona;41;Vallès Oriental;08209;Sant Fost de Campsentelles;1;3;B;;695;144;326;425;270;2;6;417;423
8;Barcelona;41;Vallès Oriental;08209;Sant Fost de Campsentelles;1;3;C;;703;158;364;441;262;1;8;432;440
8;Barcelona;7;Bages;08213;Sant Fruitós de Bages;1;1;A;;739;180;398;484;255;3;1;480;481
8;Barcelona;7;Bages;08213;Sant Fruitós de Bages;1;1;B;;711;171;363;444;267;0;3;441;444
8;Barcelona;7;Bages;08213;Sant Fruitós de Bages;1;1;C;;846;198;467;577;269;0;7;570;577
8;Barcelona;7;Bages;08213;Sant Fruitós de Bages;1;2;A;;598;148;301;379;219;2;6;371;377
8;Barcelona;7;Bages;08213;Sant Fruitós de Bages;1;2;B;;575;120;258;337;238;0;5;332;337
8;Barcelona;7;Bages;08213;Sant Fruitós de Bages;1;2;C;;646;125;331;419;227;3;2;414;416
17;Girona;20;Gironès;17163;Sant Gregori;1;1;A;;636;187;383;456;180;1;4;451;455
17;Girona;20;Gironès;17163;Sant Gregori;1;1;B;;724;231;463;552;172;1;4;547;551
17;Girona;20;Gironès;17163;Sant Gregori;1;1;C;;288;98;192;219;69;1;6;212;218
25;Lleida;32;Segarra;25192;Sant Guim de Freixenet;1;1;U;;882;256;532;669;213;3;6;660;666
25;Lleida;32;Segarra;25197;Sant Guim de la Plana;1;1;U;;172;45;108;129;43;1;2;126;128
17;Girona;34;Selva;17164;Sant Hilari Sacalm;1;1;A;;587;175;342;415;172;2;3;410;413
17;Girona;34;Selva;17164;Sant Hilari Sacalm;1;1;B;;716;217;445;529;187;2;2;525;527
17;Girona;34;Selva;17164;Sant Hilari Sacalm;1;2;A;;477;116;246;325;152;1;3;321;324
17;Girona;34;Selva;17164;Sant Hilari Sacalm;1;2;B;;544;143;292;389;155;0;3;386;389
17;Girona;34;Selva;17164;Sant Hilari Sacalm;1;3;A;;742;177;371;494;248;1;1;492;493
17;Girona;34;Selva;17164;Sant Hilari Sacalm;1;3;B;;763;195;389;511;252;0;4;507;511
8;Barcelona;24;Osona;08215;Sant Hipòlit de Voltregà;1;1;U;;721;232;454;525;196;1;5;519;524
8;Barcelona;24;Osona;08215;Sant Hipòlit de Voltregà;1;2;U;;875;318;582;669;206;1;5;663;668
8;Barcelona;24;Osona;08215;Sant Hipòlit de Voltregà;1;3;U;;854;291;567;648;206;4;4;640;644
8;Barcelona;21;Maresme;08193;Sant Iscle de Vallalta;1;1;U;;515;129;284;383;132;0;3;380;383
43;Tarragona;22;Montsià;43902;Sant Jaume d'Enveja;1;1;A;;797;171;353;439;358;1;4;434;438
43;Tarragona;22;Montsià;43902;Sant Jaume d'Enveja;1;1;B;;415;138;260;314;101;0;3;311;314
43;Tarragona;22;Montsià;43902;Sant Jaume d'Enveja;1;2;A;;810;235;424;514;296;0;7;507;514
43;Tarragona;22;Montsià;43902;Sant Jaume d'Enveja;1;2;B;;752;194;392;464;288;1;1;462;463
8;Barcelona;14;Berguedà;08216;Sant Jaume de Frontanyà;1;1;U;;19;6;11;16;3;0;0;16;16
17;Girona;19;Garrotxa;17165;Sant Jaume de Llierca;1;1;U;;636;257;433;467;169;4;4;459;463
43;Tarragona;12;Baix Penedès;43137;Sant Jaume dels Domenys;1;1;U;;1108;280;584;756;352;9;3;744;747
17;Girona;31;Ripollès;17167;Sant Joan de les Abadesses;1;1;A;;340;129;218;237;103;3;4;230;234
17;Girona;31;Ripollès;17167;Sant Joan de les Abadesses;1;1;B;;372;143;256;291;81;0;4;287;291
17;Girona;31;Ripollès;17167;Sant Joan de les Abadesses;1;2;A;;657;277;450;510;147;0;2;508;510
17;Girona;31;Ripollès;17167;Sant Joan de les Abadesses;1;2;B;;392;142;238;279;113;3;3;273;276
17;Girona;31;Ripollès;17167;Sant Joan de les Abadesses;1;2;C;;554;230;375;437;117;1;6;430;436
17;Girona;31;Ripollès;17167;Sant Joan de les Abadesses;1;3;A;;450;154;274;333;117;0;5;328;333
17;Girona;31;Ripollès;17167;Sant Joan de les Abadesses;1;3;B;;449;162;297;340;109;0;1;339;340
17;Girona;20;Gironès;17168;Sant Joan de Mollet;1;1;U;;289;106;201;231;58;0;1;230;231
8;Barcelona;11;Baix Llobregat;08217;Sant Joan Despí;1;1;U;;750;162;339;457;293;0;6;451;457
8;Barcelona;11;Baix Llobregat;08217;Sant Joan Despí;1;2;A;;457;103;209;275;182;1;4;270;274
8;Barcelona;11;Baix Llobregat;08217;Sant Joan Despí;1;2;B;;574;131;256;326;248;1;1;324;325
8;Barcelona;11;Baix Llobregat;08217;Sant Joan Despí;1;3;A;;559;132;300;396;163;1;4;391;395
8;Barcelona;11;Baix Llobregat;08217;Sant Joan Despí;1;3;B;;701;166;342;453;248;0;1;452;453
8;Barcelona;11;Baix Llobregat;08217;Sant Joan Despí;1;4;A;;449;114;236;306;143;0;4;302;306
8;Barcelona;11;Baix Llobregat;08217;Sant Joan Despí;1;4;B;;455;99;208;274;181;0;2;272;274
8;Barcelona;11;Baix Llobregat;08217;Sant Joan Despí;1;5;A;;412;105;236;302;110;0;0;302;302
8;Barcelona;11;Baix Llobregat;08217;Sant Joan Despí;1;5;B;;459;92;223;291;168;1;2;288;290
8;Barcelona;11;Baix Llobregat;08217;Sant Joan Despí;1;5;C;;535;119;293;368;167;0;4;364;368
8;Barcelona;11;Baix Llobregat;08217;Sant Joan Despí;1;6;U;;1088;205;459;598;490;1;2;595;597
8;Barcelona;11;Baix Llobregat;08217;Sant Joan Despí;1;7;A;;620;135;283;387;233;0;5;382;387
8;Barcelona;11;Baix Llobregat;08217;Sant Joan Despí;1;7;B;;662;147;308;404;258;1;3;400;403
8;Barcelona;11;Baix Llobregat;08217;Sant Joan Despí;1;8;A;;604;128;283;370;234;0;3;367;370
8;Barcelona;11;Baix Llobregat;08217;Sant Joan Despí;1;8;B;;704;161;336;452;252;0;9;443;452
8;Barcelona;11;Baix Llobregat;08217;Sant Joan Despí;2;1;A;;833;190;407;536;297;0;9;527;536
8;Barcelona;11;Baix Llobregat;08217;Sant Joan Despí;2;1;B;;999;214;521;660;339;4;10;646;656
8;Barcelona;11;Baix Llobregat;08217;Sant Joan Despí;2;2;A;;568;128;263;350;218;0;2;348;350
8;Barcelona;11;Baix Llobregat;08217;Sant Joan Despí;2;2;B;;585;155;286;365;220;1;3;361;364
8;Barcelona;11;Baix Llobregat;08217;Sant Joan Despí;2;3;U;;698;172;352;421;277;1;4;416;420
8;Barcelona;11;Baix Llobregat;08217;Sant Joan Despí;2;4;A;;552;136;255;337;215;0;10;327;337
8;Barcelona;11;Baix Llobregat;08217;Sant Joan Despí;2;4;B;;715;172;321;421;294;1;2;418;420
8;Barcelona;11;Baix Llobregat;08217;Sant Joan Despí;3;1;A;;426;106;206;267;159;0;0;267;267
8;Barcelona;11;Baix Llobregat;08217;Sant Joan Despí;3;1;B;;492;127;243;308;184;1;4;303;307
8;Barcelona;11;Baix Llobregat;08217;Sant Joan Despí;3;1;C;;458;96;190;261;197;0;4;257;261
8;Barcelona;11;Baix Llobregat;08217;Sant Joan Despí;3;2;A;;715;158;318;424;291;1;6;417;423
8;Barcelona;11;Baix Llobregat;08217;Sant Joan Despí;3;2;B;;715;169;347;445;270;6;1;438;439
8;Barcelona;11;Baix Llobregat;08217;Sant Joan Despí;3;3;A;;505;123;270;330;175;0;5;325;330
8;Barcelona;11;Baix Llobregat;08217;Sant Joan Despí;3;3;B;;454;111;229;283;171;1;1;281;282
8;Barcelona;11;Baix Llobregat;08217;Sant Joan Despí;3;4;A;;790;184;390;481;309;0;3;478;481
8;Barcelona;11;Baix Llobregat;08217;Sant Joan Despí;3;4;B;;931;200;425;541;390;3;14;524;538
8;Barcelona;11;Baix Llobregat;08217;Sant Joan Despí;3;5;A;;582;133;282;382;200;0;0;382;382
8;Barcelona;11;Baix Llobregat;08217;Sant Joan Despí;3;5;B;;632;147;314;415;217;0;2;413;415
8;Barcelona;11;Baix Llobregat;08217;Sant Joan Despí;4;1;A;;580;185;340;419;161;0;6;413;419
8;Barcelona;11;Baix Llobregat;08217;Sant Joan Despí;4;1;B;;699;195;390;498;201;1;4;493;497
8;Barcelona;7;Bages;08218;Sant Joan de Vilatorrada;1;1;A;;538;141;286;340;198;1;0;339;339
8;Barcelona;7;Bages;08218;Sant Joan de Vilatorrada;1;1;B;;536;130;280;352;184;1;4;347;351
8;Barcelona;7;Bages;08218;Sant Joan de Vilatorrada;1;1;C;;666;159;367;444;222;2;2;440;442
8;Barcelona;7;Bages;08218;Sant Joan de Vilatorrada;1;2;U;;908;196;450;536;372;1;4;531;535
8;Barcelona;7;Bages;08218;Sant Joan de Vilatorrada;1;3;A;;517;122;285;359;158;1;3;355;358
8;Barcelona;7;Bages;08218;Sant Joan de Vilatorrada;1;3;B;;571;159;306;373;198;0;4;369;373
8;Barcelona;7;Bages;08218;Sant Joan de Vilatorrada;1;3;C;;177;32;97;134;43;0;2;132;134
8;Barcelona;7;Bages;08218;Sant Joan de Vilatorrada;1;5;A;;567;154;366;410;157;2;2;406;408
8;Barcelona;7;Bages;08218;Sant Joan de Vilatorrada;1;5;B;;652;177;383;459;193;1;1;457;458
8;Barcelona;7;Bages;08218;Sant Joan de Vilatorrada;1;6;A;;698;129;448;422;276;0;3;419;422
8;Barcelona;7;Bages;08218;Sant Joan de Vilatorrada;1;6;B;;878;193;327;539;339;3;6;530;536
17;Girona;19;Garrotxa;17185;Sant Joan les Fonts;1;1;A;;525;177;328;378;147;16;4;358;362
17;Girona;19;Garrotxa;17185;Sant Joan les Fonts;1;1;B;;533;188;341;392;141;11;1;380;381
17;Girona;19;Garrotxa;17185;Sant Joan les Fonts;1;2;U;;578;176;352;410;168;13;1;396;397
17;Girona;19;Garrotxa;17185;Sant Joan les Fonts;1;3;A;;508;156;317;375;133;8;2;365;367
17;Girona;19;Garrotxa;17185;Sant Joan les Fonts;1;3;B;;217;54;114;144;73;0;4;140;144
17;Girona;20;Gironès;17166;Sant Jordi Desvalls;1;1;U;;504;105;346;392;112;1;2;389;391
8;Barcelona;14;Berguedà;08903;Sant Julià de Cerdanyola;1;1;U;;199;87;145;162;37;0;0;162;162
17;Girona;34;Selva;17903;Sant Julià del Llor i Bonmatí;1;1;U;;748;263;515;569;179;4;4;561;565
17;Girona;20;Gironès;17169;Sant Julià de Ramis;1;1;A;;952;952;607;710;242;2;1;707;708
17;Girona;20;Gironès;17169;Sant Julià de Ramis;1;1;B;;584;160;357;408;176;0;1;407;408
8;Barcelona;24;Osona;08220;Sant Julià de Vilatorta;1;1;A;;763;241;510;614;149;2;0;612;612
8;Barcelona;24;Osona;08220;Sant Julià de Vilatorta;1;1;B;;828;281;569;668;160;3;6;659;665
8;Barcelona;11;Baix Llobregat;08221;Sant Just Desvern;1;1;A;;831;216;470;560;271;1;8;551;559
8;Barcelona;11;Baix Llobregat;08221;Sant Just Desvern;1;1;B;;887;240;508;608;279;1;3;604;607
8;Barcelona;11;Baix Llobregat;08221;Sant Just Desvern;1;2;A;;472;151;288;333;139;1;3;329;332
8;Barcelona;11;Baix Llobregat;08221;Sant Just Desvern;1;2;B;;501;162;287;330;171;0;2;328;330
8;Barcelona;11;Baix Llobregat;08221;Sant Just Desvern;1;3;A;;872;233;475;581;291;6;10;565;575
8;Barcelona;11;Baix Llobregat;08221;Sant Just Desvern;1;3;B;;904;272;509;617;287;0;14;603;617
8;Barcelona;11;Baix Llobregat;08221;Sant Just Desvern;1;4;A;;761;202;387;481;280;0;9;472;481
8;Barcelona;11;Baix Llobregat;08221;Sant Just Desvern;1;4;B;;955;195;462;565;390;0;8;557;565
8;Barcelona;11;Baix Llobregat;08221;Sant Just Desvern;1;5;A;;929;251;524;644;285;0;7;637;644
8;Barcelona;11;Baix Llobregat;08221;Sant Just Desvern;1;5;B;;1096;239;560;725;371;0;8;717;725
8;Barcelona;11;Baix Llobregat;08221;Sant Just Desvern;1;6;A;;706;148;414;492;214;1;3;488;491
8;Barcelona;11;Baix Llobregat;08221;Sant Just Desvern;1;6;B;;660;119;329;438;222;0;11;427;438
8;Barcelona;11;Baix Llobregat;08221;Sant Just Desvern;1;6;C;;782;154;405;530;252;1;6;523;529
8;Barcelona;11;Baix Llobregat;08221;Sant Just Desvern;1;7;U;;654;149;346;433;221;1;8;424;432
8;Barcelona;3;Alt Penedès;08222;Sant Llorenç d'Hortons;1;1;U;;1003;223;568;690;313;2;6;682;688
17;Girona;2;Alt Empordà;17171;Sant Llorenç de la Muga;1;1;U;;144;42;86;104;40;1;0;103;103
25;Lleida;35;Solsonès;25193;Sant Llorenç de Morunys;1;1;U;;746;287;502;572;174;6;5;561;566
8;Barcelona;40;Vallès Occidental;08223;Sant Llorenç Savall;1;1;A;;733;195;393;504;229;2;2;500;502
8;Barcelona;40;Vallès Occidental;08223;Sant Llorenç Savall;1;1;B;;922;234;511;632;290;0;2;630;632
8;Barcelona;24;Osona;08225;Sant Martí d'Albars;1;1;U;;109;19;53;76;33;0;0;76;76
8;Barcelona;24;Osona;08224;Sant Martí de Centelles;1;1;U;;575;196;391;433;142;3;3;427;430
17;Girona;20;Gironès;17172;Sant Martí de Llémena;1;1;U;;308;88;173;197;111;0;3;194;197
25;Lleida;38;Urgell;25902;Sant Martí de Riucorb;1;1;U;;667;172;467;473;194;1;0;472;472
8;Barcelona;6;Anoia;08226;Sant Martí de Tous;1;1;U;;812;220;455;608;204;1;3;604;607
8;Barcelona;3;Alt Penedès;08227;Sant Martí Sarroca;1;1;A;;647;139;329;433;214;6;5;422;427
8;Barcelona;3;Alt Penedès;08227;Sant Martí Sarroca;1;1;B;;779;175;440;560;219;1;3;556;559
8;Barcelona;3;Alt Penedès;08227;Sant Martí Sarroca;1;2;U;;554;125;319;410;144;1;5;404;409
8;Barcelona;6;Anoia;08228;Sant Martí Sesgueioles;1;1;U;;298;54;181;239;59;1;10;228;238
17;Girona;20;Gironès;17173;Sant Martí Vell;1;1;U;;174;48;100;119;55;1;0;118;118
8;Barcelona;7;Bages;08229;Sant Mateu de Bages;1;1;A;;176;50;102;122;54;2;2;118;120
8;Barcelona;7;Bages;08229;Sant Mateu de Bages;1;1;B;;283;134;208;237;46;0;1;236;237
17;Girona;28;Pla de l'Estany;17174;Sant Miquel de Campmajor;1;1;U;;175;68;117;132;43;1;0;131;131
17;Girona;2;Alt Empordà;17175;Sant Miquel de Fluvià;1;1;U;;421;121;235;282;139;0;0;282;282
17;Girona;2;Alt Empordà;17176;Sant Mori;1;1;U;;102;36;80;87;15;1;2;84;86
17;Girona;31;Ripollès;17177;Sant Pau de Segúries;1;1;U;;542;199;388;444;98;0;1;443;444
8;Barcelona;7;Bages;08192;Santpedor;1;1;A;;534;48;326;385;149;2;1;382;383
8;Barcelona;7;Bages;08192;Santpedor;1;1;B;;598;154;344;412;186;0;1;411;412
8;Barcelona;7;Bages;08192;Santpedor;1;2;A;;613;164;362;440;173;1;1;438;439
8;Barcelona;7;Bages;08192;Santpedor;1;2;B;;739;170;395;499;240;0;3;496;499
8;Barcelona;7;Bages;08192;Santpedor;1;3;A;;694;165;404;508;186;3;4;501;505
8;Barcelona;7;Bages;08192;Santpedor;1;3;B;;727;182;445;526;201;1;1;524;525
8;Barcelona;17;Garraf;08231;Sant Pere de Ribes;1;1;A;;645;162;317;388;257;3;3;382;385
8;Barcelona;17;Garraf;08231;Sant Pere de Ribes;1;1;B;;729;193;360;450;279;0;5;445;450
8;Barcelona;17;Garraf;08231;Sant Pere de Ribes;1;10;A;;720;141;276;347;373;0;2;345;347
8;Barcelona;17;Garraf;08231;Sant Pere de Ribes;1;10;B;;629;112;232;302;327;0;1;301;302
8;Barcelona;17;Garraf;08231;Sant Pere de Ribes;1;2;A;;462;123;201;241;221;0;4;237;241
8;Barcelona;17;Garraf;08231;Sant Pere de Ribes;1;2;B;;547;150;260;296;251;2;2;292;294
8;Barcelona;17;Garraf;08231;Sant Pere de Ribes;1;3;A;;734;172;390;458;276;2;3;453;456
8;Barcelona;17;Garraf;08231;Sant Pere de Ribes;1;3;B;;831;174;393;483;348;2;7;474;481
8;Barcelona;17;Garraf;08231;Sant Pere de Ribes;1;4;A;;508;73;178;237;271;0;4;233;237
8;Barcelona;17;Garraf;08231;Sant Pere de Ribes;1;4;B;;675;115;239;321;354;2;1;318;319
8;Barcelona;17;Garraf;08231;Sant Pere de Ribes;1;5;A;;715;113;266;351;364;1;1;349;350
8;Barcelona;17;Garraf;08231;Sant Pere de Ribes;1;5;B;;939;143;318;431;508;1;4;426;430
8;Barcelona;17;Garraf;08231;Sant Pere de Ribes;1;6;A;;571;151;244;299;272;4;8;287;295
8;Barcelona;17;Garraf;08231;Sant Pere de Ribes;1;6;B;;734;191;297;370;364;2;2;366;368
8;Barcelona;17;Garraf;08231;Sant Pere de Ribes;1;7;A;;768;159;305;380;388;3;4;373;377
8;Barcelona;17;Garraf;08231;Sant Pere de Ribes;1;7;B;;1088;231;448;552;536;0;4;548;552
8;Barcelona;17;Garraf;08231;Sant Pere de Ribes;1;8;A;;808;156;361;452;356;0;4;448;452
8;Barcelona;17;Garraf;08231;Sant Pere de Ribes;1;8;B;;848;193;385;480;368;2;8;470;478
8;Barcelona;17;Garraf;08231;Sant Pere de Ribes;1;9;A;;613;119;297;346;267;1;4;341;345
8;Barcelona;17;Garraf;08231;Sant Pere de Ribes;1;9;B;;572;115;249;315;257;0;3;312;315
8;Barcelona;3;Alt Penedès;08232;Sant Pere de Riudebitlles;1;1;A;;861;211;510;634;227;1;3;630;633
8;Barcelona;3;Alt Penedès;08232;Sant Pere de Riudebitlles;1;1;B;;927;211;520;691;236;2;5;684;689
8;Barcelona;24;Osona;08233;Sant Pere de Torelló;1;1;U;;720;250;476;557;163;1;6;550;556
8;Barcelona;24;Osona;08233;Sant Pere de Torelló;1;2;U;;1058;265;572;721;337;4;2;715;717
8;Barcelona;41;Vallès Oriental;08234;Sant Pere de Vilamajor;1;1;A;;708;220;414;498;210;0;7;491;498
8;Barcelona;41;Vallès Oriental;08234;Sant Pere de Vilamajor;1;1;B;;730;205;400;453;277;0;4;449;453
17;Girona;2;Alt Empordà;17178;Sant Pere Pescador;1;1;U;;980;321;606;685;295;2;8;675;683
8;Barcelona;6;Anoia;08189;Sant Pere Sallavinera;1;1;U;;146;46;100;117;29;0;0;117;117
8;Barcelona;21;Maresme;08235;Sant Pol de Mar;1;1;U;;1090;356;674;820;270;1;9;810;819
8;Barcelona;21;Maresme;08235;Sant Pol de Mar;1;2;U;;1111;315;687;854;257;5;11;838;849
8;Barcelona;3;Alt Penedès;08236;Sant Quintí de Mediona;1;1;A;;648;148;332;432;216;1;3;428;431
8;Barcelona;3;Alt Penedès;08236;Sant Quintí de Mediona;1;1;B;;725;193;419;543;182;1;6;536;542
8;Barcelona;24;Osona;08237;Sant Quirze de Besora;1;1;A;;487;167;325;374;113;2;1;371;372
8;Barcelona;24;Osona;08237;Sant Quirze de Besora;1;1;B;;530;178;343;399;131;1;2;396;398
8;Barcelona;24;Osona;08237;Sant Quirze de Besora;1;2;U;;685;210;472;545;140;2;5;538;543
8;Barcelona;40;Vallès Occidental;08238;Sant Quirze del Vallès;1;1;A;;499;173;313;382;117;0;4;378;382
8;Barcelona;40;Vallès Occidental;08238;Sant Quirze del Vallès;1;1;B;;482;145;289;352;130;0;6;346;352
8;Barcelona;40;Vallès Occidental;08238;Sant Quirze del Vallès;1;2;A;;605;123;349;427;178;0;2;425;427
8;Barcelona;40;Vallès Occidental;08238;Sant Quirze del Vallès;1;2;B;;456;109;266;315;141;0;4;311;315
8;Barcelona;40;Vallès Occidental;08238;Sant Quirze del Vallès;1;3;A;;472;137;233;287;185;1;1;285;286
8;Barcelona;40;Vallès Occidental;08238;Sant Quirze del Vallès;1;3;B;;575;130;265;323;252;2;2;319;321
8;Barcelona;40;Vallès Occidental;08238;Sant Quirze del Vallès;1;4;A;;707;193;414;502;205;0;2;500;502
8;Barcelona;40;Vallès Occidental;08238;Sant Quirze del Vallès;1;4;B;;687;181;392;473;214;1;3;469;472
8;Barcelona;40;Vallès Occidental;08238;Sant Quirze del Vallès;1;5;A;;614;168;316;395;219;3;3;389;392
8;Barcelona;40;Vallès Occidental;08238;Sant Quirze del Vallès;1;5;B;;572;134;272;344;228;0;4;340;344
8;Barcelona;40;Vallès Occidental;08238;Sant Quirze del Vallès;1;6;A;;619;143;291;369;250;1;1;367;368
8;Barcelona;40;Vallès Occidental;08238;Sant Quirze del Vallès;1;6;B;;584;144;257;324;260;1;1;322;323
8;Barcelona;40;Vallès Occidental;08238;Sant Quirze del Vallès;1;7;A;;423;116;252;313;110;0;6;307;313
8;Barcelona;40;Vallès Occidental;08238;Sant Quirze del Vallès;1;7;B;;439;111;264;321;118;3;6;312;318
8;Barcelona;;;08239;Sant Quirze Safaja;1;1;U;;219;82;133;160;59;0;1;159;160
25;Lleida;32;Segarra;25194;Sant Ramon;1;1;U;;505;126;227;341;164;1;2;338;340
8;Barcelona;3;Alt Penedès;08240;Sant Sadurní d'Anoia;1;1;A;;624;149;357;468;156;1;4;463;467
8;Barcelona;3;Alt Penedès;08240;Sant Sadurní d'Anoia;1;1;B;;502;136;272;356;146;1;3;352;355
8;Barcelona;3;Alt Penedès;08240;Sant Sadurní d'Anoia;1;1;C;;771;159;397;571;200;1;4;566;570
8;Barcelona;3;Alt Penedès;08240;Sant Sadurní d'Anoia;1;2;A;;673;166;378;472;201;0;4;468;472
8;Barcelona;3;Alt Penedès;08240;Sant Sadurní d'Anoia;1;2;B;;795;169;416;541;254;0;10;531;541
8;Barcelona;3;Alt Penedès;08240;Sant Sadurní d'Anoia;1;3;A;;451;121;243;293;158;0;1;292;293
8;Barcelona;3;Alt Penedès;08240;Sant Sadurní d'Anoia;1;3;B;;491;135;250;326;165;1;4;321;325
8;Barcelona;3;Alt Penedès;08240;Sant Sadurní d'Anoia;1;4;A;;506;115;287;374;132;0;0;374;374
8;Barcelona;3;Alt Penedès;08240;Sant Sadurní d'Anoia;1;4;B;;490;124;278;365;125;0;0;365;365
8;Barcelona;3;Alt Penedès;08240;Sant Sadurní d'Anoia;2;1;A;;457;135;275;330;127;1;3;326;329
8;Barcelona;3;Alt Penedès;08240;Sant Sadurní d'Anoia;2;1;B;;555;151;316;422;133;1;1;420;421
8;Barcelona;3;Alt Penedès;08240;Sant Sadurní d'Anoia;2;2;A;;587;155;313;404;183;2;4;398;402
8;Barcelona;3;Alt Penedès;08240;Sant Sadurní d'Anoia;2;2;B;;624;171;348;427;197;1;4;422;426
8;Barcelona;24;Osona;08241;Sant Sadurní d'Osormort;1;1;U;;68;21;45;57;11;0;0;57;57
8;Barcelona;7;Bages;08098;Sant Salvador de Guardiola;1;1;A;;653;168;347;440;213;2;5;433;438
8;Barcelona;7;Bages;08098;Sant Salvador de Guardiola;1;1;B;;656;163;340;435;221;0;3;432;435
8;Barcelona;7;Bages;08262;Sant Vicenç de Castellet;1;1;A;;575;147;301;370;205;2;0;368;368
8;Barcelona;7;Bages;08262;Sant Vicenç de Castellet;1;1;B;;676;178;382;464;212;3;1;460;461
8;Barcelona;7;Bages;08262;Sant Vicenç de Castellet;1;1;C;;714;160;399;478;236;4;5;469;474
8;Barcelona;7;Bages;08262;Sant Vicenç de Castellet;1;2;A;;548;170;318;389;159;0;0;389;389
8;Barcelona;7;Bages;08262;Sant Vicenç de Castellet;1;2;B;;687;171;385;472;215;0;4;468;472
8;Barcelona;7;Bages;08262;Sant Vicenç de Castellet;2;1;A;;760;183;415;519;241;1;3;515;518
8;Barcelona;7;Bages;08262;Sant Vicenç de Castellet;2;1;B;;952;231;515;622;330;3;5;614;619
8;Barcelona;7;Bages;08262;Sant Vicenç de Castellet;2;2;A;;561;179;328;386;175;1;3;382;385
8;Barcelona;7;Bages;08262;Sant Vicenç de Castellet;2;2;B;;594;147;300;372;222;2;3;367;370
8;Barcelona;11;Baix Llobregat;08263;Sant Vicenç dels Horts;1;1;U;;688;150;365;467;221;0;12;455;467
8;Barcelona;11;Baix Llobregat;08263;Sant Vicenç dels Horts;1;2;A;;523;140;260;342;181;0;1;341;342
8;Barcelona;11;Baix Llobregat;08263;Sant Vicenç dels Horts;1;2;B;;682;145;294;391;291;0;0;391;391
8;Barcelona;11;Baix Llobregat;08263;Sant Vicenç dels Horts;1;3;A;;868;254;480;556;312;0;4;552;556
8;Barcelona;11;Baix Llobregat;08263;Sant Vicenç dels Horts;1;3;B;;973;241;500;623;350;2;7;614;621
8;Barcelona;11;Baix Llobregat;08263;Sant Vicenç dels Horts;1;4;A;;543;127;278;338;205;0;0;338;338
8;Barcelona;11;Baix Llobregat;08263;Sant Vicenç dels Horts;1;4;B;;564;166;301;361;203;1;3;357;360
8;Barcelona;11;Baix Llobregat;08263;Sant Vicenç dels Horts;1;5;A;;742;171;382;465;277;1;4;460;464
8;Barcelona;11;Baix Llobregat;08263;Sant Vicenç dels Horts;1;5;B;;822;191;424;504;318;0;2;502;504
8;Barcelona;11;Baix Llobregat;08263;Sant Vicenç dels Horts;1;6;A;;785;166;330;417;368;0;4;413;417
8;Barcelona;11;Baix Llobregat;08263;Sant Vicenç dels Horts;1;6;B;;870;179;342;432;438;1;8;423;431
8;Barcelona;11;Baix Llobregat;08263;Sant Vicenç dels Horts;1;7;U;;982;220;411;518;464;2;3;513;516
8;Barcelona;11;Baix Llobregat;08263;Sant Vicenç dels Horts;1;8;U;;731;163;336;407;324;1;6;400;406
8;Barcelona;11;Baix Llobregat;08263;Sant Vicenç dels Horts;1;9;U;;687;150;309;368;319;0;1;367;368
8;Barcelona;11;Baix Llobregat;08263;Sant Vicenç dels Horts;2;1;U;;980;192;396;451;529;2;5;444;449
8;Barcelona;11;Baix Llobregat;08263;Sant Vicenç dels Horts;2;2;U;;1063;190;407;476;587;3;1;472;473
8;Barcelona;11;Baix Llobregat;08263;Sant Vicenç dels Horts;2;3;U;;836;158;311;367;469;0;3;364;367
8;Barcelona;11;Baix Llobregat;08263;Sant Vicenç dels Horts;3;1;A;;560;119;232;281;279;0;4;277;281
8;Barcelona;11;Baix Llobregat;08263;Sant Vicenç dels Horts;3;1;B;;719;160;327;382;337;0;2;380;382
8;Barcelona;11;Baix Llobregat;08263;Sant Vicenç dels Horts;3;2;U;;1110;200;410;485;625;2;5;478;483
8;Barcelona;11;Baix Llobregat;08263;Sant Vicenç dels Horts;4;1;A;;801;179;361;444;357;1;4;439;443
8;Barcelona;11;Baix Llobregat;08263;Sant Vicenç dels Horts;4;1;B;;920;195;397;470;450;1;0;469;469
8;Barcelona;21;Maresme;08264;Sant Vicenç de Montalt;1;1;A;;870;227;510;624;246;1;7;616;623
8;Barcelona;21;Maresme;08264;Sant Vicenç de Montalt;1;1;B;;831;214;455;570;261;6;7;557;564
8;Barcelona;24;Osona;08265;Sant Vicenç de Torelló;1;1;U;;1062;347;604;749;313;0;9;740;749
8;Barcelona;24;Osona;08265;Sant Vicenç de Torelló;1;2;U;;387;130;244;289;98;0;0;289;289
43;Tarragona;16;Conca de Barberà;43142;Sarral;1;1;A;;461;75;252;318;143;1;5;312;317
43;Tarragona;16;Conca de Barberà;43142;Sarral;1;1;B;;689;107;362;448;241;3;9;436;445
17;Girona;20;Gironès;17186;Sarrià de Ter;1;1;A;;745;240;466;552;193;1;3;548;551
17;Girona;20;Gironès;17186;Sarrià de Ter;1;1;B;;849;287;550;632;217;2;1;629;630
17;Girona;20;Gironès;17186;Sarrià de Ter;1;2;A;;467;156;286;333;134;1;4;328;332
17;Girona;20;Gironès;17186;Sarrià de Ter;1;2;B;;543;196;348;395;148;0;2;393;395
25;Lleida;25;Pallars Jussà;25201;Sarroca de Bellera;1;1;U;;131;17;55;98;33;0;1;97;98
25;Lleida;33;Segrià;25200;Sarroca de Lleida;1;1;U;;389;117;200;272;117;0;1;271;272
17;Girona;2;Alt Empordà;17187;Saus, Camallera i Llampaies;1;1;U;;570;194;366;431;139;0;1;430;431
43;Tarragona;16;Conca de Barberà;43143;Savallà del Comtat;1;1;U;;56;21;41;45;11;0;0;45;45
43;Tarragona;36;Tarragonès;43144;Secuita, la;1;1;U;;848;240;475;599;249;0;1;598;599
43;Tarragona;8;Baix Camp;43145;Selva del Camp, la;1;1;A;;783;167;447;574;209;2;6;566;572
43;Tarragona;8;Baix Camp;43145;Selva del Camp, la;1;1;B;;850;177;462;615;235;6;5;604;609
43;Tarragona;8;Baix Camp;43145;Selva del Camp, la;2;1;A;;622;146;353;478;144;8;3;467;470
43;Tarragona;8;Baix Camp;43145;Selva del Camp, la;2;1;B;;692;148;415;560;132;6;3;551;554
17;Girona;2;Alt Empordà;17188;Selva de Mar, la;1;1;U;;156;66;107;125;31;1;1;123;124
43;Tarragona;16;Conca de Barberà;43146;Senan;1;1;U;;25;6;19;23;2;0;0;23;23
43;Tarragona;22;Montsià;43044;Sénia, la;1;1;A;;823;213;424;534;289;5;2;527;529
43;Tarragona;22;Montsià;43044;Sénia, la;1;1;B;;916;211;473;579;337;7;4;568;572
43;Tarragona;22;Montsià;43044;Sénia, la;2;1;A;;734;178;388;493;241;3;4;486;490
43;Tarragona;22;Montsià;43044;Sénia, la;2;1;B;;784;189;437;542;242;1;3;538;541
43;Tarragona;22;Montsià;43044;Sénia, la;2;2;U;;816;202;420;529;287;2;11;516;527
25;Lleida;25;Pallars Jussà;25202;Senterada;1;1;U;;103;22;63;75;28;0;0;75;75
25;Lleida;23;Noguera;25035;Sentiu de Sió, la;1;1;U;;397;75;237;285;112;1;6;278;284
8;Barcelona;40;Vallès Occidental;08267;Sentmenat;1;1;A;;684;159;330;451;233;1;1;449;450
8;Barcelona;40;Vallès Occidental;08267;Sentmenat;1;1;B;;821;165;357;497;324;4;4;489;493
8;Barcelona;40;Vallès Occidental;08267;Sentmenat;1;1;C;;591;149;305;405;186;1;3;401;404
8;Barcelona;40;Vallès Occidental;08267;Sentmenat;1;2;A;;590;120;320;401;189;1;4;396;400
8;Barcelona;40;Vallès Occidental;08267;Sentmenat;1;2;B;;778;169;421;538;240;0;3;535;538
8;Barcelona;40;Vallès Occidental;08267;Sentmenat;1;2;C;;489;139;244;321;168;0;1;320;321
17;Girona;28;Pla de l'Estany;17190;Serinyà;1;1;U;;605;226;406;460;145;2;2;456;458
25;Lleida;33;Segrià;25204;Seròs;1;1;U;;632;117;349;454;178;2;5;447;452
25;Lleida;33;Segrià;25204;Seròs;1;2;U;;886;199;481;645;241;3;10;632;642
17;Girona;10;Baix Empordà;17191;Serra de Daró;1;1;U;;157;63;114;131;26;1;0;130;130
17;Girona;31;Ripollès;17192;Setcases;1;1;U;;134;57;89;119;15;0;0;119;119
25;Lleida;4;Alt Urgell;25203;Seu d'Urgell, la;1;1;U;;913;244;455;553;360;3;6;544;550
25;Lleida;4;Alt Urgell;25203;Seu d'Urgell, la;1;2;U;;1189;307;614;748;441;2;7;739;746
25;Lleida;4;Alt Urgell;25203;Seu d'Urgell, la;1;3;U;;1012;188;401;518;494;0;6;512;518
25;Lleida;4;Alt Urgell;25203;Seu d'Urgell, la;1;4;A;;873;201;430;570;303;0;9;561;570
25;Lleida;4;Alt Urgell;25203;Seu d'Urgell, la;1;4;B;;846;187;416;523;323;1;8;514;522
25;Lleida;4;Alt Urgell;25203;Seu d'Urgell, la;1;5;U;;1213;289;625;771;442;2;16;753;769
25;Lleida;4;Alt Urgell;25203;Seu d'Urgell, la;1;6;A;;836;245;447;543;293;3;7;533;540
25;Lleida;4;Alt Urgell;25203;Seu d'Urgell, la;1;6;B;;390;114;219;254;136;2;2;250;252
25;Lleida;4;Alt Urgell;25203;Seu d'Urgell, la;1;7;U;;1141;226;544;688;453;2;14;672;686
8;Barcelona;24;Osona;08269;Seva;1;1;U;;902;321;621;745;157;3;8;734;742
8;Barcelona;24;Osona;08269;Seva;1;2;U;;661;184;418;509;152;0;1;508;509
25;Lleida;27;Pla d'Urgell;25205;Sidamon;1;1;U;;385;83;250;316;69;4;3;309;312
17;Girona;34;Selva;17193;Sils;1;1;A;;736;208;435;505;231;0;0;505;505
17;Girona;34;Selva;17193;Sils;1;1;B;;829;227;483;579;250;3;4;572;576
17;Girona;34;Selva;17193;Sils;1;2;U;;554;128;295;368;186;1;2;365;367
8;Barcelona;17;Garraf;08270;Sitges;1;1;U;;950;290;504;659;291;1;5;653;658
8;Barcelona;17;Garraf;08270;Sitges;1;2;A;;770;245;439;548;222;2;4;542;546
8;Barcelona;17;Garraf;08270;Sitges;1;2;B;;709;176;326;425;284;1;2;422;424
8;Barcelona;17;Garraf;08270;Sitges;1;2;C;;811;228;397;528;283;1;5;522;527
8;Barcelona;17;Garraf;08270;Sitges;1;3;U;;807;200;453;533;274;2;7;524;531
8;Barcelona;17;Garraf;08270;Sitges;2;1;A;;640;206;371;447;193;0;3;444;447
8;Barcelona;17;Garraf;08270;Sitges;2;1;B;;906;268;536;634;272;0;8;626;634
8;Barcelona;17;Garraf;08270;Sitges;2;2;A;;816;218;423;527;289;3;3;521;524
8;Barcelona;17;Garraf;08270;Sitges;2;2;B;;1028;288;528;657;371;0;6;651;657
8;Barcelona;17;Garraf;08270;Sitges;2;3;A;;795;232;431;535;260;0;4;531;535
8;Barcelona;17;Garraf;08270;Sitges;2;3;B;;1047;296;556;662;385;1;13;648;661
8;Barcelona;17;Garraf;08270;Sitges;2;4;A;;917;253;490;599;318;2;2;595;597
8;Barcelona;17;Garraf;08270;Sitges;2;4;B;;1199;284;562;690;509;3;3;684;687
8;Barcelona;17;Garraf;08270;Sitges;2;5;A;;972;257;525;644;328;0;2;642;644
8;Barcelona;17;Garraf;08270;Sitges;2;5;B;;482;145;238;283;199;0;3;280;283
17;Girona;2;Alt Empordà;17052;Siurana;1;1;U;;133;28;64;79;54;1;0;78;78
8;Barcelona;24;Osona;08271;Sobremunt;1;1;U;;72;15;38;45;27;0;0;45;45
25;Lleida;18;Garrigues;25206;Soleràs, el;1;1;U;;395;52;191;292;103;0;3;289;292
43;Tarragona;16;Conca de Barberà;43147;Solivella;1;1;U;;595;192;362;456;139;1;0;455;455
25;Lleida;35;Solsonès;25207;Solsona;1;1;A;;749;180;399;532;217;3;7;522;529
25;Lleida;35;Solsonès;25207;Solsona;1;1;B;;920;222;479;628;292;2;4;622;626
25;Lleida;35;Solsonès;25207;Solsona;1;2;A;;908;231;463;561;347;2;6;553;559
25;Lleida;35;Solsonès;25207;Solsona;1;2;B;;1055;238;496;617;438;3;2;612;614
25;Lleida;35;Solsonès;25207;Solsona;2;1;U;;836;243;486;614;222;2;7;605;612
25;Lleida;35;Solsonès;25207;Solsona;2;2;U;;1110;288;605;782;328;2;9;771;780
8;Barcelona;24;Osona;08272;Sora;1;1;U;;159;53;100;119;40;1;0;118;118
25;Lleida;26;Pallars Sobirà;25208;Soriguera;1;1;U;;269;37;111;155;114;2;0;153;153
25;Lleida;26;Pallars Sobirà;25209;Sort;1;1;U;;1394;308;765;1002;392;4;10;988;998
25;Lleida;33;Segrià;25210;Soses;1;1;U;;1227;302;739;886;341;1;2;883;885
8;Barcelona;3;Alt Penedès;08273;Subirats;1;1;U;;601;143;360;445;156;3;3;439;442
8;Barcelona;3;Alt Penedès;08273;Subirats;1;2;A;;410;50;236;327;83;0;4;323;327
8;Barcelona;3;Alt Penedès;08273;Subirats;1;2;B;;300;47;161;206;94;0;0;206;206
8;Barcelona;3;Alt Penedès;08273;Subirats;1;3;U;;584;99;401;463;121;3;2;458;460
25;Lleida;33;Segrià;25211;Sudanell;1;1;U;;617;116;301;374;243;1;0;373;373
25;Lleida;33;Segrià;25212;Sunyer;1;1;U;;269;69;151;187;82;0;1;186;187
8;Barcelona;7;Bages;08274;Súria;1;1;A;;731;245;499;578;153;2;2;574;576
8;Barcelona;7;Bages;08274;Súria;1;1;B;;765;232;492;596;169;3;3;590;593
8;Barcelona;7;Bages;08274;Súria;1;2;U;;606;183;382;448;158;2;4;442;446
8;Barcelona;7;Bages;08274;Súria;1;3;U;;388;102;217;250;138;0;3;247;250
8;Barcelona;7;Bages;08274;Súria;1;4;A;;798;212;465;562;236;2;6;554;560
8;Barcelona;7;Bages;08274;Súria;1;4;B;;794;211;466;549;245;1;9;539;548
8;Barcelona;7;Bages;08274;Súria;1;5;A;;580;174;386;431;149;0;1;430;431
8;Barcelona;7;Bages;08274;Súria;1;5;B;;607;177;392;447;160;2;3;442;445
17;Girona;34;Selva;17194;Susqueda;1;1;U;;73;10;37;56;17;0;0;56;56
8;Barcelona;41;Vallès Oriental;08276;Tagamanent;1;1;U;;160;48;85;110;50;1;1;108;109
8;Barcelona;7;Bages;08277;Talamanca;1;1;U;;84;15;33;52;32;0;0;52;52
25;Lleida;25;Pallars Jussà;25215;Talarn;1;1;U;;289;88;176;204;85;4;1;199;200
25;Lleida;32;Segarra;25216;Talavera;1;1;U;;265;85;177;221;44;0;0;221;221
17;Girona;10;Baix Empordà;17195;Tallada d'Empordà, la;1;1;U;;282;82;180;203;79;0;1;202;203
8;Barcelona;24;Osona;08278;Taradell;1;1;A;;906;273;565;694;212;2;2;690;692
8;Barcelona;24;Osona;08278;Taradell;1;1;B;;1006;288;638;760;246;7;5;748;753
8;Barcelona;24;Osona;08278;Taradell;1;2;A;;725;216;445;555;170;5;0;550;550
8;Barcelona;24;Osona;08278;Taradell;1;2;B;;467;104;273;339;128;2;2;335;337
8;Barcelona;24;Osona;08278;Taradell;1;2;C;;527;167;329;406;121;0;5;401;406
43;Tarragona;36;Tarragonès;43148;Tarragona;1;1;U;;580;183;300;357;223;2;3;352;355
43;Tarragona;36;Tarragonès;43148;Tarragona;1;2;A;;418;216;235;281;137;1;1;279;280
43;Tarragona;36;Tarragonès;43148;Tarragona;1;2;B;;485;146;252;295;190;4;4;287;291
43;Tarragona;36;Tarragonès;43148;Tarragona;2;1;U;;564;153;250;294;270;2;3;289;292
43;Tarragona;36;Tarragonès;43148;Tarragona;2;2;U;;672;257;381;449;223;2;3;444;447
43;Tarragona;36;Tarragonès;43148;Tarragona;3;1;U;;549;205;323;377;172;2;4;371;375
43;Tarragona;36;Tarragonès;43148;Tarragona;3;2;U;;585;197;320;371;214;3;4;364;368
43;Tarragona;36;Tarragonès;43148;Tarragona;3;3;U;;844;266;524;622;222;0;21;601;622
43;Tarragona;36;Tarragonès;43148;Tarragona;3;4;A;;585;163;323;400;185;2;8;390;398
43;Tarragona;36;Tarragonès;43148;Tarragona;3;4;B;;637;169;340;435;202;1;11;423;434
43;Tarragona;36;Tarragonès;43148;Tarragona;4;1;U;;735;198;420;515;220;1;7;507;514
43;Tarragona;36;Tarragonès;43148;Tarragona;4;10;A;;617;209;343;422;195;0;5;417;422
43;Tarragona;36;Tarragonès;43148;Tarragona;4;10;B;;742;243;381;487;255;3;1;483;484
43;Tarragona;36;Tarragonès;43148;Tarragona;4;11;U;;647;188;367;449;198;2;5;442;447
43;Tarragona;36;Tarragonès;43148;Tarragona;4;12;U;;816;208;420;556;260;3;12;541;553
43;Tarragona;36;Tarragonès;43148;Tarragona;4;13;U;;718;199;293;385;333;0;2;383;385
43;Tarragona;36;Tarragonès;43148;Tarragona;4;14;A;;546;170;312;380;166;0;5;375;380
43;Tarragona;36;Tarragonès;43148;Tarragona;4;14;B;;592;175;307;380;212;0;1;379;380
43;Tarragona;36;Tarragonès;43148;Tarragona;4;14;C;;601;167;344;422;179;0;4;418;422
43;Tarragona;36;Tarragonès;43148;Tarragona;4;15;U;;700;195;365;470;230;0;10;460;470
43;Tarragona;36;Tarragonès;43148;Tarragona;4;2;U;;859;268;461;588;271;0;7;581;588
43;Tarragona;36;Tarragonès;43148;Tarragona;4;3;U;;851;285;475;589;262;1;6;582;588
43;Tarragona;36;Tarragonès;43148;Tarragona;4;4;A;;535;196;313;387;148;1;2;384;386
43;Tarragona;36;Tarragonès;43148;Tarragona;4;4;B;;604;202;328;409;195;3;5;401;406
43;Tarragona;36;Tarragonès;43148;Tarragona;4;5;A;;538;155;297;388;150;0;6;382;388
43;Tarragona;36;Tarragonès;43148;Tarragona;4;5;B;;585;174;294;395;190;2;3;390;393
43;Tarragona;36;Tarragonès;43148;Tarragona;4;6;A;;639;193;348;441;198;0;6;435;441
43;Tarragona;36;Tarragonès;43148;Tarragona;4;6;B;;663;216;348;470;193;0;1;469;470
43;Tarragona;36;Tarragonès;43148;Tarragona;4;7;U;;820;297;507;616;204;4;6;606;612
43;Tarragona;36;Tarragonès;43148;Tarragona;4;8;A;;561;168;330;410;151;0;7;403;410
43;Tarragona;36;Tarragonès;43148;Tarragona;4;8;B;;459;117;235;302;157;0;1;301;302
43;Tarragona;36;Tarragonès;43148;Tarragona;4;8;C;;528;145;312;372;156;0;3;369;372
43;Tarragona;36;Tarragonès;43148;Tarragona;4;9;A;;541;187;310;399;142;1;8;390;398
43;Tarragona;36;Tarragonès;43148;Tarragona;4;9;B;;494;155;275;349;145;4;1;344;345
43;Tarragona;36;Tarragonès;43148;Tarragona;4;9;C;;561;165;316;410;151;0;11;399;410
43;Tarragona;36;Tarragonès;43148;Tarragona;5;1;A;;499;169;285;364;135;0;2;362;364
43;Tarragona;36;Tarragonès;43148;Tarragona;5;1;B;;560;181;322;396;164;0;14;382;396
43;Tarragona;36;Tarragonès;43148;Tarragona;5;2;A;;544;174;299;351;193;0;0;351;351
43;Tarragona;36;Tarragonès;43148;Tarragona;5;2;B;;586;184;338;407;179;3;3;401;404
43;Tarragona;36;Tarragonès;43148;Tarragona;5;3;A;;561;192;330;417;144;3;8;406;414
43;Tarragona;36;Tarragonès;43148;Tarragona;5;3;B;;697;214;381;470;227;1;7;462;469
43;Tarragona;36;Tarragonès;43148;Tarragona;5;4;A;;452;167;243;287;165;0;6;281;287
43;Tarragona;36;Tarragonès;43148;Tarragona;5;4;B;;524;157;260;336;188;0;6;330;336
43;Tarragona;36;Tarragonès;43148;Tarragona;5;5;A;;472;146;224;278;194;0;1;277;278
43;Tarragona;36;Tarragonès;43148;Tarragona;5;5;B;;575;171;283;372;203;1;4;367;371
43;Tarragona;36;Tarragonès;43148;Tarragona;5;6;U;;866;238;388;524;342;1;5;518;523
43;Tarragona;36;Tarragonès;43148;Tarragona;5;7;A;;443;141;257;309;134;1;3;305;308
43;Tarragona;36;Tarragonès;43148;Tarragona;5;7;B;;491;180;280;334;157;5;2;327;329
43;Tarragona;36;Tarragonès;43148;Tarragona;5;8;A;;703;232;391;476;227;0;6;470;476
43;Tarragona;36;Tarragonès;43148;Tarragona;5;8;B;;775;240;435;527;248;4;5;518;523
43;Tarragona;36;Tarragonès;43148;Tarragona;5;9;U;;657;194;362;475;182;3;5;467;472
43;Tarragona;36;Tarragonès;43148;Tarragona;6;1;A;;691;206;371;469;222;4;6;459;465
43;Tarragona;36;Tarragonès;43148;Tarragona;6;1;B;;807;197;407;567;240;3;7;557;564
43;Tarragona;36;Tarragonès;43148;Tarragona;6;10;A;;603;195;346;429;174;0;7;422;429
43;Tarragona;36;Tarragonès;43148;Tarragona;6;10;B;;524;160;284;364;160;0;2;362;364
43;Tarragona;36;Tarragonès;43148;Tarragona;6;10;C;;594;169;317;416;178;6;3;407;410
43;Tarragona;36;Tarragonès;43148;Tarragona;6;11;A;;509;138;277;343;166;0;4;339;343
43;Tarragona;36;Tarragonès;43148;Tarragona;6;11;B;;487;125;241;326;161;0;2;324;326
43;Tarragona;36;Tarragonès;43148;Tarragona;6;11;C;;580;175;318;413;167;1;3;409;412
43;Tarragona;36;Tarragonès;43148;Tarragona;6;12;U;;663;216;417;518;145;4;8;506;514
43;Tarragona;36;Tarragonès;43148;Tarragona;6;13;A;;464;151;259;334;130;0;2;332;334
43;Tarragona;36;Tarragonès;43148;Tarragona;6;13;B;;445;136;224;292;153;2;1;289;290
43;Tarragona;36;Tarragonès;43148;Tarragona;6;14;U;;740;211;372;489;251;2;4;483;487
43;Tarragona;36;Tarragonès;43148;Tarragona;6;15;A;;471;150;245;283;188;2;1;280;281
43;Tarragona;36;Tarragonès;43148;Tarragona;6;15;B;;563;164;254;316;247;0;3;313;316
43;Tarragona;36;Tarragonès;43148;Tarragona;6;16;A;;422;137;246;322;100;1;5;316;321
43;Tarragona;36;Tarragonès;43148;Tarragona;6;16;B;;497;497;268;339;158;1;3;335;338
43;Tarragona;36;Tarragonès;43148;Tarragona;6;2;U;;751;232;405;493;258;0;8;485;493
43;Tarragona;36;Tarragonès;43148;Tarragona;6;3;A;;575;162;287;352;223;0;0;352;352
43;Tarragona;36;Tarragonès;43148;Tarragona;6;3;B;;539;159;258;318;221;0;2;316;318
43;Tarragona;36;Tarragonès;43148;Tarragona;6;3;C;;530;142;257;315;215;2;2;311;313
43;Tarragona;36;Tarragonès;43148;Tarragona;6;4;U;;798;264;460;533;265;4;2;527;529
43;Tarragona;36;Tarragonès;43148;Tarragona;6;5;U;;515;156;268;317;198;0;3;314;317
43;Tarragona;36;Tarragonès;43148;Tarragona;6;6;U;;878;236;412;504;374;0;0;504;504
43;Tarragona;36;Tarragonès;43148;Tarragona;6;7;U;;553;175;280;335;218;1;2;332;334
43;Tarragona;36;Tarragonès;43148;Tarragona;6;8;A;;494;152;292;378;116;3;3;372;375
43;Tarragona;36;Tarragonès;43148;Tarragona;6;8;B;;557;174;332;411;146;1;7;403;410
43;Tarragona;36;Tarragonès;43148;Tarragona;6;9;A;;672;225;354;458;214;0;6;452;458
43;Tarragona;36;Tarragonès;43148;Tarragona;6;9;B;;769;227;686;525;244;0;3;522;525
43;Tarragona;36;Tarragonès;43148;Tarragona;7;1;U;;645;200;348;414;231;0;8;406;414
43;Tarragona;36;Tarragonès;43148;Tarragona;7;10;A;;690;170;317;394;296;0;5;389;394
43;Tarragona;36;Tarragonès;43148;Tarragona;7;10;B;;816;203;368;466;350;2;6;458;464
43;Tarragona;36;Tarragonès;43148;Tarragona;7;11;A;;577;160;282;365;212;4;2;359;361
43;Tarragona;36;Tarragonès;43148;Tarragona;7;11;B;;570;152;260;348;222;0;2;346;348
43;Tarragona;36;Tarragonès;43148;Tarragona;7;11;C;;576;160;290;354;222;0;2;352;354
43;Tarragona;36;Tarragonès;43148;Tarragona;7;12;A;;582;123;243;309;273;0;2;307;309
43;Tarragona;36;Tarragonès;43148;Tarragona;7;12;B;;545;150;244;310;235;1;1;308;309
43;Tarragona;36;Tarragonès;43148;Tarragona;7;13;A;;675;190;369;477;198;0;5;472;477
43;Tarragona;36;Tarragonès;43148;Tarragona;7;13;B;;625;189;351;438;187;3;6;429;435
43;Tarragona;36;Tarragonès;43148;Tarragona;7;13;C;;716;202;391;494;222;0;6;488;494
43;Tarragona;36;Tarragonès;43148;Tarragona;7;14;U;;819;240;449;589;230;0;16;573;589
43;Tarragona;36;Tarragonès;43148;Tarragona;7;15;A;;600;157;312;385;215;1;2;382;384
43;Tarragona;36;Tarragonès;43148;Tarragona;7;15;B;;667;195;360;450;217;5;3;442;445
43;Tarragona;36;Tarragonès;43148;Tarragona;7;2;A;;443;106;205;266;177;2;0;264;264
43;Tarragona;36;Tarragonès;43148;Tarragona;7;2;B;;502;156;261;319;183;0;1;318;319
43;Tarragona;36;Tarragonès;43148;Tarragona;7;3;A;;482;119;210;264;218;1;0;263;263
43;Tarragona;36;Tarragonès;43148;Tarragona;7;3;B;;517;120;243;296;221;0;0;296;296
43;Tarragona;36;Tarragonès;43148;Tarragona;7;3;C;;581;130;258;325;256;1;2;322;324
43;Tarragona;36;Tarragonès;43148;Tarragona;7;4;A;;608;161;285;355;253;1;4;350;354
43;Tarragona;36;Tarragonès;43148;Tarragona;7;4;B;;674;164;340;406;268;1;5;400;405
43;Tarragona;36;Tarragonès;43148;Tarragona;7;5;A;;476;140;218;260;216;0;0;260;260
43;Tarragona;36;Tarragonès;43148;Tarragona;7;5;B;;565;146;271;315;250;0;0;315;315
43;Tarragona;36;Tarragonès;43148;Tarragona;7;6;A;;593;166;311;376;217;0;7;369;376
43;Tarragona;36;Tarragonès;43148;Tarragona;7;6;B;;555;149;283;352;203;3;2;347;349
43;Tarragona;36;Tarragonès;43148;Tarragona;7;7;A;;801;212;433;545;256;0;11;534;545
43;Tarragona;36;Tarragonès;43148;Tarragona;7;7;B;;367;95;171;197;170;0;0;197;197
43;Tarragona;36;Tarragonès;43148;Tarragona;7;8;A;;692;206;363;473;219;4;5;464;469
43;Tarragona;36;Tarragonès;43148;Tarragona;7;8;B;;848;234;448;569;279;3;10;556;566
43;Tarragona;36;Tarragonès;43148;Tarragona;7;9;A;;559;135;283;333;226;3;1;329;330
43;Tarragona;36;Tarragonès;43148;Tarragona;7;9;B;;647;154;297;358;289;0;5;353;358
43;Tarragona;36;Tarragonès;43148;Tarragona;8;1;A;;496;146;241;290;206;0;4;286;290
43;Tarragona;36;Tarragonès;43148;Tarragona;8;1;B;;477;134;195;237;240;1;0;236;236
43;Tarragona;36;Tarragonès;43148;Tarragona;8;1;C;;543;137;235;302;241;1;3;298;301
43;Tarragona;36;Tarragonès;43148;Tarragona;8;10;A;;534;95;208;255;279;0;1;254;255
43;Tarragona;36;Tarragonès;43148;Tarragona;8;10;B;;586;97;212;265;321;0;0;265;265
43;Tarragona;36;Tarragonès;43148;Tarragona;8;10;C;;485;84;173;226;259;2;3;221;224
43;Tarragona;36;Tarragonès;43148;Tarragona;8;11;U;;539;118;260;323;216;1;4;318;322
43;Tarragona;36;Tarragonès;43148;Tarragona;8;2;A;;554;161;263;323;231;0;2;321;323
43;Tarragona;36;Tarragonès;43148;Tarragona;8;2;B;;625;185;286;352;273;1;3;348;351
43;Tarragona;36;Tarragonès;43148;Tarragona;8;3;A;;490;135;222;272;218;4;1;267;268
43;Tarragona;36;Tarragonès;43148;Tarragona;8;3;B;;597;150;264;344;253;2;1;341;342
43;Tarragona;36;Tarragonès;43148;Tarragona;8;3;C;;581;162;259;343;238;1;4;338;342
43;Tarragona;36;Tarragonès;43148;Tarragona;8;4;A;;617;176;318;394;223;0;8;386;394
43;Tarragona;36;Tarragonès;43148;Tarragona;8;4;B;;630;174;303;383;247;0;2;381;383
43;Tarragona;36;Tarragonès;43148;Tarragona;8;5;A;;377;83;174;217;160;0;1;216;217
43;Tarragona;36;Tarragonès;43148;Tarragona;8;5;B;;502;152;268;338;164;1;2;335;337
43;Tarragona;36;Tarragonès;43148;Tarragona;8;6;A;;497;127;244;313;184;0;2;311;313
43;Tarragona;36;Tarragonès;43148;Tarragona;8;6;B;;574;150;266;363;211;0;7;356;363
43;Tarragona;36;Tarragonès;43148;Tarragona;8;7;A;;463;101;194;268;195;0;3;265;268
43;Tarragona;36;Tarragonès;43148;Tarragona;8;7;B;;507;114;207;268;239;0;2;266;268
43;Tarragona;36;Tarragonès;43148;Tarragona;8;7;C;;510;109;216;283;227;2;2;279;281
43;Tarragona;36;Tarragonès;43148;Tarragona;8;8;A;;574;50;139;187;387;1;1;185;186
43;Tarragona;36;Tarragonès;43148;Tarragona;8;8;B;;657;69;165;237;420;0;1;236;237
43;Tarragona;36;Tarragonès;43148;Tarragona;8;8;C;;641;67;175;247;394;2;0;245;245
43;Tarragona;36;Tarragonès;43148;Tarragona;8;9;A;;513;103;199;259;254;0;2;257;259
43;Tarragona;36;Tarragonès;43148;Tarragona;8;9;B;;589;120;224;298;291;0;1;297;298
43;Tarragona;36;Tarragonès;43148;Tarragona;9;1;A;;425;89;190;216;209;0;0;216;216
43;Tarragona;36;Tarragonès;43148;Tarragona;9;1;B;;484;111;217;251;233;3;1;247;248
43;Tarragona;36;Tarragonès;43148;Tarragona;9;10;A;;407;96;172;215;192;0;2;213;215
43;Tarragona;36;Tarragonès;43148;Tarragona;9;10;B;;518;138;221;272;246;0;4;268;272
43;Tarragona;36;Tarragonès;43148;Tarragona;9;2;A;;471;98;212;256;215;0;2;254;256
43;Tarragona;36;Tarragonès;43148;Tarragona;9;2;B;;528;111;226;286;242;0;4;282;286
43;Tarragona;36;Tarragonès;43148;Tarragona;9;3;A;;418;90;179;240;178;1;1;238;239
43;Tarragona;36;Tarragonès;43148;Tarragona;9;3;B;;533;143;236;300;233;0;1;299;300
43;Tarragona;36;Tarragonès;43148;Tarragona;9;4;A;;463;109;190;231;232;1;2;228;230
43;Tarragona;36;Tarragonès;43148;Tarragona;9;4;B;;569;149;244;308;261;0;1;307;308
43;Tarragona;36;Tarragonès;43148;Tarragona;9;5;A;;408;109;210;265;143;1;0;264;264
43;Tarragona;36;Tarragonès;43148;Tarragona;9;5;B;;509;133;252;314;195;4;1;309;310
43;Tarragona;36;Tarragonès;43148;Tarragona;9;6;A;;539;155;288;338;201;1;5;332;337
43;Tarragona;36;Tarragonès;43148;Tarragona;9;6;B;;638;162;298;375;263;0;0;375;375
43;Tarragona;36;Tarragonès;43148;Tarragona;9;6;C;;558;153;271;343;215;0;0;343;343
43;Tarragona;36;Tarragonès;43148;Tarragona;9;7;U;;747;207;408;514;233;1;8;505;513
43;Tarragona;36;Tarragonès;43148;Tarragona;9;8;U;;776;207;355;439;337;0;0;439;439
43;Tarragona;36;Tarragonès;43148;Tarragona;9;9;U;;551;114;219;297;254;0;1;296;297
25;Lleida;38;Urgell;25217;Tàrrega;1;1;U;;1092;292;547;731;361;2;8;721;729
25;Lleida;38;Urgell;25217;Tàrrega;1;2;U;;780;217;400;533;247;4;7;522;529
25;Lleida;38;Urgell;25217;Tàrrega;2;1;U;;820;160;398;532;288;3;8;521;529
25;Lleida;38;Urgell;25217;Tàrrega;2;2;A;;719;160;381;501;218;3;12;486;498
25;Lleida;38;Urgell;25217;Tàrrega;2;2;B;;823;202;437;597;226;2;5;590;595
25;Lleida;38;Urgell;25217;Tàrrega;3;1;A;;796;185;415;550;246;2;7;541;548
25;Lleida;38;Urgell;25217;Tàrrega;3;1;B;;1000;214;482;642;358;1;12;629;641
25;Lleida;38;Urgell;25217;Tàrrega;3;2;U;;822;182;421;578;244;3;10;565;575
25;Lleida;38;Urgell;25217;Tàrrega;4;1;U;;760;225;427;555;205;0;11;544;555
25;Lleida;38;Urgell;25217;Tàrrega;4;2;U;;1136;265;615;816;320;3;23;790;813
25;Lleida;38;Urgell;25217;Tàrrega;5;1;A;;409;84;226;278;131;3;7;268;275
25;Lleida;38;Urgell;25217;Tàrrega;5;1;B;;199;53;101;136;63;0;2;134;136
25;Lleida;18;Garrigues;25218;Tarrés;1;1;U;;85;38;46;72;13;0;0;72;72
25;Lleida;32;Segarra;25219;Tarroja de Segarra;1;1;U;;157;43;97;121;36;0;2;119;121
8;Barcelona;24;Osona;08275;Tavèrnoles;1;1;U;;190;55;124;147;43;0;1;146;147
8;Barcelona;24;Osona;08280;Tavertet;1;1;U;;108;35;70;89;19;0;0;89;89
8;Barcelona;21;Maresme;08281;Teià;1;1;A;;589;175;352;439;150;2;7;430;437
8;Barcelona;21;Maresme;08281;Teià;1;1;B;;643;187;366;471;172;1;5;465;470
8;Barcelona;21;Maresme;08281;Teià;1;2;U;;1050;292;614;773;277;0;5;768;773
8;Barcelona;21;Maresme;08281;Teià;1;3;U;;1098;256;607;764;334;2;9;753;762
25;Lleida;23;Noguera;25220;Térmens;1;1;A;;494;86;277;369;125;0;3;366;369
25;Lleida;23;Noguera;25220;Térmens;1;1;B;;672;128;407;509;163;0;4;505;509
17;Girona;2;Alt Empordà;17196;Terrades;1;1;U;;162;54;101;111;51;0;0;111;111
8;Barcelona;40;Vallès Occidental;08279;Terrassa;1;1;A;;638;174;412;515;123;1;4;510;514
8;Barcelona;40;Vallès Occidental;08279;Terrassa;1;1;B;;595;171;373;486;109;0;2;484;486
8;Barcelona;40;Vallès Occidental;08279;Terrassa;1;10;U;;562;176;324;404;158;1;7;396;403
8;Barcelona;40;Vallès Occidental;08279;Terrassa;1;11;U;;730;189;394;468;262;2;6;460;466
8;Barcelona;40;Vallès Occidental;08279;Terrassa;1;12;A;;881;207;451;572;309;1;8;563;571
8;Barcelona;40;Vallès Occidental;08279;Terrassa;1;12;B;;1021;218;500;666;355;2;8;656;664
8;Barcelona;40;Vallès Occidental;08279;Terrassa;1;13;U;;536;136;230;322;214;1;7;314;321
8;Barcelona;40;Vallès Occidental;08279;Terrassa;1;14;A;;490;123;222;305;185;1;6;298;304
8;Barcelona;40;Vallès Occidental;08279;Terrassa;1;14;B;;607;130;256;347;260;0;7;340;347
8;Barcelona;40;Vallès Occidental;08279;Terrassa;1;14;C;;642;157;322;402;240;0;5;397;402
8;Barcelona;40;Vallès Occidental;08279;Terrassa;1;15;A;;823;167;389;519;304;0;4;515;519
8;Barcelona;40;Vallès Occidental;08279;Terrassa;1;15;B;;1076;231;512;680;396;5;5;670;675
8;Barcelona;40;Vallès Occidental;08279;Terrassa;1;16;A;;728;222;420;538;190;3;10;525;535
8;Barcelona;40;Vallès Occidental;08279;Terrassa;1;16;B;;809;252;474;609;200;0;1;608;609
8;Barcelona;40;Vallès Occidental;08279;Terrassa;1;17;A;;794;205;445;626;168;0;8;618;626
8;Barcelona;40;Vallès Occidental;08279;Terrassa;1;17;B;;988;276;561;745;243;0;0;745;745
8;Barcelona;40;Vallès Occidental;08279;Terrassa;1;18;U;;392;128;225;279;113;0;2;277;279
8;Barcelona;40;Vallès Occidental;08279;Terrassa;1;2;A;;516;152;312;398;118;0;3;395;398
8;Barcelona;40;Vallès Occidental;08279;Terrassa;1;2;B;;583;176;348;438;145;3;5;430;435
8;Barcelona;40;Vallès Occidental;08279;Terrassa;1;4;A;;511;147;299;402;109;2;0;400;400
8;Barcelona;40;Vallès Occidental;08279;Terrassa;1;4;B;;507;152;296;386;121;3;9;374;383
8;Barcelona;40;Vallès Occidental;08279;Terrassa;1;5;A;;662;180;339;462;200;4;1;457;458
8;Barcelona;40;Vallès Occidental;08279;Terrassa;1;5;B;;669;154;339;476;193;1;5;470;475
8;Barcelona;40;Vallès Occidental;08279;Terrassa;1;6;A;;760;177;434;577;183;0;7;570;577
8;Barcelona;40;Vallès Occidental;08279;Terrassa;1;6;B;;846;203;511;644;202;5;2;637;639
8;Barcelona;40;Vallès Occidental;08279;Terrassa;1;7;A;;489;152;297;381;108;0;2;379;381
8;Barcelona;40;Vallès Occidental;08279;Terrassa;1;7;B;;547;137;291;392;155;0;7;385;392
8;Barcelona;40;Vallès Occidental;08279;Terrassa;1;8;U;;832;257;483;602;230;2;11;589;600
8;Barcelona;40;Vallès Occidental;08279;Terrassa;1;9;U;;801;246;498;580;221;0;3;577;580
8;Barcelona;40;Vallès Occidental;08279;Terrassa;2;1;A;;621;154;300;374;247;0;0;374;374
8;Barcelona;40;Vallès Occidental;08279;Terrassa;2;1;B;;759;189;361;481;278;0;5;476;481
8;Barcelona;40;Vallès Occidental;08279;Terrassa;2;10;U;;478;149;242;287;191;0;3;284;287
8;Barcelona;40;Vallès Occidental;08279;Terrassa;2;11;U;;657;172;313;394;263;0;4;390;394
8;Barcelona;40;Vallès Occidental;08279;Terrassa;2;12;U;;482;118;246;303;179;2;1;300;301
8;Barcelona;40;Vallès Occidental;08279;Terrassa;2;13;U;;595;185;328;398;197;2;8;388;396
8;Barcelona;40;Vallès Occidental;08279;Terrassa;2;14;A;;934;168;378;444;490;0;5;439;444
8;Barcelona;40;Vallès Occidental;08279;Terrassa;2;14;B;;1021;200;413;485;536;0;5;480;485
8;Barcelona;40;Vallès Occidental;08279;Terrassa;2;2;A;;484;120;212;274;210;0;3;271;274
8;Barcelona;40;Vallès Occidental;08279;Terrassa;2;2;B;;644;165;291;387;257;0;3;384;387
8;Barcelona;40;Vallès Occidental;08279;Terrassa;2;3;U;;878;265;469;561;317;8;9;544;553
8;Barcelona;40;Vallès Occidental;08279;Terrassa;2;4;A;;534;163;271;330;204;1;5;324;329
8;Barcelona;40;Vallès Occidental;08279;Terrassa;2;4;B;;715;204;349;419;296;1;8;410;418
8;Barcelona;40;Vallès Occidental;08279;Terrassa;2;5;A;;468;120;210;290;178;1;3;286;289
8;Barcelona;40;Vallès Occidental;08279;Terrassa;2;5;B;;581;147;252;321;260;0;5;316;321
8;Barcelona;40;Vallès Occidental;08279;Terrassa;2;6;U;;898;225;435;551;347;1;7;543;550
8;Barcelona;40;Vallès Occidental;08279;Terrassa;2;7;U;;549;160;279;357;192;0;4;353;357
8;Barcelona;40;Vallès Occidental;08279;Terrassa;2;8;U;;883;250;433;516;367;3;4;509;513
8;Barcelona;40;Vallès Occidental;08279;Terrassa;2;9;U;;817;218;374;512;305;0;6;506;512
8;Barcelona;40;Vallès Occidental;08279;Terrassa;3;1;U;;988;228;497;653;335;0;13;640;653
8;Barcelona;40;Vallès Occidental;08279;Terrassa;3;10;A;;684;104;248;323;361;2;4;317;321
8;Barcelona;40;Vallès Occidental;08279;Terrassa;3;10;B;;879;137;303;433;446;2;5;426;431
8;Barcelona;40;Vallès Occidental;08279;Terrassa;3;11;A;;552;110;217;276;276;1;2;273;275
8;Barcelona;40;Vallès Occidental;08279;Terrassa;3;11;B;;767;118;246;341;426;1;4;336;340
8;Barcelona;40;Vallès Occidental;08279;Terrassa;3;12;A;;687;134;278;367;320;4;0;363;363
8;Barcelona;40;Vallès Occidental;08279;Terrassa;3;12;B;;746;144;307;416;330;1;6;409;415
8;Barcelona;40;Vallès Occidental;08279;Terrassa;3;13;U;;647;159;290;355;292;0;1;354;355
8;Barcelona;40;Vallès Occidental;08279;Terrassa;3;14;A;;587;118;262;334;253;1;8;325;333
8;Barcelona;40;Vallès Occidental;08279;Terrassa;3;14;B;;787;166;328;411;376;1;4;406;410
8;Barcelona;40;Vallès Occidental;08279;Terrassa;3;15;U;;862;186;368;497;365;0;6;491;497
8;Barcelona;40;Vallès Occidental;08279;Terrassa;3;16;U;;963;176;406;525;438;3;1;521;522
8;Barcelona;40;Vallès Occidental;08279;Terrassa;3;17;A;;497;79;173;250;247;2;2;246;248
8;Barcelona;40;Vallès Occidental;08279;Terrassa;3;17;B;;633;98;261;334;299;0;3;331;334
8;Barcelona;40;Vallès Occidental;08279;Terrassa;3;18;U;;716;61;263;365;351;0;3;362;365
8;Barcelona;40;Vallès Occidental;08279;Terrassa;3;19;A;;524;125;228;292;232;0;2;290;292
8;Barcelona;40;Vallès Occidental;08279;Terrassa;3;19;B;;683;162;300;392;291;0;4;388;392
8;Barcelona;40;Vallès Occidental;08279;Terrassa;3;2;A;;599;138;297;376;223;1;4;371;375
8;Barcelona;40;Vallès Occidental;08279;Terrassa;3;2;B;;614;133;259;340;274;1;5;334;339
8;Barcelona;40;Vallès Occidental;08279;Terrassa;3;2;C;;653;162;319;397;256;4;4;389;393
8;Barcelona;40;Vallès Occidental;08279;Terrassa;3;3;A;;427;108;192;246;181;0;0;246;246
8;Barcelona;40;Vallès Occidental;08279;Terrassa;3;3;B;;558;120;236;299;259;0;4;295;299
8;Barcelona;40;Vallès Occidental;08279;Terrassa;3;4;U;;828;183;380;471;357;6;7;458;465
8;Barcelona;40;Vallès Occidental;08279;Terrassa;3;5;A;;492;149;259;326;166;0;4;322;326
8;Barcelona;40;Vallès Occidental;08279;Terrassa;3;5;B;;632;152;325;412;220;0;6;406;412
8;Barcelona;40;Vallès Occidental;08279;Terrassa;3;6;U;;830;279;506;628;202;0;7;621;628
8;Barcelona;40;Vallès Occidental;08279;Terrassa;3;7;U;;703;187;355;477;226;1;7;469;476
8;Barcelona;40;Vallès Occidental;08279;Terrassa;3;8;A;;739;174;314;395;344;0;1;394;395
8;Barcelona;40;Vallès Occidental;08279;Terrassa;3;8;B;;950;206;383;478;472;0;3;475;478
8;Barcelona;40;Vallès Occidental;08279;Terrassa;3;9;U;;884;208;428;546;338;1;2;543;545
8;Barcelona;40;Vallès Occidental;08279;Terrassa;4;1;A;;510;152;305;369;141;0;4;365;369
8;Barcelona;40;Vallès Occidental;08279;Terrassa;4;1;B;;569;148;337;415;154;0;4;411;415
8;Barcelona;40;Vallès Occidental;08279;Terrassa;4;10;U;;746;203;348;449;297;0;2;447;449
8;Barcelona;40;Vallès Occidental;08279;Terrassa;4;11;U;;581;162;257;333;248;2;3;328;331
8;Barcelona;40;Vallès Occidental;08279;Terrassa;4;12;A;;498;116;241;322;176;0;6;316;322
8;Barcelona;40;Vallès Occidental;08279;Terrassa;4;12;B;;612;155;289;385;227;0;5;380;385
8;Barcelona;40;Vallès Occidental;08279;Terrassa;4;13;A;;434;123;241;304;130;1;2;301;303
8;Barcelona;40;Vallès Occidental;08279;Terrassa;4;13;B;;525;135;260;346;179;1;1;344;345
8;Barcelona;40;Vallès Occidental;08279;Terrassa;4;14;A;;718;196;429;547;171;2;6;539;545
8;Barcelona;40;Vallès Occidental;08279;Terrassa;4;14;B;;757;200;451;563;194;1;2;560;562
8;Barcelona;40;Vallès Occidental;08279;Terrassa;4;15;U;;951;236;526;714;237;0;10;704;714
8;Barcelona;40;Vallès Occidental;08279;Terrassa;4;16;A;;471;130;283;357;114;1;8;348;356
8;Barcelona;40;Vallès Occidental;08279;Terrassa;4;16;B;;551;136;315;398;153;2;3;393;396
8;Barcelona;40;Vallès Occidental;08279;Terrassa;4;17;U;;737;198;414;523;214;1;4;518;522
8;Barcelona;40;Vallès Occidental;08279;Terrassa;4;18;A;;584;168;308;421;163;3;4;414;418
8;Barcelona;40;Vallès Occidental;08279;Terrassa;4;18;B;;777;209;400;539;238;4;2;533;535
8;Barcelona;40;Vallès Occidental;08279;Terrassa;4;19;A;;577;131;255;353;224;0;7;346;353
8;Barcelona;40;Vallès Occidental;08279;Terrassa;4;19;B;;772;197;349;462;310;0;7;455;462
8;Barcelona;40;Vallès Occidental;08279;Terrassa;4;19;C;;638;158;285;371;267;0;4;367;371
8;Barcelona;40;Vallès Occidental;08279;Terrassa;4;2;A;;571;149;316;415;156;0;2;413;415
8;Barcelona;40;Vallès Occidental;08279;Terrassa;4;2;B;;602;161;340;442;160;1;8;433;441
8;Barcelona;40;Vallès Occidental;08279;Terrassa;4;20;U;;781;210;350;431;350;0;0;431;431
8;Barcelona;40;Vallès Occidental;08279;Terrassa;4;3;A;;500;167;288;343;157;3;5;335;340
8;Barcelona;40;Vallès Occidental;08279;Terrassa;4;3;B;;660;210;356;452;208;1;6;445;451
8;Barcelona;40;Vallès Occidental;08279;Terrassa;4;4;A;;572;157;295;372;200;0;1;371;372
8;Barcelona;40;Vallès Occidental;08279;Terrassa;4;4;B;;591;163;289;387;204;2;1;384;385
8;Barcelona;40;Vallès Occidental;08279;Terrassa;4;5;A;;799;197;387;506;293;3;8;495;503
8;Barcelona;40;Vallès Occidental;08279;Terrassa;4;5;B;;961;212;433;552;409;2;5;545;550
8;Barcelona;40;Vallès Occidental;08279;Terrassa;4;6;A;;494;147;247;322;172;0;3;319;322
8;Barcelona;40;Vallès Occidental;08279;Terrassa;4;6;B;;572;175;314;387;185;2;1;384;385
8;Barcelona;40;Vallès Occidental;08279;Terrassa;4;7;A;;708;148;301;394;314;0;6;388;394
8;Barcelona;40;Vallès Occidental;08279;Terrassa;4;7;B;;926;224;420;538;388;2;5;531;536
8;Barcelona;40;Vallès Occidental;08279;Terrassa;4;8;A;;805;176;372;477;328;0;9;468;477
8;Barcelona;40;Vallès Occidental;08279;Terrassa;4;8;B;;1149;247;575;662;487;0;6;656;662
8;Barcelona;40;Vallès Occidental;08279;Terrassa;4;9;U;;644;168;249;321;323;0;2;319;321
8;Barcelona;40;Vallès Occidental;08279;Terrassa;5;1;U;;938;149;378;548;390;1;9;538;547
8;Barcelona;40;Vallès Occidental;08279;Terrassa;5;10;A;;858;200;409;523;335;0;6;517;523
8;Barcelona;40;Vallès Occidental;08279;Terrassa;5;10;B;;934;220;445;540;394;4;3;533;536
8;Barcelona;40;Vallès Occidental;08279;Terrassa;5;11;A;;659;147;314;421;238;0;4;417;421
8;Barcelona;40;Vallès Occidental;08279;Terrassa;5;11;B;;812;181;390;542;270;0;9;533;542
8;Barcelona;40;Vallès Occidental;08279;Terrassa;5;12;U;;656;186;330;407;249;1;4;402;406
8;Barcelona;40;Vallès Occidental;08279;Terrassa;5;13;U;;839;162;321;418;421;5;0;413;413
8;Barcelona;40;Vallès Occidental;08279;Terrassa;5;14;A;;408;86;180;233;175;0;5;228;233
8;Barcelona;40;Vallès Occidental;08279;Terrassa;5;14;B;;542;111;237;300;242;1;3;296;299
8;Barcelona;40;Vallès Occidental;08279;Terrassa;5;14;C;;504;133;264;318;186;1;3;314;317
8;Barcelona;40;Vallès Occidental;08279;Terrassa;5;15;A;;642;131;299;380;262;1;1;378;379
8;Barcelona;40;Vallès Occidental;08279;Terrassa;5;15;B;;837;170;374;470;367;0;3;467;470
8;Barcelona;40;Vallès Occidental;08279;Terrassa;5;16;A;;666;158;304;386;280;3;2;381;383
8;Barcelona;40;Vallès Occidental;08279;Terrassa;5;16;B;;945;229;444;556;389;3;3;550;553
8;Barcelona;40;Vallès Occidental;08279;Terrassa;5;17;U;;909;211;394;524;385;1;2;521;523
8;Barcelona;40;Vallès Occidental;08279;Terrassa;5;18;A;;532;117;243;342;190;0;6;336;342
8;Barcelona;40;Vallès Occidental;08279;Terrassa;5;18;B;;707;151;284;419;288;0;6;413;419
8;Barcelona;40;Vallès Occidental;08279;Terrassa;5;19;U;;985;208;393;532;453;0;6;526;532
8;Barcelona;40;Vallès Occidental;08279;Terrassa;5;2;A;;609;112;247;345;264;1;2;342;344
8;Barcelona;40;Vallès Occidental;08279;Terrassa;5;2;B;;831;155;330;449;382;0;8;441;449
8;Barcelona;40;Vallès Occidental;08279;Terrassa;5;20;A;;429;97;208;278;151;0;3;275;278
8;Barcelona;40;Vallès Occidental;08279;Terrassa;5;20;B;;539;126;256;354;185;0;2;352;354
8;Barcelona;40;Vallès Occidental;08279;Terrassa;5;21;A;;596;114;266;374;222;0;5;369;374
8;Barcelona;40;Vallès Occidental;08279;Terrassa;5;21;B;;850;182;384;505;345;1;6;498;504
8;Barcelona;40;Vallès Occidental;08279;Terrassa;5;22;U;;530;134;244;321;209;0;3;318;321
8;Barcelona;40;Vallès Occidental;08279;Terrassa;5;3;A;;675;180;339;442;233;0;4;438;442
8;Barcelona;40;Vallès Occidental;08279;Terrassa;5;3;B;;830;186;436;561;269;1;2;558;560
8;Barcelona;40;Vallès Occidental;08279;Terrassa;5;4;A;;718;198;390;494;224;0;5;489;494
8;Barcelona;40;Vallès Occidental;08279;Terrassa;5;4;B;;831;214;452;574;257;0;4;570;574
8;Barcelona;40;Vallès Occidental;08279;Terrassa;5;5;U;;696;175;359;449;247;0;7;442;449
8;Barcelona;40;Vallès Occidental;08279;Terrassa;5;6;A;;710;170;369;494;216;1;5;488;493
8;Barcelona;40;Vallès Occidental;08279;Terrassa;5;6;B;;846;216;470;591;255;1;6;584;590
8;Barcelona;40;Vallès Occidental;08279;Terrassa;5;7;A;;680;179;383;484;196;0;6;478;484
8;Barcelona;40;Vallès Occidental;08279;Terrassa;5;7;B;;787;204;427;569;218;1;7;561;568
8;Barcelona;40;Vallès Occidental;08279;Terrassa;5;8;A;;613;150;326;435;178;2;7;426;433
8;Barcelona;40;Vallès Occidental;08279;Terrassa;5;8;B;;714;177;362;474;240;0;5;469;474
8;Barcelona;40;Vallès Occidental;08279;Terrassa;5;9;A;;855;199;442;576;279;0;0;576;576
8;Barcelona;40;Vallès Occidental;08279;Terrassa;5;9;B;;892;213;467;596;296;2;4;590;594
8;Barcelona;40;Vallès Occidental;08279;Terrassa;6;1;U;;969;221;434;565;404;1;5;559;564
8;Barcelona;40;Vallès Occidental;08279;Terrassa;6;10;A;;657;117;267;357;300;0;3;354;357
8;Barcelona;40;Vallès Occidental;08279;Terrassa;6;10;B;;855;132;318;427;428;2;1;424;425
8;Barcelona;40;Vallès Occidental;08279;Terrassa;6;11;A;;650;111;226;298;352;2;4;292;296
8;Barcelona;40;Vallès Occidental;08279;Terrassa;6;11;B;;786;115;267;352;434;0;5;347;352
8;Barcelona;40;Vallès Occidental;08279;Terrassa;6;12;A;;455;108;224;284;171;2;2;280;282
8;Barcelona;40;Vallès Occidental;08279;Terrassa;6;12;B;;711;170;323;409;302;1;4;404;408
8;Barcelona;40;Vallès Occidental;08279;Terrassa;6;13;U;;862;203;382;539;323;0;4;535;539
8;Barcelona;40;Vallès Occidental;08279;Terrassa;6;14;A;;431;78;172;212;219;1;3;208;211
8;Barcelona;40;Vallès Occidental;08279;Terrassa;6;14;B;;493;103;214;280;213;0;3;277;280
8;Barcelona;40;Vallès Occidental;08279;Terrassa;6;16;A;;378;115;179;226;152;0;3;223;226
8;Barcelona;40;Vallès Occidental;08279;Terrassa;6;16;B;;544;146;266;310;234;0;4;306;310
8;Barcelona;40;Vallès Occidental;08279;Terrassa;6;18;U;;691;200;328;411;280;0;2;409;411
8;Barcelona;40;Vallès Occidental;08279;Terrassa;6;19;U;;651;154;316;389;262;0;6;383;389
8;Barcelona;40;Vallès Occidental;08279;Terrassa;6;2;A;;530;117;216;289;241;0;0;289;289
8;Barcelona;40;Vallès Occidental;08279;Terrassa;6;2;B;;773;166;318;437;336;1;1;435;436
8;Barcelona;40;Vallès Occidental;08279;Terrassa;6;20;U;;720;178;326;409;311;2;0;407;407
8;Barcelona;40;Vallès Occidental;08279;Terrassa;6;21;U;;562;182;302;354;208;0;4;350;354
8;Barcelona;40;Vallès Occidental;08279;Terrassa;6;22;A;;718;207;351;439;279;1;4;434;438
8;Barcelona;40;Vallès Occidental;08279;Terrassa;6;22;B;;906;210;408;495;411;1;5;489;494
8;Barcelona;40;Vallès Occidental;08279;Terrassa;6;23;A;;683;115;247;362;321;0;7;355;362
8;Barcelona;40;Vallès Occidental;08279;Terrassa;6;23;B;;997;188;411;559;438;0;7;552;559
8;Barcelona;40;Vallès Occidental;08279;Terrassa;6;24;A;;576;91;219;306;270;0;4;302;306
8;Barcelona;40;Vallès Occidental;08279;Terrassa;6;24;B;;865;112;278;398;467;1;5;392;397
8;Barcelona;40;Vallès Occidental;08279;Terrassa;6;25;A;;645;101;239;315;330;0;3;312;315
8;Barcelona;40;Vallès Occidental;08279;Terrassa;6;25;B;;883;150;358;440;443;1;3;436;439
8;Barcelona;40;Vallès Occidental;08279;Terrassa;6;26;U;;852;196;387;487;365;7;2;478;480
8;Barcelona;40;Vallès Occidental;08279;Terrassa;6;3;A;;629;130;257;352;277;1;5;346;351
8;Barcelona;40;Vallès Occidental;08279;Terrassa;6;3;B;;876;173;361;473;403;4;3;466;469
8;Barcelona;40;Vallès Occidental;08279;Terrassa;6;4;A;;602;169;303;381;221;0;4;377;381
8;Barcelona;40;Vallès Occidental;08279;Terrassa;6;4;B;;648;192;315;398;250;1;5;392;397
8;Barcelona;40;Vallès Occidental;08279;Terrassa;6;5;U;;786;175;331;418;368;0;1;417;418
8;Barcelona;40;Vallès Occidental;08279;Terrassa;6;6;U;;731;139;275;389;342;0;2;387;389
8;Barcelona;40;Vallès Occidental;08279;Terrassa;6;8;A;;625;148;284;379;246;0;5;374;379
8;Barcelona;40;Vallès Occidental;08279;Terrassa;6;8;B;;840;217;406;530;310;0;5;525;530
8;Barcelona;40;Vallès Occidental;08279;Terrassa;6;9;A;;382;65;141;203;179;0;0;203;203
8;Barcelona;40;Vallès Occidental;08279;Terrassa;6;9;B;;471;85;170;250;221;0;1;249;250
8;Barcelona;21;Maresme;08282;Tiana;1;1;A;;402;119;261;305;97;1;1;303;304
8;Barcelona;21;Maresme;08282;Tiana;1;1;B;;462;121;286;346;116;1;4;341;345
8;Barcelona;21;Maresme;08282;Tiana;1;2;A;;628;165;342;453;175;0;5;448;453
8;Barcelona;21;Maresme;08282;Tiana;1;2;B;;781;210;396;552;229;2;4;546;550
8;Barcelona;21;Maresme;08282;Tiana;1;3;A;;808;194;508;598;210;2;8;588;596
8;Barcelona;21;Maresme;08282;Tiana;1;3;B;;901;210;542;625;276;0;10;615;625
25;Lleida;26;Pallars Sobirà;25221;Tírvia;1;1;U;;95;14;59;71;24;0;0;71;71
25;Lleida;23;Noguera;25222;Tiurana;1;1;U;;146;29;65;81;65;0;0;81;81
43;Tarragona;9;Baix Ebre;43149;Tivenys;1;1;U;;869;235;488;606;263;2;6;598;604
43;Tarragona;30;Ribera d'Ebre;43150;Tivissa;1;1;A;;545;98;265;396;149;4;2;390;392
43;Tarragona;30;Ribera d'Ebre;43150;Tivissa;1;1;B;;640;128;316;447;193;5;5;437;442
43;Tarragona;30;Ribera d'Ebre;43150;Tivissa;1;1;C;;278;62;156;182;96;1;2;179;181
8;Barcelona;24;Osona;08283;Tona;1;1;A;;547;148;321;389;158;0;1;388;389
8;Barcelona;24;Osona;08283;Tona;1;1;B;;683;164;365;450;233;1;5;444;449
8;Barcelona;24;Osona;08283;Tona;1;2;A;;645;158;367;442;203;2;5;435;440
8;Barcelona;24;Osona;08283;Tona;1;2;B;;673;149;364;445;228;0;6;439;445
8;Barcelona;24;Osona;08283;Tona;1;2;C;;531;119;312;371;160;0;4;367;371
8;Barcelona;24;Osona;08283;Tona;1;3;A;;737;153;399;517;220;4;4;509;513
8;Barcelona;24;Osona;08283;Tona;1;3;B;;762;179;438;538;224;3;9;526;535
25;Lleida;32;Segarra;25223;Torà;1;1;U;;939;240;552;667;272;3;4;660;664
8;Barcelona;21;Maresme;08284;Tordera;1;1;A;;725;184;409;521;204;2;2;517;519
8;Barcelona;21;Maresme;08284;Tordera;1;1;B;;1011;268;575;736;275;1;3;732;735
8;Barcelona;21;Maresme;08284;Tordera;1;2;A;;671;150;336;420;251;4;6;410;416
8;Barcelona;21;Maresme;08284;Tordera;1;2;B;;823;220;429;538;285;3;5;530;535
8;Barcelona;21;Maresme;08284;Tordera;1;3;A;;407;91;225;274;133;0;1;273;274
8;Barcelona;21;Maresme;08284;Tordera;1;3;B;;576;135;314;373;203;3;1;369;370
8;Barcelona;21;Maresme;08284;Tordera;2;1;A;;910;212;453;578;332;0;4;574;578
8;Barcelona;21;Maresme;08284;Tordera;2;1;B;;1060;262;539;691;369;2;5;684;689
8;Barcelona;21;Maresme;08284;Tordera;2;2;A;;416;129;219;269;147;0;3;266;269
8;Barcelona;21;Maresme;08284;Tordera;2;2;B;;539;160;281;340;199;2;3;335;338
8;Barcelona;24;Osona;08285;Torelló;1;1;A;;471;123;273;332;139;0;4;328;332
8;Barcelona;24;Osona;08285;Torelló;1;1;B;;513;132;272;332;181;2;2;328;330
8;Barcelona;24;Osona;08285;Torelló;1;2;A;;691;171;414;493;198;1;5;487;492
8;Barcelona;24;Osona;08285;Torelló;1;2;B;;660;169;387;480;180;0;5;475;480
8;Barcelona;24;Osona;08285;Torelló;1;3;U;;871;209;542;628;243;2;6;620;626
8;Barcelona;24;Osona;08285;Torelló;1;4;A;;553;126;307;365;188;0;0;365;365
8;Barcelona;24;Osona;08285;Torelló;1;4;B;;612;112;309;396;216;0;1;395;396
8;Barcelona;24;Osona;08285;Torelló;2;1;U;;819;192;426;538;281;1;4;533;537
8;Barcelona;24;Osona;08285;Torelló;2;2;A;;513;114;273;333;180;1;0;332;332
8;Barcelona;24;Osona;08285;Torelló;2;2;B;;590;127;332;416;174;2;3;411;414
8;Barcelona;24;Osona;08285;Torelló;2;3;A;;455;114;238;306;149;3;2;301;303
8;Barcelona;24;Osona;08285;Torelló;2;3;B;;549;126;290;365;184;2;1;362;363
8;Barcelona;24;Osona;08285;Torelló;2;4;A;;466;91;260;317;149;4;0;313;313
8;Barcelona;24;Osona;08285;Torelló;2;4;B;;527;107;261;355;172;5;1;349;350
8;Barcelona;24;Osona;08285;Torelló;2;5;A;;534;116;285;357;177;0;3;354;357
8;Barcelona;24;Osona;08285;Torelló;2;5;B;;718;153;402;476;242;1;5;470;475
25;Lleida;18;Garrigues;25224;Torms, els;1;1;U;;172;13;59;103;69;0;0;103;103
25;Lleida;38;Urgell;25225;Tornabous;1;1;U;;731;163;390;495;236;0;11;484;495
25;Lleida;33;Segrià;25226;Torrebesses;1;1;U;;289;87;160;199;90;0;1;198;199
25;Lleida;25;Pallars Jussà;25227;Torre de Cabdella, la;1;1;U;;658;145;297;410;248;1;1;408;409
8;Barcelona;6;Anoia;08286;Torre de Claramunt, la;1;1;U;;1147;315;625;769;378;2;1;766;767
8;Barcelona;6;Anoia;08286;Torre de Claramunt, la;1;2;U;;393;124;207;253;140;2;0;251;251
43;Tarragona;29;Priorat;43151;Torre de Fontaubella, la;1;1;U;;75;19;49;54;21;1;2;51;53
43;Tarragona;30;Ribera d'Ebre;43152;Torre de l'Espanyol, la;1;1;U;;589;154;396;479;110;4;3;472;475
43;Tarragona;36;Tarragonès;43153;Torredembarra;1;1;A;;480;127;258;328;152;2;2;324;326
43;Tarragona;36;Tarragonès;43153;Torredembarra;1;1;B;;624;188;339;415;209;2;10;403;413
43;Tarragona;36;Tarragonès;43153;Torredembarra;1;2;A;;536;130;249;308;228;2;3;303;306
43;Tarragona;36;Tarragonès;43153;Torredembarra;1;2;B;;651;164;335;418;233;2;5;411;416
43;Tarragona;36;Tarragonès;43153;Torredembarra;1;3;A;;538;162;253;323;215;1;0;322;322
43;Tarragona;36;Tarragonès;43153;Torredembarra;1;3;B;;565;175;296;349;216;2;0;347;347
43;Tarragona;36;Tarragonès;43153;Torredembarra;1;4;A;;449;122;240;312;137;3;5;304;309
43;Tarragona;36;Tarragonès;43153;Torredembarra;1;4;B;;549;154;307;384;165;4;4;376;380
43;Tarragona;36;Tarragonès;43153;Torredembarra;1;5;A;;421;113;203;266;155;2;1;263;264
43;Tarragona;36;Tarragonès;43153;Torredembarra;1;5;B;;570;137;273;343;227;1;1;341;342
43;Tarragona;36;Tarragonès;43153;Torredembarra;1;6;A;;569;160;294;359;210;2;1;356;357
43;Tarragona;36;Tarragonès;43153;Torredembarra;1;6;B;;724;210;366;443;281;7;4;432;436
25;Lleida;33;Segrià;25228;Torrefarrera;1;1;A;;583;179;360;456;127;3;0;453;453
25;Lleida;33;Segrià;25228;Torrefarrera;1;1;B;;662;190;398;498;164;0;5;493;498
25;Lleida;32;Segarra;25907;Torrefeta i Florejacs;1;1;U;;608;141;354;411;197;2;4;405;409
25;Lleida;27;Pla d'Urgell;25230;Torregrossa;1;1;U;;623;204;403;486;137;3;3;480;483
25;Lleida;27;Pla d'Urgell;25230;Torregrossa;1;2;A;;606;156;363;476;130;15;4;457;461
25;Lleida;27;Pla d'Urgell;25230;Torregrossa;1;2;B;;632;165;391;513;119;2;12;499;511
25;Lleida;23;Noguera;25231;Torrelameu;1;1;U;;493;127;320;383;110;1;2;380;382
8;Barcelona;3;Alt Penedès;08287;Torrelavit;1;1;U;;996;248;593;719;277;1;9;709;718
8;Barcelona;3;Alt Penedès;08288;Torrelles de Foix;1;1;A;;564;147;292;364;200;1;1;362;363
8;Barcelona;3;Alt Penedès;08288;Torrelles de Foix;1;1;B;;723;193;346;440;283;4;3;433;436
8;Barcelona;11;Baix Llobregat;08289;Torrelles de Llobregat;1;1;A;;505;150;281;356;149;0;3;353;356
8;Barcelona;11;Baix Llobregat;08289;Torrelles de Llobregat;1;1;B;;724;169;419;507;217;1;5;501;506
8;Barcelona;11;Baix Llobregat;08289;Torrelles de Llobregat;1;2;A;;547;130;253;328;219;0;2;326;328
8;Barcelona;11;Baix Llobregat;08289;Torrelles de Llobregat;1;2;B;;565;136;281;358;207;0;5;353;358
17;Girona;10;Baix Empordà;17197;Torrent;1;1;U;;147;42;81;101;46;0;2;99;101
25;Lleida;33;Segrià;25232;Torres de Segre;1;1;A;;718;179;414;525;193;3;5;517;522
25;Lleida;33;Segrià;25232;Torres de Segre;1;1;B;;798;187;447;566;232;2;5;559;564
25;Lleida;33;Segrià;25233;Torre-serona;1;1;U;;257;75;154;182;75;0;1;181;182
17;Girona;2;Alt Empordà;17198;Torroella de Fluvià;1;1;U;;236;77;152;170;66;1;4;165;169
17;Girona;10;Baix Empordà;17199;Torroella de Montgrí;1;1;A;;523;166;300;375;148;2;2;371;373
17;Girona;10;Baix Empordà;17199;Torroella de Montgrí;1;1;B;;398;135;222;274;124;0;4;270;274
17;Girona;10;Baix Empordà;17199;Torroella de Montgrí;1;1;C;;464;142;274;343;121;1;1;341;342
17;Girona;10;Baix Empordà;17199;Torroella de Montgrí;1;2;A;;667;183;340;445;222;2;4;439;443
17;Girona;10;Baix Empordà;17199;Torroella de Montgrí;1;2;B;;531;159;296;359;172;0;8;351;359
17;Girona;10;Baix Empordà;17199;Torroella de Montgrí;1;2;C;;652;173;351;448;204;1;4;443;447
17;Girona;10;Baix Empordà;17199;Torroella de Montgrí;1;3;U;;1243;292;609;706;537;1;12;693;705
17;Girona;10;Baix Empordà;17199;Torroella de Montgrí;1;4;U;;1267;288;680;883;384;3;3;877;880
43;Tarragona;29;Priorat;43154;Torroja del Priorat;1;1;U;;124;20;65;87;37;0;1;86;87
17;Girona;19;Garrotxa;17200;Tortellà;1;1;U;;590;245;382;438;152;5;1;432;433
43;Tarragona;9;Baix Ebre;43155;Tortosa;1;1;U;;911;290;432;552;359;7;8;537;545
43;Tarragona;9;Baix Ebre;43155;Tortosa;1;2;U;;512;148;248;327;185;6;4;317;321
43;Tarragona;9;Baix Ebre;43155;Tortosa;1;3;A;;681;195;352;452;229;0;9;443;452
43;Tarragona;9;Baix Ebre;43155;Tortosa;1;3;B;;611;200;320;407;204;2;5;400;405
43;Tarragona;9;Baix Ebre;43155;Tortosa;1;4;A;;646;191;319;420;226;1;9;410;419
43;Tarragona;9;Baix Ebre;43155;Tortosa;1;4;B;;637;166;300;413;224;5;4;404;408
43;Tarragona;9;Baix Ebre;43155;Tortosa;1;5;U;;566;149;249;291;275;1;5;285;290
43;Tarragona;9;Baix Ebre;43155;Tortosa;1;6;A;;528;170;292;370;158;2;11;357;368
43;Tarragona;9;Baix Ebre;43155;Tortosa;1;6;B;;501;146;254;320;181;0;2;318;320
43;Tarragona;9;Baix Ebre;43155;Tortosa;1;7;U;;1197;319;580;782;415;4;12;766;778
43;Tarragona;9;Baix Ebre;43155;Tortosa;2;1;U;;822;188;341;420;402;3;1;416;417
43;Tarragona;9;Baix Ebre;43155;Tortosa;2;2;U;;852;157;345;499;353;1;10;488;498
43;Tarragona;9;Baix Ebre;43155;Tortosa;2;3;A;;737;197;352;452;285;1;8;443;451
43;Tarragona;9;Baix Ebre;43155;Tortosa;2;3;B;;732;156;360;453;279;1;4;448;452
43;Tarragona;9;Baix Ebre;43155;Tortosa;2;4;U;;783;166;330;433;350;0;9;424;433
43;Tarragona;9;Baix Ebre;43155;Tortosa;2;5;U;;888;195;418;580;308;3;6;571;577
43;Tarragona;9;Baix Ebre;43155;Tortosa;3;1;A;;606;141;228;307;299;2;4;301;305
43;Tarragona;9;Baix Ebre;43155;Tortosa;3;1;B;;480;145;212;271;209;0;5;266;271
43;Tarragona;9;Baix Ebre;43155;Tortosa;3;2;U;;989;255;470;605;384;3;8;594;602
43;Tarragona;9;Baix Ebre;43155;Tortosa;3;3;A;;518;125;210;277;241;2;5;270;275
43;Tarragona;9;Baix Ebre;43155;Tortosa;3;3;B;;478;91;187;243;235;1;4;238;242
43;Tarragona;9;Baix Ebre;43155;Tortosa;3;4;A;;555;117;211;315;240;5;4;306;310
43;Tarragona;9;Baix Ebre;43155;Tortosa;3;4;B;;562;128;233;310;252;1;3;306;309
43;Tarragona;9;Baix Ebre;43155;Tortosa;4;1;A;;1020;245;460;609;411;0;14;595;609
43;Tarragona;9;Baix Ebre;43155;Tortosa;4;1;B;;850;238;414;540;310;2;7;531;538
43;Tarragona;9;Baix Ebre;43155;Tortosa;4;2;A;;500;120;251;330;170;3;7;320;327
43;Tarragona;9;Baix Ebre;43155;Tortosa;4;2;B;;429;108;194;260;169;0;10;250;260
43;Tarragona;9;Baix Ebre;43155;Tortosa;4;2;C;;455;126;217;277;178;1;2;274;276
43;Tarragona;9;Baix Ebre;43155;Tortosa;4;3;A;;713;173;288;377;336;4;4;369;373
43;Tarragona;9;Baix Ebre;43155;Tortosa;4;3;B;;649;112;222;318;331;2;3;313;316
43;Tarragona;9;Baix Ebre;43155;Tortosa;4;4;A;;580;134;235;306;274;0;1;305;306
43;Tarragona;9;Baix Ebre;43155;Tortosa;4;4;B;;498;118;198;275;223;3;1;271;272
43;Tarragona;9;Baix Ebre;43155;Tortosa;4;5;U;;938;222;438;591;347;6;4;581;585
43;Tarragona;9;Baix Ebre;43155;Tortosa;4;6;U;;785;198;395;528;257;2;6;520;526
43;Tarragona;9;Baix Ebre;43155;Tortosa;4;7;A;;501;129;254;343;158;0;1;342;343
43;Tarragona;9;Baix Ebre;43155;Tortosa;4;7;B;;261;41;104;150;111;0;0;150;150
17;Girona;31;Ripollès;17201;Toses;1;1;U;;122;37;53;77;45;0;1;76;77
17;Girona;34;Selva;17202;Tossa de Mar;1;1;U;;832;266;485;548;284;3;1;544;545
17;Girona;34;Selva;17202;Tossa de Mar;1;2;U;;881;248;502;611;270;2;7;602;609
17;Girona;34;Selva;17202;Tossa de Mar;1;3;U;;1351;335;760;943;408;4;9;930;939
25;Lleida;25;Pallars Jussà;25234;Tremp;1;1;U;;853;185;439;593;260;7;8;578;586
25;Lleida;25;Pallars Jussà;25234;Tremp;1;2;U;;902;184;437;560;342;0;4;556;560
25;Lleida;25;Pallars Jussà;25234;Tremp;2;1;U;;1105;269;583;740;365;2;7;731;738
25;Lleida;25;Pallars Jussà;25234;Tremp;2;2;U;;1006;196;525;687;319;3;9;675;684
25;Lleida;25;Pallars Jussà;25234;Tremp;3;1;U;;566;73;227;313;253;3;2;308;310
17;Girona;10;Baix Empordà;17204;Ullà;1;1;A;;322;107;223;243;79;4;0;239;239
17;Girona;10;Baix Empordà;17204;Ullà;1;1;B;;264;93;162;187;77;4;2;181;183
8;Barcelona;40;Vallès Occidental;08290;Ullastrell;1;1;U;;813;275;589;692;121;4;8;680;688
17;Girona;10;Baix Empordà;17205;Ullastret;1;1;U;;209;51;121;147;62;0;1;146;147
43;Tarragona;22;Montsià;43156;Ulldecona;1;1;U;;866;251;487;616;250;0;9;607;616
43;Tarragona;22;Montsià;43156;Ulldecona;1;2;A;;772;215;432;560;212;7;7;546;553
43;Tarragona;22;Montsià;43156;Ulldecona;1;2;B;;841;214;458;635;206;4;4;627;631
43;Tarragona;22;Montsià;43156;Ulldecona;2;1;U;;599;188;368;454;145;1;3;450;453
43;Tarragona;22;Montsià;43156;Ulldecona;2;2;U;;706;192;405;512;194;6;5;501;506
43;Tarragona;22;Montsià;43156;Ulldecona;3;1;U;;496;110;241;295;201;0;5;290;295
43;Tarragona;29;Priorat;43157;Ulldemolins;1;1;U;;458;106;226;330;128;0;4;326;330
17;Girona;10;Baix Empordà;17203;Ultramort;1;1;U;;167;66;114;124;43;0;0;124;124
17;Girona;15;Cerdanya;17206;Urús;1;1;U;;126;32;74;90;36;0;1;89;90
8;Barcelona;40;Vallès Occidental;08291;Vacarisses;1;1;A;;658;191;351;407;251;1;6;400;406
8;Barcelona;40;Vallès Occidental;08291;Vacarisses;1;1;B;;705;200;396;453;252;1;5;447;452
17;Girona;2;Alt Empordà;17014;Vajol, la;1;1;U;;79;24;45;58;21;0;1;57;58
8;Barcelona;6;Anoia;08292;Vallbona d'Anoia;1;1;U;;840;257;543;678;162;1;6;671;677
25;Lleida;38;Urgell;25238;Vallbona de les Monges;1;1;U;;268;104;148;184;84;1;1;182;183
8;Barcelona;14;Berguedà;08293;Vallcebre;1;1;U;;235;63;139;169;66;0;1;168;169
43;Tarragona;16;Conca de Barberà;43158;Vallclara;1;1;U;;96;25;60;67;29;2;2;63;65
17;Girona;19;Garrotxa;17207;Vall d'en Bas, la;1;1;A;;828;258;540;621;207;6;4;611;615
17;Girona;19;Garrotxa;17207;Vall d'en Bas, la;1;1;B;;216;73;151;178;38;1;5;172;177
17;Girona;19;Garrotxa;17207;Vall d'en Bas, la;1;2;A;;804;245;496;581;223;2;4;575;579
17;Girona;19;Garrotxa;17207;Vall d'en Bas, la;1;2;B;;241;52;140;181;60;1;1;179;180
17;Girona;19;Garrotxa;17208;Vall de Bianya, la;1;1;A;;435;141;261;307;128;2;4;301;305
17;Girona;19;Garrotxa;17208;Vall de Bianya, la;1;1;B;;456;146;283;347;109;3;11;333;344
25;Lleida;5;Alta Ribagorça;25043;Vall de Boí, la;1;1;U;;650;106;278;361;289;0;4;357;361
25;Lleida;26;Pallars Sobirà;25901;Vall de Cardós;1;1;U;;286;64;146;196;90;0;4;192;196
25;Lleida;23;Noguera;25240;Vallfogona de Balaguer;1;1;A;;757;179;454;571;186;0;5;566;571
25;Lleida;23;Noguera;25240;Vallfogona de Balaguer;1;1;B;;399;85;232;285;114;0;1;284;285
17;Girona;31;Ripollès;17170;Vallfogona de Ripollès;1;1;U;;188;49;115;132;56;0;4;128;132
43;Tarragona;16;Conca de Barberà;43159;Vallfogona de Riucorb;1;1;U;;102;29;69;81;21;3;5;73;78
8;Barcelona;41;Vallès Oriental;08294;Vallgorguina;1;1;A;;561;148;355;413;148;1;2;410;412
8;Barcelona;41;Vallès Oriental;08294;Vallgorguina;1;1;B;;231;62;114;132;99;0;0;132;132
8;Barcelona;11;Baix Llobregat;08295;Vallirana;1;1;A;;637;132;344;415;222;4;3;408;411
8;Barcelona;11;Baix Llobregat;08295;Vallirana;1;1;B;;616;167;343;417;199;1;4;412;416
8;Barcelona;11;Baix Llobregat;08295;Vallirana;1;2;A;;596;146;336;402;194;0;2;400;402
8;Barcelona;11;Baix Llobregat;08295;Vallirana;1;2;B;;602;167;347;414;188;2;3;409;412
8;Barcelona;11;Baix Llobregat;08295;Vallirana;1;3;A;;454;129;256;310;144;0;6;304;310
8;Barcelona;11;Baix Llobregat;08295;Vallirana;1;3;B;;384;91;202;269;115;0;9;260;269
8;Barcelona;11;Baix Llobregat;08295;Vallirana;1;4;A;;952;224;460;539;413;2;7;530;537
8;Barcelona;11;Baix Llobregat;08295;Vallirana;1;4;B;;888;197;389;484;404;0;2;482;484
8;Barcelona;11;Baix Llobregat;08295;Vallirana;1;5;A;;466;110;216;252;214;1;1;250;251
8;Barcelona;11;Baix Llobregat;08295;Vallirana;1;5;B;;412;93;185;213;199;0;1;212;213
17;Girona;10;Baix Empordà;17209;Vall-llobrega;1;1;U;;226;67;157;182;44;0;3;179;182
43;Tarragona;1;Alt Camp;43160;Vallmoll;1;1;A;;403;121;232;306;97;0;1;305;306
43;Tarragona;1;Alt Camp;43160;Vallmoll;1;1;B;;496;85;271;341;155;3;3;335;338
8;Barcelona;41;Vallès Oriental;08296;Vallromanes;1;1;U;;780;214;455;559;221;4;6;549;555
43;Tarragona;1;Alt Camp;43161;Valls;1;1;A;;491;160;250;320;171;0;2;318;320
43;Tarragona;1;Alt Camp;43161;Valls;1;1;B;;487;148;253;303;184;2;1;300;301
43;Tarragona;1;Alt Camp;43161;Valls;2;1;A;;407;125;203;262;145;0;4;258;262
43;Tarragona;1;Alt Camp;43161;Valls;2;1;B;;514;130;233;315;199;0;2;313;315
43;Tarragona;1;Alt Camp;43161;Valls;3;1;A;;761;227;387;513;248;1;6;506;512
43;Tarragona;1;Alt Camp;43161;Valls;3;1;B;;918;251;430;570;348;4;6;560;566
43;Tarragona;1;Alt Camp;43161;Valls;4;1;U;;905;315;536;674;231;0;5;669;674
43;Tarragona;1;Alt Camp;43161;Valls;4;2;A;;919;250;485;591;328;7;9;575;584
43;Tarragona;1;Alt Camp;43161;Valls;4;2;B;;385;152;266;298;87;0;3;295;298
43;Tarragona;1;Alt Camp;43161;Valls;4;3;U;;680;142;271;373;307;0;1;372;373
43;Tarragona;1;Alt Camp;43161;Valls;5;1;A;;557;164;324;398;159;5;7;386;393
43;Tarragona;1;Alt Camp;43161;Valls;5;1;B;;562;181;317;410;152;4;4;402;406
43;Tarragona;1;Alt Camp;43161;Valls;5;1;C;;723;235;445;547;176;0;10;537;547
43;Tarragona;1;Alt Camp;43161;Valls;5;2;A;;565;152;305;403;162;1;1;401;402
43;Tarragona;1;Alt Camp;43161;Valls;5;2;B;;543;143;273;374;169;0;4;370;374
43;Tarragona;1;Alt Camp;43161;Valls;5;2;C;;652;150;332;458;194;3;5;450;455
43;Tarragona;1;Alt Camp;43161;Valls;5;3;U;;782;143;318;428;354;0;3;425;428
43;Tarragona;1;Alt Camp;43161;Valls;6;1;A;;811;200;404;510;301;1;5;504;509
43;Tarragona;1;Alt Camp;43161;Valls;6;1;B;;971;247;461;596;375;0;3;593;596
43;Tarragona;1;Alt Camp;43161;Valls;6;2;U;;959;250;570;722;237;2;9;711;720
43;Tarragona;1;Alt Camp;43161;Valls;6;3;U;;658;190;388;502;156;1;5;496;501
43;Tarragona;1;Alt Camp;43161;Valls;6;4;U;;913;273;473;589;324;2;9;578;587
43;Tarragona;1;Alt Camp;43161;Valls;6;5;U;;1081;301;603;769;312;5;9;755;764
25;Lleida;4;Alt Urgell;25906;Valls d'Aguilar, les;1;1;U;;222;56;109;136;86;2;1;133;134
25;Lleida;4;Alt Urgell;25239;Valls de Valira, les;1;1;U;;645;94;250;308;337;0;2;306;308
43;Tarragona;8;Baix Camp;43162;Vandellòs i l'Hospitalet de l'Infant;1;1;U;;883;270;515;648;235;3;1;644;645
43;Tarragona;8;Baix Camp;43162;Vandellòs i l'Hospitalet de l'Infant;1;2;A;;904;185;420;541;363;6;7;528;535
43;Tarragona;8;Baix Camp;43162;Vandellòs i l'Hospitalet de l'Infant;1;2;B;;928;190;440;545;383;5;11;529;540
43;Tarragona;8;Baix Camp;43162;Vandellòs i l'Hospitalet de l'Infant;1;3;U;;881;248;460;593;288;2;7;584;591
25;Lleida;4;Alt Urgell;25909;Vansa i Fórnols, la;1;1;U;;143;16;50;65;78;0;0;65;65
8;Barcelona;6;Anoia;08297;Veciana;1;1;U;;146;50;92;109;37;0;0;109;109
43;Tarragona;12;Baix Penedès;43163;Vendrell, el;1;1;A;;639;186;356;439;200;0;4;435;439
43;Tarragona;12;Baix Penedès;43163;Vendrell, el;1;1;B;;670;198;371;463;207;2;3;458;461
43;Tarragona;12;Baix Penedès;43163;Vendrell, el;1;2;U;;879;271;477;582;297;5;4;573;577
43;Tarragona;12;Baix Penedès;43163;Vendrell, el;2;1;U;;850;258;466;560;290;4;5;551;556
43;Tarragona;12;Baix Penedès;43163;Vendrell, el;2;2;A;;542;126;273;364;178;1;3;360;363
43;Tarragona;12;Baix Penedès;43163;Vendrell, el;2;2;B;;747;194;359;460;287;3;2;455;457
43;Tarragona;12;Baix Penedès;43163;Vendrell, el;2;3;A;;521;155;237;293;228;0;5;288;293
43;Tarragona;12;Baix Penedès;43163;Vendrell, el;2;3;B;;661;229;330;412;249;2;0;410;410
43;Tarragona;12;Baix Penedès;43163;Vendrell, el;2;4;U;;1152;270;491;630;522;2;5;623;628
43;Tarragona;12;Baix Penedès;43163;Vendrell, el;3;1;A;;842;207;424;590;252;1;6;583;589
43;Tarragona;12;Baix Penedès;43163;Vendrell, el;3;1;B;;1055;229;564;736;319;1;6;729;735
43;Tarragona;12;Baix Penedès;43163;Vendrell, el;3;2;A;;954;201;440;561;393;1;9;551;560
43;Tarragona;12;Baix Penedès;43163;Vendrell, el;3;2;B;;1090;205;524;675;415;7;9;659;668
43;Tarragona;12;Baix Penedès;43163;Vendrell, el;3;3;A;;957;231;459;539;418;3;7;529;536
43;Tarragona;12;Baix Penedès;43163;Vendrell, el;3;3;B;;1085;265;507;608;477;1;5;602;607
43;Tarragona;12;Baix Penedès;43163;Vendrell, el;3;4;U;;1411;300;723;928;483;9;13;906;919
17;Girona;2;Alt Empordà;17210;Ventalló;1;1;U;;457;136;271;330;127;1;5;324;329
25;Lleida;38;Urgell;25242;Verdú;1;1;U;;814;228;447;562;252;2;8;552;560
17;Girona;10;Baix Empordà;17211;Verges;1;1;U;;890;290;590;681;209;7;4;670;674
43;Tarragona;36;Tarragonès;43164;Vespella de Gaià;1;1;U;;131;45;80;97;34;2;0;95;95
8;Barcelona;24;Osona;08298;Vic;1;1;U;;593;181;351;406;187;1;0;405;405
8;Barcelona;24;Osona;08298;Vic;1;2;U;;785;212;400;495;290;5;1;489;490
8;Barcelona;24;Osona;08298;Vic;1;3;U;;634;228;373;462;172;3;1;458;459
8;Barcelona;24;Osona;08298;Vic;2;1;U;;742;249;407;517;225;4;5;508;513
8;Barcelona;24;Osona;08298;Vic;2;2;A;;846;210;491;616;230;0;4;612;616
8;Barcelona;24;Osona;08298;Vic;2;2;B;;1021;260;616;787;234;0;3;784;787
8;Barcelona;24;Osona;08298;Vic;2;3;A;;708;209;412;494;214;4;7;483;490
8;Barcelona;24;Osona;08298;Vic;2;3;B;;884;252;517;624;260;0;0;624;624
8;Barcelona;24;Osona;08298;Vic;2;4;A;;714;212;440;507;207;0;6;501;507
8;Barcelona;24;Osona;08298;Vic;2;4;B;;948;268;587;681;267;2;2;677;679
8;Barcelona;24;Osona;08298;Vic;3;1;A;;617;180;388;475;142;0;3;472;475
8;Barcelona;24;Osona;08298;Vic;3;1;B;;606;177;374;463;143;1;3;459;462
8;Barcelona;24;Osona;08298;Vic;3;10;U;;502;141;275;346;156;0;1;345;346
8;Barcelona;24;Osona;08298;Vic;3;11;A;;559;155;297;359;200;1;2;356;358
8;Barcelona;24;Osona;08298;Vic;3;11;B;;520;158;287;343;177;2;3;338;341
8;Barcelona;24;Osona;08298;Vic;3;2;U;;886;297;546;606;280;2;4;600;604
8;Barcelona;24;Osona;08298;Vic;3;3;A;;681;161;361;468;213;0;2;466;468
8;Barcelona;24;Osona;08298;Vic;3;3;B;;877;226;487;582;295;1;8;573;581
8;Barcelona;24;Osona;08298;Vic;3;4;U;;819;246;491;589;230;0;2;587;589
8;Barcelona;24;Osona;08298;Vic;3;5;A;;633;143;316;400;233;0;6;394;400
8;Barcelona;24;Osona;08298;Vic;3;5;B;;706;176;405;482;224;0;4;478;482
8;Barcelona;24;Osona;08298;Vic;3;6;A;;539;144;307;358;181;0;1;357;358
8;Barcelona;24;Osona;08298;Vic;3;6;B;;630;166;371;421;209;0;4;417;421
8;Barcelona;24;Osona;08298;Vic;3;7;A;;655;190;397;500;155;2;2;496;498
8;Barcelona;24;Osona;08298;Vic;3;7;B;;759;236;456;576;183;1;5;570;575
8;Barcelona;24;Osona;08298;Vic;3;8;A;;619;128;304;393;226;1;2;390;392
8;Barcelona;24;Osona;08298;Vic;3;8;B;;661;135;345;401;260;2;2;397;399
8;Barcelona;24;Osona;08298;Vic;3;9;U;;723;189;423;531;192;2;7;522;529
8;Barcelona;24;Osona;08298;Vic;4;1;A;;664;215;388;465;199;1;2;462;464
8;Barcelona;24;Osona;08298;Vic;4;1;B;;753;214;429;502;251;1;2;499;501
8;Barcelona;24;Osona;08298;Vic;4;2;A;;578;169;350;421;157;0;4;417;421
8;Barcelona;24;Osona;08298;Vic;4;2;B;;816;198;469;573;243;0;4;569;573
8;Barcelona;24;Osona;08298;Vic;4;3;A;;640;171;360;438;202;0;2;436;438
8;Barcelona;24;Osona;08298;Vic;4;3;B;;937;238;502;594;343;0;5;589;594
8;Barcelona;24;Osona;08298;Vic;5;1;U;;533;110;302;386;147;0;6;380;386
17;Girona;24;Osona;17212;Vidrà;1;1;U;;145;33;66;99;46;0;1;98;99
17;Girona;34;Selva;17213;Vidreres;1;1;A;;671;137;393;468;203;1;1;466;467
17;Girona;34;Selva;17213;Vidreres;1;1;B;;691;176;388;510;181;2;4;504;508
17;Girona;34;Selva;17213;Vidreres;1;2;U;;772;185;434;559;213;4;3;552;555
17;Girona;34;Selva;17213;Vidreres;1;3;A;;566;102;259;359;207;4;4;351;355
17;Girona;34;Selva;17213;Vidreres;1;3;B;;593;132;260;354;239;4;1;349;350
25;Lleida;39;Consell General d'Aran;25243;Vielha e Mijaran;1;1;A;;864;186;403;514;350;1;5;508;513
25;Lleida;39;Consell General d'Aran;25243;Vielha e Mijaran;1;1;B;;939;201;449;571;368;2;2;567;569
25;Lleida;39;Consell General d'Aran;25243;Vielha e Mijaran;1;2;A;;321;52;134;200;121;0;0;200;200
25;Lleida;39;Consell General d'Aran;25243;Vielha e Mijaran;1;2;B;;391;63;163;191;200;0;1;190;191
25;Lleida;39;Consell General d'Aran;25243;Vielha e Mijaran;1;2;C;;368;53;155;197;171;1;2;194;196
43;Tarragona;1;Alt Camp;43165;Vilabella;1;1;U;;671;182;430;531;140;4;7;520;527
17;Girona;2;Alt Empordà;17214;Vilabertran;1;1;U;;663;165;390;467;196;3;5;459;464
17;Girona;20;Gironès;17215;Vilablareix;1;1;U;;973;297;593;733;240;2;6;725;731
8;Barcelona;14;Berguedà;08299;Vilada;1;1;U;;472;147;298;341;131;1;0;340;340
17;Girona;2;Alt Empordà;17217;Viladamat;1;1;U;;330;130;244;268;62;0;2;266;268
17;Girona;20;Gironès;17216;Viladasens;1;1;U;;151;67;104;119;32;0;0;119;119
8;Barcelona;11;Baix Llobregat;08301;Viladecans;1;1;A;;836;187;360;448;388;0;2;446;448
8;Barcelona;11;Baix Llobregat;08301;Viladecans;1;1;B;;1017;223;443;557;460;0;2;555;557
8;Barcelona;11;Baix Llobregat;08301;Viladecans;1;10;A;;588;157;284;329;259;0;3;326;329
8;Barcelona;11;Baix Llobregat;08301;Viladecans;1;10;B;;678;151;328;381;297;0;0;381;381
8;Barcelona;11;Baix Llobregat;08301;Viladecans;1;11;U;;889;212;454;549;340;4;4;541;545
8;Barcelona;11;Baix Llobregat;08301;Viladecans;1;12;U;;759;150;320;440;319;0;8;432;440
8;Barcelona;11;Baix Llobregat;08301;Viladecans;1;13;U;;771;140;336;435;336;2;3;430;433
8;Barcelona;11;Baix Llobregat;08301;Viladecans;1;2;A;;586;138;264;318;268;0;3;315;318
8;Barcelona;11;Baix Llobregat;08301;Viladecans;1;2;B;;744;168;305;376;368;1;1;374;375
8;Barcelona;11;Baix Llobregat;08301;Viladecans;1;3;A;;652;176;329;409;243;1;4;404;408
8;Barcelona;11;Baix Llobregat;08301;Viladecans;1;3;B;;725;164;336;433;292;1;6;426;432
8;Barcelona;11;Baix Llobregat;08301;Viladecans;1;4;A;;599;121;272;343;256;1;5;337;342
8;Barcelona;11;Baix Llobregat;08301;Viladecans;1;4;B;;703;175;350;417;286;5;4;408;412
8;Barcelona;11;Baix Llobregat;08301;Viladecans;1;5;U;;582;142;288;365;217;1;6;358;364
8;Barcelona;11;Baix Llobregat;08301;Viladecans;1;6;A;;638;150;302;369;269;0;3;366;369
8;Barcelona;11;Baix Llobregat;08301;Viladecans;1;6;B;;759;165;350;447;312;0;2;445;447
8;Barcelona;11;Baix Llobregat;08301;Viladecans;1;7;A;;538;119;246;309;229;2;2;305;307
8;Barcelona;11;Baix Llobregat;08301;Viladecans;1;7;B;;591;124;271;356;235;0;1;355;356
8;Barcelona;11;Baix Llobregat;08301;Viladecans;1;8;A;;746;191;372;445;301;0;2;443;445
8;Barcelona;11;Baix Llobregat;08301;Viladecans;1;8;B;;975;209;449;529;446;4;8;517;525
8;Barcelona;11;Baix Llobregat;08301;Viladecans;1;9;U;;929;185;425;537;392;0;5;532;537
8;Barcelona;11;Baix Llobregat;08301;Viladecans;2;1;A;;604;185;320;365;239;0;1;364;365
8;Barcelona;11;Baix Llobregat;08301;Viladecans;2;1;B;;789;204;370;445;344;0;1;444;445
8;Barcelona;11;Baix Llobregat;08301;Viladecans;2;10;A;;559;118;227;283;276;1;1;281;282
8;Barcelona;11;Baix Llobregat;08301;Viladecans;2;10;B;;702;143;249;357;345;0;3;354;357
8;Barcelona;11;Baix Llobregat;08301;Viladecans;2;11;A;;728;150;297;354;374;0;3;351;354
8;Barcelona;11;Baix Llobregat;08301;Viladecans;2;11;B;;829;135;323;391;438;0;3;388;391
8;Barcelona;11;Baix Llobregat;08301;Viladecans;2;12;A;;632;103;261;325;307;0;4;321;325
8;Barcelona;11;Baix Llobregat;08301;Viladecans;2;12;B;;649;125;274;335;314;0;3;332;335
8;Barcelona;11;Baix Llobregat;08301;Viladecans;2;13;A;;591;117;247;322;269;0;3;319;322
8;Barcelona;11;Baix Llobregat;08301;Viladecans;2;13;B;;729;145;294;375;354;0;2;373;375
8;Barcelona;11;Baix Llobregat;08301;Viladecans;2;14;U;;810;107;286;340;470;0;1;339;340
8;Barcelona;11;Baix Llobregat;08301;Viladecans;2;15;A;;733;138;291;359;374;2;2;355;357
8;Barcelona;11;Baix Llobregat;08301;Viladecans;2;15;B;;836;134;280;387;449;1;6;380;386
8;Barcelona;11;Baix Llobregat;08301;Viladecans;2;16;A;;733;148;342;434;299;2;4;428;432
8;Barcelona;11;Baix Llobregat;08301;Viladecans;2;16;B;;859;170;370;471;388;0;9;462;471
8;Barcelona;11;Baix Llobregat;08301;Viladecans;2;17;A;;811;162;363;454;357;0;1;453;454
8;Barcelona;11;Baix Llobregat;08301;Viladecans;2;17;B;;973;204;415;496;477;0;5;491;496
8;Barcelona;11;Baix Llobregat;08301;Viladecans;2;18;U;;981;159;377;459;522;0;10;449;459
8;Barcelona;11;Baix Llobregat;08301;Viladecans;2;19;U;;706;135;284;343;363;3;6;334;340
8;Barcelona;11;Baix Llobregat;08301;Viladecans;2;2;U;;861;137;321;391;470;2;1;388;389
8;Barcelona;11;Baix Llobregat;08301;Viladecans;2;3;A;;941;201;450;547;394;1;8;538;546
8;Barcelona;11;Baix Llobregat;08301;Viladecans;2;3;B;;1246;241;564;727;519;2;10;715;725
8;Barcelona;11;Baix Llobregat;08301;Viladecans;2;4;U;;866;167;340;423;443;1;4;418;422
8;Barcelona;11;Baix Llobregat;08301;Viladecans;2;5;A;;679;138;334;417;262;1;0;416;416
8;Barcelona;11;Baix Llobregat;08301;Viladecans;2;5;B;;891;182;447;552;339;3;10;539;549
8;Barcelona;11;Baix Llobregat;08301;Viladecans;2;6;A;;539;108;212;274;265;0;1;273;274
8;Barcelona;11;Baix Llobregat;08301;Viladecans;2;6;B;;746;168;330;411;335;3;4;404;408
8;Barcelona;11;Baix Llobregat;08301;Viladecans;2;6;C;;740;155;316;387;353;0;0;387;387
8;Barcelona;11;Baix Llobregat;08301;Viladecans;2;7;A;;550;130;240;297;253;1;1;295;296
8;Barcelona;11;Baix Llobregat;08301;Viladecans;2;7;B;;662;151;415;361;301;2;4;355;359
8;Barcelona;11;Baix Llobregat;08301;Viladecans;2;8;A;;716;117;274;367;349;1;3;363;366
8;Barcelona;11;Baix Llobregat;08301;Viladecans;2;8;B;;923;175;390;500;423;1;3;496;499
8;Barcelona;11;Baix Llobregat;08301;Viladecans;2;9;A;;624;110;223;285;339;0;4;281;285
8;Barcelona;11;Baix Llobregat;08301;Viladecans;2;9;B;;687;112;242;302;385;2;2;298;300
8;Barcelona;40;Vallès Occidental;08300;Viladecavalls;1;1;A;;705;240;422;514;191;0;10;504;514
8;Barcelona;40;Vallès Occidental;08300;Viladecavalls;1;1;B;;818;225;459;583;235;2;7;574;581
8;Barcelona;40;Vallès Occidental;08300;Viladecavalls;1;2;A;;856;189;361;472;384;3;6;463;469
8;Barcelona;40;Vallès Occidental;08300;Viladecavalls;1;2;B;;1078;199;431;588;490;7;2;579;581
17;Girona;28;Pla de l'Estany;17218;Vilademuls;1;1;A;;298;85;170;194;104;0;1;193;194
17;Girona;28;Pla de l'Estany;17218;Vilademuls;1;1;B;;337;122;213;244;93;0;1;243;244
17;Girona;24;Osona;17220;Viladrau;1;1;U;;729;252;451;543;186;3;4;536;540
17;Girona;2;Alt Empordà;17221;Vilafant;1;1;A;;684;183;419;476;208;5;4;467;471
17;Girona;2;Alt Empordà;17221;Vilafant;1;1;B;;572;144;321;354;218;0;0;354;354
17;Girona;2;Alt Empordà;17221;Vilafant;1;2;U;;1216;315;677;872;344;1;5;866;871
8;Barcelona;3;Alt Penedès;08305;Vilafranca del Penedès;1;1;A;;691;204;364;446;245;0;2;444;446
8;Barcelona;3;Alt Penedès;08305;Vilafranca del Penedès;1;1;B;;923;245;467;595;328;0;2;593;595
8;Barcelona;3;Alt Penedès;08305;Vilafranca del Penedès;1;2;A;;840;220;459;556;284;0;9;547;556
8;Barcelona;3;Alt Penedès;08305;Vilafranca del Penedès;1;2;B;;942;245;500;615;327;4;6;605;611
8;Barcelona;3;Alt Penedès;08305;Vilafranca del Penedès;2;1;A;;738;181;345;445;293;1;2;442;444
8;Barcelona;3;Alt Penedès;08305;Vilafranca del Penedès;2;1;B;;895;237;442;558;337;2;4;552;556
8;Barcelona;3;Alt Penedès;08305;Vilafranca del Penedès;2;2;A;;465;90;209;276;189;1;2;273;275
8;Barcelona;3;Alt Penedès;08305;Vilafranca del Penedès;2;2;B;;629;152;297;391;238;1;2;388;390
8;Barcelona;3;Alt Penedès;08305;Vilafranca del Penedès;2;3;A;;547;154;279;356;191;0;1;355;356
8;Barcelona;3;Alt Penedès;08305;Vilafranca del Penedès;2;3;B;;616;180;323;397;219;3;3;391;394
8;Barcelona;3;Alt Penedès;08305;Vilafranca del Penedès;2;4;A;;637;167;330;397;240;0;3;394;397
8;Barcelona;3;Alt Penedès;08305;Vilafranca del Penedès;2;4;B;;734;204;407;494;240;5;2;487;489
8;Barcelona;3;Alt Penedès;08305;Vilafranca del Penedès;2;5;A;;592;151;324;417;175;0;2;415;417
8;Barcelona;3;Alt Penedès;08305;Vilafranca del Penedès;2;5;B;;762;240;432;546;216;2;7;537;544
8;Barcelona;3;Alt Penedès;08305;Vilafranca del Penedès;2;6;A;;610;141;291;360;250;3;3;354;357
8;Barcelona;3;Alt Penedès;08305;Vilafranca del Penedès;2;6;B;;786;159;358;466;320;2;5;459;464
8;Barcelona;3;Alt Penedès;08305;Vilafranca del Penedès;3;1;A;;837;225;431;551;286;1;5;545;550
8;Barcelona;3;Alt Penedès;08305;Vilafranca del Penedès;3;1;B;;690;174;342;440;250;2;1;437;438
8;Barcelona;3;Alt Penedès;08305;Vilafranca del Penedès;3;1;C;;462;128;235;292;170;1;1;290;291
8;Barcelona;3;Alt Penedès;08305;Vilafranca del Penedès;3;2;U;;778;199;468;562;216;0;4;558;562
8;Barcelona;3;Alt Penedès;08305;Vilafranca del Penedès;3;3;A;;761;188;374;460;301;0;2;458;460
8;Barcelona;3;Alt Penedès;08305;Vilafranca del Penedès;3;3;B;;917;238;470;591;326;1;2;588;590
8;Barcelona;3;Alt Penedès;08305;Vilafranca del Penedès;4;1;A;;592;155;339;431;161;0;3;428;431
8;Barcelona;3;Alt Penedès;08305;Vilafranca del Penedès;4;1;B;;675;169;354;462;213;0;6;456;462
8;Barcelona;3;Alt Penedès;08305;Vilafranca del Penedès;4;2;A;;621;190;332;428;193;3;5;420;425
8;Barcelona;3;Alt Penedès;08305;Vilafranca del Penedès;4;2;B;;770;240;439;545;225;2;4;539;543
8;Barcelona;3;Alt Penedès;08305;Vilafranca del Penedès;4;3;A;;723;188;416;504;219;0;5;499;504
8;Barcelona;3;Alt Penedès;08305;Vilafranca del Penedès;4;3;B;;809;200;435;566;243;3;3;560;563
8;Barcelona;3;Alt Penedès;08305;Vilafranca del Penedès;4;4;A;;597;152;340;422;175;0;6;416;422
8;Barcelona;3;Alt Penedès;08305;Vilafranca del Penedès;4;4;B;;705;203;392;506;199;9;1;496;497
8;Barcelona;3;Alt Penedès;08305;Vilafranca del Penedès;4;5;U;;601;176;322;418;183;3;1;414;415
8;Barcelona;3;Alt Penedès;08305;Vilafranca del Penedès;4;6;U;;955;308;578;713;242;0;4;709;713
25;Lleida;38;Urgell;25244;Vilagrassa;1;1;U;;356;90;208;273;83;0;1;272;273
17;Girona;2;Alt Empordà;17223;Vilajuïga;1;1;U;;606;224;386;462;144;0;1;461;462
43;Tarragona;37;Terra Alta;43175;Vilalba dels Arcs;1;1;U;;679;162;384;505;174;2;5;498;503
8;Barcelona;41;Vallès Oriental;08306;Vilalba Sasserra;1;1;U;;267;60;155;200;67;0;1;199;200
25;Lleida;5;Alta Ribagorça;25245;Vilaller;1;1;U;;522;138;282;342;180;0;3;339;342
43;Tarragona;36;Tarragonès;43166;Vilallonga del Camp;1;1;U;;978;202;546;689;289;2;10;677;687
17;Girona;31;Ripollès;17224;Vilallonga de Ter;1;1;U;;364;129;257;311;53;1;1;309;310
17;Girona;2;Alt Empordà;17225;Vilamacolum;1;1;U;;211;45;121;141;70;0;1;140;141
17;Girona;2;Alt Empordà;17226;Vilamalla;1;1;U;;598;111;306;370;228;0;1;369;370
17;Girona;2;Alt Empordà;17227;Vilamaniscle;1;1;U;;101;40;65;81;20;0;0;81;81
25;Lleida;39;Consell General d'Aran;25247;Vilamòs;1;1;U;;101;18;43;54;47;0;0;54;54
17;Girona;2;Alt Empordà;17228;Vilanant;1;1;U;;208;51;118;135;73;0;1;134;135
43;Tarragona;8;Baix Camp;43167;Vilanova d'Escornalbou;1;1;U;;349;90;208;268;81;0;1;267;268
25;Lleida;27;Pla d'Urgell;25248;Vilanova de Bellpuig;1;1;U;;993;243;576;773;220;4;4;765;769
25;Lleida;23;Noguera;25249;Vilanova de l'Aguda;1;1;U;;250;47;142;168;82;0;0;168;168
25;Lleida;33;Segrià;25254;Vilanova de la Barca;1;1;U;;796;211;455;550;246;6;0;544;544
8;Barcelona;6;Anoia;08302;Vilanova del Camí;1;1;A;;643;166;280;367;276;0;3;364;367
8;Barcelona;6;Anoia;08302;Vilanova del Camí;1;1;B;;718;190;327;417;301;0;2;415;417
8;Barcelona;6;Anoia;08302;Vilanova del Camí;1;2;A;;769;162;307;424;345;0;1;423;424
8;Barcelona;6;Anoia;08302;Vilanova del Camí;1;2;B;;800;183;355;451;349;0;6;445;451
8;Barcelona;6;Anoia;08302;Vilanova del Camí;1;3;A;;632;114;254;355;277;1;4;350;354
8;Barcelona;6;Anoia;08302;Vilanova del Camí;1;3;B;;730;118;313;398;332;1;2;395;397
8;Barcelona;6;Anoia;08302;Vilanova del Camí;1;4;A;;784;170;352;452;332;0;4;448;452
8;Barcelona;6;Anoia;08302;Vilanova del Camí;1;4;B;;850;195;380;497;353;0;7;490;497
8;Barcelona;6;Anoia;08302;Vilanova del Camí;1;5;A;;785;190;357;434;351;2;0;432;432
8;Barcelona;6;Anoia;08302;Vilanova del Camí;1;5;B;;805;164;346;447;358;0;1;446;447
8;Barcelona;41;Vallès Oriental;08902;Vilanova del Vallès;1;1;A;;714;205;371;489;225;1;5;483;488
8;Barcelona;41;Vallès Oriental;08902;Vilanova del Vallès;1;1;B;;763;205;408;502;261;4;2;496;498
25;Lleida;23;Noguera;25250;Vilanova de Meià;1;1;U;;441;77;240;288;153;2;1;285;286
43;Tarragona;16;Conca de Barberà;43168;Vilanova de Prades;1;1;U;;139;37;69;93;46;1;0;92;92
8;Barcelona;24;Osona;08303;Vilanova de Sau;1;1;U;;250;95;180;196;54;0;6;190;196
25;Lleida;33;Segrià;25251;Vilanova de Segrià;1;1;U;;576;135;364;418;158;1;4;413;417
8;Barcelona;17;Garraf;08307;Vilanova i la Geltrú;1;1;A;;763;216;392;499;264;2;0;497;497
8;Barcelona;17;Garraf;08307;Vilanova i la Geltrú;1;1;B;;844;218;437;546;298;1;1;544;545
8;Barcelona;17;Garraf;08307;Vilanova i la Geltrú;1;2;A;;810;217;430;538;272;2;3;533;536
8;Barcelona;17;Garraf;08307;Vilanova i la Geltrú;1;2;B;;894;250;506;627;267;0;2;625;627
8;Barcelona;17;Garraf;08307;Vilanova i la Geltrú;1;3;A;;815;212;428;541;274;1;7;533;540
8;Barcelona;17;Garraf;08307;Vilanova i la Geltrú;1;3;B;;934;240;523;631;303;2;6;623;629
8;Barcelona;17;Garraf;08307;Vilanova i la Geltrú;1;4;U;;794;248;455;550;244;1;4;545;549
8;Barcelona;17;Garraf;08307;Vilanova i la Geltrú;1;5;U;;823;310;483;587;236;0;6;581;587
8;Barcelona;17;Garraf;08307;Vilanova i la Geltrú;1;6;A;;587;163;321;416;171;3;3;410;413
8;Barcelona;17;Garraf;08307;Vilanova i la Geltrú;1;6;B;;694;184;349;442;252;0;3;439;442
8;Barcelona;17;Garraf;08307;Vilanova i la Geltrú;1;7;A;;634;193;334;407;227;0;6;401;407
8;Barcelona;17;Garraf;08307;Vilanova i la Geltrú;1;7;B;;758;200;360;458;300;0;5;453;458
8;Barcelona;17;Garraf;08307;Vilanova i la Geltrú;1;8;A;;711;182;352;445;266;5;3;437;440
8;Barcelona;17;Garraf;08307;Vilanova i la Geltrú;1;8;B;;766;203;389;495;271;1;4;490;494
8;Barcelona;17;Garraf;08307;Vilanova i la Geltrú;1;9;A;;784;212;376;459;325;2;4;453;457
8;Barcelona;17;Garraf;08307;Vilanova i la Geltrú;1;9;B;;845;213;406;506;339;0;6;500;506
8;Barcelona;17;Garraf;08307;Vilanova i la Geltrú;2;1;A;;648;178;372;450;198;1;5;444;449
8;Barcelona;17;Garraf;08307;Vilanova i la Geltrú;2;1;B;;726;189;391;481;245;1;4;476;480
8;Barcelona;17;Garraf;08307;Vilanova i la Geltrú;2;2;A;;833;207;405;535;298;0;6;529;535
8;Barcelona;17;Garraf;08307;Vilanova i la Geltrú;2;2;B;;881;211;443;563;318;0;5;558;563
8;Barcelona;17;Garraf;08307;Vilanova i la Geltrú;2;3;U;;892;263;493;588;304;2;5;581;586
8;Barcelona;17;Garraf;08307;Vilanova i la Geltrú;2;4;A;;762;223;435;514;248;3;7;504;511
8;Barcelona;17;Garraf;08307;Vilanova i la Geltrú;2;4;B;;900;264;485;574;326;0;5;569;574
8;Barcelona;17;Garraf;08307;Vilanova i la Geltrú;2;5;U;;499;111;209;250;249;2;0;248;248
8;Barcelona;17;Garraf;08307;Vilanova i la Geltrú;2;6;A;;638;175;322;413;225;0;2;411;413
8;Barcelona;17;Garraf;08307;Vilanova i la Geltrú;2;6;B;;688;173;339;418;270;0;1;417;418
8;Barcelona;17;Garraf;08307;Vilanova i la Geltrú;2;7;A;;813;220;393;474;339;2;2;470;472
8;Barcelona;17;Garraf;08307;Vilanova i la Geltrú;2;7;B;;939;237;399;503;436;0;8;495;503
8;Barcelona;17;Garraf;08307;Vilanova i la Geltrú;3;1;U;;583;168;327;382;201;2;1;379;380
8;Barcelona;17;Garraf;08307;Vilanova i la Geltrú;3;2;U;;873;296;487;584;289;5;4;575;579
8;Barcelona;17;Garraf;08307;Vilanova i la Geltrú;3;3;U;;765;220;403;472;293;1;4;467;471
8;Barcelona;17;Garraf;08307;Vilanova i la Geltrú;3;4;A;;605;193;329;377;228;0;3;374;377
8;Barcelona;17;Garraf;08307;Vilanova i la Geltrú;3;4;B;;644;183;326;375;269;0;2;373;375
8;Barcelona;17;Garraf;08307;Vilanova i la Geltrú;3;5;U;;1043;243;466;584;459;1;9;574;583
8;Barcelona;17;Garraf;08307;Vilanova i la Geltrú;4;1;A;;476;143;262;330;146;1;4;325;329
8;Barcelona;17;Garraf;08307;Vilanova i la Geltrú;4;1;B;;523;176;302;360;163;0;2;358;360
8;Barcelona;17;Garraf;08307;Vilanova i la Geltrú;4;10;A;;640;147;306;373;267;0;4;369;373
8;Barcelona;17;Garraf;08307;Vilanova i la Geltrú;4;10;B;;790;190;403;505;285;4;4;497;501
8;Barcelona;17;Garraf;08307;Vilanova i la Geltrú;4;11;A;;719;147;309;383;336;0;4;379;383
8;Barcelona;17;Garraf;08307;Vilanova i la Geltrú;4;11;B;;918;172;373;507;411;2;4;501;505
8;Barcelona;17;Garraf;08307;Vilanova i la Geltrú;4;2;U;;696;212;386;462;234;1;5;456;461
8;Barcelona;17;Garraf;08307;Vilanova i la Geltrú;4;3;A;;557;141;242;303;254;3;2;298;300
8;Barcelona;17;Garraf;08307;Vilanova i la Geltrú;4;3;B;;697;170;287;361;336;0;0;361;361
8;Barcelona;17;Garraf;08307;Vilanova i la Geltrú;4;4;A;;710;210;352;427;283;1;3;423;426
8;Barcelona;17;Garraf;08307;Vilanova i la Geltrú;4;4;B;;923;266;460;554;369;2;5;547;552
8;Barcelona;17;Garraf;08307;Vilanova i la Geltrú;4;5;U;;775;202;400;477;298;1;4;472;476
8;Barcelona;17;Garraf;08307;Vilanova i la Geltrú;4;6;A;;697;199;362;455;242;1;2;452;454
8;Barcelona;17;Garraf;08307;Vilanova i la Geltrú;4;6;B;;944;248;479;582;362;0;0;582;582
8;Barcelona;17;Garraf;08307;Vilanova i la Geltrú;4;7;A;;682;151;292;374;308;1;1;372;373
8;Barcelona;17;Garraf;08307;Vilanova i la Geltrú;4;7;B;;649;133;300;377;272;0;1;376;377
8;Barcelona;17;Garraf;08307;Vilanova i la Geltrú;4;8;U;;834;209;398;483;351;0;4;479;483
8;Barcelona;17;Garraf;08307;Vilanova i la Geltrú;4;9;U;;974;231;540;655;319;3;6;646;652
43;Tarragona;8;Baix Camp;43169;Vilaplana;1;1;U;;447;89;264;349;98;3;4;342;346
43;Tarragona;1;Alt Camp;43170;Vila-rodona;1;1;U;;849;166;496;633;216;2;6;625;631
17;Girona;2;Alt Empordà;17230;Vila-sacra;1;1;U;;316;93;197;227;89;0;3;224;227
25;Lleida;27;Pla d'Urgell;25252;Vila-sana;1;1;U;;450;142;276;319;131;0;0;319;319
43;Tarragona;36;Tarragonès;43171;Vila-seca;1;1;A;;736;233;427;520;216;2;4;514;518
43;Tarragona;36;Tarragonès;43171;Vila-seca;1;1;B;;468;121;234;282;186;0;0;282;282
43;Tarragona;36;Tarragonès;43171;Vila-seca;1;2;A;;530;131;250;331;199;0;1;330;331
43;Tarragona;36;Tarragonès;43171;Vila-seca;1;2;B;;773;166;361;495;278;6;1;488;489
43;Tarragona;36;Tarragonès;43171;Vila-seca;1;3;A;;397;104;180;248;149;0;3;245;248
43;Tarragona;36;Tarragonès;43171;Vila-seca;1;3;B;;533;138;261;344;189;0;2;342;344
43;Tarragona;36;Tarragonès;43171;Vila-seca;1;4;A;;377;141;231;290;87;0;6;284;290
43;Tarragona;36;Tarragonès;43171;Vila-seca;1;4;B;;469;165;273;334;135;2;1;331;332
43;Tarragona;36;Tarragonès;43171;Vila-seca;1;5;A;;570;157;298;389;181;0;0;389;389
43;Tarragona;36;Tarragonès;43171;Vila-seca;1;5;B;;643;206;356;446;197;4;10;432;442
43;Tarragona;36;Tarragonès;43171;Vila-seca;1;6;A;;734;160;329;472;262;0;5;467;472
43;Tarragona;36;Tarragonès;43171;Vila-seca;1;6;B;;832;206;401;544;288;0;10;534;544
43;Tarragona;36;Tarragonès;43171;Vila-seca;1;7;U;;644;183;335;424;220;3;0;421;421
43;Tarragona;36;Tarragonès;43171;Vila-seca;1;8;U;;964;164;331;410;554;3;5;402;407
43;Tarragona;36;Tarragonès;43171;Vila-seca;1;9;A;;412;100;209;268;144;0;3;265;268
43;Tarragona;36;Tarragonès;43171;Vila-seca;1;9;B;;553;149;284;367;186;2;6;359;365
8;Barcelona;21;Maresme;08214;Vilassar de Dalt;1;1;U;;834;203;435;583;251;1;8;574;582
8;Barcelona;21;Maresme;08214;Vilassar de Dalt;1;2;U;;822;212;459;539;283;0;3;536;539
8;Barcelona;21;Maresme;08214;Vilassar de Dalt;1;3;A;;580;151;327;385;195;5;5;375;380
8;Barcelona;21;Maresme;08214;Vilassar de Dalt;1;3;B;;556;135;323;387;169;9;1;377;378
8;Barcelona;21;Maresme;08214;Vilassar de Dalt;1;4;U;;727;187;420;524;203;0;3;521;524
8;Barcelona;21;Maresme;08214;Vilassar de Dalt;2;1;A;;742;197;442;540;202;1;1;538;539
8;Barcelona;21;Maresme;08214;Vilassar de Dalt;2;1;B;;711;219;432;526;185;1;0;525;525
8;Barcelona;21;Maresme;08214;Vilassar de Dalt;2;2;U;;855;248;510;606;249;0;5;601;606
8;Barcelona;21;Maresme;08219;Vilassar de Mar;1;1;A;;750;198;406;524;226;2;6;516;522
8;Barcelona;21;Maresme;08219;Vilassar de Mar;1;1;B;;845;247;466;594;251;2;6;586;592
8;Barcelona;21;Maresme;08219;Vilassar de Mar;1;2;A;;881;267;524;633;248;1;11;621;632
8;Barcelona;21;Maresme;08219;Vilassar de Mar;1;2;B;;1124;309;630;778;346;0;5;773;778
8;Barcelona;21;Maresme;08219;Vilassar de Mar;1;3;A;;631;172;323;393;238;0;5;388;393
8;Barcelona;21;Maresme;08219;Vilassar de Mar;1;3;B;;798;174;387;492;306;0;9;483;492
8;Barcelona;21;Maresme;08219;Vilassar de Mar;2;1;A;;719;200;399;502;217;2;4;496;500
8;Barcelona;21;Maresme;08219;Vilassar de Mar;2;1;B;;767;222;424;510;257;3;5;502;507
8;Barcelona;21;Maresme;08219;Vilassar de Mar;2;2;A;;955;289;565;678;277;0;0;678;678
8;Barcelona;21;Maresme;08219;Vilassar de Mar;2;2;B;;1032;275;535;675;357;3;0;672;672
8;Barcelona;21;Maresme;08219;Vilassar de Mar;3;1;A;;478;167;293;353;125;1;2;350;352
8;Barcelona;21;Maresme;08219;Vilassar de Mar;3;1;B;;573;191;311;392;181;1;4;387;391
8;Barcelona;21;Maresme;08219;Vilassar de Mar;3;2;A;;941;263;525;615;326;1;7;607;614
8;Barcelona;21;Maresme;08219;Vilassar de Mar;3;2;B;;1018;308;577;681;337;1;10;670;680
17;Girona;2;Alt Empordà;17222;Vilaür;1;1;U;;96;33;57;70;26;1;0;69;69
43;Tarragona;16;Conca de Barberà;43172;Vilaverd;1;1;U;;321;110;214;254;67;2;1;251;252
43;Tarragona;29;Priorat;43173;Vilella Alta, la;1;1;U;;119;19;78;98;21;0;0;98;98
43;Tarragona;29;Priorat;43174;Vilella Baixa, la;1;1;U;;148;42;78;110;38;0;1;109;110
17;Girona;34;Selva;17233;Vilobí d'Onyar;1;1;A;;804;197;462;572;232;1;5;566;571
17;Girona;34;Selva;17233;Vilobí d'Onyar;1;1;B;;893;257;516;641;252;0;3;638;641
8;Barcelona;3;Alt Penedès;08304;Vilobí del Penedès;1;1;U;;664;196;390;502;162;3;3;496;499
17;Girona;10;Baix Empordà;17232;Vilopriu;1;1;U;;155;54;83;97;58;0;0;97;97
25;Lleida;18;Garrigues;25253;Vilosell, el;1;1;U;;177;30;112;141;36;0;0;141;141
43;Tarragona;16;Conca de Barberà;43176;Vimbodí i Poblet;1;1;U;;950;250;574;700;250;7;2;691;693
25;Lleida;18;Garrigues;25255;Vinaixa;1;1;U;;561;106;255;388;173;9;3;376;379
43;Tarragona;30;Ribera d'Ebre;43177;Vinebre;1;1;U;;377;85;244;282;95;4;1;277;278
43;Tarragona;8;Baix Camp;43178;Vinyols i els Arcs;1;1;U;;746;210;452;541;205;4;1;536;537
8;Barcelona;14;Berguedà;08308;Viver i Serrateix;1;1;U;;157;44;94;123;34;0;2;121;123
43;Tarragona;9;Baix Ebre;43052;Xerta;1;1;U;;1032;351;631;806;226;8;6;792;798
8;Barcelona;98;Residents Absents;08998;Residents Absents;1;1;U;;36662; ; ;10080;26582;42;17;10021;10038
17;Girona;98;Residents Absents;17998;Residents Absents;1;1;U;;4264; ; ;1328;2936;47;2;1279;1281
25;Lleida;98;Residents Absents;25998;Residents Absents;1;1;U;;5266; ; ;1687;3579;0;3;1684;1687
43;Tarragona;98;Residents Absents;43998;Residents Absents;1;1;U;;4235; ; ;1342;2893;24;2;1316;1318
