﻿Codi Província;Nom Província;Codi Comarca;Nom Comarca;Codi Municipi;Nom Municipi;Districte;Secció;Mesa;Població;Cens;Participació 20:00;Abstenció;Vots nuls;Vots en blanc;Vots a candidatures;Vots vàlids
25;Lleida;25;Pallars Jussà;25001;Abella de la Conca;1;1;U;;137;60;77;0;0;60;60
8;Barcelona;11;Baix Llobregat;08001;Abrera;1;1;A;;625;343;282;1;3;339;342
8;Barcelona;11;Baix Llobregat;08001;Abrera;1;1;B;;649;348;301;2;8;338;346
8;Barcelona;11;Baix Llobregat;08001;Abrera;1;1;C;;644;332;312;2;6;324;330
8;Barcelona;11;Baix Llobregat;08001;Abrera;1;2;A;;571;313;258;2;1;310;311
8;Barcelona;11;Baix Llobregat;08001;Abrera;1;2;B;;594;289;305;3;0;286;286
8;Barcelona;11;Baix Llobregat;08001;Abrera;1;3;U;;401;175;226;0;3;172;175
8;Barcelona;11;Baix Llobregat;08001;Abrera;1;4;U;;458;263;195;1;0;262;262
25;Lleida;23;Noguera;25002;Àger;1;1;U;;533;350;183;3;7;340;347
25;Lleida;38;Urgell;25003;Agramunt;1;1;U;;957;583;374;2;10;571;581
25;Lleida;38;Urgell;25003;Agramunt;1;2;U;;1030;622;408;0;10;612;622
25;Lleida;38;Urgell;25003;Agramunt;1;3;U;;881;541;340;4;11;526;537
25;Lleida;38;Urgell;25003;Agramunt;1;4;U;;874;557;317;4;13;540;553
8;Barcelona;7;Bages;08002;Aguilar de Segarra;1;1;U;;177;125;52;1;2;122;124
17;Girona;2;Alt Empordà;17001;Agullana;1;1;U;;560;355;205;3;3;349;352
8;Barcelona;41;Vallès Oriental;08014;Aiguafreda;1;1;A;;663;487;176;0;10;477;487
8;Barcelona;41;Vallès Oriental;08014;Aiguafreda;1;1;B;;995;735;260;2;14;719;733
43;Tarragona;1;Alt Camp;43001;Aiguamúrcia;1;1;A;;210;166;44;0;0;166;166
43;Tarragona;1;Alt Camp;43001;Aiguamúrcia;1;1;B;;251;163;88;3;3;157;160
17;Girona;20;Gironès;17002;Aiguaviva;1;1;U;;296;197;99;0;0;197;197
25;Lleida;33;Segrià;25038;Aitona;1;1;U;;869;659;210;3;3;653;656
25;Lleida;33;Segrià;25038;Aitona;1;2;U;;914;636;278;5;3;628;631
25;Lleida;33;Segrià;25004;Alamús, els;1;1;U;;542;346;196;3;4;339;343
25;Lleida;4;Alt Urgell;25005;Alàs i Cerc;1;1;U;;364;194;170;0;2;192;194
25;Lleida;18;Garrigues;25006;Albagés, l';1;1;U;;451;299;152;2;2;295;297
17;Girona;2;Alt Empordà;17003;Albanyà;1;1;U;;93;64;29;0;0;64;64
25;Lleida;33;Segrià;25007;Albatàrrec;1;1;U;;826;527;299;0;2;525;527
25;Lleida;23;Noguera;25008;Albesa;1;1;A;;601;419;182;4;1;414;415
25;Lleida;23;Noguera;25008;Albesa;1;1;B;;566;409;157;2;5;402;407
25;Lleida;18;Garrigues;25009;Albi, l';1;1;U;;639;402;237;3;3;396;399
43;Tarragona;12;Baix Penedès;43002;Albinyana;1;1;U;;626;411;215;1;3;407;410
43;Tarragona;8;Baix Camp;43003;Albiol, l';1;1;U;;85;52;33;0;1;51;52
17;Girona;10;Baix Empordà;17004;Albons;1;1;U;;397;279;118;3;9;267;276
43;Tarragona;22;Montsià;43004;Alcanar;1;1;U;;770;427;343;3;7;417;424
43;Tarragona;22;Montsià;43004;Alcanar;1;2;A;;634;374;260;0;9;365;374
43;Tarragona;22;Montsià;43004;Alcanar;1;2;B;;361;183;178;0;3;180;183
43;Tarragona;22;Montsià;43004;Alcanar;1;2;C;;743;427;316;0;7;420;427
43;Tarragona;22;Montsià;43004;Alcanar;1;3;U;;790;442;348;0;2;440;442
43;Tarragona;22;Montsià;43004;Alcanar;2;1;A;;530;275;255;1;3;271;274
43;Tarragona;22;Montsià;43004;Alcanar;2;1;B;;552;291;261;3;6;282;288
43;Tarragona;22;Montsià;43004;Alcanar;2;2;U;;753;434;319;1;7;426;433
43;Tarragona;22;Montsià;43004;Alcanar;2;3;U;;548;275;273;0;7;268;275
25;Lleida;33;Segrià;25010;Alcanó;1;1;U;;243;140;103;1;1;138;139
25;Lleida;33;Segrià;25011;Alcarràs;1;1;A;;837;422;415;0;2;420;422
25;Lleida;33;Segrià;25011;Alcarràs;1;1;B;;708;329;379;1;0;328;328
25;Lleida;33;Segrià;25011;Alcarràs;1;2;A;;717;366;351;2;5;359;364
25;Lleida;33;Segrià;25011;Alcarràs;1;2;B;;629;286;343;0;2;284;286
25;Lleida;33;Segrià;25011;Alcarràs;1;3;U;;655;288;367;2;1;285;286
25;Lleida;33;Segrià;25012;Alcoletge;1;1;U;;1188;706;482;4;12;690;702
43;Tarragona;1;Alt Camp;43005;Alcover;1;1;A;;742;421;321;12;3;406;409
43;Tarragona;1;Alt Camp;43005;Alcover;1;1;B;;777;462;315;3;5;454;459
43;Tarragona;1;Alt Camp;43005;Alcover;2;1;A;;586;306;280;9;5;292;297
43;Tarragona;1;Alt Camp;43005;Alcover;2;1;B;;600;342;258;4;3;335;338
43;Tarragona;9;Baix Ebre;43904;Aldea, l';1;1;A;;809;389;420;3;5;381;386
43;Tarragona;9;Baix Ebre;43904;Aldea, l';1;1;B;;730;323;407;3;2;318;320
43;Tarragona;9;Baix Ebre;43904;Aldea, l';1;2;A;;815;361;454;5;8;348;356
43;Tarragona;9;Baix Ebre;43904;Aldea, l';1;2;B;;599;286;313;3;2;281;283
43;Tarragona;9;Baix Ebre;43006;Aldover;1;1;U;;698;459;239;1;5;453;458
43;Tarragona;8;Baix Camp;43007;Aleixar, l';1;1;U;;531;392;139;0;4;388;392
8;Barcelona;21;Maresme;08003;Alella;1;1;A;;695;467;228;1;6;460;466
8;Barcelona;21;Maresme;08003;Alella;1;1;B;;726;470;256;3;0;467;467
8;Barcelona;21;Maresme;08003;Alella;1;2;A;;665;355;310;0;4;351;355
8;Barcelona;21;Maresme;08003;Alella;1;2;B;;747;398;349;1;7;390;397
8;Barcelona;21;Maresme;08003;Alella;1;3;A;;996;628;368;3;10;615;625
8;Barcelona;21;Maresme;08003;Alella;1;3;B;;1037;605;432;11;12;582;594
43;Tarragona;9;Baix Ebre;43008;Alfara de Carles;1;1;U;;342;254;88;1;3;250;253
25;Lleida;33;Segrià;25013;Alfarràs;1;1;U;;1331;873;458;3;12;858;870
25;Lleida;33;Segrià;25013;Alfarràs;1;2;U;;1140;708;432;6;2;700;702
25;Lleida;33;Segrià;25014;Alfés;1;1;U;;284;173;111;0;2;171;173
43;Tarragona;8;Baix Camp;43009;Alforja;1;1;U;;898;669;229;19;18;632;650
25;Lleida;23;Noguera;25015;Algerri;1;1;U;;492;330;162;2;6;322;328
25;Lleida;33;Segrià;25016;Alguaire;1;1;A;;671;397;274;2;1;394;395
25;Lleida;33;Segrià;25016;Alguaire;1;1;B;;752;403;349;3;4;396;400
25;Lleida;33;Segrià;25016;Alguaire;1;2;U;;858;456;402;0;3;453;456
25;Lleida;26;Pallars Sobirà;25017;Alins;1;1;U;;258;169;89;0;1;168;169
43;Tarragona;1;Alt Camp;43010;Alió;1;1;U;;286;161;125;2;4;155;159
25;Lleida;33;Segrià;25019;Almacelles;1;1;U;;746;388;358;2;8;378;386
25;Lleida;33;Segrià;25019;Almacelles;1;2;U;;1244;697;547;0;12;685;697
25;Lleida;33;Segrià;25019;Almacelles;2;1;A;;605;346;259;2;4;340;344
25;Lleida;33;Segrià;25019;Almacelles;2;1;B;;693;378;315;1;6;371;377
25;Lleida;33;Segrià;25019;Almacelles;2;2;U;;1111;562;549;3;6;553;559
25;Lleida;33;Segrià;25020;Almatret;1;1;U;;491;304;187;1;4;299;303
25;Lleida;33;Segrià;25021;Almenar;1;1;U;;886;454;432;2;1;451;452
25;Lleida;33;Segrià;25021;Almenar;2;1;U;;1043;637;406;1;10;626;636
25;Lleida;33;Segrià;25021;Almenar;2;2;U;;975;575;400;0;8;567;575
43;Tarragona;8;Baix Camp;43011;Almoster;1;1;U;;368;275;93;6;0;269;269
25;Lleida;23;Noguera;25022;Alòs de Balaguer;1;1;U;;156;122;34;1;1;120;121
17;Girona;15;Cerdanya;17006;Alp;1;1;U;;696;439;257;2;10;427;437
8;Barcelona;24;Osona;08004;Alpens;1;1;U;;207;148;59;0;2;146;148
25;Lleida;33;Segrià;25023;Alpicat;1;1;A;;992;557;435;0;7;550;557
25;Lleida;33;Segrià;25023;Alpicat;1;1;B;;995;567;428;1;3;563;566
43;Tarragona;36;Tarragonès;43012;Altafulla;1;1;A;;595;360;235;3;5;352;357
43;Tarragona;36;Tarragonès;43012;Altafulla;1;1;B;;749;465;284;0;5;460;465
25;Lleida;26;Pallars Sobirà;25024;Alt Àneu;1;1;U;;302;173;129;0;1;172;173
17;Girona;34;Selva;17007;Amer;1;1;A;;613;427;186;1;5;421;426
17;Girona;34;Selva;17007;Amer;1;1;B;;589;410;179;1;5;404;409
17;Girona;34;Selva;17007;Amer;1;1;C;;713;511;202;5;7;499;506
8;Barcelona;41;Vallès Oriental;08005;Ametlla del Vallès, l';1;1;A;;350;216;134;0;3;213;216
8;Barcelona;41;Vallès Oriental;08005;Ametlla del Vallès, l';1;1;B;;380;217;163;1;0;216;216
8;Barcelona;41;Vallès Oriental;08005;Ametlla del Vallès, l';1;2;A;;443;291;152;4;1;286;287
8;Barcelona;41;Vallès Oriental;08005;Ametlla del Vallès, l';1;2;B;;455;295;160;0;4;291;295
8;Barcelona;41;Vallès Oriental;08005;Ametlla del Vallès, l';1;3;A;;476;271;205;0;4;267;271
8;Barcelona;41;Vallès Oriental;08005;Ametlla del Vallès, l';1;3;B;;524;334;190;3;6;325;331
43;Tarragona;9;Baix Ebre;43013;Ametlla de Mar, l';1;1;A;;468;356;112;4;4;348;352
43;Tarragona;9;Baix Ebre;43013;Ametlla de Mar, l';1;1;B;;560;417;143;3;2;412;414
43;Tarragona;9;Baix Ebre;43013;Ametlla de Mar, l';1;2;A;;551;444;107;2;4;438;442
43;Tarragona;9;Baix Ebre;43013;Ametlla de Mar, l';1;2;B;;519;391;128;1;4;386;390
43;Tarragona;9;Baix Ebre;43013;Ametlla de Mar, l';1;3;A;;555;364;191;8;8;348;356
43;Tarragona;9;Baix Ebre;43013;Ametlla de Mar, l';1;3;B;;567;371;196;2;1;368;369
43;Tarragona;9;Baix Ebre;43906;Ampolla, l';1;1;A;;732;579;153;2;1;576;577
43;Tarragona;9;Baix Ebre;43906;Ampolla, l';1;1;B;;435;334;101;1;0;333;333
43;Tarragona;22;Montsià;43014;Amposta;1;1;A;;505;289;216;1;3;285;288
43;Tarragona;22;Montsià;43014;Amposta;1;1;B;;601;387;214;4;2;381;383
43;Tarragona;22;Montsià;43014;Amposta;1;2;A;;476;285;191;4;4;277;281
43;Tarragona;22;Montsià;43014;Amposta;1;2;B;;522;346;176;10;1;335;336
43;Tarragona;22;Montsià;43014;Amposta;2;1;U;;819;528;291;7;11;510;521
43;Tarragona;22;Montsià;43014;Amposta;2;2;U;;986;605;381;2;14;589;603
43;Tarragona;22;Montsià;43014;Amposta;3;1;A;;529;283;246;4;10;269;279
43;Tarragona;22;Montsià;43014;Amposta;3;1;B;;509;281;228;3;11;267;278
43;Tarragona;22;Montsià;43014;Amposta;3;2;A;;547;286;261;4;3;279;282
43;Tarragona;22;Montsià;43014;Amposta;3;2;B;;649;342;307;1;6;335;341
43;Tarragona;22;Montsià;43014;Amposta;4;1;A;;648;376;272;0;7;369;376
43;Tarragona;22;Montsià;43014;Amposta;4;1;B;;728;424;304;1;7;416;423
43;Tarragona;22;Montsià;43014;Amposta;4;2;A;;823;431;392;8;11;412;423
43;Tarragona;22;Montsià;43014;Amposta;4;2;B;;853;450;403;7;6;437;443
43;Tarragona;22;Montsià;43014;Amposta;4;3;A;;751;407;344;11;10;386;396
43;Tarragona;22;Montsià;43014;Amposta;4;3;B;;801;452;349;5;12;435;447
43;Tarragona;22;Montsià;43014;Amposta;4;4;A;;695;333;362;6;2;325;327
43;Tarragona;22;Montsià;43014;Amposta;4;4;B;;669;364;305;5;7;352;359
17;Girona;34;Selva;17008;Anglès;1;1;A;;515;359;156;2;1;356;357
17;Girona;34;Selva;17008;Anglès;1;1;B;;671;455;216;2;4;449;453
17;Girona;34;Selva;17008;Anglès;1;2;A;;711;500;211;3;1;496;497
17;Girona;34;Selva;17008;Anglès;1;2;B;;812;571;241;0;3;568;571
17;Girona;34;Selva;17008;Anglès;1;3;A;;543;375;168;1;1;373;374
17;Girona;34;Selva;17008;Anglès;1;3;B;;642;405;237;2;1;402;403
25;Lleida;38;Urgell;25027;Anglesola;1;1;U;;1045;671;374;2;7;662;669
25;Lleida;18;Garrigues;25029;Arbeca;1;1;U;;989;676;313;1;11;664;675
25;Lleida;18;Garrigues;25029;Arbeca;1;2;U;;979;623;356;10;1;612;613
43;Tarragona;12;Baix Penedès;43016;Arboç, l';1;1;A;;595;357;238;4;0;353;353
43;Tarragona;12;Baix Penedès;43016;Arboç, l';1;1;B;;901;561;340;5;4;552;556
43;Tarragona;12;Baix Penedès;43016;Arboç, l';1;2;A;;700;377;323;6;2;369;371
43;Tarragona;12;Baix Penedès;43016;Arboç, l';1;2;B;;699;401;298;4;1;396;397
43;Tarragona;8;Baix Camp;43015;Arbolí;1;1;U;;118;80;38;0;1;79;80
17;Girona;34;Selva;17009;Arbúcies;1;1;A;;705;513;192;3;1;509;510
17;Girona;34;Selva;17009;Arbúcies;1;1;B;;799;579;220;3;6;570;576
17;Girona;34;Selva;17009;Arbúcies;1;2;A;;708;499;209;3;1;495;496
17;Girona;34;Selva;17009;Arbúcies;1;2;B;;768;563;205;3;3;557;560
17;Girona;34;Selva;17009;Arbúcies;2;1;U;;671;471;200;2;2;467;469
8;Barcelona;21;Maresme;08006;Arenys de Mar;1;1;A;;610;372;238;0;7;365;372
8;Barcelona;21;Maresme;08006;Arenys de Mar;1;1;B;;755;466;289;0;8;458;466
8;Barcelona;21;Maresme;08006;Arenys de Mar;1;2;A;;655;411;244;2;1;408;409
8;Barcelona;21;Maresme;08006;Arenys de Mar;1;2;B;;797;510;287;1;7;502;509
8;Barcelona;21;Maresme;08006;Arenys de Mar;1;3;U;;965;617;348;5;14;598;612
8;Barcelona;21;Maresme;08006;Arenys de Mar;2;1;A;;498;316;182;1;3;312;315
8;Barcelona;21;Maresme;08006;Arenys de Mar;2;1;B;;605;360;245;0;3;357;360
8;Barcelona;21;Maresme;08006;Arenys de Mar;2;2;A;;712;463;249;4;3;456;459
8;Barcelona;21;Maresme;08006;Arenys de Mar;2;2;B;;796;522;274;2;2;518;520
8;Barcelona;21;Maresme;08006;Arenys de Mar;2;3;A;;453;253;200;2;3;248;251
8;Barcelona;21;Maresme;08006;Arenys de Mar;2;3;B;;627;380;247;0;3;377;380
8;Barcelona;21;Maresme;08006;Arenys de Mar;2;4;A;;566;274;292;0;1;273;274
8;Barcelona;21;Maresme;08006;Arenys de Mar;2;4;B;;614;306;308;0;0;306;306
8;Barcelona;21;Maresme;08007;Arenys de Munt;1;1;U;;592;429;163;0;6;423;429
8;Barcelona;21;Maresme;08007;Arenys de Munt;1;2;A;;541;407;134;1;4;402;406
8;Barcelona;21;Maresme;08007;Arenys de Munt;1;2;B;;636;447;189;2;5;440;445
8;Barcelona;21;Maresme;08007;Arenys de Munt;2;1;U;;883;618;265;7;1;610;611
8;Barcelona;21;Maresme;08007;Arenys de Munt;2;2;A;;444;290;154;0;0;290;290
8;Barcelona;21;Maresme;08007;Arenys de Munt;2;2;B;;516;323;193;1;3;319;322
17;Girona;19;Garrotxa;17010;Argelaguer;1;1;U;;306;195;111;0;2;193;195
8;Barcelona;6;Anoia;08008;Argençola;1;1;U;;141;81;60;0;2;79;81
43;Tarragona;8;Baix Camp;43017;Argentera, l';1;1;U;;121;77;44;0;3;74;77
8;Barcelona;21;Maresme;08009;Argentona;1;1;A;;704;441;263;1;5;435;440
8;Barcelona;21;Maresme;08009;Argentona;1;1;B;;739;410;329;0;5;405;410
8;Barcelona;21;Maresme;08009;Argentona;1;2;A;;818;549;269;2;6;541;547
8;Barcelona;21;Maresme;08009;Argentona;1;2;B;;846;524;322;4;3;517;520
8;Barcelona;21;Maresme;08009;Argentona;1;3;U;;968;548;420;1;3;544;547
8;Barcelona;21;Maresme;08009;Argentona;2;1;A;;757;527;230;3;1;523;524
8;Barcelona;21;Maresme;08009;Argentona;2;1;B;;567;370;197;0;5;365;370
8;Barcelona;21;Maresme;08009;Argentona;2;1;C;;707;462;245;0;3;459;462
17;Girona;2;Alt Empordà;17011;Armentera, l';1;1;U;;646;467;179;5;3;459;462
43;Tarragona;37;Terra Alta;43018;Arnes;1;1;U;;460;385;75;5;6;374;380
25;Lleida;39;Consell General d'Aran;25031;Arres;1;1;U;;37;31;6;0;0;31;31
25;Lleida;4;Alt Urgell;25032;Arsèguel;1;1;U;;81;60;21;0;11;49;60
8;Barcelona;7;Bages;08010;Artés;1;1;U;;997;624;373;2;2;620;622
8;Barcelona;7;Bages;08010;Artés;2;1;A;;731;539;192;2;3;534;537
8;Barcelona;7;Bages;08010;Artés;2;1;B;;889;628;261;3;3;622;625
8;Barcelona;7;Bages;08010;Artés;2;2;U;;578;396;182;0;0;396;396
25;Lleida;33;Segrià;25033;Artesa de Lleida;1;1;U;;968;611;357;3;12;596;608
25;Lleida;23;Noguera;25034;Artesa de Segre;1;1;U;;1150;813;337;5;10;798;808
25;Lleida;23;Noguera;25034;Artesa de Segre;1;2;U;;705;496;209;1;6;489;495
25;Lleida;23;Noguera;25034;Artesa de Segre;2;1;A;;196;117;79;0;2;115;117
25;Lleida;23;Noguera;25034;Artesa de Segre;2;1;B;;320;191;129;0;2;189;191
25;Lleida;23;Noguera;25034;Artesa de Segre;2;1;C;;234;138;96;0;1;137;138
43;Tarragona;30;Ribera d'Ebre;43019;Ascó;1;1;A;;620;368;252;9;4;355;359
43;Tarragona;30;Ribera d'Ebre;43019;Ascó;1;1;B;;715;447;268;8;3;436;439
25;Lleida;33;Segrià;25036;Aspa;1;1;U;;224;138;86;2;7;129;136
25;Lleida;23;Noguera;25037;Avellanes i Santa Linya, les;1;1;U;;434;284;150;0;7;277;284
8;Barcelona;14;Berguedà;08011;Avià;1;1;A;;672;445;227;4;6;435;441
8;Barcelona;14;Berguedà;08011;Avià;1;1;B;;782;501;281;4;7;490;497
8;Barcelona;7;Bages;08012;Avinyó;1;1;A;;841;619;222;7;2;610;612
8;Barcelona;7;Bages;08012;Avinyó;1;1;B;;808;554;254;3;0;551;551
8;Barcelona;3;Alt Penedès;08013;Avinyonet del Penedès;1;1;U;;974;647;327;4;3;640;643
17;Girona;2;Alt Empordà;17012;Avinyonet de Puigventós;1;1;U;;328;156;172;1;3;152;155
8;Barcelona;13;Barcelonès;08015;Badalona;1;1;A;;426;267;159;2;7;258;265
8;Barcelona;13;Barcelonès;08015;Badalona;1;1;B;;557;345;212;2;3;340;343
8;Barcelona;13;Barcelonès;08015;Badalona;1;2;U;;451;276;175;2;2;272;274
8;Barcelona;13;Barcelonès;08015;Badalona;1;3;A;;444;303;141;0;2;301;303
8;Barcelona;13;Barcelonès;08015;Badalona;1;3;B;;486;337;149;0;0;337;337
8;Barcelona;13;Barcelonès;08015;Badalona;1;4;U;;781;513;268;0;4;509;513
8;Barcelona;13;Barcelonès;08015;Badalona;1;5;A;;461;327;134;6;0;321;321
8;Barcelona;13;Barcelonès;08015;Badalona;1;5;B;;548;353;195;0;3;350;353
8;Barcelona;13;Barcelonès;08015;Badalona;1;6;U;;779;536;243;1;3;532;535
8;Barcelona;13;Barcelonès;08015;Badalona;1;7;A;;559;352;207;0;4;348;352
8;Barcelona;13;Barcelonès;08015;Badalona;1;7;B;;594;359;235;0;3;356;359
8;Barcelona;13;Barcelonès;08015;Badalona;1;8;U;;717;475;242;1;7;467;474
8;Barcelona;13;Barcelonès;08015;Badalona;1;9;U;;500;355;145;2;7;346;353
8;Barcelona;13;Barcelonès;08015;Badalona;2;1;A;;605;313;292;0;2;311;313
8;Barcelona;13;Barcelonès;08015;Badalona;2;1;B;;659;353;306;0;0;353;353
8;Barcelona;13;Barcelonès;08015;Badalona;2;10;A;;629;274;355;0;4;270;274
8;Barcelona;13;Barcelonès;08015;Badalona;2;10;B;;763;298;465;1;0;297;297
8;Barcelona;13;Barcelonès;08015;Badalona;2;11;A;;643;271;372;1;9;261;270
8;Barcelona;13;Barcelonès;08015;Badalona;2;11;B;;804;329;475;0;3;326;329
8;Barcelona;13;Barcelonès;08015;Badalona;2;12;A;;471;189;282;0;2;187;189
8;Barcelona;13;Barcelonès;08015;Badalona;2;12;B;;539;200;339;0;6;194;200
8;Barcelona;13;Barcelonès;08015;Badalona;2;13;A;;496;197;299;2;2;193;195
8;Barcelona;13;Barcelonès;08015;Badalona;2;13;B;;688;257;431;2;4;251;255
8;Barcelona;13;Barcelonès;08015;Badalona;2;14;U;;566;238;328;1;0;237;237
8;Barcelona;13;Barcelonès;08015;Badalona;2;15;A;;540;225;315;1;0;224;224
8;Barcelona;13;Barcelonès;08015;Badalona;2;15;B;;637;279;358;2;1;276;277
8;Barcelona;13;Barcelonès;08015;Badalona;2;2;A;;524;299;225;2;3;294;297
8;Barcelona;13;Barcelonès;08015;Badalona;2;2;B;;617;343;274;1;9;333;342
8;Barcelona;13;Barcelonès;08015;Badalona;2;3;U;;809;468;341;0;2;466;468
8;Barcelona;13;Barcelonès;08015;Badalona;2;4;A;;566;371;195;0;4;367;371
8;Barcelona;13;Barcelonès;08015;Badalona;2;4;B;;500;310;190;0;6;304;310
8;Barcelona;13;Barcelonès;08015;Badalona;2;4;C;;608;426;182;0;10;416;426
8;Barcelona;13;Barcelonès;08015;Badalona;2;5;U;;561;287;274;0;2;285;287
8;Barcelona;13;Barcelonès;08015;Badalona;2;6;U;;636;313;323;1;1;311;312
8;Barcelona;13;Barcelonès;08015;Badalona;2;7;U;;761;307;454;0;6;301;307
8;Barcelona;13;Barcelonès;08015;Badalona;2;8;A;;552;312;240;0;7;305;312
8;Barcelona;13;Barcelonès;08015;Badalona;2;8;B;;535;277;258;0;0;277;277
8;Barcelona;13;Barcelonès;08015;Badalona;2;8;C;;615;350;265;0;4;346;350
8;Barcelona;13;Barcelonès;08015;Badalona;2;9;A;;535;218;317;0;2;216;218
8;Barcelona;13;Barcelonès;08015;Badalona;2;9;B;;684;295;389;1;2;292;294
8;Barcelona;13;Barcelonès;08015;Badalona;3;1;U;;428;203;225;0;2;201;203
8;Barcelona;13;Barcelonès;08015;Badalona;3;10;A;;603;278;325;1;2;275;277
8;Barcelona;13;Barcelonès;08015;Badalona;3;10;B;;676;322;354;0;3;319;322
8;Barcelona;13;Barcelonès;08015;Badalona;3;11;U;;743;410;333;1;4;405;409
8;Barcelona;13;Barcelonès;08015;Badalona;3;12;A;;567;340;227;0;5;335;340
8;Barcelona;13;Barcelonès;08015;Badalona;3;12;B;;668;416;252;0;0;416;416
8;Barcelona;13;Barcelonès;08015;Badalona;3;2;A;;724;334;390;0;6;328;334
8;Barcelona;13;Barcelonès;08015;Badalona;3;2;B;;776;332;444;0;9;323;332
8;Barcelona;13;Barcelonès;08015;Badalona;3;3;A;;637;283;354;3;1;279;280
8;Barcelona;13;Barcelonès;08015;Badalona;3;3;B;;742;319;423;0;1;318;319
8;Barcelona;13;Barcelonès;08015;Badalona;3;4;U;;797;425;372;0;9;416;425
8;Barcelona;13;Barcelonès;08015;Badalona;3;5;A;;581;268;313;0;4;264;268
8;Barcelona;13;Barcelonès;08015;Badalona;3;5;B;;672;324;348;0;3;321;324
8;Barcelona;13;Barcelonès;08015;Badalona;3;6;U;;784;503;281;3;4;496;500
8;Barcelona;13;Barcelonès;08015;Badalona;3;7;U;;846;526;320;4;6;516;522
8;Barcelona;13;Barcelonès;08015;Badalona;3;8;U;;639;378;261;0;3;375;378
8;Barcelona;13;Barcelonès;08015;Badalona;3;9;U;;562;338;224;0;8;330;338
8;Barcelona;13;Barcelonès;08015;Badalona;4;1;U;;736;374;362;2;1;371;372
8;Barcelona;13;Barcelonès;08015;Badalona;4;10;A;;460;218;242;2;0;216;216
8;Barcelona;13;Barcelonès;08015;Badalona;4;10;B;;565;241;324;0;4;237;241
8;Barcelona;13;Barcelonès;08015;Badalona;4;11;A;;469;190;279;1;0;189;189
8;Barcelona;13;Barcelonès;08015;Badalona;4;11;B;;611;234;377;1;1;232;233
8;Barcelona;13;Barcelonès;08015;Badalona;4;2;A;;506;264;242;0;3;261;264
8;Barcelona;13;Barcelonès;08015;Badalona;4;2;B;;596;295;301;0;0;295;295
8;Barcelona;13;Barcelonès;08015;Badalona;4;3;A;;479;241;238;3;2;236;238
8;Barcelona;13;Barcelonès;08015;Badalona;4;3;B;;500;226;274;1;2;223;225
8;Barcelona;13;Barcelonès;08015;Badalona;4;4;A;;603;254;349;0;1;253;254
8;Barcelona;13;Barcelonès;08015;Badalona;4;4;B;;673;303;370;1;3;299;302
8;Barcelona;13;Barcelonès;08015;Badalona;4;5;U;;841;415;426;0;0;415;415
8;Barcelona;13;Barcelonès;08015;Badalona;4;6;A;;554;249;305;0;0;249;249
8;Barcelona;13;Barcelonès;08015;Badalona;4;6;B;;783;394;389;2;0;392;392
8;Barcelona;13;Barcelonès;08015;Badalona;4;7;A;;816;418;398;0;2;416;418
8;Barcelona;13;Barcelonès;08015;Badalona;4;7;B;;1000;531;469;3;8;520;528
8;Barcelona;13;Barcelonès;08015;Badalona;4;8;A;;580;223;357;4;1;218;219
8;Barcelona;13;Barcelonès;08015;Badalona;4;8;B;;703;291;412;0;2;289;291
8;Barcelona;13;Barcelonès;08015;Badalona;4;8;C;;726;309;417;0;4;305;309
8;Barcelona;13;Barcelonès;08015;Badalona;4;9;U;;611;314;297;1;2;311;313
8;Barcelona;13;Barcelonès;08015;Badalona;5;1;A;;737;463;274;1;6;456;462
8;Barcelona;13;Barcelonès;08015;Badalona;5;1;B;;834;553;281;0;9;544;553
8;Barcelona;13;Barcelonès;08015;Badalona;5;2;A;;444;265;179;0;6;259;265
8;Barcelona;13;Barcelonès;08015;Badalona;5;2;B;;461;300;161;1;2;297;299
8;Barcelona;13;Barcelonès;08015;Badalona;5;3;A;;628;326;302;0;3;323;326
8;Barcelona;13;Barcelonès;08015;Badalona;5;3;B;;599;287;312;0;1;286;287
8;Barcelona;13;Barcelonès;08015;Badalona;5;4;A;;555;290;265;0;1;289;290
8;Barcelona;13;Barcelonès;08015;Badalona;5;4;B;;589;273;316;3;4;266;270
8;Barcelona;13;Barcelonès;08015;Badalona;5;4;C;;526;243;283;2;0;241;241
8;Barcelona;13;Barcelonès;08015;Badalona;5;5;A;;529;289;240;1;10;278;288
8;Barcelona;13;Barcelonès;08015;Badalona;5;5;B;;550;283;267;2;6;275;281
8;Barcelona;13;Barcelonès;08015;Badalona;5;5;C;;565;289;276;1;2;286;288
8;Barcelona;13;Barcelonès;08015;Badalona;5;6;A;;503;341;162;1;5;335;340
8;Barcelona;13;Barcelonès;08015;Badalona;5;6;B;;553;341;212;2;2;337;339
8;Barcelona;13;Barcelonès;08015;Badalona;6;1;U;;944;493;451;1;4;488;492
8;Barcelona;13;Barcelonès;08015;Badalona;6;2;A;;378;223;155;0;1;222;223
8;Barcelona;13;Barcelonès;08015;Badalona;6;2;B;;349;217;132;1;1;215;216
8;Barcelona;13;Barcelonès;08015;Badalona;6;3;A;;641;232;409;0;3;229;232
8;Barcelona;13;Barcelonès;08015;Badalona;6;3;B;;752;297;455;0;3;294;297
8;Barcelona;13;Barcelonès;08015;Badalona;6;4;A;;597;230;367;1;0;229;229
8;Barcelona;13;Barcelonès;08015;Badalona;6;4;B;;810;321;489;1;0;320;320
8;Barcelona;13;Barcelonès;08015;Badalona;6;5;A;;426;150;276;1;0;149;149
8;Barcelona;13;Barcelonès;08015;Badalona;6;5;B;;603;225;378;2;2;221;223
8;Barcelona;13;Barcelonès;08015;Badalona;6;5;C;;563;228;335;0;2;226;228
8;Barcelona;13;Barcelonès;08015;Badalona;6;6;A;;549;190;359;0;1;189;190
8;Barcelona;13;Barcelonès;08015;Badalona;6;6;B;;675;264;411;0;2;262;264
8;Barcelona;13;Barcelonès;08015;Badalona;7;1;A;;529;187;342;0;1;186;187
8;Barcelona;13;Barcelonès;08015;Badalona;7;1;B;;677;298;379;0;2;296;298
8;Barcelona;13;Barcelonès;08015;Badalona;7;10;A;;366;133;233;1;2;130;132
8;Barcelona;13;Barcelonès;08015;Badalona;7;10;B;;505;180;325;2;4;174;178
8;Barcelona;13;Barcelonès;08015;Badalona;7;11;A;;900;353;547;1;4;348;352
8;Barcelona;13;Barcelonès;08015;Badalona;7;11;B;;1027;407;620;7;0;400;400
8;Barcelona;13;Barcelonès;08015;Badalona;7;12;A;;571;251;320;3;5;243;248
8;Barcelona;13;Barcelonès;08015;Badalona;7;12;B;;707;285;422;1;2;282;284
8;Barcelona;13;Barcelonès;08015;Badalona;7;13;A;;512;163;349;3;1;159;160
8;Barcelona;13;Barcelonès;08015;Badalona;7;13;B;;616;213;403;3;2;208;210
8;Barcelona;13;Barcelonès;08015;Badalona;7;14;A;;556;202;354;0;1;201;202
8;Barcelona;13;Barcelonès;08015;Badalona;7;14;B;;682;271;411;2;7;262;269
8;Barcelona;13;Barcelonès;08015;Badalona;7;15;U;;908;350;558;2;3;345;348
8;Barcelona;13;Barcelonès;08015;Badalona;7;16;U;;425;156;269;0;0;156;156
8;Barcelona;13;Barcelonès;08015;Badalona;7;17;U;;662;251;411;0;1;250;251
8;Barcelona;13;Barcelonès;08015;Badalona;7;18;A;;572;201;371;2;6;193;199
8;Barcelona;13;Barcelonès;08015;Badalona;7;18;B;;766;312;454;0;5;307;312
8;Barcelona;13;Barcelonès;08015;Badalona;7;18;C;;735;287;448;0;3;284;287
8;Barcelona;13;Barcelonès;08015;Badalona;7;19;U;;562;225;337;2;0;223;223
8;Barcelona;13;Barcelonès;08015;Badalona;7;2;A;;635;282;353;1;1;280;281
8;Barcelona;13;Barcelonès;08015;Badalona;7;2;B;;671;286;385;0;5;281;286
8;Barcelona;13;Barcelonès;08015;Badalona;7;20;A;;621;299;322;0;1;298;299
8;Barcelona;13;Barcelonès;08015;Badalona;7;20;B;;726;319;407;10;0;309;309
8;Barcelona;13;Barcelonès;08015;Badalona;7;21;U;;923;349;574;0;4;345;349
8;Barcelona;13;Barcelonès;08015;Badalona;7;22;U;;692;340;352;3;1;336;337
8;Barcelona;13;Barcelonès;08015;Badalona;7;23;A;;676;395;281;0;7;388;395
8;Barcelona;13;Barcelonès;08015;Badalona;7;23;B;;762;398;364;2;6;390;396
8;Barcelona;13;Barcelonès;08015;Badalona;7;24;A;;500;239;261;0;2;237;239
8;Barcelona;13;Barcelonès;08015;Badalona;7;24;B;;579;246;333;0;2;244;246
8;Barcelona;13;Barcelonès;08015;Badalona;7;25;U;;686;226;460;0;0;226;226
8;Barcelona;13;Barcelonès;08015;Badalona;7;26;U;;690;251;439;1;1;249;250
8;Barcelona;13;Barcelonès;08015;Badalona;7;27;A;;622;226;396;0;0;226;226
8;Barcelona;13;Barcelonès;08015;Badalona;7;27;B;;735;261;474;0;1;260;261
8;Barcelona;13;Barcelonès;08015;Badalona;7;28;A;;498;177;321;0;4;173;177
8;Barcelona;13;Barcelonès;08015;Badalona;7;28;B;;645;235;410;1;0;234;234
8;Barcelona;13;Barcelonès;08015;Badalona;7;28;C;;582;221;361;3;0;218;218
8;Barcelona;13;Barcelonès;08015;Badalona;7;29;A;;700;308;392;0;4;304;308
8;Barcelona;13;Barcelonès;08015;Badalona;7;29;B;;848;328;520;1;0;327;327
8;Barcelona;13;Barcelonès;08015;Badalona;7;3;A;;696;314;382;0;6;308;314
8;Barcelona;13;Barcelonès;08015;Badalona;7;3;B;;788;331;457;1;4;326;330
8;Barcelona;13;Barcelonès;08015;Badalona;7;4;U;;878;385;493;0;2;383;385
8;Barcelona;13;Barcelonès;08015;Badalona;7;5;U;;823;343;480;1;5;337;342
8;Barcelona;13;Barcelonès;08015;Badalona;7;6;U;;768;386;382;0;4;382;386
8;Barcelona;13;Barcelonès;08015;Badalona;7;7;U;;913;337;576;1;1;335;336
8;Barcelona;13;Barcelonès;08015;Badalona;7;8;A;;542;217;325;0;2;215;217
8;Barcelona;13;Barcelonès;08015;Badalona;7;8;B;;702;224;478;0;2;222;224
8;Barcelona;13;Barcelonès;08015;Badalona;7;9;U;;684;284;400;1;8;275;283
8;Barcelona;13;Barcelonès;08015;Badalona;8;1;U;;793;297;496;1;3;293;296
8;Barcelona;13;Barcelonès;08015;Badalona;8;10;A;;705;259;446;0;4;255;259
8;Barcelona;13;Barcelonès;08015;Badalona;8;10;B;;775;337;438;0;2;335;337
8;Barcelona;13;Barcelonès;08015;Badalona;8;11;U;;627;232;395;0;3;229;232
8;Barcelona;13;Barcelonès;08015;Badalona;8;2;A;;723;306;417;4;2;300;302
8;Barcelona;13;Barcelonès;08015;Badalona;8;2;B;;882;352;530;0;2;350;352
8;Barcelona;13;Barcelonès;08015;Badalona;8;3;A;;599;205;394;0;0;205;205
8;Barcelona;13;Barcelonès;08015;Badalona;8;3;B;;780;283;497;1;1;281;282
8;Barcelona;13;Barcelonès;08015;Badalona;8;4;U;;648;241;407;1;4;236;240
8;Barcelona;13;Barcelonès;08015;Badalona;8;5;A;;484;235;249;2;2;231;233
8;Barcelona;13;Barcelonès;08015;Badalona;8;5;B;;538;229;309;0;3;226;229
8;Barcelona;13;Barcelonès;08015;Badalona;8;6;A;;743;269;474;1;6;262;268
8;Barcelona;13;Barcelonès;08015;Badalona;8;6;B;;878;316;562;0;1;315;316
8;Barcelona;13;Barcelonès;08015;Badalona;8;7;A;;582;247;335;2;0;245;245
8;Barcelona;13;Barcelonès;08015;Badalona;8;7;B;;619;248;371;0;0;248;248
8;Barcelona;13;Barcelonès;08015;Badalona;8;8;A;;679;233;446;0;0;233;233
8;Barcelona;13;Barcelonès;08015;Badalona;8;8;B;;842;271;571;0;2;269;271
8;Barcelona;13;Barcelonès;08015;Badalona;8;9;A;;597;249;348;2;7;240;247
8;Barcelona;13;Barcelonès;08015;Badalona;8;9;B;;711;303;408;2;8;293;301
8;Barcelona;13;Barcelonès;08015;Badalona;9;1;U;;636;304;332;0;3;301;304
8;Barcelona;13;Barcelonès;08015;Badalona;9;10;A;;610;298;312;0;1;297;298
8;Barcelona;13;Barcelonès;08015;Badalona;9;10;B;;806;343;463;1;4;338;342
8;Barcelona;13;Barcelonès;08015;Badalona;9;11;A;;526;248;278;2;5;241;246
8;Barcelona;13;Barcelonès;08015;Badalona;9;11;B;;594;282;312;1;2;279;281
8;Barcelona;13;Barcelonès;08015;Badalona;9;12;U;;769;357;412;0;8;349;357
8;Barcelona;13;Barcelonès;08015;Badalona;9;13;U;;809;318;491;0;0;318;318
8;Barcelona;13;Barcelonès;08015;Badalona;9;14;A;;686;298;388;0;4;294;298
8;Barcelona;13;Barcelonès;08015;Badalona;9;14;B;;814;369;445;3;2;364;366
8;Barcelona;13;Barcelonès;08015;Badalona;9;15;U;;846;318;528;0;4;314;318
8;Barcelona;13;Barcelonès;08015;Badalona;9;16;A;;716;249;467;3;1;245;246
8;Barcelona;13;Barcelonès;08015;Badalona;9;16;B;;758;285;473;2;3;280;283
8;Barcelona;13;Barcelonès;08015;Badalona;9;17;U;;715;266;449;2;3;261;264
8;Barcelona;13;Barcelonès;08015;Badalona;9;18;U;;552;249;303;0;3;246;249
8;Barcelona;13;Barcelonès;08015;Badalona;9;19;A;;458;185;273;0;0;185;185
8;Barcelona;13;Barcelonès;08015;Badalona;9;19;B;;563;217;346;3;2;212;214
8;Barcelona;13;Barcelonès;08015;Badalona;9;2;A;;482;185;297;0;2;183;185
8;Barcelona;13;Barcelonès;08015;Badalona;9;2;B;;542;206;336;1;1;204;205
8;Barcelona;13;Barcelonès;08015;Badalona;9;20;A;;492;202;290;0;5;197;202
8;Barcelona;13;Barcelonès;08015;Badalona;9;20;B;;585;221;364;0;4;217;221
8;Barcelona;13;Barcelonès;08015;Badalona;9;20;C;;633;239;394;0;3;236;239
8;Barcelona;13;Barcelonès;08015;Badalona;9;21;A;;569;233;336;1;4;228;232
8;Barcelona;13;Barcelonès;08015;Badalona;9;21;B;;670;286;384;0;3;283;286
8;Barcelona;13;Barcelonès;08015;Badalona;9;22;U;;958;407;551;0;7;400;407
8;Barcelona;13;Barcelonès;08015;Badalona;9;23;U;;699;316;383;0;8;308;316
8;Barcelona;13;Barcelonès;08015;Badalona;9;24;A;;541;234;307;0;4;230;234
8;Barcelona;13;Barcelonès;08015;Badalona;9;24;B;;583;247;336;0;5;242;247
8;Barcelona;13;Barcelonès;08015;Badalona;9;24;C;;624;263;361;0;4;259;263
8;Barcelona;13;Barcelonès;08015;Badalona;9;25;A;;600;248;352;4;0;244;244
8;Barcelona;13;Barcelonès;08015;Badalona;9;25;B;;601;258;343;0;4;254;258
8;Barcelona;13;Barcelonès;08015;Badalona;9;26;A;;505;205;300;0;1;204;205
8;Barcelona;13;Barcelonès;08015;Badalona;9;26;B;;611;227;384;1;4;222;226
8;Barcelona;13;Barcelonès;08015;Badalona;9;27;U;;836;334;502;2;0;332;332
8;Barcelona;13;Barcelonès;08015;Badalona;9;28;A;;747;193;554;0;3;190;193
8;Barcelona;13;Barcelonès;08015;Badalona;9;28;B;;782;222;560;3;0;219;219
8;Barcelona;13;Barcelonès;08015;Badalona;9;29;A;;568;236;332;0;6;230;236
8;Barcelona;13;Barcelonès;08015;Badalona;9;29;B;;657;271;386;0;3;268;271
8;Barcelona;13;Barcelonès;08015;Badalona;9;29;C;;643;261;382;0;3;258;261
8;Barcelona;13;Barcelonès;08015;Badalona;9;3;U;;698;227;471;0;2;225;227
8;Barcelona;13;Barcelonès;08015;Badalona;9;30;A;;459;158;301;0;1;157;158
8;Barcelona;13;Barcelonès;08015;Badalona;9;30;B;;541;184;357;0;2;182;184
8;Barcelona;13;Barcelonès;08015;Badalona;9;31;A;;518;218;300;1;5;212;217
8;Barcelona;13;Barcelonès;08015;Badalona;9;31;B;;594;255;339;1;3;251;254
8;Barcelona;13;Barcelonès;08015;Badalona;9;32;U;;880;328;552;1;2;325;327
8;Barcelona;13;Barcelonès;08015;Badalona;9;33;A;;652;311;341;2;4;305;309
8;Barcelona;13;Barcelonès;08015;Badalona;9;33;B;;863;372;491;0;2;370;372
8;Barcelona;13;Barcelonès;08015;Badalona;9;34;A;;685;326;359;0;6;320;326
8;Barcelona;13;Barcelonès;08015;Badalona;9;34;B;;780;338;442;1;4;333;337
8;Barcelona;13;Barcelonès;08015;Badalona;9;35;A;;598;206;392;0;3;203;206
8;Barcelona;13;Barcelonès;08015;Badalona;9;35;B;;683;191;492;0;1;190;191
8;Barcelona;13;Barcelonès;08015;Badalona;9;36;A;;543;189;354;0;2;187;189
8;Barcelona;13;Barcelonès;08015;Badalona;9;36;B;;680;235;445;2;3;230;233
8;Barcelona;13;Barcelonès;08015;Badalona;9;37;A;;468;161;307;2;1;158;159
8;Barcelona;13;Barcelonès;08015;Badalona;9;37;B;;565;190;375;2;0;188;188
8;Barcelona;13;Barcelonès;08015;Badalona;9;38;U;;489;208;281;3;0;205;205
8;Barcelona;13;Barcelonès;08015;Badalona;9;39;U;;584;232;352;0;1;231;232
8;Barcelona;13;Barcelonès;08015;Badalona;9;4;U;;434;199;235;0;5;194;199
8;Barcelona;13;Barcelonès;08015;Badalona;9;40;U;;503;186;317;1;1;184;185
8;Barcelona;13;Barcelonès;08015;Badalona;9;41;A;;565;208;357;5;0;203;203
8;Barcelona;13;Barcelonès;08015;Badalona;9;41;B;;583;218;365;0;0;218;218
8;Barcelona;13;Barcelonès;08015;Badalona;9;42;A;;538;225;313;5;0;220;220
8;Barcelona;13;Barcelonès;08015;Badalona;9;42;B;;689;269;420;0;5;264;269
8;Barcelona;13;Barcelonès;08015;Badalona;9;43;A;;574;204;370;0;7;197;204
8;Barcelona;13;Barcelonès;08015;Badalona;9;43;B;;691;241;450;1;5;235;240
8;Barcelona;13;Barcelonès;08015;Badalona;9;44;U;;1000;404;596;0;3;401;404
8;Barcelona;13;Barcelonès;08015;Badalona;9;45;A;;602;242;360;0;2;240;242
8;Barcelona;13;Barcelonès;08015;Badalona;9;45;B;;721;308;413;0;4;304;308
8;Barcelona;13;Barcelonès;08015;Badalona;9;46;U;;786;318;468;0;3;315;318
8;Barcelona;13;Barcelonès;08015;Badalona;9;47;U;;863;283;580;0;0;283;283
8;Barcelona;13;Barcelonès;08015;Badalona;9;48;A;;443;189;254;1;1;187;188
8;Barcelona;13;Barcelonès;08015;Badalona;9;48;B;;536;213;323;1;1;211;212
8;Barcelona;13;Barcelonès;08015;Badalona;9;49;A;;606;259;347;1;2;256;258
8;Barcelona;13;Barcelonès;08015;Badalona;9;49;B;;690;266;424;2;0;264;264
8;Barcelona;13;Barcelonès;08015;Badalona;9;5;A;;571;199;372;1;1;197;198
8;Barcelona;13;Barcelonès;08015;Badalona;9;5;B;;693;235;458;0;1;234;235
8;Barcelona;13;Barcelonès;08015;Badalona;9;50;U;;769;240;529;0;3;237;240
8;Barcelona;13;Barcelonès;08015;Badalona;9;51;U;;459;201;258;1;0;200;200
8;Barcelona;13;Barcelonès;08015;Badalona;9;52;U;;866;338;528;2;0;336;336
8;Barcelona;13;Barcelonès;08015;Badalona;9;53;A;;485;196;289;1;1;194;195
8;Barcelona;13;Barcelonès;08015;Badalona;9;53;B;;627;248;379;1;1;246;247
8;Barcelona;13;Barcelonès;08015;Badalona;9;54;A;;484;181;303;0;1;180;181
8;Barcelona;13;Barcelonès;08015;Badalona;9;54;B;;620;222;398;0;5;217;222
8;Barcelona;13;Barcelonès;08015;Badalona;9;55;A;;498;219;279;0;1;218;219
8;Barcelona;13;Barcelonès;08015;Badalona;9;55;B;;519;215;304;0;0;215;215
8;Barcelona;13;Barcelonès;08015;Badalona;9;56;U;;701;224;477;1;2;221;223
8;Barcelona;13;Barcelonès;08015;Badalona;9;57;U;;795;325;470;1;6;318;324
8;Barcelona;13;Barcelonès;08015;Badalona;9;6;A;;510;202;308;0;0;202;202
8;Barcelona;13;Barcelonès;08015;Badalona;9;6;B;;510;198;312;0;1;197;198
8;Barcelona;13;Barcelonès;08015;Badalona;9;7;U;;520;216;304;0;3;213;216
8;Barcelona;13;Barcelonès;08015;Badalona;9;8;A;;791;301;490;1;2;298;300
8;Barcelona;13;Barcelonès;08015;Badalona;9;8;B;;961;338;623;1;4;333;337
8;Barcelona;13;Barcelonès;08015;Badalona;9;9;A;;583;249;334;1;4;244;248
8;Barcelona;13;Barcelonès;08015;Badalona;9;9;B;;714;310;404;3;5;302;307
8;Barcelona;14;Berguedà;08016;Bagà;1;1;U;;1682;1089;593;3;8;1078;1086
25;Lleida;26;Pallars Sobirà;25039;Baix Pallars;1;1;U;;326;185;141;4;4;177;181
25;Lleida;23;Noguera;25040;Balaguer;1;1;A;;593;345;248;4;0;341;341
25;Lleida;23;Noguera;25040;Balaguer;1;1;B;;707;457;250;1;2;454;456
25;Lleida;23;Noguera;25040;Balaguer;1;2;U;;887;600;287;2;7;591;598
25;Lleida;23;Noguera;25040;Balaguer;2;1;A;;517;305;212;0;9;296;305
25;Lleida;23;Noguera;25040;Balaguer;2;1;B;;292;198;94;0;1;197;198
25;Lleida;23;Noguera;25040;Balaguer;2;2;U;;527;318;209;3;2;313;315
25;Lleida;23;Noguera;25040;Balaguer;3;1;A;;754;495;259;6;3;486;489
25;Lleida;23;Noguera;25040;Balaguer;3;1;B;;824;547;277;2;5;540;545
25;Lleida;23;Noguera;25040;Balaguer;3;2;U;;778;500;278;1;1;498;499
25;Lleida;23;Noguera;25040;Balaguer;4;1;A;;667;462;205;2;7;453;460
25;Lleida;23;Noguera;25040;Balaguer;4;1;B;;776;543;233;10;5;528;533
25;Lleida;23;Noguera;25040;Balaguer;4;2;A;;705;463;242;0;5;458;463
25;Lleida;23;Noguera;25040;Balaguer;4;2;B;;853;546;307;3;6;537;543
25;Lleida;23;Noguera;25040;Balaguer;4;3;A;;642;460;182;4;2;454;456
25;Lleida;23;Noguera;25040;Balaguer;4;3;B;;837;607;230;2;9;596;605
8;Barcelona;24;Osona;08017;Balenyà;1;1;A;;669;461;208;1;1;459;460
8;Barcelona;24;Osona;08017;Balenyà;1;1;B;;577;372;205;3;1;368;369
8;Barcelona;24;Osona;08017;Balenyà;1;1;C;;748;531;217;4;5;522;527
8;Barcelona;24;Osona;08017;Balenyà;1;2;U;;434;283;151;1;0;282;282
8;Barcelona;7;Bages;08018;Balsareny;1;1;U;;1271;767;504;4;5;758;763
8;Barcelona;7;Bages;08018;Balsareny;1;2;U;;916;545;371;4;4;537;541
8;Barcelona;7;Bages;08018;Balsareny;1;3;A;;276;199;77;2;0;197;197
8;Barcelona;7;Bages;08018;Balsareny;1;3;B;;255;159;96;0;2;157;159
43;Tarragona;12;Baix Penedès;43020;Banyeres del Penedès;1;1;U;;1131;750;381;6;10;734;744
17;Girona;28;Pla de l'Estany;17015;Banyoles;1;1;A;;552;381;171;4;7;370;377
17;Girona;28;Pla de l'Estany;17015;Banyoles;1;1;B;;658;465;193;0;10;455;465
17;Girona;28;Pla de l'Estany;17015;Banyoles;1;2;U;;723;491;232;0;9;482;491
17;Girona;28;Pla de l'Estany;17015;Banyoles;1;3;A;;630;393;237;2;2;389;391
17;Girona;28;Pla de l'Estany;17015;Banyoles;1;3;B;;733;455;278;2;5;448;453
17;Girona;28;Pla de l'Estany;17015;Banyoles;1;4;A;;604;398;206;2;5;391;396
17;Girona;28;Pla de l'Estany;17015;Banyoles;1;4;B;;795;504;291;14;3;487;490
17;Girona;28;Pla de l'Estany;17015;Banyoles;2;1;A;;797;508;289;2;11;495;506
17;Girona;28;Pla de l'Estany;17015;Banyoles;2;1;B;;921;569;352;1;14;554;568
17;Girona;28;Pla de l'Estany;17015;Banyoles;2;2;U;;784;538;246;5;7;526;533
17;Girona;28;Pla de l'Estany;17015;Banyoles;2;3;A;;649;401;248;1;2;398;400
17;Girona;28;Pla de l'Estany;17015;Banyoles;2;3;B;;768;489;279;0;5;484;489
17;Girona;28;Pla de l'Estany;17015;Banyoles;3;1;A;;573;405;168;0;8;397;405
17;Girona;28;Pla de l'Estany;17015;Banyoles;3;1;B;;638;425;213;5;7;413;420
17;Girona;28;Pla de l'Estany;17015;Banyoles;3;2;U;;717;396;321;1;14;381;395
25;Lleida;27;Pla d'Urgell;25041;Barbens;1;1;U;;656;429;227;5;2;422;424
43;Tarragona;16;Conca de Barberà;43021;Barberà de la Conca;1;1;U;;357;226;131;3;8;215;223
8;Barcelona;40;Vallès Occidental;08252;Barberà del Vallès;1;1;A;;729;332;397;1;2;329;331
8;Barcelona;40;Vallès Occidental;08252;Barberà del Vallès;1;1;B;;701;318;383;4;3;311;314
8;Barcelona;40;Vallès Occidental;08252;Barberà del Vallès;1;10;A;;590;279;311;1;3;275;278
8;Barcelona;40;Vallès Occidental;08252;Barberà del Vallès;1;10;B;;686;324;362;2;8;314;322
8;Barcelona;40;Vallès Occidental;08252;Barberà del Vallès;1;10;C;;783;353;430;3;3;347;350
8;Barcelona;40;Vallès Occidental;08252;Barberà del Vallès;1;11;A;;924;453;471;0;3;450;453
8;Barcelona;40;Vallès Occidental;08252;Barberà del Vallès;1;11;B;;856;402;454;0;3;399;402
8;Barcelona;40;Vallès Occidental;08252;Barberà del Vallès;1;12;A;;557;220;337;2;5;213;218
8;Barcelona;40;Vallès Occidental;08252;Barberà del Vallès;1;12;B;;584;212;372;1;6;205;211
8;Barcelona;40;Vallès Occidental;08252;Barberà del Vallès;1;13;A;;646;240;406;7;0;233;233
8;Barcelona;40;Vallès Occidental;08252;Barberà del Vallès;1;13;B;;701;258;443;6;6;246;252
8;Barcelona;40;Vallès Occidental;08252;Barberà del Vallès;1;14;A;;647;232;415;0;4;228;232
8;Barcelona;40;Vallès Occidental;08252;Barberà del Vallès;1;14;B;;576;210;366;0;4;206;210
8;Barcelona;40;Vallès Occidental;08252;Barberà del Vallès;1;15;A;;582;224;358;2;3;219;222
8;Barcelona;40;Vallès Occidental;08252;Barberà del Vallès;1;15;B;;505;173;332;3;1;169;170
8;Barcelona;40;Vallès Occidental;08252;Barberà del Vallès;1;16;A;;606;246;360;9;3;234;237
8;Barcelona;40;Vallès Occidental;08252;Barberà del Vallès;1;16;B;;491;176;315;0;0;176;176
8;Barcelona;40;Vallès Occidental;08252;Barberà del Vallès;1;17;A;;622;218;404;1;1;216;217
8;Barcelona;40;Vallès Occidental;08252;Barberà del Vallès;1;17;B;;454;159;295;1;1;157;158
8;Barcelona;40;Vallès Occidental;08252;Barberà del Vallès;1;2;A;;720;350;370;0;7;343;350
8;Barcelona;40;Vallès Occidental;08252;Barberà del Vallès;1;2;B;;694;317;377;0;2;315;317
8;Barcelona;40;Vallès Occidental;08252;Barberà del Vallès;1;3;A;;688;264;424;1;2;261;263
8;Barcelona;40;Vallès Occidental;08252;Barberà del Vallès;1;3;B;;641;293;348;0;5;288;293
8;Barcelona;40;Vallès Occidental;08252;Barberà del Vallès;1;4;A;;552;253;299;3;2;248;250
8;Barcelona;40;Vallès Occidental;08252;Barberà del Vallès;1;4;B;;551;268;283;1;1;266;267
8;Barcelona;40;Vallès Occidental;08252;Barberà del Vallès;1;5;A;;583;263;320;3;0;260;260
8;Barcelona;40;Vallès Occidental;08252;Barberà del Vallès;1;5;B;;478;227;251;0;4;223;227
8;Barcelona;40;Vallès Occidental;08252;Barberà del Vallès;1;6;A;;838;351;487;0;4;347;351
8;Barcelona;40;Vallès Occidental;08252;Barberà del Vallès;1;6;B;;807;348;459;0;3;345;348
8;Barcelona;40;Vallès Occidental;08252;Barberà del Vallès;1;7;A;;878;379;499;0;4;375;379
8;Barcelona;40;Vallès Occidental;08252;Barberà del Vallès;1;7;B;;786;340;446;0;1;339;340
8;Barcelona;40;Vallès Occidental;08252;Barberà del Vallès;1;8;A;;711;296;415;0;1;295;296
8;Barcelona;40;Vallès Occidental;08252;Barberà del Vallès;1;8;B;;657;301;356;2;5;294;299
8;Barcelona;40;Vallès Occidental;08252;Barberà del Vallès;1;9;A;;889;421;468;1;1;419;420
8;Barcelona;40;Vallès Occidental;08252;Barberà del Vallès;1;9;B;;766;338;428;0;3;335;338
8;Barcelona;13;Barcelonès;08019;Barcelona;1;1;U;;703;280;423;0;3;277;280
8;Barcelona;13;Barcelonès;08019;Barcelona;1;10;U;;610;299;311;0;5;294;299
8;Barcelona;13;Barcelonès;08019;Barcelona;1;100;U;;380;140;240;0;0;140;140
8;Barcelona;13;Barcelonès;08019;Barcelona;1;101;U;;441;178;263;0;0;178;178
8;Barcelona;13;Barcelonès;08019;Barcelona;1;102;U;;562;226;336;1;1;224;225
8;Barcelona;13;Barcelonès;08019;Barcelona;1;103;U;;805;351;454;1;5;345;350
8;Barcelona;13;Barcelonès;08019;Barcelona;1;104;U;;798;370;428;2;0;368;368
8;Barcelona;13;Barcelonès;08019;Barcelona;1;105;U;;636;250;386;8;1;241;242
8;Barcelona;13;Barcelonès;08019;Barcelona;1;107;U;;850;335;515;1;1;333;334
8;Barcelona;13;Barcelonès;08019;Barcelona;1;108;U;;584;226;358;6;0;220;220
8;Barcelona;13;Barcelonès;08019;Barcelona;1;109;U;;414;163;251;0;1;162;163
8;Barcelona;13;Barcelonès;08019;Barcelona;1;11;U;;435;190;245;0;0;190;190
8;Barcelona;13;Barcelonès;08019;Barcelona;1;110;U;;615;262;353;2;0;260;260
8;Barcelona;13;Barcelonès;08019;Barcelona;1;111;U;;504;244;260;0;8;236;244
8;Barcelona;13;Barcelonès;08019;Barcelona;1;112;U;;418;214;204;1;3;210;213
8;Barcelona;13;Barcelonès;08019;Barcelona;1;113;U;;655;283;372;4;4;275;279
8;Barcelona;13;Barcelonès;08019;Barcelona;1;114;U;;686;306;380;4;1;301;302
8;Barcelona;13;Barcelonès;08019;Barcelona;1;115;U;;696;281;415;2;5;274;279
8;Barcelona;13;Barcelonès;08019;Barcelona;1;116;A;;551;230;321;2;0;228;228
8;Barcelona;13;Barcelonès;08019;Barcelona;1;116;B;;532;222;310;0;0;222;222
8;Barcelona;13;Barcelonès;08019;Barcelona;1;117;U;;696;271;425;0;4;267;271
8;Barcelona;13;Barcelonès;08019;Barcelona;1;118;U;;376;194;182;1;0;193;193
8;Barcelona;13;Barcelonès;08019;Barcelona;1;119;U;;427;199;228;1;3;195;198
8;Barcelona;13;Barcelonès;08019;Barcelona;1;12;U;;485;269;216;0;4;265;269
8;Barcelona;13;Barcelonès;08019;Barcelona;1;120;A;;538;238;300;0;1;237;238
8;Barcelona;13;Barcelonès;08019;Barcelona;1;120;B;;569;242;327;2;3;237;240
8;Barcelona;13;Barcelonès;08019;Barcelona;1;122;U;;725;321;404;0;0;321;321
8;Barcelona;13;Barcelonès;08019;Barcelona;1;123;U;;683;365;318;1;3;361;364
8;Barcelona;13;Barcelonès;08019;Barcelona;1;124;U;;553;237;316;0;1;236;237
8;Barcelona;13;Barcelonès;08019;Barcelona;1;125;U;;377;215;162;0;1;214;215
8;Barcelona;13;Barcelonès;08019;Barcelona;1;126;U;;436;225;211;0;0;225;225
8;Barcelona;13;Barcelonès;08019;Barcelona;1;127;U;;751;389;362;5;3;381;384
8;Barcelona;13;Barcelonès;08019;Barcelona;1;129;U;;546;330;216;1;7;322;329
8;Barcelona;13;Barcelonès;08019;Barcelona;1;13;U;;508;285;223;0;6;279;285
8;Barcelona;13;Barcelonès;08019;Barcelona;1;130;U;;510;275;235;0;2;273;275
8;Barcelona;13;Barcelonès;08019;Barcelona;1;132;U;;755;405;350;3;3;399;402
8;Barcelona;13;Barcelonès;08019;Barcelona;1;133;U;;409;218;191;0;2;216;218
8;Barcelona;13;Barcelonès;08019;Barcelona;1;134;U;;388;187;201;0;1;186;187
8;Barcelona;13;Barcelonès;08019;Barcelona;1;135;U;;436;249;187;0;4;245;249
8;Barcelona;13;Barcelonès;08019;Barcelona;1;136;U;;464;221;243;0;1;220;221
8;Barcelona;13;Barcelonès;08019;Barcelona;1;137;U;;578;290;288;0;4;286;290
8;Barcelona;13;Barcelonès;08019;Barcelona;1;138;U;;549;234;315;6;1;227;228
8;Barcelona;13;Barcelonès;08019;Barcelona;1;139;U;;744;339;405;0;3;336;339
8;Barcelona;13;Barcelonès;08019;Barcelona;1;14;U;;524;245;279;1;2;242;244
8;Barcelona;13;Barcelonès;08019;Barcelona;1;140;U;;718;338;380;0;2;336;338
8;Barcelona;13;Barcelonès;08019;Barcelona;1;141;U;;701;344;357;2;3;339;342
8;Barcelona;13;Barcelonès;08019;Barcelona;1;142;U;;804;413;391;3;2;408;410
8;Barcelona;13;Barcelonès;08019;Barcelona;1;144;U;;806;400;406;4;3;393;396
8;Barcelona;13;Barcelonès;08019;Barcelona;1;146;U;;515;321;194;0;6;315;321
8;Barcelona;13;Barcelonès;08019;Barcelona;1;148;U;;841;470;371;1;1;468;469
8;Barcelona;13;Barcelonès;08019;Barcelona;1;149;U;;560;273;287;1;2;270;272
8;Barcelona;13;Barcelonès;08019;Barcelona;1;15;U;;697;312;385;11;4;297;301
8;Barcelona;13;Barcelonès;08019;Barcelona;1;150;U;;669;361;308;2;1;358;359
8;Barcelona;13;Barcelonès;08019;Barcelona;1;151;U;;678;323;355;0;4;319;323
8;Barcelona;13;Barcelonès;08019;Barcelona;1;16;U;;561;305;256;0;2;303;305
8;Barcelona;13;Barcelonès;08019;Barcelona;1;17;U;;490;264;226;2;0;262;262
8;Barcelona;13;Barcelonès;08019;Barcelona;1;18;U;;690;245;445;0;0;245;245
8;Barcelona;13;Barcelonès;08019;Barcelona;1;19;U;;738;352;386;2;2;348;350
8;Barcelona;13;Barcelonès;08019;Barcelona;1;2;U;;602;298;304;0;0;298;298
8;Barcelona;13;Barcelonès;08019;Barcelona;1;20;U;;489;216;273;0;2;214;216
8;Barcelona;13;Barcelonès;08019;Barcelona;1;21;U;;450;206;244;1;0;205;205
8;Barcelona;13;Barcelonès;08019;Barcelona;1;22;U;;594;242;352;0;4;238;242
8;Barcelona;13;Barcelonès;08019;Barcelona;1;23;U;;450;204;246;0;3;201;204
8;Barcelona;13;Barcelonès;08019;Barcelona;1;24;U;;882;420;462;0;4;416;420
8;Barcelona;13;Barcelonès;08019;Barcelona;1;25;U;;836;431;405;0;5;426;431
8;Barcelona;13;Barcelonès;08019;Barcelona;1;27;U;;559;297;262;3;2;292;294
8;Barcelona;13;Barcelonès;08019;Barcelona;1;28;U;;453;209;244;0;2;207;209
8;Barcelona;13;Barcelonès;08019;Barcelona;1;29;U;;685;330;355;0;4;326;330
8;Barcelona;13;Barcelonès;08019;Barcelona;1;3;U;;379;182;197;0;1;181;182
8;Barcelona;13;Barcelonès;08019;Barcelona;1;30;U;;548;269;279;3;1;265;266
8;Barcelona;13;Barcelonès;08019;Barcelona;1;31;U;;680;340;340;0;2;338;340
8;Barcelona;13;Barcelonès;08019;Barcelona;1;32;U;;652;316;336;2;2;312;314
8;Barcelona;13;Barcelonès;08019;Barcelona;1;33;U;;824;394;430;7;5;382;387
8;Barcelona;13;Barcelonès;08019;Barcelona;1;34;U;;488;240;248;0;2;238;240
8;Barcelona;13;Barcelonès;08019;Barcelona;1;35;U;;469;224;245;2;0;222;222
8;Barcelona;13;Barcelonès;08019;Barcelona;1;36;U;;841;418;423;0;5;413;418
8;Barcelona;13;Barcelonès;08019;Barcelona;1;38;U;;668;336;332;0;3;333;336
8;Barcelona;13;Barcelonès;08019;Barcelona;1;39;U;;828;481;347;0;8;473;481
8;Barcelona;13;Barcelonès;08019;Barcelona;1;4;U;;422;171;251;0;1;170;171
8;Barcelona;13;Barcelonès;08019;Barcelona;1;40;U;;572;277;295;1;2;274;276
8;Barcelona;13;Barcelonès;08019;Barcelona;1;42;U;;434;193;241;1;3;189;192
8;Barcelona;13;Barcelonès;08019;Barcelona;1;43;U;;593;258;335;2;0;256;256
8;Barcelona;13;Barcelonès;08019;Barcelona;1;44;U;;563;247;316;4;1;242;243
8;Barcelona;13;Barcelonès;08019;Barcelona;1;45;U;;652;326;326;0;6;320;326
8;Barcelona;13;Barcelonès;08019;Barcelona;1;46;U;;640;255;385;0;3;252;255
8;Barcelona;13;Barcelonès;08019;Barcelona;1;47;U;;582;280;302;1;2;277;279
8;Barcelona;13;Barcelonès;08019;Barcelona;1;48;U;;644;308;336;0;1;307;308
8;Barcelona;13;Barcelonès;08019;Barcelona;1;49;A;;533;259;274;0;1;258;259
8;Barcelona;13;Barcelonès;08019;Barcelona;1;49;B;;559;254;305;0;4;250;254
8;Barcelona;13;Barcelonès;08019;Barcelona;1;5;U;;673;297;376;1;0;296;296
8;Barcelona;13;Barcelonès;08019;Barcelona;1;50;U;;409;202;207;0;2;200;202
8;Barcelona;13;Barcelonès;08019;Barcelona;1;51;U;;679;366;313;0;7;359;366
8;Barcelona;13;Barcelonès;08019;Barcelona;1;52;U;;666;346;320;0;14;332;346
8;Barcelona;13;Barcelonès;08019;Barcelona;1;53;U;;769;385;384;3;6;376;382
8;Barcelona;13;Barcelonès;08019;Barcelona;1;54;U;;579;302;277;1;1;300;301
8;Barcelona;13;Barcelonès;08019;Barcelona;1;55;U;;518;240;278;2;5;233;238
8;Barcelona;13;Barcelonès;08019;Barcelona;1;56;U;;544;265;279;0;3;262;265
8;Barcelona;13;Barcelonès;08019;Barcelona;1;57;U;;498;295;203;0;2;293;295
8;Barcelona;13;Barcelonès;08019;Barcelona;1;58;U;;751;436;315;8;7;421;428
8;Barcelona;13;Barcelonès;08019;Barcelona;1;59;U;;385;213;172;2;0;211;211
8;Barcelona;13;Barcelonès;08019;Barcelona;1;6;U;;787;336;451;2;6;328;334
8;Barcelona;13;Barcelonès;08019;Barcelona;1;60;U;;371;178;193;2;1;175;176
8;Barcelona;13;Barcelonès;08019;Barcelona;1;61;U;;419;192;227;0;1;191;192
8;Barcelona;13;Barcelonès;08019;Barcelona;1;62;U;;475;269;206;1;10;258;268
8;Barcelona;13;Barcelonès;08019;Barcelona;1;63;U;;547;326;221;1;4;321;325
8;Barcelona;13;Barcelonès;08019;Barcelona;1;64;U;;789;463;326;0;5;458;463
8;Barcelona;13;Barcelonès;08019;Barcelona;1;66;U;;420;222;198;1;2;219;221
8;Barcelona;13;Barcelonès;08019;Barcelona;1;67;U;;468;244;224;2;3;239;242
8;Barcelona;13;Barcelonès;08019;Barcelona;1;68;U;;765;466;299;1;3;462;465
8;Barcelona;13;Barcelonès;08019;Barcelona;1;69;U;;448;229;219;2;4;223;227
8;Barcelona;13;Barcelonès;08019;Barcelona;1;7;U;;791;384;407;0;6;378;384
8;Barcelona;13;Barcelonès;08019;Barcelona;1;70;U;;425;207;218;4;5;198;203
8;Barcelona;13;Barcelonès;08019;Barcelona;1;71;U;;774;357;417;2;4;351;355
8;Barcelona;13;Barcelonès;08019;Barcelona;1;73;U;;568;223;345;1;0;222;222
8;Barcelona;13;Barcelonès;08019;Barcelona;1;75;U;;765;374;391;4;4;366;370
8;Barcelona;13;Barcelonès;08019;Barcelona;1;76;U;;505;245;260;1;1;243;244
8;Barcelona;13;Barcelonès;08019;Barcelona;1;77;U;;477;232;245;2;1;229;230
8;Barcelona;13;Barcelonès;08019;Barcelona;1;78;U;;508;265;243;1;6;258;264
8;Barcelona;13;Barcelonès;08019;Barcelona;1;79;U;;752;355;397;3;0;352;352
8;Barcelona;13;Barcelonès;08019;Barcelona;1;8;U;;803;356;447;0;2;354;356
8;Barcelona;13;Barcelonès;08019;Barcelona;1;82;A;;481;236;245;0;0;236;236
8;Barcelona;13;Barcelonès;08019;Barcelona;1;82;B;;564;275;289;0;1;274;275
8;Barcelona;13;Barcelonès;08019;Barcelona;1;83;U;;553;253;300;1;3;249;252
8;Barcelona;13;Barcelonès;08019;Barcelona;1;84;U;;602;231;371;4;6;221;227
8;Barcelona;13;Barcelonès;08019;Barcelona;1;86;U;;573;244;329;1;4;239;243
8;Barcelona;13;Barcelonès;08019;Barcelona;1;87;U;;814;263;551;0;5;258;263
8;Barcelona;13;Barcelonès;08019;Barcelona;1;88;U;;716;324;392;4;0;320;320
8;Barcelona;13;Barcelonès;08019;Barcelona;1;89;U;;598;240;358;2;3;235;238
8;Barcelona;13;Barcelonès;08019;Barcelona;1;9;U;;718;327;391;1;0;326;326
8;Barcelona;13;Barcelonès;08019;Barcelona;1;90;U;;504;220;284;2;4;214;218
8;Barcelona;13;Barcelonès;08019;Barcelona;1;91;U;;615;230;385;1;5;224;229
8;Barcelona;13;Barcelonès;08019;Barcelona;1;92;U;;504;203;301;1;5;197;202
8;Barcelona;13;Barcelonès;08019;Barcelona;1;94;U;;415;188;227;1;2;185;187
8;Barcelona;13;Barcelonès;08019;Barcelona;1;95;U;;862;381;481;2;7;372;379
8;Barcelona;13;Barcelonès;08019;Barcelona;1;96;U;;575;286;289;0;1;285;286
8;Barcelona;13;Barcelonès;08019;Barcelona;1;97;U;;862;340;522;0;5;335;340
8;Barcelona;13;Barcelonès;08019;Barcelona;1;99;U;;741;289;452;0;2;287;289
8;Barcelona;13;Barcelonès;08019;Barcelona;10;1;A;;544;310;234;0;4;306;310
8;Barcelona;13;Barcelonès;08019;Barcelona;10;1;B;;594;315;279;0;5;310;315
8;Barcelona;13;Barcelonès;08019;Barcelona;10;10;U;;572;330;242;1;7;322;329
8;Barcelona;13;Barcelonès;08019;Barcelona;10;100;U;;540;287;253;0;4;283;287
8;Barcelona;13;Barcelonès;08019;Barcelona;10;101;A;;655;321;334;3;3;315;318
8;Barcelona;13;Barcelonès;08019;Barcelona;10;101;B;;580;283;297;0;1;282;283
8;Barcelona;13;Barcelonès;08019;Barcelona;10;101;C;;781;392;389;0;6;386;392
8;Barcelona;13;Barcelonès;08019;Barcelona;10;101;D;;639;307;332;0;2;305;307
8;Barcelona;13;Barcelonès;08019;Barcelona;10;102;A;;496;288;208;0;7;281;288
8;Barcelona;13;Barcelonès;08019;Barcelona;10;102;B;;499;274;225;0;4;270;274
8;Barcelona;13;Barcelonès;08019;Barcelona;10;103;A;;714;374;340;0;7;367;374
8;Barcelona;13;Barcelonès;08019;Barcelona;10;103;B;;783;396;387;0;3;393;396
8;Barcelona;13;Barcelonès;08019;Barcelona;10;104;U;;779;438;341;1;4;433;437
8;Barcelona;13;Barcelonès;08019;Barcelona;10;105;U;;921;491;430;1;13;477;490
8;Barcelona;13;Barcelonès;08019;Barcelona;10;106;A;;523;287;236;0;4;283;287
8;Barcelona;13;Barcelonès;08019;Barcelona;10;106;B;;576;343;233;2;4;337;341
8;Barcelona;13;Barcelonès;08019;Barcelona;10;107;U;;684;400;284;0;4;396;400
8;Barcelona;13;Barcelonès;08019;Barcelona;10;108;U;;570;314;256;0;2;312;314
8;Barcelona;13;Barcelonès;08019;Barcelona;10;109;U;;777;424;353;2;1;421;422
8;Barcelona;13;Barcelonès;08019;Barcelona;10;11;U;;954;464;490;2;9;453;462
8;Barcelona;13;Barcelonès;08019;Barcelona;10;110;U;;745;399;346;1;2;396;398
8;Barcelona;13;Barcelonès;08019;Barcelona;10;111;U;;436;253;183;0;2;251;253
8;Barcelona;13;Barcelonès;08019;Barcelona;10;112;U;;514;257;257;0;1;256;257
8;Barcelona;13;Barcelonès;08019;Barcelona;10;113;U;;421;225;196;0;1;224;225
8;Barcelona;13;Barcelonès;08019;Barcelona;10;114;U;;986;595;391;5;8;582;590
8;Barcelona;13;Barcelonès;08019;Barcelona;10;115;U;;877;482;395;6;8;468;476
8;Barcelona;13;Barcelonès;08019;Barcelona;10;116;A;;513;347;166;0;2;345;347
8;Barcelona;13;Barcelonès;08019;Barcelona;10;116;B;;528;322;206;1;3;318;321
8;Barcelona;13;Barcelonès;08019;Barcelona;10;117;U;;711;442;269;0;3;439;442
8;Barcelona;13;Barcelonès;08019;Barcelona;10;118;U;;617;365;252;0;4;361;365
8;Barcelona;13;Barcelonès;08019;Barcelona;10;119;U;;414;258;156;2;5;251;256
8;Barcelona;13;Barcelonès;08019;Barcelona;10;120;U;;710;407;303;0;6;401;407
8;Barcelona;13;Barcelonès;08019;Barcelona;10;121;U;;931;584;347;1;8;575;583
8;Barcelona;13;Barcelonès;08019;Barcelona;10;122;A;;516;304;212;0;1;303;304
8;Barcelona;13;Barcelonès;08019;Barcelona;10;122;B;;485;278;207;0;6;272;278
8;Barcelona;13;Barcelonès;08019;Barcelona;10;123;U;;440;282;158;2;3;277;280
8;Barcelona;13;Barcelonès;08019;Barcelona;10;124;U;;702;401;301;8;8;385;393
8;Barcelona;13;Barcelonès;08019;Barcelona;10;125;U;;600;351;249;2;4;345;349
8;Barcelona;13;Barcelonès;08019;Barcelona;10;126;U;;556;265;291;4;4;257;261
8;Barcelona;13;Barcelonès;08019;Barcelona;10;127;U;;512;302;210;2;3;297;300
8;Barcelona;13;Barcelonès;08019;Barcelona;10;128;U;;581;336;245;0;14;322;336
8;Barcelona;13;Barcelonès;08019;Barcelona;10;129;U;;554;325;229;3;9;313;322
8;Barcelona;13;Barcelonès;08019;Barcelona;10;13;U;;594;284;310;5;4;275;279
8;Barcelona;13;Barcelonès;08019;Barcelona;10;130;U;;578;335;243;1;5;329;334
8;Barcelona;13;Barcelonès;08019;Barcelona;10;131;U;;535;318;217;3;5;310;315
8;Barcelona;13;Barcelonès;08019;Barcelona;10;132;U;;516;319;197;1;1;317;318
8;Barcelona;13;Barcelonès;08019;Barcelona;10;133;A;;544;374;170;0;7;367;374
8;Barcelona;13;Barcelonès;08019;Barcelona;10;133;B;;653;421;232;1;19;401;420
8;Barcelona;13;Barcelonès;08019;Barcelona;10;134;U;;797;479;318;0;7;472;479
8;Barcelona;13;Barcelonès;08019;Barcelona;10;135;U;;584;307;277;3;6;298;304
8;Barcelona;13;Barcelonès;08019;Barcelona;10;136;U;;475;267;208;0;4;263;267
8;Barcelona;13;Barcelonès;08019;Barcelona;10;137;U;;627;348;279;1;8;339;347
8;Barcelona;13;Barcelonès;08019;Barcelona;10;138;A;;525;327;198;2;11;314;325
8;Barcelona;13;Barcelonès;08019;Barcelona;10;138;B;;543;323;220;0;3;320;323
8;Barcelona;13;Barcelonès;08019;Barcelona;10;139;U;;794;432;362;3;9;420;429
8;Barcelona;13;Barcelonès;08019;Barcelona;10;14;U;;485;180;305;1;0;179;179
8;Barcelona;13;Barcelonès;08019;Barcelona;10;140;U;;488;272;216;2;4;266;270
8;Barcelona;13;Barcelonès;08019;Barcelona;10;141;U;;741;400;341;1;3;396;399
8;Barcelona;13;Barcelonès;08019;Barcelona;10;142;U;;804;486;318;0;2;484;486
8;Barcelona;13;Barcelonès;08019;Barcelona;10;143;U;;531;256;275;0;2;254;256
8;Barcelona;13;Barcelonès;08019;Barcelona;10;144;U;;787;425;362;0;6;419;425
8;Barcelona;13;Barcelonès;08019;Barcelona;10;145;U;;972;492;480;9;0;483;483
8;Barcelona;13;Barcelonès;08019;Barcelona;10;146;U;;672;380;292;1;4;375;379
8;Barcelona;13;Barcelonès;08019;Barcelona;10;147;U;;693;410;283;1;7;402;409
8;Barcelona;13;Barcelonès;08019;Barcelona;10;149;U;;832;502;330;0;3;499;502
8;Barcelona;13;Barcelonès;08019;Barcelona;10;150;A;;480;269;211;2;1;266;267
8;Barcelona;13;Barcelonès;08019;Barcelona;10;150;B;;538;324;214;0;5;319;324
8;Barcelona;13;Barcelonès;08019;Barcelona;10;151;U;;598;334;264;0;1;333;334
8;Barcelona;13;Barcelonès;08019;Barcelona;10;152;U;;477;290;187;2;3;285;288
8;Barcelona;13;Barcelonès;08019;Barcelona;10;153;U;;794;471;323;3;1;467;468
8;Barcelona;13;Barcelonès;08019;Barcelona;10;154;U;;575;311;264;0;2;309;311
8;Barcelona;13;Barcelonès;08019;Barcelona;10;155;A;;599;313;286;1;5;307;312
8;Barcelona;13;Barcelonès;08019;Barcelona;10;155;B;;693;370;323;6;3;361;364
8;Barcelona;13;Barcelonès;08019;Barcelona;10;156;A;;679;378;301;4;2;372;374
8;Barcelona;13;Barcelonès;08019;Barcelona;10;156;B;;695;385;310;0;2;383;385
8;Barcelona;13;Barcelonès;08019;Barcelona;10;157;U;;462;252;210;0;4;248;252
8;Barcelona;13;Barcelonès;08019;Barcelona;10;158;U;;588;309;279;0;5;304;309
8;Barcelona;13;Barcelonès;08019;Barcelona;10;16;U;;377;182;195;0;3;179;182
8;Barcelona;13;Barcelonès;08019;Barcelona;10;160;A;;506;311;195;0;8;303;311
8;Barcelona;13;Barcelonès;08019;Barcelona;10;160;B;;625;387;238;1;6;380;386
8;Barcelona;13;Barcelonès;08019;Barcelona;10;161;U;;463;282;181;0;5;277;282
8;Barcelona;13;Barcelonès;08019;Barcelona;10;162;U;;590;327;263;0;3;324;327
8;Barcelona;13;Barcelonès;08019;Barcelona;10;163;A;;611;345;266;0;3;342;345
8;Barcelona;13;Barcelonès;08019;Barcelona;10;163;B;;626;348;278;0;2;346;348
8;Barcelona;13;Barcelonès;08019;Barcelona;10;164;A;;474;248;226;0;1;247;248
8;Barcelona;13;Barcelonès;08019;Barcelona;10;164;B;;548;294;254;0;4;290;294
8;Barcelona;13;Barcelonès;08019;Barcelona;10;165;U;;938;495;443;0;4;491;495
8;Barcelona;13;Barcelonès;08019;Barcelona;10;166;U;;494;281;213;3;1;277;278
8;Barcelona;13;Barcelonès;08019;Barcelona;10;167;U;;462;290;172;0;2;288;290
8;Barcelona;13;Barcelonès;08019;Barcelona;10;168;U;;494;265;229;0;0;265;265
8;Barcelona;13;Barcelonès;08019;Barcelona;10;169;U;;491;251;240;0;0;251;251
8;Barcelona;13;Barcelonès;08019;Barcelona;10;17;U;;651;317;334;4;2;311;313
8;Barcelona;13;Barcelonès;08019;Barcelona;10;170;U;;550;296;254;0;4;292;296
8;Barcelona;13;Barcelonès;08019;Barcelona;10;171;U;;580;312;268;0;2;310;312
8;Barcelona;13;Barcelonès;08019;Barcelona;10;172;U;;763;419;344;0;5;414;419
8;Barcelona;13;Barcelonès;08019;Barcelona;10;173;A;;584;334;250;0;7;327;334
8;Barcelona;13;Barcelonès;08019;Barcelona;10;173;B;;698;400;298;1;2;397;399
8;Barcelona;13;Barcelonès;08019;Barcelona;10;174;U;;706;385;321;1;2;382;384
8;Barcelona;13;Barcelonès;08019;Barcelona;10;175;A;;516;290;226;2;2;286;288
8;Barcelona;13;Barcelonès;08019;Barcelona;10;175;B;;596;332;264;0;9;323;332
8;Barcelona;13;Barcelonès;08019;Barcelona;10;176;A;;506;216;290;0;0;216;216
8;Barcelona;13;Barcelonès;08019;Barcelona;10;176;B;;603;213;390;2;0;211;211
8;Barcelona;13;Barcelonès;08019;Barcelona;10;176;C;;639;239;400;1;3;235;238
8;Barcelona;13;Barcelonès;08019;Barcelona;10;177;U;;669;350;319;10;7;333;340
8;Barcelona;13;Barcelonès;08019;Barcelona;10;178;U;;627;338;289;3;2;333;335
8;Barcelona;13;Barcelonès;08019;Barcelona;10;179;U;;443;228;215;0;3;225;228
8;Barcelona;13;Barcelonès;08019;Barcelona;10;18;U;;456;217;239;1;2;214;216
8;Barcelona;13;Barcelonès;08019;Barcelona;10;180;U;;410;221;189;0;1;220;221
8;Barcelona;13;Barcelonès;08019;Barcelona;10;181;U;;895;453;442;1;5;447;452
8;Barcelona;13;Barcelonès;08019;Barcelona;10;182;U;;637;361;276;4;2;355;357
8;Barcelona;13;Barcelonès;08019;Barcelona;10;183;A;;576;284;292;0;4;280;284
8;Barcelona;13;Barcelonès;08019;Barcelona;10;183;B;;654;333;321;2;3;328;331
8;Barcelona;13;Barcelonès;08019;Barcelona;10;184;U;;511;290;221;0;7;283;290
8;Barcelona;13;Barcelonès;08019;Barcelona;10;185;U;;802;412;390;0;16;396;412
8;Barcelona;13;Barcelonès;08019;Barcelona;10;186;U;;704;406;298;0;8;398;406
8;Barcelona;13;Barcelonès;08019;Barcelona;10;187;U;;892;555;337;11;1;543;544
8;Barcelona;13;Barcelonès;08019;Barcelona;10;188;U;;848;496;352;6;8;482;490
8;Barcelona;13;Barcelonès;08019;Barcelona;10;189;U;;756;407;349;1;11;395;406
8;Barcelona;13;Barcelonès;08019;Barcelona;10;19;U;;720;352;368;0;8;344;352
8;Barcelona;13;Barcelonès;08019;Barcelona;10;190;U;;879;561;318;3;15;543;558
8;Barcelona;13;Barcelonès;08019;Barcelona;10;191;A;;576;338;238;0;5;333;338
8;Barcelona;13;Barcelonès;08019;Barcelona;10;191;B;;578;330;248;0;5;325;330
8;Barcelona;13;Barcelonès;08019;Barcelona;10;192;A;;628;308;320;0;5;303;308
8;Barcelona;13;Barcelonès;08019;Barcelona;10;192;B;;735;375;360;0;2;373;375
8;Barcelona;13;Barcelonès;08019;Barcelona;10;193;U;;603;275;328;0;4;271;275
8;Barcelona;13;Barcelonès;08019;Barcelona;10;194;A;;653;340;313;0;5;335;340
8;Barcelona;13;Barcelonès;08019;Barcelona;10;194;B;;641;331;310;1;4;326;330
8;Barcelona;13;Barcelonès;08019;Barcelona;10;195;A;;524;282;242;0;5;277;282
8;Barcelona;13;Barcelonès;08019;Barcelona;10;195;B;;609;298;311;1;7;290;297
8;Barcelona;13;Barcelonès;08019;Barcelona;10;195;C;;711;355;356;0;5;350;355
8;Barcelona;13;Barcelonès;08019;Barcelona;10;197;A;;595;351;244;2;8;341;349
8;Barcelona;13;Barcelonès;08019;Barcelona;10;197;B;;591;337;254;0;6;331;337
8;Barcelona;13;Barcelonès;08019;Barcelona;10;198;U;;961;465;496;0;6;459;465
8;Barcelona;13;Barcelonès;08019;Barcelona;10;199;A;;625;300;325;0;2;298;300
8;Barcelona;13;Barcelonès;08019;Barcelona;10;199;B;;686;369;317;0;2;367;369
8;Barcelona;13;Barcelonès;08019;Barcelona;10;2;A;;486;269;217;0;4;265;269
8;Barcelona;13;Barcelonès;08019;Barcelona;10;2;B;;525;289;236;2;4;283;287
8;Barcelona;13;Barcelonès;08019;Barcelona;10;20;U;;756;362;394;3;1;358;359
8;Barcelona;13;Barcelonès;08019;Barcelona;10;200;U;;973;469;504;2;5;462;467
8;Barcelona;13;Barcelonès;08019;Barcelona;10;201;U;;532;260;272;2;4;254;258
8;Barcelona;13;Barcelonès;08019;Barcelona;10;202;A;;513;274;239;1;10;263;273
8;Barcelona;13;Barcelonès;08019;Barcelona;10;202;B;;604;302;302;1;10;291;301
8;Barcelona;13;Barcelonès;08019;Barcelona;10;202;C;;549;284;265;0;6;278;284
8;Barcelona;13;Barcelonès;08019;Barcelona;10;203;U;;645;339;306;0;7;332;339
8;Barcelona;13;Barcelonès;08019;Barcelona;10;204;U;;732;400;332;2;10;388;398
8;Barcelona;13;Barcelonès;08019;Barcelona;10;205;U;;592;301;291;0;2;299;301
8;Barcelona;13;Barcelonès;08019;Barcelona;10;206;U;;881;395;486;0;4;391;395
8;Barcelona;13;Barcelonès;08019;Barcelona;10;207;A;;594;307;287;0;5;302;307
8;Barcelona;13;Barcelonès;08019;Barcelona;10;207;B;;685;391;294;0;5;386;391
8;Barcelona;13;Barcelonès;08019;Barcelona;10;208;U;;679;343;336;0;5;338;343
8;Barcelona;13;Barcelonès;08019;Barcelona;10;209;U;;704;326;378;0;3;323;326
8;Barcelona;13;Barcelonès;08019;Barcelona;10;21;A;;500;288;212;0;6;282;288
8;Barcelona;13;Barcelonès;08019;Barcelona;10;21;B;;542;295;247;2;2;291;293
8;Barcelona;13;Barcelonès;08019;Barcelona;10;210;U;;561;254;307;0;3;251;254
8;Barcelona;13;Barcelonès;08019;Barcelona;10;211;A;;471;252;219;1;2;249;251
8;Barcelona;13;Barcelonès;08019;Barcelona;10;211;B;;576;286;290;0;2;284;286
8;Barcelona;13;Barcelonès;08019;Barcelona;10;212;A;;476;236;240;0;7;229;236
8;Barcelona;13;Barcelonès;08019;Barcelona;10;212;B;;549;268;281;1;6;261;267
8;Barcelona;13;Barcelonès;08019;Barcelona;10;213;U;;524;226;298;1;3;222;225
8;Barcelona;13;Barcelonès;08019;Barcelona;10;214;U;;641;309;332;0;5;304;309
8;Barcelona;13;Barcelonès;08019;Barcelona;10;215;A;;460;216;244;0;1;215;216
8;Barcelona;13;Barcelonès;08019;Barcelona;10;215;B;;562;285;277;0;4;281;285
8;Barcelona;13;Barcelonès;08019;Barcelona;10;216;U;;766;364;402;1;4;359;363
8;Barcelona;13;Barcelonès;08019;Barcelona;10;217;U;;496;217;279;0;3;214;217
8;Barcelona;13;Barcelonès;08019;Barcelona;10;218;U;;958;433;525;7;4;422;426
8;Barcelona;13;Barcelonès;08019;Barcelona;10;219;U;;408;195;213;1;0;194;194
8;Barcelona;13;Barcelonès;08019;Barcelona;10;22;U;;740;383;357;1;0;382;382
8;Barcelona;13;Barcelonès;08019;Barcelona;10;220;A;;548;265;283;0;3;262;265
8;Barcelona;13;Barcelonès;08019;Barcelona;10;220;B;;620;291;329;1;3;287;290
8;Barcelona;13;Barcelonès;08019;Barcelona;10;221;U;;873;404;469;0;5;399;404
8;Barcelona;13;Barcelonès;08019;Barcelona;10;222;A;;476;224;252;1;0;223;223
8;Barcelona;13;Barcelonès;08019;Barcelona;10;222;B;;537;292;245;0;0;292;292
8;Barcelona;13;Barcelonès;08019;Barcelona;10;223;A;;501;243;258;0;1;242;243
8;Barcelona;13;Barcelonès;08019;Barcelona;10;223;B;;573;298;275;0;3;295;298
8;Barcelona;13;Barcelonès;08019;Barcelona;10;223;C;;557;258;299;1;0;257;257
8;Barcelona;13;Barcelonès;08019;Barcelona;10;224;A;;740;420;320;7;2;411;413
8;Barcelona;13;Barcelonès;08019;Barcelona;10;224;B;;758;405;353;3;4;398;402
8;Barcelona;13;Barcelonès;08019;Barcelona;10;225;A;;486;257;229;1;4;252;256
8;Barcelona;13;Barcelonès;08019;Barcelona;10;225;B;;537;251;286;1;3;247;250
8;Barcelona;13;Barcelonès;08019;Barcelona;10;226;U;;955;451;504;1;3;447;450
8;Barcelona;13;Barcelonès;08019;Barcelona;10;227;U;;437;231;206;1;2;228;230
8;Barcelona;13;Barcelonès;08019;Barcelona;10;228;U;;395;197;198;0;1;196;197
8;Barcelona;13;Barcelonès;08019;Barcelona;10;23;U;;545;280;265;0;3;277;280
8;Barcelona;13;Barcelonès;08019;Barcelona;10;24;U;;453;252;201;0;1;251;252
8;Barcelona;13;Barcelonès;08019;Barcelona;10;25;U;;865;518;347;0;7;511;518
8;Barcelona;13;Barcelonès;08019;Barcelona;10;26;U;;405;225;180;0;3;222;225
8;Barcelona;13;Barcelonès;08019;Barcelona;10;27;U;;471;238;233;2;6;230;236
8;Barcelona;13;Barcelonès;08019;Barcelona;10;28;U;;526;278;248;1;0;277;277
8;Barcelona;13;Barcelonès;08019;Barcelona;10;29;U;;368;215;153;0;1;214;215
8;Barcelona;13;Barcelonès;08019;Barcelona;10;3;U;;433;240;193;0;7;233;240
8;Barcelona;13;Barcelonès;08019;Barcelona;10;30;U;;551;303;248;1;2;300;302
8;Barcelona;13;Barcelonès;08019;Barcelona;10;31;U;;726;422;304;0;4;418;422
8;Barcelona;13;Barcelonès;08019;Barcelona;10;32;U;;396;275;121;0;2;273;275
8;Barcelona;13;Barcelonès;08019;Barcelona;10;33;U;;432;258;174;0;1;257;258
8;Barcelona;13;Barcelonès;08019;Barcelona;10;34;U;;555;333;222;0;1;332;333
8;Barcelona;13;Barcelonès;08019;Barcelona;10;35;U;;620;384;236;0;5;379;384
8;Barcelona;13;Barcelonès;08019;Barcelona;10;36;U;;820;443;377;1;4;438;442
8;Barcelona;13;Barcelonès;08019;Barcelona;10;37;U;;643;309;334;0;1;308;309
8;Barcelona;13;Barcelonès;08019;Barcelona;10;38;U;;642;316;326;0;2;314;316
8;Barcelona;13;Barcelonès;08019;Barcelona;10;39;U;;622;311;311;1;4;306;310
8;Barcelona;13;Barcelonès;08019;Barcelona;10;4;U;;821;419;402;1;11;407;418
8;Barcelona;13;Barcelonès;08019;Barcelona;10;40;A;;702;335;367;0;1;334;335
8;Barcelona;13;Barcelonès;08019;Barcelona;10;40;B;;802;391;411;3;4;384;388
8;Barcelona;13;Barcelonès;08019;Barcelona;10;41;U;;866;440;426;1;6;433;439
8;Barcelona;13;Barcelonès;08019;Barcelona;10;43;U;;442;218;224;0;0;218;218
8;Barcelona;13;Barcelonès;08019;Barcelona;10;44;A;;449;263;186;1;1;261;262
8;Barcelona;13;Barcelonès;08019;Barcelona;10;44;B;;557;297;260;0;2;295;297
8;Barcelona;13;Barcelonès;08019;Barcelona;10;45;U;;782;372;410;2;5;365;370
8;Barcelona;13;Barcelonès;08019;Barcelona;10;46;A;;470;236;234;3;6;227;233
8;Barcelona;13;Barcelonès;08019;Barcelona;10;46;B;;524;287;237;0;2;285;287
8;Barcelona;13;Barcelonès;08019;Barcelona;10;47;U;;570;285;285;1;8;276;284
8;Barcelona;13;Barcelonès;08019;Barcelona;10;48;U;;743;425;318;3;4;418;422
8;Barcelona;13;Barcelonès;08019;Barcelona;10;49;U;;469;296;173;0;4;292;296
8;Barcelona;13;Barcelonès;08019;Barcelona;10;5;A;;545;282;263;1;5;276;281
8;Barcelona;13;Barcelonès;08019;Barcelona;10;5;B;;596;330;266;1;7;322;329
8;Barcelona;13;Barcelonès;08019;Barcelona;10;50;U;;792;438;354;0;5;433;438
8;Barcelona;13;Barcelonès;08019;Barcelona;10;51;A;;459;257;202;0;1;256;257
8;Barcelona;13;Barcelonès;08019;Barcelona;10;51;B;;581;272;309;1;2;269;271
8;Barcelona;13;Barcelonès;08019;Barcelona;10;53;U;;659;330;329;6;1;323;324
8;Barcelona;13;Barcelonès;08019;Barcelona;10;54;U;;841;450;391;0;8;442;450
8;Barcelona;13;Barcelonès;08019;Barcelona;10;56;A;;512;318;194;1;2;315;317
8;Barcelona;13;Barcelonès;08019;Barcelona;10;56;B;;574;333;241;0;2;331;333
8;Barcelona;13;Barcelonès;08019;Barcelona;10;57;A;;632;341;291;0;9;332;341
8;Barcelona;13;Barcelonès;08019;Barcelona;10;57;B;;680;352;328;0;2;350;352
8;Barcelona;13;Barcelonès;08019;Barcelona;10;57;C;;698;350;348;0;1;349;350
8;Barcelona;13;Barcelonès;08019;Barcelona;10;58;U;;830;477;353;1;9;467;476
8;Barcelona;13;Barcelonès;08019;Barcelona;10;59;A;;690;345;345;2;8;335;343
8;Barcelona;13;Barcelonès;08019;Barcelona;10;59;B;;678;351;327;1;5;345;350
8;Barcelona;13;Barcelonès;08019;Barcelona;10;59;C;;711;379;332;2;2;375;377
8;Barcelona;13;Barcelonès;08019;Barcelona;10;6;A;;483;251;232;1;1;249;250
8;Barcelona;13;Barcelonès;08019;Barcelona;10;6;B;;554;308;246;0;10;298;308
8;Barcelona;13;Barcelonès;08019;Barcelona;10;60;A;;642;345;297;3;8;334;342
8;Barcelona;13;Barcelonès;08019;Barcelona;10;60;B;;720;405;315;0;3;402;405
8;Barcelona;13;Barcelonès;08019;Barcelona;10;60;C;;648;348;300;0;5;343;348
8;Barcelona;13;Barcelonès;08019;Barcelona;10;62;U;;633;261;372;0;3;258;261
8;Barcelona;13;Barcelonès;08019;Barcelona;10;63;U;;475;205;270;0;0;205;205
8;Barcelona;13;Barcelonès;08019;Barcelona;10;64;U;;505;216;289;2;1;213;214
8;Barcelona;13;Barcelonès;08019;Barcelona;10;65;A;;722;382;340;3;6;373;379
8;Barcelona;13;Barcelonès;08019;Barcelona;10;65;B;;623;306;317;0;6;300;306
8;Barcelona;13;Barcelonès;08019;Barcelona;10;65;C;;861;474;387;0;8;466;474
8;Barcelona;13;Barcelonès;08019;Barcelona;10;65;D;;623;313;310;1;4;308;312
8;Barcelona;13;Barcelonès;08019;Barcelona;10;66;U;;466;230;236;0;0;230;230
8;Barcelona;13;Barcelonès;08019;Barcelona;10;67;U;;542;277;265;0;5;272;277
8;Barcelona;13;Barcelonès;08019;Barcelona;10;68;U;;876;435;441;2;4;429;433
8;Barcelona;13;Barcelonès;08019;Barcelona;10;69;U;;606;337;269;4;7;326;333
8;Barcelona;13;Barcelonès;08019;Barcelona;10;70;U;;665;282;383;0;0;282;282
8;Barcelona;13;Barcelonès;08019;Barcelona;10;71;A;;516;230;286;2;4;224;228
8;Barcelona;13;Barcelonès;08019;Barcelona;10;71;B;;571;259;312;0;5;254;259
8;Barcelona;13;Barcelonès;08019;Barcelona;10;72;U;;780;401;379;0;2;399;401
8;Barcelona;13;Barcelonès;08019;Barcelona;10;73;A;;592;256;336;0;3;253;256
8;Barcelona;13;Barcelonès;08019;Barcelona;10;73;B;;600;270;330;0;1;269;270
8;Barcelona;13;Barcelonès;08019;Barcelona;10;75;U;;706;299;407;0;5;294;299
8;Barcelona;13;Barcelonès;08019;Barcelona;10;76;U;;654;285;369;3;3;279;282
8;Barcelona;13;Barcelonès;08019;Barcelona;10;77;U;;542;216;326;0;2;214;216
8;Barcelona;13;Barcelonès;08019;Barcelona;10;78;U;;640;301;339;1;2;298;300
8;Barcelona;13;Barcelonès;08019;Barcelona;10;79;U;;880;435;445;1;2;432;434
8;Barcelona;13;Barcelonès;08019;Barcelona;10;8;U;;721;467;254;0;7;460;467
8;Barcelona;13;Barcelonès;08019;Barcelona;10;80;U;;534;281;253;1;4;276;280
8;Barcelona;13;Barcelonès;08019;Barcelona;10;81;U;;515;192;323;1;2;189;191
8;Barcelona;13;Barcelonès;08019;Barcelona;10;82;A;;589;272;317;0;1;271;272
8;Barcelona;13;Barcelonès;08019;Barcelona;10;82;B;;523;256;267;0;3;253;256
8;Barcelona;13;Barcelonès;08019;Barcelona;10;83;U;;427;218;209;0;0;218;218
8;Barcelona;13;Barcelonès;08019;Barcelona;10;84;U;;468;210;258;0;0;210;210
8;Barcelona;13;Barcelonès;08019;Barcelona;10;85;U;;794;391;403;1;2;388;390
8;Barcelona;13;Barcelonès;08019;Barcelona;10;86;U;;545;293;252;0;4;289;293
8;Barcelona;13;Barcelonès;08019;Barcelona;10;87;U;;588;322;266;0;1;321;322
8;Barcelona;13;Barcelonès;08019;Barcelona;10;88;U;;898;458;440;0;4;454;458
8;Barcelona;13;Barcelonès;08019;Barcelona;10;89;U;;831;411;420;8;6;397;403
8;Barcelona;13;Barcelonès;08019;Barcelona;10;9;U;;924;484;440;4;10;470;480
8;Barcelona;13;Barcelonès;08019;Barcelona;10;90;U;;631;342;289;2;7;333;340
8;Barcelona;13;Barcelonès;08019;Barcelona;10;91;U;;499;254;245;0;4;250;254
8;Barcelona;13;Barcelonès;08019;Barcelona;10;92;U;;635;316;319;2;2;312;314
8;Barcelona;13;Barcelonès;08019;Barcelona;10;93;A;;498;226;272;0;0;226;226
8;Barcelona;13;Barcelonès;08019;Barcelona;10;93;B;;557;247;310;1;2;244;246
8;Barcelona;13;Barcelonès;08019;Barcelona;10;94;U;;774;423;351;3;12;408;420
8;Barcelona;13;Barcelonès;08019;Barcelona;10;96;A;;572;291;281;0;5;286;291
8;Barcelona;13;Barcelonès;08019;Barcelona;10;96;B;;712;354;358;0;5;349;354
8;Barcelona;13;Barcelonès;08019;Barcelona;10;98;A;;710;328;382;1;6;321;327
8;Barcelona;13;Barcelonès;08019;Barcelona;10;98;B;;827;408;419;1;4;403;407
8;Barcelona;13;Barcelonès;08019;Barcelona;10;98;C;;750;350;400;1;6;343;349
8;Barcelona;13;Barcelonès;08019;Barcelona;10;99;U;;534;245;289;1;7;237;244
8;Barcelona;13;Barcelonès;08019;Barcelona;2;1;U;;524;320;204;0;3;317;320
8;Barcelona;13;Barcelonès;08019;Barcelona;2;10;U;;567;328;239;1;5;322;327
8;Barcelona;13;Barcelonès;08019;Barcelona;2;100;U;;557;345;212;0;5;340;345
8;Barcelona;13;Barcelonès;08019;Barcelona;2;101;U;;963;585;378;4;0;581;581
8;Barcelona;13;Barcelonès;08019;Barcelona;2;102;U;;894;545;349;2;7;536;543
8;Barcelona;13;Barcelonès;08019;Barcelona;2;103;U;;759;435;324;4;4;427;431
8;Barcelona;13;Barcelonès;08019;Barcelona;2;104;U;;658;384;274;3;7;374;381
8;Barcelona;13;Barcelonès;08019;Barcelona;2;105;U;;716;417;299;2;4;411;415
8;Barcelona;13;Barcelonès;08019;Barcelona;2;106;U;;757;435;322;0;4;431;435
8;Barcelona;13;Barcelonès;08019;Barcelona;2;107;U;;546;352;194;1;6;345;351
8;Barcelona;13;Barcelonès;08019;Barcelona;2;108;U;;588;371;217;0;10;361;371
8;Barcelona;13;Barcelonès;08019;Barcelona;2;109;U;;567;312;255;3;5;304;309
8;Barcelona;13;Barcelonès;08019;Barcelona;2;11;U;;871;519;352;0;8;511;519
8;Barcelona;13;Barcelonès;08019;Barcelona;2;110;U;;418;215;203;0;3;212;215
8;Barcelona;13;Barcelonès;08019;Barcelona;2;111;U;;447;282;165;0;1;281;282
8;Barcelona;13;Barcelonès;08019;Barcelona;2;112;U;;427;271;156;0;6;265;271
8;Barcelona;13;Barcelonès;08019;Barcelona;2;113;U;;397;246;151;0;2;244;246
8;Barcelona;13;Barcelonès;08019;Barcelona;2;114;U;;447;300;147;1;5;294;299
8;Barcelona;13;Barcelonès;08019;Barcelona;2;115;U;;512;301;211;0;3;298;301
8;Barcelona;13;Barcelonès;08019;Barcelona;2;116;U;;418;278;140;2;3;273;276
8;Barcelona;13;Barcelonès;08019;Barcelona;2;117;U;;500;340;160;2;6;332;338
8;Barcelona;13;Barcelonès;08019;Barcelona;2;118;U;;564;375;189;1;5;369;374
8;Barcelona;13;Barcelonès;08019;Barcelona;2;119;U;;717;456;261;1;4;451;455
8;Barcelona;13;Barcelonès;08019;Barcelona;2;12;U;;823;494;329;0;3;491;494
8;Barcelona;13;Barcelonès;08019;Barcelona;2;120;U;;564;351;213;0;1;350;351
8;Barcelona;13;Barcelonès;08019;Barcelona;2;121;U;;566;362;204;0;1;361;362
8;Barcelona;13;Barcelonès;08019;Barcelona;2;122;U;;689;444;245;2;2;440;442
8;Barcelona;13;Barcelonès;08019;Barcelona;2;123;U;;477;279;198;0;6;273;279
8;Barcelona;13;Barcelonès;08019;Barcelona;2;124;U;;697;453;244;2;8;443;451
8;Barcelona;13;Barcelonès;08019;Barcelona;2;125;U;;768;495;273;0;12;483;495
8;Barcelona;13;Barcelonès;08019;Barcelona;2;126;U;;575;392;183;1;6;385;391
8;Barcelona;13;Barcelonès;08019;Barcelona;2;127;U;;822;494;328;4;21;469;490
8;Barcelona;13;Barcelonès;08019;Barcelona;2;128;A;;577;373;204;1;3;369;372
8;Barcelona;13;Barcelonès;08019;Barcelona;2;128;B;;611;382;229;3;3;376;379
8;Barcelona;13;Barcelonès;08019;Barcelona;2;129;A;;514;338;176;0;6;332;338
8;Barcelona;13;Barcelonès;08019;Barcelona;2;129;B;;493;333;160;2;5;326;331
8;Barcelona;13;Barcelonès;08019;Barcelona;2;13;A;;620;377;243;0;3;374;377
8;Barcelona;13;Barcelonès;08019;Barcelona;2;13;B;;682;424;258;0;7;417;424
8;Barcelona;13;Barcelonès;08019;Barcelona;2;130;U;;799;502;297;0;9;493;502
8;Barcelona;13;Barcelonès;08019;Barcelona;2;131;U;;884;486;398;2;3;481;484
8;Barcelona;13;Barcelonès;08019;Barcelona;2;132;A;;598;378;220;2;6;370;376
8;Barcelona;13;Barcelonès;08019;Barcelona;2;132;B;;572;345;227;0;11;334;345
8;Barcelona;13;Barcelonès;08019;Barcelona;2;133;U;;787;524;263;4;3;517;520
8;Barcelona;13;Barcelonès;08019;Barcelona;2;134;A;;683;389;294;0;0;389;389
8;Barcelona;13;Barcelonès;08019;Barcelona;2;134;B;;666;415;251;3;3;409;412
8;Barcelona;13;Barcelonès;08019;Barcelona;2;135;A;;554;324;230;4;6;314;320
8;Barcelona;13;Barcelonès;08019;Barcelona;2;135;B;;564;363;201;3;9;351;360
8;Barcelona;13;Barcelonès;08019;Barcelona;2;136;U;;459;297;162;1;4;292;296
8;Barcelona;13;Barcelonès;08019;Barcelona;2;137;A;;549;364;185;0;8;356;364
8;Barcelona;13;Barcelonès;08019;Barcelona;2;137;B;;593;380;213;0;8;372;380
8;Barcelona;13;Barcelonès;08019;Barcelona;2;138;U;;432;279;153;0;1;278;279
8;Barcelona;13;Barcelonès;08019;Barcelona;2;139;A;;436;268;168;0;3;265;268
8;Barcelona;13;Barcelonès;08019;Barcelona;2;139;B;;576;282;294;0;5;277;282
8;Barcelona;13;Barcelonès;08019;Barcelona;2;14;U;;719;391;328;0;3;388;391
8;Barcelona;13;Barcelonès;08019;Barcelona;2;140;A;;508;249;259;1;3;245;248
8;Barcelona;13;Barcelonès;08019;Barcelona;2;140;B;;609;294;315;2;3;289;292
8;Barcelona;13;Barcelonès;08019;Barcelona;2;141;U;;792;435;357;0;3;432;435
8;Barcelona;13;Barcelonès;08019;Barcelona;2;142;U;;700;389;311;1;9;379;388
8;Barcelona;13;Barcelonès;08019;Barcelona;2;143;A;;570;151;419;0;0;151;151
8;Barcelona;13;Barcelonès;08019;Barcelona;2;143;B;;644;157;487;1;2;154;156
8;Barcelona;13;Barcelonès;08019;Barcelona;2;143;C;;679;160;519;0;1;159;160
8;Barcelona;13;Barcelonès;08019;Barcelona;2;144;U;;906;577;329;3;10;564;574
8;Barcelona;13;Barcelonès;08019;Barcelona;2;145;A;;597;363;234;0;6;357;363
8;Barcelona;13;Barcelonès;08019;Barcelona;2;145;B;;650;423;227;1;6;416;422
8;Barcelona;13;Barcelonès;08019;Barcelona;2;146;U;;403;253;150;0;6;247;253
8;Barcelona;13;Barcelonès;08019;Barcelona;2;147;A;;527;363;164;2;6;355;361
8;Barcelona;13;Barcelonès;08019;Barcelona;2;147;B;;533;338;195;1;6;331;337
8;Barcelona;13;Barcelonès;08019;Barcelona;2;148;A;;601;385;216;0;12;373;385
8;Barcelona;13;Barcelonès;08019;Barcelona;2;148;B;;571;391;180;1;5;385;390
8;Barcelona;13;Barcelonès;08019;Barcelona;2;149;U;;409;240;169;0;0;240;240
8;Barcelona;13;Barcelonès;08019;Barcelona;2;15;U;;549;337;212;1;7;329;336
8;Barcelona;13;Barcelonès;08019;Barcelona;2;150;U;;488;271;217;0;2;269;271
8;Barcelona;13;Barcelonès;08019;Barcelona;2;151;U;;673;406;267;0;4;402;406
8;Barcelona;13;Barcelonès;08019;Barcelona;2;152;U;;982;584;398;2;15;567;582
8;Barcelona;13;Barcelonès;08019;Barcelona;2;153;U;;664;411;253;2;8;401;409
8;Barcelona;13;Barcelonès;08019;Barcelona;2;154;A;;552;343;209;0;5;338;343
8;Barcelona;13;Barcelonès;08019;Barcelona;2;154;B;;516;330;186;1;7;322;329
8;Barcelona;13;Barcelonès;08019;Barcelona;2;155;A;;530;327;203;0;4;323;327
8;Barcelona;13;Barcelonès;08019;Barcelona;2;155;B;;540;335;205;0;6;329;335
8;Barcelona;13;Barcelonès;08019;Barcelona;2;156;U;;769;471;298;2;7;462;469
8;Barcelona;13;Barcelonès;08019;Barcelona;2;157;U;;940;624;316;0;4;620;624
8;Barcelona;13;Barcelonès;08019;Barcelona;2;158;U;;908;611;297;1;6;604;610
8;Barcelona;13;Barcelonès;08019;Barcelona;2;159;U;;597;344;253;5;6;333;339
8;Barcelona;13;Barcelonès;08019;Barcelona;2;16;U;;632;378;254;0;6;372;378
8;Barcelona;13;Barcelonès;08019;Barcelona;2;160;U;;579;385;194;1;8;376;384
8;Barcelona;13;Barcelonès;08019;Barcelona;2;161;U;;807;503;304;3;13;487;500
8;Barcelona;13;Barcelonès;08019;Barcelona;2;162;U;;825;531;294;0;7;524;531
8;Barcelona;13;Barcelonès;08019;Barcelona;2;163;U;;496;313;183;1;5;307;312
8;Barcelona;13;Barcelonès;08019;Barcelona;2;164;U;;403;274;129;1;11;262;273
8;Barcelona;13;Barcelonès;08019;Barcelona;2;165;U;;508;295;213;1;5;289;294
8;Barcelona;13;Barcelonès;08019;Barcelona;2;167;A;;475;340;135;0;4;336;340
8;Barcelona;13;Barcelonès;08019;Barcelona;2;167;B;;517;356;161;3;5;348;353
8;Barcelona;13;Barcelonès;08019;Barcelona;2;168;U;;885;555;330;0;14;541;555
8;Barcelona;13;Barcelonès;08019;Barcelona;2;169;U;;570;386;184;0;6;380;386
8;Barcelona;13;Barcelonès;08019;Barcelona;2;17;U;;634;374;260;3;3;368;371
8;Barcelona;13;Barcelonès;08019;Barcelona;2;170;A;;438;276;162;2;2;272;274
8;Barcelona;13;Barcelonès;08019;Barcelona;2;170;B;;568;384;184;0;2;382;384
8;Barcelona;13;Barcelonès;08019;Barcelona;2;171;U;;715;416;299;2;7;407;414
8;Barcelona;13;Barcelonès;08019;Barcelona;2;172;U;;768;560;208;1;22;537;559
8;Barcelona;13;Barcelonès;08019;Barcelona;2;173;U;;631;432;199;1;6;425;431
8;Barcelona;13;Barcelonès;08019;Barcelona;2;174;U;;610;381;229;0;5;376;381
8;Barcelona;13;Barcelonès;08019;Barcelona;2;175;U;;724;484;240;1;7;476;483
8;Barcelona;13;Barcelonès;08019;Barcelona;2;176;U;;972;543;429;0;8;535;543
8;Barcelona;13;Barcelonès;08019;Barcelona;2;177;U;;634;406;228;4;4;398;402
8;Barcelona;13;Barcelonès;08019;Barcelona;2;178;U;;761;496;265;0;9;487;496
8;Barcelona;13;Barcelonès;08019;Barcelona;2;179;U;;712;435;277;2;5;428;433
8;Barcelona;13;Barcelonès;08019;Barcelona;2;18;A;;671;418;253;3;6;409;415
8;Barcelona;13;Barcelonès;08019;Barcelona;2;18;B;;745;463;282;2;10;451;461
8;Barcelona;13;Barcelonès;08019;Barcelona;2;180;U;;481;323;158;0;2;321;323
8;Barcelona;13;Barcelonès;08019;Barcelona;2;181;U;;480;322;158;5;4;313;317
8;Barcelona;13;Barcelonès;08019;Barcelona;2;182;U;;560;335;225;0;11;324;335
8;Barcelona;13;Barcelonès;08019;Barcelona;2;183;U;;900;590;310;1;12;577;589
8;Barcelona;13;Barcelonès;08019;Barcelona;2;184;U;;830;538;292;0;8;530;538
8;Barcelona;13;Barcelonès;08019;Barcelona;2;185;U;;624;423;201;0;10;413;423
8;Barcelona;13;Barcelonès;08019;Barcelona;2;186;U;;472;329;143;1;6;322;328
8;Barcelona;13;Barcelonès;08019;Barcelona;2;187;U;;804;529;275;0;8;521;529
8;Barcelona;13;Barcelonès;08019;Barcelona;2;189;U;;718;494;224;2;11;481;492
8;Barcelona;13;Barcelonès;08019;Barcelona;2;19;A;;532;311;221;0;2;309;311
8;Barcelona;13;Barcelonès;08019;Barcelona;2;19;B;;594;330;264;1;8;321;329
8;Barcelona;13;Barcelonès;08019;Barcelona;2;190;U;;660;447;213;0;12;435;447
8;Barcelona;13;Barcelonès;08019;Barcelona;2;191;U;;649;419;230;0;9;410;419
8;Barcelona;13;Barcelonès;08019;Barcelona;2;192;U;;934;564;370;2;10;552;562
8;Barcelona;13;Barcelonès;08019;Barcelona;2;193;U;;448;313;135;0;10;303;313
8;Barcelona;13;Barcelonès;08019;Barcelona;2;194;U;;460;300;160;1;7;292;299
8;Barcelona;13;Barcelonès;08019;Barcelona;2;195;U;;537;390;147;1;4;385;389
8;Barcelona;13;Barcelonès;08019;Barcelona;2;196;U;;576;377;199;4;7;366;373
8;Barcelona;13;Barcelonès;08019;Barcelona;2;197;A;;592;367;225;0;5;362;367
8;Barcelona;13;Barcelonès;08019;Barcelona;2;197;B;;520;336;184;1;8;327;335
8;Barcelona;13;Barcelonès;08019;Barcelona;2;199;U;;684;453;231;0;11;442;453
8;Barcelona;13;Barcelonès;08019;Barcelona;2;2;U;;844;490;354;0;5;485;490
8;Barcelona;13;Barcelonès;08019;Barcelona;2;20;A;;640;334;306;0;0;334;334
8;Barcelona;13;Barcelonès;08019;Barcelona;2;20;B;;702;363;339;0;11;352;363
8;Barcelona;13;Barcelonès;08019;Barcelona;2;201;U;;469;312;157;1;2;309;311
8;Barcelona;13;Barcelonès;08019;Barcelona;2;202;U;;633;423;210;0;10;413;423
8;Barcelona;13;Barcelonès;08019;Barcelona;2;203;U;;765;502;263;0;10;492;502
8;Barcelona;13;Barcelonès;08019;Barcelona;2;206;U;;844;551;293;0;8;543;551
8;Barcelona;13;Barcelonès;08019;Barcelona;2;207;U;;794;529;265;2;10;517;527
8;Barcelona;13;Barcelonès;08019;Barcelona;2;209;U;;549;337;212;0;3;334;337
8;Barcelona;13;Barcelonès;08019;Barcelona;2;21;U;;424;230;194;0;4;226;230
8;Barcelona;13;Barcelonès;08019;Barcelona;2;210;U;;525;341;184;0;2;339;341
8;Barcelona;13;Barcelonès;08019;Barcelona;2;211;U;;730;475;255;2;5;468;473
8;Barcelona;13;Barcelonès;08019;Barcelona;2;212;U;;923;522;401;0;12;510;522
8;Barcelona;13;Barcelonès;08019;Barcelona;2;213;U;;709;420;289;0;11;409;420
8;Barcelona;13;Barcelonès;08019;Barcelona;2;214;U;;809;507;302;0;8;499;507
8;Barcelona;13;Barcelonès;08019;Barcelona;2;215;A;;474;288;186;3;4;281;285
8;Barcelona;13;Barcelonès;08019;Barcelona;2;215;B;;530;335;195;0;5;330;335
8;Barcelona;13;Barcelonès;08019;Barcelona;2;216;U;;867;461;406;1;11;449;460
8;Barcelona;13;Barcelonès;08019;Barcelona;2;219;U;;948;609;339;2;14;593;607
8;Barcelona;13;Barcelonès;08019;Barcelona;2;220;U;;577;363;214;0;2;361;363
8;Barcelona;13;Barcelonès;08019;Barcelona;2;221;U;;724;459;265;1;6;452;458
8;Barcelona;13;Barcelonès;08019;Barcelona;2;223;U;;507;263;244;1;3;259;262
8;Barcelona;13;Barcelonès;08019;Barcelona;2;224;U;;673;449;224;1;8;440;448
8;Barcelona;13;Barcelonès;08019;Barcelona;2;225;U;;437;282;155;2;3;277;280
8;Barcelona;13;Barcelonès;08019;Barcelona;2;226;U;;630;419;211;0;12;407;419
8;Barcelona;13;Barcelonès;08019;Barcelona;2;227;U;;487;322;165;1;3;318;321
8;Barcelona;13;Barcelonès;08019;Barcelona;2;229;U;;767;502;265;0;5;497;502
8;Barcelona;13;Barcelonès;08019;Barcelona;2;23;U;;808;450;358;2;2;446;448
8;Barcelona;13;Barcelonès;08019;Barcelona;2;230;U;;434;299;135;1;3;295;298
8;Barcelona;13;Barcelonès;08019;Barcelona;2;231;U;;688;473;215;2;6;465;471
8;Barcelona;13;Barcelonès;08019;Barcelona;2;232;U;;564;348;216;0;3;345;348
8;Barcelona;13;Barcelonès;08019;Barcelona;2;233;U;;759;504;255;0;3;501;504
8;Barcelona;13;Barcelonès;08019;Barcelona;2;234;U;;732;482;250;0;7;475;482
8;Barcelona;13;Barcelonès;08019;Barcelona;2;236;U;;818;552;266;1;9;542;551
8;Barcelona;13;Barcelonès;08019;Barcelona;2;237;U;;745;469;276;1;11;457;468
8;Barcelona;13;Barcelonès;08019;Barcelona;2;238;A;;534;339;195;1;8;330;338
8;Barcelona;13;Barcelonès;08019;Barcelona;2;238;B;;556;355;201;1;7;347;354
8;Barcelona;13;Barcelonès;08019;Barcelona;2;239;U;;865;534;331;0;6;528;534
8;Barcelona;13;Barcelonès;08019;Barcelona;2;24;U;;784;481;303;1;9;471;480
8;Barcelona;13;Barcelonès;08019;Barcelona;2;240;A;;633;374;259;0;7;367;374
8;Barcelona;13;Barcelonès;08019;Barcelona;2;240;B;;672;393;279;1;4;388;392
8;Barcelona;13;Barcelonès;08019;Barcelona;2;241;U;;687;475;212;0;5;470;475
8;Barcelona;13;Barcelonès;08019;Barcelona;2;242;U;;435;299;136;0;4;295;299
8;Barcelona;13;Barcelonès;08019;Barcelona;2;243;U;;811;422;389;1;4;417;421
8;Barcelona;13;Barcelonès;08019;Barcelona;2;244;U;;635;377;258;3;6;368;374
8;Barcelona;13;Barcelonès;08019;Barcelona;2;245;U;;534;270;264;0;1;269;270
8;Barcelona;13;Barcelonès;08019;Barcelona;2;246;A;;529;288;241;1;2;285;287
8;Barcelona;13;Barcelonès;08019;Barcelona;2;246;B;;616;306;310;1;5;300;305
8;Barcelona;13;Barcelonès;08019;Barcelona;2;247;U;;894;476;418;0;3;473;476
8;Barcelona;13;Barcelonès;08019;Barcelona;2;248;A;;466;283;183;1;6;276;282
8;Barcelona;13;Barcelonès;08019;Barcelona;2;248;B;;548;341;207;0;4;337;341
8;Barcelona;13;Barcelonès;08019;Barcelona;2;249;U;;608;364;244;2;1;361;362
8;Barcelona;13;Barcelonès;08019;Barcelona;2;25;A;;571;329;242;0;0;329;329
8;Barcelona;13;Barcelonès;08019;Barcelona;2;25;B;;647;399;248;0;10;389;399
8;Barcelona;13;Barcelonès;08019;Barcelona;2;250;U;;457;242;215;4;2;236;238
8;Barcelona;13;Barcelonès;08019;Barcelona;2;251;A;;559;344;215;3;4;337;341
8;Barcelona;13;Barcelonès;08019;Barcelona;2;251;B;;623;357;266;1;7;349;356
8;Barcelona;13;Barcelonès;08019;Barcelona;2;252;U;;955;598;357;0;15;583;598
8;Barcelona;13;Barcelonès;08019;Barcelona;2;253;U;;473;249;224;0;0;249;249
8;Barcelona;13;Barcelonès;08019;Barcelona;2;254;U;;576;325;251;3;3;319;322
8;Barcelona;13;Barcelonès;08019;Barcelona;2;255;U;;781;493;288;2;2;489;491
8;Barcelona;13;Barcelonès;08019;Barcelona;2;256;U;;791;470;321;0;3;467;470
8;Barcelona;13;Barcelonès;08019;Barcelona;2;257;U;;603;333;270;1;1;331;332
8;Barcelona;13;Barcelonès;08019;Barcelona;2;258;A;;559;353;206;2;4;347;351
8;Barcelona;13;Barcelonès;08019;Barcelona;2;258;B;;622;372;250;0;4;368;372
8;Barcelona;13;Barcelonès;08019;Barcelona;2;259;U;;832;507;325;0;4;503;507
8;Barcelona;13;Barcelonès;08019;Barcelona;2;26;U;;871;553;318;2;9;542;551
8;Barcelona;13;Barcelonès;08019;Barcelona;2;260;U;;823;482;341;1;5;476;481
8;Barcelona;13;Barcelonès;08019;Barcelona;2;261;U;;615;356;259;0;4;352;356
8;Barcelona;13;Barcelonès;08019;Barcelona;2;262;A;;581;374;207;0;5;369;374
8;Barcelona;13;Barcelonès;08019;Barcelona;2;262;B;;648;411;237;1;7;403;410
8;Barcelona;13;Barcelonès;08019;Barcelona;2;263;U;;517;311;206;1;4;306;310
8;Barcelona;13;Barcelonès;08019;Barcelona;2;264;U;;935;512;423;6;1;505;506
8;Barcelona;13;Barcelonès;08019;Barcelona;2;265;U;;813;423;390;0;10;413;423
8;Barcelona;13;Barcelonès;08019;Barcelona;2;266;U;;677;357;320;0;3;354;357
8;Barcelona;13;Barcelonès;08019;Barcelona;2;267;U;;627;331;296;0;0;331;331
8;Barcelona;13;Barcelonès;08019;Barcelona;2;268;U;;725;421;304;0;8;413;421
8;Barcelona;13;Barcelonès;08019;Barcelona;2;269;U;;962;524;438;0;5;519;524
8;Barcelona;13;Barcelonès;08019;Barcelona;2;27;U;;699;437;262;0;7;430;437
8;Barcelona;13;Barcelonès;08019;Barcelona;2;271;U;;887;455;432;0;8;447;455
8;Barcelona;13;Barcelonès;08019;Barcelona;2;272;U;;863;432;431;4;4;424;428
8;Barcelona;13;Barcelonès;08019;Barcelona;2;273;U;;914;486;428;1;10;475;485
8;Barcelona;13;Barcelonès;08019;Barcelona;2;274;U;;841;435;406;2;7;426;433
8;Barcelona;13;Barcelonès;08019;Barcelona;2;275;U;;892;483;409;1;6;476;482
8;Barcelona;13;Barcelonès;08019;Barcelona;2;276;A;;484;279;205;1;4;274;278
8;Barcelona;13;Barcelonès;08019;Barcelona;2;276;B;;579;344;235;3;7;334;341
8;Barcelona;13;Barcelonès;08019;Barcelona;2;277;A;;493;286;207;2;1;283;284
8;Barcelona;13;Barcelonès;08019;Barcelona;2;277;B;;491;303;188;1;5;297;302
8;Barcelona;13;Barcelonès;08019;Barcelona;2;278;U;;814;451;363;1;5;445;450
8;Barcelona;13;Barcelonès;08019;Barcelona;2;279;U;;819;511;308;5;6;500;506
8;Barcelona;13;Barcelonès;08019;Barcelona;2;28;U;;885;531;354;0;8;523;531
8;Barcelona;13;Barcelonès;08019;Barcelona;2;280;A;;661;382;279;1;9;372;381
8;Barcelona;13;Barcelonès;08019;Barcelona;2;280;B;;750;457;293;0;6;451;457
8;Barcelona;13;Barcelonès;08019;Barcelona;2;281;U;;645;420;225;2;5;413;418
8;Barcelona;13;Barcelonès;08019;Barcelona;2;282;U;;475;271;204;2;0;269;269
8;Barcelona;13;Barcelonès;08019;Barcelona;2;283;A;;482;308;174;1;12;295;307
8;Barcelona;13;Barcelonès;08019;Barcelona;2;283;B;;544;331;213;2;5;324;329
8;Barcelona;13;Barcelonès;08019;Barcelona;2;284;A;;524;292;232;0;5;287;292
8;Barcelona;13;Barcelonès;08019;Barcelona;2;284;B;;587;301;286;0;3;298;301
8;Barcelona;13;Barcelonès;08019;Barcelona;2;285;A;;673;390;283;1;5;384;389
8;Barcelona;13;Barcelonès;08019;Barcelona;2;285;B;;679;389;290;5;7;377;384
8;Barcelona;13;Barcelonès;08019;Barcelona;2;286;U;;789;482;307;1;2;479;481
8;Barcelona;13;Barcelonès;08019;Barcelona;2;287;U;;863;493;370;1;4;488;492
8;Barcelona;13;Barcelonès;08019;Barcelona;2;288;U;;799;436;363;2;2;432;434
8;Barcelona;13;Barcelonès;08019;Barcelona;2;289;A;;486;286;200;0;3;283;286
8;Barcelona;13;Barcelonès;08019;Barcelona;2;289;B;;569;309;260;2;1;306;307
8;Barcelona;13;Barcelonès;08019;Barcelona;2;29;U;;909;580;329;0;11;569;580
8;Barcelona;13;Barcelonès;08019;Barcelona;2;290;U;;434;257;177;1;8;248;256
8;Barcelona;13;Barcelonès;08019;Barcelona;2;291;U;;398;248;150;1;6;241;247
8;Barcelona;13;Barcelonès;08019;Barcelona;2;292;U;;814;490;324;0;5;485;490
8;Barcelona;13;Barcelonès;08019;Barcelona;2;294;U;;614;393;221;6;7;380;387
8;Barcelona;13;Barcelonès;08019;Barcelona;2;295;U;;827;526;301;1;5;520;525
8;Barcelona;13;Barcelonès;08019;Barcelona;2;296;U;;936;608;328;1;7;600;607
8;Barcelona;13;Barcelonès;08019;Barcelona;2;297;U;;946;547;399;2;8;537;545
8;Barcelona;13;Barcelonès;08019;Barcelona;2;298;U;;894;464;430;1;4;459;463
8;Barcelona;13;Barcelonès;08019;Barcelona;2;3;U;;691;365;326;1;0;364;364
8;Barcelona;13;Barcelonès;08019;Barcelona;2;30;A;;604;336;268;0;7;329;336
8;Barcelona;13;Barcelonès;08019;Barcelona;2;30;B;;655;361;294;0;7;354;361
8;Barcelona;13;Barcelonès;08019;Barcelona;2;300;U;;981;602;379;0;7;595;602
8;Barcelona;13;Barcelonès;08019;Barcelona;2;301;A;;709;460;249;0;7;453;460
8;Barcelona;13;Barcelonès;08019;Barcelona;2;301;B;;760;477;283;5;2;470;472
8;Barcelona;13;Barcelonès;08019;Barcelona;2;302;A;;548;314;234;0;9;305;314
8;Barcelona;13;Barcelonès;08019;Barcelona;2;302;B;;496;305;191;3;11;291;302
8;Barcelona;13;Barcelonès;08019;Barcelona;2;303;A;;526;336;190;1;8;327;335
8;Barcelona;13;Barcelonès;08019;Barcelona;2;303;B;;597;399;198;1;7;391;398
8;Barcelona;13;Barcelonès;08019;Barcelona;2;304;A;;529;302;227;7;0;295;295
8;Barcelona;13;Barcelonès;08019;Barcelona;2;304;B;;605;339;266;1;3;335;338
8;Barcelona;13;Barcelonès;08019;Barcelona;2;305;A;;545;330;215;1;5;324;329
8;Barcelona;13;Barcelonès;08019;Barcelona;2;305;B;;596;371;225;3;5;363;368
8;Barcelona;13;Barcelonès;08019;Barcelona;2;306;A;;531;335;196;0;4;331;335
8;Barcelona;13;Barcelonès;08019;Barcelona;2;306;B;;501;317;184;2;6;309;315
8;Barcelona;13;Barcelonès;08019;Barcelona;2;307;A;;713;442;271;1;4;437;441
8;Barcelona;13;Barcelonès;08019;Barcelona;2;307;B;;731;477;254;2;9;466;475
8;Barcelona;13;Barcelonès;08019;Barcelona;2;308;A;;532;301;231;0;5;296;301
8;Barcelona;13;Barcelonès;08019;Barcelona;2;308;B;;515;300;215;1;5;294;299
8;Barcelona;13;Barcelonès;08019;Barcelona;2;309;U;;512;287;225;0;3;284;287
8;Barcelona;13;Barcelonès;08019;Barcelona;2;31;U;;986;581;405;8;9;564;573
8;Barcelona;13;Barcelonès;08019;Barcelona;2;310;U;;518;291;227;0;1;290;291
8;Barcelona;13;Barcelonès;08019;Barcelona;2;311;A;;489;271;218;1;6;264;270
8;Barcelona;13;Barcelonès;08019;Barcelona;2;311;B;;578;324;254;1;3;320;323
8;Barcelona;13;Barcelonès;08019;Barcelona;2;312;U;;568;348;220;2;4;342;346
8;Barcelona;13;Barcelonès;08019;Barcelona;2;313;U;;482;263;219;1;3;259;262
8;Barcelona;13;Barcelonès;08019;Barcelona;2;314;U;;675;419;256;1;6;412;418
8;Barcelona;13;Barcelonès;08019;Barcelona;2;315;U;;903;499;404;2;7;490;497
8;Barcelona;13;Barcelonès;08019;Barcelona;2;317;A;;655;337;318;2;4;331;335
8;Barcelona;13;Barcelonès;08019;Barcelona;2;317;B;;696;357;339;0;6;351;357
8;Barcelona;13;Barcelonès;08019;Barcelona;2;32;U;;878;553;325;5;1;547;548
8;Barcelona;13;Barcelonès;08019;Barcelona;2;33;U;;827;513;314;0;6;507;513
8;Barcelona;13;Barcelonès;08019;Barcelona;2;34;A;;515;306;209;2;4;300;304
8;Barcelona;13;Barcelonès;08019;Barcelona;2;34;B;;530;308;222;0;8;300;308
8;Barcelona;13;Barcelonès;08019;Barcelona;2;35;U;;795;455;340;1;10;444;454
8;Barcelona;13;Barcelonès;08019;Barcelona;2;36;U;;907;557;350;1;10;546;556
8;Barcelona;13;Barcelonès;08019;Barcelona;2;37;U;;451;271;180;0;5;266;271
8;Barcelona;13;Barcelonès;08019;Barcelona;2;38;U;;500;319;181;1;1;317;318
8;Barcelona;13;Barcelonès;08019;Barcelona;2;39;U;;765;440;325;2;11;427;438
8;Barcelona;13;Barcelonès;08019;Barcelona;2;4;U;;678;392;286;0;5;387;392
8;Barcelona;13;Barcelonès;08019;Barcelona;2;40;U;;775;488;287;4;4;480;484
8;Barcelona;13;Barcelonès;08019;Barcelona;2;41;U;;904;546;358;0;8;538;546
8;Barcelona;13;Barcelonès;08019;Barcelona;2;42;U;;725;393;332;1;5;387;392
8;Barcelona;13;Barcelonès;08019;Barcelona;2;43;U;;547;322;225;0;6;316;322
8;Barcelona;13;Barcelonès;08019;Barcelona;2;44;U;;379;219;160;1;1;217;218
8;Barcelona;13;Barcelonès;08019;Barcelona;2;45;U;;758;425;333;0;7;418;425
8;Barcelona;13;Barcelonès;08019;Barcelona;2;47;U;;899;527;372;4;4;519;523
8;Barcelona;13;Barcelonès;08019;Barcelona;2;48;U;;536;306;230;0;2;304;306
8;Barcelona;13;Barcelonès;08019;Barcelona;2;49;U;;641;380;261;0;6;374;380
8;Barcelona;13;Barcelonès;08019;Barcelona;2;5;U;;646;368;278;0;2;366;368
8;Barcelona;13;Barcelonès;08019;Barcelona;2;50;U;;485;253;232;0;4;249;253
8;Barcelona;13;Barcelonès;08019;Barcelona;2;51;U;;547;347;200;0;5;342;347
8;Barcelona;13;Barcelonès;08019;Barcelona;2;52;U;;765;496;269;2;6;488;494
8;Barcelona;13;Barcelonès;08019;Barcelona;2;53;U;;739;444;295;0;8;436;444
8;Barcelona;13;Barcelonès;08019;Barcelona;2;54;U;;824;504;320;2;7;495;502
8;Barcelona;13;Barcelonès;08019;Barcelona;2;55;U;;532;323;209;0;5;318;323
8;Barcelona;13;Barcelonès;08019;Barcelona;2;56;U;;668;435;233;1;5;429;434
8;Barcelona;13;Barcelonès;08019;Barcelona;2;57;U;;749;498;251;0;6;492;498
8;Barcelona;13;Barcelonès;08019;Barcelona;2;58;U;;674;405;269;1;2;402;404
8;Barcelona;13;Barcelonès;08019;Barcelona;2;59;U;;711;410;301;1;3;406;409
8;Barcelona;13;Barcelonès;08019;Barcelona;2;6;U;;652;346;306;5;6;335;341
8;Barcelona;13;Barcelonès;08019;Barcelona;2;60;U;;917;514;403;2;7;505;512
8;Barcelona;13;Barcelonès;08019;Barcelona;2;61;U;;893;551;342;2;9;540;549
8;Barcelona;13;Barcelonès;08019;Barcelona;2;62;U;;786;476;310;1;4;471;475
8;Barcelona;13;Barcelonès;08019;Barcelona;2;63;U;;979;570;409;2;8;560;568
8;Barcelona;13;Barcelonès;08019;Barcelona;2;65;U;;912;585;327;1;8;576;584
8;Barcelona;13;Barcelonès;08019;Barcelona;2;66;U;;944;553;391;2;11;540;551
8;Barcelona;13;Barcelonès;08019;Barcelona;2;67;U;;933;572;361;1;2;569;571
8;Barcelona;13;Barcelonès;08019;Barcelona;2;68;U;;944;546;398;8;0;538;538
8;Barcelona;13;Barcelonès;08019;Barcelona;2;7;U;;748;356;392;2;5;349;354
8;Barcelona;13;Barcelonès;08019;Barcelona;2;70;U;;742;409;333;1;3;405;408
8;Barcelona;13;Barcelonès;08019;Barcelona;2;71;U;;957;556;401;2;4;550;554
8;Barcelona;13;Barcelonès;08019;Barcelona;2;72;U;;844;501;343;1;6;494;500
8;Barcelona;13;Barcelonès;08019;Barcelona;2;73;A;;497;323;174;1;4;318;322
8;Barcelona;13;Barcelonès;08019;Barcelona;2;73;B;;504;330;174;0;7;323;330
8;Barcelona;13;Barcelonès;08019;Barcelona;2;74;U;;886;520;366;0;8;512;520
8;Barcelona;13;Barcelonès;08019;Barcelona;2;75;U;;843;504;339;4;5;495;500
8;Barcelona;13;Barcelonès;08019;Barcelona;2;76;U;;420;260;160;0;9;251;260
8;Barcelona;13;Barcelonès;08019;Barcelona;2;77;U;;889;542;347;0;7;535;542
8;Barcelona;13;Barcelonès;08019;Barcelona;2;78;U;;733;418;315;1;8;409;417
8;Barcelona;13;Barcelonès;08019;Barcelona;2;79;A;;463;280;183;4;6;270;276
8;Barcelona;13;Barcelonès;08019;Barcelona;2;79;B;;569;337;232;5;3;329;332
8;Barcelona;13;Barcelonès;08019;Barcelona;2;8;U;;784;400;384;0;2;398;400
8;Barcelona;13;Barcelonès;08019;Barcelona;2;80;A;;474;275;199;1;5;269;274
8;Barcelona;13;Barcelonès;08019;Barcelona;2;80;B;;556;327;229;0;4;323;327
8;Barcelona;13;Barcelonès;08019;Barcelona;2;81;A;;505;294;211;3;5;286;291
8;Barcelona;13;Barcelonès;08019;Barcelona;2;81;B;;593;309;284;1;8;300;308
8;Barcelona;13;Barcelonès;08019;Barcelona;2;82;U;;969;553;416;5;1;547;548
8;Barcelona;13;Barcelonès;08019;Barcelona;2;83;U;;686;394;292;2;4;388;392
8;Barcelona;13;Barcelonès;08019;Barcelona;2;84;A;;688;393;295;0;12;381;393
8;Barcelona;13;Barcelonès;08019;Barcelona;2;84;B;;671;380;291;1;4;375;379
8;Barcelona;13;Barcelonès;08019;Barcelona;2;85;U;;815;492;323;4;9;479;488
8;Barcelona;13;Barcelonès;08019;Barcelona;2;86;A;;548;308;240;1;1;306;307
8;Barcelona;13;Barcelonès;08019;Barcelona;2;86;B;;643;330;313;1;2;327;329
8;Barcelona;13;Barcelonès;08019;Barcelona;2;87;U;;773;454;319;0;1;453;454
8;Barcelona;13;Barcelonès;08019;Barcelona;2;88;U;;479;279;200;3;2;274;276
8;Barcelona;13;Barcelonès;08019;Barcelona;2;89;A;;526;376;150;0;3;373;376
8;Barcelona;13;Barcelonès;08019;Barcelona;2;89;B;;603;392;211;1;10;381;391
8;Barcelona;13;Barcelonès;08019;Barcelona;2;9;U;;825;441;384;2;3;436;439
8;Barcelona;13;Barcelonès;08019;Barcelona;2;90;A;;534;357;177;0;6;351;357
8;Barcelona;13;Barcelonès;08019;Barcelona;2;90;B;;603;366;237;0;4;362;366
8;Barcelona;13;Barcelonès;08019;Barcelona;2;91;U;;550;334;216;0;8;326;334
8;Barcelona;13;Barcelonès;08019;Barcelona;2;92;A;;510;315;195;0;5;310;315
8;Barcelona;13;Barcelonès;08019;Barcelona;2;92;B;;625;374;251;2;4;368;372
8;Barcelona;13;Barcelonès;08019;Barcelona;2;93;U;;750;416;334;2;6;408;414
8;Barcelona;13;Barcelonès;08019;Barcelona;2;94;A;;499;301;198;0;5;296;301
8;Barcelona;13;Barcelonès;08019;Barcelona;2;94;B;;579;341;238;1;1;339;340
8;Barcelona;13;Barcelonès;08019;Barcelona;2;95;A;;575;384;191;1;7;376;383
8;Barcelona;13;Barcelonès;08019;Barcelona;2;95;B;;646;430;216;0;4;426;430
8;Barcelona;13;Barcelonès;08019;Barcelona;2;96;U;;524;330;194;0;0;330;330
8;Barcelona;13;Barcelonès;08019;Barcelona;2;97;A;;474;280;194;0;5;275;280
8;Barcelona;13;Barcelonès;08019;Barcelona;2;97;B;;529;363;166;1;2;360;362
8;Barcelona;13;Barcelonès;08019;Barcelona;2;98;U;;801;495;306;3;8;484;492
8;Barcelona;13;Barcelonès;08019;Barcelona;2;99;U;;633;379;254;0;9;370;379
8;Barcelona;13;Barcelonès;08019;Barcelona;3;1;U;;799;397;402;0;7;390;397
8;Barcelona;13;Barcelonès;08019;Barcelona;3;10;U;;665;352;313;9;1;342;343
8;Barcelona;13;Barcelonès;08019;Barcelona;3;100;A;;575;304;271;0;5;299;304
8;Barcelona;13;Barcelonès;08019;Barcelona;3;100;B;;591;347;244;0;5;342;347
8;Barcelona;13;Barcelonès;08019;Barcelona;3;101;A;;528;289;239;0;7;282;289
8;Barcelona;13;Barcelonès;08019;Barcelona;3;101;B;;564;328;236;0;2;326;328
8;Barcelona;13;Barcelonès;08019;Barcelona;3;102;U;;839;467;372;0;12;455;467
8;Barcelona;13;Barcelonès;08019;Barcelona;3;103;U;;735;393;342;0;5;388;393
8;Barcelona;13;Barcelonès;08019;Barcelona;3;104;U;;532;278;254;0;5;273;278
8;Barcelona;13;Barcelonès;08019;Barcelona;3;105;U;;400;209;191;2;6;201;207
8;Barcelona;13;Barcelonès;08019;Barcelona;3;106;U;;615;413;202;0;4;409;413
8;Barcelona;13;Barcelonès;08019;Barcelona;3;107;U;;547;343;204;0;0;343;343
8;Barcelona;13;Barcelonès;08019;Barcelona;3;108;U;;448;220;228;0;2;218;220
8;Barcelona;13;Barcelonès;08019;Barcelona;3;109;A;;709;304;405;0;4;300;304
8;Barcelona;13;Barcelonès;08019;Barcelona;3;109;B;;854;396;458;1;3;392;395
8;Barcelona;13;Barcelonès;08019;Barcelona;3;11;U;;408;189;219;0;0;189;189
8;Barcelona;13;Barcelonès;08019;Barcelona;3;110;A;;677;347;330;5;4;338;342
8;Barcelona;13;Barcelonès;08019;Barcelona;3;110;B;;796;423;373;0;8;415;423
8;Barcelona;13;Barcelonès;08019;Barcelona;3;111;A;;715;332;383;0;7;325;332
8;Barcelona;13;Barcelonès;08019;Barcelona;3;111;B;;813;396;417;3;3;390;393
8;Barcelona;13;Barcelonès;08019;Barcelona;3;112;U;;564;287;277;2;3;282;285
8;Barcelona;13;Barcelonès;08019;Barcelona;3;113;U;;622;315;307;1;2;312;314
8;Barcelona;13;Barcelonès;08019;Barcelona;3;114;U;;576;302;274;0;7;295;302
8;Barcelona;13;Barcelonès;08019;Barcelona;3;115;U;;672;375;297;4;4;367;371
8;Barcelona;13;Barcelonès;08019;Barcelona;3;116;U;;475;252;223;1;0;251;251
8;Barcelona;13;Barcelonès;08019;Barcelona;3;117;U;;685;385;300;0;5;380;385
8;Barcelona;13;Barcelonès;08019;Barcelona;3;118;U;;875;572;303;1;9;562;571
8;Barcelona;13;Barcelonès;08019;Barcelona;3;119;U;;530;294;236;1;2;291;293
8;Barcelona;13;Barcelonès;08019;Barcelona;3;12;A;;553;271;282;1;2;268;270
8;Barcelona;13;Barcelonès;08019;Barcelona;3;12;B;;577;263;314;0;2;261;263
8;Barcelona;13;Barcelonès;08019;Barcelona;3;120;U;;753;459;294;1;3;455;458
8;Barcelona;13;Barcelonès;08019;Barcelona;3;121;U;;581;358;223;6;2;350;352
8;Barcelona;13;Barcelonès;08019;Barcelona;3;122;U;;619;403;216;0;2;401;403
8;Barcelona;13;Barcelonès;08019;Barcelona;3;123;U;;423;256;167;2;3;251;254
8;Barcelona;13;Barcelonès;08019;Barcelona;3;124;U;;786;496;290;2;7;487;494
8;Barcelona;13;Barcelonès;08019;Barcelona;3;125;U;;459;265;194;0;3;262;265
8;Barcelona;13;Barcelonès;08019;Barcelona;3;126;U;;394;240;154;1;4;235;239
8;Barcelona;13;Barcelonès;08019;Barcelona;3;127;U;;748;442;306;0;3;439;442
8;Barcelona;13;Barcelonès;08019;Barcelona;3;128;U;;590;343;247;0;5;338;343
8;Barcelona;13;Barcelonès;08019;Barcelona;3;129;U;;591;326;265;0;4;322;326
8;Barcelona;13;Barcelonès;08019;Barcelona;3;130;A;;523;287;236;2;4;281;285
8;Barcelona;13;Barcelonès;08019;Barcelona;3;130;B;;462;257;205;1;4;252;256
8;Barcelona;13;Barcelonès;08019;Barcelona;3;132;U;;726;428;298;0;3;425;428
8;Barcelona;13;Barcelonès;08019;Barcelona;3;133;U;;560;357;203;2;2;353;355
8;Barcelona;13;Barcelonès;08019;Barcelona;3;134;A;;632;369;263;0;3;366;369
8;Barcelona;13;Barcelonès;08019;Barcelona;3;134;B;;575;321;254;1;8;312;320
8;Barcelona;13;Barcelonès;08019;Barcelona;3;134;C;;683;374;309;2;1;371;372
8;Barcelona;13;Barcelonès;08019;Barcelona;3;135;U;;466;226;240;0;5;221;226
8;Barcelona;13;Barcelonès;08019;Barcelona;3;136;U;;538;319;219;0;1;318;319
8;Barcelona;13;Barcelonès;08019;Barcelona;3;137;A;;523;303;220;1;2;300;302
8;Barcelona;13;Barcelonès;08019;Barcelona;3;137;B;;529;317;212;2;4;311;315
8;Barcelona;13;Barcelonès;08019;Barcelona;3;138;U;;877;519;358;2;7;510;517
8;Barcelona;13;Barcelonès;08019;Barcelona;3;139;U;;624;373;251;0;2;371;373
8;Barcelona;13;Barcelonès;08019;Barcelona;3;14;U;;830;383;447;3;7;373;380
8;Barcelona;13;Barcelonès;08019;Barcelona;3;140;U;;547;338;209;1;4;333;337
8;Barcelona;13;Barcelonès;08019;Barcelona;3;141;U;;715;414;301;1;3;410;413
8;Barcelona;13;Barcelonès;08019;Barcelona;3;142;U;;839;487;352;0;4;483;487
8;Barcelona;13;Barcelonès;08019;Barcelona;3;143;U;;614;294;320;0;3;291;294
8;Barcelona;13;Barcelonès;08019;Barcelona;3;144;U;;537;308;229;0;6;302;308
8;Barcelona;13;Barcelonès;08019;Barcelona;3;145;U;;440;264;176;0;4;260;264
8;Barcelona;13;Barcelonès;08019;Barcelona;3;146;U;;701;423;278;2;4;417;421
8;Barcelona;13;Barcelonès;08019;Barcelona;3;147;A;;576;366;210;0;3;363;366
8;Barcelona;13;Barcelonès;08019;Barcelona;3;147;B;;464;276;188;0;6;270;276
8;Barcelona;13;Barcelonès;08019;Barcelona;3;147;C;;610;376;234;0;3;373;376
8;Barcelona;13;Barcelonès;08019;Barcelona;3;148;A;;524;310;214;0;4;306;310
8;Barcelona;13;Barcelonès;08019;Barcelona;3;148;B;;594;351;243;1;11;339;350
8;Barcelona;13;Barcelonès;08019;Barcelona;3;149;U;;953;508;445;1;7;500;507
8;Barcelona;13;Barcelonès;08019;Barcelona;3;15;U;;640;353;287;3;0;350;350
8;Barcelona;13;Barcelonès;08019;Barcelona;3;150;U;;797;460;337;1;6;453;459
8;Barcelona;13;Barcelonès;08019;Barcelona;3;151;U;;907;535;372;1;3;531;534
8;Barcelona;13;Barcelonès;08019;Barcelona;3;152;U;;639;380;259;2;2;376;378
8;Barcelona;13;Barcelonès;08019;Barcelona;3;153;U;;927;509;418;1;3;505;508
8;Barcelona;13;Barcelonès;08019;Barcelona;3;154;U;;507;323;184;4;3;316;319
8;Barcelona;13;Barcelonès;08019;Barcelona;3;155;U;;427;245;182;2;0;243;243
8;Barcelona;13;Barcelonès;08019;Barcelona;3;156;U;;544;331;213;0;4;327;331
8;Barcelona;13;Barcelonès;08019;Barcelona;3;157;U;;475;272;203;0;3;269;272
8;Barcelona;13;Barcelonès;08019;Barcelona;3;158;U;;459;294;165;0;3;291;294
8;Barcelona;13;Barcelonès;08019;Barcelona;3;159;U;;773;468;305;5;5;458;463
8;Barcelona;13;Barcelonès;08019;Barcelona;3;16;U;;697;338;359;0;6;332;338
8;Barcelona;13;Barcelonès;08019;Barcelona;3;160;U;;450;294;156;0;1;293;294
8;Barcelona;13;Barcelonès;08019;Barcelona;3;161;U;;572;373;199;0;3;370;373
8;Barcelona;13;Barcelonès;08019;Barcelona;3;162;U;;394;216;178;1;0;215;215
8;Barcelona;13;Barcelonès;08019;Barcelona;3;163;U;;542;284;258;0;3;281;284
8;Barcelona;13;Barcelonès;08019;Barcelona;3;164;U;;710;414;296;0;9;405;414
8;Barcelona;13;Barcelonès;08019;Barcelona;3;165;U;;709;373;336;2;8;363;371
8;Barcelona;13;Barcelonès;08019;Barcelona;3;167;U;;793;466;327;0;6;460;466
8;Barcelona;13;Barcelonès;08019;Barcelona;3;168;A;;522;290;232;0;7;283;290
8;Barcelona;13;Barcelonès;08019;Barcelona;3;168;B;;515;271;244;0;5;266;271
8;Barcelona;13;Barcelonès;08019;Barcelona;3;168;C;;556;312;244;0;6;306;312
8;Barcelona;13;Barcelonès;08019;Barcelona;3;169;A;;552;323;229;1;4;318;322
8;Barcelona;13;Barcelonès;08019;Barcelona;3;169;B;;663;362;301;1;7;354;361
8;Barcelona;13;Barcelonès;08019;Barcelona;3;17;U;;776;353;423;0;2;351;353
8;Barcelona;13;Barcelonès;08019;Barcelona;3;170;U;;834;411;423;0;3;408;411
8;Barcelona;13;Barcelonès;08019;Barcelona;3;171;U;;456;241;215;0;2;239;241
8;Barcelona;13;Barcelonès;08019;Barcelona;3;172;U;;818;469;349;0;5;464;469
8;Barcelona;13;Barcelonès;08019;Barcelona;3;173;U;;472;288;184;0;5;283;288
8;Barcelona;13;Barcelonès;08019;Barcelona;3;174;U;;539;300;239;0;5;295;300
8;Barcelona;13;Barcelonès;08019;Barcelona;3;175;U;;524;302;222;1;1;300;301
8;Barcelona;13;Barcelonès;08019;Barcelona;3;176;U;;648;382;266;0;8;374;382
8;Barcelona;13;Barcelonès;08019;Barcelona;3;177;U;;648;302;346;3;1;298;299
8;Barcelona;13;Barcelonès;08019;Barcelona;3;178;U;;787;450;337;1;6;443;449
8;Barcelona;13;Barcelonès;08019;Barcelona;3;179;A;;488;273;215;1;6;266;272
8;Barcelona;13;Barcelonès;08019;Barcelona;3;179;B;;593;354;239;0;4;350;354
8;Barcelona;13;Barcelonès;08019;Barcelona;3;18;U;;643;319;324;3;3;313;316
8;Barcelona;13;Barcelonès;08019;Barcelona;3;180;U;;829;424;405;3;6;415;421
8;Barcelona;13;Barcelonès;08019;Barcelona;3;182;U;;599;336;263;1;7;328;335
8;Barcelona;13;Barcelonès;08019;Barcelona;3;183;U;;856;470;386;1;5;464;469
8;Barcelona;13;Barcelonès;08019;Barcelona;3;184;U;;646;338;308;1;5;332;337
8;Barcelona;13;Barcelonès;08019;Barcelona;3;185;U;;398;189;209;0;0;189;189
8;Barcelona;13;Barcelonès;08019;Barcelona;3;186;U;;550;307;243;2;6;299;305
8;Barcelona;13;Barcelonès;08019;Barcelona;3;187;U;;421;220;201;1;1;218;219
8;Barcelona;13;Barcelonès;08019;Barcelona;3;188;U;;590;324;266;0;6;318;324
8;Barcelona;13;Barcelonès;08019;Barcelona;3;189;U;;766;404;362;0;3;401;404
8;Barcelona;13;Barcelonès;08019;Barcelona;3;19;U;;649;339;310;1;8;330;338
8;Barcelona;13;Barcelonès;08019;Barcelona;3;191;U;;954;578;376;2;2;574;576
8;Barcelona;13;Barcelonès;08019;Barcelona;3;192;U;;663;365;298;1;4;360;364
8;Barcelona;13;Barcelonès;08019;Barcelona;3;193;A;;521;302;219;3;2;297;299
8;Barcelona;13;Barcelonès;08019;Barcelona;3;193;B;;572;343;229;5;8;330;338
8;Barcelona;13;Barcelonès;08019;Barcelona;3;194;U;;478;214;264;1;5;208;213
8;Barcelona;13;Barcelonès;08019;Barcelona;3;195;U;;659;370;289;0;5;365;370
8;Barcelona;13;Barcelonès;08019;Barcelona;3;196;U;;708;383;325;0;4;379;383
8;Barcelona;13;Barcelonès;08019;Barcelona;3;197;U;;593;313;280;1;1;311;312
8;Barcelona;13;Barcelonès;08019;Barcelona;3;198;A;;536;280;256;0;1;279;280
8;Barcelona;13;Barcelonès;08019;Barcelona;3;198;B;;620;317;303;0;4;313;317
8;Barcelona;13;Barcelonès;08019;Barcelona;3;199;U;;668;345;323;0;4;341;345
8;Barcelona;13;Barcelonès;08019;Barcelona;3;2;U;;425;215;210;0;3;212;215
8;Barcelona;13;Barcelonès;08019;Barcelona;3;20;U;;751;439;312;2;9;428;437
8;Barcelona;13;Barcelonès;08019;Barcelona;3;200;U;;923;508;415;1;15;492;507
8;Barcelona;13;Barcelonès;08019;Barcelona;3;201;A;;619;306;313;0;2;304;306
8;Barcelona;13;Barcelonès;08019;Barcelona;3;201;B;;705;342;363;1;6;335;341
8;Barcelona;13;Barcelonès;08019;Barcelona;3;202;A;;591;289;302;5;3;281;284
8;Barcelona;13;Barcelonès;08019;Barcelona;3;202;B;;663;361;302;1;6;354;360
8;Barcelona;13;Barcelonès;08019;Barcelona;3;204;U;;933;486;447;1;9;476;485
8;Barcelona;13;Barcelonès;08019;Barcelona;3;205;U;;560;325;235;0;5;320;325
8;Barcelona;13;Barcelonès;08019;Barcelona;3;206;U;;428;239;189;1;3;235;238
8;Barcelona;13;Barcelonès;08019;Barcelona;3;207;U;;852;457;395;0;3;454;457
8;Barcelona;13;Barcelonès;08019;Barcelona;3;208;U;;630;382;248;3;1;378;379
8;Barcelona;13;Barcelonès;08019;Barcelona;3;209;U;;858;519;339;0;6;513;519
8;Barcelona;13;Barcelonès;08019;Barcelona;3;210;A;;474;254;220;0;5;249;254
8;Barcelona;13;Barcelonès;08019;Barcelona;3;210;B;;539;280;259;0;8;272;280
8;Barcelona;13;Barcelonès;08019;Barcelona;3;22;U;;873;468;405;0;2;466;468
8;Barcelona;13;Barcelonès;08019;Barcelona;3;23;U;;475;261;214;1;3;257;260
8;Barcelona;13;Barcelonès;08019;Barcelona;3;24;U;;677;372;305;1;3;368;371
8;Barcelona;13;Barcelonès;08019;Barcelona;3;25;U;;578;300;278;2;1;297;298
8;Barcelona;13;Barcelonès;08019;Barcelona;3;26;U;;566;331;235;1;6;324;330
8;Barcelona;13;Barcelonès;08019;Barcelona;3;28;U;;436;230;206;3;0;227;227
8;Barcelona;13;Barcelonès;08019;Barcelona;3;29;U;;700;355;345;5;0;350;350
8;Barcelona;13;Barcelonès;08019;Barcelona;3;3;U;;678;283;395;1;4;278;282
8;Barcelona;13;Barcelonès;08019;Barcelona;3;30;U;;419;238;181;0;6;232;238
8;Barcelona;13;Barcelonès;08019;Barcelona;3;31;U;;596;307;289;0;4;303;307
8;Barcelona;13;Barcelonès;08019;Barcelona;3;32;U;;422;195;227;0;6;189;195
8;Barcelona;13;Barcelonès;08019;Barcelona;3;33;U;;795;397;398;4;4;389;393
8;Barcelona;13;Barcelonès;08019;Barcelona;3;34;U;;627;357;270;2;1;354;355
8;Barcelona;13;Barcelonès;08019;Barcelona;3;35;U;;464;267;197;2;0;265;265
8;Barcelona;13;Barcelonès;08019;Barcelona;3;36;U;;410;182;228;2;0;180;180
8;Barcelona;13;Barcelonès;08019;Barcelona;3;37;U;;755;372;383;1;1;370;371
8;Barcelona;13;Barcelonès;08019;Barcelona;3;38;A;;455;225;230;1;3;221;224
8;Barcelona;13;Barcelonès;08019;Barcelona;3;38;B;;551;276;275;2;0;274;274
8;Barcelona;13;Barcelonès;08019;Barcelona;3;39;U;;462;248;214;1;3;244;247
8;Barcelona;13;Barcelonès;08019;Barcelona;3;4;U;;644;297;347;0;3;294;297
8;Barcelona;13;Barcelonès;08019;Barcelona;3;41;U;;666;374;292;1;4;369;373
8;Barcelona;13;Barcelonès;08019;Barcelona;3;42;U;;624;331;293;2;2;327;329
8;Barcelona;13;Barcelonès;08019;Barcelona;3;43;U;;900;443;457;0;1;442;443
8;Barcelona;13;Barcelonès;08019;Barcelona;3;44;U;;495;268;227;1;3;264;267
8;Barcelona;13;Barcelonès;08019;Barcelona;3;45;U;;400;228;172;1;4;223;227
8;Barcelona;13;Barcelonès;08019;Barcelona;3;47;U;;792;426;366;1;2;423;425
8;Barcelona;13;Barcelonès;08019;Barcelona;3;48;U;;882;416;466;1;12;403;415
8;Barcelona;13;Barcelonès;08019;Barcelona;3;49;U;;816;442;374;2;4;436;440
8;Barcelona;13;Barcelonès;08019;Barcelona;3;5;U;;411;173;238;0;3;170;173
8;Barcelona;13;Barcelonès;08019;Barcelona;3;50;U;;574;313;261;2;5;306;311
8;Barcelona;13;Barcelonès;08019;Barcelona;3;51;U;;447;250;197;3;1;246;247
8;Barcelona;13;Barcelonès;08019;Barcelona;3;53;U;;578;336;242;1;2;333;335
8;Barcelona;13;Barcelonès;08019;Barcelona;3;54;U;;486;247;239;0;5;242;247
8;Barcelona;13;Barcelonès;08019;Barcelona;3;55;U;;697;393;304;4;4;385;389
8;Barcelona;13;Barcelonès;08019;Barcelona;3;56;U;;585;330;255;0;0;330;330
8;Barcelona;13;Barcelonès;08019;Barcelona;3;57;U;;254;146;108;0;2;144;146
8;Barcelona;13;Barcelonès;08019;Barcelona;3;58;U;;318;132;186;0;1;131;132
8;Barcelona;13;Barcelonès;08019;Barcelona;3;59;U;;453;159;294;1;1;157;158
8;Barcelona;13;Barcelonès;08019;Barcelona;3;6;U;;645;333;312;1;7;325;332
8;Barcelona;13;Barcelonès;08019;Barcelona;3;60;U;;270;63;207;0;2;61;63
8;Barcelona;13;Barcelonès;08019;Barcelona;3;61;U;;276;42;234;0;1;41;42
8;Barcelona;13;Barcelonès;08019;Barcelona;3;62;U;;386;157;229;0;3;154;157
8;Barcelona;13;Barcelonès;08019;Barcelona;3;63;U;;390;184;206;0;1;183;184
8;Barcelona;13;Barcelonès;08019;Barcelona;3;64;U;;378;154;224;0;3;151;154
8;Barcelona;13;Barcelonès;08019;Barcelona;3;65;A;;685;308;377;1;1;306;307
8;Barcelona;13;Barcelonès;08019;Barcelona;3;65;B;;834;357;477;2;1;354;355
8;Barcelona;13;Barcelonès;08019;Barcelona;3;66;U;;921;459;462;3;8;448;456
8;Barcelona;13;Barcelonès;08019;Barcelona;3;67;U;;747;359;388;0;2;357;359
8;Barcelona;13;Barcelonès;08019;Barcelona;3;68;A;;492;242;250;0;8;234;242
8;Barcelona;13;Barcelonès;08019;Barcelona;3;68;B;;582;295;287;0;3;292;295
8;Barcelona;13;Barcelonès;08019;Barcelona;3;69;U;;701;369;332;0;2;367;369
8;Barcelona;13;Barcelonès;08019;Barcelona;3;7;U;;588;244;344;0;0;244;244
8;Barcelona;13;Barcelonès;08019;Barcelona;3;70;U;;478;191;287;0;1;190;191
8;Barcelona;13;Barcelonès;08019;Barcelona;3;71;A;;620;315;305;2;4;309;313
8;Barcelona;13;Barcelonès;08019;Barcelona;3;71;B;;675;368;307;0;6;362;368
8;Barcelona;13;Barcelonès;08019;Barcelona;3;72;A;;799;376;423;2;7;367;374
8;Barcelona;13;Barcelonès;08019;Barcelona;3;72;B;;584;260;324;2;6;252;258
8;Barcelona;13;Barcelonès;08019;Barcelona;3;72;C;;552;247;305;0;1;246;247
8;Barcelona;13;Barcelonès;08019;Barcelona;3;72;D;;684;317;367;0;2;315;317
8;Barcelona;13;Barcelonès;08019;Barcelona;3;72;E;;560;258;302;2;3;253;256
8;Barcelona;13;Barcelonès;08019;Barcelona;3;72;F;;798;408;390;0;5;403;408
8;Barcelona;13;Barcelonès;08019;Barcelona;3;72;G;;651;310;341;1;5;304;309
8;Barcelona;13;Barcelonès;08019;Barcelona;3;72;H;;479;232;247;2;3;227;230
8;Barcelona;13;Barcelonès;08019;Barcelona;3;72;I;;873;414;459;1;3;410;413
8;Barcelona;13;Barcelonès;08019;Barcelona;3;73;A;;507;221;286;1;1;219;220
8;Barcelona;13;Barcelonès;08019;Barcelona;3;73;B;;644;254;390;0;3;251;254
8;Barcelona;13;Barcelonès;08019;Barcelona;3;73;C;;599;243;356;0;3;240;243
8;Barcelona;13;Barcelonès;08019;Barcelona;3;74;A;;614;280;334;0;4;276;280
8;Barcelona;13;Barcelonès;08019;Barcelona;3;74;B;;642;259;383;1;4;254;258
8;Barcelona;13;Barcelonès;08019;Barcelona;3;74;C;;691;315;376;9;1;305;306
8;Barcelona;13;Barcelonès;08019;Barcelona;3;75;A;;452;210;242;0;2;208;210
8;Barcelona;13;Barcelonès;08019;Barcelona;3;75;B;;568;264;304;1;4;259;263
8;Barcelona;13;Barcelonès;08019;Barcelona;3;75;C;;558;260;298;0;2;258;260
8;Barcelona;13;Barcelonès;08019;Barcelona;3;76;U;;623;242;381;1;9;232;241
8;Barcelona;13;Barcelonès;08019;Barcelona;3;77;U;;484;164;320;0;2;162;164
8;Barcelona;13;Barcelonès;08019;Barcelona;3;78;U;;862;346;516;6;1;339;340
8;Barcelona;13;Barcelonès;08019;Barcelona;3;79;U;;693;282;411;0;2;280;282
8;Barcelona;13;Barcelonès;08019;Barcelona;3;8;U;;562;278;284;2;0;276;276
8;Barcelona;13;Barcelonès;08019;Barcelona;3;80;U;;408;190;218;0;1;189;190
8;Barcelona;13;Barcelonès;08019;Barcelona;3;81;U;;677;299;378;0;0;299;299
8;Barcelona;13;Barcelonès;08019;Barcelona;3;82;A;;597;307;290;0;7;300;307
8;Barcelona;13;Barcelonès;08019;Barcelona;3;82;B;;625;310;315;0;4;306;310
8;Barcelona;13;Barcelonès;08019;Barcelona;3;83;A;;470;214;256;0;9;205;214
8;Barcelona;13;Barcelonès;08019;Barcelona;3;83;B;;538;271;267;0;3;268;271
8;Barcelona;13;Barcelonès;08019;Barcelona;3;84;U;;657;351;306;4;3;344;347
8;Barcelona;13;Barcelonès;08019;Barcelona;3;85;U;;835;403;432;1;5;397;402
8;Barcelona;13;Barcelonès;08019;Barcelona;3;86;U;;751;351;400;0;5;346;351
8;Barcelona;13;Barcelonès;08019;Barcelona;3;87;U;;623;358;265;3;6;349;355
8;Barcelona;13;Barcelonès;08019;Barcelona;3;88;U;;876;524;352;0;12;512;524
8;Barcelona;13;Barcelonès;08019;Barcelona;3;89;U;;548;326;222;4;5;317;322
8;Barcelona;13;Barcelonès;08019;Barcelona;3;9;U;;443;227;216;1;2;224;226
8;Barcelona;13;Barcelonès;08019;Barcelona;3;90;U;;565;289;276;0;2;287;289
8;Barcelona;13;Barcelonès;08019;Barcelona;3;91;A;;455;243;212;0;0;243;243
8;Barcelona;13;Barcelonès;08019;Barcelona;3;91;B;;535;313;222;1;6;306;312
8;Barcelona;13;Barcelonès;08019;Barcelona;3;92;U;;645;359;286;1;3;355;358
8;Barcelona;13;Barcelonès;08019;Barcelona;3;93;U;;704;385;319;0;4;381;385
8;Barcelona;13;Barcelonès;08019;Barcelona;3;94;U;;713;373;340;3;7;363;370
8;Barcelona;13;Barcelonès;08019;Barcelona;3;95;U;;729;389;340;0;7;382;389
8;Barcelona;13;Barcelonès;08019;Barcelona;3;97;U;;778;491;287;2;3;486;489
8;Barcelona;13;Barcelonès;08019;Barcelona;3;98;U;;528;318;210;0;1;317;318
8;Barcelona;13;Barcelonès;08019;Barcelona;3;99;U;;602;353;249;0;4;349;353
8;Barcelona;13;Barcelonès;08019;Barcelona;4;1;A;;590;351;239;1;8;342;350
8;Barcelona;13;Barcelonès;08019;Barcelona;4;1;B;;515;311;204;0;10;301;311
8;Barcelona;13;Barcelonès;08019;Barcelona;4;1;C;;708;444;264;1;10;433;443
8;Barcelona;13;Barcelonès;08019;Barcelona;4;1;D;;539;347;192;1;9;337;346
8;Barcelona;13;Barcelonès;08019;Barcelona;4;10;A;;721;444;277;1;9;434;443
8;Barcelona;13;Barcelonès;08019;Barcelona;4;10;B;;551;326;225;0;9;317;326
8;Barcelona;13;Barcelonès;08019;Barcelona;4;10;C;;731;438;293;1;9;428;437
8;Barcelona;13;Barcelonès;08019;Barcelona;4;10;D;;635;419;216;0;9;410;419
8;Barcelona;13;Barcelonès;08019;Barcelona;4;11;A;;626;374;252;1;3;370;373
8;Barcelona;13;Barcelonès;08019;Barcelona;4;11;B;;673;379;294;2;4;373;377
8;Barcelona;13;Barcelonès;08019;Barcelona;4;11;C;;721;457;264;2;8;447;455
8;Barcelona;13;Barcelonès;08019;Barcelona;4;12;U;;653;357;296;0;6;351;357
8;Barcelona;13;Barcelonès;08019;Barcelona;4;13;A;;494;239;255;1;1;237;238
8;Barcelona;13;Barcelonès;08019;Barcelona;4;13;B;;569;322;247;0;9;313;322
8;Barcelona;13;Barcelonès;08019;Barcelona;4;14;U;;574;306;268;0;5;301;306
8;Barcelona;13;Barcelonès;08019;Barcelona;4;15;U;;719;338;381;1;4;333;337
8;Barcelona;13;Barcelonès;08019;Barcelona;4;16;A;;691;353;338;1;5;347;352
8;Barcelona;13;Barcelonès;08019;Barcelona;4;16;B;;884;426;458;1;9;416;425
8;Barcelona;13;Barcelonès;08019;Barcelona;4;17;U;;576;252;324;1;2;249;251
8;Barcelona;13;Barcelonès;08019;Barcelona;4;18;A;;553;309;244;0;5;304;309
8;Barcelona;13;Barcelonès;08019;Barcelona;4;18;B;;580;330;250;0;7;323;330
8;Barcelona;13;Barcelonès;08019;Barcelona;4;19;A;;665;426;239;0;9;417;426
8;Barcelona;13;Barcelonès;08019;Barcelona;4;19;B;;634;360;274;0;7;353;360
8;Barcelona;13;Barcelonès;08019;Barcelona;4;19;C;;710;422;288;0;9;413;422
8;Barcelona;13;Barcelonès;08019;Barcelona;4;2;U;;677;388;289;5;6;377;383
8;Barcelona;13;Barcelonès;08019;Barcelona;4;20;A;;730;458;272;1;8;449;457
8;Barcelona;13;Barcelonès;08019;Barcelona;4;20;B;;771;476;295;0;4;472;476
8;Barcelona;13;Barcelonès;08019;Barcelona;4;21;A;;592;443;149;0;7;436;443
8;Barcelona;13;Barcelonès;08019;Barcelona;4;21;B;;622;446;176;2;9;435;444
8;Barcelona;13;Barcelonès;08019;Barcelona;4;22;U;;969;542;427;2;15;525;540
8;Barcelona;13;Barcelonès;08019;Barcelona;4;23;U;;664;398;266;3;4;391;395
8;Barcelona;13;Barcelonès;08019;Barcelona;4;24;U;;768;474;294;2;3;469;472
8;Barcelona;13;Barcelonès;08019;Barcelona;4;25;U;;677;386;291;0;6;380;386
8;Barcelona;13;Barcelonès;08019;Barcelona;4;26;U;;699;415;284;0;5;410;415
8;Barcelona;13;Barcelonès;08019;Barcelona;4;27;U;;660;340;320;0;6;334;340
8;Barcelona;13;Barcelonès;08019;Barcelona;4;28;U;;779;384;395;0;11;373;384
8;Barcelona;13;Barcelonès;08019;Barcelona;4;29;A;;519;317;202;0;1;316;317
8;Barcelona;13;Barcelonès;08019;Barcelona;4;29;B;;519;320;199;2;1;317;318
8;Barcelona;13;Barcelonès;08019;Barcelona;4;3;U;;528;278;250;8;5;265;270
8;Barcelona;13;Barcelonès;08019;Barcelona;4;30;U;;459;274;185;1;5;268;273
8;Barcelona;13;Barcelonès;08019;Barcelona;4;31;U;;609;301;308;2;2;297;299
8;Barcelona;13;Barcelonès;08019;Barcelona;4;32;U;;790;447;343;1;9;437;446
8;Barcelona;13;Barcelonès;08019;Barcelona;4;33;U;;820;439;381;4;11;424;435
8;Barcelona;13;Barcelonès;08019;Barcelona;4;34;U;;811;496;315;0;8;488;496
8;Barcelona;13;Barcelonès;08019;Barcelona;4;35;A;;512;277;235;0;6;271;277
8;Barcelona;13;Barcelonès;08019;Barcelona;4;35;B;;504;283;221;1;1;281;282
8;Barcelona;13;Barcelonès;08019;Barcelona;4;36;U;;633;392;241;0;6;386;392
8;Barcelona;13;Barcelonès;08019;Barcelona;4;37;A;;522;308;214;2;9;297;306
8;Barcelona;13;Barcelonès;08019;Barcelona;4;37;B;;520;305;215;0;2;303;305
8;Barcelona;13;Barcelonès;08019;Barcelona;4;38;U;;684;386;298;0;6;380;386
8;Barcelona;13;Barcelonès;08019;Barcelona;4;39;U;;668;432;236;2;6;424;430
8;Barcelona;13;Barcelonès;08019;Barcelona;4;4;U;;679;394;285;0;5;389;394
8;Barcelona;13;Barcelonès;08019;Barcelona;4;40;A;;656;418;238;0;14;404;418
8;Barcelona;13;Barcelonès;08019;Barcelona;4;40;B;;767;497;270;4;11;482;493
8;Barcelona;13;Barcelonès;08019;Barcelona;4;41;A;;654;387;267;0;6;381;387
8;Barcelona;13;Barcelonès;08019;Barcelona;4;41;B;;653;400;253;2;1;397;398
8;Barcelona;13;Barcelonès;08019;Barcelona;4;42;A;;622;373;249;1;10;362;372
8;Barcelona;13;Barcelonès;08019;Barcelona;4;42;B;;636;378;258;1;4;373;377
8;Barcelona;13;Barcelonès;08019;Barcelona;4;43;U;;642;370;272;0;4;366;370
8;Barcelona;13;Barcelonès;08019;Barcelona;4;44;A;;506;320;186;6;2;312;314
8;Barcelona;13;Barcelonès;08019;Barcelona;4;44;B;;546;305;241;1;6;298;304
8;Barcelona;13;Barcelonès;08019;Barcelona;4;45;U;;394;198;196;0;0;198;198
8;Barcelona;13;Barcelonès;08019;Barcelona;4;46;U;;595;347;248;0;5;342;347
8;Barcelona;13;Barcelonès;08019;Barcelona;4;48;U;;667;393;274;0;4;389;393
8;Barcelona;13;Barcelonès;08019;Barcelona;4;49;U;;468;317;151;0;7;310;317
8;Barcelona;13;Barcelonès;08019;Barcelona;4;5;U;;624;323;301;0;1;322;323
8;Barcelona;13;Barcelonès;08019;Barcelona;4;50;U;;806;502;304;5;6;491;497
8;Barcelona;13;Barcelonès;08019;Barcelona;4;51;U;;621;414;207;5;8;401;409
8;Barcelona;13;Barcelonès;08019;Barcelona;4;52;U;;962;629;333;3;8;618;626
8;Barcelona;13;Barcelonès;08019;Barcelona;4;53;U;;807;488;319;1;4;483;487
8;Barcelona;13;Barcelonès;08019;Barcelona;4;54;U;;955;601;354;3;15;583;598
8;Barcelona;13;Barcelonès;08019;Barcelona;4;55;U;;674;419;255;1;10;408;418
8;Barcelona;13;Barcelonès;08019;Barcelona;4;56;U;;545;357;188;0;7;350;357
8;Barcelona;13;Barcelonès;08019;Barcelona;4;57;U;;550;341;209;0;8;333;341
8;Barcelona;13;Barcelonès;08019;Barcelona;4;58;U;;666;447;219;0;3;444;447
8;Barcelona;13;Barcelonès;08019;Barcelona;4;6;U;;674;362;312;0;4;358;362
8;Barcelona;13;Barcelonès;08019;Barcelona;4;60;U;;705;443;262;0;11;432;443
8;Barcelona;13;Barcelonès;08019;Barcelona;4;61;U;;578;356;222;1;0;355;355
8;Barcelona;13;Barcelonès;08019;Barcelona;4;62;U;;668;437;231;0;6;431;437
8;Barcelona;13;Barcelonès;08019;Barcelona;4;63;U;;501;320;181;2;5;313;318
8;Barcelona;13;Barcelonès;08019;Barcelona;4;64;U;;446;268;178;1;5;262;267
8;Barcelona;13;Barcelonès;08019;Barcelona;4;65;U;;561;346;215;0;8;338;346
8;Barcelona;13;Barcelonès;08019;Barcelona;4;66;A;;558;385;173;0;7;378;385
8;Barcelona;13;Barcelonès;08019;Barcelona;4;66;B;;659;438;221;0;6;432;438
8;Barcelona;13;Barcelonès;08019;Barcelona;4;67;U;;416;267;149;0;8;259;267
8;Barcelona;13;Barcelonès;08019;Barcelona;4;68;U;;825;530;295;2;5;523;528
8;Barcelona;13;Barcelonès;08019;Barcelona;4;69;A;;613;381;232;1;2;378;380
8;Barcelona;13;Barcelonès;08019;Barcelona;4;69;B;;680;416;264;0;4;412;416
8;Barcelona;13;Barcelonès;08019;Barcelona;4;7;A;;623;393;230;1;6;386;392
8;Barcelona;13;Barcelonès;08019;Barcelona;4;7;B;;538;321;217;0;3;318;321
8;Barcelona;13;Barcelonès;08019;Barcelona;4;7;C;;575;374;201;0;3;371;374
8;Barcelona;13;Barcelonès;08019;Barcelona;4;70;U;;563;321;242;0;4;317;321
8;Barcelona;13;Barcelonès;08019;Barcelona;4;71;A;;651;418;233;0;3;415;418
8;Barcelona;13;Barcelonès;08019;Barcelona;4;71;B;;663;452;211;0;11;441;452
8;Barcelona;13;Barcelonès;08019;Barcelona;4;73;A;;556;410;146;0;11;399;410
8;Barcelona;13;Barcelonès;08019;Barcelona;4;73;B;;565;417;148;1;4;412;416
8;Barcelona;13;Barcelonès;08019;Barcelona;4;74;A;;681;444;237;0;11;433;444
8;Barcelona;13;Barcelonès;08019;Barcelona;4;74;B;;545;367;178;1;9;357;366
8;Barcelona;13;Barcelonès;08019;Barcelona;4;74;C;;715;478;237;0;11;467;478
8;Barcelona;13;Barcelonès;08019;Barcelona;4;75;U;;572;366;206;0;7;359;366
8;Barcelona;13;Barcelonès;08019;Barcelona;4;76;A;;619;393;226;1;3;389;392
8;Barcelona;13;Barcelonès;08019;Barcelona;4;76;B;;663;441;222;1;14;426;440
8;Barcelona;13;Barcelonès;08019;Barcelona;4;77;A;;738;513;225;1;8;504;512
8;Barcelona;13;Barcelonès;08019;Barcelona;4;77;B;;689;480;209;0;7;473;480
8;Barcelona;13;Barcelonès;08019;Barcelona;4;78;U;;433;199;234;2;4;193;197
8;Barcelona;13;Barcelonès;08019;Barcelona;4;79;U;;943;649;294;0;8;641;649
8;Barcelona;13;Barcelonès;08019;Barcelona;4;8;U;;173;51;122;0;0;51;51
8;Barcelona;13;Barcelonès;08019;Barcelona;4;80;U;;722;426;296;3;9;414;423
8;Barcelona;13;Barcelonès;08019;Barcelona;4;81;A;;482;332;150;1;4;327;331
8;Barcelona;13;Barcelonès;08019;Barcelona;4;81;B;;583;406;177;1;4;401;405
8;Barcelona;13;Barcelonès;08019;Barcelona;4;82;U;;809;512;297;0;6;506;512
8;Barcelona;13;Barcelonès;08019;Barcelona;4;9;U;;929;545;384;0;19;526;545
8;Barcelona;13;Barcelonès;08019;Barcelona;5;1;U;;392;263;129;1;8;254;262
8;Barcelona;13;Barcelonès;08019;Barcelona;5;10;U;;949;591;358;2;11;578;589
8;Barcelona;13;Barcelonès;08019;Barcelona;5;100;U;;734;510;224;0;18;492;510
8;Barcelona;13;Barcelonès;08019;Barcelona;5;101;U;;705;366;339;1;0;365;365
8;Barcelona;13;Barcelonès;08019;Barcelona;5;102;U;;855;615;240;3;8;604;612
8;Barcelona;13;Barcelonès;08019;Barcelona;5;103;U;;593;410;183;0;8;402;410
8;Barcelona;13;Barcelonès;08019;Barcelona;5;104;U;;414;295;119;0;4;291;295
8;Barcelona;13;Barcelonès;08019;Barcelona;5;105;A;;599;400;199;0;8;392;400
8;Barcelona;13;Barcelonès;08019;Barcelona;5;105;B;;693;473;220;0;6;467;473
8;Barcelona;13;Barcelonès;08019;Barcelona;5;106;U;;850;566;284;0;11;555;566
8;Barcelona;13;Barcelonès;08019;Barcelona;5;107;U;;576;370;206;1;13;356;369
8;Barcelona;13;Barcelonès;08019;Barcelona;5;108;U;;464;285;179;0;1;284;285
8;Barcelona;13;Barcelonès;08019;Barcelona;5;109;U;;700;472;228;0;11;461;472
8;Barcelona;13;Barcelonès;08019;Barcelona;5;11;U;;570;390;180;0;4;386;390
8;Barcelona;13;Barcelonès;08019;Barcelona;5;110;U;;428;278;150;0;5;273;278
8;Barcelona;13;Barcelonès;08019;Barcelona;5;111;U;;799;521;278;3;13;505;518
8;Barcelona;13;Barcelonès;08019;Barcelona;5;112;U;;866;560;306;0;10;550;560
8;Barcelona;13;Barcelonès;08019;Barcelona;5;113;U;;480;293;187;0;4;289;293
8;Barcelona;13;Barcelonès;08019;Barcelona;5;114;U;;525;347;178;0;10;337;347
8;Barcelona;13;Barcelonès;08019;Barcelona;5;115;U;;499;299;200;0;6;293;299
8;Barcelona;13;Barcelonès;08019;Barcelona;5;116;U;;556;349;207;2;8;339;347
8;Barcelona;13;Barcelonès;08019;Barcelona;5;117;U;;694;490;204;0;8;482;490
8;Barcelona;13;Barcelonès;08019;Barcelona;5;118;U;;434;296;138;1;10;285;295
8;Barcelona;13;Barcelonès;08019;Barcelona;5;119;U;;577;362;215;3;4;355;359
8;Barcelona;13;Barcelonès;08019;Barcelona;5;12;U;;764;486;278;2;10;474;484
8;Barcelona;13;Barcelonès;08019;Barcelona;5;120;U;;586;368;218;0;7;361;368
8;Barcelona;13;Barcelonès;08019;Barcelona;5;121;U;;437;297;140;0;5;292;297
8;Barcelona;13;Barcelonès;08019;Barcelona;5;122;U;;945;641;304;0;8;633;641
8;Barcelona;13;Barcelonès;08019;Barcelona;5;123;U;;458;291;167;1;4;286;290
8;Barcelona;13;Barcelonès;08019;Barcelona;5;124;U;;681;470;211;1;11;458;469
8;Barcelona;13;Barcelonès;08019;Barcelona;5;125;U;;630;411;219;0;7;404;411
8;Barcelona;13;Barcelonès;08019;Barcelona;5;126;U;;582;396;186;0;6;390;396
8;Barcelona;13;Barcelonès;08019;Barcelona;5;127;U;;617;441;176;0;5;436;441
8;Barcelona;13;Barcelonès;08019;Barcelona;5;128;U;;472;277;195;1;8;268;276
8;Barcelona;13;Barcelonès;08019;Barcelona;5;129;U;;617;432;185;0;12;420;432
8;Barcelona;13;Barcelonès;08019;Barcelona;5;13;A;;454;284;170;0;1;283;284
8;Barcelona;13;Barcelonès;08019;Barcelona;5;13;B;;537;346;191;0;6;340;346
8;Barcelona;13;Barcelonès;08019;Barcelona;5;130;U;;514;372;142;1;10;361;371
8;Barcelona;13;Barcelonès;08019;Barcelona;5;131;U;;421;304;117;0;8;296;304
8;Barcelona;13;Barcelonès;08019;Barcelona;5;132;U;;513;358;155;0;9;349;358
8;Barcelona;13;Barcelonès;08019;Barcelona;5;133;A;;510;352;158;1;8;343;351
8;Barcelona;13;Barcelonès;08019;Barcelona;5;133;B;;516;352;164;0;4;348;352
8;Barcelona;13;Barcelonès;08019;Barcelona;5;134;U;;681;480;201;0;13;467;480
8;Barcelona;13;Barcelonès;08019;Barcelona;5;135;A;;535;383;152;0;16;367;383
8;Barcelona;13;Barcelonès;08019;Barcelona;5;135;B;;581;410;171;1;9;400;409
8;Barcelona;13;Barcelonès;08019;Barcelona;5;136;U;;889;610;279;0;9;601;610
8;Barcelona;13;Barcelonès;08019;Barcelona;5;137;U;;632;469;163;5;9;455;464
8;Barcelona;13;Barcelonès;08019;Barcelona;5;138;U;;771;488;283;0;5;483;488
8;Barcelona;13;Barcelonès;08019;Barcelona;5;139;U;;814;560;254;0;10;550;560
8;Barcelona;13;Barcelonès;08019;Barcelona;5;14;U;;613;385;228;1;5;379;384
8;Barcelona;13;Barcelonès;08019;Barcelona;5;140;U;;634;403;231;1;7;395;402
8;Barcelona;13;Barcelonès;08019;Barcelona;5;141;U;;498;334;164;1;7;326;333
8;Barcelona;13;Barcelonès;08019;Barcelona;5;142;U;;431;245;186;1;5;239;244
8;Barcelona;13;Barcelonès;08019;Barcelona;5;143;U;;555;381;174;0;10;371;381
8;Barcelona;13;Barcelonès;08019;Barcelona;5;144;U;;696;460;236;0;14;446;460
8;Barcelona;13;Barcelonès;08019;Barcelona;5;145;U;;825;556;269;0;15;541;556
8;Barcelona;13;Barcelonès;08019;Barcelona;5;146;U;;829;502;327;0;6;496;502
8;Barcelona;13;Barcelonès;08019;Barcelona;5;147;U;;636;458;178;1;5;452;457
8;Barcelona;13;Barcelonès;08019;Barcelona;5;148;A;;658;435;223;0;9;426;435
8;Barcelona;13;Barcelonès;08019;Barcelona;5;148;B;;706;494;212;1;9;484;493
8;Barcelona;13;Barcelonès;08019;Barcelona;5;149;U;;543;303;240;1;11;291;302
8;Barcelona;13;Barcelonès;08019;Barcelona;5;15;U;;510;373;137;0;9;364;373
8;Barcelona;13;Barcelonès;08019;Barcelona;5;150;A;;549;348;201;1;6;341;347
8;Barcelona;13;Barcelonès;08019;Barcelona;5;150;B;;603;369;234;3;3;363;366
8;Barcelona;13;Barcelonès;08019;Barcelona;5;152;U;;660;373;287;1;8;364;372
8;Barcelona;13;Barcelonès;08019;Barcelona;5;153;U;;762;498;264;2;10;486;496
8;Barcelona;13;Barcelonès;08019;Barcelona;5;154;U;;674;460;214;0;14;446;460
8;Barcelona;13;Barcelonès;08019;Barcelona;5;155;U;;541;364;177;1;8;355;363
8;Barcelona;13;Barcelonès;08019;Barcelona;5;156;U;;754;514;240;0;7;507;514
8;Barcelona;13;Barcelonès;08019;Barcelona;5;157;U;;659;429;230;2;8;419;427
8;Barcelona;13;Barcelonès;08019;Barcelona;5;158;U;;792;547;245;2;9;536;545
8;Barcelona;13;Barcelonès;08019;Barcelona;5;16;U;;580;403;177;0;7;396;403
8;Barcelona;13;Barcelonès;08019;Barcelona;5;160;A;;547;366;181;0;10;356;366
8;Barcelona;13;Barcelonès;08019;Barcelona;5;160;B;;493;348;145;1;7;340;347
8;Barcelona;13;Barcelonès;08019;Barcelona;5;161;U;;786;551;235;0;7;544;551
8;Barcelona;13;Barcelonès;08019;Barcelona;5;162;U;;543;349;194;1;4;344;348
8;Barcelona;13;Barcelonès;08019;Barcelona;5;163;U;;535;336;199;1;6;329;335
8;Barcelona;13;Barcelonès;08019;Barcelona;5;164;U;;656;417;239;1;2;414;416
8;Barcelona;13;Barcelonès;08019;Barcelona;5;165;U;;689;479;210;0;16;463;479
8;Barcelona;13;Barcelonès;08019;Barcelona;5;166;U;;392;269;123;0;3;266;269
8;Barcelona;13;Barcelonès;08019;Barcelona;5;167;U;;447;285;162;3;3;279;282
8;Barcelona;13;Barcelonès;08019;Barcelona;5;168;U;;601;417;184;0;3;414;417
8;Barcelona;13;Barcelonès;08019;Barcelona;5;169;U;;819;593;226;1;15;577;592
8;Barcelona;13;Barcelonès;08019;Barcelona;5;17;U;;544;394;150;0;4;390;394
8;Barcelona;13;Barcelonès;08019;Barcelona;5;170;U;;690;443;247;1;9;433;442
8;Barcelona;13;Barcelonès;08019;Barcelona;5;171;U;;597;448;149;2;10;436;446
8;Barcelona;13;Barcelonès;08019;Barcelona;5;172;U;;383;274;109;1;4;269;273
8;Barcelona;13;Barcelonès;08019;Barcelona;5;174;U;;552;293;259;0;6;287;293
8;Barcelona;13;Barcelonès;08019;Barcelona;5;175;U;;656;402;254;1;9;392;401
8;Barcelona;13;Barcelonès;08019;Barcelona;5;176;U;;496;365;131;1;3;361;364
8;Barcelona;13;Barcelonès;08019;Barcelona;5;177;U;;623;439;184;0;11;428;439
8;Barcelona;13;Barcelonès;08019;Barcelona;5;178;U;;499;350;149;1;7;342;349
8;Barcelona;13;Barcelonès;08019;Barcelona;5;179;U;;516;309;207;1;5;303;308
8;Barcelona;13;Barcelonès;08019;Barcelona;5;18;U;;838;552;286;1;7;544;551
8;Barcelona;13;Barcelonès;08019;Barcelona;5;180;U;;487;300;187;1;3;296;299
8;Barcelona;13;Barcelonès;08019;Barcelona;5;182;U;;815;485;330;0;15;470;485
8;Barcelona;13;Barcelonès;08019;Barcelona;5;183;U;;510;218;292;4;7;207;214
8;Barcelona;13;Barcelonès;08019;Barcelona;5;19;U;;719;466;253;1;6;459;465
8;Barcelona;13;Barcelonès;08019;Barcelona;5;2;U;;725;501;224;0;13;488;501
8;Barcelona;13;Barcelonès;08019;Barcelona;5;20;U;;645;422;223;1;6;415;421
8;Barcelona;13;Barcelonès;08019;Barcelona;5;21;U;;513;360;153;0;11;349;360
8;Barcelona;13;Barcelonès;08019;Barcelona;5;22;U;;626;402;224;0;7;395;402
8;Barcelona;13;Barcelonès;08019;Barcelona;5;23;U;;680;464;216;0;10;454;464
8;Barcelona;13;Barcelonès;08019;Barcelona;5;24;U;;729;475;254;0;10;465;475
8;Barcelona;13;Barcelonès;08019;Barcelona;5;25;U;;687;443;244;2;8;433;441
8;Barcelona;13;Barcelonès;08019;Barcelona;5;27;U;;771;497;274;3;5;489;494
8;Barcelona;13;Barcelonès;08019;Barcelona;5;28;U;;705;467;238;1;1;465;466
8;Barcelona;13;Barcelonès;08019;Barcelona;5;29;U;;506;346;160;1;7;338;345
8;Barcelona;13;Barcelonès;08019;Barcelona;5;3;A;;605;372;233;0;13;359;372
8;Barcelona;13;Barcelonès;08019;Barcelona;5;3;B;;675;420;255;7;2;411;413
8;Barcelona;13;Barcelonès;08019;Barcelona;5;30;U;;704;501;203;1;5;495;500
8;Barcelona;13;Barcelonès;08019;Barcelona;5;31;U;;786;500;286;0;10;490;500
8;Barcelona;13;Barcelonès;08019;Barcelona;5;32;U;;610;386;224;0;4;382;386
8;Barcelona;13;Barcelonès;08019;Barcelona;5;33;U;;593;412;181;0;9;403;412
8;Barcelona;13;Barcelonès;08019;Barcelona;5;34;U;;738;457;281;0;6;451;457
8;Barcelona;13;Barcelonès;08019;Barcelona;5;35;U;;784;491;293;1;7;483;490
8;Barcelona;13;Barcelonès;08019;Barcelona;5;36;U;;517;306;211;2;9;295;304
8;Barcelona;13;Barcelonès;08019;Barcelona;5;37;U;;943;599;344;2;10;587;597
8;Barcelona;13;Barcelonès;08019;Barcelona;5;38;U;;613;396;217;10;2;384;386
8;Barcelona;13;Barcelonès;08019;Barcelona;5;39;A;;523;357;166;1;6;350;356
8;Barcelona;13;Barcelonès;08019;Barcelona;5;39;B;;634;400;234;0;14;386;400
8;Barcelona;13;Barcelonès;08019;Barcelona;5;4;U;;935;636;299;1;11;624;635
8;Barcelona;13;Barcelonès;08019;Barcelona;5;40;U;;667;442;225;2;9;431;440
8;Barcelona;13;Barcelonès;08019;Barcelona;5;41;A;;533;357;176;2;7;348;355
8;Barcelona;13;Barcelonès;08019;Barcelona;5;41;B;;679;449;230;1;13;435;448
8;Barcelona;13;Barcelonès;08019;Barcelona;5;42;U;;944;606;338;1;5;600;605
8;Barcelona;13;Barcelonès;08019;Barcelona;5;43;U;;597;416;181;2;9;405;414
8;Barcelona;13;Barcelonès;08019;Barcelona;5;44;U;;660;471;189;0;10;461;471
8;Barcelona;13;Barcelonès;08019;Barcelona;5;45;U;;504;336;168;0;12;324;336
8;Barcelona;13;Barcelonès;08019;Barcelona;5;46;U;;757;538;219;3;4;531;535
8;Barcelona;13;Barcelonès;08019;Barcelona;5;47;U;;641;462;179;2;8;452;460
8;Barcelona;13;Barcelonès;08019;Barcelona;5;48;U;;480;313;167;0;7;306;313
8;Barcelona;13;Barcelonès;08019;Barcelona;5;49;U;;778;504;274;0;4;500;504
8;Barcelona;13;Barcelonès;08019;Barcelona;5;5;A;;490;321;169;0;4;317;321
8;Barcelona;13;Barcelonès;08019;Barcelona;5;5;B;;594;387;207;0;12;375;387
8;Barcelona;13;Barcelonès;08019;Barcelona;5;50;U;;666;432;234;0;11;421;432
8;Barcelona;13;Barcelonès;08019;Barcelona;5;51;U;;646;424;222;1;8;415;423
8;Barcelona;13;Barcelonès;08019;Barcelona;5;52;U;;794;536;258;0;6;530;536
8;Barcelona;13;Barcelonès;08019;Barcelona;5;53;U;;636;443;193;1;8;434;442
8;Barcelona;13;Barcelonès;08019;Barcelona;5;54;U;;758;529;229;0;2;527;529
8;Barcelona;13;Barcelonès;08019;Barcelona;5;55;A;;492;354;138;4;5;345;350
8;Barcelona;13;Barcelonès;08019;Barcelona;5;55;B;;502;337;165;0;2;335;337
8;Barcelona;13;Barcelonès;08019;Barcelona;5;56;U;;715;481;234;5;16;460;476
8;Barcelona;13;Barcelonès;08019;Barcelona;5;57;U;;669;449;220;0;6;443;449
8;Barcelona;13;Barcelonès;08019;Barcelona;5;58;U;;910;576;334;3;9;564;573
8;Barcelona;13;Barcelonès;08019;Barcelona;5;59;U;;593;371;222;2;4;365;369
8;Barcelona;13;Barcelonès;08019;Barcelona;5;6;A;;588;388;200;0;11;377;388
8;Barcelona;13;Barcelonès;08019;Barcelona;5;6;B;;701;457;244;0;12;445;457
8;Barcelona;13;Barcelonès;08019;Barcelona;5;60;U;;838;517;321;1;6;510;516
8;Barcelona;13;Barcelonès;08019;Barcelona;5;61;U;;852;521;331;4;13;504;517
8;Barcelona;13;Barcelonès;08019;Barcelona;5;62;U;;424;284;140;0;0;284;284
8;Barcelona;13;Barcelonès;08019;Barcelona;5;63;U;;579;371;208;1;4;366;370
8;Barcelona;13;Barcelonès;08019;Barcelona;5;64;U;;600;388;212;0;2;386;388
8;Barcelona;13;Barcelonès;08019;Barcelona;5;65;U;;550;334;216;0;10;324;334
8;Barcelona;13;Barcelonès;08019;Barcelona;5;66;U;;511;297;214;2;5;290;295
8;Barcelona;13;Barcelonès;08019;Barcelona;5;67;U;;571;382;189;0;5;377;382
8;Barcelona;13;Barcelonès;08019;Barcelona;5;68;U;;567;353;214;0;11;342;353
8;Barcelona;13;Barcelonès;08019;Barcelona;5;69;U;;776;475;301;0;5;470;475
8;Barcelona;13;Barcelonès;08019;Barcelona;5;7;U;;628;421;207;0;8;413;421
8;Barcelona;13;Barcelonès;08019;Barcelona;5;70;U;;690;431;259;0;7;424;431
8;Barcelona;13;Barcelonès;08019;Barcelona;5;71;U;;438;281;157;1;4;276;280
8;Barcelona;13;Barcelonès;08019;Barcelona;5;72;U;;722;474;248;0;4;470;474
8;Barcelona;13;Barcelonès;08019;Barcelona;5;73;U;;563;374;189;0;6;368;374
8;Barcelona;13;Barcelonès;08019;Barcelona;5;74;U;;652;447;205;2;11;434;445
8;Barcelona;13;Barcelonès;08019;Barcelona;5;75;U;;802;527;275;0;12;515;527
8;Barcelona;13;Barcelonès;08019;Barcelona;5;76;U;;644;466;178;1;11;454;465
8;Barcelona;13;Barcelonès;08019;Barcelona;5;77;A;;536;386;150;0;3;383;386
8;Barcelona;13;Barcelonès;08019;Barcelona;5;77;B;;581;381;200;1;3;377;380
8;Barcelona;13;Barcelonès;08019;Barcelona;5;78;U;;448;292;156;0;6;286;292
8;Barcelona;13;Barcelonès;08019;Barcelona;5;79;U;;702;486;216;1;4;481;485
8;Barcelona;13;Barcelonès;08019;Barcelona;5;8;U;;757;464;293;1;5;458;463
8;Barcelona;13;Barcelonès;08019;Barcelona;5;80;U;;513;339;174;0;7;332;339
8;Barcelona;13;Barcelonès;08019;Barcelona;5;81;U;;582;363;219;0;5;358;363
8;Barcelona;13;Barcelonès;08019;Barcelona;5;82;U;;744;443;301;0;8;435;443
8;Barcelona;13;Barcelonès;08019;Barcelona;5;83;U;;554;354;200;0;2;352;354
8;Barcelona;13;Barcelonès;08019;Barcelona;5;84;U;;529;334;195;1;7;326;333
8;Barcelona;13;Barcelonès;08019;Barcelona;5;85;U;;926;632;294;1;13;618;631
8;Barcelona;13;Barcelonès;08019;Barcelona;5;86;U;;772;446;326;0;5;441;446
8;Barcelona;13;Barcelonès;08019;Barcelona;5;87;U;;615;412;203;1;8;403;411
8;Barcelona;13;Barcelonès;08019;Barcelona;5;88;U;;570;386;184;0;6;380;386
8;Barcelona;13;Barcelonès;08019;Barcelona;5;89;U;;918;624;294;0;7;617;624
8;Barcelona;13;Barcelonès;08019;Barcelona;5;90;U;;663;438;225;1;5;432;437
8;Barcelona;13;Barcelonès;08019;Barcelona;5;91;A;;544;371;173;2;11;358;369
8;Barcelona;13;Barcelonès;08019;Barcelona;5;91;B;;479;318;161;1;6;311;317
8;Barcelona;13;Barcelonès;08019;Barcelona;5;91;C;;651;448;203;1;10;437;447
8;Barcelona;13;Barcelonès;08019;Barcelona;5;92;U;;546;372;174;1;5;366;371
8;Barcelona;13;Barcelonès;08019;Barcelona;5;93;U;;575;373;202;0;10;363;373
8;Barcelona;13;Barcelonès;08019;Barcelona;5;94;U;;579;387;192;0;5;382;387
8;Barcelona;13;Barcelonès;08019;Barcelona;5;95;U;;832;509;323;1;14;494;508
8;Barcelona;13;Barcelonès;08019;Barcelona;5;96;U;;664;423;241;1;6;416;422
8;Barcelona;13;Barcelonès;08019;Barcelona;5;97;A;;518;334;184;1;4;329;333
8;Barcelona;13;Barcelonès;08019;Barcelona;5;97;B;;485;305;180;0;6;299;305
8;Barcelona;13;Barcelonès;08019;Barcelona;5;97;C;;591;364;227;4;9;351;360
8;Barcelona;13;Barcelonès;08019;Barcelona;5;98;U;;687;427;260;1;10;416;426
8;Barcelona;13;Barcelonès;08019;Barcelona;5;99;U;;619;413;206;0;11;402;413
8;Barcelona;13;Barcelonès;08019;Barcelona;6;1;U;;536;340;196;1;4;335;339
8;Barcelona;13;Barcelonès;08019;Barcelona;6;10;U;;919;514;405;2;9;503;512
8;Barcelona;13;Barcelonès;08019;Barcelona;6;100;U;;466;288;178;0;5;283;288
8;Barcelona;13;Barcelonès;08019;Barcelona;6;101;U;;453;262;191;0;1;261;262
8;Barcelona;13;Barcelonès;08019;Barcelona;6;102;U;;655;439;216;0;9;430;439
8;Barcelona;13;Barcelonès;08019;Barcelona;6;103;U;;972;636;336;2;3;631;634
8;Barcelona;13;Barcelonès;08019;Barcelona;6;104;U;;774;482;292;1;15;466;481
8;Barcelona;13;Barcelonès;08019;Barcelona;6;105;U;;774;469;305;1;3;465;468
8;Barcelona;13;Barcelonès;08019;Barcelona;6;106;U;;832;458;374;0;9;449;458
8;Barcelona;13;Barcelonès;08019;Barcelona;6;107;U;;607;370;237;2;3;365;368
8;Barcelona;13;Barcelonès;08019;Barcelona;6;108;U;;495;296;199;1;3;292;295
8;Barcelona;13;Barcelonès;08019;Barcelona;6;109;U;;742;448;294;0;1;447;448
8;Barcelona;13;Barcelonès;08019;Barcelona;6;11;A;;484;295;189;3;2;290;292
8;Barcelona;13;Barcelonès;08019;Barcelona;6;11;B;;552;300;252;1;2;297;299
8;Barcelona;13;Barcelonès;08019;Barcelona;6;110;U;;503;336;167;0;4;332;336
8;Barcelona;13;Barcelonès;08019;Barcelona;6;111;U;;548;313;235;0;1;312;313
8;Barcelona;13;Barcelonès;08019;Barcelona;6;112;U;;938;585;353;3;14;568;582
8;Barcelona;13;Barcelonès;08019;Barcelona;6;113;U;;979;637;342;1;11;625;636
8;Barcelona;13;Barcelonès;08019;Barcelona;6;114;A;;514;326;188;0;4;322;326
8;Barcelona;13;Barcelonès;08019;Barcelona;6;114;B;;510;316;194;0;11;305;316
8;Barcelona;13;Barcelonès;08019;Barcelona;6;114;C;;589;370;219;0;6;364;370
8;Barcelona;13;Barcelonès;08019;Barcelona;6;115;A;;495;323;172;0;11;312;323
8;Barcelona;13;Barcelonès;08019;Barcelona;6;115;B;;531;343;188;1;4;338;342
8;Barcelona;13;Barcelonès;08019;Barcelona;6;116;U;;584;374;210;0;6;368;374
8;Barcelona;13;Barcelonès;08019;Barcelona;6;117;U;;765;482;283;1;6;475;481
8;Barcelona;13;Barcelonès;08019;Barcelona;6;118;U;;795;528;267;2;4;522;526
8;Barcelona;13;Barcelonès;08019;Barcelona;6;119;U;;922;606;316;2;6;598;604
8;Barcelona;13;Barcelonès;08019;Barcelona;6;12;U;;631;372;259;0;3;369;372
8;Barcelona;13;Barcelonès;08019;Barcelona;6;120;U;;766;503;263;1;6;496;502
8;Barcelona;13;Barcelonès;08019;Barcelona;6;121;U;;880;487;393;1;8;478;486
8;Barcelona;13;Barcelonès;08019;Barcelona;6;122;A;;514;339;175;1;4;334;338
8;Barcelona;13;Barcelonès;08019;Barcelona;6;122;B;;566;346;220;4;4;338;342
8;Barcelona;13;Barcelonès;08019;Barcelona;6;124;U;;816;437;379;0;4;433;437
8;Barcelona;13;Barcelonès;08019;Barcelona;6;125;U;;642;367;275;2;5;360;365
8;Barcelona;13;Barcelonès;08019;Barcelona;6;127;U;;947;566;381;1;9;556;565
8;Barcelona;13;Barcelonès;08019;Barcelona;6;128;U;;852;545;307;0;10;535;545
8;Barcelona;13;Barcelonès;08019;Barcelona;6;129;U;;522;289;233;2;7;280;287
8;Barcelona;13;Barcelonès;08019;Barcelona;6;13;U;;670;393;277;1;5;387;392
8;Barcelona;13;Barcelonès;08019;Barcelona;6;130;U;;618;341;277;0;14;327;341
8;Barcelona;13;Barcelonès;08019;Barcelona;6;131;U;;945;476;469;2;5;469;474
8;Barcelona;13;Barcelonès;08019;Barcelona;6;132;U;;767;397;370;1;8;388;396
8;Barcelona;13;Barcelonès;08019;Barcelona;6;133;U;;733;375;358;3;9;363;372
8;Barcelona;13;Barcelonès;08019;Barcelona;6;134;U;;466;286;180;0;4;282;286
8;Barcelona;13;Barcelonès;08019;Barcelona;6;135;A;;448;287;161;1;2;284;286
8;Barcelona;13;Barcelonès;08019;Barcelona;6;135;B;;543;347;196;0;5;342;347
8;Barcelona;13;Barcelonès;08019;Barcelona;6;136;A;;581;324;257;0;5;319;324
8;Barcelona;13;Barcelonès;08019;Barcelona;6;136;B;;685;398;287;3;3;392;395
8;Barcelona;13;Barcelonès;08019;Barcelona;6;137;U;;694;445;249;1;3;441;444
8;Barcelona;13;Barcelonès;08019;Barcelona;6;138;U;;914;508;406;1;9;498;507
8;Barcelona;13;Barcelonès;08019;Barcelona;6;139;U;;757;454;303;1;12;441;453
8;Barcelona;13;Barcelonès;08019;Barcelona;6;14;U;;479;291;188;2;4;285;289
8;Barcelona;13;Barcelonès;08019;Barcelona;6;140;U;;689;409;280;2;4;403;407
8;Barcelona;13;Barcelonès;08019;Barcelona;6;141;U;;618;362;256;1;5;356;361
8;Barcelona;13;Barcelonès;08019;Barcelona;6;142;U;;762;386;376;1;8;377;385
8;Barcelona;13;Barcelonès;08019;Barcelona;6;143;U;;573;282;291;4;5;273;278
8;Barcelona;13;Barcelonès;08019;Barcelona;6;144;U;;762;378;384;0;2;376;378
8;Barcelona;13;Barcelonès;08019;Barcelona;6;145;U;;540;262;278;0;2;260;262
8;Barcelona;13;Barcelonès;08019;Barcelona;6;146;U;;783;366;417;0;8;358;366
8;Barcelona;13;Barcelonès;08019;Barcelona;6;147;U;;521;260;261;0;1;259;260
8;Barcelona;13;Barcelonès;08019;Barcelona;6;148;U;;632;335;297;1;10;324;334
8;Barcelona;13;Barcelonès;08019;Barcelona;6;149;U;;671;372;299;0;6;366;372
8;Barcelona;13;Barcelonès;08019;Barcelona;6;15;U;;502;297;205;2;6;289;295
8;Barcelona;13;Barcelonès;08019;Barcelona;6;150;U;;468;312;156;0;8;304;312
8;Barcelona;13;Barcelonès;08019;Barcelona;6;151;U;;753;490;263;1;7;482;489
8;Barcelona;13;Barcelonès;08019;Barcelona;6;152;U;;668;409;259;2;3;404;407
8;Barcelona;13;Barcelonès;08019;Barcelona;6;153;U;;808;469;339;2;9;458;467
8;Barcelona;13;Barcelonès;08019;Barcelona;6;154;U;;517;288;229;2;2;284;286
8;Barcelona;13;Barcelonès;08019;Barcelona;6;155;A;;699;418;281;0;11;407;418
8;Barcelona;13;Barcelonès;08019;Barcelona;6;155;B;;806;439;367;0;16;423;439
8;Barcelona;13;Barcelonès;08019;Barcelona;6;157;A;;652;421;231;0;12;409;421
8;Barcelona;13;Barcelonès;08019;Barcelona;6;157;B;;529;310;219;2;8;300;308
8;Barcelona;13;Barcelonès;08019;Barcelona;6;157;C;;660;407;253;5;10;392;402
8;Barcelona;13;Barcelonès;08019;Barcelona;6;158;U;;607;350;257;0;6;344;350
8;Barcelona;13;Barcelonès;08019;Barcelona;6;159;U;;448;263;185;0;10;253;263
8;Barcelona;13;Barcelonès;08019;Barcelona;6;16;U;;779;429;350;1;4;424;428
8;Barcelona;13;Barcelonès;08019;Barcelona;6;17;U;;624;361;263;1;5;355;360
8;Barcelona;13;Barcelonès;08019;Barcelona;6;18;U;;830;471;359;2;7;462;469
8;Barcelona;13;Barcelonès;08019;Barcelona;6;19;U;;640;387;253;1;3;383;386
8;Barcelona;13;Barcelonès;08019;Barcelona;6;2;U;;525;323;202;0;3;320;323
8;Barcelona;13;Barcelonès;08019;Barcelona;6;20;U;;815;471;344;0;4;467;471
8;Barcelona;13;Barcelonès;08019;Barcelona;6;21;U;;692;393;299;0;3;390;393
8;Barcelona;13;Barcelonès;08019;Barcelona;6;22;U;;464;262;202;0;1;261;262
8;Barcelona;13;Barcelonès;08019;Barcelona;6;23;A;;481;302;179;1;2;299;301
8;Barcelona;13;Barcelonès;08019;Barcelona;6;23;B;;554;349;205;1;2;346;348
8;Barcelona;13;Barcelonès;08019;Barcelona;6;25;U;;673;406;267;1;2;403;405
8;Barcelona;13;Barcelonès;08019;Barcelona;6;26;U;;514;322;192;0;5;317;322
8;Barcelona;13;Barcelonès;08019;Barcelona;6;27;U;;740;489;251;2;1;486;487
8;Barcelona;13;Barcelonès;08019;Barcelona;6;28;U;;689;425;264;1;12;412;424
8;Barcelona;13;Barcelonès;08019;Barcelona;6;29;U;;979;596;383;1;4;591;595
8;Barcelona;13;Barcelonès;08019;Barcelona;6;3;U;;432;285;147;2;10;273;283
8;Barcelona;13;Barcelonès;08019;Barcelona;6;30;U;;792;482;310;4;3;475;478
8;Barcelona;13;Barcelonès;08019;Barcelona;6;31;U;;891;532;359;1;1;530;531
8;Barcelona;13;Barcelonès;08019;Barcelona;6;32;U;;859;508;351;0;5;503;508
8;Barcelona;13;Barcelonès;08019;Barcelona;6;33;U;;705;415;290;2;4;409;413
8;Barcelona;13;Barcelonès;08019;Barcelona;6;34;U;;894;589;305;3;3;583;586
8;Barcelona;13;Barcelonès;08019;Barcelona;6;35;A;;459;271;188;1;3;267;270
8;Barcelona;13;Barcelonès;08019;Barcelona;6;35;B;;551;329;222;2;6;321;327
8;Barcelona;13;Barcelonès;08019;Barcelona;6;36;U;;618;443;175;0;11;432;443
8;Barcelona;13;Barcelonès;08019;Barcelona;6;37;U;;664;420;244;1;8;411;419
8;Barcelona;13;Barcelonès;08019;Barcelona;6;38;U;;724;448;276;1;8;439;447
8;Barcelona;13;Barcelonès;08019;Barcelona;6;39;U;;596;375;221;1;5;369;374
8;Barcelona;13;Barcelonès;08019;Barcelona;6;4;U;;592;337;255;2;4;331;335
8;Barcelona;13;Barcelonès;08019;Barcelona;6;40;U;;875;547;328;2;8;537;545
8;Barcelona;13;Barcelonès;08019;Barcelona;6;41;A;;593;396;197;1;7;388;395
8;Barcelona;13;Barcelonès;08019;Barcelona;6;41;B;;704;425;279;0;7;418;425
8;Barcelona;13;Barcelonès;08019;Barcelona;6;42;U;;989;612;377;0;10;602;612
8;Barcelona;13;Barcelonès;08019;Barcelona;6;43;U;;916;591;325;3;12;576;588
8;Barcelona;13;Barcelonès;08019;Barcelona;6;44;U;;561;328;233;2;1;325;326
8;Barcelona;13;Barcelonès;08019;Barcelona;6;45;U;;769;420;349;0;5;415;420
8;Barcelona;13;Barcelonès;08019;Barcelona;6;47;U;;596;327;269;4;3;320;323
8;Barcelona;13;Barcelonès;08019;Barcelona;6;48;U;;718;379;339;0;5;374;379
8;Barcelona;13;Barcelonès;08019;Barcelona;6;49;U;;590;331;259;1;1;329;330
8;Barcelona;13;Barcelonès;08019;Barcelona;6;5;U;;538;355;183;0;7;348;355
8;Barcelona;13;Barcelonès;08019;Barcelona;6;50;U;;872;535;337;1;7;527;534
8;Barcelona;13;Barcelonès;08019;Barcelona;6;51;U;;463;279;184;0;6;273;279
8;Barcelona;13;Barcelonès;08019;Barcelona;6;52;U;;565;329;236;0;10;319;329
8;Barcelona;13;Barcelonès;08019;Barcelona;6;53;U;;492;267;225;0;1;266;267
8;Barcelona;13;Barcelonès;08019;Barcelona;6;54;U;;656;404;252;2;4;398;402
8;Barcelona;13;Barcelonès;08019;Barcelona;6;55;U;;744;417;327;0;4;413;417
8;Barcelona;13;Barcelonès;08019;Barcelona;6;56;U;;896;505;391;0;5;500;505
8;Barcelona;13;Barcelonès;08019;Barcelona;6;57;U;;671;451;220;0;8;443;451
8;Barcelona;13;Barcelonès;08019;Barcelona;6;58;U;;671;467;204;0;4;463;467
8;Barcelona;13;Barcelonès;08019;Barcelona;6;59;A;;479;300;179;0;0;300;300
8;Barcelona;13;Barcelonès;08019;Barcelona;6;59;B;;558;356;202;0;7;349;356
8;Barcelona;13;Barcelonès;08019;Barcelona;6;6;U;;511;318;193;0;0;318;318
8;Barcelona;13;Barcelonès;08019;Barcelona;6;60;U;;606;416;190;1;12;403;415
8;Barcelona;13;Barcelonès;08019;Barcelona;6;61;U;;595;367;228;4;4;359;363
8;Barcelona;13;Barcelonès;08019;Barcelona;6;62;U;;509;301;208;0;2;299;301
8;Barcelona;13;Barcelonès;08019;Barcelona;6;63;U;;537;327;210;2;3;322;325
8;Barcelona;13;Barcelonès;08019;Barcelona;6;64;U;;424;259;165;0;1;258;259
8;Barcelona;13;Barcelonès;08019;Barcelona;6;65;U;;402;205;197;0;0;205;205
8;Barcelona;13;Barcelonès;08019;Barcelona;6;66;U;;603;311;292;0;1;310;311
8;Barcelona;13;Barcelonès;08019;Barcelona;6;68;U;;865;461;404;1;5;455;460
8;Barcelona;13;Barcelonès;08019;Barcelona;6;69;U;;454;285;169;0;3;282;285
8;Barcelona;13;Barcelonès;08019;Barcelona;6;7;U;;638;363;275;2;2;359;361
8;Barcelona;13;Barcelonès;08019;Barcelona;6;70;U;;800;480;320;3;8;469;477
8;Barcelona;13;Barcelonès;08019;Barcelona;6;71;U;;484;282;202;1;7;274;281
8;Barcelona;13;Barcelonès;08019;Barcelona;6;72;U;;474;313;161;0;3;310;313
8;Barcelona;13;Barcelonès;08019;Barcelona;6;73;U;;476;298;178;0;5;293;298
8;Barcelona;13;Barcelonès;08019;Barcelona;6;74;U;;555;354;201;0;7;347;354
8;Barcelona;13;Barcelonès;08019;Barcelona;6;75;U;;462;282;180;0;3;279;282
8;Barcelona;13;Barcelonès;08019;Barcelona;6;76;U;;650;380;270;0;1;379;380
8;Barcelona;13;Barcelonès;08019;Barcelona;6;77;U;;599;345;254;0;4;341;345
8;Barcelona;13;Barcelonès;08019;Barcelona;6;78;U;;411;236;175;0;4;232;236
8;Barcelona;13;Barcelonès;08019;Barcelona;6;79;U;;532;298;234;0;6;292;298
8;Barcelona;13;Barcelonès;08019;Barcelona;6;8;U;;694;422;272;2;9;411;420
8;Barcelona;13;Barcelonès;08019;Barcelona;6;80;U;;492;285;207;1;4;280;284
8;Barcelona;13;Barcelonès;08019;Barcelona;6;81;U;;658;413;245;3;7;403;410
8;Barcelona;13;Barcelonès;08019;Barcelona;6;82;U;;458;268;190;0;4;264;268
8;Barcelona;13;Barcelonès;08019;Barcelona;6;83;U;;513;296;217;2;2;292;294
8;Barcelona;13;Barcelonès;08019;Barcelona;6;84;U;;707;438;269;0;4;434;438
8;Barcelona;13;Barcelonès;08019;Barcelona;6;85;U;;748;482;266;3;5;474;479
8;Barcelona;13;Barcelonès;08019;Barcelona;6;86;U;;534;354;180;0;3;351;354
8;Barcelona;13;Barcelonès;08019;Barcelona;6;87;U;;529;328;201;0;8;320;328
8;Barcelona;13;Barcelonès;08019;Barcelona;6;88;U;;507;332;175;1;4;327;331
8;Barcelona;13;Barcelonès;08019;Barcelona;6;89;U;;955;653;302;2;5;646;651
8;Barcelona;13;Barcelonès;08019;Barcelona;6;9;U;;452;260;192;0;5;255;260
8;Barcelona;13;Barcelonès;08019;Barcelona;6;90;U;;653;420;233;1;8;411;419
8;Barcelona;13;Barcelonès;08019;Barcelona;6;91;U;;543;323;220;0;6;317;323
8;Barcelona;13;Barcelonès;08019;Barcelona;6;92;U;;591;403;188;1;7;395;402
8;Barcelona;13;Barcelonès;08019;Barcelona;6;93;U;;716;410;306;1;7;402;409
8;Barcelona;13;Barcelonès;08019;Barcelona;6;94;U;;841;502;339;0;3;499;502
8;Barcelona;13;Barcelonès;08019;Barcelona;6;95;U;;635;398;237;0;6;392;398
8;Barcelona;13;Barcelonès;08019;Barcelona;6;96;U;;610;352;258;0;2;350;352
8;Barcelona;13;Barcelonès;08019;Barcelona;6;97;A;;491;299;192;0;4;295;299
8;Barcelona;13;Barcelonès;08019;Barcelona;6;97;B;;578;376;202;0;6;370;376
8;Barcelona;13;Barcelonès;08019;Barcelona;6;98;U;;393;263;130;1;7;255;262
8;Barcelona;13;Barcelonès;08019;Barcelona;6;99;U;;529;308;221;0;4;304;308
8;Barcelona;13;Barcelonès;08019;Barcelona;7;1;A;;563;364;199;0;1;363;364
8;Barcelona;13;Barcelonès;08019;Barcelona;7;1;B;;589;377;212;1;8;368;376
8;Barcelona;13;Barcelonès;08019;Barcelona;7;10;U;;876;505;371;5;9;491;500
8;Barcelona;13;Barcelonès;08019;Barcelona;7;100;U;;839;411;428;0;5;406;411
8;Barcelona;13;Barcelonès;08019;Barcelona;7;101;U;;639;371;268;1;7;363;370
8;Barcelona;13;Barcelonès;08019;Barcelona;7;102;U;;546;301;245;0;5;296;301
8;Barcelona;13;Barcelonès;08019;Barcelona;7;103;U;;561;345;216;1;3;341;344
8;Barcelona;13;Barcelonès;08019;Barcelona;7;104;A;;538;303;235;0;4;299;303
8;Barcelona;13;Barcelonès;08019;Barcelona;7;104;B;;577;309;268;2;6;301;307
8;Barcelona;13;Barcelonès;08019;Barcelona;7;105;U;;626;394;232;1;9;384;393
8;Barcelona;13;Barcelonès;08019;Barcelona;7;106;U;;728;469;259;0;9;460;469
8;Barcelona;13;Barcelonès;08019;Barcelona;7;107;U;;526;334;192;1;4;329;333
8;Barcelona;13;Barcelonès;08019;Barcelona;7;108;U;;636;336;300;0;9;327;336
8;Barcelona;13;Barcelonès;08019;Barcelona;7;109;U;;656;348;308;0;10;338;348
8;Barcelona;13;Barcelonès;08019;Barcelona;7;11;U;;669;397;272;1;2;394;396
8;Barcelona;13;Barcelonès;08019;Barcelona;7;110;U;;425;200;225;0;2;198;200
8;Barcelona;13;Barcelonès;08019;Barcelona;7;111;U;;415;171;244;0;4;167;171
8;Barcelona;13;Barcelonès;08019;Barcelona;7;112;U;;645;272;373;0;3;269;272
8;Barcelona;13;Barcelonès;08019;Barcelona;7;113;U;;750;305;445;0;5;300;305
8;Barcelona;13;Barcelonès;08019;Barcelona;7;114;U;;793;303;490;3;6;294;300
8;Barcelona;13;Barcelonès;08019;Barcelona;7;115;U;;424;201;223;0;9;192;201
8;Barcelona;13;Barcelonès;08019;Barcelona;7;116;A;;465;211;254;2;4;205;209
8;Barcelona;13;Barcelonès;08019;Barcelona;7;116;B;;508;232;276;0;2;230;232
8;Barcelona;13;Barcelonès;08019;Barcelona;7;117;U;;878;403;475;0;2;401;403
8;Barcelona;13;Barcelonès;08019;Barcelona;7;118;A;;531;209;322;1;1;207;208
8;Barcelona;13;Barcelonès;08019;Barcelona;7;118;B;;640;250;390;0;8;242;250
8;Barcelona;13;Barcelonès;08019;Barcelona;7;119;U;;979;421;558;0;3;418;421
8;Barcelona;13;Barcelonès;08019;Barcelona;7;12;U;;797;446;351;2;4;440;444
8;Barcelona;13;Barcelonès;08019;Barcelona;7;120;U;;700;316;384;0;2;314;316
8;Barcelona;13;Barcelonès;08019;Barcelona;7;121;U;;561;246;315;0;2;244;246
8;Barcelona;13;Barcelonès;08019;Barcelona;7;122;A;;432;171;261;0;3;168;171
8;Barcelona;13;Barcelonès;08019;Barcelona;7;122;B;;617;291;326;0;1;290;291
8;Barcelona;13;Barcelonès;08019;Barcelona;7;123;U;;432;212;220;0;3;209;212
8;Barcelona;13;Barcelonès;08019;Barcelona;7;124;U;;833;366;467;0;5;361;366
8;Barcelona;13;Barcelonès;08019;Barcelona;7;125;A;;473;207;266;0;5;202;207
8;Barcelona;13;Barcelonès;08019;Barcelona;7;125;B;;585;300;285;0;5;295;300
8;Barcelona;13;Barcelonès;08019;Barcelona;7;126;A;;482;210;272;1;2;207;209
8;Barcelona;13;Barcelonès;08019;Barcelona;7;126;B;;615;284;331;0;5;279;284
8;Barcelona;13;Barcelonès;08019;Barcelona;7;127;U;;737;297;440;4;4;289;293
8;Barcelona;13;Barcelonès;08019;Barcelona;7;128;U;;778;337;441;1;4;332;336
8;Barcelona;13;Barcelonès;08019;Barcelona;7;129;U;;672;332;340;0;0;332;332
8;Barcelona;13;Barcelonès;08019;Barcelona;7;13;U;;851;461;390;1;10;450;460
8;Barcelona;13;Barcelonès;08019;Barcelona;7;130;U;;482;189;293;2;6;181;187
8;Barcelona;13;Barcelonès;08019;Barcelona;7;131;U;;902;352;550;1;8;343;351
8;Barcelona;13;Barcelonès;08019;Barcelona;7;132;U;;606;266;340;6;0;260;260
8;Barcelona;13;Barcelonès;08019;Barcelona;7;133;U;;980;424;556;1;6;417;423
8;Barcelona;13;Barcelonès;08019;Barcelona;7;134;U;;874;394;480;2;8;384;392
8;Barcelona;13;Barcelonès;08019;Barcelona;7;135;U;;493;253;240;0;2;251;253
8;Barcelona;13;Barcelonès;08019;Barcelona;7;136;U;;592;281;311;0;3;278;281
8;Barcelona;13;Barcelonès;08019;Barcelona;7;137;U;;520;244;276;0;2;242;244
8;Barcelona;13;Barcelonès;08019;Barcelona;7;138;U;;764;391;373;0;9;382;391
8;Barcelona;13;Barcelonès;08019;Barcelona;7;139;A;;501;258;243;0;2;256;258
8;Barcelona;13;Barcelonès;08019;Barcelona;7;139;B;;618;273;345;0;8;265;273
8;Barcelona;13;Barcelonès;08019;Barcelona;7;14;U;;586;315;271;1;0;314;314
8;Barcelona;13;Barcelonès;08019;Barcelona;7;140;U;;598;324;274;0;3;321;324
8;Barcelona;13;Barcelonès;08019;Barcelona;7;141;U;;666;321;345;1;7;313;320
8;Barcelona;13;Barcelonès;08019;Barcelona;7;142;U;;465;215;250;0;1;214;215
8;Barcelona;13;Barcelonès;08019;Barcelona;7;143;U;;697;315;382;2;6;307;313
8;Barcelona;13;Barcelonès;08019;Barcelona;7;144;U;;526;246;280;0;2;244;246
8;Barcelona;13;Barcelonès;08019;Barcelona;7;145;U;;682;321;361;1;7;313;320
8;Barcelona;13;Barcelonès;08019;Barcelona;7;146;U;;485;222;263;1;2;219;221
8;Barcelona;13;Barcelonès;08019;Barcelona;7;147;U;;841;449;392;1;7;441;448
8;Barcelona;13;Barcelonès;08019;Barcelona;7;148;U;;696;315;381;1;4;310;314
8;Barcelona;13;Barcelonès;08019;Barcelona;7;149;U;;509;224;285;0;3;221;224
8;Barcelona;13;Barcelonès;08019;Barcelona;7;15;U;;517;282;235;1;7;274;281
8;Barcelona;13;Barcelonès;08019;Barcelona;7;150;U;;503;282;221;0;6;276;282
8;Barcelona;13;Barcelonès;08019;Barcelona;7;151;U;;667;347;320;0;4;343;347
8;Barcelona;13;Barcelonès;08019;Barcelona;7;152;U;;614;312;302;0;8;304;312
8;Barcelona;13;Barcelonès;08019;Barcelona;7;153;U;;412;249;163;0;4;245;249
8;Barcelona;13;Barcelonès;08019;Barcelona;7;154;U;;571;304;267;0;6;298;304
8;Barcelona;13;Barcelonès;08019;Barcelona;7;155;U;;447;261;186;0;2;259;261
8;Barcelona;13;Barcelonès;08019;Barcelona;7;156;U;;500;239;261;1;1;237;238
8;Barcelona;13;Barcelonès;08019;Barcelona;7;157;U;;692;378;314;2;4;372;376
8;Barcelona;13;Barcelonès;08019;Barcelona;7;158;U;;681;345;336;0;5;340;345
8;Barcelona;13;Barcelonès;08019;Barcelona;7;159;U;;748;366;382;1;12;353;365
8;Barcelona;13;Barcelonès;08019;Barcelona;7;16;A;;478;243;235;1;4;238;242
8;Barcelona;13;Barcelonès;08019;Barcelona;7;16;B;;533;295;238;2;2;291;293
8;Barcelona;13;Barcelonès;08019;Barcelona;7;160;U;;573;332;241;0;7;325;332
8;Barcelona;13;Barcelonès;08019;Barcelona;7;161;U;;544;330;214;4;0;326;326
8;Barcelona;13;Barcelonès;08019;Barcelona;7;162;U;;781;461;320;0;5;456;461
8;Barcelona;13;Barcelonès;08019;Barcelona;7;163;U;;643;359;284;1;3;355;358
8;Barcelona;13;Barcelonès;08019;Barcelona;7;164;U;;479;262;217;1;6;255;261
8;Barcelona;13;Barcelonès;08019;Barcelona;7;165;U;;639;336;303;1;7;328;335
8;Barcelona;13;Barcelonès;08019;Barcelona;7;166;A;;506;291;215;0;4;287;291
8;Barcelona;13;Barcelonès;08019;Barcelona;7;166;B;;588;334;254;2;7;325;332
8;Barcelona;13;Barcelonès;08019;Barcelona;7;167;U;;767;433;334;0;11;422;433
8;Barcelona;13;Barcelonès;08019;Barcelona;7;169;U;;834;489;345;3;5;481;486
8;Barcelona;13;Barcelonès;08019;Barcelona;7;17;U;;508;264;244;0;4;260;264
8;Barcelona;13;Barcelonès;08019;Barcelona;7;170;A;;498;263;235;0;1;262;263
8;Barcelona;13;Barcelonès;08019;Barcelona;7;170;B;;521;262;259;0;3;259;262
8;Barcelona;13;Barcelonès;08019;Barcelona;7;172;U;;594;298;296;4;4;290;294
8;Barcelona;13;Barcelonès;08019;Barcelona;7;173;U;;384;210;174;0;1;209;210
8;Barcelona;13;Barcelonès;08019;Barcelona;7;174;U;;831;482;349;1;12;469;481
8;Barcelona;13;Barcelonès;08019;Barcelona;7;175;U;;689;325;364;0;4;321;325
8;Barcelona;13;Barcelonès;08019;Barcelona;7;176;U;;520;373;147;1;5;367;372
8;Barcelona;13;Barcelonès;08019;Barcelona;7;177;U;;751;387;364;0;0;387;387
8;Barcelona;13;Barcelonès;08019;Barcelona;7;178;U;;460;216;244;2;1;213;214
8;Barcelona;13;Barcelonès;08019;Barcelona;7;179;U;;643;360;283;2;3;355;358
8;Barcelona;13;Barcelonès;08019;Barcelona;7;18;U;;586;338;248;0;4;334;338
8;Barcelona;13;Barcelonès;08019;Barcelona;7;180;U;;658;339;319;2;7;330;337
8;Barcelona;13;Barcelonès;08019;Barcelona;7;181;U;;486;242;244;0;4;238;242
8;Barcelona;13;Barcelonès;08019;Barcelona;7;182;U;;433;228;205;1;4;223;227
8;Barcelona;13;Barcelonès;08019;Barcelona;7;183;U;;728;324;404;4;2;318;320
8;Barcelona;13;Barcelonès;08019;Barcelona;7;184;A;;511;262;249;3;0;259;259
8;Barcelona;13;Barcelonès;08019;Barcelona;7;184;B;;527;273;254;3;3;267;270
8;Barcelona;13;Barcelonès;08019;Barcelona;7;185;U;;940;510;430;2;5;503;508
8;Barcelona;13;Barcelonès;08019;Barcelona;7;187;U;;466;217;249;0;0;217;217
8;Barcelona;13;Barcelonès;08019;Barcelona;7;188;U;;824;390;434;7;0;383;383
8;Barcelona;13;Barcelonès;08019;Barcelona;7;189;U;;798;364;434;1;3;360;363
8;Barcelona;13;Barcelonès;08019;Barcelona;7;19;U;;717;432;285;1;2;429;431
8;Barcelona;13;Barcelonès;08019;Barcelona;7;190;A;;596;314;282;1;2;311;313
8;Barcelona;13;Barcelonès;08019;Barcelona;7;190;B;;699;370;329;1;9;360;369
8;Barcelona;13;Barcelonès;08019;Barcelona;7;191;U;;892;441;451;1;3;437;440
8;Barcelona;13;Barcelonès;08019;Barcelona;7;192;A;;497;251;246;0;2;249;251
8;Barcelona;13;Barcelonès;08019;Barcelona;7;192;B;;577;300;277;2;4;294;298
8;Barcelona;13;Barcelonès;08019;Barcelona;7;193;U;;609;279;330;0;6;273;279
8;Barcelona;13;Barcelonès;08019;Barcelona;7;194;U;;550;359;191;0;11;348;359
8;Barcelona;13;Barcelonès;08019;Barcelona;7;195;U;;935;465;470;0;15;450;465
8;Barcelona;13;Barcelonès;08019;Barcelona;7;196;A;;506;285;221;0;1;284;285
8;Barcelona;13;Barcelonès;08019;Barcelona;7;196;B;;511;283;228;4;4;275;279
8;Barcelona;13;Barcelonès;08019;Barcelona;7;197;U;;929;521;408;1;5;515;520
8;Barcelona;13;Barcelonès;08019;Barcelona;7;198;U;;500;266;234;0;2;264;266
8;Barcelona;13;Barcelonès;08019;Barcelona;7;199;U;;442;297;145;1;7;289;296
8;Barcelona;13;Barcelonès;08019;Barcelona;7;2;U;;679;400;279;0;8;392;400
8;Barcelona;13;Barcelonès;08019;Barcelona;7;20;U;;730;398;332;1;4;393;397
8;Barcelona;13;Barcelonès;08019;Barcelona;7;200;U;;814;429;385;0;4;425;429
8;Barcelona;13;Barcelonès;08019;Barcelona;7;201;U;;879;456;423;0;8;448;456
8;Barcelona;13;Barcelonès;08019;Barcelona;7;202;U;;857;507;350;1;11;495;506
8;Barcelona;13;Barcelonès;08019;Barcelona;7;203;U;;407;182;225;0;1;181;182
8;Barcelona;13;Barcelonès;08019;Barcelona;7;204;U;;440;261;179;3;2;256;258
8;Barcelona;13;Barcelonès;08019;Barcelona;7;205;A;;596;309;287;0;6;303;309
8;Barcelona;13;Barcelonès;08019;Barcelona;7;205;B;;663;346;317;0;0;346;346
8;Barcelona;13;Barcelonès;08019;Barcelona;7;206;U;;777;402;375;3;9;390;399
8;Barcelona;13;Barcelonès;08019;Barcelona;7;207;A;;557;314;243;0;5;309;314
8;Barcelona;13;Barcelonès;08019;Barcelona;7;207;B;;476;239;237;0;4;235;239
8;Barcelona;13;Barcelonès;08019;Barcelona;7;207;C;;568;308;260;0;10;298;308
8;Barcelona;13;Barcelonès;08019;Barcelona;7;209;U;;560;219;341;1;2;216;218
8;Barcelona;13;Barcelonès;08019;Barcelona;7;210;A;;472;201;271;0;2;199;201
8;Barcelona;13;Barcelonès;08019;Barcelona;7;210;B;;503;254;249;1;3;250;253
8;Barcelona;13;Barcelonès;08019;Barcelona;7;211;A;;515;205;310;0;4;201;205
8;Barcelona;13;Barcelonès;08019;Barcelona;7;211;B;;572;218;354;0;9;209;218
8;Barcelona;13;Barcelonès;08019;Barcelona;7;212;U;;444;171;273;1;1;169;170
8;Barcelona;13;Barcelonès;08019;Barcelona;7;213;U;;798;369;429;1;3;365;368
8;Barcelona;13;Barcelonès;08019;Barcelona;7;214;U;;620;267;353;0;5;262;267
8;Barcelona;13;Barcelonès;08019;Barcelona;7;215;U;;609;246;363;2;8;236;244
8;Barcelona;13;Barcelonès;08019;Barcelona;7;216;U;;464;179;285;0;2;177;179
8;Barcelona;13;Barcelonès;08019;Barcelona;7;217;U;;512;251;261;0;4;247;251
8;Barcelona;13;Barcelonès;08019;Barcelona;7;218;U;;789;380;409;15;6;359;365
8;Barcelona;13;Barcelonès;08019;Barcelona;7;219;U;;805;403;402;2;3;398;401
8;Barcelona;13;Barcelonès;08019;Barcelona;7;22;U;;560;327;233;0;5;322;327
8;Barcelona;13;Barcelonès;08019;Barcelona;7;220;U;;781;395;386;3;6;386;392
8;Barcelona;13;Barcelonès;08019;Barcelona;7;221;U;;707;358;349;1;9;348;357
8;Barcelona;13;Barcelonès;08019;Barcelona;7;222;U;;446;213;233;0;3;210;213
8;Barcelona;13;Barcelonès;08019;Barcelona;7;23;U;;655;363;292;1;4;358;362
8;Barcelona;13;Barcelonès;08019;Barcelona;7;24;U;;530;304;226;0;5;299;304
8;Barcelona;13;Barcelonès;08019;Barcelona;7;25;U;;396;238;158;0;1;237;238
8;Barcelona;13;Barcelonès;08019;Barcelona;7;26;U;;609;357;252;0;1;356;357
8;Barcelona;13;Barcelonès;08019;Barcelona;7;27;U;;535;306;229;0;8;298;306
8;Barcelona;13;Barcelonès;08019;Barcelona;7;28;U;;572;329;243;1;2;326;328
8;Barcelona;13;Barcelonès;08019;Barcelona;7;29;U;;845;452;393;0;8;444;452
8;Barcelona;13;Barcelonès;08019;Barcelona;7;3;U;;683;383;300;0;7;376;383
8;Barcelona;13;Barcelonès;08019;Barcelona;7;31;U;;812;440;372;1;8;431;439
8;Barcelona;13;Barcelonès;08019;Barcelona;7;32;U;;520;302;218;0;2;300;302
8;Barcelona;13;Barcelonès;08019;Barcelona;7;33;U;;581;354;227;0;4;350;354
8;Barcelona;13;Barcelonès;08019;Barcelona;7;34;A;;529;265;264;1;5;259;264
8;Barcelona;13;Barcelonès;08019;Barcelona;7;34;B;;529;284;245;2;6;276;282
8;Barcelona;13;Barcelonès;08019;Barcelona;7;36;U;;517;311;206;3;4;304;308
8;Barcelona;13;Barcelonès;08019;Barcelona;7;37;U;;549;299;250;0;4;295;299
8;Barcelona;13;Barcelonès;08019;Barcelona;7;38;U;;739;403;336;0;8;395;403
8;Barcelona;13;Barcelonès;08019;Barcelona;7;39;U;;627;356;271;3;5;348;353
8;Barcelona;13;Barcelonès;08019;Barcelona;7;4;U;;483;271;212;0;10;261;271
8;Barcelona;13;Barcelonès;08019;Barcelona;7;40;U;;604;366;238;2;5;359;364
8;Barcelona;13;Barcelonès;08019;Barcelona;7;41;U;;546;321;225;0;8;313;321
8;Barcelona;13;Barcelonès;08019;Barcelona;7;42;U;;569;346;223;0;3;343;346
8;Barcelona;13;Barcelonès;08019;Barcelona;7;43;U;;844;504;340;1;6;497;503
8;Barcelona;13;Barcelonès;08019;Barcelona;7;44;U;;711;438;273;2;5;431;436
8;Barcelona;13;Barcelonès;08019;Barcelona;7;45;U;;877;549;328;2;4;543;547
8;Barcelona;13;Barcelonès;08019;Barcelona;7;47;U;;852;490;362;1;0;489;489
8;Barcelona;13;Barcelonès;08019;Barcelona;7;48;U;;530;293;237;0;1;292;293
8;Barcelona;13;Barcelonès;08019;Barcelona;7;49;U;;492;293;199;0;6;287;293
8;Barcelona;13;Barcelonès;08019;Barcelona;7;5;U;;462;253;209;0;8;245;253
8;Barcelona;13;Barcelonès;08019;Barcelona;7;50;U;;747;375;372;1;8;366;374
8;Barcelona;13;Barcelonès;08019;Barcelona;7;51;U;;902;524;378;0;4;520;524
8;Barcelona;13;Barcelonès;08019;Barcelona;7;52;U;;614;321;293;0;7;314;321
8;Barcelona;13;Barcelonès;08019;Barcelona;7;53;U;;594;318;276;2;4;312;316
8;Barcelona;13;Barcelonès;08019;Barcelona;7;54;U;;570;280;290;0;4;276;280
8;Barcelona;13;Barcelonès;08019;Barcelona;7;55;U;;950;524;426;3;5;516;521
8;Barcelona;13;Barcelonès;08019;Barcelona;7;56;U;;624;352;272;1;5;346;351
8;Barcelona;13;Barcelonès;08019;Barcelona;7;57;A;;586;314;272;1;3;310;313
8;Barcelona;13;Barcelonès;08019;Barcelona;7;57;B;;597;339;258;0;4;335;339
8;Barcelona;13;Barcelonès;08019;Barcelona;7;58;U;;727;386;341;0;3;383;386
8;Barcelona;13;Barcelonès;08019;Barcelona;7;6;U;;565;226;339;0;1;225;226
8;Barcelona;13;Barcelonès;08019;Barcelona;7;60;U;;810;388;422;1;2;385;387
8;Barcelona;13;Barcelonès;08019;Barcelona;7;61;U;;547;330;217;0;5;325;330
8;Barcelona;13;Barcelonès;08019;Barcelona;7;62;U;;544;300;244;0;1;299;300
8;Barcelona;13;Barcelonès;08019;Barcelona;7;63;U;;426;244;182;4;5;235;240
8;Barcelona;13;Barcelonès;08019;Barcelona;7;64;U;;622;386;236;2;1;383;384
8;Barcelona;13;Barcelonès;08019;Barcelona;7;65;U;;930;501;429;1;13;487;500
8;Barcelona;13;Barcelonès;08019;Barcelona;7;66;U;;613;333;280;0;4;329;333
8;Barcelona;13;Barcelonès;08019;Barcelona;7;67;U;;629;324;305;0;7;317;324
8;Barcelona;13;Barcelonès;08019;Barcelona;7;68;U;;608;353;255;1;4;348;352
8;Barcelona;13;Barcelonès;08019;Barcelona;7;69;U;;456;267;189;0;7;260;267
8;Barcelona;13;Barcelonès;08019;Barcelona;7;7;U;;586;378;208;0;7;371;378
8;Barcelona;13;Barcelonès;08019;Barcelona;7;70;U;;453;244;209;0;3;241;244
8;Barcelona;13;Barcelonès;08019;Barcelona;7;71;U;;642;341;301;0;7;334;341
8;Barcelona;13;Barcelonès;08019;Barcelona;7;72;A;;639;382;257;1;6;375;381
8;Barcelona;13;Barcelonès;08019;Barcelona;7;72;B;;604;357;247;1;11;345;356
8;Barcelona;13;Barcelonès;08019;Barcelona;7;72;C;;614;353;261;2;11;340;351
8;Barcelona;13;Barcelonès;08019;Barcelona;7;73;U;;502;282;220;1;4;277;281
8;Barcelona;13;Barcelonès;08019;Barcelona;7;74;U;;779;388;391;3;6;379;385
8;Barcelona;13;Barcelonès;08019;Barcelona;7;75;U;;956;519;437;1;5;513;518
8;Barcelona;13;Barcelonès;08019;Barcelona;7;76;U;;772;449;323;2;18;429;447
8;Barcelona;13;Barcelonès;08019;Barcelona;7;77;U;;434;258;176;1;3;254;257
8;Barcelona;13;Barcelonès;08019;Barcelona;7;78;A;;584;331;253;0;7;324;331
8;Barcelona;13;Barcelonès;08019;Barcelona;7;78;B;;514;279;235;0;4;275;279
8;Barcelona;13;Barcelonès;08019;Barcelona;7;78;C;;590;322;268;2;6;314;320
8;Barcelona;13;Barcelonès;08019;Barcelona;7;79;A;;637;374;263;1;5;368;373
8;Barcelona;13;Barcelonès;08019;Barcelona;7;79;B;;729;427;302;2;10;415;425
8;Barcelona;13;Barcelonès;08019;Barcelona;7;8;A;;741;417;324;1;10;406;416
8;Barcelona;13;Barcelonès;08019;Barcelona;7;8;B;;721;452;269;0;9;443;452
8;Barcelona;13;Barcelonès;08019;Barcelona;7;80;U;;731;418;313;1;11;406;417
8;Barcelona;13;Barcelonès;08019;Barcelona;7;81;A;;470;270;200;0;4;266;270
8;Barcelona;13;Barcelonès;08019;Barcelona;7;81;B;;563;310;253;1;7;302;309
8;Barcelona;13;Barcelonès;08019;Barcelona;7;83;U;;618;302;316;0;5;297;302
8;Barcelona;13;Barcelonès;08019;Barcelona;7;84;U;;900;527;373;0;8;519;527
8;Barcelona;13;Barcelonès;08019;Barcelona;7;85;U;;934;556;378;2;7;547;554
8;Barcelona;13;Barcelonès;08019;Barcelona;7;86;U;;496;322;174;0;2;320;322
8;Barcelona;13;Barcelonès;08019;Barcelona;7;87;U;;415;243;172;1;7;235;242
8;Barcelona;13;Barcelonès;08019;Barcelona;7;88;A;;472;256;216;2;6;248;254
8;Barcelona;13;Barcelonès;08019;Barcelona;7;88;B;;537;289;248;1;7;281;288
8;Barcelona;13;Barcelonès;08019;Barcelona;7;89;U;;579;283;296;0;5;278;283
8;Barcelona;13;Barcelonès;08019;Barcelona;7;9;A;;550;310;240;2;2;306;308
8;Barcelona;13;Barcelonès;08019;Barcelona;7;9;B;;559;342;217;3;2;337;339
8;Barcelona;13;Barcelonès;08019;Barcelona;7;90;U;;461;226;235;2;6;218;224
8;Barcelona;13;Barcelonès;08019;Barcelona;7;91;U;;918;530;388;1;10;519;529
8;Barcelona;13;Barcelonès;08019;Barcelona;7;92;U;;668;307;361;0;6;301;307
8;Barcelona;13;Barcelonès;08019;Barcelona;7;93;A;;609;293;316;0;7;286;293
8;Barcelona;13;Barcelonès;08019;Barcelona;7;93;B;;531;238;293;0;3;235;238
8;Barcelona;13;Barcelonès;08019;Barcelona;7;93;C;;711;373;338;1;3;369;372
8;Barcelona;13;Barcelonès;08019;Barcelona;7;93;D;;554;270;284;1;3;266;269
8;Barcelona;13;Barcelonès;08019;Barcelona;7;94;U;;829;333;496;2;2;329;331
8;Barcelona;13;Barcelonès;08019;Barcelona;7;95;U;;499;238;261;1;2;235;237
8;Barcelona;13;Barcelonès;08019;Barcelona;7;96;U;;929;403;526;4;6;393;399
8;Barcelona;13;Barcelonès;08019;Barcelona;7;97;U;;776;346;430;8;2;336;338
8;Barcelona;13;Barcelonès;08019;Barcelona;7;98;U;;791;404;387;4;6;394;400
8;Barcelona;13;Barcelonès;08019;Barcelona;8;1;A;;587;308;279;1;5;302;307
8;Barcelona;13;Barcelonès;08019;Barcelona;8;1;B;;579;320;259;1;4;315;319
8;Barcelona;13;Barcelonès;08019;Barcelona;8;10;U;;929;427;502;1;6;420;426
8;Barcelona;13;Barcelonès;08019;Barcelona;8;100;U;;966;466;500;0;2;464;466
8;Barcelona;13;Barcelonès;08019;Barcelona;8;101;A;;505;267;238;1;4;262;266
8;Barcelona;13;Barcelonès;08019;Barcelona;8;101;B;;590;303;287;2;2;299;301
8;Barcelona;13;Barcelonès;08019;Barcelona;8;102;U;;725;348;377;0;2;346;348
8;Barcelona;13;Barcelonès;08019;Barcelona;8;103;U;;422;230;192;1;1;228;229
8;Barcelona;13;Barcelonès;08019;Barcelona;8;104;U;;426;196;230;0;0;196;196
8;Barcelona;13;Barcelonès;08019;Barcelona;8;105;U;;536;227;309;1;0;226;226
8;Barcelona;13;Barcelonès;08019;Barcelona;8;106;U;;571;298;273;1;2;295;297
8;Barcelona;13;Barcelonès;08019;Barcelona;8;107;U;;963;443;520;0;5;438;443
8;Barcelona;13;Barcelonès;08019;Barcelona;8;108;U;;443;206;237;1;1;204;205
8;Barcelona;13;Barcelonès;08019;Barcelona;8;109;U;;805;380;425;1;6;373;379
8;Barcelona;13;Barcelonès;08019;Barcelona;8;11;U;;836;456;380;1;5;450;455
8;Barcelona;13;Barcelonès;08019;Barcelona;8;110;U;;451;206;245;0;3;203;206
8;Barcelona;13;Barcelonès;08019;Barcelona;8;111;U;;680;292;388;5;3;284;287
8;Barcelona;13;Barcelonès;08019;Barcelona;8;112;U;;667;342;325;2;4;336;340
8;Barcelona;13;Barcelonès;08019;Barcelona;8;113;U;;910;436;474;0;8;428;436
8;Barcelona;13;Barcelonès;08019;Barcelona;8;114;A;;431;208;223;1;3;204;207
8;Barcelona;13;Barcelonès;08019;Barcelona;8;114;B;;560;290;270;1;5;284;289
8;Barcelona;13;Barcelonès;08019;Barcelona;8;115;U;;484;247;237;0;1;246;247
8;Barcelona;13;Barcelonès;08019;Barcelona;8;116;A;;583;273;310;0;7;266;273
8;Barcelona;13;Barcelonès;08019;Barcelona;8;116;B;;600;290;310;0;2;288;290
8;Barcelona;13;Barcelonès;08019;Barcelona;8;117;U;;706;355;351;0;3;352;355
8;Barcelona;13;Barcelonès;08019;Barcelona;8;118;U;;509;257;252;0;3;254;257
8;Barcelona;13;Barcelonès;08019;Barcelona;8;119;U;;493;240;253;0;4;236;240
8;Barcelona;13;Barcelonès;08019;Barcelona;8;12;U;;683;345;338;0;0;345;345
8;Barcelona;13;Barcelonès;08019;Barcelona;8;120;U;;470;238;232;2;3;233;236
8;Barcelona;13;Barcelonès;08019;Barcelona;8;121;U;;684;272;412;2;5;265;270
8;Barcelona;13;Barcelonès;08019;Barcelona;8;122;A;;463;230;233;1;2;227;229
8;Barcelona;13;Barcelonès;08019;Barcelona;8;122;B;;634;325;309;1;4;320;324
8;Barcelona;13;Barcelonès;08019;Barcelona;8;123;U;;558;290;268;1;6;283;289
8;Barcelona;13;Barcelonès;08019;Barcelona;8;124;U;;457;226;231;1;1;224;225
8;Barcelona;13;Barcelonès;08019;Barcelona;8;125;U;;474;221;253;8;3;210;213
8;Barcelona;13;Barcelonès;08019;Barcelona;8;126;U;;634;247;387;1;0;246;246
8;Barcelona;13;Barcelonès;08019;Barcelona;8;127;U;;820;417;403;1;7;409;416
8;Barcelona;13;Barcelonès;08019;Barcelona;8;128;U;;528;265;263;1;4;260;264
8;Barcelona;13;Barcelonès;08019;Barcelona;8;129;U;;600;246;354;0;3;243;246
8;Barcelona;13;Barcelonès;08019;Barcelona;8;13;U;;944;513;431;0;5;508;513
8;Barcelona;13;Barcelonès;08019;Barcelona;8;130;U;;487;225;262;0;7;218;225
8;Barcelona;13;Barcelonès;08019;Barcelona;8;131;U;;585;282;303;3;5;274;279
8;Barcelona;13;Barcelonès;08019;Barcelona;8;132;U;;567;235;332;0;2;233;235
8;Barcelona;13;Barcelonès;08019;Barcelona;8;133;U;;664;340;324;3;2;335;337
8;Barcelona;13;Barcelonès;08019;Barcelona;8;134;U;;591;327;264;0;1;326;327
8;Barcelona;13;Barcelonès;08019;Barcelona;8;135;U;;749;381;368;3;4;374;378
8;Barcelona;13;Barcelonès;08019;Barcelona;8;136;U;;702;327;375;0;12;315;327
8;Barcelona;13;Barcelonès;08019;Barcelona;8;137;U;;488;252;236;0;4;248;252
8;Barcelona;13;Barcelonès;08019;Barcelona;8;138;U;;809;373;436;1;6;366;372
8;Barcelona;13;Barcelonès;08019;Barcelona;8;14;U;;574;294;280;0;4;290;294
8;Barcelona;13;Barcelonès;08019;Barcelona;8;140;A;;551;266;285;0;0;266;266
8;Barcelona;13;Barcelonès;08019;Barcelona;8;140;B;;594;261;333;3;4;254;258
8;Barcelona;13;Barcelonès;08019;Barcelona;8;141;A;;495;245;250;3;5;237;242
8;Barcelona;13;Barcelonès;08019;Barcelona;8;141;B;;516;239;277;0;1;238;239
8;Barcelona;13;Barcelonès;08019;Barcelona;8;142;A;;681;321;360;0;2;319;321
8;Barcelona;13;Barcelonès;08019;Barcelona;8;142;B;;816;384;432;0;4;380;384
8;Barcelona;13;Barcelonès;08019;Barcelona;8;143;A;;507;274;233;0;8;266;274
8;Barcelona;13;Barcelonès;08019;Barcelona;8;143;B;;674;379;295;0;6;373;379
8;Barcelona;13;Barcelonès;08019;Barcelona;8;144;A;;490;227;263;0;4;223;227
8;Barcelona;13;Barcelonès;08019;Barcelona;8;144;B;;575;282;293;4;5;273;278
8;Barcelona;13;Barcelonès;08019;Barcelona;8;145;U;;633;264;369;1;3;260;263
8;Barcelona;13;Barcelonès;08019;Barcelona;8;146;U;;529;259;270;0;2;257;259
8;Barcelona;13;Barcelonès;08019;Barcelona;8;147;U;;638;301;337;1;3;297;300
8;Barcelona;13;Barcelonès;08019;Barcelona;8;148;U;;510;210;300;0;3;207;210
8;Barcelona;13;Barcelonès;08019;Barcelona;8;149;U;;718;366;352;2;4;360;364
8;Barcelona;13;Barcelonès;08019;Barcelona;8;15;U;;434;241;193;1;4;236;240
8;Barcelona;13;Barcelonès;08019;Barcelona;8;150;U;;817;399;418;2;3;394;397
8;Barcelona;13;Barcelonès;08019;Barcelona;8;151;U;;657;304;353;0;2;302;304
8;Barcelona;13;Barcelonès;08019;Barcelona;8;152;A;;476;213;263;1;4;208;212
8;Barcelona;13;Barcelonès;08019;Barcelona;8;152;B;;568;247;321;2;1;244;245
8;Barcelona;13;Barcelonès;08019;Barcelona;8;153;U;;613;268;345;2;3;263;266
8;Barcelona;13;Barcelonès;08019;Barcelona;8;154;U;;733;355;378;0;1;354;355
8;Barcelona;13;Barcelonès;08019;Barcelona;8;155;U;;772;383;389;0;7;376;383
8;Barcelona;13;Barcelonès;08019;Barcelona;8;156;U;;476;197;279;0;2;195;197
8;Barcelona;13;Barcelonès;08019;Barcelona;8;157;U;;849;374;475;14;3;357;360
8;Barcelona;13;Barcelonès;08019;Barcelona;8;158;U;;475;202;273;1;3;198;201
8;Barcelona;13;Barcelonès;08019;Barcelona;8;159;U;;571;273;298;1;5;267;272
8;Barcelona;13;Barcelonès;08019;Barcelona;8;16;U;;465;270;195;0;5;265;270
8;Barcelona;13;Barcelonès;08019;Barcelona;8;160;U;;956;444;512;1;2;441;443
8;Barcelona;13;Barcelonès;08019;Barcelona;8;161;U;;839;391;448;5;1;385;386
8;Barcelona;13;Barcelonès;08019;Barcelona;8;162;U;;799;284;515;1;3;280;283
8;Barcelona;13;Barcelonès;08019;Barcelona;8;163;U;;785;348;437;1;2;345;347
8;Barcelona;13;Barcelonès;08019;Barcelona;8;164;U;;724;289;435;0;0;289;289
8;Barcelona;13;Barcelonès;08019;Barcelona;8;165;U;;492;234;258;0;0;234;234
8;Barcelona;13;Barcelonès;08019;Barcelona;8;166;U;;969;446;523;1;0;445;445
8;Barcelona;13;Barcelonès;08019;Barcelona;8;167;U;;786;318;468;0;2;316;318
8;Barcelona;13;Barcelonès;08019;Barcelona;8;168;U;;821;374;447;0;3;371;374
8;Barcelona;13;Barcelonès;08019;Barcelona;8;17;U;;539;307;232;4;3;300;303
8;Barcelona;13;Barcelonès;08019;Barcelona;8;170;U;;679;352;327;2;1;349;350
8;Barcelona;13;Barcelonès;08019;Barcelona;8;171;U;;954;466;488;4;6;456;462
8;Barcelona;13;Barcelonès;08019;Barcelona;8;172;U;;750;351;399;0;3;348;351
8;Barcelona;13;Barcelonès;08019;Barcelona;8;173;A;;463;237;226;1;1;235;236
8;Barcelona;13;Barcelonès;08019;Barcelona;8;173;B;;548;295;253;0;4;291;295
8;Barcelona;13;Barcelonès;08019;Barcelona;8;174;U;;581;288;293;0;3;285;288
8;Barcelona;13;Barcelonès;08019;Barcelona;8;175;U;;506;257;249;2;2;253;255
8;Barcelona;13;Barcelonès;08019;Barcelona;8;176;U;;809;393;416;2;0;391;391
8;Barcelona;13;Barcelonès;08019;Barcelona;8;178;U;;778;363;415;5;3;355;358
8;Barcelona;13;Barcelonès;08019;Barcelona;8;18;A;;490;274;216;0;5;269;274
8;Barcelona;13;Barcelonès;08019;Barcelona;8;18;B;;550;340;210;0;7;333;340
8;Barcelona;13;Barcelonès;08019;Barcelona;8;180;U;;577;266;311;0;1;265;266
8;Barcelona;13;Barcelonès;08019;Barcelona;8;181;U;;713;339;374;1;3;335;338
8;Barcelona;13;Barcelonès;08019;Barcelona;8;182;U;;565;283;282;0;6;277;283
8;Barcelona;13;Barcelonès;08019;Barcelona;8;183;U;;823;377;446;0;5;372;377
8;Barcelona;13;Barcelonès;08019;Barcelona;8;184;U;;703;323;380;0;0;323;323
8;Barcelona;13;Barcelonès;08019;Barcelona;8;185;U;;760;305;455;0;6;299;305
8;Barcelona;13;Barcelonès;08019;Barcelona;8;186;U;;917;329;588;4;10;315;325
8;Barcelona;13;Barcelonès;08019;Barcelona;8;187;U;;601;215;386;0;0;215;215
8;Barcelona;13;Barcelonès;08019;Barcelona;8;188;U;;626;269;357;0;2;267;269
8;Barcelona;13;Barcelonès;08019;Barcelona;8;189;A;;551;280;271;0;4;276;280
8;Barcelona;13;Barcelonès;08019;Barcelona;8;189;B;;678;333;345;10;0;323;323
8;Barcelona;13;Barcelonès;08019;Barcelona;8;19;A;;557;358;199;4;5;349;354
8;Barcelona;13;Barcelonès;08019;Barcelona;8;19;B;;624;396;228;3;6;387;393
8;Barcelona;13;Barcelonès;08019;Barcelona;8;190;A;;525;228;297;0;8;220;228
8;Barcelona;13;Barcelonès;08019;Barcelona;8;190;B;;591;242;349;2;3;237;240
8;Barcelona;13;Barcelonès;08019;Barcelona;8;191;A;;633;263;370;1;2;260;262
8;Barcelona;13;Barcelonès;08019;Barcelona;8;191;B;;586;284;302;5;3;276;279
8;Barcelona;13;Barcelonès;08019;Barcelona;8;191;C;;713;314;399;3;3;308;311
8;Barcelona;13;Barcelonès;08019;Barcelona;8;191;D;;602;254;348;1;1;252;253
8;Barcelona;13;Barcelonès;08019;Barcelona;8;192;U;;636;251;385;2;1;248;249
8;Barcelona;13;Barcelonès;08019;Barcelona;8;193;A;;543;246;297;1;1;244;245
8;Barcelona;13;Barcelonès;08019;Barcelona;8;193;B;;652;274;378;0;3;271;274
8;Barcelona;13;Barcelonès;08019;Barcelona;8;193;C;;586;253;333;2;1;250;251
8;Barcelona;13;Barcelonès;08019;Barcelona;8;194;U;;362;121;241;0;2;119;121
8;Barcelona;13;Barcelonès;08019;Barcelona;8;195;U;;550;215;335;0;1;214;215
8;Barcelona;13;Barcelonès;08019;Barcelona;8;196;U;;792;367;425;2;4;361;365
8;Barcelona;13;Barcelonès;08019;Barcelona;8;197;A;;463;207;256;0;2;205;207
8;Barcelona;13;Barcelonès;08019;Barcelona;8;197;B;;586;257;329;0;4;253;257
8;Barcelona;13;Barcelonès;08019;Barcelona;8;198;U;;618;249;369;7;6;236;242
8;Barcelona;13;Barcelonès;08019;Barcelona;8;2;U;;779;413;366;0;4;409;413
8;Barcelona;13;Barcelonès;08019;Barcelona;8;20;U;;415;237;178;0;8;229;237
8;Barcelona;13;Barcelonès;08019;Barcelona;8;200;U;;944;371;573;0;3;368;371
8;Barcelona;13;Barcelonès;08019;Barcelona;8;201;U;;537;199;338;3;1;195;196
8;Barcelona;13;Barcelonès;08019;Barcelona;8;202;U;;957;397;560;0;8;389;397
8;Barcelona;13;Barcelonès;08019;Barcelona;8;203;U;;644;246;398;3;0;243;243
8;Barcelona;13;Barcelonès;08019;Barcelona;8;204;U;;417;180;237;0;0;180;180
8;Barcelona;13;Barcelonès;08019;Barcelona;8;205;A;;575;241;334;1;1;239;240
8;Barcelona;13;Barcelonès;08019;Barcelona;8;205;B;;564;258;306;0;3;255;258
8;Barcelona;13;Barcelonès;08019;Barcelona;8;207;U;;560;270;290;0;4;266;270
8;Barcelona;13;Barcelonès;08019;Barcelona;8;208;U;;920;423;497;9;4;410;414
8;Barcelona;13;Barcelonès;08019;Barcelona;8;209;U;;456;205;251;0;2;203;205
8;Barcelona;13;Barcelonès;08019;Barcelona;8;21;U;;484;265;219;1;3;261;264
8;Barcelona;13;Barcelonès;08019;Barcelona;8;210;U;;927;402;525;1;6;395;401
8;Barcelona;13;Barcelonès;08019;Barcelona;8;211;U;;496;176;320;1;1;174;175
8;Barcelona;13;Barcelonès;08019;Barcelona;8;212;U;;328;116;212;1;1;114;115
8;Barcelona;13;Barcelonès;08019;Barcelona;8;22;U;;589;305;284;0;1;304;305
8;Barcelona;13;Barcelonès;08019;Barcelona;8;23;U;;604;353;251;0;8;345;353
8;Barcelona;13;Barcelonès;08019;Barcelona;8;24;U;;447;232;215;0;0;232;232
8;Barcelona;13;Barcelonès;08019;Barcelona;8;25;U;;451;242;209;0;0;242;242
8;Barcelona;13;Barcelonès;08019;Barcelona;8;26;U;;433;213;220;0;4;209;213
8;Barcelona;13;Barcelonès;08019;Barcelona;8;27;U;;870;472;398;1;9;462;471
8;Barcelona;13;Barcelonès;08019;Barcelona;8;28;A;;598;327;271;2;7;318;325
8;Barcelona;13;Barcelonès;08019;Barcelona;8;28;B;;712;405;307;1;6;398;404
8;Barcelona;13;Barcelonès;08019;Barcelona;8;29;U;;792;428;364;0;4;424;428
8;Barcelona;13;Barcelonès;08019;Barcelona;8;3;U;;759;391;368;1;2;388;390
8;Barcelona;13;Barcelonès;08019;Barcelona;8;30;U;;423;244;179;0;4;240;244
8;Barcelona;13;Barcelonès;08019;Barcelona;8;31;U;;844;460;384;1;3;456;459
8;Barcelona;13;Barcelonès;08019;Barcelona;8;33;U;;846;427;419;1;12;414;426
8;Barcelona;13;Barcelonès;08019;Barcelona;8;34;U;;493;252;241;2;5;245;250
8;Barcelona;13;Barcelonès;08019;Barcelona;8;36;U;;479;285;194;0;3;282;285
8;Barcelona;13;Barcelonès;08019;Barcelona;8;37;U;;543;313;230;1;7;305;312
8;Barcelona;13;Barcelonès;08019;Barcelona;8;38;U;;565;321;244;1;3;317;320
8;Barcelona;13;Barcelonès;08019;Barcelona;8;39;U;;635;332;303;0;2;330;332
8;Barcelona;13;Barcelonès;08019;Barcelona;8;4;U;;462;248;214;1;6;241;247
8;Barcelona;13;Barcelonès;08019;Barcelona;8;40;U;;592;331;261;1;6;324;330
8;Barcelona;13;Barcelonès;08019;Barcelona;8;41;U;;619;330;289;2;2;326;328
8;Barcelona;13;Barcelonès;08019;Barcelona;8;42;U;;669;371;298;5;2;364;366
8;Barcelona;13;Barcelonès;08019;Barcelona;8;43;U;;564;302;262;0;4;298;302
8;Barcelona;13;Barcelonès;08019;Barcelona;8;44;A;;592;284;308;0;4;280;284
8;Barcelona;13;Barcelonès;08019;Barcelona;8;44;B;;634;345;289;2;4;339;343
8;Barcelona;13;Barcelonès;08019;Barcelona;8;45;U;;565;336;229;0;7;329;336
8;Barcelona;13;Barcelonès;08019;Barcelona;8;46;A;;715;360;355;1;3;356;359
8;Barcelona;13;Barcelonès;08019;Barcelona;8;46;B;;832;348;484;1;6;341;347
8;Barcelona;13;Barcelonès;08019;Barcelona;8;46;C;;802;356;446;1;7;348;355
8;Barcelona;13;Barcelonès;08019;Barcelona;8;47;U;;628;314;314;3;3;308;311
8;Barcelona;13;Barcelonès;08019;Barcelona;8;48;U;;678;306;372;2;5;299;304
8;Barcelona;13;Barcelonès;08019;Barcelona;8;49;A;;443;209;234;1;1;207;208
8;Barcelona;13;Barcelonès;08019;Barcelona;8;49;B;;573;261;312;3;0;258;258
8;Barcelona;13;Barcelonès;08019;Barcelona;8;5;U;;910;476;434;1;8;467;475
8;Barcelona;13;Barcelonès;08019;Barcelona;8;50;U;;610;263;347;1;0;262;262
8;Barcelona;13;Barcelonès;08019;Barcelona;8;51;U;;790;425;365;0;9;416;425
8;Barcelona;13;Barcelonès;08019;Barcelona;8;52;U;;689;296;393;0;3;293;296
8;Barcelona;13;Barcelonès;08019;Barcelona;8;53;A;;445;225;220;1;1;223;224
8;Barcelona;13;Barcelonès;08019;Barcelona;8;53;B;;602;275;327;0;5;270;275
8;Barcelona;13;Barcelonès;08019;Barcelona;8;54;U;;611;313;298;2;0;311;311
8;Barcelona;13;Barcelonès;08019;Barcelona;8;55;U;;551;232;319;0;1;231;232
8;Barcelona;13;Barcelonès;08019;Barcelona;8;56;A;;635;313;322;2;3;308;311
8;Barcelona;13;Barcelonès;08019;Barcelona;8;56;B;;741;352;389;3;9;340;349
8;Barcelona;13;Barcelonès;08019;Barcelona;8;57;A;;451;222;229;1;4;217;221
8;Barcelona;13;Barcelonès;08019;Barcelona;8;57;B;;573;270;303;2;6;262;268
8;Barcelona;13;Barcelonès;08019;Barcelona;8;58;U;;441;183;258;1;3;179;182
8;Barcelona;13;Barcelonès;08019;Barcelona;8;59;U;;650;275;375;2;1;272;273
8;Barcelona;13;Barcelonès;08019;Barcelona;8;6;U;;851;485;366;1;7;477;484
8;Barcelona;13;Barcelonès;08019;Barcelona;8;60;U;;400;204;196;0;1;203;204
8;Barcelona;13;Barcelonès;08019;Barcelona;8;61;U;;740;351;389;0;6;345;351
8;Barcelona;13;Barcelonès;08019;Barcelona;8;62;U;;450;238;212;5;4;229;233
8;Barcelona;13;Barcelonès;08019;Barcelona;8;63;U;;636;347;289;2;6;339;345
8;Barcelona;13;Barcelonès;08019;Barcelona;8;64;U;;569;335;234;2;8;325;333
8;Barcelona;13;Barcelonès;08019;Barcelona;8;65;U;;974;469;505;0;11;458;469
8;Barcelona;13;Barcelonès;08019;Barcelona;8;66;U;;740;385;355;3;4;378;382
8;Barcelona;13;Barcelonès;08019;Barcelona;8;67;U;;799;415;384;7;6;402;408
8;Barcelona;13;Barcelonès;08019;Barcelona;8;68;U;;920;455;465;5;0;450;450
8;Barcelona;13;Barcelonès;08019;Barcelona;8;69;U;;699;353;346;1;1;351;352
8;Barcelona;13;Barcelonès;08019;Barcelona;8;7;U;;806;464;342;0;10;454;464
8;Barcelona;13;Barcelonès;08019;Barcelona;8;70;U;;641;339;302;3;8;328;336
8;Barcelona;13;Barcelonès;08019;Barcelona;8;71;U;;425;227;198;3;5;219;224
8;Barcelona;13;Barcelonès;08019;Barcelona;8;72;U;;625;359;266;0;7;352;359
8;Barcelona;13;Barcelonès;08019;Barcelona;8;73;U;;846;429;417;3;6;420;426
8;Barcelona;13;Barcelonès;08019;Barcelona;8;74;U;;947;509;438;3;4;502;506
8;Barcelona;13;Barcelonès;08019;Barcelona;8;75;U;;555;310;245;2;5;303;308
8;Barcelona;13;Barcelonès;08019;Barcelona;8;76;U;;712;368;344;0;5;363;368
8;Barcelona;13;Barcelonès;08019;Barcelona;8;77;U;;408;216;192;0;6;210;216
8;Barcelona;13;Barcelonès;08019;Barcelona;8;78;U;;574;292;282;1;2;289;291
8;Barcelona;13;Barcelonès;08019;Barcelona;8;79;U;;467;259;208;0;1;258;259
8;Barcelona;13;Barcelonès;08019;Barcelona;8;8;A;;546;298;248;0;11;287;298
8;Barcelona;13;Barcelonès;08019;Barcelona;8;8;B;;497;275;222;7;0;268;268
8;Barcelona;13;Barcelonès;08019;Barcelona;8;80;U;;536;283;253;1;3;279;282
8;Barcelona;13;Barcelonès;08019;Barcelona;8;81;A;;488;240;248;2;2;236;238
8;Barcelona;13;Barcelonès;08019;Barcelona;8;81;B;;540;258;282;0;4;254;258
8;Barcelona;13;Barcelonès;08019;Barcelona;8;82;U;;690;353;337;0;3;350;353
8;Barcelona;13;Barcelonès;08019;Barcelona;8;83;U;;677;354;323;1;8;345;353
8;Barcelona;13;Barcelonès;08019;Barcelona;8;84;A;;688;365;323;5;7;353;360
8;Barcelona;13;Barcelonès;08019;Barcelona;8;84;B;;750;397;353;0;7;390;397
8;Barcelona;13;Barcelonès;08019;Barcelona;8;85;U;;941;430;511;11;11;408;419
8;Barcelona;13;Barcelonès;08019;Barcelona;8;86;U;;956;401;555;0;3;398;401
8;Barcelona;13;Barcelonès;08019;Barcelona;8;88;U;;718;346;372;0;7;339;346
8;Barcelona;13;Barcelonès;08019;Barcelona;8;89;A;;534;288;246;1;5;282;287
8;Barcelona;13;Barcelonès;08019;Barcelona;8;89;B;;561;252;309;3;5;244;249
8;Barcelona;13;Barcelonès;08019;Barcelona;8;9;U;;514;228;286;2;4;222;226
8;Barcelona;13;Barcelonès;08019;Barcelona;8;90;A;;483;255;228;1;9;245;254
8;Barcelona;13;Barcelonès;08019;Barcelona;8;90;B;;550;280;270;2;6;272;278
8;Barcelona;13;Barcelonès;08019;Barcelona;8;91;A;;649;294;355;0;2;292;294
8;Barcelona;13;Barcelonès;08019;Barcelona;8;91;B;;584;274;310;1;4;269;273
8;Barcelona;13;Barcelonès;08019;Barcelona;8;91;C;;683;300;383;1;7;292;299
8;Barcelona;13;Barcelonès;08019;Barcelona;8;91;D;;530;251;279;0;2;249;251
8;Barcelona;13;Barcelonès;08019;Barcelona;8;92;A;;629;311;318;0;1;310;311
8;Barcelona;13;Barcelonès;08019;Barcelona;8;92;B;;663;333;330;0;10;323;333
8;Barcelona;13;Barcelonès;08019;Barcelona;8;92;C;;708;362;346;0;8;354;362
8;Barcelona;13;Barcelonès;08019;Barcelona;8;93;A;;532;282;250;3;6;273;279
8;Barcelona;13;Barcelonès;08019;Barcelona;8;93;B;;618;304;314;1;3;300;303
8;Barcelona;13;Barcelonès;08019;Barcelona;8;93;C;;596;301;295;0;2;299;301
8;Barcelona;13;Barcelonès;08019;Barcelona;8;94;U;;585;342;243;1;6;335;341
8;Barcelona;13;Barcelonès;08019;Barcelona;8;95;U;;806;487;319;0;6;481;487
8;Barcelona;13;Barcelonès;08019;Barcelona;8;96;A;;473;233;240;2;1;230;231
8;Barcelona;13;Barcelonès;08019;Barcelona;8;96;B;;547;267;280;0;1;266;267
8;Barcelona;13;Barcelonès;08019;Barcelona;8;97;A;;556;277;279;3;1;273;274
8;Barcelona;13;Barcelonès;08019;Barcelona;8;97;B;;538;287;251;1;3;283;286
8;Barcelona;13;Barcelonès;08019;Barcelona;8;98;U;;726;339;387;0;4;335;339
8;Barcelona;13;Barcelonès;08019;Barcelona;8;99;U;;513;253;260;1;0;252;252
8;Barcelona;13;Barcelonès;08019;Barcelona;9;10;U;;568;294;274;0;3;291;294
8;Barcelona;13;Barcelonès;08019;Barcelona;9;100;U;;746;388;358;4;2;382;384
8;Barcelona;13;Barcelonès;08019;Barcelona;9;101;U;;432;220;212;0;5;215;220
8;Barcelona;13;Barcelonès;08019;Barcelona;9;102;A;;662;315;347;1;3;311;314
8;Barcelona;13;Barcelonès;08019;Barcelona;9;102;B;;685;367;318;2;9;356;365
8;Barcelona;13;Barcelonès;08019;Barcelona;9;103;A;;568;255;313;1;6;248;254
8;Barcelona;13;Barcelonès;08019;Barcelona;9;103;B;;675;301;374;0;5;296;301
8;Barcelona;13;Barcelonès;08019;Barcelona;9;103;C;;655;296;359;0;2;294;296
8;Barcelona;13;Barcelonès;08019;Barcelona;9;104;U;;624;295;329;0;4;291;295
8;Barcelona;13;Barcelonès;08019;Barcelona;9;105;U;;528;288;240;0;3;285;288
8;Barcelona;13;Barcelonès;08019;Barcelona;9;106;U;;774;375;399;0;1;374;375
8;Barcelona;13;Barcelonès;08019;Barcelona;9;107;U;;625;325;300;1;1;323;324
8;Barcelona;13;Barcelonès;08019;Barcelona;9;108;A;;514;236;278;0;9;227;236
8;Barcelona;13;Barcelonès;08019;Barcelona;9;108;B;;632;302;330;0;8;294;302
8;Barcelona;13;Barcelonès;08019;Barcelona;9;109;U;;974;511;463;0;5;506;511
8;Barcelona;13;Barcelonès;08019;Barcelona;9;11;U;;563;319;244;0;0;319;319
8;Barcelona;13;Barcelonès;08019;Barcelona;9;110;A;;499;261;238;0;5;256;261
8;Barcelona;13;Barcelonès;08019;Barcelona;9;110;B;;531;286;245;0;7;279;286
8;Barcelona;13;Barcelonès;08019;Barcelona;9;111;U;;751;402;349;1;10;391;401
8;Barcelona;13;Barcelonès;08019;Barcelona;9;112;U;;608;300;308;2;3;295;298
8;Barcelona;13;Barcelonès;08019;Barcelona;9;113;A;;457;223;234;0;2;221;223
8;Barcelona;13;Barcelonès;08019;Barcelona;9;113;B;;542;248;294;0;6;242;248
8;Barcelona;13;Barcelonès;08019;Barcelona;9;114;U;;621;292;329;0;3;289;292
8;Barcelona;13;Barcelonès;08019;Barcelona;9;115;U;;933;500;433;3;4;493;497
8;Barcelona;13;Barcelonès;08019;Barcelona;9;116;U;;590;366;224;1;3;362;365
8;Barcelona;13;Barcelonès;08019;Barcelona;9;117;U;;518;328;190;1;5;322;327
8;Barcelona;13;Barcelonès;08019;Barcelona;9;118;U;;850;450;400;0;10;440;450
8;Barcelona;13;Barcelonès;08019;Barcelona;9;119;U;;572;327;245;1;1;325;326
8;Barcelona;13;Barcelonès;08019;Barcelona;9;12;U;;608;259;349;1;1;257;258
8;Barcelona;13;Barcelonès;08019;Barcelona;9;120;U;;944;460;484;0;7;453;460
8;Barcelona;13;Barcelonès;08019;Barcelona;9;121;U;;863;421;442;2;6;413;419
8;Barcelona;13;Barcelonès;08019;Barcelona;9;122;U;;639;376;263;1;5;370;375
8;Barcelona;13;Barcelonès;08019;Barcelona;9;123;U;;710;440;270;2;13;425;438
8;Barcelona;13;Barcelonès;08019;Barcelona;9;124;U;;622;351;271;1;6;344;350
8;Barcelona;13;Barcelonès;08019;Barcelona;9;125;U;;749;459;290;0;6;453;459
8;Barcelona;13;Barcelonès;08019;Barcelona;9;126;A;;508;299;209;0;5;294;299
8;Barcelona;13;Barcelonès;08019;Barcelona;9;126;B;;611;352;259;0;7;345;352
8;Barcelona;13;Barcelonès;08019;Barcelona;9;128;U;;818;393;425;1;0;392;392
8;Barcelona;13;Barcelonès;08019;Barcelona;9;129;U;;669;301;368;0;6;295;301
8;Barcelona;13;Barcelonès;08019;Barcelona;9;13;A;;522;315;207;0;6;309;315
8;Barcelona;13;Barcelonès;08019;Barcelona;9;13;B;;595;346;249;3;11;332;343
8;Barcelona;13;Barcelonès;08019;Barcelona;9;130;U;;615;296;319;0;0;296;296
8;Barcelona;13;Barcelonès;08019;Barcelona;9;131;U;;625;312;313;5;2;305;307
8;Barcelona;13;Barcelonès;08019;Barcelona;9;132;A;;521;235;286;0;4;231;235
8;Barcelona;13;Barcelonès;08019;Barcelona;9;132;B;;647;293;354;0;5;288;293
8;Barcelona;13;Barcelonès;08019;Barcelona;9;133;U;;859;413;446;2;6;405;411
8;Barcelona;13;Barcelonès;08019;Barcelona;9;134;U;;783;359;424;0;3;356;359
8;Barcelona;13;Barcelonès;08019;Barcelona;9;136;A;;514;243;271;0;4;239;243
8;Barcelona;13;Barcelonès;08019;Barcelona;9;136;B;;487;215;272;0;1;214;215
8;Barcelona;13;Barcelonès;08019;Barcelona;9;137;U;;479;233;246;1;2;230;232
8;Barcelona;13;Barcelonès;08019;Barcelona;9;138;U;;494;199;295;1;0;198;198
8;Barcelona;13;Barcelonès;08019;Barcelona;9;139;U;;736;343;393;0;1;342;343
8;Barcelona;13;Barcelonès;08019;Barcelona;9;14;A;;549;315;234;1;12;302;314
8;Barcelona;13;Barcelonès;08019;Barcelona;9;14;B;;521;313;208;0;5;308;313
8;Barcelona;13;Barcelonès;08019;Barcelona;9;140;U;;482;246;236;1;0;245;245
8;Barcelona;13;Barcelonès;08019;Barcelona;9;141;U;;433;174;259;0;2;172;174
8;Barcelona;13;Barcelonès;08019;Barcelona;9;142;U;;495;227;268;1;1;225;226
8;Barcelona;13;Barcelonès;08019;Barcelona;9;143;U;;337;149;188;0;3;146;149
8;Barcelona;13;Barcelonès;08019;Barcelona;9;144;A;;505;238;267;1;2;235;237
8;Barcelona;13;Barcelonès;08019;Barcelona;9;144;B;;589;292;297;1;1;290;291
8;Barcelona;13;Barcelonès;08019;Barcelona;9;145;U;;668;335;333;2;3;330;333
8;Barcelona;13;Barcelonès;08019;Barcelona;9;146;U;;763;382;381;1;4;377;381
8;Barcelona;13;Barcelonès;08019;Barcelona;9;147;U;;735;317;418;2;3;312;315
8;Barcelona;13;Barcelonès;08019;Barcelona;9;148;U;;752;331;421;1;5;325;330
8;Barcelona;13;Barcelonès;08019;Barcelona;9;149;U;;711;328;383;2;7;319;326
8;Barcelona;13;Barcelonès;08019;Barcelona;9;15;A;;546;333;213;0;4;329;333
8;Barcelona;13;Barcelonès;08019;Barcelona;9;15;B;;588;355;233;1;5;349;354
8;Barcelona;13;Barcelonès;08019;Barcelona;9;150;A;;480;187;293;0;2;185;187
8;Barcelona;13;Barcelonès;08019;Barcelona;9;150;B;;538;220;318;0;6;214;220
8;Barcelona;13;Barcelonès;08019;Barcelona;9;151;A;;531;215;316;2;2;211;213
8;Barcelona;13;Barcelonès;08019;Barcelona;9;151;B;;517;221;296;2;4;215;219
8;Barcelona;13;Barcelonès;08019;Barcelona;9;153;U;;737;250;487;0;0;250;250
8;Barcelona;13;Barcelonès;08019;Barcelona;9;154;U;;765;308;457;7;4;297;301
8;Barcelona;13;Barcelonès;08019;Barcelona;9;17;A;;507;300;207;1;6;293;299
8;Barcelona;13;Barcelonès;08019;Barcelona;9;17;B;;542;315;227;0;6;309;315
8;Barcelona;13;Barcelonès;08019;Barcelona;9;18;U;;645;393;252;2;1;390;391
8;Barcelona;13;Barcelonès;08019;Barcelona;9;19;U;;878;491;387;7;1;483;484
8;Barcelona;13;Barcelonès;08019;Barcelona;9;2;A;;685;344;341;1;7;336;343
8;Barcelona;13;Barcelonès;08019;Barcelona;9;2;B;;852;457;395;1;4;452;456
8;Barcelona;13;Barcelonès;08019;Barcelona;9;20;U;;870;503;367;7;0;496;496
8;Barcelona;13;Barcelonès;08019;Barcelona;9;21;U;;984;601;383;3;2;596;598
8;Barcelona;13;Barcelonès;08019;Barcelona;9;22;U;;650;396;254;1;4;391;395
8;Barcelona;13;Barcelonès;08019;Barcelona;9;23;U;;736;379;357;0;6;373;379
8;Barcelona;13;Barcelonès;08019;Barcelona;9;24;U;;496;272;224;0;4;268;272
8;Barcelona;13;Barcelonès;08019;Barcelona;9;25;U;;833;437;396;0;4;433;437
8;Barcelona;13;Barcelonès;08019;Barcelona;9;26;A;;595;330;265;0;2;328;330
8;Barcelona;13;Barcelonès;08019;Barcelona;9;26;B;;590;303;287;3;5;295;300
8;Barcelona;13;Barcelonès;08019;Barcelona;9;26;C;;597;314;283;0;4;310;314
8;Barcelona;13;Barcelonès;08019;Barcelona;9;27;U;;935;482;453;1;7;474;481
8;Barcelona;13;Barcelonès;08019;Barcelona;9;28;U;;577;316;261;5;3;308;311
8;Barcelona;13;Barcelonès;08019;Barcelona;9;3;A;;641;343;298;0;2;341;343
8;Barcelona;13;Barcelonès;08019;Barcelona;9;3;B;;660;340;320;3;5;332;337
8;Barcelona;13;Barcelonès;08019;Barcelona;9;3;C;;691;362;329;0;7;355;362
8;Barcelona;13;Barcelonès;08019;Barcelona;9;30;A;;696;333;363;1;8;324;332
8;Barcelona;13;Barcelonès;08019;Barcelona;9;30;B;;804;377;427;1;2;374;376
8;Barcelona;13;Barcelonès;08019;Barcelona;9;31;U;;763;431;332;1;4;426;430
8;Barcelona;13;Barcelonès;08019;Barcelona;9;32;U;;780;400;380;1;2;397;399
8;Barcelona;13;Barcelonès;08019;Barcelona;9;33;U;;418;232;186;4;1;227;228
8;Barcelona;13;Barcelonès;08019;Barcelona;9;34;U;;418;273;145;0;7;266;273
8;Barcelona;13;Barcelonès;08019;Barcelona;9;35;U;;583;339;244;0;4;335;339
8;Barcelona;13;Barcelonès;08019;Barcelona;9;36;U;;544;313;231;2;7;304;311
8;Barcelona;13;Barcelonès;08019;Barcelona;9;37;A;;557;279;278;0;4;275;279
8;Barcelona;13;Barcelonès;08019;Barcelona;9;37;B;;616;316;300;4;0;312;312
8;Barcelona;13;Barcelonès;08019;Barcelona;9;39;A;;632;349;283;0;6;343;349
8;Barcelona;13;Barcelonès;08019;Barcelona;9;39;B;;553;308;245;0;8;300;308
8;Barcelona;13;Barcelonès;08019;Barcelona;9;39;C;;689;354;335;2;5;347;352
8;Barcelona;13;Barcelonès;08019;Barcelona;9;39;D;;574;325;249;1;6;318;324
8;Barcelona;13;Barcelonès;08019;Barcelona;9;4;A;;536;302;234;2;6;294;300
8;Barcelona;13;Barcelonès;08019;Barcelona;9;4;B;;634;353;281;1;5;347;352
8;Barcelona;13;Barcelonès;08019;Barcelona;9;40;A;;481;265;216;0;7;258;265
8;Barcelona;13;Barcelonès;08019;Barcelona;9;40;B;;581;316;265;0;7;309;316
8;Barcelona;13;Barcelonès;08019;Barcelona;9;41;U;;799;474;325;3;10;461;471
8;Barcelona;13;Barcelonès;08019;Barcelona;9;42;A;;469;271;198;0;9;262;271
8;Barcelona;13;Barcelonès;08019;Barcelona;9;42;B;;520;284;236;1;5;278;283
8;Barcelona;13;Barcelonès;08019;Barcelona;9;43;A;;560;282;278;1;6;275;281
8;Barcelona;13;Barcelonès;08019;Barcelona;9;43;B;;579;323;256;0;5;318;323
8;Barcelona;13;Barcelonès;08019;Barcelona;9;44;A;;490;257;233;0;5;252;257
8;Barcelona;13;Barcelonès;08019;Barcelona;9;44;B;;557;268;289;0;3;265;268
8;Barcelona;13;Barcelonès;08019;Barcelona;9;44;C;;594;281;313;0;5;276;281
8;Barcelona;13;Barcelonès;08019;Barcelona;9;45;A;;587;338;249;0;7;331;338
8;Barcelona;13;Barcelonès;08019;Barcelona;9;45;B;;567;318;249;0;4;314;318
8;Barcelona;13;Barcelonès;08019;Barcelona;9;45;C;;665;372;293;1;6;365;371
8;Barcelona;13;Barcelonès;08019;Barcelona;9;46;A;;640;331;309;0;5;326;331
8;Barcelona;13;Barcelonès;08019;Barcelona;9;46;B;;747;370;377;1;5;364;369
8;Barcelona;13;Barcelonès;08019;Barcelona;9;47;A;;588;273;315;1;1;271;272
8;Barcelona;13;Barcelonès;08019;Barcelona;9;47;B;;656;329;327;0;7;322;329
8;Barcelona;13;Barcelonès;08019;Barcelona;9;48;A;;509;280;229;4;2;274;276
8;Barcelona;13;Barcelonès;08019;Barcelona;9;48;B;;550;326;224;0;5;321;326
8;Barcelona;13;Barcelonès;08019;Barcelona;9;49;U;;432;265;167;0;4;261;265
8;Barcelona;13;Barcelonès;08019;Barcelona;9;5;A;;571;331;240;0;3;328;331
8;Barcelona;13;Barcelonès;08019;Barcelona;9;5;B;;600;315;285;0;7;308;315
8;Barcelona;13;Barcelonès;08019;Barcelona;9;50;U;;467;243;224;0;0;243;243
8;Barcelona;13;Barcelonès;08019;Barcelona;9;51;A;;479;256;223;0;5;251;256
8;Barcelona;13;Barcelonès;08019;Barcelona;9;51;B;;548;301;247;1;5;295;300
8;Barcelona;13;Barcelonès;08019;Barcelona;9;52;U;;438;256;182;0;5;251;256
8;Barcelona;13;Barcelonès;08019;Barcelona;9;53;U;;478;261;217;2;1;258;259
8;Barcelona;13;Barcelonès;08019;Barcelona;9;54;U;;533;288;245;1;2;285;287
8;Barcelona;13;Barcelonès;08019;Barcelona;9;55;U;;517;288;229;0;5;283;288
8;Barcelona;13;Barcelonès;08019;Barcelona;9;56;U;;421;215;206;0;3;212;215
8;Barcelona;13;Barcelonès;08019;Barcelona;9;57;U;;611;343;268;1;6;336;342
8;Barcelona;13;Barcelonès;08019;Barcelona;9;59;U;;872;453;419;0;8;445;453
8;Barcelona;13;Barcelonès;08019;Barcelona;9;6;A;;574;306;268;0;4;302;306
8;Barcelona;13;Barcelonès;08019;Barcelona;9;6;B;;597;350;247;0;8;342;350
8;Barcelona;13;Barcelonès;08019;Barcelona;9;60;U;;507;311;196;3;11;297;308
8;Barcelona;13;Barcelonès;08019;Barcelona;9;61;U;;836;449;387;0;6;443;449
8;Barcelona;13;Barcelonès;08019;Barcelona;9;62;U;;584;351;233;0;4;347;351
8;Barcelona;13;Barcelonès;08019;Barcelona;9;63;U;;768;465;303;0;18;447;465
8;Barcelona;13;Barcelonès;08019;Barcelona;9;64;U;;436;274;162;2;3;269;272
8;Barcelona;13;Barcelonès;08019;Barcelona;9;65;U;;798;486;312;0;3;483;486
8;Barcelona;13;Barcelonès;08019;Barcelona;9;66;U;;987;592;395;8;0;584;584
8;Barcelona;13;Barcelonès;08019;Barcelona;9;67;U;;506;337;169;2;3;332;335
8;Barcelona;13;Barcelonès;08019;Barcelona;9;68;U;;817;515;302;1;8;506;514
8;Barcelona;13;Barcelonès;08019;Barcelona;9;69;U;;937;566;371;1;12;553;565
8;Barcelona;13;Barcelonès;08019;Barcelona;9;7;U;;654;400;254;1;15;384;399
8;Barcelona;13;Barcelonès;08019;Barcelona;9;70;U;;436;247;189;1;7;239;246
8;Barcelona;13;Barcelonès;08019;Barcelona;9;71;U;;565;345;220;1;3;341;344
8;Barcelona;13;Barcelonès;08019;Barcelona;9;72;A;;471;278;193;1;4;273;277
8;Barcelona;13;Barcelonès;08019;Barcelona;9;72;B;;571;338;233;0;8;330;338
8;Barcelona;13;Barcelonès;08019;Barcelona;9;73;U;;842;522;320;1;8;513;521
8;Barcelona;13;Barcelonès;08019;Barcelona;9;74;U;;589;343;246;0;6;337;343
8;Barcelona;13;Barcelonès;08019;Barcelona;9;75;U;;573;351;222;4;6;341;347
8;Barcelona;13;Barcelonès;08019;Barcelona;9;76;U;;445;258;187;1;1;256;257
8;Barcelona;13;Barcelonès;08019;Barcelona;9;77;U;;418;266;152;0;6;260;266
8;Barcelona;13;Barcelonès;08019;Barcelona;9;78;U;;541;309;232;1;7;301;308
8;Barcelona;13;Barcelonès;08019;Barcelona;9;79;U;;806;463;343;1;2;460;462
8;Barcelona;13;Barcelonès;08019;Barcelona;9;8;U;;520;315;205;2;0;313;313
8;Barcelona;13;Barcelonès;08019;Barcelona;9;80;U;;502;321;181;2;5;314;319
8;Barcelona;13;Barcelonès;08019;Barcelona;9;81;U;;836;495;341;5;2;488;490
8;Barcelona;13;Barcelonès;08019;Barcelona;9;82;U;;488;276;212;0;5;271;276
8;Barcelona;13;Barcelonès;08019;Barcelona;9;83;U;;568;349;219;0;5;344;349
8;Barcelona;13;Barcelonès;08019;Barcelona;9;84;U;;602;335;267;0;2;333;335
8;Barcelona;13;Barcelonès;08019;Barcelona;9;85;U;;429;239;190;1;3;235;238
8;Barcelona;13;Barcelonès;08019;Barcelona;9;86;A;;733;438;295;1;13;424;437
8;Barcelona;13;Barcelonès;08019;Barcelona;9;86;B;;747;408;339;0;6;402;408
8;Barcelona;13;Barcelonès;08019;Barcelona;9;87;U;;736;402;334;0;5;397;402
8;Barcelona;13;Barcelonès;08019;Barcelona;9;88;U;;542;309;233;1;1;307;308
8;Barcelona;13;Barcelonès;08019;Barcelona;9;89;A;;545;311;234;0;4;307;311
8;Barcelona;13;Barcelonès;08019;Barcelona;9;89;B;;594;364;230;1;2;361;363
8;Barcelona;13;Barcelonès;08019;Barcelona;9;9;U;;610;348;262;0;4;344;348
8;Barcelona;13;Barcelonès;08019;Barcelona;9;90;U;;586;333;253;0;3;330;333
8;Barcelona;13;Barcelonès;08019;Barcelona;9;91;U;;535;318;217;0;5;313;318
8;Barcelona;13;Barcelonès;08019;Barcelona;9;92;U;;778;438;340;0;4;434;438
8;Barcelona;13;Barcelonès;08019;Barcelona;9;93;U;;425;238;187;0;3;235;238
8;Barcelona;13;Barcelonès;08019;Barcelona;9;94;U;;722;440;282;1;2;437;439
8;Barcelona;13;Barcelonès;08019;Barcelona;9;95;U;;567;364;203;1;4;359;363
8;Barcelona;13;Barcelonès;08019;Barcelona;9;96;U;;545;314;231;0;1;313;314
8;Barcelona;13;Barcelonès;08019;Barcelona;9;97;U;;637;407;230;0;6;401;407
8;Barcelona;13;Barcelonès;08019;Barcelona;9;98;U;;484;244;240;1;0;243;243
8;Barcelona;13;Barcelonès;08019;Barcelona;9;99;U;;664;374;290;2;2;370;372
25;Lleida;23;Noguera;25042;Baronia de Rialb, la;1;1;U;;228;150;78;0;3;147;150
17;Girona;2;Alt Empordà;17016;Bàscara;1;1;U;;649;448;201;3;1;444;445
25;Lleida;4;Alt Urgell;25044;Bassella;1;1;U;;320;217;103;0;0;217;217
43;Tarragona;37;Terra Alta;43022;Batea;1;1;U;;1016;753;263;3;4;746;750
43;Tarragona;37;Terra Alta;43022;Batea;1;2;U;;646;456;190;3;1;452;453
25;Lleida;39;Consell General d'Aran;25045;Bausen;1;1;U;;67;58;9;0;0;58;58
8;Barcelona;11;Baix Llobregat;08020;Begues;1;1;A;;608;400;208;2;7;391;398
8;Barcelona;11;Baix Llobregat;08020;Begues;1;1;B;;962;621;341;1;9;611;620
17;Girona;10;Baix Empordà;17013;Begur;1;1;A;;747;504;243;1;2;501;503
17;Girona;10;Baix Empordà;17013;Begur;1;1;B;;791;552;239;2;4;546;550
17;Girona;10;Baix Empordà;17013;Begur;1;1;C;;496;340;156;2;7;331;338
25;Lleida;38;Urgell;25046;Belianes;1;1;U;;520;309;211;6;2;301;303
25;Lleida;18;Garrigues;25170;Bellaguarda;1;1;U;;326;189;137;0;2;187;189
17;Girona;10;Baix Empordà;17018;Bellcaire d'Empordà;1;1;U;;433;323;110;1;5;317;322
25;Lleida;23;Noguera;25047;Bellcaire d'Urgell;1;1;A;;569;394;175;0;0;394;394
25;Lleida;23;Noguera;25047;Bellcaire d'Urgell;1;1;B;;668;472;196;1;1;470;471
25;Lleida;27;Pla d'Urgell;25048;Bell-lloc d'Urgell;1;1;U;;769;512;257;0;3;509;512
25;Lleida;27;Pla d'Urgell;25048;Bell-lloc d'Urgell;1;2;U;;1013;639;374;9;4;626;630
25;Lleida;23;Noguera;25049;Bellmunt d'Urgell;1;1;U;;195;133;62;4;1;128;129
43;Tarragona;29;Priorat;43023;Bellmunt del Priorat;1;1;U;;269;210;59;2;2;206;208
8;Barcelona;6;Anoia;08021;Bellprat;1;1;U;;88;50;38;2;0;48;48
25;Lleida;38;Urgell;25050;Bellpuig;1;1;U;;1088;653;435;6;12;635;647
25;Lleida;38;Urgell;25050;Bellpuig;1;2;U;;984;630;354;3;19;608;627
25;Lleida;38;Urgell;25050;Bellpuig;1;3;U;;912;590;322;2;16;572;588
43;Tarragona;12;Baix Penedès;43024;Bellvei;1;1;U;;750;556;194;12;8;536;544
25;Lleida;15;Cerdanya;25051;Bellver de Cerdanya;1;1;U;;1288;868;420;13;8;847;855
25;Lleida;27;Pla d'Urgell;25052;Bellvís;1;1;A;;865;516;349;4;10;502;512
25;Lleida;27;Pla d'Urgell;25052;Bellvís;1;1;B;;828;532;296;5;0;527;527
25;Lleida;27;Pla d'Urgell;25052;Bellvís;1;1;C;;221;128;93;1;0;127;127
25;Lleida;33;Segrià;25053;Benavent de Segrià;1;1;U;;581;383;198;1;10;372;382
43;Tarragona;9;Baix Ebre;43025;Benifallet;1;1;U;;798;552;246;3;2;547;549
43;Tarragona;30;Ribera d'Ebre;43026;Benissanet;1;1;U;;849;554;295;4;6;544;550
8;Barcelona;14;Berguedà;08022;Berga;1;1;U;;1109;659;450;3;10;646;656
8;Barcelona;14;Berguedà;08022;Berga;1;2;U;;1255;838;417;1;12;825;837
8;Barcelona;14;Berguedà;08022;Berga;1;3;U;;766;523;243;0;6;517;523
8;Barcelona;14;Berguedà;08022;Berga;1;4;U;;1397;881;516;4;17;860;877
8;Barcelona;14;Berguedà;08022;Berga;1;5;U;;950;592;358;2;10;580;590
8;Barcelona;14;Berguedà;08022;Berga;2;1;A;;576;312;264;2;3;307;310
8;Barcelona;14;Berguedà;08022;Berga;2;1;B;;561;320;241;0;3;317;320
8;Barcelona;14;Berguedà;08022;Berga;2;2;U;;960;567;393;13;5;549;554
8;Barcelona;14;Berguedà;08022;Berga;2;3;A;;760;435;325;4;2;429;431
8;Barcelona;14;Berguedà;08022;Berga;2;3;B;;950;550;400;5;0;545;545
8;Barcelona;14;Berguedà;08022;Berga;2;4;U;;1074;699;375;6;5;688;693
8;Barcelona;14;Berguedà;08022;Berga;3;1;U;;547;340;207;3;2;335;337
8;Barcelona;14;Berguedà;08022;Berga;4;1;U;;407;281;126;3;2;276;278
17;Girona;19;Garrotxa;17019;Besalú;1;1;A;;539;363;176;6;10;347;357
17;Girona;19;Garrotxa;17019;Besalú;1;1;B;;398;283;115;4;10;269;279
17;Girona;19;Garrotxa;17019;Besalú;1;1;C;;795;528;267;9;13;506;519
17;Girona;20;Gironès;17020;Bescanó;1;1;A;;537;426;111;4;2;420;422
17;Girona;20;Gironès;17020;Bescanó;1;1;B;;584;445;139;0;7;438;445
17;Girona;20;Gironès;17020;Bescanó;1;1;C;;595;454;141;3;1;450;451
17;Girona;20;Gironès;17020;Bescanó;1;2;A;;237;152;85;0;0;152;152
17;Girona;20;Gironès;17020;Bescanó;1;2;B;;274;170;104;1;7;162;169
17;Girona;19;Garrotxa;17021;Beuda;1;1;U;;96;54;42;2;0;52;52
8;Barcelona;41;Vallès Oriental;08023;Bigues i Riells;1;1;A;;1857;960;897;2;8;950;958
8;Barcelona;41;Vallès Oriental;08023;Bigues i Riells;1;1;B;;298;221;77;5;0;216;216
25;Lleida;32;Segarra;25055;Biosca;1;1;U;;239;175;64;0;0;175;175
17;Girona;10;Baix Empordà;17022;Bisbal d'Empordà, la;1;1;U;;631;389;242;2;2;385;387
17;Girona;10;Baix Empordà;17022;Bisbal d'Empordà, la;1;2;U;;1040;715;325;2;10;703;713
17;Girona;10;Baix Empordà;17022;Bisbal d'Empordà, la;1;3;U;;825;527;298;1;9;517;526
17;Girona;10;Baix Empordà;17022;Bisbal d'Empordà, la;1;4;U;;938;629;309;1;7;621;628
17;Girona;10;Baix Empordà;17022;Bisbal d'Empordà, la;2;1;U;;519;364;155;2;2;360;362
17;Girona;10;Baix Empordà;17022;Bisbal d'Empordà, la;2;2;A;;593;385;208;0;3;382;385
17;Girona;10;Baix Empordà;17022;Bisbal d'Empordà, la;2;2;B;;710;480;230;3;1;476;477
17;Girona;10;Baix Empordà;17022;Bisbal d'Empordà, la;2;3;U;;931;628;303;1;6;621;627
43;Tarragona;29;Priorat;43027;Bisbal de Falset, la;1;1;U;;248;118;130;1;7;110;117
43;Tarragona;12;Baix Penedès;43028;Bisbal del Penedès, la;1;1;U;;1093;695;398;8;9;678;687
17;Girona;2;Alt Empordà;17234;Biure;1;1;U;;223;131;92;1;0;130;130
43;Tarragona;16;Conca de Barberà;43029;Blancafort;1;1;U;;349;228;121;2;1;225;226
17;Girona;34;Selva;17023;Blanes;1;1;U;;914;597;317;2;7;588;595
17;Girona;34;Selva;17023;Blanes;1;2;U;;1215;862;353;4;13;845;858
17;Girona;34;Selva;17023;Blanes;2;1;U;;963;563;400;0;6;557;563
17;Girona;34;Selva;17023;Blanes;2;2;U;;1193;767;426;1;6;760;766
17;Girona;34;Selva;17023;Blanes;2;3;A;;560;316;244;1;5;310;315
17;Girona;34;Selva;17023;Blanes;2;3;B;;626;367;259;4;5;358;363
17;Girona;34;Selva;17023;Blanes;2;4;U;;1187;588;599;3;3;582;585
17;Girona;34;Selva;17023;Blanes;2;5;A;;795;419;376;1;6;412;418
17;Girona;34;Selva;17023;Blanes;2;5;B;;893;473;420;1;2;470;472
17;Girona;34;Selva;17023;Blanes;2;6;A;;335;183;152;3;2;178;180
17;Girona;34;Selva;17023;Blanes;2;6;B;;434;226;208;0;0;226;226
17;Girona;34;Selva;17023;Blanes;2;6;C;;394;213;181;1;0;212;212
17;Girona;34;Selva;17023;Blanes;2;7;A;;488;214;274;1;2;211;213
17;Girona;34;Selva;17023;Blanes;2;7;B;;535;232;303;0;1;231;232
17;Girona;34;Selva;17023;Blanes;2;8;A;;668;380;288;0;3;377;380
17;Girona;34;Selva;17023;Blanes;2;8;B;;694;406;288;0;2;404;406
17;Girona;34;Selva;17023;Blanes;3;1;A;;852;500;352;4;0;496;496
17;Girona;34;Selva;17023;Blanes;3;1;B;;943;552;391;5;8;539;547
17;Girona;34;Selva;17023;Blanes;3;2;A;;592;283;309;5;0;278;278
17;Girona;34;Selva;17023;Blanes;3;2;B;;759;342;417;3;5;334;339
17;Girona;34;Selva;17023;Blanes;3;2;C;;759;345;414;0;4;341;345
17;Girona;34;Selva;17023;Blanes;3;3;A;;718;384;334;1;3;380;383
17;Girona;34;Selva;17023;Blanes;3;3;B;;863;460;403;0;1;459;460
17;Girona;34;Selva;17023;Blanes;3;4;A;;441;276;165;0;1;275;276
17;Girona;34;Selva;17023;Blanes;3;4;B;;562;311;251;2;5;304;309
17;Girona;34;Selva;17023;Blanes;3;5;U;;1183;642;541;3;1;638;639
17;Girona;2;Alt Empordà;17029;Boadella i les Escaules;1;1;U;;200;120;80;0;4;116;120
17;Girona;15;Cerdanya;17024;Bolvir;1;1;U;;177;123;54;0;2;121;123
43;Tarragona;12;Baix Penedès;43030;Bonastre;1;1;U;;223;192;31;2;7;183;190
25;Lleida;39;Consell General d'Aran;25057;Bòrdes, es;1;1;U;;154;100;54;0;0;100;100
17;Girona;20;Gironès;17025;Bordils;1;1;U;;1047;718;329;6;6;706;712
25;Lleida;18;Garrigues;25058;Borges Blanques, les;1;1;U;;840;524;316;0;9;515;524
25;Lleida;18;Garrigues;25058;Borges Blanques, les;1;2;U;;984;619;365;4;5;610;615
25;Lleida;18;Garrigues;25058;Borges Blanques, les;2;1;U;;1088;734;354;5;10;719;729
25;Lleida;18;Garrigues;25058;Borges Blanques, les;2;2;U;;1153;765;388;5;14;746;760
43;Tarragona;8;Baix Camp;43031;Borges del Camp, les;1;1;U;;1110;841;269;13;10;818;828
17;Girona;2;Alt Empordà;17026;Borrassà;1;1;U;;404;276;128;1;1;274;275
8;Barcelona;14;Berguedà;08024;Borredà;1;1;U;;358;271;87;2;1;268;269
25;Lleida;39;Consell General d'Aran;25059;Bossòst;1;1;U;;634;469;165;2;7;460;467
43;Tarragona;37;Terra Alta;43032;Bot;1;1;U;;783;562;221;2;1;559;560
43;Tarragona;8;Baix Camp;43033;Botarell;1;1;U;;355;239;116;1;7;231;238
25;Lleida;18;Garrigues;25056;Bovera;1;1;U;;387;239;148;2;6;231;237
43;Tarragona;1;Alt Camp;43034;Bràfim;1;1;U;;482;383;99;1;7;375;382
17;Girona;34;Selva;17027;Breda;1;1;A;;665;434;231;2;10;422;432
17;Girona;34;Selva;17027;Breda;1;1;B;;800;557;243;10;5;542;547
17;Girona;34;Selva;17027;Breda;1;2;A;;486;339;147;5;6;328;334
17;Girona;34;Selva;17027;Breda;1;2;B;;572;403;169;7;3;393;396
8;Barcelona;6;Anoia;08025;Bruc, el;1;1;U;;576;408;168;1;8;399;407
8;Barcelona;24;Osona;08026;Brull, el;1;1;U;;154;117;37;0;2;115;117
17;Girona;34;Selva;17028;Brunyola i Sant Martí Sapresa;1;1;U;;336;231;105;0;1;230;231
43;Tarragona;29;Priorat;43035;Cabacés;1;1;U;;284;183;101;4;2;177;179
25;Lleida;23;Noguera;25060;Cabanabona;1;1;U;;100;63;37;0;0;63;63
17;Girona;2;Alt Empordà;17031;Cabanelles;1;1;U;;190;95;95;1;0;94;94
17;Girona;2;Alt Empordà;17030;Cabanes;1;1;U;;651;367;284;7;3;357;360
8;Barcelona;3;Alt Penedès;08027;Cabanyes, les;1;1;U;;329;268;61;4;0;264;264
25;Lleida;4;Alt Urgell;25061;Cabó;1;1;U;;130;67;63;0;1;66;67
43;Tarragona;1;Alt Camp;43036;Cabra del Camp;1;1;U;;350;229;121;0;2;227;229
8;Barcelona;6;Anoia;08028;Cabrera d'Anoia;1;1;U;;251;162;89;0;0;162;162
8;Barcelona;21;Maresme;08029;Cabrera de Mar;1;1;A;;675;450;225;1;3;446;449
8;Barcelona;21;Maresme;08029;Cabrera de Mar;1;1;B;;616;405;211;1;4;400;404
8;Barcelona;21;Maresme;08029;Cabrera de Mar;1;1;C;;794;538;256;0;3;535;538
8;Barcelona;21;Maresme;08030;Cabrils;1;1;A;;814;541;273;2;4;535;539
8;Barcelona;21;Maresme;08030;Cabrils;1;1;B;;619;416;203;2;5;409;414
8;Barcelona;21;Maresme;08030;Cabrils;1;1;C;;743;503;240;6;5;492;497
17;Girona;2;Alt Empordà;17032;Cadaqués;1;1;A;;694;476;218;6;8;462;470
17;Girona;2;Alt Empordà;17032;Cadaqués;1;1;B;;713;469;244;3;4;462;466
8;Barcelona;6;Anoia;08031;Calaf;1;1;U;;746;480;266;3;3;474;477
8;Barcelona;6;Anoia;08031;Calaf;1;2;A;;570;400;170;2;4;394;398
8;Barcelona;6;Anoia;08031;Calaf;1;2;B;;511;374;137;1;6;367;373
8;Barcelona;6;Anoia;08031;Calaf;1;2;C;;705;493;212;2;6;485;491
43;Tarragona;12;Baix Penedès;43037;Calafell;1;1;A;;668;388;280;5;2;381;383
43;Tarragona;12;Baix Penedès;43037;Calafell;1;1;B;;995;631;364;1;2;628;630
43;Tarragona;12;Baix Penedès;43037;Calafell;1;2;U;;611;410;201;2;5;403;408
43;Tarragona;12;Baix Penedès;43037;Calafell;2;1;U;;1316;905;411;2;5;898;903
43;Tarragona;12;Baix Penedès;43037;Calafell;2;2;U;;962;480;482;0;2;478;480
43;Tarragona;12;Baix Penedès;43037;Calafell;2;3;U;;1092;501;591;10;4;487;491
8;Barcelona;;;08034;Calders;1;1;U;;457;327;130;3;1;323;324
8;Barcelona;21;Maresme;08032;Caldes d'Estrac;1;1;A;;549;349;200;0;0;349;349
8;Barcelona;21;Maresme;08032;Caldes d'Estrac;1;1;B;;639;450;189;0;2;448;450
17;Girona;34;Selva;17033;Caldes de Malavella;1;1;A;;904;583;321;4;11;568;579
17;Girona;34;Selva;17033;Caldes de Malavella;1;1;B;;936;595;341;4;3;588;591
17;Girona;34;Selva;17033;Caldes de Malavella;1;2;U;;695;336;359;5;4;327;331
8;Barcelona;41;Vallès Oriental;08033;Caldes de Montbui;1;1;A;;498;316;182;1;3;312;315
8;Barcelona;41;Vallès Oriental;08033;Caldes de Montbui;1;1;B;;723;458;265;0;4;454;458
8;Barcelona;41;Vallès Oriental;08033;Caldes de Montbui;1;2;A;;718;378;340;6;0;372;372
8;Barcelona;41;Vallès Oriental;08033;Caldes de Montbui;1;2;B;;835;395;440;0;3;392;395
8;Barcelona;41;Vallès Oriental;08033;Caldes de Montbui;1;3;U;;754;515;239;2;7;506;513
8;Barcelona;41;Vallès Oriental;08033;Caldes de Montbui;2;1;A;;758;464;294;7;4;453;457
8;Barcelona;41;Vallès Oriental;08033;Caldes de Montbui;2;1;B;;971;589;382;1;6;582;588
8;Barcelona;41;Vallès Oriental;08033;Caldes de Montbui;3;1;A;;893;571;322;4;3;564;567
8;Barcelona;41;Vallès Oriental;08033;Caldes de Montbui;3;1;B;;1080;643;437;6;8;629;637
8;Barcelona;41;Vallès Oriental;08033;Caldes de Montbui;3;2;U;;788;475;313;1;1;473;474
8;Barcelona;41;Vallès Oriental;08033;Caldes de Montbui;3;3;U;;860;384;476;3;1;380;381
8;Barcelona;21;Maresme;08035;Calella;1;1;A;;522;337;185;1;2;334;336
8;Barcelona;21;Maresme;08035;Calella;1;1;B;;593;392;201;1;0;391;391
8;Barcelona;21;Maresme;08035;Calella;1;2;U;;618;418;200;0;3;415;418
8;Barcelona;21;Maresme;08035;Calella;1;3;A;;445;211;234;0;6;205;211
8;Barcelona;21;Maresme;08035;Calella;1;3;B;;588;295;293;2;4;289;293
8;Barcelona;21;Maresme;08035;Calella;2;1;U;;534;354;180;0;4;350;354
8;Barcelona;21;Maresme;08035;Calella;2;2;A;;651;438;213;0;8;430;438
8;Barcelona;21;Maresme;08035;Calella;2;2;B;;873;550;323;0;7;543;550
8;Barcelona;21;Maresme;08035;Calella;3;1;A;;739;434;305;0;3;431;434
8;Barcelona;21;Maresme;08035;Calella;3;1;B;;802;478;324;0;3;475;478
8;Barcelona;21;Maresme;08035;Calella;3;2;A;;618;323;295;2;7;314;321
8;Barcelona;21;Maresme;08035;Calella;3;2;B;;729;394;335;1;6;387;393
8;Barcelona;21;Maresme;08035;Calella;3;3;A;;646;387;259;0;0;387;387
8;Barcelona;21;Maresme;08035;Calella;3;3;B;;781;458;323;0;1;457;458
8;Barcelona;24;Osona;08037;Calldetenes;1;1;U;;1145;866;279;2;2;862;864
8;Barcelona;7;Bages;08038;Callús;1;1;A;;519;356;163;1;4;351;355
8;Barcelona;7;Bages;08038;Callús;1;1;B;;631;435;196;0;2;433;435
17;Girona;10;Baix Empordà;17034;Calonge i Sant Antoni;1;1;A;;620;384;236;0;3;381;384
17;Girona;10;Baix Empordà;17034;Calonge i Sant Antoni;1;1;B;;904;520;384;0;5;515;520
17;Girona;10;Baix Empordà;17034;Calonge i Sant Antoni;1;2;U;;763;472;291;10;3;459;462
17;Girona;10;Baix Empordà;17034;Calonge i Sant Antoni;1;3;U;;700;412;288;1;2;409;411
17;Girona;10;Baix Empordà;17034;Calonge i Sant Antoni;1;4;U;;897;461;436;1;3;457;460
8;Barcelona;6;Anoia;08036;Calonge de Segarra;1;1;U;;169;143;26;1;1;141;142
25;Lleida;23;Noguera;25062;Camarasa;1;1;U;;786;539;247;2;7;530;537
43;Tarragona;9;Baix Ebre;43903;Camarles;1;1;A;;837;596;241;6;3;587;590
43;Tarragona;9;Baix Ebre;43903;Camarles;1;1;B;;704;517;187;1;9;507;516
43;Tarragona;9;Baix Ebre;43903;Camarles;1;2;U;;746;456;290;0;2;454;456
43;Tarragona;8;Baix Camp;43038;Cambrils;1;1;A;;700;294;406;0;6;288;294
43;Tarragona;8;Baix Camp;43038;Cambrils;1;1;B;;767;371;396;0;7;364;371
43;Tarragona;8;Baix Camp;43038;Cambrils;1;2;A;;548;270;278;2;4;264;268
43;Tarragona;8;Baix Camp;43038;Cambrils;1;2;B;;715;367;348;3;4;360;364
43;Tarragona;8;Baix Camp;43038;Cambrils;1;3;A;;655;332;323;1;8;323;331
43;Tarragona;8;Baix Camp;43038;Cambrils;1;3;B;;826;435;391;5;6;424;430
43;Tarragona;8;Baix Camp;43038;Cambrils;1;4;U;;1132;468;664;1;14;453;467
43;Tarragona;8;Baix Camp;43038;Cambrils;2;1;A;;683;380;303;0;4;376;380
43;Tarragona;8;Baix Camp;43038;Cambrils;2;1;B;;688;386;302;1;8;377;385
43;Tarragona;8;Baix Camp;43038;Cambrils;2;2;A;;640;304;336;2;5;297;302
43;Tarragona;8;Baix Camp;43038;Cambrils;2;2;B;;627;281;346;0;3;278;281
43;Tarragona;8;Baix Camp;43038;Cambrils;2;3;A;;701;280;421;1;4;275;279
43;Tarragona;8;Baix Camp;43038;Cambrils;2;3;B;;833;347;486;0;4;343;347
43;Tarragona;8;Baix Camp;43038;Cambrils;2;4;A;;559;223;336;1;5;217;222
43;Tarragona;8;Baix Camp;43038;Cambrils;2;4;B;;657;284;373;0;7;277;284
43;Tarragona;8;Baix Camp;43038;Cambrils;2;5;U;;528;197;331;2;0;195;195
17;Girona;28;Pla de l'Estany;17035;Camós;1;1;U;;490;360;130;5;8;347;355
17;Girona;31;Ripollès;17036;Campdevànol;1;1;A;;428;291;137;2;3;286;289
17;Girona;31;Ripollès;17036;Campdevànol;1;1;B;;539;407;132;1;2;404;406
17;Girona;31;Ripollès;17036;Campdevànol;1;2;A;;488;344;144;4;6;334;340
17;Girona;31;Ripollès;17036;Campdevànol;1;2;B;;540;394;146;3;1;390;391
17;Girona;31;Ripollès;17036;Campdevànol;1;3;U;;776;489;287;4;6;479;485
17;Girona;31;Ripollès;17037;Campelles;1;1;U;;126;76;50;0;0;76;76
8;Barcelona;41;Vallès Oriental;08039;Campins;1;1;U;;171;119;52;0;0;119;119
17;Girona;20;Gironès;17038;Campllong;1;1;U;;220;146;74;0;0;146;146
17;Girona;31;Ripollès;17039;Camprodon;1;1;A;;560;431;129;4;9;418;427
17;Girona;31;Ripollès;17039;Camprodon;1;1;B;;796;619;177;8;6;605;611
17;Girona;31;Ripollès;17039;Camprodon;1;1;C;;502;391;111;1;3;387;390
25;Lleida;39;Consell General d'Aran;25063;Canejan;1;1;U;;103;83;20;0;0;83;83
17;Girona;20;Gironès;17040;Canet d'Adri;1;1;U;;371;255;116;1;4;250;254
8;Barcelona;21;Maresme;08040;Canet de Mar;1;1;A;;844;568;276;3;6;559;565
8;Barcelona;21;Maresme;08040;Canet de Mar;1;1;B;;1007;667;340;4;7;656;663
8;Barcelona;21;Maresme;08040;Canet de Mar;1;2;U;;1391;839;552;2;9;828;837
8;Barcelona;21;Maresme;08040;Canet de Mar;1;3;U;;1687;1043;644;0;7;1036;1043
8;Barcelona;21;Maresme;08040;Canet de Mar;1;4;A;;887;530;357;2;7;521;528
8;Barcelona;21;Maresme;08040;Canet de Mar;1;4;B;;1072;658;414;4;8;646;654
8;Barcelona;41;Vallès Oriental;08041;Canovelles;1;1;U;;1085;494;591;0;12;482;494
8;Barcelona;41;Vallès Oriental;08041;Canovelles;1;2;A;;749;431;318;3;0;428;428
8;Barcelona;41;Vallès Oriental;08041;Canovelles;1;2;B;;913;508;405;2;3;503;506
8;Barcelona;41;Vallès Oriental;08041;Canovelles;1;3;A;;637;352;285;1;6;345;351
8;Barcelona;41;Vallès Oriental;08041;Canovelles;1;3;B;;841;450;391;0;4;446;450
8;Barcelona;41;Vallès Oriental;08041;Canovelles;1;4;U;;984;468;516;4;7;457;464
8;Barcelona;41;Vallès Oriental;08041;Canovelles;1;5;A;;581;311;270;2;2;307;309
8;Barcelona;41;Vallès Oriental;08041;Canovelles;1;5;B;;748;425;323;0;3;422;425
8;Barcelona;41;Vallès Oriental;08041;Canovelles;1;6;U;;1200;616;584;1;4;611;615
8;Barcelona;41;Vallès Oriental;08041;Canovelles;1;7;U;;1242;709;533;0;8;701;709
8;Barcelona;41;Vallès Oriental;08041;Canovelles;1;8;U;;678;431;247;1;1;429;430
8;Barcelona;41;Vallès Oriental;08042;Cànoves i Samalús;1;1;U;;784;522;262;0;4;518;522
17;Girona;2;Alt Empordà;17041;Cantallops;1;1;U;;225;168;57;0;0;168;168
8;Barcelona;17;Garraf;08043;Canyelles;1;1;U;;593;342;251;2;0;340;340
43;Tarragona;8;Baix Camp;43039;Capafonts;1;1;U;;89;49;40;0;9;40;49
43;Tarragona;29;Priorat;43040;Capçanes;1;1;U;;334;251;83;5;7;239;246
8;Barcelona;6;Anoia;08044;Capellades;1;1;A;;808;518;290;5;2;511;513
8;Barcelona;6;Anoia;08044;Capellades;1;1;B;;949;595;354;1;7;587;594
8;Barcelona;6;Anoia;08044;Capellades;2;1;A;;677;453;224;2;5;446;451
8;Barcelona;6;Anoia;08044;Capellades;2;1;B;;574;360;214;0;2;358;360
8;Barcelona;6;Anoia;08044;Capellades;2;1;C;;808;554;254;0;2;552;554
17;Girona;2;Alt Empordà;17042;Capmany;1;1;U;;365;266;99;1;2;263;265
8;Barcelona;14;Berguedà;08045;Capolat;1;1;U;;57;44;13;0;1;43;44
8;Barcelona;41;Vallès Oriental;08046;Cardedeu;1;1;A;;812;491;321;0;3;488;491
8;Barcelona;41;Vallès Oriental;08046;Cardedeu;1;1;B;;939;553;386;4;11;538;549
8;Barcelona;41;Vallès Oriental;08046;Cardedeu;1;2;U;;990;664;326;0;9;655;664
8;Barcelona;41;Vallès Oriental;08046;Cardedeu;2;1;A;;838;488;350;3;5;480;485
8;Barcelona;41;Vallès Oriental;08046;Cardedeu;2;1;B;;982;576;406;0;14;562;576
8;Barcelona;41;Vallès Oriental;08046;Cardedeu;2;2;A;;723;462;261;2;5;455;460
8;Barcelona;41;Vallès Oriental;08046;Cardedeu;2;2;B;;938;534;404;5;5;524;529
8;Barcelona;41;Vallès Oriental;08046;Cardedeu;2;3;U;;668;422;246;0;8;414;422
8;Barcelona;7;Bages;08047;Cardona;1;1;A;;660;431;229;3;10;418;428
8;Barcelona;7;Bages;08047;Cardona;1;1;B;;595;389;206;1;3;385;388
8;Barcelona;7;Bages;08047;Cardona;1;1;C;;693;479;214;1;8;470;478
8;Barcelona;7;Bages;08047;Cardona;1;2;A;;635;408;227;4;2;402;404
8;Barcelona;7;Bages;08047;Cardona;1;2;B;;702;441;261;0;7;434;441
8;Barcelona;7;Bages;08047;Cardona;2;1;U;;601;367;234;3;2;362;364
8;Barcelona;7;Bages;08047;Cardona;2;2;U;;787;512;275;10;1;501;502
8;Barcelona;7;Bages;08047;Cardona;2;3;U;;579;396;183;4;7;385;392
8;Barcelona;6;Anoia;08048;Carme;1;1;U;;565;418;147;3;1;414;415
43;Tarragona;37;Terra Alta;43041;Caseres;1;1;U;;271;208;63;2;1;205;206
17;Girona;20;Gironès;17044;Cassà de la Selva;1;1;U;;891;595;296;2;9;584;593
17;Girona;20;Gironès;17044;Cassà de la Selva;1;2;A;;509;327;182;3;2;322;324
17;Girona;20;Gironès;17044;Cassà de la Selva;1;2;B;;591;371;220;1;5;365;370
17;Girona;20;Gironès;17044;Cassà de la Selva;2;1;A;;699;454;245;4;2;448;450
17;Girona;20;Gironès;17044;Cassà de la Selva;2;1;B;;789;493;296;8;7;478;485
17;Girona;20;Gironès;17044;Cassà de la Selva;2;2;A;;687;435;252;2;1;432;433
17;Girona;20;Gironès;17044;Cassà de la Selva;2;2;B;;789;489;300;2;8;479;487
17;Girona;20;Gironès;17044;Cassà de la Selva;2;3;U;;664;446;218;1;4;441;445
8;Barcelona;14;Berguedà;08049;Casserres;1;1;A;;1122;757;365;5;13;739;752
8;Barcelona;14;Berguedà;08049;Casserres;1;1;B;;327;234;93;0;3;231;234
25;Lleida;35;Solsonès;25064;Castellar de la Ribera;1;1;U;;135;99;36;0;0;99;99
8;Barcelona;14;Berguedà;08050;Castellar del Riu;1;1;U;;45;25;20;1;0;24;24
8;Barcelona;40;Vallès Occidental;08051;Castellar del Vallès;1;1;U;;1038;595;443;0;2;593;595
8;Barcelona;40;Vallès Occidental;08051;Castellar del Vallès;1;2;U;;1275;777;498;2;2;773;775
8;Barcelona;40;Vallès Occidental;08051;Castellar del Vallès;1;3;U;;1012;567;445;0;6;561;567
8;Barcelona;40;Vallès Occidental;08051;Castellar del Vallès;1;4;A;;748;438;310;1;1;436;437
8;Barcelona;40;Vallès Occidental;08051;Castellar del Vallès;1;4;B;;851;499;352;1;6;492;498
8;Barcelona;40;Vallès Occidental;08051;Castellar del Vallès;1;5;U;;1249;760;489;3;11;746;757
8;Barcelona;40;Vallès Occidental;08051;Castellar del Vallès;1;6;U;;1472;683;789;0;5;678;683
8;Barcelona;40;Vallès Occidental;08051;Castellar del Vallès;1;7;A;;559;329;230;1;1;327;328
8;Barcelona;40;Vallès Occidental;08051;Castellar del Vallès;1;7;B;;595;292;303;1;3;288;291
8;Barcelona;40;Vallès Occidental;08051;Castellar del Vallès;1;8;U;;1131;620;511;5;8;607;615
8;Barcelona;40;Vallès Occidental;08051;Castellar del Vallès;1;9;U;;512;280;232;0;6;274;280
8;Barcelona;14;Berguedà;08052;Castellar de n'Hug;1;1;U;;150;101;49;0;0;101;101
8;Barcelona;7;Bages;08053;Castellbell i el Vilar;1;1;U;;1334;879;455;4;5;870;875
8;Barcelona;7;Bages;08053;Castellbell i el Vilar;1;2;U;;1156;547;609;4;2;541;543
8;Barcelona;40;Vallès Occidental;08054;Castellbisbal;1;1;A;;672;447;225;1;11;435;446
8;Barcelona;40;Vallès Occidental;08054;Castellbisbal;1;1;B;;965;571;394;0;6;565;571
8;Barcelona;40;Vallès Occidental;08054;Castellbisbal;1;2;A;;889;444;445;2;3;439;442
8;Barcelona;40;Vallès Occidental;08054;Castellbisbal;1;2;B;;1160;641;519;1;5;635;640
8;Barcelona;;;08055;Castellcir;1;1;U;;197;141;56;2;3;136;139
25;Lleida;18;Garrigues;25067;Castelldans;1;1;U;;827;481;346;2;6;473;479
8;Barcelona;11;Baix Llobregat;08056;Castelldefels;1;1;U;;718;373;345;0;0;373;373
8;Barcelona;11;Baix Llobregat;08056;Castelldefels;1;2;A;;591;309;282;2;1;306;307
8;Barcelona;11;Baix Llobregat;08056;Castelldefels;1;2;B;;663;372;291;0;7;365;372
8;Barcelona;11;Baix Llobregat;08056;Castelldefels;1;3;A;;503;242;261;0;2;240;242
8;Barcelona;11;Baix Llobregat;08056;Castelldefels;1;3;B;;603;309;294;0;1;308;309
8;Barcelona;11;Baix Llobregat;08056;Castelldefels;1;4;A;;678;281;397;0;2;279;281
8;Barcelona;11;Baix Llobregat;08056;Castelldefels;1;4;B;;707;279;428;0;4;275;279
8;Barcelona;11;Baix Llobregat;08056;Castelldefels;1;5;A;;668;289;379;1;2;286;288
8;Barcelona;11;Baix Llobregat;08056;Castelldefels;1;5;B;;706;282;424;2;4;276;280
8;Barcelona;11;Baix Llobregat;08056;Castelldefels;1;6;A;;806;347;459;0;8;339;347
8;Barcelona;11;Baix Llobregat;08056;Castelldefels;1;6;B;;967;431;536;1;3;427;430
8;Barcelona;11;Baix Llobregat;08056;Castelldefels;1;7;U;;548;220;328;3;2;215;217
8;Barcelona;11;Baix Llobregat;08056;Castelldefels;2;1;A;;582;266;316;1;1;264;265
8;Barcelona;11;Baix Llobregat;08056;Castelldefels;2;1;B;;670;335;335;3;1;331;332
8;Barcelona;11;Baix Llobregat;08056;Castelldefels;2;2;A;;910;393;517;0;7;386;393
8;Barcelona;11;Baix Llobregat;08056;Castelldefels;2;2;B;;994;498;496;2;5;491;496
8;Barcelona;11;Baix Llobregat;08056;Castelldefels;2;3;A;;558;295;263;0;6;289;295
8;Barcelona;11;Baix Llobregat;08056;Castelldefels;2;3;B;;574;280;294;2;3;275;278
8;Barcelona;11;Baix Llobregat;08056;Castelldefels;2;4;A;;834;396;438;1;5;390;395
8;Barcelona;11;Baix Llobregat;08056;Castelldefels;2;4;B;;917;461;456;0;7;454;461
8;Barcelona;11;Baix Llobregat;08056;Castelldefels;2;5;U;;799;359;440;4;8;347;355
8;Barcelona;11;Baix Llobregat;08056;Castelldefels;3;1;A;;577;254;323;2;1;251;252
8;Barcelona;11;Baix Llobregat;08056;Castelldefels;3;1;B;;726;336;390;2;2;332;334
8;Barcelona;11;Baix Llobregat;08056;Castelldefels;3;1;C;;746;322;424;6;2;314;316
8;Barcelona;11;Baix Llobregat;08056;Castelldefels;3;2;A;;560;285;275;0;0;285;285
8;Barcelona;11;Baix Llobregat;08056;Castelldefels;3;2;B;;518;282;236;0;3;279;282
8;Barcelona;11;Baix Llobregat;08056;Castelldefels;4;1;A;;577;306;271;1;5;300;305
8;Barcelona;11;Baix Llobregat;08056;Castelldefels;4;1;B;;676;368;308;1;11;356;367
8;Barcelona;11;Baix Llobregat;08056;Castelldefels;4;2;A;;651;252;399;0;5;247;252
8;Barcelona;11;Baix Llobregat;08056;Castelldefels;4;2;B;;671;280;391;0;7;273;280
8;Barcelona;11;Baix Llobregat;08056;Castelldefels;4;2;C;;721;300;421;0;6;294;300
8;Barcelona;11;Baix Llobregat;08056;Castelldefels;5;1;U;;907;420;487;0;5;415;420
8;Barcelona;11;Baix Llobregat;08056;Castelldefels;5;2;A;;649;277;372;1;2;274;276
8;Barcelona;11;Baix Llobregat;08056;Castelldefels;5;2;B;;760;291;469;2;5;284;289
8;Barcelona;14;Berguedà;08057;Castell de l'Areny;1;1;U;;48;30;18;0;1;29;30
25;Lleida;25;Pallars Jussà;25904;Castell de Mur;1;1;U;;136;93;43;0;2;91;93
8;Barcelona;3;Alt Penedès;08058;Castellet i la Gornal;1;1;U;;433;261;172;0;2;259;261
8;Barcelona;3;Alt Penedès;08058;Castellet i la Gornal;1;2;U;;478;290;188;2;0;288;288
17;Girona;19;Garrotxa;17046;Castellfollit de la Roca;1;1;A;;443;348;95;2;15;331;346
17;Girona;19;Garrotxa;17046;Castellfollit de la Roca;1;1;B;;405;299;106;5;10;284;294
8;Barcelona;7;Bages;08059;Castellfollit del Boix;1;1;U;;278;148;130;1;3;144;147
8;Barcelona;6;Anoia;08060;Castellfollit de Riubregós;1;1;U;;224;177;47;0;1;176;177
8;Barcelona;7;Bages;08061;Castellgalí;1;1;U;;589;423;166;0;2;421;423
8;Barcelona;7;Bages;08062;Castellnou de Bages;1;1;U;;136;88;48;3;0;85;85
25;Lleida;27;Pla d'Urgell;25068;Castellnou de Seana;1;1;U;;633;395;238;2;0;393;393
17;Girona;2;Alt Empordà;17047;Castelló d'Empúries;1;1;A;;839;532;307;4;4;524;528
17;Girona;2;Alt Empordà;17047;Castelló d'Empúries;1;1;B;;821;320;501;3;4;313;317
17;Girona;2;Alt Empordà;17047;Castelló d'Empúries;1;2;A;;510;361;149;1;6;354;360
17;Girona;2;Alt Empordà;17047;Castelló d'Empúries;1;2;B;;522;363;159;3;11;349;360
25;Lleida;23;Noguera;25069;Castelló de Farfanya;1;1;U;;523;338;185;2;1;335;336
8;Barcelona;6;Anoia;08063;Castellolí;1;1;U;;342;264;78;5;6;253;259
17;Girona;10;Baix Empordà;17048;Castell-Platja d'Aro;1;1;U;;739;498;241;3;3;492;495
17;Girona;10;Baix Empordà;17048;Castell-Platja d'Aro;1;2;A;;707;352;355;3;5;344;349
17;Girona;10;Baix Empordà;17048;Castell-Platja d'Aro;1;2;B;;673;354;319;2;6;346;352
17;Girona;10;Baix Empordà;17048;Castell-Platja d'Aro;1;3;A;;789;433;356;2;5;426;431
17;Girona;10;Baix Empordà;17048;Castell-Platja d'Aro;1;3;B;;975;564;411;5;3;556;559
25;Lleida;38;Urgell;25070;Castellserà;1;1;U;;999;703;296;2;7;694;701
8;Barcelona;;;08064;Castellterçol;1;1;A;;830;625;205;11;17;597;614
8;Barcelona;;;08064;Castellterçol;1;1;B;;761;570;191;3;25;542;567
43;Tarragona;8;Baix Camp;43042;Castellvell del Camp;1;1;U;;666;450;216;1;5;444;449
8;Barcelona;3;Alt Penedès;08065;Castellví de la Marca;1;1;U;;1092;636;456;2;5;629;634
8;Barcelona;11;Baix Llobregat;08066;Castellví de Rosanes;1;1;U;;474;336;138;1;2;333;335
43;Tarragona;36;Tarragonès;43043;Catllar, el;1;1;U;;943;581;362;5;11;565;576
25;Lleida;4;Alt Urgell;25071;Cava;1;1;U;;46;22;24;0;1;21;22
17;Girona;34;Selva;17189;Cellera de Ter, la;1;1;U;;853;609;244;3;1;605;606
17;Girona;34;Selva;17189;Cellera de Ter, la;1;2;U;;782;552;230;4;0;548;548
17;Girona;20;Gironès;17049;Celrà;1;1;A;;912;556;356;0;3;553;556
17;Girona;20;Gironès;17049;Celrà;1;1;B;;994;610;384;2;2;606;608
8;Barcelona;24;Osona;08067;Centelles;1;1;A;;558;375;183;1;0;374;374
8;Barcelona;24;Osona;08067;Centelles;1;1;B;;555;366;189;2;4;360;364
8;Barcelona;24;Osona;08067;Centelles;1;2;A;;478;285;193;2;1;282;283
8;Barcelona;24;Osona;08067;Centelles;1;2;B;;498;329;169;1;2;326;328
8;Barcelona;24;Osona;08067;Centelles;1;3;A;;407;259;148;1;2;256;258
8;Barcelona;24;Osona;08067;Centelles;1;3;B;;558;378;180;0;0;378;378
8;Barcelona;24;Osona;08067;Centelles;1;4;A;;629;374;255;1;3;370;373
8;Barcelona;24;Osona;08067;Centelles;1;4;B;;877;530;347;6;0;524;524
8;Barcelona;14;Berguedà;08268;Cercs;1;1;A;;409;279;130;0;1;278;279
8;Barcelona;14;Berguedà;08268;Cercs;1;1;B;;328;177;151;0;0;177;177
8;Barcelona;14;Berguedà;08268;Cercs;1;2;U;;700;496;204;1;1;494;495
8;Barcelona;40;Vallès Occidental;08266;Cerdanyola del Vallès;1;1;A;;653;336;317;1;7;328;335
8;Barcelona;40;Vallès Occidental;08266;Cerdanyola del Vallès;1;1;B;;817;404;413;4;7;393;400
8;Barcelona;40;Vallès Occidental;08266;Cerdanyola del Vallès;1;10;A;;849;430;419;0;4;426;430
8;Barcelona;40;Vallès Occidental;08266;Cerdanyola del Vallès;1;10;B;;1097;538;559;1;8;529;537
8;Barcelona;40;Vallès Occidental;08266;Cerdanyola del Vallès;1;11;U;;788;280;508;0;0;280;280
8;Barcelona;40;Vallès Occidental;08266;Cerdanyola del Vallès;1;12;A;;843;443;400;0;4;439;443
8;Barcelona;40;Vallès Occidental;08266;Cerdanyola del Vallès;1;12;B;;1026;505;521;2;7;496;503
8;Barcelona;40;Vallès Occidental;08266;Cerdanyola del Vallès;1;13;A;;906;417;489;0;7;410;417
8;Barcelona;40;Vallès Occidental;08266;Cerdanyola del Vallès;1;13;B;;1033;443;590;0;4;439;443
8;Barcelona;40;Vallès Occidental;08266;Cerdanyola del Vallès;1;14;A;;821;416;405;2;4;410;414
8;Barcelona;40;Vallès Occidental;08266;Cerdanyola del Vallès;1;14;B;;886;438;448;2;7;429;436
8;Barcelona;40;Vallès Occidental;08266;Cerdanyola del Vallès;1;15;A;;825;354;471;1;7;346;353
8;Barcelona;40;Vallès Occidental;08266;Cerdanyola del Vallès;1;15;B;;953;443;510;1;6;436;442
8;Barcelona;40;Vallès Occidental;08266;Cerdanyola del Vallès;1;16;A;;758;405;353;2;4;399;403
8;Barcelona;40;Vallès Occidental;08266;Cerdanyola del Vallès;1;16;B;;794;404;390;1;3;400;403
8;Barcelona;40;Vallès Occidental;08266;Cerdanyola del Vallès;1;17;A;;927;406;521;0;9;397;406
8;Barcelona;40;Vallès Occidental;08266;Cerdanyola del Vallès;1;17;B;;972;431;541;1;8;422;430
8;Barcelona;40;Vallès Occidental;08266;Cerdanyola del Vallès;1;18;A;;779;412;367;0;3;409;412
8;Barcelona;40;Vallès Occidental;08266;Cerdanyola del Vallès;1;18;B;;876;439;437;0;1;438;439
8;Barcelona;40;Vallès Occidental;08266;Cerdanyola del Vallès;1;19;A;;775;372;403;1;6;365;371
8;Barcelona;40;Vallès Occidental;08266;Cerdanyola del Vallès;1;19;B;;967;452;515;0;0;452;452
8;Barcelona;40;Vallès Occidental;08266;Cerdanyola del Vallès;1;2;A;;612;283;329;4;6;273;279
8;Barcelona;40;Vallès Occidental;08266;Cerdanyola del Vallès;1;2;B;;767;381;386;1;6;374;380
8;Barcelona;40;Vallès Occidental;08266;Cerdanyola del Vallès;1;20;U;;1398;942;456;1;23;918;941
8;Barcelona;40;Vallès Occidental;08266;Cerdanyola del Vallès;1;21;U;;1140;459;681;2;5;452;457
8;Barcelona;40;Vallès Occidental;08266;Cerdanyola del Vallès;1;22;U;;870;300;570;0;5;295;300
8;Barcelona;40;Vallès Occidental;08266;Cerdanyola del Vallès;1;23;U;;1217;461;756;5;6;450;456
8;Barcelona;40;Vallès Occidental;08266;Cerdanyola del Vallès;1;24;U;;1174;427;747;0;5;422;427
8;Barcelona;40;Vallès Occidental;08266;Cerdanyola del Vallès;1;25;U;;1150;398;752;2;3;393;396
8;Barcelona;40;Vallès Occidental;08266;Cerdanyola del Vallès;1;26;U;;1451;529;922;2;4;523;527
8;Barcelona;40;Vallès Occidental;08266;Cerdanyola del Vallès;1;27;A;;767;337;430;1;4;332;336
8;Barcelona;40;Vallès Occidental;08266;Cerdanyola del Vallès;1;27;B;;803;358;445;0;4;354;358
8;Barcelona;40;Vallès Occidental;08266;Cerdanyola del Vallès;1;28;U;;851;467;384;0;7;460;467
8;Barcelona;40;Vallès Occidental;08266;Cerdanyola del Vallès;1;29;U;;1096;546;550;4;5;537;542
8;Barcelona;40;Vallès Occidental;08266;Cerdanyola del Vallès;1;3;A;;711;319;392;2;4;313;317
8;Barcelona;40;Vallès Occidental;08266;Cerdanyola del Vallès;1;3;B;;890;429;461;0;4;425;429
8;Barcelona;40;Vallès Occidental;08266;Cerdanyola del Vallès;1;4;A;;883;383;500;0;3;380;383
8;Barcelona;40;Vallès Occidental;08266;Cerdanyola del Vallès;1;4;B;;971;449;522;2;7;440;447
8;Barcelona;40;Vallès Occidental;08266;Cerdanyola del Vallès;1;5;A;;1029;471;558;1;4;466;470
8;Barcelona;40;Vallès Occidental;08266;Cerdanyola del Vallès;1;5;B;;1083;475;608;4;6;465;471
8;Barcelona;40;Vallès Occidental;08266;Cerdanyola del Vallès;1;6;U;;957;442;515;0;6;436;442
8;Barcelona;40;Vallès Occidental;08266;Cerdanyola del Vallès;1;7;U;;513;271;242;1;3;267;270
8;Barcelona;40;Vallès Occidental;08266;Cerdanyola del Vallès;1;8;A;;665;296;369;0;1;295;296
8;Barcelona;40;Vallès Occidental;08266;Cerdanyola del Vallès;1;8;B;;793;389;404;7;0;382;382
8;Barcelona;40;Vallès Occidental;08266;Cerdanyola del Vallès;1;9;A;;832;420;412;0;5;415;420
8;Barcelona;40;Vallès Occidental;08266;Cerdanyola del Vallès;1;9;B;;995;520;475;0;7;513;520
8;Barcelona;11;Baix Llobregat;08068;Cervelló;1;1;A;;837;403;434;3;4;396;400
8;Barcelona;11;Baix Llobregat;08068;Cervelló;1;1;B;;968;479;489;3;5;471;476
8;Barcelona;11;Baix Llobregat;08068;Cervelló;1;2;U;;776;481;295;2;8;471;479
8;Barcelona;11;Baix Llobregat;08068;Cervelló;1;3;A;;714;405;309;1;8;396;404
8;Barcelona;11;Baix Llobregat;08068;Cervelló;1;3;B;;773;484;289;5;7;472;479
25;Lleida;32;Segarra;25072;Cervera;1;1;A;;633;395;238;2;2;391;393
25;Lleida;32;Segarra;25072;Cervera;1;1;B;;765;472;293;1;3;468;471
25;Lleida;32;Segarra;25072;Cervera;2;1;A;;697;467;230;2;10;455;465
25;Lleida;32;Segarra;25072;Cervera;2;1;B;;828;565;263;0;7;558;565
25;Lleida;32;Segarra;25072;Cervera;2;2;A;;858;525;333;5;2;518;520
25;Lleida;32;Segarra;25072;Cervera;2;2;B;;949;599;350;1;13;585;598
25;Lleida;32;Segarra;25072;Cervera;3;1;U;;843;518;325;7;11;500;511
25;Lleida;18;Garrigues;25073;Cervià de les Garrigues;1;1;U;;754;445;309;0;4;441;445
17;Girona;20;Gironès;17050;Cervià de Ter;1;1;U;;499;367;132;2;6;359;365
17;Girona;2;Alt Empordà;17051;Cistella;1;1;U;;174;127;47;0;3;124;127
25;Lleida;38;Urgell;25074;Ciutadilla;1;1;U;;199;132;67;0;0;132;132
25;Lleida;35;Solsonès;25075;Clariana de Cardener;1;1;U;;123;92;31;1;1;90;91
25;Lleida;18;Garrigues;25076;Cogul, el;1;1;U;;198;120;78;0;0;120;120
17;Girona;2;Alt Empordà;17054;Colera;1;1;U;;367;250;117;3;1;246;247
8;Barcelona;11;Baix Llobregat;08069;Collbató;1;1;U;;871;513;358;5;7;501;508
43;Tarragona;8;Baix Camp;43045;Colldejou;1;1;U;;136;79;57;0;2;77;79
25;Lleida;4;Alt Urgell;25077;Coll de Nargó;1;1;U;;552;326;226;2;0;324;324
8;Barcelona;;;08070;Collsuspina;1;1;U;;176;128;48;0;1;127;128
17;Girona;10;Baix Empordà;17055;Colomers;1;1;U;;180;138;42;0;0;138;138
25;Lleida;35;Solsonès;25163;Coma i la Pedra, la;1;1;U;;203;133;70;3;0;130;130
25;Lleida;25;Pallars Jussà;25161;Conca de Dalt;1;1;U;;404;202;202;0;1;201;202
43;Tarragona;16;Conca de Barberà;43046;Conesa;1;1;U;;121;62;59;0;3;59;62
43;Tarragona;36;Tarragonès;43047;Constantí;1;1;A;;550;343;207;2;6;335;341
43;Tarragona;36;Tarragonès;43047;Constantí;1;1;B;;606;385;221;2;0;383;383
43;Tarragona;36;Tarragonès;43047;Constantí;1;2;A;;641;230;411;0;3;227;230
43;Tarragona;36;Tarragonès;43047;Constantí;1;2;B;;760;324;436;0;2;322;324
43;Tarragona;36;Tarragonès;43047;Constantí;2;1;A;;597;348;249;1;5;342;347
43;Tarragona;36;Tarragonès;43047;Constantí;2;1;B;;880;488;392;1;11;476;487
8;Barcelona;6;Anoia;08071;Copons;1;1;U;;247;168;79;1;2;165;167
43;Tarragona;37;Terra Alta;43048;Corbera d'Ebre;1;1;U;;929;512;417;8;7;497;504
8;Barcelona;11;Baix Llobregat;08072;Corbera de Llobregat;1;1;A;;658;370;288;1;2;367;369
8;Barcelona;11;Baix Llobregat;08072;Corbera de Llobregat;1;1;B;;614;333;281;1;5;327;332
8;Barcelona;11;Baix Llobregat;08072;Corbera de Llobregat;1;2;A;;539;326;213;3;2;321;323
8;Barcelona;11;Baix Llobregat;08072;Corbera de Llobregat;1;2;B;;543;308;235;3;4;301;305
8;Barcelona;11;Baix Llobregat;08072;Corbera de Llobregat;1;3;A;;527;284;243;4;9;271;280
8;Barcelona;11;Baix Llobregat;08072;Corbera de Llobregat;1;3;B;;538;281;257;0;1;280;281
8;Barcelona;11;Baix Llobregat;08072;Corbera de Llobregat;1;3;C;;513;289;224;1;4;284;288
25;Lleida;33;Segrià;25078;Corbins;1;1;U;;840;487;353;0;12;475;487
17;Girona;10;Baix Empordà;17057;Corçà;1;1;U;;880;549;331;3;1;545;546
8;Barcelona;11;Baix Llobregat;08073;Cornellà de Llobregat;1;1;A;;623;347;276;0;4;343;347
8;Barcelona;11;Baix Llobregat;08073;Cornellà de Llobregat;1;1;B;;796;451;345;0;3;448;451
8;Barcelona;11;Baix Llobregat;08073;Cornellà de Llobregat;1;10;A;;623;331;292;1;3;327;330
8;Barcelona;11;Baix Llobregat;08073;Cornellà de Llobregat;1;10;B;;712;357;355;0;3;354;357
8;Barcelona;11;Baix Llobregat;08073;Cornellà de Llobregat;1;11;U;;874;376;498;0;3;373;376
8;Barcelona;11;Baix Llobregat;08073;Cornellà de Llobregat;1;12;U;;891;342;549;3;3;336;339
8;Barcelona;11;Baix Llobregat;08073;Cornellà de Llobregat;1;13;A;;563;266;297;0;1;265;266
8;Barcelona;11;Baix Llobregat;08073;Cornellà de Llobregat;1;13;B;;551;249;302;0;5;244;249
8;Barcelona;11;Baix Llobregat;08073;Cornellà de Llobregat;1;14;U;;905;467;438;0;3;464;467
8;Barcelona;11;Baix Llobregat;08073;Cornellà de Llobregat;1;2;A;;684;368;316;1;5;362;367
8;Barcelona;11;Baix Llobregat;08073;Cornellà de Llobregat;1;2;B;;764;367;397;1;3;363;366
8;Barcelona;11;Baix Llobregat;08073;Cornellà de Llobregat;1;3;A;;573;247;326;1;3;243;246
8;Barcelona;11;Baix Llobregat;08073;Cornellà de Llobregat;1;3;B;;633;291;342;3;5;283;288
8;Barcelona;11;Baix Llobregat;08073;Cornellà de Llobregat;1;4;U;;953;438;515;1;9;428;437
8;Barcelona;11;Baix Llobregat;08073;Cornellà de Llobregat;1;5;U;;836;385;451;0;4;381;385
8;Barcelona;11;Baix Llobregat;08073;Cornellà de Llobregat;1;6;U;;497;289;208;0;2;287;289
8;Barcelona;11;Baix Llobregat;08073;Cornellà de Llobregat;1;7;A;;577;328;249;0;0;328;328
8;Barcelona;11;Baix Llobregat;08073;Cornellà de Llobregat;1;7;B;;676;387;289;0;5;382;387
8;Barcelona;11;Baix Llobregat;08073;Cornellà de Llobregat;1;8;A;;499;197;302;0;1;196;197
8;Barcelona;11;Baix Llobregat;08073;Cornellà de Llobregat;1;8;B;;518;206;312;0;0;206;206
8;Barcelona;11;Baix Llobregat;08073;Cornellà de Llobregat;1;9;A;;487;258;229;0;2;256;258
8;Barcelona;11;Baix Llobregat;08073;Cornellà de Llobregat;1;9;B;;512;284;228;1;1;282;283
8;Barcelona;11;Baix Llobregat;08073;Cornellà de Llobregat;2;1;U;;825;376;449;3;2;371;373
8;Barcelona;11;Baix Llobregat;08073;Cornellà de Llobregat;2;2;U;;999;490;509;1;2;487;489
8;Barcelona;11;Baix Llobregat;08073;Cornellà de Llobregat;3;1;A;;457;242;215;0;9;233;242
8;Barcelona;11;Baix Llobregat;08073;Cornellà de Llobregat;3;1;B;;489;224;265;0;3;221;224
8;Barcelona;11;Baix Llobregat;08073;Cornellà de Llobregat;3;2;A;;525;224;301;0;2;222;224
8;Barcelona;11;Baix Llobregat;08073;Cornellà de Llobregat;3;2;B;;581;259;322;2;2;255;257
8;Barcelona;11;Baix Llobregat;08073;Cornellà de Llobregat;3;3;U;;734;355;379;2;1;352;353
8;Barcelona;11;Baix Llobregat;08073;Cornellà de Llobregat;3;4;U;;442;180;262;0;3;177;180
8;Barcelona;11;Baix Llobregat;08073;Cornellà de Llobregat;3;5;U;;854;382;472;0;6;376;382
8;Barcelona;11;Baix Llobregat;08073;Cornellà de Llobregat;3;6;U;;694;383;311;0;5;378;383
8;Barcelona;11;Baix Llobregat;08073;Cornellà de Llobregat;3;7;A;;461;241;220;1;4;236;240
8;Barcelona;11;Baix Llobregat;08073;Cornellà de Llobregat;3;7;B;;554;251;303;0;3;248;251
8;Barcelona;11;Baix Llobregat;08073;Cornellà de Llobregat;3;8;U;;823;330;493;2;1;327;328
8;Barcelona;11;Baix Llobregat;08073;Cornellà de Llobregat;3;9;A;;495;201;294;0;0;201;201
8;Barcelona;11;Baix Llobregat;08073;Cornellà de Llobregat;3;9;B;;572;236;336;0;3;233;236
8;Barcelona;11;Baix Llobregat;08073;Cornellà de Llobregat;4;1;A;;568;260;308;2;4;254;258
8;Barcelona;11;Baix Llobregat;08073;Cornellà de Llobregat;4;1;B;;705;314;391;0;0;314;314
8;Barcelona;11;Baix Llobregat;08073;Cornellà de Llobregat;4;10;A;;498;245;253;1;1;243;244
8;Barcelona;11;Baix Llobregat;08073;Cornellà de Llobregat;4;10;B;;578;300;278;2;1;297;298
8;Barcelona;11;Baix Llobregat;08073;Cornellà de Llobregat;4;11;A;;503;231;272;0;2;229;231
8;Barcelona;11;Baix Llobregat;08073;Cornellà de Llobregat;4;11;B;;561;249;312;5;0;244;244
8;Barcelona;11;Baix Llobregat;08073;Cornellà de Llobregat;4;12;A;;652;320;332;1;5;314;319
8;Barcelona;11;Baix Llobregat;08073;Cornellà de Llobregat;4;12;B;;730;358;372;0;4;354;358
8;Barcelona;11;Baix Llobregat;08073;Cornellà de Llobregat;4;13;A;;683;333;350;0;1;332;333
8;Barcelona;11;Baix Llobregat;08073;Cornellà de Llobregat;4;13;B;;748;338;410;2;4;332;336
8;Barcelona;11;Baix Llobregat;08073;Cornellà de Llobregat;4;14;A;;506;234;272;0;3;231;234
8;Barcelona;11;Baix Llobregat;08073;Cornellà de Llobregat;4;14;B;;577;256;321;1;6;249;255
8;Barcelona;11;Baix Llobregat;08073;Cornellà de Llobregat;4;15;A;;432;211;221;1;2;208;210
8;Barcelona;11;Baix Llobregat;08073;Cornellà de Llobregat;4;15;B;;522;276;246;0;4;272;276
8;Barcelona;11;Baix Llobregat;08073;Cornellà de Llobregat;4;16;A;;632;303;329;0;4;299;303
8;Barcelona;11;Baix Llobregat;08073;Cornellà de Llobregat;4;16;B;;667;337;330;0;4;333;337
8;Barcelona;11;Baix Llobregat;08073;Cornellà de Llobregat;4;17;A;;606;269;337;0;1;268;269
8;Barcelona;11;Baix Llobregat;08073;Cornellà de Llobregat;4;17;B;;662;279;383;0;2;277;279
8;Barcelona;11;Baix Llobregat;08073;Cornellà de Llobregat;4;18;U;;848;387;461;0;0;387;387
8;Barcelona;11;Baix Llobregat;08073;Cornellà de Llobregat;4;19;U;;856;357;499;1;1;355;356
8;Barcelona;11;Baix Llobregat;08073;Cornellà de Llobregat;4;2;U;;702;321;381;1;3;317;320
8;Barcelona;11;Baix Llobregat;08073;Cornellà de Llobregat;4;3;A;;616;273;343;0;5;268;273
8;Barcelona;11;Baix Llobregat;08073;Cornellà de Llobregat;4;3;B;;752;348;404;1;3;344;347
8;Barcelona;11;Baix Llobregat;08073;Cornellà de Llobregat;4;4;A;;522;263;259;0;2;261;263
8;Barcelona;11;Baix Llobregat;08073;Cornellà de Llobregat;4;4;B;;572;304;268;3;0;301;301
8;Barcelona;11;Baix Llobregat;08073;Cornellà de Llobregat;4;5;A;;434;211;223;0;2;209;211
8;Barcelona;11;Baix Llobregat;08073;Cornellà de Llobregat;4;5;B;;500;260;240;0;2;258;260
8;Barcelona;11;Baix Llobregat;08073;Cornellà de Llobregat;4;6;A;;710;304;406;0;2;302;304
8;Barcelona;11;Baix Llobregat;08073;Cornellà de Llobregat;4;6;B;;759;361;398;0;3;358;361
8;Barcelona;11;Baix Llobregat;08073;Cornellà de Llobregat;4;7;A;;469;215;254;1;5;209;214
8;Barcelona;11;Baix Llobregat;08073;Cornellà de Llobregat;4;7;B;;565;284;281;0;6;278;284
8;Barcelona;11;Baix Llobregat;08073;Cornellà de Llobregat;4;8;A;;681;301;380;0;4;297;301
8;Barcelona;11;Baix Llobregat;08073;Cornellà de Llobregat;4;8;B;;667;327;340;0;3;324;327
8;Barcelona;11;Baix Llobregat;08073;Cornellà de Llobregat;4;9;U;;887;467;420;0;7;460;467
8;Barcelona;11;Baix Llobregat;08073;Cornellà de Llobregat;5;1;U;;786;387;399;0;4;383;387
8;Barcelona;11;Baix Llobregat;08073;Cornellà de Llobregat;5;10;A;;582;275;307;2;1;272;273
8;Barcelona;11;Baix Llobregat;08073;Cornellà de Llobregat;5;10;B;;584;269;315;1;3;265;268
8;Barcelona;11;Baix Llobregat;08073;Cornellà de Llobregat;5;2;U;;791;308;483;4;6;298;304
8;Barcelona;11;Baix Llobregat;08073;Cornellà de Llobregat;5;3;A;;537;254;283;5;4;245;249
8;Barcelona;11;Baix Llobregat;08073;Cornellà de Llobregat;5;3;B;;496;226;270;1;0;225;225
8;Barcelona;11;Baix Llobregat;08073;Cornellà de Llobregat;5;4;U;;794;391;403;1;5;385;390
8;Barcelona;11;Baix Llobregat;08073;Cornellà de Llobregat;5;5;U;;911;406;505;1;3;402;405
8;Barcelona;11;Baix Llobregat;08073;Cornellà de Llobregat;5;6;A;;487;221;266;2;1;218;219
8;Barcelona;11;Baix Llobregat;08073;Cornellà de Llobregat;5;6;B;;570;243;327;2;3;238;241
8;Barcelona;11;Baix Llobregat;08073;Cornellà de Llobregat;5;7;A;;548;262;286;0;4;258;262
8;Barcelona;11;Baix Llobregat;08073;Cornellà de Llobregat;5;7;B;;651;285;366;0;1;284;285
8;Barcelona;11;Baix Llobregat;08073;Cornellà de Llobregat;5;8;A;;487;235;252;0;3;232;235
8;Barcelona;11;Baix Llobregat;08073;Cornellà de Llobregat;5;8;B;;478;218;260;2;3;213;216
8;Barcelona;11;Baix Llobregat;08073;Cornellà de Llobregat;5;9;U;;844;407;437;1;7;399;406
8;Barcelona;11;Baix Llobregat;08073;Cornellà de Llobregat;6;1;U;;635;270;365;0;0;270;270
8;Barcelona;11;Baix Llobregat;08073;Cornellà de Llobregat;6;10;U;;892;433;459;0;2;431;433
8;Barcelona;11;Baix Llobregat;08073;Cornellà de Llobregat;6;11;U;;575;231;344;0;1;230;231
8;Barcelona;11;Baix Llobregat;08073;Cornellà de Llobregat;6;12;U;;741;318;423;0;1;317;318
8;Barcelona;11;Baix Llobregat;08073;Cornellà de Llobregat;6;13;U;;724;319;405;2;3;314;317
8;Barcelona;11;Baix Llobregat;08073;Cornellà de Llobregat;6;14;U;;923;378;545;2;4;372;376
8;Barcelona;11;Baix Llobregat;08073;Cornellà de Llobregat;6;15;U;;792;386;406;1;9;376;385
8;Barcelona;11;Baix Llobregat;08073;Cornellà de Llobregat;6;16;U;;675;285;390;0;4;281;285
8;Barcelona;11;Baix Llobregat;08073;Cornellà de Llobregat;6;2;A;;521;266;255;3;2;261;263
8;Barcelona;11;Baix Llobregat;08073;Cornellà de Llobregat;6;2;B;;574;296;278;1;1;294;295
8;Barcelona;11;Baix Llobregat;08073;Cornellà de Llobregat;6;3;U;;589;269;320;0;2;267;269
8;Barcelona;11;Baix Llobregat;08073;Cornellà de Llobregat;6;4;U;;692;288;404;3;4;281;285
8;Barcelona;11;Baix Llobregat;08073;Cornellà de Llobregat;6;5;U;;820;349;471;3;6;340;346
8;Barcelona;11;Baix Llobregat;08073;Cornellà de Llobregat;6;6;U;;642;279;363;4;1;274;275
8;Barcelona;11;Baix Llobregat;08073;Cornellà de Llobregat;6;7;A;;467;223;244;3;0;220;220
8;Barcelona;11;Baix Llobregat;08073;Cornellà de Llobregat;6;7;B;;562;257;305;1;1;255;256
8;Barcelona;11;Baix Llobregat;08073;Cornellà de Llobregat;6;8;U;;713;310;403;2;1;307;308
8;Barcelona;11;Baix Llobregat;08073;Cornellà de Llobregat;6;9;A;;565;275;290;0;3;272;275
8;Barcelona;11;Baix Llobregat;08073;Cornellà de Llobregat;6;9;B;;722;348;374;3;4;341;345
8;Barcelona;11;Baix Llobregat;08073;Cornellà de Llobregat;6;9;C;;648;313;335;1;1;311;312
17;Girona;28;Pla de l'Estany;17056;Cornellà del Terri;1;1;A;;658;451;207;2;8;441;449
17;Girona;28;Pla de l'Estany;17056;Cornellà del Terri;1;1;B;;747;512;235;2;13;497;510
43;Tarragona;29;Priorat;43049;Cornudella de Montsant;1;1;U;;756;551;205;7;5;539;544
43;Tarragona;36;Tarragonès;43050;Creixell;1;1;U;;797;504;293;5;4;495;499
17;Girona;28;Pla de l'Estany;17058;Crespià;1;1;U;;170;100;70;0;1;99;100
17;Girona;10;Baix Empordà;17901;Cruïlles, Monells i Sant Sadurní;1;1;A;;413;240;173;0;3;237;240
17;Girona;10;Baix Empordà;17901;Cruïlles, Monells i Sant Sadurní;1;1;B;;214;145;69;0;2;143;145
17;Girona;10;Baix Empordà;17901;Cruïlles, Monells i Sant Sadurní;1;1;C;;194;137;57;1;3;133;136
8;Barcelona;17;Garraf;08074;Cubelles;1;1;U;;511;324;187;3;5;316;321
8;Barcelona;17;Garraf;08074;Cubelles;1;2;U;;925;534;391;0;8;526;534
8;Barcelona;17;Garraf;08074;Cubelles;1;3;U;;1020;499;521;3;4;492;496
25;Lleida;23;Noguera;25079;Cubells;1;1;U;;332;258;74;4;0;254;254
43;Tarragona;12;Baix Penedès;43051;Cunit;1;1;A;;660;302;358;7;4;291;295
43;Tarragona;12;Baix Penedès;43051;Cunit;1;1;B;;687;284;403;6;3;275;278
43;Tarragona;12;Baix Penedès;43051;Cunit;1;1;C;;741;343;398;6;3;334;337
17;Girona;2;Alt Empordà;17060;Darnius;1;1;U;;388;281;107;2;6;273;279
17;Girona;15;Cerdanya;17061;Das;1;1;U;;122;87;35;1;4;82;86
43;Tarragona;9;Baix Ebre;43901;Deltebre;1;1;A;;719;432;287;0;4;428;432
43;Tarragona;9;Baix Ebre;43901;Deltebre;1;1;B;;627;383;244;0;2;381;383
43;Tarragona;9;Baix Ebre;43901;Deltebre;1;2;A;;1012;603;409;1;5;597;602
43;Tarragona;9;Baix Ebre;43901;Deltebre;1;2;B;;762;454;308;3;4;447;451
43;Tarragona;9;Baix Ebre;43901;Deltebre;1;3;A;;598;364;234;0;2;362;364
43;Tarragona;9;Baix Ebre;43901;Deltebre;1;3;B;;444;280;164;1;4;275;279
43;Tarragona;9;Baix Ebre;43901;Deltebre;1;4;A;;779;466;313;2;13;451;464
43;Tarragona;9;Baix Ebre;43901;Deltebre;1;4;B;;454;272;182;1;4;267;271
43;Tarragona;9;Baix Ebre;43901;Deltebre;1;5;A;;618;351;267;4;7;340;347
43;Tarragona;9;Baix Ebre;43901;Deltebre;1;5;B;;555;297;258;0;9;288;297
43;Tarragona;9;Baix Ebre;43901;Deltebre;1;6;A;;824;508;316;1;5;502;507
43;Tarragona;9;Baix Ebre;43901;Deltebre;1;6;B;;625;368;257;4;4;360;364
8;Barcelona;21;Maresme;08075;Dosrius;1;1;A;;743;429;314;1;4;424;428
8;Barcelona;21;Maresme;08075;Dosrius;1;1;B;;351;251;100;0;0;251;251
43;Tarragona;8;Baix Camp;43053;Duesaigües;1;1;U;;184;135;49;0;4;131;135
17;Girona;2;Alt Empordà;17062;Escala, l';1;1;U;;990;608;382;0;6;602;608
17;Girona;2;Alt Empordà;17062;Escala, l';1;2;A;;960;552;408;6;7;539;546
17;Girona;2;Alt Empordà;17062;Escala, l';1;2;B;;1012;579;433;1;8;570;578
17;Girona;2;Alt Empordà;17062;Escala, l';1;3;U;;1020;616;404;2;7;607;614
8;Barcelona;11;Baix Llobregat;08076;Esparreguera;1;1;A;;572;332;240;0;2;330;332
8;Barcelona;11;Baix Llobregat;08076;Esparreguera;1;1;B;;624;364;260;5;2;357;359
8;Barcelona;11;Baix Llobregat;08076;Esparreguera;1;2;A;;532;299;233;1;5;293;298
8;Barcelona;11;Baix Llobregat;08076;Esparreguera;1;2;B;;644;380;264;3;2;375;377
8;Barcelona;11;Baix Llobregat;08076;Esparreguera;1;3;A;;575;356;219;1;2;353;355
8;Barcelona;11;Baix Llobregat;08076;Esparreguera;1;3;B;;749;485;264;2;1;482;483
8;Barcelona;11;Baix Llobregat;08076;Esparreguera;1;4;A;;516;329;187;3;6;320;326
8;Barcelona;11;Baix Llobregat;08076;Esparreguera;1;4;B;;619;362;257;2;3;357;360
8;Barcelona;11;Baix Llobregat;08076;Esparreguera;1;5;U;;591;304;287;4;3;297;300
8;Barcelona;11;Baix Llobregat;08076;Esparreguera;2;1;A;;569;332;237;0;3;329;332
8;Barcelona;11;Baix Llobregat;08076;Esparreguera;2;1;B;;700;390;310;1;2;387;389
8;Barcelona;11;Baix Llobregat;08076;Esparreguera;2;2;A;;608;290;318;0;1;289;290
8;Barcelona;11;Baix Llobregat;08076;Esparreguera;2;2;B;;713;346;367;0;5;341;346
8;Barcelona;11;Baix Llobregat;08076;Esparreguera;2;3;U;;832;506;326;2;8;496;504
8;Barcelona;11;Baix Llobregat;08076;Esparreguera;2;4;U;;670;372;298;1;6;365;371
17;Girona;24;Osona;17063;Espinelves;1;1;U;;189;131;58;2;0;129;129
25;Lleida;18;Garrigues;25081;Espluga Calba, l';1;1;U;;380;244;136;2;6;236;242
43;Tarragona;16;Conca de Barberà;43054;Espluga de Francolí, l';1;1;A;;578;365;213;2;4;359;363
43;Tarragona;16;Conca de Barberà;43054;Espluga de Francolí, l';1;1;B;;408;231;177;0;2;229;231
43;Tarragona;16;Conca de Barberà;43054;Espluga de Francolí, l';1;1;C;;723;447;276;5;4;438;442
43;Tarragona;16;Conca de Barberà;43054;Espluga de Francolí, l';2;1;A;;477;302;175;7;4;291;295
43;Tarragona;16;Conca de Barberà;43054;Espluga de Francolí, l';2;1;B;;648;400;248;0;5;395;400
8;Barcelona;11;Baix Llobregat;08077;Esplugues de Llobregat;1;1;A;;592;315;277;0;4;311;315
8;Barcelona;11;Baix Llobregat;08077;Esplugues de Llobregat;1;1;B;;747;378;369;0;3;375;378
8;Barcelona;11;Baix Llobregat;08077;Esplugues de Llobregat;1;2;A;;895;455;440;3;10;442;452
8;Barcelona;11;Baix Llobregat;08077;Esplugues de Llobregat;1;2;B;;988;523;465;2;7;514;521
8;Barcelona;11;Baix Llobregat;08077;Esplugues de Llobregat;1;3;U;;990;494;496;0;2;492;494
8;Barcelona;11;Baix Llobregat;08077;Esplugues de Llobregat;1;4;A;;550;312;238;0;5;307;312
8;Barcelona;11;Baix Llobregat;08077;Esplugues de Llobregat;1;4;B;;620;348;272;0;1;347;348
8;Barcelona;11;Baix Llobregat;08077;Esplugues de Llobregat;1;5;A;;638;404;234;0;5;399;404
8;Barcelona;11;Baix Llobregat;08077;Esplugues de Llobregat;1;5;B;;670;405;265;0;5;400;405
8;Barcelona;11;Baix Llobregat;08077;Esplugues de Llobregat;1;6;A;;561;310;251;1;4;305;309
8;Barcelona;11;Baix Llobregat;08077;Esplugues de Llobregat;1;6;B;;653;333;320;1;9;323;332
8;Barcelona;11;Baix Llobregat;08077;Esplugues de Llobregat;1;7;A;;540;312;228;1;7;304;311
8;Barcelona;11;Baix Llobregat;08077;Esplugues de Llobregat;1;7;B;;565;350;215;0;7;343;350
8;Barcelona;11;Baix Llobregat;08077;Esplugues de Llobregat;1;8;U;;655;329;326;3;4;322;326
8;Barcelona;11;Baix Llobregat;08077;Esplugues de Llobregat;2;1;U;;815;459;356;0;14;445;459
8;Barcelona;11;Baix Llobregat;08077;Esplugues de Llobregat;2;2;U;;748;426;322;0;9;417;426
8;Barcelona;11;Baix Llobregat;08077;Esplugues de Llobregat;3;1;A;;884;496;388;1;6;489;495
8;Barcelona;11;Baix Llobregat;08077;Esplugues de Llobregat;3;1;B;;1057;564;493;2;0;562;562
8;Barcelona;11;Baix Llobregat;08077;Esplugues de Llobregat;3;2;A;;646;301;345;0;6;295;301
8;Barcelona;11;Baix Llobregat;08077;Esplugues de Llobregat;3;2;B;;807;383;424;1;2;380;382
8;Barcelona;11;Baix Llobregat;08077;Esplugues de Llobregat;3;3;A;;1016;444;572;1;9;434;443
8;Barcelona;11;Baix Llobregat;08077;Esplugues de Llobregat;3;3;B;;1011;478;533;1;5;472;477
8;Barcelona;11;Baix Llobregat;08077;Esplugues de Llobregat;3;4;A;;635;314;321;1;3;310;313
8;Barcelona;11;Baix Llobregat;08077;Esplugues de Llobregat;3;4;B;;819;375;444;2;4;369;373
8;Barcelona;11;Baix Llobregat;08077;Esplugues de Llobregat;3;5;A;;634;291;343;1;2;288;290
8;Barcelona;11;Baix Llobregat;08077;Esplugues de Llobregat;3;5;B;;699;322;377;2;4;316;320
8;Barcelona;11;Baix Llobregat;08077;Esplugues de Llobregat;3;6;A;;804;388;416;3;1;384;385
8;Barcelona;11;Baix Llobregat;08077;Esplugues de Llobregat;3;6;B;;864;409;455;3;2;404;406
8;Barcelona;11;Baix Llobregat;08077;Esplugues de Llobregat;3;7;A;;926;416;510;1;4;411;415
8;Barcelona;11;Baix Llobregat;08077;Esplugues de Llobregat;3;7;B;;1066;507;559;4;2;501;503
8;Barcelona;11;Baix Llobregat;08077;Esplugues de Llobregat;3;8;A;;510;224;286;1;1;222;223
8;Barcelona;11;Baix Llobregat;08077;Esplugues de Llobregat;3;8;B;;607;293;314;3;0;290;290
8;Barcelona;11;Baix Llobregat;08077;Esplugues de Llobregat;4;1;A;;522;265;257;1;3;261;264
8;Barcelona;11;Baix Llobregat;08077;Esplugues de Llobregat;4;1;B;;624;326;298;0;7;319;326
8;Barcelona;11;Baix Llobregat;08077;Esplugues de Llobregat;4;2;A;;934;456;478;0;10;446;456
8;Barcelona;11;Baix Llobregat;08077;Esplugues de Llobregat;4;2;B;;960;442;518;1;2;439;441
8;Barcelona;11;Baix Llobregat;08077;Esplugues de Llobregat;4;3;A;;706;337;369;3;8;326;334
8;Barcelona;11;Baix Llobregat;08077;Esplugues de Llobregat;4;3;B;;842;374;468;1;8;365;373
8;Barcelona;11;Baix Llobregat;08077;Esplugues de Llobregat;4;4;A;;880;421;459;6;3;412;415
8;Barcelona;11;Baix Llobregat;08077;Esplugues de Llobregat;4;4;B;;1035;458;577;5;7;446;453
8;Barcelona;11;Baix Llobregat;08077;Esplugues de Llobregat;4;5;A;;694;338;356;2;12;324;336
8;Barcelona;11;Baix Llobregat;08077;Esplugues de Llobregat;4;5;B;;816;355;461;2;6;347;353
8;Barcelona;11;Baix Llobregat;08077;Esplugues de Llobregat;4;6;A;;631;323;308;3;3;317;320
8;Barcelona;11;Baix Llobregat;08077;Esplugues de Llobregat;4;6;B;;684;324;360;0;6;318;324
8;Barcelona;11;Baix Llobregat;08077;Esplugues de Llobregat;4;7;A;;576;280;296;2;7;271;278
8;Barcelona;11;Baix Llobregat;08077;Esplugues de Llobregat;4;7;B;;680;315;365;0;9;306;315
8;Barcelona;11;Baix Llobregat;08077;Esplugues de Llobregat;5;1;A;;705;350;355;0;4;346;350
8;Barcelona;11;Baix Llobregat;08077;Esplugues de Llobregat;5;1;B;;757;375;382;0;2;373;375
8;Barcelona;11;Baix Llobregat;08077;Esplugues de Llobregat;5;2;A;;650;295;355;1;7;287;294
8;Barcelona;11;Baix Llobregat;08077;Esplugues de Llobregat;5;2;B;;694;323;371;1;2;320;322
17;Girona;2;Alt Empordà;17064;Espolla;1;1;U;;340;243;97;4;1;238;239
17;Girona;28;Pla de l'Estany;17065;Esponellà;1;1;U;;295;189;106;1;1;187;188
25;Lleida;26;Pallars Sobirà;25082;Espot;1;1;U;;205;120;85;0;0;120;120
8;Barcelona;14;Berguedà;08078;Espunyola, l';1;1;U;;266;150;116;2;0;148;148
8;Barcelona;24;Osona;08254;Esquirol, l';1;1;A;;1154;777;377;1;11;765;776
8;Barcelona;24;Osona;08254;Esquirol, l';1;1;B;;221;160;61;0;0;160;160
8;Barcelona;24;Osona;08254;Esquirol, l';1;1;C;;232;153;79;0;4;149;153
25;Lleida;4;Alt Urgell;25088;Estamariu;1;1;U;;121;98;23;0;0;98;98
8;Barcelona;;;08079;Estany, l';1;1;U;;313;226;87;0;1;225;226
25;Lleida;32;Segarra;25085;Estaràs;1;1;U;;149;107;42;1;0;106;106
25;Lleida;26;Pallars Sobirà;25086;Esterri d'Àneu;1;1;U;;448;309;139;1;3;305;308
25;Lleida;26;Pallars Sobirà;25087;Esterri de Cardós;1;1;U;;54;34;20;0;1;33;34
43;Tarragona;29;Priorat;43055;Falset;1;1;A;;439;352;87;2;4;346;350
43;Tarragona;29;Priorat;43055;Falset;1;1;B;;544;450;94;0;5;445;450
43;Tarragona;29;Priorat;43055;Falset;2;1;A;;453;358;95;1;5;352;357
43;Tarragona;29;Priorat;43055;Falset;2;1;B;;589;445;144;3;7;435;442
17;Girona;2;Alt Empordà;17005;Far d'Empordà, el;1;1;U;;331;202;129;1;1;200;201
25;Lleida;26;Pallars Sobirà;25089;Farrera;1;1;U;;68;41;27;0;0;41;41
43;Tarragona;37;Terra Alta;43056;Fatarella, la;1;1;U;;517;197;320;2;4;191;195
43;Tarragona;37;Terra Alta;43056;Fatarella, la;1;2;U;;669;308;361;3;2;303;305
43;Tarragona;8;Baix Camp;43057;Febró, la;1;1;U;;41;22;19;0;0;22;22
8;Barcelona;41;Vallès Oriental;08134;Figaró-Montmany;1;1;U;;498;339;159;1;0;338;338
8;Barcelona;14;Berguedà;08080;Fígols;1;1;U;;31;21;10;0;0;21;21
25;Lleida;4;Alt Urgell;25908;Fígols i Alinyà;1;1;U;;298;177;121;0;3;174;177
43;Tarragona;29;Priorat;43058;Figuera, la;1;1;U;;116;71;45;0;0;71;71
17;Girona;2;Alt Empordà;17066;Figueres;1;1;A;;652;323;329;2;5;316;321
17;Girona;2;Alt Empordà;17066;Figueres;1;1;B;;496;226;270;0;3;223;226
17;Girona;2;Alt Empordà;17066;Figueres;1;1;C;;667;325;342;0;2;323;325
17;Girona;2;Alt Empordà;17066;Figueres;1;2;A;;550;292;258;9;2;281;283
17;Girona;2;Alt Empordà;17066;Figueres;1;2;B;;643;378;265;1;14;363;377
17;Girona;2;Alt Empordà;17066;Figueres;1;3;A;;542;263;279;0;0;263;263
17;Girona;2;Alt Empordà;17066;Figueres;1;3;B;;627;320;307;3;4;313;317
17;Girona;2;Alt Empordà;17066;Figueres;1;4;A;;592;313;279;1;7;305;312
17;Girona;2;Alt Empordà;17066;Figueres;1;4;B;;560;278;282;2;2;274;276
17;Girona;2;Alt Empordà;17066;Figueres;1;4;C;;611;306;305;1;4;301;305
17;Girona;2;Alt Empordà;17066;Figueres;1;5;A;;620;315;305;0;0;315;315
17;Girona;2;Alt Empordà;17066;Figueres;1;5;B;;589;297;292;2;4;291;295
17;Girona;2;Alt Empordà;17066;Figueres;2;1;U;;820;442;378;1;17;424;441
17;Girona;2;Alt Empordà;17066;Figueres;2;2;A;;508;257;251;0;4;253;257
17;Girona;2;Alt Empordà;17066;Figueres;2;2;B;;533;279;254;1;1;277;278
17;Girona;2;Alt Empordà;17066;Figueres;2;3;A;;883;429;454;6;6;417;423
17;Girona;2;Alt Empordà;17066;Figueres;2;3;B;;963;432;531;2;9;421;430
17;Girona;2;Alt Empordà;17066;Figueres;2;4;U;;997;531;466;4;6;521;527
17;Girona;2;Alt Empordà;17066;Figueres;3;1;U;;795;451;344;2;4;445;449
17;Girona;2;Alt Empordà;17066;Figueres;3;2;U;;665;406;259;7;7;392;399
17;Girona;2;Alt Empordà;17066;Figueres;3;3;A;;707;373;334;4;6;363;369
17;Girona;2;Alt Empordà;17066;Figueres;3;3;B;;735;376;359;9;4;363;367
17;Girona;2;Alt Empordà;17066;Figueres;3;4;A;;625;286;339;3;4;279;283
17;Girona;2;Alt Empordà;17066;Figueres;3;4;B;;728;340;388;0;1;339;340
17;Girona;2;Alt Empordà;17066;Figueres;3;5;A;;559;335;224;3;6;326;332
17;Girona;2;Alt Empordà;17066;Figueres;3;5;B;;616;352;264;1;5;346;351
17;Girona;2;Alt Empordà;17066;Figueres;4;1;A;;645;363;282;0;10;353;363
17;Girona;2;Alt Empordà;17066;Figueres;4;1;B;;659;382;277;2;12;368;380
17;Girona;2;Alt Empordà;17066;Figueres;4;2;A;;671;375;296;4;13;358;371
17;Girona;2;Alt Empordà;17066;Figueres;4;2;B;;523;269;254;2;4;263;267
17;Girona;2;Alt Empordà;17066;Figueres;4;2;C;;746;445;301;10;7;428;435
17;Girona;2;Alt Empordà;17066;Figueres;4;3;A;;759;410;349;3;1;406;407
17;Girona;2;Alt Empordà;17066;Figueres;4;3;B;;610;300;310;1;3;296;299
17;Girona;2;Alt Empordà;17066;Figueres;4;3;C;;833;433;400;0;6;427;433
17;Girona;2;Alt Empordà;17066;Figueres;4;4;A;;553;317;236;3;5;309;314
17;Girona;2;Alt Empordà;17066;Figueres;4;4;B;;416;238;178;1;6;231;237
17;Girona;2;Alt Empordà;17066;Figueres;4;4;C;;583;355;228;1;8;346;354
17;Girona;2;Alt Empordà;17066;Figueres;4;5;A;;748;409;339;0;10;399;409
17;Girona;2;Alt Empordà;17066;Figueres;4;5;B;;807;404;403;2;8;394;402
17;Girona;2;Alt Empordà;17066;Figueres;4;6;U;;505;248;257;4;1;243;244
43;Tarragona;1;Alt Camp;43059;Figuerola del Camp;1;1;U;;189;141;48;0;0;141;141
17;Girona;20;Gironès;17067;Flaçà;1;1;U;;748;519;229;5;6;508;514
43;Tarragona;30;Ribera d'Ebre;43060;Flix;1;1;A;;605;427;178;13;9;405;414
43;Tarragona;30;Ribera d'Ebre;43060;Flix;1;1;B;;681;448;233;7;7;434;441
43;Tarragona;30;Ribera d'Ebre;43060;Flix;1;2;A;;655;439;216;2;4;433;437
43;Tarragona;30;Ribera d'Ebre;43060;Flix;1;2;B;;706;453;253;3;3;447;450
43;Tarragona;30;Ribera d'Ebre;43060;Flix;2;1;A;;593;374;219;3;6;365;371
43;Tarragona;30;Ribera d'Ebre;43060;Flix;2;1;B;;603;395;208;4;9;382;391
25;Lleida;18;Garrigues;25092;Floresta, la;1;1;U;;175;124;51;0;0;124;124
8;Barcelona;34;Selva;08082;Fogars de la Selva;1;1;U;;323;169;154;0;0;169;169
8;Barcelona;41;Vallès Oriental;08081;Fogars de Montclús;1;1;U;;229;153;76;1;1;151;152
17;Girona;10;Baix Empordà;17068;Foixà;1;1;U;;267;190;77;1;0;189;189
8;Barcelona;24;Osona;08083;Folgueroles;1;1;U;;900;707;193;4;5;698;703
25;Lleida;27;Pla d'Urgell;25093;Fondarella;1;1;U;;448;278;170;3;0;275;275
8;Barcelona;7;Bages;08084;Fonollosa;1;1;A;;320;229;91;2;2;225;227
8;Barcelona;7;Bages;08084;Fonollosa;1;1;B;;226;139;87;0;2;137;139
17;Girona;15;Cerdanya;17069;Fontanals de Cerdanya;1;1;U;;272;188;84;3;2;183;185
17;Girona;10;Baix Empordà;17070;Fontanilles;1;1;U;;96;64;32;0;0;64;64
17;Girona;28;Pla de l'Estany;17071;Fontcoberta;1;1;U;;669;435;234;6;6;423;429
8;Barcelona;3;Alt Penedès;08085;Font-rubí;1;1;U;;937;630;307;3;5;622;627
25;Lleida;23;Noguera;25094;Foradada;1;1;U;;133;84;49;1;2;81;83
17;Girona;10;Baix Empordà;17902;Forallac;1;1;U;;660;472;188;3;10;459;469
17;Girona;10;Baix Empordà;17902;Forallac;1;2;A;;341;200;141;0;3;197;200
17;Girona;10;Baix Empordà;17902;Forallac;1;2;B;;257;184;73;1;0;183;183
43;Tarragona;16;Conca de Barberà;43061;Forès;1;1;U;;51;31;20;1;2;28;30
17;Girona;20;Gironès;17073;Fornells de la Selva;1;1;U;;876;622;254;1;6;615;621
17;Girona;2;Alt Empordà;17074;Fortià;1;1;U;;417;281;136;4;2;275;277
8;Barcelona;41;Vallès Oriental;08086;Franqueses del Vallès, les;1;1;A;;648;436;212;0;2;434;436
8;Barcelona;41;Vallès Oriental;08086;Franqueses del Vallès, les;1;1;B;;552;353;199;0;3;350;353
8;Barcelona;41;Vallès Oriental;08086;Franqueses del Vallès, les;1;2;A;;952;507;445;2;4;501;505
8;Barcelona;41;Vallès Oriental;08086;Franqueses del Vallès, les;1;2;B;;890;477;413;1;3;473;476
8;Barcelona;41;Vallès Oriental;08086;Franqueses del Vallès, les;1;3;A;;864;415;449;4;4;407;411
8;Barcelona;41;Vallès Oriental;08086;Franqueses del Vallès, les;1;3;B;;900;441;459;0;4;437;441
8;Barcelona;41;Vallès Oriental;08086;Franqueses del Vallès, les;1;4;A;;590;353;237;0;8;345;353
8;Barcelona;41;Vallès Oriental;08086;Franqueses del Vallès, les;1;4;B;;479;285;194;0;7;278;285
8;Barcelona;41;Vallès Oriental;08086;Franqueses del Vallès, les;1;5;U;;728;355;373;1;7;347;354
8;Barcelona;41;Vallès Oriental;08086;Franqueses del Vallès, les;2;1;U;;1000;633;367;4;5;624;629
43;Tarragona;22;Montsià;43062;Freginals;1;1;U;;324;271;53;1;0;270;270
25;Lleida;38;Urgell;25096;Fuliola, la;1;1;U;;1055;708;347;1;10;697;707
25;Lleida;18;Garrigues;25097;Fulleda;1;1;U;;95;67;28;0;0;67;67
8;Barcelona;7;Bages;08090;Gaià;1;1;U;;118;80;38;0;0;80;80
43;Tarragona;22;Montsià;43063;Galera, la;1;1;U;;639;353;286;5;3;345;348
8;Barcelona;40;Vallès Occidental;08087;Gallifa;1;1;U;;64;50;14;0;0;50;50
43;Tarragona;37;Terra Alta;43064;Gandesa;1;1;A;;600;431;169;8;3;420;423
43;Tarragona;37;Terra Alta;43064;Gandesa;1;1;B;;654;480;174;8;3;469;472
43;Tarragona;37;Terra Alta;43064;Gandesa;2;1;U;;891;635;256;6;3;626;629
43;Tarragona;30;Ribera d'Ebre;43065;Garcia;1;1;U;;477;347;130;1;5;341;346
43;Tarragona;1;Alt Camp;43066;Garidells, els;1;1;U;;126;90;36;0;0;90;90
8;Barcelona;41;Vallès Oriental;08088;Garriga, la;1;1;U;;1391;920;471;1;7;912;919
8;Barcelona;41;Vallès Oriental;08088;Garriga, la;1;2;A;;1092;625;467;4;4;617;621
8;Barcelona;41;Vallès Oriental;08088;Garriga, la;1;2;B;;952;542;410;7;0;535;535
8;Barcelona;41;Vallès Oriental;08088;Garriga, la;2;1;U;;1398;939;459;1;9;929;938
8;Barcelona;41;Vallès Oriental;08088;Garriga, la;2;2;A;;1231;725;506;0;13;712;725
8;Barcelona;41;Vallès Oriental;08088;Garriga, la;2;2;B;;1294;745;549;3;8;734;742
17;Girona;2;Alt Empordà;17075;Garrigàs;1;1;U;;264;182;82;3;2;177;179
17;Girona;10;Baix Empordà;17076;Garrigoles;1;1;U;;126;82;44;0;0;82;82
17;Girona;2;Alt Empordà;17077;Garriguella;1;1;U;;529;319;210;3;1;315;316
8;Barcelona;11;Baix Llobregat;08089;Gavà;1;1;A;;556;267;289;2;6;259;265
8;Barcelona;11;Baix Llobregat;08089;Gavà;1;1;B;;621;326;295;0;5;321;326
8;Barcelona;11;Baix Llobregat;08089;Gavà;1;2;A;;587;348;239;1;1;346;347
8;Barcelona;11;Baix Llobregat;08089;Gavà;1;2;B;;705;420;285;1;3;416;419
8;Barcelona;11;Baix Llobregat;08089;Gavà;1;3;A;;603;364;239;1;6;357;363
8;Barcelona;11;Baix Llobregat;08089;Gavà;1;3;B;;586;303;283;1;1;301;302
8;Barcelona;11;Baix Llobregat;08089;Gavà;1;3;C;;672;367;305;6;6;355;361
8;Barcelona;11;Baix Llobregat;08089;Gavà;1;4;A;;731;385;346;1;6;378;384
8;Barcelona;11;Baix Llobregat;08089;Gavà;1;4;B;;799;398;401;1;1;396;397
8;Barcelona;11;Baix Llobregat;08089;Gavà;1;5;U;;985;445;540;2;5;438;443
8;Barcelona;11;Baix Llobregat;08089;Gavà;1;6;U;;639;292;347;0;3;289;292
8;Barcelona;11;Baix Llobregat;08089;Gavà;1;7;U;;826;325;501;0;4;321;325
8;Barcelona;11;Baix Llobregat;08089;Gavà;2;1;A;;789;453;336;3;6;444;450
8;Barcelona;11;Baix Llobregat;08089;Gavà;2;1;B;;895;496;399;0;5;491;496
8;Barcelona;11;Baix Llobregat;08089;Gavà;2;2;U;;898;485;413;0;7;478;485
8;Barcelona;11;Baix Llobregat;08089;Gavà;2;3;A;;935;455;480;0;2;453;455
8;Barcelona;11;Baix Llobregat;08089;Gavà;2;3;B;;1021;511;510;0;1;510;511
8;Barcelona;11;Baix Llobregat;08089;Gavà;2;4;A;;605;241;364;0;2;239;241
8;Barcelona;11;Baix Llobregat;08089;Gavà;2;4;B;;770;288;482;2;1;285;286
8;Barcelona;11;Baix Llobregat;08089;Gavà;2;5;U;;706;261;445;1;1;259;260
8;Barcelona;11;Baix Llobregat;08089;Gavà;2;6;A;;736;326;410;1;0;325;325
8;Barcelona;11;Baix Llobregat;08089;Gavà;2;6;B;;810;332;478;3;1;328;329
8;Barcelona;11;Baix Llobregat;08089;Gavà;2;7;U;;591;279;312;1;2;276;278
8;Barcelona;11;Baix Llobregat;08089;Gavà;2;8;A;;608;239;369;1;5;233;238
8;Barcelona;11;Baix Llobregat;08089;Gavà;2;8;B;;678;285;393;1;6;278;284
8;Barcelona;11;Baix Llobregat;08089;Gavà;3;1;A;;540;243;297;0;3;240;243
8;Barcelona;11;Baix Llobregat;08089;Gavà;3;1;B;;570;275;295;2;2;271;273
8;Barcelona;11;Baix Llobregat;08089;Gavà;3;2;U;;915;424;491;0;8;416;424
8;Barcelona;11;Baix Llobregat;08089;Gavà;3;3;U;;965;403;562;0;6;397;403
8;Barcelona;11;Baix Llobregat;08089;Gavà;3;4;A;;535;225;310;0;3;222;225
8;Barcelona;11;Baix Llobregat;08089;Gavà;3;4;B;;625;271;354;0;1;270;271
8;Barcelona;11;Baix Llobregat;08089;Gavà;3;5;A;;764;277;487;1;2;274;276
8;Barcelona;11;Baix Llobregat;08089;Gavà;3;5;B;;688;277;411;0;2;275;277
8;Barcelona;11;Baix Llobregat;08089;Gavà;3;6;U;;884;466;418;0;3;463;466
8;Barcelona;11;Baix Llobregat;08089;Gavà;4;1;A;;695;323;372;0;4;319;323
8;Barcelona;11;Baix Llobregat;08089;Gavà;4;1;B;;870;422;448;2;4;416;420
8;Barcelona;11;Baix Llobregat;08089;Gavà;4;2;A;;671;351;320;2;2;347;349
8;Barcelona;11;Baix Llobregat;08089;Gavà;4;2;B;;872;475;397;1;10;464;474
25;Lleida;25;Pallars Jussà;25098;Gavet de la Conca;1;1;U;;343;208;135;0;0;208;208
8;Barcelona;3;Alt Penedès;08091;Gelida;1;1;A;;790;554;236;3;7;544;551
8;Barcelona;3;Alt Penedès;08091;Gelida;1;1;B;;1035;685;350;7;5;673;678
8;Barcelona;3;Alt Penedès;08091;Gelida;2;1;A;;625;421;204;0;4;417;421
8;Barcelona;3;Alt Penedès;08091;Gelida;2;1;B;;665;444;221;3;3;438;441
17;Girona;15;Cerdanya;17078;Ger;1;1;U;;229;173;56;6;2;165;167
25;Lleida;33;Segrià;25912;Gimenells i el Pla de la Font;1;1;A;;664;348;316;0;6;342;348
25;Lleida;33;Segrià;25912;Gimenells i el Pla de la Font;1;1;B;;359;205;154;1;3;201;204
43;Tarragona;30;Ribera d'Ebre;43067;Ginestar;1;1;U;;754;552;202;2;11;539;550
17;Girona;20;Gironès;17079;Girona;1;1;U;;658;388;270;4;4;380;384
17;Girona;20;Gironès;17079;Girona;1;2;U;;744;467;277;1;15;451;466
17;Girona;20;Gironès;17079;Girona;1;3;U;;910;580;330;1;8;571;579
17;Girona;20;Gironès;17079;Girona;1;4;U;;963;538;425;0;1;537;538
17;Girona;20;Gironès;17079;Girona;1;5;A;;925;410;515;3;2;405;407
17;Girona;20;Gironès;17079;Girona;1;5;B;;587;300;287;0;1;299;300
17;Girona;20;Gironès;17079;Girona;1;6;A;;491;332;159;0;2;330;332
17;Girona;20;Gironès;17079;Girona;1;6;B;;719;458;261;1;4;453;457
17;Girona;20;Gironès;17079;Girona;2;1;U;;751;523;228;0;6;517;523
17;Girona;20;Gironès;17079;Girona;2;10;A;;806;468;338;3;17;448;465
17;Girona;20;Gironès;17079;Girona;2;10;B;;915;574;341;4;15;555;570
17;Girona;20;Gironès;17079;Girona;2;11;A;;781;473;308;0;10;463;473
17;Girona;20;Gironès;17079;Girona;2;11;B;;873;535;338;1;15;519;534
17;Girona;20;Gironès;17079;Girona;2;12;U;;1161;747;414;1;18;728;746
17;Girona;20;Gironès;17079;Girona;2;13;U;;1153;755;398;3;16;736;752
17;Girona;20;Gironès;17079;Girona;2;14;U;;840;480;360;0;9;471;480
17;Girona;20;Gironès;17079;Girona;2;2;U;;621;414;207;1;14;399;413
17;Girona;20;Gironès;17079;Girona;2;3;A;;509;345;164;2;5;338;343
17;Girona;20;Gironès;17079;Girona;2;3;B;;623;408;215;0;10;398;408
17;Girona;20;Gironès;17079;Girona;2;4;A;;608;440;168;2;2;436;438
17;Girona;20;Gironès;17079;Girona;2;4;B;;669;452;217;4;5;443;448
17;Girona;20;Gironès;17079;Girona;2;5;U;;845;558;287;1;12;545;557
17;Girona;20;Gironès;17079;Girona;2;6;A;;599;402;197;3;5;394;399
17;Girona;20;Gironès;17079;Girona;2;6;B;;414;278;136;3;1;274;275
17;Girona;20;Gironès;17079;Girona;2;6;C;;640;422;218;1;7;414;421
17;Girona;20;Gironès;17079;Girona;2;7;A;;670;441;229;3;10;428;438
17;Girona;20;Gironès;17079;Girona;2;7;B;;727;403;324;4;5;394;399
17;Girona;20;Gironès;17079;Girona;2;8;A;;609;426;183;5;8;413;421
17;Girona;20;Gironès;17079;Girona;2;8;B;;735;452;283;1;3;448;451
17;Girona;20;Gironès;17079;Girona;2;9;U;;1432;782;650;3;11;768;779
17;Girona;20;Gironès;17079;Girona;3;1;U;;951;608;343;0;10;598;608
17;Girona;20;Gironès;17079;Girona;3;10;U;;938;530;408;3;0;527;527
17;Girona;20;Gironès;17079;Girona;3;11;A;;617;361;256;0;3;358;361
17;Girona;20;Gironès;17079;Girona;3;11;B;;455;241;214;1;1;239;240
17;Girona;20;Gironès;17079;Girona;3;11;C;;698;428;270;0;1;427;428
17;Girona;20;Gironès;17079;Girona;3;12;A;;732;368;364;0;3;365;368
17;Girona;20;Gironès;17079;Girona;3;12;B;;881;440;441;0;3;437;440
17;Girona;20;Gironès;17079;Girona;3;13;A;;661;400;261;4;2;394;396
17;Girona;20;Gironès;17079;Girona;3;13;B;;762;489;273;0;7;482;489
17;Girona;20;Gironès;17079;Girona;3;14;A;;628;360;268;1;5;354;359
17;Girona;20;Gironès;17079;Girona;3;14;B;;675;367;308;0;6;361;367
17;Girona;20;Gironès;17079;Girona;3;15;A;;670;391;279;3;4;384;388
17;Girona;20;Gironès;17079;Girona;3;15;B;;832;497;335;2;10;485;495
17;Girona;20;Gironès;17079;Girona;3;16;U;;1058;643;415;2;16;625;641
17;Girona;20;Gironès;17079;Girona;3;2;U;;970;640;330;2;12;626;638
17;Girona;20;Gironès;17079;Girona;3;3;U;;921;605;316;4;12;589;601
17;Girona;20;Gironès;17079;Girona;3;4;U;;922;634;288;4;3;627;630
17;Girona;20;Gironès;17079;Girona;3;5;U;;887;575;312;2;13;560;573
17;Girona;20;Gironès;17079;Girona;3;6;U;;939;640;299;3;7;630;637
17;Girona;20;Gironès;17079;Girona;3;7;A;;729;402;327;0;1;401;402
17;Girona;20;Gironès;17079;Girona;3;7;B;;802;441;361;3;4;434;438
17;Girona;20;Gironès;17079;Girona;3;8;A;;581;363;218;3;3;357;360
17;Girona;20;Gironès;17079;Girona;3;8;B;;731;458;273;3;3;452;455
17;Girona;20;Gironès;17079;Girona;3;9;A;;596;336;260;1;2;333;335
17;Girona;20;Gironès;17079;Girona;3;9;B;;577;305;272;0;1;304;305
17;Girona;20;Gironès;17079;Girona;3;9;C;;691;399;292;3;5;391;396
17;Girona;20;Gironès;17079;Girona;4;1;U;;813;501;312;4;8;489;497
17;Girona;20;Gironès;17079;Girona;4;2;U;;904;506;398;1;10;495;505
17;Girona;20;Gironès;17079;Girona;4;3;U;;692;340;352;2;5;333;338
17;Girona;20;Gironès;17079;Girona;5;1;U;;1252;783;469;6;18;759;777
17;Girona;20;Gironès;17079;Girona;5;2;U;;638;402;236;5;2;395;397
17;Girona;20;Gironès;17079;Girona;5;3;U;;997;580;417;2;10;568;578
17;Girona;20;Gironès;17079;Girona;5;4;U;;576;374;202;2;4;368;372
17;Girona;20;Gironès;17079;Girona;5;5;A;;571;356;215;3;6;347;353
17;Girona;20;Gironès;17079;Girona;5;5;B;;620;372;248;0;1;371;372
17;Girona;20;Gironès;17079;Girona;6;1;A;;693;352;341;0;1;351;352
17;Girona;20;Gironès;17079;Girona;6;1;B;;669;311;358;0;3;308;311
17;Girona;20;Gironès;17079;Girona;6;2;A;;574;336;238;1;4;331;335
17;Girona;20;Gironès;17079;Girona;6;2;B;;662;413;249;0;6;407;413
17;Girona;20;Gironès;17079;Girona;6;3;U;;1031;638;393;1;6;631;637
8;Barcelona;14;Berguedà;08092;Gironella;1;1;A;;640;438;202;4;1;433;434
8;Barcelona;14;Berguedà;08092;Gironella;1;1;B;;682;448;234;4;5;439;444
8;Barcelona;14;Berguedà;08092;Gironella;2;1;U;;607;406;201;0;5;401;406
8;Barcelona;14;Berguedà;08092;Gironella;2;2;A;;553;376;177;2;9;365;374
8;Barcelona;14;Berguedà;08092;Gironella;2;2;B;;654;463;191;5;8;450;458
8;Barcelona;14;Berguedà;08092;Gironella;2;3;A;;582;375;207;8;0;367;367
8;Barcelona;14;Berguedà;08092;Gironella;2;3;B;;763;500;263;6;2;492;494
8;Barcelona;14;Berguedà;08093;Gisclareny;1;1;U;;29;21;8;0;0;21;21
43;Tarragona;22;Montsià;43068;Godall;1;1;U;;661;462;199;9;0;453;453
25;Lleida;27;Pla d'Urgell;25099;Golmés;1;1;U;;997;624;373;8;6;610;616
17;Girona;31;Ripollès;17080;Gombrèn;1;1;U;;213;144;69;0;1;143;144
25;Lleida;14;Berguedà;25100;Gósol;1;1;U;;167;139;28;0;0;139;139
8;Barcelona;3;Alt Penedès;08094;Granada, la;1;1;U;;967;687;280;5;7;675;682
25;Lleida;18;Garrigues;25101;Granadella, la;1;1;U;;743;512;231;1;4;507;511
8;Barcelona;;;08095;Granera;1;1;U;;60;39;21;0;1;38;39
25;Lleida;33;Segrià;25102;Granja d'Escarp, la;1;1;U;;908;580;328;1;6;573;579
8;Barcelona;41;Vallès Oriental;08096;Granollers;1;1;U;;618;481;137;5;4;472;476
8;Barcelona;41;Vallès Oriental;08096;Granollers;1;10;A;;555;338;217;3;3;332;335
8;Barcelona;41;Vallès Oriental;08096;Granollers;1;10;B;;690;380;310;1;5;374;379
8;Barcelona;41;Vallès Oriental;08096;Granollers;1;11;A;;687;362;325;2;4;356;360
8;Barcelona;41;Vallès Oriental;08096;Granollers;1;11;B;;791;425;366;1;3;421;424
8;Barcelona;41;Vallès Oriental;08096;Granollers;1;2;A;;473;343;130;0;3;340;343
8;Barcelona;41;Vallès Oriental;08096;Granollers;1;2;B;;617;458;159;1;0;457;457
8;Barcelona;41;Vallès Oriental;08096;Granollers;1;3;A;;693;467;226;0;3;464;467
8;Barcelona;41;Vallès Oriental;08096;Granollers;1;3;B;;818;526;292;0;3;523;526
8;Barcelona;41;Vallès Oriental;08096;Granollers;1;4;U;;535;352;183;2;2;348;350
8;Barcelona;41;Vallès Oriental;08096;Granollers;1;5;A;;520;340;180;0;6;334;340
8;Barcelona;41;Vallès Oriental;08096;Granollers;1;5;B;;633;392;241;0;5;387;392
8;Barcelona;41;Vallès Oriental;08096;Granollers;1;6;A;;572;351;221;0;1;350;351
8;Barcelona;41;Vallès Oriental;08096;Granollers;1;6;B;;838;519;319;0;0;519;519
8;Barcelona;41;Vallès Oriental;08096;Granollers;1;7;U;;690;391;299;0;7;384;391
8;Barcelona;41;Vallès Oriental;08096;Granollers;1;8;U;;656;377;279;3;6;368;374
8;Barcelona;41;Vallès Oriental;08096;Granollers;1;9;A;;524;301;223;1;0;300;300
8;Barcelona;41;Vallès Oriental;08096;Granollers;1;9;B;;657;359;298;3;1;355;356
8;Barcelona;41;Vallès Oriental;08096;Granollers;2;1;A;;657;433;224;3;5;425;430
8;Barcelona;41;Vallès Oriental;08096;Granollers;2;1;B;;765;502;263;1;4;497;501
8;Barcelona;41;Vallès Oriental;08096;Granollers;2;2;U;;489;333;156;0;1;332;333
8;Barcelona;41;Vallès Oriental;08096;Granollers;2;3;U;;548;397;151;0;1;396;397
8;Barcelona;41;Vallès Oriental;08096;Granollers;2;4;A;;799;458;341;2;2;454;456
8;Barcelona;41;Vallès Oriental;08096;Granollers;2;4;B;;944;538;406;1;2;535;537
8;Barcelona;41;Vallès Oriental;08096;Granollers;2;5;U;;878;511;367;1;10;500;510
8;Barcelona;41;Vallès Oriental;08096;Granollers;2;6;A;;449;283;166;0;1;282;283
8;Barcelona;41;Vallès Oriental;08096;Granollers;2;6;B;;606;416;190;2;0;414;414
8;Barcelona;41;Vallès Oriental;08096;Granollers;2;7;A;;457;265;192;1;2;262;264
8;Barcelona;41;Vallès Oriental;08096;Granollers;2;7;B;;567;307;260;2;1;304;305
8;Barcelona;41;Vallès Oriental;08096;Granollers;3;1;A;;741;478;263;0;5;473;478
8;Barcelona;41;Vallès Oriental;08096;Granollers;3;1;B;;805;520;285;1;1;518;519
8;Barcelona;41;Vallès Oriental;08096;Granollers;3;2;A;;521;289;232;2;5;282;287
8;Barcelona;41;Vallès Oriental;08096;Granollers;3;2;B;;599;323;276;0;2;321;323
8;Barcelona;41;Vallès Oriental;08096;Granollers;3;3;A;;856;442;414;2;5;435;440
8;Barcelona;41;Vallès Oriental;08096;Granollers;3;3;B;;1019;485;534;0;5;480;485
8;Barcelona;41;Vallès Oriental;08096;Granollers;3;4;A;;816;495;321;2;5;488;493
8;Barcelona;41;Vallès Oriental;08096;Granollers;3;4;B;;911;533;378;1;2;530;532
8;Barcelona;41;Vallès Oriental;08096;Granollers;3;5;A;;544;315;229;0;3;312;315
8;Barcelona;41;Vallès Oriental;08096;Granollers;3;5;B;;650;391;259;1;3;387;390
8;Barcelona;41;Vallès Oriental;08096;Granollers;3;6;A;;588;320;268;0;4;316;320
8;Barcelona;41;Vallès Oriental;08096;Granollers;3;6;B;;644;320;324;0;5;315;320
8;Barcelona;41;Vallès Oriental;08096;Granollers;3;7;U;;566;304;262;1;1;302;303
8;Barcelona;41;Vallès Oriental;08096;Granollers;4;1;A;;874;560;314;1;5;554;559
8;Barcelona;41;Vallès Oriental;08096;Granollers;4;1;B;;937;555;382;0;3;552;555
8;Barcelona;41;Vallès Oriental;08096;Granollers;4;10;A;;608;398;210;3;7;388;395
8;Barcelona;41;Vallès Oriental;08096;Granollers;4;10;B;;779;475;304;1;5;469;474
8;Barcelona;41;Vallès Oriental;08096;Granollers;4;10;C;;372;229;143;0;0;229;229
8;Barcelona;41;Vallès Oriental;08096;Granollers;4;2;A;;784;432;352;0;4;428;432
8;Barcelona;41;Vallès Oriental;08096;Granollers;4;2;B;;807;464;343;1;8;455;463
8;Barcelona;41;Vallès Oriental;08096;Granollers;4;3;U;;842;448;394;2;9;437;446
8;Barcelona;41;Vallès Oriental;08096;Granollers;4;4;U;;732;374;358;0;3;371;374
8;Barcelona;41;Vallès Oriental;08096;Granollers;4;5;U;;699;370;329;1;0;369;369
8;Barcelona;41;Vallès Oriental;08096;Granollers;4;6;U;;712;388;324;1;2;385;387
8;Barcelona;41;Vallès Oriental;08096;Granollers;4;7;U;;550;316;234;0;1;315;316
8;Barcelona;41;Vallès Oriental;08096;Granollers;4;8;U;;609;333;276;1;0;332;332
8;Barcelona;41;Vallès Oriental;08096;Granollers;4;9;A;;558;301;257;1;2;298;300
8;Barcelona;41;Vallès Oriental;08096;Granollers;4;9;B;;671;381;290;1;4;376;380
25;Lleida;32;Segarra;25103;Granyanella;1;1;U;;114;84;30;0;5;79;84
25;Lleida;18;Garrigues;25105;Granyena de les Garrigues;1;1;U;;162;111;51;3;0;108;108
25;Lleida;32;Segarra;25104;Granyena de Segarra;1;1;U;;166;115;51;0;0;115;115
43;Tarragona;29;Priorat;43069;Gratallops;1;1;U;;201;147;54;1;3;143;146
8;Barcelona;41;Vallès Oriental;08097;Gualba;1;1;U;;491;301;190;0;8;293;301
17;Girona;10;Baix Empordà;17081;Gualta;1;1;U;;243;174;69;1;3;170;173
8;Barcelona;14;Berguedà;08099;Guardiola de Berguedà;1;1;A;;853;563;290;4;6;553;559
8;Barcelona;14;Berguedà;08099;Guardiola de Berguedà;1;1;B;;186;158;28;0;0;158;158
43;Tarragona;29;Priorat;43070;Guiamets, els;1;1;U;;242;158;84;1;2;155;157
17;Girona;15;Cerdanya;17082;Guils de Cerdanya;1;1;U;;214;164;50;0;4;160;164
25;Lleida;38;Urgell;25109;Guimerà;1;1;U;;420;271;149;2;3;266;269
25;Lleida;26;Pallars Sobirà;25903;Guingueta d'Àneu, la;1;1;U;;225;145;80;2;0;143;143
25;Lleida;32;Segarra;25110;Guissona;1;1;U;;1003;676;327;5;5;666;671
25;Lleida;32;Segarra;25110;Guissona;1;2;U;;1081;730;351;2;8;720;728
25;Lleida;35;Solsonès;25111;Guixers;1;1;U;;146;93;53;1;1;91;92
8;Barcelona;24;Osona;08100;Gurb;1;1;A;;619;411;208;0;0;411;411
8;Barcelona;24;Osona;08100;Gurb;1;1;B;;772;535;237;1;2;532;534
43;Tarragona;37;Terra Alta;43071;Horta de Sant Joan;1;1;U;;1101;657;444;1;4;652;656
8;Barcelona;13;Barcelonès;08101;Hospitalet de Llobregat, l';1;1;U;;778;294;484;0;2;292;294
8;Barcelona;13;Barcelonès;08101;Hospitalet de Llobregat, l';1;10;U;;1093;516;577;2;5;509;514
8;Barcelona;13;Barcelonès;08101;Hospitalet de Llobregat, l';1;11;U;;922;473;449;0;9;464;473
8;Barcelona;13;Barcelonès;08101;Hospitalet de Llobregat, l';1;12;U;;1196;646;550;1;10;635;645
8;Barcelona;13;Barcelonès;08101;Hospitalet de Llobregat, l';1;13;U;;990;473;517;0;9;464;473
8;Barcelona;13;Barcelonès;08101;Hospitalet de Llobregat, l';1;14;A;;746;301;445;0;3;298;301
8;Barcelona;13;Barcelonès;08101;Hospitalet de Llobregat, l';1;14;B;;811;341;470;0;2;339;341
8;Barcelona;13;Barcelonès;08101;Hospitalet de Llobregat, l';1;15;U;;1107;420;687;1;2;417;419
8;Barcelona;13;Barcelonès;08101;Hospitalet de Llobregat, l';1;16;U;;1211;538;673;2;5;531;536
8;Barcelona;13;Barcelonès;08101;Hospitalet de Llobregat, l';1;17;A;;671;296;375;0;4;292;296
8;Barcelona;13;Barcelonès;08101;Hospitalet de Llobregat, l';1;17;B;;714;321;393;0;5;316;321
8;Barcelona;13;Barcelonès;08101;Hospitalet de Llobregat, l';1;18;U;;1279;553;726;1;2;550;552
8;Barcelona;13;Barcelonès;08101;Hospitalet de Llobregat, l';1;19;U;;1215;581;634;0;1;580;581
8;Barcelona;13;Barcelonès;08101;Hospitalet de Llobregat, l';1;2;A;;689;348;341;1;2;345;347
8;Barcelona;13;Barcelonès;08101;Hospitalet de Llobregat, l';1;2;B;;791;372;419;0;3;369;372
8;Barcelona;13;Barcelonès;08101;Hospitalet de Llobregat, l';1;20;U;;1225;564;661;0;5;559;564
8;Barcelona;13;Barcelonès;08101;Hospitalet de Llobregat, l';1;21;U;;832;420;412;0;5;415;420
8;Barcelona;13;Barcelonès;08101;Hospitalet de Llobregat, l';1;22;U;;858;394;464;0;4;390;394
8;Barcelona;13;Barcelonès;08101;Hospitalet de Llobregat, l';1;23;U;;1066;556;510;0;5;551;556
8;Barcelona;13;Barcelonès;08101;Hospitalet de Llobregat, l';1;24;U;;731;364;367;0;11;353;364
8;Barcelona;13;Barcelonès;08101;Hospitalet de Llobregat, l';1;25;U;;998;403;595;1;3;399;402
8;Barcelona;13;Barcelonès;08101;Hospitalet de Llobregat, l';1;26;U;;1089;552;537;0;10;542;552
8;Barcelona;13;Barcelonès;08101;Hospitalet de Llobregat, l';1;27;U;;643;282;361;2;7;273;280
8;Barcelona;13;Barcelonès;08101;Hospitalet de Llobregat, l';1;28;U;;869;379;490;1;5;373;378
8;Barcelona;13;Barcelonès;08101;Hospitalet de Llobregat, l';1;29;U;;959;416;543;0;2;414;416
8;Barcelona;13;Barcelonès;08101;Hospitalet de Llobregat, l';1;3;U;;665;344;321;0;3;341;344
8;Barcelona;13;Barcelonès;08101;Hospitalet de Llobregat, l';1;30;U;;965;531;434;0;3;528;531
8;Barcelona;13;Barcelonès;08101;Hospitalet de Llobregat, l';1;31;U;;1211;551;660;0;6;545;551
8;Barcelona;13;Barcelonès;08101;Hospitalet de Llobregat, l';1;32;A;;720;308;412;0;6;302;308
8;Barcelona;13;Barcelonès;08101;Hospitalet de Llobregat, l';1;32;B;;859;326;533;0;2;324;326
8;Barcelona;13;Barcelonès;08101;Hospitalet de Llobregat, l';1;33;U;;827;484;343;0;5;479;484
8;Barcelona;13;Barcelonès;08101;Hospitalet de Llobregat, l';1;34;U;;991;467;524;1;6;460;466
8;Barcelona;13;Barcelonès;08101;Hospitalet de Llobregat, l';1;35;U;;1166;480;686;1;5;474;479
8;Barcelona;13;Barcelonès;08101;Hospitalet de Llobregat, l';1;36;U;;996;515;481;2;1;512;513
8;Barcelona;13;Barcelonès;08101;Hospitalet de Llobregat, l';1;37;U;;1029;530;499;1;3;526;529
8;Barcelona;13;Barcelonès;08101;Hospitalet de Llobregat, l';1;38;U;;678;334;344;2;3;329;332
8;Barcelona;13;Barcelonès;08101;Hospitalet de Llobregat, l';1;39;U;;637;308;329;2;4;302;306
8;Barcelona;13;Barcelonès;08101;Hospitalet de Llobregat, l';1;4;U;;764;424;340;1;3;420;423
8;Barcelona;13;Barcelonès;08101;Hospitalet de Llobregat, l';1;40;U;;904;404;500;1;6;397;403
8;Barcelona;13;Barcelonès;08101;Hospitalet de Llobregat, l';1;5;U;;938;505;433;0;6;499;505
8;Barcelona;13;Barcelonès;08101;Hospitalet de Llobregat, l';1;6;A;;626;284;342;0;5;279;284
8;Barcelona;13;Barcelonès;08101;Hospitalet de Llobregat, l';1;6;B;;780;323;457;0;1;322;323
8;Barcelona;13;Barcelonès;08101;Hospitalet de Llobregat, l';1;7;A;;713;340;373;2;2;336;338
8;Barcelona;13;Barcelonès;08101;Hospitalet de Llobregat, l';1;7;B;;860;426;434;7;4;415;419
8;Barcelona;13;Barcelonès;08101;Hospitalet de Llobregat, l';1;8;U;;1176;675;501;0;10;665;675
8;Barcelona;13;Barcelonès;08101;Hospitalet de Llobregat, l';1;9;U;;974;556;418;0;7;549;556
8;Barcelona;13;Barcelonès;08101;Hospitalet de Llobregat, l';2;1;U;;643;304;339;0;2;302;304
8;Barcelona;13;Barcelonès;08101;Hospitalet de Llobregat, l';2;10;U;;865;461;404;0;12;449;461
8;Barcelona;13;Barcelonès;08101;Hospitalet de Llobregat, l';2;11;U;;1075;488;587;0;13;475;488
8;Barcelona;13;Barcelonès;08101;Hospitalet de Llobregat, l';2;12;U;;1123;473;650;3;3;467;470
8;Barcelona;13;Barcelonès;08101;Hospitalet de Llobregat, l';2;13;U;;740;327;413;5;0;322;322
8;Barcelona;13;Barcelonès;08101;Hospitalet de Llobregat, l';2;14;U;;628;302;326;3;5;294;299
8;Barcelona;13;Barcelonès;08101;Hospitalet de Llobregat, l';2;15;U;;797;409;388;0;4;405;409
8;Barcelona;13;Barcelonès;08101;Hospitalet de Llobregat, l';2;16;U;;1104;495;609;0;2;493;495
8;Barcelona;13;Barcelonès;08101;Hospitalet de Llobregat, l';2;17;U;;491;255;236;2;1;252;253
8;Barcelona;13;Barcelonès;08101;Hospitalet de Llobregat, l';2;18;U;;604;268;336;0;0;268;268
8;Barcelona;13;Barcelonès;08101;Hospitalet de Llobregat, l';2;19;U;;1050;503;547;1;5;497;502
8;Barcelona;13;Barcelonès;08101;Hospitalet de Llobregat, l';2;2;U;;663;309;354;0;1;308;309
8;Barcelona;13;Barcelonès;08101;Hospitalet de Llobregat, l';2;20;U;;773;354;419;0;8;346;354
8;Barcelona;13;Barcelonès;08101;Hospitalet de Llobregat, l';2;21;U;;1013;399;614;4;2;393;395
8;Barcelona;13;Barcelonès;08101;Hospitalet de Llobregat, l';2;22;U;;751;320;431;1;3;316;319
8;Barcelona;13;Barcelonès;08101;Hospitalet de Llobregat, l';2;23;U;;1049;450;599;0;13;437;450
8;Barcelona;13;Barcelonès;08101;Hospitalet de Llobregat, l';2;24;U;;547;280;267;1;8;271;279
8;Barcelona;13;Barcelonès;08101;Hospitalet de Llobregat, l';2;25;U;;514;266;248;3;4;259;263
8;Barcelona;13;Barcelonès;08101;Hospitalet de Llobregat, l';2;26;U;;957;445;512;3;6;436;442
8;Barcelona;13;Barcelonès;08101;Hospitalet de Llobregat, l';2;27;U;;601;297;304;1;5;291;296
8;Barcelona;13;Barcelonès;08101;Hospitalet de Llobregat, l';2;28;U;;592;270;322;1;3;266;269
8;Barcelona;13;Barcelonès;08101;Hospitalet de Llobregat, l';2;29;U;;634;271;363;0;3;268;271
8;Barcelona;13;Barcelonès;08101;Hospitalet de Llobregat, l';2;3;U;;691;346;345;0;4;342;346
8;Barcelona;13;Barcelonès;08101;Hospitalet de Llobregat, l';2;30;U;;701;275;426;5;2;268;270
8;Barcelona;13;Barcelonès;08101;Hospitalet de Llobregat, l';2;31;U;;991;419;572;6;9;404;413
8;Barcelona;13;Barcelonès;08101;Hospitalet de Llobregat, l';2;32;U;;954;487;467;0;8;479;487
8;Barcelona;13;Barcelonès;08101;Hospitalet de Llobregat, l';2;33;U;;734;356;378;6;3;347;350
8;Barcelona;13;Barcelonès;08101;Hospitalet de Llobregat, l';2;34;U;;861;430;431;0;4;426;430
8;Barcelona;13;Barcelonès;08101;Hospitalet de Llobregat, l';2;35;A;;566;264;302;1;2;261;263
8;Barcelona;13;Barcelonès;08101;Hospitalet de Llobregat, l';2;35;B;;701;323;378;1;4;318;322
8;Barcelona;13;Barcelonès;08101;Hospitalet de Llobregat, l';2;36;U;;1026;498;528;3;9;486;495
8;Barcelona;13;Barcelonès;08101;Hospitalet de Llobregat, l';2;37;U;;1163;559;604;2;7;550;557
8;Barcelona;13;Barcelonès;08101;Hospitalet de Llobregat, l';2;38;U;;669;320;349;0;1;319;320
8;Barcelona;13;Barcelonès;08101;Hospitalet de Llobregat, l';2;39;U;;1081;530;551;0;5;525;530
8;Barcelona;13;Barcelonès;08101;Hospitalet de Llobregat, l';2;4;U;;519;240;279;3;1;236;237
8;Barcelona;13;Barcelonès;08101;Hospitalet de Llobregat, l';2;40;U;;676;316;360;2;5;309;314
8;Barcelona;13;Barcelonès;08101;Hospitalet de Llobregat, l';2;41;U;;595;308;287;2;2;304;306
8;Barcelona;13;Barcelonès;08101;Hospitalet de Llobregat, l';2;42;U;;1001;516;485;0;5;511;516
8;Barcelona;13;Barcelonès;08101;Hospitalet de Llobregat, l';2;43;A;;619;318;301;0;2;316;318
8;Barcelona;13;Barcelonès;08101;Hospitalet de Llobregat, l';2;43;B;;685;341;344;1;4;336;340
8;Barcelona;13;Barcelonès;08101;Hospitalet de Llobregat, l';2;44;U;;564;268;296;3;0;265;265
8;Barcelona;13;Barcelonès;08101;Hospitalet de Llobregat, l';2;45;U;;873;442;431;0;3;439;442
8;Barcelona;13;Barcelonès;08101;Hospitalet de Llobregat, l';2;46;U;;944;421;523;5;7;409;416
8;Barcelona;13;Barcelonès;08101;Hospitalet de Llobregat, l';2;47;U;;1047;470;577;0;2;468;470
8;Barcelona;13;Barcelonès;08101;Hospitalet de Llobregat, l';2;48;U;;982;448;534;0;4;444;448
8;Barcelona;13;Barcelonès;08101;Hospitalet de Llobregat, l';2;49;U;;971;430;541;0;6;424;430
8;Barcelona;13;Barcelonès;08101;Hospitalet de Llobregat, l';2;5;U;;728;391;337;0;4;387;391
8;Barcelona;13;Barcelonès;08101;Hospitalet de Llobregat, l';2;6;U;;794;410;384;3;4;403;407
8;Barcelona;13;Barcelonès;08101;Hospitalet de Llobregat, l';2;7;U;;698;384;314;0;1;383;384
8;Barcelona;13;Barcelonès;08101;Hospitalet de Llobregat, l';2;8;A;;802;426;376;1;6;419;425
8;Barcelona;13;Barcelonès;08101;Hospitalet de Llobregat, l';2;8;B;;927;493;434;0;7;486;493
8;Barcelona;13;Barcelonès;08101;Hospitalet de Llobregat, l';2;9;U;;979;513;466;2;2;509;511
8;Barcelona;13;Barcelonès;08101;Hospitalet de Llobregat, l';3;1;A;;675;300;375;0;4;296;300
8;Barcelona;13;Barcelonès;08101;Hospitalet de Llobregat, l';3;1;B;;803;339;464;0;3;336;339
8;Barcelona;13;Barcelonès;08101;Hospitalet de Llobregat, l';3;10;U;;701;315;386;0;4;311;315
8;Barcelona;13;Barcelonès;08101;Hospitalet de Llobregat, l';3;11;U;;1265;632;633;2;10;620;630
8;Barcelona;13;Barcelonès;08101;Hospitalet de Llobregat, l';3;12;U;;1040;506;534;0;3;503;506
8;Barcelona;13;Barcelonès;08101;Hospitalet de Llobregat, l';3;13;A;;684;329;355;0;9;320;329
8;Barcelona;13;Barcelonès;08101;Hospitalet de Llobregat, l';3;13;B;;783;358;425;1;0;357;357
8;Barcelona;13;Barcelonès;08101;Hospitalet de Llobregat, l';3;14;A;;741;343;398;1;9;333;342
8;Barcelona;13;Barcelonès;08101;Hospitalet de Llobregat, l';3;14;B;;869;388;481;1;4;383;387
8;Barcelona;13;Barcelonès;08101;Hospitalet de Llobregat, l';3;15;U;;1111;476;635;2;2;472;474
8;Barcelona;13;Barcelonès;08101;Hospitalet de Llobregat, l';3;16;A;;726;367;359;0;9;358;367
8;Barcelona;13;Barcelonès;08101;Hospitalet de Llobregat, l';3;16;B;;849;417;432;0;4;413;417
8;Barcelona;13;Barcelonès;08101;Hospitalet de Llobregat, l';3;17;U;;679;317;362;7;1;309;310
8;Barcelona;13;Barcelonès;08101;Hospitalet de Llobregat, l';3;18;U;;568;291;277;1;6;284;290
8;Barcelona;13;Barcelonès;08101;Hospitalet de Llobregat, l';3;19;U;;650;332;318;5;7;320;327
8;Barcelona;13;Barcelonès;08101;Hospitalet de Llobregat, l';3;2;U;;1189;580;609;0;8;572;580
8;Barcelona;13;Barcelonès;08101;Hospitalet de Llobregat, l';3;20;U;;838;437;401;0;7;430;437
8;Barcelona;13;Barcelonès;08101;Hospitalet de Llobregat, l';3;21;A;;775;365;410;0;0;365;365
8;Barcelona;13;Barcelonès;08101;Hospitalet de Llobregat, l';3;21;B;;802;447;355;3;4;440;444
8;Barcelona;13;Barcelonès;08101;Hospitalet de Llobregat, l';3;22;U;;931;453;478;0;6;447;453
8;Barcelona;13;Barcelonès;08101;Hospitalet de Llobregat, l';3;23;A;;754;314;440;1;7;306;313
8;Barcelona;13;Barcelonès;08101;Hospitalet de Llobregat, l';3;23;B;;930;389;541;0;8;381;389
8;Barcelona;13;Barcelonès;08101;Hospitalet de Llobregat, l';3;24;U;;678;324;354;0;2;322;324
8;Barcelona;13;Barcelonès;08101;Hospitalet de Llobregat, l';3;25;U;;1521;917;604;4;18;895;913
8;Barcelona;13;Barcelonès;08101;Hospitalet de Llobregat, l';3;3;A;;760;379;381;0;0;379;379
8;Barcelona;13;Barcelonès;08101;Hospitalet de Llobregat, l';3;3;B;;851;443;408;2;4;437;441
8;Barcelona;13;Barcelonès;08101;Hospitalet de Llobregat, l';3;4;U;;1044;520;524;1;4;515;519
8;Barcelona;13;Barcelonès;08101;Hospitalet de Llobregat, l';3;5;U;;1108;637;471;4;5;628;633
8;Barcelona;13;Barcelonès;08101;Hospitalet de Llobregat, l';3;6;U;;1294;703;591;9;0;694;694
8;Barcelona;13;Barcelonès;08101;Hospitalet de Llobregat, l';3;7;A;;610;358;252;0;7;351;358
8;Barcelona;13;Barcelonès;08101;Hospitalet de Llobregat, l';3;7;B;;662;326;336;0;5;321;326
8;Barcelona;13;Barcelonès;08101;Hospitalet de Llobregat, l';3;8;U;;1213;620;593;2;6;612;618
8;Barcelona;13;Barcelonès;08101;Hospitalet de Llobregat, l';3;9;U;;541;257;284;3;2;252;254
8;Barcelona;13;Barcelonès;08101;Hospitalet de Llobregat, l';4;1;U;;1068;490;578;0;1;489;490
8;Barcelona;13;Barcelonès;08101;Hospitalet de Llobregat, l';4;10;A;;691;318;373;2;3;313;316
8;Barcelona;13;Barcelonès;08101;Hospitalet de Llobregat, l';4;10;B;;851;357;494;5;0;352;352
8;Barcelona;13;Barcelonès;08101;Hospitalet de Llobregat, l';4;11;U;;978;406;572;2;4;400;404
8;Barcelona;13;Barcelonès;08101;Hospitalet de Llobregat, l';4;12;A;;645;293;352;1;6;286;292
8;Barcelona;13;Barcelonès;08101;Hospitalet de Llobregat, l';4;12;B;;810;365;445;2;3;360;363
8;Barcelona;13;Barcelonès;08101;Hospitalet de Llobregat, l';4;13;U;;503;243;260;2;1;240;241
8;Barcelona;13;Barcelonès;08101;Hospitalet de Llobregat, l';4;14;U;;845;362;483;1;3;358;361
8;Barcelona;13;Barcelonès;08101;Hospitalet de Llobregat, l';4;15;U;;666;314;352;0;3;311;314
8;Barcelona;13;Barcelonès;08101;Hospitalet de Llobregat, l';4;16;U;;706;315;391;0;6;309;315
8;Barcelona;13;Barcelonès;08101;Hospitalet de Llobregat, l';4;17;U;;589;256;333;1;2;253;255
8;Barcelona;13;Barcelonès;08101;Hospitalet de Llobregat, l';4;18;U;;993;482;511;1;5;476;481
8;Barcelona;13;Barcelonès;08101;Hospitalet de Llobregat, l';4;19;U;;732;326;406;2;2;322;324
8;Barcelona;13;Barcelonès;08101;Hospitalet de Llobregat, l';4;2;U;;822;312;510;0;6;306;312
8;Barcelona;13;Barcelonès;08101;Hospitalet de Llobregat, l';4;20;U;;1146;558;588;0;8;550;558
8;Barcelona;13;Barcelonès;08101;Hospitalet de Llobregat, l';4;21;U;;1094;466;628;1;5;460;465
8;Barcelona;13;Barcelonès;08101;Hospitalet de Llobregat, l';4;22;U;;951;440;511;1;5;434;439
8;Barcelona;13;Barcelonès;08101;Hospitalet de Llobregat, l';4;23;U;;952;471;481;1;4;466;470
8;Barcelona;13;Barcelonès;08101;Hospitalet de Llobregat, l';4;24;U;;526;221;305;1;4;216;220
8;Barcelona;13;Barcelonès;08101;Hospitalet de Llobregat, l';4;25;U;;884;387;497;6;9;372;381
8;Barcelona;13;Barcelonès;08101;Hospitalet de Llobregat, l';4;26;U;;836;384;452;0;4;380;384
8;Barcelona;13;Barcelonès;08101;Hospitalet de Llobregat, l';4;27;U;;817;373;444;1;4;368;372
8;Barcelona;13;Barcelonès;08101;Hospitalet de Llobregat, l';4;28;U;;492;230;262;0;6;224;230
8;Barcelona;13;Barcelonès;08101;Hospitalet de Llobregat, l';4;29;U;;532;270;262;0;1;269;270
8;Barcelona;13;Barcelonès;08101;Hospitalet de Llobregat, l';4;3;U;;1120;527;593;3;5;519;524
8;Barcelona;13;Barcelonès;08101;Hospitalet de Llobregat, l';4;30;U;;808;348;460;0;8;340;348
8;Barcelona;13;Barcelonès;08101;Hospitalet de Llobregat, l';4;31;A;;548;254;294;2;3;249;252
8;Barcelona;13;Barcelonès;08101;Hospitalet de Llobregat, l';4;31;B;;700;355;345;2;1;352;353
8;Barcelona;13;Barcelonès;08101;Hospitalet de Llobregat, l';4;32;U;;1076;526;550;1;12;513;525
8;Barcelona;13;Barcelonès;08101;Hospitalet de Llobregat, l';4;33;U;;813;324;489;2;0;322;322
8;Barcelona;13;Barcelonès;08101;Hospitalet de Llobregat, l';4;34;U;;601;298;303;1;1;296;297
8;Barcelona;13;Barcelonès;08101;Hospitalet de Llobregat, l';4;35;U;;994;427;567;1;2;424;426
8;Barcelona;13;Barcelonès;08101;Hospitalet de Llobregat, l';4;36;U;;671;247;424;0;6;241;247
8;Barcelona;13;Barcelonès;08101;Hospitalet de Llobregat, l';4;37;U;;720;319;401;1;2;316;318
8;Barcelona;13;Barcelonès;08101;Hospitalet de Llobregat, l';4;38;U;;790;357;433;1;3;353;356
8;Barcelona;13;Barcelonès;08101;Hospitalet de Llobregat, l';4;39;U;;921;421;500;0;7;414;421
8;Barcelona;13;Barcelonès;08101;Hospitalet de Llobregat, l';4;4;U;;1213;525;688;2;13;510;523
8;Barcelona;13;Barcelonès;08101;Hospitalet de Llobregat, l';4;40;U;;1054;457;597;3;5;449;454
8;Barcelona;13;Barcelonès;08101;Hospitalet de Llobregat, l';4;41;A;;762;363;399;1;5;357;362
8;Barcelona;13;Barcelonès;08101;Hospitalet de Llobregat, l';4;41;B;;878;444;434;0;12;432;444
8;Barcelona;13;Barcelonès;08101;Hospitalet de Llobregat, l';4;42;U;;574;226;348;2;2;222;224
8;Barcelona;13;Barcelonès;08101;Hospitalet de Llobregat, l';4;5;U;;872;388;484;0;4;384;388
8;Barcelona;13;Barcelonès;08101;Hospitalet de Llobregat, l';4;6;U;;1152;478;674;0;5;473;478
8;Barcelona;13;Barcelonès;08101;Hospitalet de Llobregat, l';4;7;U;;982;409;573;1;4;404;408
8;Barcelona;13;Barcelonès;08101;Hospitalet de Llobregat, l';4;8;U;;784;315;469;0;0;315;315
8;Barcelona;13;Barcelonès;08101;Hospitalet de Llobregat, l';4;9;U;;619;282;337;0;4;278;282
8;Barcelona;13;Barcelonès;08101;Hospitalet de Llobregat, l';5;1;U;;885;466;419;1;4;461;465
8;Barcelona;13;Barcelonès;08101;Hospitalet de Llobregat, l';5;10;U;;968;411;557;0;4;407;411
8;Barcelona;13;Barcelonès;08101;Hospitalet de Llobregat, l';5;11;U;;645;313;332;0;0;313;313
8;Barcelona;13;Barcelonès;08101;Hospitalet de Llobregat, l';5;12;U;;819;339;480;0;2;337;339
8;Barcelona;13;Barcelonès;08101;Hospitalet de Llobregat, l';5;13;U;;713;284;429;4;3;277;280
8;Barcelona;13;Barcelonès;08101;Hospitalet de Llobregat, l';5;14;U;;689;347;342;5;0;342;342
8;Barcelona;13;Barcelonès;08101;Hospitalet de Llobregat, l';5;15;U;;501;203;298;0;0;203;203
8;Barcelona;13;Barcelonès;08101;Hospitalet de Llobregat, l';5;16;U;;586;227;359;0;2;225;227
8;Barcelona;13;Barcelonès;08101;Hospitalet de Llobregat, l';5;17;U;;1016;445;571;0;0;445;445
8;Barcelona;13;Barcelonès;08101;Hospitalet de Llobregat, l';5;18;U;;1033;479;554;1;3;475;478
8;Barcelona;13;Barcelonès;08101;Hospitalet de Llobregat, l';5;19;U;;565;262;303;1;3;258;261
8;Barcelona;13;Barcelonès;08101;Hospitalet de Llobregat, l';5;2;A;;635;300;335;0;0;300;300
8;Barcelona;13;Barcelonès;08101;Hospitalet de Llobregat, l';5;2;B;;725;386;339;1;1;384;385
8;Barcelona;13;Barcelonès;08101;Hospitalet de Llobregat, l';5;20;U;;816;346;470;0;2;344;346
8;Barcelona;13;Barcelonès;08101;Hospitalet de Llobregat, l';5;21;U;;1065;501;564;0;9;492;501
8;Barcelona;13;Barcelonès;08101;Hospitalet de Llobregat, l';5;22;U;;655;311;344;1;3;307;310
8;Barcelona;13;Barcelonès;08101;Hospitalet de Llobregat, l';5;23;U;;1174;547;627;4;8;535;543
8;Barcelona;13;Barcelonès;08101;Hospitalet de Llobregat, l';5;24;U;;1103;449;654;1;5;443;448
8;Barcelona;13;Barcelonès;08101;Hospitalet de Llobregat, l';5;25;U;;746;348;398;1;7;340;347
8;Barcelona;13;Barcelonès;08101;Hospitalet de Llobregat, l';5;26;U;;618;299;319;0;2;297;299
8;Barcelona;13;Barcelonès;08101;Hospitalet de Llobregat, l';5;27;U;;903;379;524;0;1;378;379
8;Barcelona;13;Barcelonès;08101;Hospitalet de Llobregat, l';5;28;U;;1070;523;547;2;7;514;521
8;Barcelona;13;Barcelonès;08101;Hospitalet de Llobregat, l';5;29;U;;1113;544;569;0;4;540;544
8;Barcelona;13;Barcelonès;08101;Hospitalet de Llobregat, l';5;3;U;;709;405;304;6;14;385;399
8;Barcelona;13;Barcelonès;08101;Hospitalet de Llobregat, l';5;30;U;;1244;592;652;0;6;586;592
8;Barcelona;13;Barcelonès;08101;Hospitalet de Llobregat, l';5;31;U;;857;378;479;0;1;377;378
8;Barcelona;13;Barcelonès;08101;Hospitalet de Llobregat, l';5;32;U;;1256;637;619;2;5;630;635
8;Barcelona;13;Barcelonès;08101;Hospitalet de Llobregat, l';5;33;U;;878;416;462;1;2;413;415
8;Barcelona;13;Barcelonès;08101;Hospitalet de Llobregat, l';5;34;U;;875;400;475;0;2;398;400
8;Barcelona;13;Barcelonès;08101;Hospitalet de Llobregat, l';5;35;U;;962;436;526;0;3;433;436
8;Barcelona;13;Barcelonès;08101;Hospitalet de Llobregat, l';5;36;U;;867;474;393;0;7;467;474
8;Barcelona;13;Barcelonès;08101;Hospitalet de Llobregat, l';5;37;U;;1127;551;576;2;4;545;549
8;Barcelona;13;Barcelonès;08101;Hospitalet de Llobregat, l';5;38;U;;1121;531;590;4;0;527;527
8;Barcelona;13;Barcelonès;08101;Hospitalet de Llobregat, l';5;4;U;;1173;572;601;0;8;564;572
8;Barcelona;13;Barcelonès;08101;Hospitalet de Llobregat, l';5;5;U;;1306;620;686;0;5;615;620
8;Barcelona;13;Barcelonès;08101;Hospitalet de Llobregat, l';5;6;A;;831;400;431;0;2;398;400
8;Barcelona;13;Barcelonès;08101;Hospitalet de Llobregat, l';5;6;B;;805;350;455;10;8;332;340
8;Barcelona;13;Barcelonès;08101;Hospitalet de Llobregat, l';5;7;U;;734;371;363;1;0;370;370
8;Barcelona;13;Barcelonès;08101;Hospitalet de Llobregat, l';5;8;U;;570;270;300;0;1;269;270
8;Barcelona;13;Barcelonès;08101;Hospitalet de Llobregat, l';5;9;U;;703;357;346;0;3;354;357
8;Barcelona;13;Barcelonès;08101;Hospitalet de Llobregat, l';6;1;U;;1238;634;604;1;15;618;633
8;Barcelona;13;Barcelonès;08101;Hospitalet de Llobregat, l';6;10;U;;1346;659;687;13;0;646;646
8;Barcelona;13;Barcelonès;08101;Hospitalet de Llobregat, l';6;11;U;;1554;695;859;2;5;688;693
8;Barcelona;13;Barcelonès;08101;Hospitalet de Llobregat, l';6;12;U;;1120;523;597;5;3;515;518
8;Barcelona;13;Barcelonès;08101;Hospitalet de Llobregat, l';6;13;U;;1351;637;714;3;6;628;634
8;Barcelona;13;Barcelonès;08101;Hospitalet de Llobregat, l';6;14;U;;942;458;484;0;9;449;458
8;Barcelona;13;Barcelonès;08101;Hospitalet de Llobregat, l';6;15;U;;953;474;479;0;7;467;474
8;Barcelona;13;Barcelonès;08101;Hospitalet de Llobregat, l';6;16;A;;646;243;403;0;3;240;243
8;Barcelona;13;Barcelonès;08101;Hospitalet de Llobregat, l';6;16;B;;727;249;478;0;0;249;249
8;Barcelona;13;Barcelonès;08101;Hospitalet de Llobregat, l';6;17;U;;1097;493;604;9;3;481;484
8;Barcelona;13;Barcelonès;08101;Hospitalet de Llobregat, l';6;18;U;;597;310;287;0;3;307;310
8;Barcelona;13;Barcelonès;08101;Hospitalet de Llobregat, l';6;19;U;;1269;587;682;3;4;580;584
8;Barcelona;13;Barcelonès;08101;Hospitalet de Llobregat, l';6;2;U;;613;311;302;1;8;302;310
8;Barcelona;13;Barcelonès;08101;Hospitalet de Llobregat, l';6;20;U;;597;293;304;2;0;291;291
8;Barcelona;13;Barcelonès;08101;Hospitalet de Llobregat, l';6;21;U;;1282;596;686;1;5;590;595
8;Barcelona;13;Barcelonès;08101;Hospitalet de Llobregat, l';6;22;U;;805;349;456;1;2;346;348
8;Barcelona;13;Barcelonès;08101;Hospitalet de Llobregat, l';6;23;A;;649;317;332;0;4;313;317
8;Barcelona;13;Barcelonès;08101;Hospitalet de Llobregat, l';6;23;B;;776;380;396;0;8;372;380
8;Barcelona;13;Barcelonès;08101;Hospitalet de Llobregat, l';6;24;U;;1083;470;613;1;9;460;469
8;Barcelona;13;Barcelonès;08101;Hospitalet de Llobregat, l';6;25;U;;1051;491;560;2;8;481;489
8;Barcelona;13;Barcelonès;08101;Hospitalet de Llobregat, l';6;26;U;;1071;475;596;0;8;467;475
8;Barcelona;13;Barcelonès;08101;Hospitalet de Llobregat, l';6;27;U;;905;448;457;0;2;446;448
8;Barcelona;13;Barcelonès;08101;Hospitalet de Llobregat, l';6;28;U;;997;423;574;0;7;416;423
8;Barcelona;13;Barcelonès;08101;Hospitalet de Llobregat, l';6;29;U;;599;263;336;0;6;257;263
8;Barcelona;13;Barcelonès;08101;Hospitalet de Llobregat, l';6;3;U;;612;270;342;0;0;270;270
8;Barcelona;13;Barcelonès;08101;Hospitalet de Llobregat, l';6;30;U;;769;388;381;0;1;387;388
8;Barcelona;13;Barcelonès;08101;Hospitalet de Llobregat, l';6;31;U;;1074;522;552;2;4;516;520
8;Barcelona;13;Barcelonès;08101;Hospitalet de Llobregat, l';6;32;U;;973;384;589;1;4;379;383
8;Barcelona;13;Barcelonès;08101;Hospitalet de Llobregat, l';6;4;U;;682;319;363;2;3;314;317
8;Barcelona;13;Barcelonès;08101;Hospitalet de Llobregat, l';6;5;U;;732;367;365;1;14;352;366
8;Barcelona;13;Barcelonès;08101;Hospitalet de Llobregat, l';6;6;U;;996;439;557;1;5;433;438
8;Barcelona;13;Barcelonès;08101;Hospitalet de Llobregat, l';6;7;U;;1036;451;585;2;7;442;449
8;Barcelona;13;Barcelonès;08101;Hospitalet de Llobregat, l';6;8;U;;909;397;512;1;3;393;396
8;Barcelona;13;Barcelonès;08101;Hospitalet de Llobregat, l';6;9;U;;881;428;453;0;11;417;428
8;Barcelona;6;Anoia;08162;Hostalets de Pierola, els;1;1;U;;758;516;242;1;3;512;515
17;Girona;34;Selva;17083;Hostalric;1;1;U;;1104;712;392;7;2;703;705
17;Girona;34;Selva;17083;Hostalric;1;2;U;;1110;670;440;6;2;662;664
8;Barcelona;6;Anoia;08102;Igualada;1;1;U;;592;375;217;0;2;373;375
8;Barcelona;6;Anoia;08102;Igualada;1;2;U;;648;410;238;4;1;405;406
8;Barcelona;6;Anoia;08102;Igualada;1;3;U;;544;314;230;0;4;310;314
8;Barcelona;6;Anoia;08102;Igualada;2;1;U;;612;416;196;0;1;415;416
8;Barcelona;6;Anoia;08102;Igualada;2;2;U;;910;541;369;2;10;529;539
8;Barcelona;6;Anoia;08102;Igualada;2;3;U;;1452;979;473;2;18;959;977
8;Barcelona;6;Anoia;08102;Igualada;3;1;U;;955;614;341;2;5;607;612
8;Barcelona;6;Anoia;08102;Igualada;3;2;U;;694;433;261;1;5;427;432
8;Barcelona;6;Anoia;08102;Igualada;3;3;U;;1376;865;511;3;12;850;862
8;Barcelona;6;Anoia;08102;Igualada;3;4;U;;1277;760;517;0;21;739;760
8;Barcelona;6;Anoia;08102;Igualada;3;5;U;;1078;681;397;0;3;678;681
8;Barcelona;6;Anoia;08102;Igualada;3;6;U;;941;594;347;0;5;589;594
8;Barcelona;6;Anoia;08102;Igualada;3;7;U;;1157;754;403;3;11;740;751
8;Barcelona;6;Anoia;08102;Igualada;4;1;U;;817;528;289;3;6;519;525
8;Barcelona;6;Anoia;08102;Igualada;4;2;U;;866;542;324;8;2;532;534
8;Barcelona;6;Anoia;08102;Igualada;4;3;U;;689;466;223;2;4;460;464
8;Barcelona;6;Anoia;08102;Igualada;4;4;U;;1016;617;399;1;7;609;616
8;Barcelona;6;Anoia;08102;Igualada;4;5;U;;1432;927;505;1;10;916;926
8;Barcelona;6;Anoia;08102;Igualada;5;1;U;;1130;717;413;2;3;712;715
8;Barcelona;6;Anoia;08102;Igualada;5;2;U;;1136;717;419;5;6;706;712
8;Barcelona;6;Anoia;08102;Igualada;5;3;A;;815;520;295;2;7;511;518
8;Barcelona;6;Anoia;08102;Igualada;5;3;B;;1000;674;326;0;6;668;674
8;Barcelona;6;Anoia;08102;Igualada;5;4;U;;1117;681;436;10;13;658;671
8;Barcelona;6;Anoia;08102;Igualada;5;5;U;;672;382;290;2;0;380;380
8;Barcelona;6;Anoia;08102;Igualada;5;6;U;;1172;684;488;4;3;677;680
8;Barcelona;6;Anoia;08102;Igualada;5;7;U;;727;458;269;2;3;453;456
25;Lleida;25;Pallars Jussà;25115;Isona i Conca Dellà;1;1;A;;749;386;363;2;7;377;384
25;Lleida;25;Pallars Jussà;25115;Isona i Conca Dellà;1;1;B;;228;121;107;5;0;116;116
25;Lleida;25;Pallars Jussà;25115;Isona i Conca Dellà;1;1;C;;229;165;64;0;1;164;165
17;Girona;15;Cerdanya;17084;Isòvol;1;1;U;;160;124;36;0;2;122;124
25;Lleida;27;Pla d'Urgell;25113;Ivars d'Urgell;1;1;U;;706;524;182;2;3;519;522
25;Lleida;27;Pla d'Urgell;25113;Ivars d'Urgell;1;2;U;;763;538;225;2;7;529;536
25;Lleida;23;Noguera;25112;Ivars de Noguera;1;1;U;;302;242;60;1;1;240;241
25;Lleida;32;Segarra;25114;Ivorra;1;1;U;;146;132;14;1;0;131;131
17;Girona;10;Baix Empordà;17085;Jafre;1;1;U;;305;216;89;2;0;214;214
17;Girona;2;Alt Empordà;17086;Jonquera, la;1;1;A;;380;189;191;1;2;186;188
17;Girona;2;Alt Empordà;17086;Jonquera, la;1;1;B;;387;186;201;2;4;180;184
17;Girona;2;Alt Empordà;17086;Jonquera, la;1;1;C;;436;230;206;2;6;222;228
17;Girona;2;Alt Empordà;17086;Jonquera, la;1;2;A;;417;234;183;1;4;229;233
17;Girona;2;Alt Empordà;17086;Jonquera, la;1;2;B;;429;242;187;5;5;232;237
8;Barcelona;6;Anoia;08103;Jorba;1;1;U;;453;276;177;1;1;274;275
25;Lleida;4;Alt Urgell;25910;Josa i Tuixén;1;1;U;;123;83;40;0;0;83;83
17;Girona;20;Gironès;17087;Juià;1;1;U;;221;155;66;0;1;154;155
25;Lleida;18;Garrigues;25118;Juncosa;1;1;U;;489;344;145;0;3;341;344
25;Lleida;18;Garrigues;25119;Juneda;1;1;A;;754;508;246;9;3;496;499
25;Lleida;18;Garrigues;25119;Juneda;1;1;B;;725;470;255;7;6;457;463
25;Lleida;18;Garrigues;25119;Juneda;1;2;U;;941;657;284;13;3;641;644
25;Lleida;39;Consell General d'Aran;25121;Les;1;1;U;;534;406;128;1;2;403;405
25;Lleida;27;Pla d'Urgell;25122;Linyola;1;1;U;;978;638;340;7;8;623;631
25;Lleida;27;Pla d'Urgell;25122;Linyola;1;2;U;;929;609;320;1;10;598;608
8;Barcelona;6;Anoia;08104;Llacuna, la;1;1;U;;627;372;255;3;7;362;369
17;Girona;2;Alt Empordà;17088;Lladó;1;1;U;;424;295;129;3;3;289;292
25;Lleida;26;Pallars Sobirà;25123;Lladorre;1;1;U;;185;132;53;2;0;130;130
25;Lleida;35;Solsonès;25124;Lladurs;1;1;U;;222;130;92;0;2;128;130
8;Barcelona;41;Vallès Oriental;08105;Llagosta, la;1;1;A;;470;221;249;0;2;219;221
8;Barcelona;41;Vallès Oriental;08105;Llagosta, la;1;1;B;;710;347;363;1;2;344;346
8;Barcelona;41;Vallès Oriental;08105;Llagosta, la;1;2;A;;667;320;347;2;1;317;318
8;Barcelona;41;Vallès Oriental;08105;Llagosta, la;1;2;B;;740;325;415;5;3;317;320
8;Barcelona;41;Vallès Oriental;08105;Llagosta, la;1;3;A;;632;273;359;0;7;266;273
8;Barcelona;41;Vallès Oriental;08105;Llagosta, la;1;3;B;;777;358;419;0;5;353;358
8;Barcelona;41;Vallès Oriental;08105;Llagosta, la;1;4;A;;589;326;263;1;1;324;325
8;Barcelona;41;Vallès Oriental;08105;Llagosta, la;1;4;B;;742;384;358;2;2;380;382
8;Barcelona;41;Vallès Oriental;08105;Llagosta, la;1;5;A;;512;203;309;1;1;201;202
8;Barcelona;41;Vallès Oriental;08105;Llagosta, la;1;5;B;;632;282;350;2;4;276;280
8;Barcelona;41;Vallès Oriental;08105;Llagosta, la;1;6;A;;535;249;286;0;1;248;249
8;Barcelona;41;Vallès Oriental;08105;Llagosta, la;1;6;B;;731;335;396;2;4;329;333
8;Barcelona;41;Vallès Oriental;08105;Llagosta, la;1;7;A;;659;305;354;5;4;296;300
8;Barcelona;41;Vallès Oriental;08105;Llagosta, la;1;7;B;;720;312;408;0;7;305;312
17;Girona;20;Gironès;17089;Llagostera;1;1;A;;565;357;208;2;3;352;355
17;Girona;20;Gironès;17089;Llagostera;1;1;B;;795;483;312;2;3;478;481
17;Girona;20;Gironès;17089;Llagostera;1;2;A;;746;514;232;1;4;509;513
17;Girona;20;Gironès;17089;Llagostera;1;2;B;;1154;776;378;1;8;767;775
17;Girona;20;Gironès;17089;Llagostera;1;3;U;;876;522;354;0;7;515;522
17;Girona;20;Gironès;17090;Llambilles;1;1;U;;356;246;110;0;3;243;246
17;Girona;31;Ripollès;17091;Llanars;1;1;U;;333;266;67;2;0;264;264
17;Girona;2;Alt Empordà;17092;Llançà;1;1;U;;601;444;157;8;5;431;436
17;Girona;2;Alt Empordà;17092;Llançà;1;2;A;;566;407;159;3;2;402;404
17;Girona;2;Alt Empordà;17092;Llançà;1;2;B;;556;399;157;2;2;395;397
17;Girona;2;Alt Empordà;17092;Llançà;1;3;A;;417;291;126;2;0;289;289
17;Girona;2;Alt Empordà;17092;Llançà;1;3;B;;501;346;155;3;5;338;343
25;Lleida;33;Segrià;25125;Llardecans;1;1;U;;566;387;179;4;8;375;383
25;Lleida;26;Pallars Sobirà;25126;Llavorsí;1;1;U;;250;151;99;0;3;148;151
25;Lleida;33;Segrià;25120;Lleida;1;1;A;;854;522;332;2;8;512;520
25;Lleida;33;Segrià;25120;Lleida;1;1;B;;947;523;424;1;14;508;522
25;Lleida;33;Segrià;25120;Lleida;1;10;U;;1195;658;537;1;8;649;657
25;Lleida;33;Segrià;25120;Lleida;1;2;U;;743;443;300;3;3;437;440
25;Lleida;33;Segrià;25120;Lleida;1;3;U;;1020;556;464;1;5;550;555
25;Lleida;33;Segrià;25120;Lleida;1;4;U;;1052;507;545;0;8;499;507
25;Lleida;33;Segrià;25120;Lleida;1;5;U;;1139;596;543;0;11;585;596
25;Lleida;33;Segrià;25120;Lleida;1;6;U;;1030;556;474;1;6;549;555
25;Lleida;33;Segrià;25120;Lleida;1;7;A;;918;428;490;0;3;425;428
25;Lleida;33;Segrià;25120;Lleida;1;7;B;;1066;495;571;0;13;482;495
25;Lleida;33;Segrià;25120;Lleida;1;8;A;;770;398;372;2;5;391;396
25;Lleida;33;Segrià;25120;Lleida;1;8;B;;892;475;417;0;8;467;475
25;Lleida;33;Segrià;25120;Lleida;1;9;U;;1078;591;487;1;8;582;590
25;Lleida;33;Segrià;25120;Lleida;2;1;U;;1026;544;482;6;7;531;538
25;Lleida;33;Segrià;25120;Lleida;2;2;A;;681;353;328;1;5;347;352
25;Lleida;33;Segrià;25120;Lleida;2;2;B;;829;464;365;2;5;457;462
25;Lleida;33;Segrià;25120;Lleida;2;3;U;;1160;583;577;5;7;571;578
25;Lleida;33;Segrià;25120;Lleida;2;4;U;;331;173;158;0;2;171;173
25;Lleida;33;Segrià;25120;Lleida;2;5;U;;534;250;284;1;3;246;249
25;Lleida;33;Segrià;25120;Lleida;2;6;A;;524;283;241;0;2;281;283
25;Lleida;33;Segrià;25120;Lleida;2;6;B;;650;365;285;2;5;358;363
25;Lleida;33;Segrià;25120;Lleida;2;7;U;;1364;675;689;4;12;659;671
25;Lleida;33;Segrià;25120;Lleida;2;8;A;;657;371;286;1;7;363;370
25;Lleida;33;Segrià;25120;Lleida;2;8;B;;723;403;320;1;5;397;402
25;Lleida;33;Segrià;25120;Lleida;3;1;U;;626;292;334;2;1;289;290
25;Lleida;33;Segrià;25120;Lleida;3;2;U;;608;287;321;2;1;284;285
25;Lleida;33;Segrià;25120;Lleida;3;3;U;;770;511;259;1;5;505;510
25;Lleida;33;Segrià;25120;Lleida;3;4;U;;924;557;367;0;13;544;557
25;Lleida;33;Segrià;25120;Lleida;3;5;U;;729;368;361;1;3;364;367
25;Lleida;33;Segrià;25120;Lleida;3;6;U;;1253;692;561;9;6;677;683
25;Lleida;33;Segrià;25120;Lleida;3;7;U;;603;325;278;8;3;314;317
25;Lleida;33;Segrià;25120;Lleida;3;8;U;;1001;571;430;1;9;561;570
25;Lleida;33;Segrià;25120;Lleida;4;1;U;;990;492;498;2;3;487;490
25;Lleida;33;Segrià;25120;Lleida;4;10;A;;730;314;416;1;5;308;313
25;Lleida;33;Segrià;25120;Lleida;4;10;B;;646;296;350;1;5;290;295
25;Lleida;33;Segrià;25120;Lleida;4;11;U;;1206;522;684;8;2;512;514
25;Lleida;33;Segrià;25120;Lleida;4;12;U;;921;527;394;4;4;519;523
25;Lleida;33;Segrià;25120;Lleida;4;13;U;;1264;599;665;3;3;593;596
25;Lleida;33;Segrià;25120;Lleida;4;14;U;;791;377;414;0;2;375;377
25;Lleida;33;Segrià;25120;Lleida;4;15;U;;1245;639;606;2;7;630;637
25;Lleida;33;Segrià;25120;Lleida;4;16;A;;658;353;305;0;8;345;353
25;Lleida;33;Segrià;25120;Lleida;4;16;B;;767;409;358;0;10;399;409
25;Lleida;33;Segrià;25120;Lleida;4;2;U;;889;440;449;2;6;432;438
25;Lleida;33;Segrià;25120;Lleida;4;3;A;;691;443;248;0;12;431;443
25;Lleida;33;Segrià;25120;Lleida;4;3;B;;790;499;291;4;18;477;495
25;Lleida;33;Segrià;25120;Lleida;4;4;U;;855;480;375;0;5;475;480
25;Lleida;33;Segrià;25120;Lleida;4;5;U;;911;543;368;1;6;536;542
25;Lleida;33;Segrià;25120;Lleida;4;6;U;;1148;620;528;10;3;607;610
25;Lleida;33;Segrià;25120;Lleida;4;7;U;;1065;531;534;4;9;518;527
25;Lleida;33;Segrià;25120;Lleida;4;8;U;;1143;582;561;1;4;577;581
25;Lleida;33;Segrià;25120;Lleida;4;9;A;;933;450;483;2;6;442;448
25;Lleida;33;Segrià;25120;Lleida;4;9;B;;929;422;507;0;5;417;422
25;Lleida;33;Segrià;25120;Lleida;5;1;U;;655;281;374;0;0;281;281
25;Lleida;33;Segrià;25120;Lleida;5;10;U;;1008;585;423;4;14;567;581
25;Lleida;33;Segrià;25120;Lleida;5;2;A;;497;298;199;4;7;287;294
25;Lleida;33;Segrià;25120;Lleida;5;2;B;;578;330;248;3;6;321;327
25;Lleida;33;Segrià;25120;Lleida;5;3;U;;1207;719;488;5;11;703;714
25;Lleida;33;Segrià;25120;Lleida;5;4;U;;1055;653;402;0;19;634;653
25;Lleida;33;Segrià;25120;Lleida;5;5;U;;1025;653;372;5;13;635;648
25;Lleida;33;Segrià;25120;Lleida;5;6;U;;1422;803;619;7;16;780;796
25;Lleida;33;Segrià;25120;Lleida;5;7;U;;911;486;425;4;5;477;482
25;Lleida;33;Segrià;25120;Lleida;5;8;A;;746;388;358;5;5;378;383
25;Lleida;33;Segrià;25120;Lleida;5;8;B;;869;520;349;0;11;509;520
25;Lleida;33;Segrià;25120;Lleida;5;9;U;;863;526;337;4;12;510;522
25;Lleida;33;Segrià;25120;Lleida;6;1;U;;524;215;309;4;2;209;211
25;Lleida;33;Segrià;25120;Lleida;6;10;U;;1314;741;573;4;14;723;737
25;Lleida;33;Segrià;25120;Lleida;6;11;A;;757;426;331;2;6;418;424
25;Lleida;33;Segrià;25120;Lleida;6;11;B;;743;437;306;3;8;426;434
25;Lleida;33;Segrià;25120;Lleida;6;12;U;;1364;767;597;5;22;740;762
25;Lleida;33;Segrià;25120;Lleida;6;13;U;;1208;731;477;1;9;721;730
25;Lleida;33;Segrià;25120;Lleida;6;14;U;;654;328;326;2;3;323;326
25;Lleida;33;Segrià;25120;Lleida;6;2;A;;737;432;305;1;3;428;431
25;Lleida;33;Segrià;25120;Lleida;6;2;B;;799;489;310;3;4;482;486
25;Lleida;33;Segrià;25120;Lleida;6;3;A;;789;435;354;4;9;422;431
25;Lleida;33;Segrià;25120;Lleida;6;3;B;;856;455;401;7;7;441;448
25;Lleida;33;Segrià;25120;Lleida;6;4;A;;932;563;369;2;13;548;561
25;Lleida;33;Segrià;25120;Lleida;6;4;B;;1043;595;448;0;12;583;595
25;Lleida;33;Segrià;25120;Lleida;6;5;U;;971;630;341;1;18;611;629
25;Lleida;33;Segrià;25120;Lleida;6;6;A;;799;358;441;2;6;350;356
25;Lleida;33;Segrià;25120;Lleida;6;6;B;;874;423;451;2;8;413;421
25;Lleida;33;Segrià;25120;Lleida;6;7;U;;1258;583;675;2;12;569;581
25;Lleida;33;Segrià;25120;Lleida;6;8;U;;1045;659;386;2;11;646;657
25;Lleida;33;Segrià;25120;Lleida;6;9;U;;1051;521;530;1;10;510;520
25;Lleida;33;Segrià;25120;Lleida;7;1;A;;757;373;384;1;5;367;372
25;Lleida;33;Segrià;25120;Lleida;7;1;B;;820;403;417;2;4;397;401
25;Lleida;33;Segrià;25120;Lleida;7;2;A;;651;337;314;0;2;335;337
25;Lleida;33;Segrià;25120;Lleida;7;2;B;;779;388;391;5;5;378;383
25;Lleida;33;Segrià;25120;Lleida;7;3;A;;157;98;59;0;0;98;98
25;Lleida;33;Segrià;25120;Lleida;7;3;B;;392;170;222;0;5;165;170
25;Lleida;33;Segrià;25120;Lleida;7;4;A;;702;432;270;4;1;427;428
25;Lleida;33;Segrià;25120;Lleida;7;4;B;;837;523;314;4;6;513;519
25;Lleida;33;Segrià;25120;Lleida;7;5;U;;924;454;470;0;7;447;454
25;Lleida;33;Segrià;25120;Lleida;7;6;A;;697;367;330;0;8;359;367
25;Lleida;33;Segrià;25120;Lleida;7;6;B;;804;444;360;0;8;436;444
25;Lleida;33;Segrià;25120;Lleida;8;1;A;;676;322;354;0;10;312;322
25;Lleida;33;Segrià;25120;Lleida;8;1;B;;777;344;433;1;2;341;343
25;Lleida;33;Segrià;25120;Lleida;8;2;A;;621;380;241;0;6;374;380
25;Lleida;33;Segrià;25120;Lleida;8;2;B;;352;136;216;0;1;135;136
25;Lleida;33;Segrià;25120;Lleida;8;3;A;;362;223;139;1;4;218;222
25;Lleida;33;Segrià;25120;Lleida;8;3;B;;505;304;201;2;3;299;302
25;Lleida;33;Segrià;25120;Lleida;9;1;A;;433;228;205;0;5;223;228
25;Lleida;33;Segrià;25120;Lleida;9;1;B;;610;272;338;0;2;270;272
25;Lleida;33;Segrià;25120;Lleida;9;2;A;;724;367;357;0;3;364;367
25;Lleida;33;Segrià;25120;Lleida;9;2;B;;388;213;175;0;4;209;213
17;Girona;2;Alt Empordà;17093;Llers;1;1;U;;627;392;235;5;2;385;387
25;Lleida;15;Cerdanya;25127;Lles de Cerdanya;1;1;U;;264;155;109;0;5;150;155
8;Barcelona;41;Vallès Oriental;08107;Lliçà d'Amunt;1;1;A;;686;384;302;3;7;374;381
8;Barcelona;41;Vallès Oriental;08107;Lliçà d'Amunt;1;1;B;;722;365;357;3;0;362;362
8;Barcelona;41;Vallès Oriental;08107;Lliçà d'Amunt;1;1;C;;856;440;416;0;6;434;440
8;Barcelona;41;Vallès Oriental;08107;Lliçà d'Amunt;1;2;A;;826;440;386;0;9;431;440
8;Barcelona;41;Vallès Oriental;08107;Lliçà d'Amunt;1;2;B;;1052;539;513;3;6;530;536
8;Barcelona;41;Vallès Oriental;08108;Lliçà de Vall;1;1;A;;649;313;336;6;1;306;307
8;Barcelona;41;Vallès Oriental;08108;Lliçà de Vall;1;1;B;;711;351;360;1;4;346;350
8;Barcelona;41;Vallès Oriental;08108;Lliçà de Vall;1;2;A;;538;325;213;2;2;321;323
8;Barcelona;41;Vallès Oriental;08108;Lliçà de Vall;1;2;B;;601;353;248;1;0;352;352
25;Lleida;25;Pallars Jussà;25128;Llimiana;1;1;U;;117;70;47;0;1;69;70
8;Barcelona;41;Vallès Oriental;08106;Llinars del Vallès;1;1;A;;664;364;300;1;2;361;363
8;Barcelona;41;Vallès Oriental;08106;Llinars del Vallès;1;1;B;;562;314;248;0;2;312;314
8;Barcelona;41;Vallès Oriental;08106;Llinars del Vallès;1;1;C;;712;400;312;1;2;397;399
8;Barcelona;41;Vallès Oriental;08106;Llinars del Vallès;2;1;A;;808;467;341;2;7;458;465
8;Barcelona;41;Vallès Oriental;08106;Llinars del Vallès;2;1;B;;648;330;318;0;5;325;330
8;Barcelona;41;Vallès Oriental;08106;Llinars del Vallès;2;1;C;;806;428;378;3;2;423;425
17;Girona;15;Cerdanya;17094;Llívia;1;1;U;;721;467;254;2;7;458;465
43;Tarragona;29;Priorat;43072;Lloar, el;1;1;U;;130;90;40;0;1;89;90
25;Lleida;35;Solsonès;25129;Llobera;1;1;U;;209;131;78;0;3;128;131
43;Tarragona;16;Conca de Barberà;43073;Llorac;1;1;U;;87;62;25;0;0;62;62
43;Tarragona;12;Baix Penedès;43074;Llorenç del Penedès;1;1;U;;1032;740;292;11;4;725;729
17;Girona;34;Selva;17095;Lloret de Mar;1;1;U;;1183;486;697;0;4;482;486
17;Girona;34;Selva;17095;Lloret de Mar;1;2;U;;1235;611;624;2;10;599;609
17;Girona;34;Selva;17095;Lloret de Mar;2;1;A;;830;446;384;8;1;437;438
17;Girona;34;Selva;17095;Lloret de Mar;2;1;B;;936;513;423;1;4;508;512
17;Girona;34;Selva;17095;Lloret de Mar;2;2;A;;676;347;329;0;3;344;347
17;Girona;34;Selva;17095;Lloret de Mar;2;2;B;;731;354;377;1;4;349;353
17;Girona;34;Selva;17095;Lloret de Mar;2;3;U;;1054;490;564;0;4;486;490
17;Girona;34;Selva;17095;Lloret de Mar;3;1;U;;1230;478;752;2;3;473;476
17;Girona;34;Selva;17095;Lloret de Mar;3;2;A;;926;432;494;5;4;423;427
17;Girona;34;Selva;17095;Lloret de Mar;3;2;B;;1023;464;559;3;3;458;461
17;Girona;34;Selva;17095;Lloret de Mar;4;1;A;;925;387;538;0;3;384;387
17;Girona;34;Selva;17095;Lloret de Mar;4;1;B;;1057;443;614;1;5;437;442
17;Girona;31;Ripollès;17096;Llosses, les;1;1;U;;341;130;211;1;1;128;129
8;Barcelona;24;Osona;08109;Lluçà;1;1;U;;229;152;77;2;0;150;150
17;Girona;2;Alt Empordà;17102;Maçanet de Cabrenys;1;1;U;;596;430;166;0;5;425;430
17;Girona;34;Selva;17103;Maçanet de la Selva;1;1;A;;917;579;338;5;6;568;574
17;Girona;34;Selva;17103;Maçanet de la Selva;1;1;B;;659;401;258;7;6;388;394
17;Girona;34;Selva;17103;Maçanet de la Selva;1;2;U;;707;349;358;3;3;343;346
17;Girona;20;Gironès;17097;Madremanya;1;1;U;;170;117;53;0;2;115;117
17;Girona;19;Garrotxa;17098;Maià de Montcal;1;1;U;;282;189;93;1;5;183;188
25;Lleida;33;Segrià;25133;Maials;1;1;U;;961;603;358;3;4;596;600
25;Lleida;38;Urgell;25130;Maldà;1;1;U;;278;185;93;2;2;181;183
8;Barcelona;21;Maresme;08110;Malgrat de Mar;1;1;A;;753;414;339;3;2;409;411
8;Barcelona;21;Maresme;08110;Malgrat de Mar;1;1;B;;921;514;407;0;5;509;514
8;Barcelona;21;Maresme;08110;Malgrat de Mar;1;2;A;;420;289;131;2;0;287;287
8;Barcelona;21;Maresme;08110;Malgrat de Mar;1;2;B;;543;365;178;0;7;358;365
8;Barcelona;21;Maresme;08110;Malgrat de Mar;1;3;A;;512;296;216;0;3;293;296
8;Barcelona;21;Maresme;08110;Malgrat de Mar;1;3;B;;587;320;267;0;8;312;320
8;Barcelona;21;Maresme;08110;Malgrat de Mar;1;4;A;;521;302;219;0;5;297;302
8;Barcelona;21;Maresme;08110;Malgrat de Mar;1;4;B;;615;333;282;2;1;330;331
8;Barcelona;21;Maresme;08110;Malgrat de Mar;1;5;A;;560;299;261;0;2;297;299
8;Barcelona;21;Maresme;08110;Malgrat de Mar;1;5;B;;572;326;246;0;3;323;326
8;Barcelona;21;Maresme;08110;Malgrat de Mar;2;1;A;;666;413;253;1;3;409;412
8;Barcelona;21;Maresme;08110;Malgrat de Mar;2;1;B;;882;543;339;3;4;536;540
8;Barcelona;21;Maresme;08110;Malgrat de Mar;2;2;A;;481;317;164;1;7;309;316
8;Barcelona;21;Maresme;08110;Malgrat de Mar;2;2;B;;455;275;180;2;1;272;273
8;Barcelona;21;Maresme;08110;Malgrat de Mar;2;2;C;;585;346;239;1;3;342;345
8;Barcelona;24;Osona;08111;Malla;1;1;U;;212;177;35;1;4;172;176
8;Barcelona;24;Osona;08112;Manlleu;1;1;A;;550;371;179;4;0;367;367
8;Barcelona;24;Osona;08112;Manlleu;1;1;B;;646;417;229;0;2;415;417
8;Barcelona;24;Osona;08112;Manlleu;1;2;U;;764;561;203;8;0;553;553
8;Barcelona;24;Osona;08112;Manlleu;2;1;A;;570;396;174;0;2;394;396
8;Barcelona;24;Osona;08112;Manlleu;2;1;B;;740;509;231;0;4;505;509
8;Barcelona;24;Osona;08112;Manlleu;2;2;A;;531;311;220;1;2;308;310
8;Barcelona;24;Osona;08112;Manlleu;2;2;B;;644;374;270;1;4;369;373
8;Barcelona;24;Osona;08112;Manlleu;2;3;A;;547;366;181;1;6;359;365
8;Barcelona;24;Osona;08112;Manlleu;2;3;B;;603;388;215;0;1;387;388
8;Barcelona;24;Osona;08112;Manlleu;2;4;A;;506;307;199;1;3;303;306
8;Barcelona;24;Osona;08112;Manlleu;2;4;B;;626;396;230;1;1;394;395
8;Barcelona;24;Osona;08112;Manlleu;3;1;A;;786;470;316;1;1;468;469
8;Barcelona;24;Osona;08112;Manlleu;3;1;B;;820;454;366;0;2;452;454
8;Barcelona;24;Osona;08112;Manlleu;3;2;A;;554;386;168;0;3;383;386
8;Barcelona;24;Osona;08112;Manlleu;3;2;B;;729;470;259;1;5;464;469
8;Barcelona;24;Osona;08112;Manlleu;3;3;A;;624;405;219;1;2;402;404
8;Barcelona;24;Osona;08112;Manlleu;3;3;B;;781;490;291;1;3;486;489
8;Barcelona;24;Osona;08112;Manlleu;4;1;U;;649;447;202;0;2;445;447
8;Barcelona;24;Osona;08112;Manlleu;4;2;A;;559;382;177;0;6;376;382
8;Barcelona;24;Osona;08112;Manlleu;4;2;B;;633;418;215;2;3;413;416
8;Barcelona;7;Bages;08113;Manresa;1;1;U;;647;332;315;0;8;324;332
8;Barcelona;7;Bages;08113;Manresa;1;2;U;;397;201;196;1;1;199;200
8;Barcelona;7;Bages;08113;Manresa;1;3;U;;475;274;201;0;2;272;274
8;Barcelona;7;Bages;08113;Manresa;1;4;U;;442;278;164;1;3;274;277
8;Barcelona;7;Bages;08113;Manresa;2;1;U;;890;608;282;3;10;595;605
8;Barcelona;7;Bages;08113;Manresa;2;10;A;;624;440;184;1;3;436;439
8;Barcelona;7;Bages;08113;Manresa;2;10;B;;740;471;269;0;5;466;471
8;Barcelona;7;Bages;08113;Manresa;2;11;A;;552;343;209;2;1;340;341
8;Barcelona;7;Bages;08113;Manresa;2;11;B;;657;397;260;0;0;397;397
8;Barcelona;7;Bages;08113;Manresa;2;12;U;;743;424;319;1;8;415;423
8;Barcelona;7;Bages;08113;Manresa;2;13;A;;510;328;182;1;5;322;327
8;Barcelona;7;Bages;08113;Manresa;2;13;B;;649;410;239;8;5;397;402
8;Barcelona;7;Bages;08113;Manresa;2;14;U;;550;213;337;0;3;210;213
8;Barcelona;7;Bages;08113;Manresa;2;2;A;;641;431;210;0;4;427;431
8;Barcelona;7;Bages;08113;Manresa;2;2;B;;881;592;289;4;7;581;588
8;Barcelona;7;Bages;08113;Manresa;2;3;A;;629;391;238;0;8;383;391
8;Barcelona;7;Bages;08113;Manresa;2;3;B;;803;527;276;1;5;521;526
8;Barcelona;7;Bages;08113;Manresa;2;4;A;;662;437;225;0;6;431;437
8;Barcelona;7;Bages;08113;Manresa;2;4;B;;902;594;308;0;0;594;594
8;Barcelona;7;Bages;08113;Manresa;2;5;A;;723;456;267;1;4;451;455
8;Barcelona;7;Bages;08113;Manresa;2;5;B;;826;520;306;0;1;519;520
8;Barcelona;7;Bages;08113;Manresa;2;6;U;;743;393;350;1;4;388;392
8;Barcelona;7;Bages;08113;Manresa;2;7;A;;472;260;212;4;1;255;256
8;Barcelona;7;Bages;08113;Manresa;2;7;B;;584;341;243;1;4;336;340
8;Barcelona;7;Bages;08113;Manresa;2;8;U;;656;356;300;2;0;354;354
8;Barcelona;7;Bages;08113;Manresa;2;9;A;;593;350;243;2;4;344;348
8;Barcelona;7;Bages;08113;Manresa;2;9;B;;783;473;310;0;5;468;473
8;Barcelona;7;Bages;08113;Manresa;3;1;U;;540;298;242;1;2;295;297
8;Barcelona;7;Bages;08113;Manresa;3;2;U;;732;402;330;0;5;397;402
8;Barcelona;7;Bages;08113;Manresa;3;3;U;;590;325;265;2;2;321;323
8;Barcelona;7;Bages;08113;Manresa;3;4;A;;472;283;189;1;5;277;282
8;Barcelona;7;Bages;08113;Manresa;3;4;B;;646;394;252;1;4;389;393
8;Barcelona;7;Bages;08113;Manresa;3;5;U;;349;189;160;0;1;188;189
8;Barcelona;7;Bages;08113;Manresa;3;6;A;;466;305;161;0;6;299;305
8;Barcelona;7;Bages;08113;Manresa;3;6;B;;680;422;258;5;9;408;417
8;Barcelona;7;Bages;08113;Manresa;3;7;U;;637;392;245;3;3;386;389
8;Barcelona;7;Bages;08113;Manresa;4;1;U;;570;373;197;0;2;371;373
8;Barcelona;7;Bages;08113;Manresa;4;10;A;;458;272;186;0;2;270;272
8;Barcelona;7;Bages;08113;Manresa;4;10;B;;570;336;234;1;3;332;335
8;Barcelona;7;Bages;08113;Manresa;4;11;U;;868;522;346;4;2;516;518
8;Barcelona;7;Bages;08113;Manresa;4;12;U;;597;358;239;0;0;358;358
8;Barcelona;7;Bages;08113;Manresa;4;2;A;;558;345;213;6;4;335;339
8;Barcelona;7;Bages;08113;Manresa;4;2;B;;556;370;186;2;1;367;368
8;Barcelona;7;Bages;08113;Manresa;4;3;U;;892;554;338;4;2;548;550
8;Barcelona;7;Bages;08113;Manresa;4;4;A;;646;440;206;1;1;438;439
8;Barcelona;7;Bages;08113;Manresa;4;4;B;;909;607;302;1;8;598;606
8;Barcelona;7;Bages;08113;Manresa;4;5;U;;445;288;157;0;5;283;288
8;Barcelona;7;Bages;08113;Manresa;4;6;A;;529;341;188;4;3;334;337
8;Barcelona;7;Bages;08113;Manresa;4;6;B;;741;491;250;1;8;482;490
8;Barcelona;7;Bages;08113;Manresa;4;7;A;;559;353;206;0;1;352;353
8;Barcelona;7;Bages;08113;Manresa;4;7;B;;684;414;270;0;9;405;414
8;Barcelona;7;Bages;08113;Manresa;4;8;A;;539;362;177;1;8;353;361
8;Barcelona;7;Bages;08113;Manresa;4;8;B;;703;431;272;2;2;427;429
8;Barcelona;7;Bages;08113;Manresa;4;9;A;;551;334;217;1;7;326;333
8;Barcelona;7;Bages;08113;Manresa;4;9;B;;557;313;244;3;1;309;310
8;Barcelona;7;Bages;08113;Manresa;4;9;C;;779;451;328;2;5;444;449
8;Barcelona;7;Bages;08113;Manresa;5;1;U;;926;520;406;0;4;516;520
8;Barcelona;7;Bages;08113;Manresa;5;10;A;;557;286;271;1;2;283;285
8;Barcelona;7;Bages;08113;Manresa;5;10;B;;620;328;292;0;2;326;328
8;Barcelona;7;Bages;08113;Manresa;5;11;A;;467;292;175;0;2;290;292
8;Barcelona;7;Bages;08113;Manresa;5;11;B;;599;363;236;2;4;357;361
8;Barcelona;7;Bages;08113;Manresa;5;12;U;;775;437;338;0;6;431;437
8;Barcelona;7;Bages;08113;Manresa;5;13;A;;544;305;239;0;5;300;305
8;Barcelona;7;Bages;08113;Manresa;5;13;B;;612;383;229;1;7;375;382
8;Barcelona;7;Bages;08113;Manresa;5;14;A;;470;295;175;1;5;289;294
8;Barcelona;7;Bages;08113;Manresa;5;14;B;;582;381;201;0;4;377;381
8;Barcelona;7;Bages;08113;Manresa;5;15;A;;737;354;383;0;3;351;354
8;Barcelona;7;Bages;08113;Manresa;5;15;B;;906;470;436;0;3;467;470
8;Barcelona;7;Bages;08113;Manresa;5;16;U;;620;308;312;0;1;307;308
8;Barcelona;7;Bages;08113;Manresa;5;2;U;;362;203;159;3;1;199;200
8;Barcelona;7;Bages;08113;Manresa;5;3;U;;924;526;398;1;1;524;525
8;Barcelona;7;Bages;08113;Manresa;5;4;U;;636;461;175;2;4;455;459
8;Barcelona;7;Bages;08113;Manresa;5;5;A;;544;321;223;2;0;319;319
8;Barcelona;7;Bages;08113;Manresa;5;5;B;;621;373;248;1;3;369;372
8;Barcelona;7;Bages;08113;Manresa;5;6;A;;606;373;233;3;4;366;370
8;Barcelona;7;Bages;08113;Manresa;5;6;B;;836;493;343;1;2;490;492
8;Barcelona;7;Bages;08113;Manresa;5;7;U;;462;278;184;1;4;273;277
8;Barcelona;7;Bages;08113;Manresa;5;8;U;;641;407;234;0;4;403;407
8;Barcelona;7;Bages;08113;Manresa;5;9;U;;940;568;372;3;2;563;565
8;Barcelona;7;Bages;08113;Manresa;6;1;A;;548;294;254;4;0;290;290
8;Barcelona;7;Bages;08113;Manresa;6;1;B;;766;440;326;4;2;434;436
8;Barcelona;7;Bages;08113;Manresa;6;2;U;;517;316;201;0;6;310;316
8;Barcelona;7;Bages;08113;Manresa;6;3;U;;435;245;190;0;4;241;245
43;Tarragona;29;Priorat;43076;Marçà;1;1;U;;478;347;131;1;3;343;346
43;Tarragona;29;Priorat;43075;Margalef;1;1;U;;138;86;52;0;0;86;86
8;Barcelona;7;Bages;08242;Marganell;1;1;U;;182;127;55;0;0;127;127
8;Barcelona;11;Baix Llobregat;08114;Martorell;1;1;A;;460;308;152;1;3;304;307
8;Barcelona;11;Baix Llobregat;08114;Martorell;1;1;B;;470;316;154;4;2;310;312
8;Barcelona;11;Baix Llobregat;08114;Martorell;2;1;U;;748;450;298;0;5;445;450
8;Barcelona;11;Baix Llobregat;08114;Martorell;2;2;A;;522;346;176;0;5;341;346
8;Barcelona;11;Baix Llobregat;08114;Martorell;2;2;B;;514;357;157;5;5;347;352
8;Barcelona;11;Baix Llobregat;08114;Martorell;3;1;A;;787;457;330;2;2;453;455
8;Barcelona;11;Baix Llobregat;08114;Martorell;3;1;B;;908;534;374;3;7;524;531
8;Barcelona;11;Baix Llobregat;08114;Martorell;3;2;A;;468;275;193;0;2;273;275
8;Barcelona;11;Baix Llobregat;08114;Martorell;3;2;B;;490;288;202;0;1;287;288
8;Barcelona;11;Baix Llobregat;08114;Martorell;3;3;A;;437;251;186;0;0;251;251
8;Barcelona;11;Baix Llobregat;08114;Martorell;3;3;B;;542;318;224;1;3;314;317
8;Barcelona;11;Baix Llobregat;08114;Martorell;3;4;A;;534;287;247;1;4;282;286
8;Barcelona;11;Baix Llobregat;08114;Martorell;3;4;B;;643;313;330;1;5;307;312
8;Barcelona;11;Baix Llobregat;08114;Martorell;3;4;C;;649;329;320;1;1;327;328
8;Barcelona;11;Baix Llobregat;08114;Martorell;3;5;A;;665;384;281;0;2;382;384
8;Barcelona;11;Baix Llobregat;08114;Martorell;3;5;B;;680;421;259;3;1;417;418
8;Barcelona;11;Baix Llobregat;08114;Martorell;3;6;A;;882;563;319;1;3;559;562
8;Barcelona;11;Baix Llobregat;08114;Martorell;3;6;B;;895;562;333;3;5;554;559
8;Barcelona;11;Baix Llobregat;08114;Martorell;3;7;A;;808;440;368;2;1;437;438
8;Barcelona;11;Baix Llobregat;08114;Martorell;3;7;B;;872;455;417;0;6;449;455
8;Barcelona;41;Vallès Oriental;08115;Martorelles;1;1;A;;671;321;350;3;1;317;318
8;Barcelona;41;Vallès Oriental;08115;Martorelles;1;1;B;;937;458;479;3;1;454;455
8;Barcelona;41;Vallès Oriental;08115;Martorelles;1;2;A;;459;259;200;1;5;253;258
8;Barcelona;41;Vallès Oriental;08115;Martorelles;1;2;B;;664;384;280;4;4;376;380
8;Barcelona;41;Vallès Oriental;08115;Martorelles;1;3;A;;439;230;209;1;3;226;229
8;Barcelona;41;Vallès Oriental;08115;Martorelles;1;3;B;;618;341;277;1;3;337;340
17;Girona;2;Alt Empordà;17100;Masarac;1;1;U;;225;159;66;0;2;157;159
43;Tarragona;22;Montsià;43077;Mas de Barberans;1;1;U;;627;424;203;4;6;414;420
43;Tarragona;22;Montsià;43078;Masdenverge;1;1;U;;714;402;312;0;3;399;402
8;Barcelona;24;Osona;08116;Masies de Roda, les;1;1;U;;487;338;149;0;1;337;338
8;Barcelona;24;Osona;08117;Masies de Voltregà, les;1;1;A;;765;567;198;0;10;557;567
8;Barcelona;24;Osona;08117;Masies de Voltregà, les;1;1;B;;559;371;188;0;2;369;371
8;Barcelona;24;Osona;08117;Masies de Voltregà, les;2;1;U;;664;403;261;2;0;401;401
43;Tarragona;12;Baix Penedès;43079;Masllorenç;1;1;U;;326;217;109;2;0;215;215
8;Barcelona;21;Maresme;08118;Masnou, el;1;1;U;;1038;533;505;1;9;523;532
8;Barcelona;21;Maresme;08118;Masnou, el;1;2;A;;859;467;392;1;5;461;466
8;Barcelona;21;Maresme;08118;Masnou, el;1;2;B;;984;563;421;1;7;555;562
8;Barcelona;21;Maresme;08118;Masnou, el;1;3;A;;676;350;326;5;5;340;345
8;Barcelona;21;Maresme;08118;Masnou, el;1;3;B;;718;378;340;2;6;370;376
8;Barcelona;21;Maresme;08118;Masnou, el;1;4;U;;903;498;405;1;7;490;497
8;Barcelona;21;Maresme;08118;Masnou, el;1;5;A;;709;411;298;2;5;404;409
8;Barcelona;21;Maresme;08118;Masnou, el;1;5;B;;787;426;361;4;4;418;422
8;Barcelona;21;Maresme;08118;Masnou, el;1;6;A;;561;274;287;0;5;269;274
8;Barcelona;21;Maresme;08118;Masnou, el;1;6;B;;673;319;354;1;4;314;318
8;Barcelona;21;Maresme;08118;Masnou, el;1;7;A;;525;265;260;4;1;260;261
8;Barcelona;21;Maresme;08118;Masnou, el;1;7;B;;589;288;301;0;5;283;288
8;Barcelona;21;Maresme;08118;Masnou, el;1;8;U;;902;478;424;2;11;465;476
8;Barcelona;21;Maresme;08118;Masnou, el;2;1;A;;545;314;231;0;7;307;314
8;Barcelona;21;Maresme;08118;Masnou, el;2;1;B;;597;355;242;0;4;351;355
8;Barcelona;21;Maresme;08118;Masnou, el;2;2;A;;892;488;404;0;7;481;488
8;Barcelona;21;Maresme;08118;Masnou, el;2;2;B;;944;520;424;1;6;513;519
8;Barcelona;21;Maresme;08118;Masnou, el;2;3;A;;478;241;237;1;4;236;240
8;Barcelona;21;Maresme;08118;Masnou, el;2;3;B;;536;308;228;0;0;308;308
43;Tarragona;1;Alt Camp;43080;Masó, la;1;1;U;;217;139;78;6;5;128;133
43;Tarragona;8;Baix Camp;43081;Maspujols;1;1;U;;332;242;90;3;4;235;239
8;Barcelona;6;Anoia;08119;Masquefa;1;1;A;;699;448;251;0;1;447;448
8;Barcelona;6;Anoia;08119;Masquefa;1;1;B;;694;415;279;11;0;404;404
8;Barcelona;6;Anoia;08119;Masquefa;1;1;C;;719;435;284;5;0;430;430
43;Tarragona;29;Priorat;43082;Masroig, el;1;1;U;;456;375;81;1;3;371;374
25;Lleida;33;Segrià;25131;Massalcoreig;1;1;U;;564;469;95;0;0;469;469
17;Girona;34;Selva;17101;Massanes;1;1;U;;374;244;130;0;0;244;244
25;Lleida;32;Segarra;25132;Massoteres;1;1;U;;147;104;43;0;2;102;104
8;Barcelona;40;Vallès Occidental;08120;Matadepera;1;1;A;;805;583;222;0;4;579;583
8;Barcelona;40;Vallès Occidental;08120;Matadepera;1;1;B;;751;532;219;1;4;527;531
8;Barcelona;40;Vallès Occidental;08120;Matadepera;1;2;A;;914;666;248;0;6;660;666
8;Barcelona;40;Vallès Occidental;08120;Matadepera;1;2;B;;1010;732;278;1;8;723;731
8;Barcelona;21;Maresme;08121;Mataró;1;1;U;;709;503;206;2;6;495;501
8;Barcelona;21;Maresme;08121;Mataró;1;2;A;;478;322;156;0;2;320;322
8;Barcelona;21;Maresme;08121;Mataró;1;2;B;;521;342;179;0;2;340;342
8;Barcelona;21;Maresme;08121;Mataró;1;3;A;;519;366;153;0;7;359;366
8;Barcelona;21;Maresme;08121;Mataró;1;3;B;;568;391;177;0;4;387;391
8;Barcelona;21;Maresme;08121;Mataró;1;4;A;;499;370;129;3;2;365;367
8;Barcelona;21;Maresme;08121;Mataró;1;4;B;;516;385;131;3;0;382;382
8;Barcelona;21;Maresme;08121;Mataró;1;5;A;;504;370;134;0;4;366;370
8;Barcelona;21;Maresme;08121;Mataró;1;5;B;;623;466;157;0;5;461;466
8;Barcelona;21;Maresme;08121;Mataró;1;6;A;;592;436;156;1;3;432;435
8;Barcelona;21;Maresme;08121;Mataró;1;6;B;;465;318;147;0;2;316;318
8;Barcelona;21;Maresme;08121;Mataró;1;6;C;;635;447;188;0;3;444;447
8;Barcelona;21;Maresme;08121;Mataró;1;7;A;;501;358;143;2;3;353;356
8;Barcelona;21;Maresme;08121;Mataró;1;7;B;;597;427;170;0;0;427;427
8;Barcelona;21;Maresme;08121;Mataró;1;8;U;;615;448;167;0;8;440;448
8;Barcelona;21;Maresme;08121;Mataró;2;1;A;;544;358;186;0;0;358;358
8;Barcelona;21;Maresme;08121;Mataró;2;1;B;;606;400;206;0;1;399;400
8;Barcelona;21;Maresme;08121;Mataró;2;10;U;;902;608;294;0;4;604;608
8;Barcelona;21;Maresme;08121;Mataró;2;11;A;;549;366;183;1;3;362;365
8;Barcelona;21;Maresme;08121;Mataró;2;11;B;;549;353;196;1;1;351;352
8;Barcelona;21;Maresme;08121;Mataró;2;12;U;;865;589;276;3;3;583;586
8;Barcelona;21;Maresme;08121;Mataró;2;2;U;;802;463;339;2;3;458;461
8;Barcelona;21;Maresme;08121;Mataró;2;3;U;;607;355;252;0;3;352;355
8;Barcelona;21;Maresme;08121;Mataró;2;4;U;;879;439;440;1;1;437;438
8;Barcelona;21;Maresme;08121;Mataró;2;5;A;;636;391;245;0;6;385;391
8;Barcelona;21;Maresme;08121;Mataró;2;5;B;;777;449;328;0;3;446;449
8;Barcelona;21;Maresme;08121;Mataró;2;6;A;;561;330;231;1;5;324;329
8;Barcelona;21;Maresme;08121;Mataró;2;6;B;;690;377;313;1;1;375;376
8;Barcelona;21;Maresme;08121;Mataró;2;7;U;;482;329;153;0;2;327;329
8;Barcelona;21;Maresme;08121;Mataró;2;8;A;;544;347;197;0;6;341;347
8;Barcelona;21;Maresme;08121;Mataró;2;8;B;;592;412;180;1;6;405;411
8;Barcelona;21;Maresme;08121;Mataró;2;9;U;;859;583;276;1;4;578;582
8;Barcelona;21;Maresme;08121;Mataró;3;1;A;;584;331;253;0;0;331;331
8;Barcelona;21;Maresme;08121;Mataró;3;1;B;;690;407;283;0;6;401;407
8;Barcelona;21;Maresme;08121;Mataró;3;10;U;;677;471;206;1;9;461;470
8;Barcelona;21;Maresme;08121;Mataró;3;11;A;;570;347;223;0;0;347;347
8;Barcelona;21;Maresme;08121;Mataró;3;11;B;;666;403;263;0;3;400;403
8;Barcelona;21;Maresme;08121;Mataró;3;12;U;;684;445;239;0;1;444;445
8;Barcelona;21;Maresme;08121;Mataró;3;2;A;;650;348;302;0;3;345;348
8;Barcelona;21;Maresme;08121;Mataró;3;2;B;;712;389;323;0;6;383;389
8;Barcelona;21;Maresme;08121;Mataró;3;3;A;;562;324;238;1;2;321;323
8;Barcelona;21;Maresme;08121;Mataró;3;3;B;;716;401;315;2;3;396;399
8;Barcelona;21;Maresme;08121;Mataró;3;4;A;;464;225;239;1;0;224;224
8;Barcelona;21;Maresme;08121;Mataró;3;4;B;;664;296;368;1;0;295;295
8;Barcelona;21;Maresme;08121;Mataró;3;4;C;;641;304;337;2;4;298;302
8;Barcelona;21;Maresme;08121;Mataró;3;5;A;;587;302;285;1;4;297;301
8;Barcelona;21;Maresme;08121;Mataró;3;5;B;;767;384;383;0;3;381;384
8;Barcelona;21;Maresme;08121;Mataró;3;6;U;;585;330;255;2;1;327;328
8;Barcelona;21;Maresme;08121;Mataró;3;7;A;;483;259;224;1;8;250;258
8;Barcelona;21;Maresme;08121;Mataró;3;7;B;;606;337;269;2;3;332;335
8;Barcelona;21;Maresme;08121;Mataró;3;8;A;;472;254;218;0;2;252;254
8;Barcelona;21;Maresme;08121;Mataró;3;8;B;;603;321;282;3;5;313;318
8;Barcelona;21;Maresme;08121;Mataró;3;9;A;;649;356;293;2;1;353;354
8;Barcelona;21;Maresme;08121;Mataró;3;9;B;;734;364;370;4;3;357;360
8;Barcelona;21;Maresme;08121;Mataró;4;1;A;;479;295;184;0;0;295;295
8;Barcelona;21;Maresme;08121;Mataró;4;1;B;;519;344;175;1;6;337;343
8;Barcelona;21;Maresme;08121;Mataró;4;2;A;;576;302;274;1;0;301;301
8;Barcelona;21;Maresme;08121;Mataró;4;2;B;;678;392;286;3;6;383;389
8;Barcelona;21;Maresme;08121;Mataró;4;3;U;;874;470;404;0;0;470;470
8;Barcelona;21;Maresme;08121;Mataró;4;4;U;;827;485;342;1;2;482;484
8;Barcelona;21;Maresme;08121;Mataró;4;5;U;;882;463;419;1;2;460;462
8;Barcelona;21;Maresme;08121;Mataró;4;6;A;;515;296;219;1;0;295;295
8;Barcelona;21;Maresme;08121;Mataró;4;6;B;;605;365;240;2;2;361;363
8;Barcelona;21;Maresme;08121;Mataró;4;7;U;;932;449;483;0;10;439;449
8;Barcelona;21;Maresme;08121;Mataró;5;1;U;;877;486;391;4;2;480;482
8;Barcelona;21;Maresme;08121;Mataró;5;10;U;;496;262;234;1;3;258;261
8;Barcelona;21;Maresme;08121;Mataró;5;11;A;;716;352;364;2;5;345;350
8;Barcelona;21;Maresme;08121;Mataró;5;11;B;;730;396;334;3;6;387;393
8;Barcelona;21;Maresme;08121;Mataró;5;12;A;;508;293;215;1;3;289;292
8;Barcelona;21;Maresme;08121;Mataró;5;12;B;;564;302;262;1;4;297;301
8;Barcelona;21;Maresme;08121;Mataró;5;13;A;;484;277;207;2;1;274;275
8;Barcelona;21;Maresme;08121;Mataró;5;13;B;;629;373;256;0;7;366;373
8;Barcelona;21;Maresme;08121;Mataró;5;13;C;;671;366;305;2;2;362;364
8;Barcelona;21;Maresme;08121;Mataró;5;14;U;;754;386;368;0;4;382;386
8;Barcelona;21;Maresme;08121;Mataró;5;15;U;;805;390;415;2;4;384;388
8;Barcelona;21;Maresme;08121;Mataró;5;16;A;;518;270;248;0;1;269;270
8;Barcelona;21;Maresme;08121;Mataró;5;16;B;;496;271;225;0;3;268;271
8;Barcelona;21;Maresme;08121;Mataró;5;17;U;;791;415;376;1;1;413;414
8;Barcelona;21;Maresme;08121;Mataró;5;18;U;;541;271;270;0;3;268;271
8;Barcelona;21;Maresme;08121;Mataró;5;19;U;;732;370;362;0;3;367;370
8;Barcelona;21;Maresme;08121;Mataró;5;2;A;;604;335;269;2;2;331;333
8;Barcelona;21;Maresme;08121;Mataró;5;2;B;;644;366;278;1;2;363;365
8;Barcelona;21;Maresme;08121;Mataró;5;20;A;;533;254;279;0;1;253;254
8;Barcelona;21;Maresme;08121;Mataró;5;20;B;;669;334;335;0;3;331;334
8;Barcelona;21;Maresme;08121;Mataró;5;3;A;;793;422;371;0;3;419;422
8;Barcelona;21;Maresme;08121;Mataró;5;3;B;;923;467;456;1;6;460;466
8;Barcelona;21;Maresme;08121;Mataró;5;4;U;;902;506;396;0;4;502;506
8;Barcelona;21;Maresme;08121;Mataró;5;5;U;;689;349;340;0;0;349;349
8;Barcelona;21;Maresme;08121;Mataró;5;6;A;;589;276;313;0;7;269;276
8;Barcelona;21;Maresme;08121;Mataró;5;6;B;;622;302;320;0;2;300;302
8;Barcelona;21;Maresme;08121;Mataró;5;7;A;;542;249;293;0;2;247;249
8;Barcelona;21;Maresme;08121;Mataró;5;7;B;;589;271;318;1;2;268;270
8;Barcelona;21;Maresme;08121;Mataró;5;8;U;;848;429;419;0;4;425;429
8;Barcelona;21;Maresme;08121;Mataró;5;9;U;;964;498;466;2;5;491;496
8;Barcelona;21;Maresme;08121;Mataró;6;1;A;;713;404;309;1;1;402;403
8;Barcelona;21;Maresme;08121;Mataró;6;1;B;;835;483;352;0;4;479;483
8;Barcelona;21;Maresme;08121;Mataró;6;10;A;;604;334;270;2;3;329;332
8;Barcelona;21;Maresme;08121;Mataró;6;10;B;;502;285;217;3;5;277;282
8;Barcelona;21;Maresme;08121;Mataró;6;10;C;;619;342;277;0;3;339;342
8;Barcelona;21;Maresme;08121;Mataró;6;11;A;;535;332;203;1;3;328;331
8;Barcelona;21;Maresme;08121;Mataró;6;11;B;;518;305;213;0;2;303;305
8;Barcelona;21;Maresme;08121;Mataró;6;11;C;;674;402;272;2;5;395;400
8;Barcelona;21;Maresme;08121;Mataró;6;12;A;;504;280;224;0;2;278;280
8;Barcelona;21;Maresme;08121;Mataró;6;12;B;;603;325;278;0;3;322;325
8;Barcelona;21;Maresme;08121;Mataró;6;12;C;;564;276;288;0;4;272;276
8;Barcelona;21;Maresme;08121;Mataró;6;13;U;;943;560;383;0;4;556;560
8;Barcelona;21;Maresme;08121;Mataró;6;2;U;;595;388;207;1;8;379;387
8;Barcelona;21;Maresme;08121;Mataró;6;3;U;;916;655;261;0;4;651;655
8;Barcelona;21;Maresme;08121;Mataró;6;4;A;;490;321;169;0;3;318;321
8;Barcelona;21;Maresme;08121;Mataró;6;4;B;;561;377;184;0;1;376;377
8;Barcelona;21;Maresme;08121;Mataró;6;5;A;;764;433;331;1;8;424;432
8;Barcelona;21;Maresme;08121;Mataró;6;5;B;;850;461;389;4;0;457;457
8;Barcelona;21;Maresme;08121;Mataró;6;6;A;;613;423;190;1;4;418;422
8;Barcelona;21;Maresme;08121;Mataró;6;6;B;;673;427;246;1;2;424;426
8;Barcelona;21;Maresme;08121;Mataró;6;7;A;;561;314;247;0;1;313;314
8;Barcelona;21;Maresme;08121;Mataró;6;7;B;;625;387;238;0;1;386;387
8;Barcelona;21;Maresme;08121;Mataró;6;8;A;;540;335;205;0;1;334;335
8;Barcelona;21;Maresme;08121;Mataró;6;8;B;;589;358;231;0;3;355;358
8;Barcelona;21;Maresme;08121;Mataró;6;9;A;;488;202;286;1;2;199;201
8;Barcelona;21;Maresme;08121;Mataró;6;9;B;;571;260;311;2;1;257;258
8;Barcelona;3;Alt Penedès;08122;Mediona;1;1;U;;848;572;276;3;3;566;569
25;Lleida;23;Noguera;25134;Menàrguens;1;1;U;;752;481;271;0;2;479;481
17;Girona;15;Cerdanya;17099;Meranges;1;1;U;;56;28;28;0;0;28;28
17;Girona;19;Garrotxa;17105;Mieres;1;1;U;;303;179;124;0;5;174;179
43;Tarragona;1;Alt Camp;43083;Milà, el;1;1;U;;125;89;36;1;0;88;88
25;Lleida;27;Pla d'Urgell;25135;Miralcamp;1;1;U;;958;677;281;10;7;660;667
43;Tarragona;30;Ribera d'Ebre;43084;Miravet;1;1;U;;671;431;240;1;2;428;430
8;Barcelona;;;08138;Moià;1;1;U;;1094;772;322;7;7;758;765
8;Barcelona;;;08138;Moià;1;2;A;;710;483;227;0;5;478;483
8;Barcelona;;;08138;Moià;1;2;B;;852;577;275;0;7;570;577
43;Tarragona;29;Priorat;43085;Molar, el;1;1;U;;285;206;79;0;1;205;206
8;Barcelona;11;Baix Llobregat;08123;Molins de Rei;1;1;A;;532;340;192;1;3;336;339
8;Barcelona;11;Baix Llobregat;08123;Molins de Rei;1;1;B;;688;419;269;1;4;414;418
8;Barcelona;11;Baix Llobregat;08123;Molins de Rei;1;2;A;;504;295;209;1;0;294;294
8;Barcelona;11;Baix Llobregat;08123;Molins de Rei;1;2;B;;608;351;257;0;6;345;351
8;Barcelona;11;Baix Llobregat;08123;Molins de Rei;1;3;A;;770;491;279;2;2;487;489
8;Barcelona;11;Baix Llobregat;08123;Molins de Rei;1;3;B;;756;433;323;1;5;427;432
8;Barcelona;11;Baix Llobregat;08123;Molins de Rei;2;1;U;;1008;599;409;1;9;589;598
8;Barcelona;11;Baix Llobregat;08123;Molins de Rei;2;2;U;;985;600;385;1;5;594;599
8;Barcelona;11;Baix Llobregat;08123;Molins de Rei;2;3;A;;870;528;342;0;12;516;528
8;Barcelona;11;Baix Llobregat;08123;Molins de Rei;2;3;B;;1058;634;424;3;10;621;631
8;Barcelona;11;Baix Llobregat;08123;Molins de Rei;2;4;U;;939;526;413;0;5;521;526
8;Barcelona;11;Baix Llobregat;08123;Molins de Rei;3;1;A;;539;332;207;1;1;330;331
8;Barcelona;11;Baix Llobregat;08123;Molins de Rei;3;1;B;;657;401;256;0;2;399;401
8;Barcelona;11;Baix Llobregat;08123;Molins de Rei;3;2;A;;871;585;286;0;3;582;585
8;Barcelona;11;Baix Llobregat;08123;Molins de Rei;3;2;B;;971;627;344;3;8;616;624
8;Barcelona;11;Baix Llobregat;08123;Molins de Rei;3;3;A;;965;540;425;2;4;534;538
8;Barcelona;11;Baix Llobregat;08123;Molins de Rei;3;3;B;;1129;623;506;2;2;619;621
8;Barcelona;11;Baix Llobregat;08123;Molins de Rei;4;1;U;;720;401;319;1;3;397;400
25;Lleida;27;Pla d'Urgell;25137;Mollerussa;1;1;A;;747;493;254;5;10;478;488
25;Lleida;27;Pla d'Urgell;25137;Mollerussa;1;1;B;;820;504;316;1;4;499;503
25;Lleida;27;Pla d'Urgell;25137;Mollerussa;1;2;A;;734;439;295;5;6;428;434
25;Lleida;27;Pla d'Urgell;25137;Mollerussa;1;2;B;;762;458;304;1;7;450;457
25;Lleida;27;Pla d'Urgell;25137;Mollerussa;1;3;A;;821;522;299;6;5;511;516
25;Lleida;27;Pla d'Urgell;25137;Mollerussa;1;3;B;;971;580;391;7;5;568;573
25;Lleida;27;Pla d'Urgell;25137;Mollerussa;1;4;A;;851;517;334;3;11;503;514
25;Lleida;27;Pla d'Urgell;25137;Mollerussa;1;4;B;;1091;658;433;3;16;639;655
8;Barcelona;41;Vallès Oriental;08124;Mollet del Vallès;1;1;U;;662;301;361;0;1;300;301
8;Barcelona;41;Vallès Oriental;08124;Mollet del Vallès;1;2;A;;641;304;337;1;2;301;303
8;Barcelona;41;Vallès Oriental;08124;Mollet del Vallès;1;2;B;;807;374;433;0;0;374;374
8;Barcelona;41;Vallès Oriental;08124;Mollet del Vallès;1;3;A;;555;267;288;0;1;266;267
8;Barcelona;41;Vallès Oriental;08124;Mollet del Vallès;1;3;B;;547;251;296;1;2;248;250
8;Barcelona;41;Vallès Oriental;08124;Mollet del Vallès;1;3;C;;649;302;347;2;2;298;300
8;Barcelona;41;Vallès Oriental;08124;Mollet del Vallès;1;4;A;;557;318;239;0;5;313;318
8;Barcelona;41;Vallès Oriental;08124;Mollet del Vallès;1;4;B;;677;389;288;1;2;386;388
8;Barcelona;41;Vallès Oriental;08124;Mollet del Vallès;1;5;A;;648;237;411;0;2;235;237
8;Barcelona;41;Vallès Oriental;08124;Mollet del Vallès;1;5;B;;731;295;436;1;3;291;294
8;Barcelona;41;Vallès Oriental;08124;Mollet del Vallès;1;6;A;;597;313;284;0;2;311;313
8;Barcelona;41;Vallès Oriental;08124;Mollet del Vallès;1;6;B;;577;277;300;2;1;274;275
8;Barcelona;41;Vallès Oriental;08124;Mollet del Vallès;1;6;C;;669;339;330;0;2;337;339
8;Barcelona;41;Vallès Oriental;08124;Mollet del Vallès;1;7;A;;491;210;281;0;1;209;210
8;Barcelona;41;Vallès Oriental;08124;Mollet del Vallès;1;7;B;;570;219;351;2;2;215;217
8;Barcelona;41;Vallès Oriental;08124;Mollet del Vallès;2;1;A;;549;289;260;1;2;286;288
8;Barcelona;41;Vallès Oriental;08124;Mollet del Vallès;2;1;B;;548;269;279;0;4;265;269
8;Barcelona;41;Vallès Oriental;08124;Mollet del Vallès;2;1;C;;640;338;302;2;4;332;336
8;Barcelona;41;Vallès Oriental;08124;Mollet del Vallès;2;2;U;;742;367;375;1;2;364;366
8;Barcelona;41;Vallès Oriental;08124;Mollet del Vallès;2;3;A;;668;301;367;2;2;297;299
8;Barcelona;41;Vallès Oriental;08124;Mollet del Vallès;2;3;B;;857;396;461;2;6;388;394
8;Barcelona;41;Vallès Oriental;08124;Mollet del Vallès;2;4;A;;769;337;432;5;1;331;332
8;Barcelona;41;Vallès Oriental;08124;Mollet del Vallès;2;4;B;;870;368;502;1;5;362;367
8;Barcelona;41;Vallès Oriental;08124;Mollet del Vallès;2;5;A;;549;196;353;0;4;192;196
8;Barcelona;41;Vallès Oriental;08124;Mollet del Vallès;2;5;B;;710;258;452;0;2;256;258
8;Barcelona;41;Vallès Oriental;08124;Mollet del Vallès;3;1;A;;613;293;320;4;0;289;289
8;Barcelona;41;Vallès Oriental;08124;Mollet del Vallès;3;1;B;;641;275;366;0;3;272;275
8;Barcelona;41;Vallès Oriental;08124;Mollet del Vallès;3;1;C;;675;339;336;1;9;329;338
8;Barcelona;41;Vallès Oriental;08124;Mollet del Vallès;3;10;U;;625;278;347;0;1;277;278
8;Barcelona;41;Vallès Oriental;08124;Mollet del Vallès;3;2;A;;721;323;398;0;5;318;323
8;Barcelona;41;Vallès Oriental;08124;Mollet del Vallès;3;2;B;;822;364;458;0;2;362;364
8;Barcelona;41;Vallès Oriental;08124;Mollet del Vallès;3;3;A;;494;268;226;0;2;266;268
8;Barcelona;41;Vallès Oriental;08124;Mollet del Vallès;3;3;B;;508;282;226;0;2;280;282
8;Barcelona;41;Vallès Oriental;08124;Mollet del Vallès;3;4;A;;684;345;339;1;6;338;344
8;Barcelona;41;Vallès Oriental;08124;Mollet del Vallès;3;4;B;;856;426;430;0;3;423;426
8;Barcelona;41;Vallès Oriental;08124;Mollet del Vallès;3;5;A;;706;296;410;0;4;292;296
8;Barcelona;41;Vallès Oriental;08124;Mollet del Vallès;3;5;B;;805;355;450;0;3;352;355
8;Barcelona;41;Vallès Oriental;08124;Mollet del Vallès;3;6;A;;753;317;436;1;3;313;316
8;Barcelona;41;Vallès Oriental;08124;Mollet del Vallès;3;6;B;;794;335;459;1;6;328;334
8;Barcelona;41;Vallès Oriental;08124;Mollet del Vallès;3;7;A;;514;181;333;0;0;181;181
8;Barcelona;41;Vallès Oriental;08124;Mollet del Vallès;3;7;B;;602;209;393;0;0;209;209
8;Barcelona;41;Vallès Oriental;08124;Mollet del Vallès;3;7;C;;681;277;404;0;6;271;277
8;Barcelona;41;Vallès Oriental;08124;Mollet del Vallès;3;8;U;;732;350;382;3;6;341;347
8;Barcelona;41;Vallès Oriental;08124;Mollet del Vallès;3;9;A;;431;210;221;0;2;208;210
8;Barcelona;41;Vallès Oriental;08124;Mollet del Vallès;3;9;B;;574;273;301;0;0;273;273
17;Girona;2;Alt Empordà;17106;Mollet de Peralada;1;1;U;;182;129;53;0;1;128;129
17;Girona;31;Ripollès;17107;Molló;1;1;U;;309;228;81;1;0;227;227
25;Lleida;35;Solsonès;25136;Molsosa, la;1;1;U;;106;85;21;0;1;84;85
8;Barcelona;;;08128;Monistrol de Calders;1;1;U;;498;348;150;1;0;347;347
8;Barcelona;7;Bages;08127;Monistrol de Montserrat;1;1;U;;778;549;229;7;7;535;542
8;Barcelona;7;Bages;08127;Monistrol de Montserrat;1;2;A;;595;396;199;3;0;393;393
8;Barcelona;7;Bages;08127;Monistrol de Montserrat;1;2;B;;678;438;240;4;2;432;434
17;Girona;19;Garrotxa;17109;Montagut i Oix;1;1;U;;667;345;322;1;0;344;344
43;Tarragona;16;Conca de Barberà;43086;Montblanc;1;1;U;;782;480;302;6;10;464;474
43;Tarragona;16;Conca de Barberà;43086;Montblanc;1;2;U;;655;402;253;7;2;393;395
43;Tarragona;16;Conca de Barberà;43086;Montblanc;2;1;A;;806;538;268;11;4;523;527
43;Tarragona;16;Conca de Barberà;43086;Montblanc;2;1;B;;951;642;309;6;15;621;636
43;Tarragona;16;Conca de Barberà;43086;Montblanc;2;2;A;;610;406;204;4;6;396;402
43;Tarragona;16;Conca de Barberà;43086;Montblanc;2;2;B;;765;486;279;5;4;477;481
43;Tarragona;8;Baix Camp;43088;Montbrió del Camp;1;1;A;;613;460;153;9;6;445;451
43;Tarragona;8;Baix Camp;43088;Montbrió del Camp;1;1;B;;540;429;111;4;3;422;425
8;Barcelona;40;Vallès Occidental;08125;Montcada i Reixac;1;1;U;;988;549;439;2;5;542;547
8;Barcelona;40;Vallès Occidental;08125;Montcada i Reixac;1;2;U;;1227;744;483;6;4;734;738
8;Barcelona;40;Vallès Occidental;08125;Montcada i Reixac;1;4;U;;1310;626;684;1;6;619;625
8;Barcelona;40;Vallès Occidental;08125;Montcada i Reixac;1;5;U;;1187;567;620;0;10;557;567
8;Barcelona;40;Vallès Occidental;08125;Montcada i Reixac;2;1;A;;790;325;465;2;2;321;323
8;Barcelona;40;Vallès Occidental;08125;Montcada i Reixac;2;1;B;;894;366;528;7;8;351;359
8;Barcelona;40;Vallès Occidental;08125;Montcada i Reixac;2;2;A;;724;347;377;3;3;341;344
8;Barcelona;40;Vallès Occidental;08125;Montcada i Reixac;2;2;B;;837;405;432;3;5;397;402
8;Barcelona;40;Vallès Occidental;08125;Montcada i Reixac;2;3;A;;790;426;364;3;3;420;423
8;Barcelona;40;Vallès Occidental;08125;Montcada i Reixac;2;3;B;;906;454;452;10;4;440;444
8;Barcelona;40;Vallès Occidental;08125;Montcada i Reixac;3;1;A;;687;380;307;0;5;375;380
8;Barcelona;40;Vallès Occidental;08125;Montcada i Reixac;3;1;B;;835;446;389;1;3;442;445
8;Barcelona;40;Vallès Occidental;08125;Montcada i Reixac;3;2;U;;1079;527;552;1;3;523;526
8;Barcelona;40;Vallès Occidental;08125;Montcada i Reixac;3;3;A;;749;338;411;0;1;337;338
8;Barcelona;40;Vallès Occidental;08125;Montcada i Reixac;3;3;B;;970;486;484;1;5;480;485
8;Barcelona;40;Vallès Occidental;08125;Montcada i Reixac;4;1;A;;671;308;363;0;3;305;308
8;Barcelona;40;Vallès Occidental;08125;Montcada i Reixac;4;1;B;;927;425;502;1;7;417;424
8;Barcelona;40;Vallès Occidental;08125;Montcada i Reixac;5;1;A;;863;359;504;0;4;355;359
8;Barcelona;40;Vallès Occidental;08125;Montcada i Reixac;5;1;B;;959;400;559;1;1;398;399
8;Barcelona;40;Vallès Occidental;08125;Montcada i Reixac;5;2;U;;1149;486;663;1;5;480;485
8;Barcelona;40;Vallès Occidental;08125;Montcada i Reixac;5;3;U;;1254;480;774;5;2;473;475
8;Barcelona;40;Vallès Occidental;08125;Montcada i Reixac;6;1;U;;916;306;610;0;7;299;306
8;Barcelona;14;Berguedà;08130;Montclar;1;1;U;;134;94;40;0;0;94;94
25;Lleida;15;Cerdanya;25139;Montellà i Martinet;1;1;U;;464;306;158;0;8;298;306
8;Barcelona;24;Osona;08131;Montesquiu;1;1;U;;710;469;241;4;8;457;465
25;Lleida;4;Alt Urgell;25140;Montferrer i Castellbò;1;1;U;;553;332;221;3;2;327;329
43;Tarragona;1;Alt Camp;43089;Montferri;1;1;U;;143;99;44;0;0;99;99
25;Lleida;23;Noguera;25138;Montgai;1;1;A;;478;349;129;0;6;343;349
25;Lleida;23;Noguera;25138;Montgai;1;1;B;;243;170;73;0;1;169;170
8;Barcelona;21;Maresme;08126;Montgat;1;1;A;;431;252;179;0;1;251;252
8;Barcelona;21;Maresme;08126;Montgat;1;1;B;;547;317;230;2;3;312;315
8;Barcelona;21;Maresme;08126;Montgat;1;2;A;;540;244;296;0;3;241;244
8;Barcelona;21;Maresme;08126;Montgat;1;2;B;;644;287;357;0;2;285;287
8;Barcelona;21;Maresme;08126;Montgat;1;2;C;;726;329;397;2;2;325;327
8;Barcelona;21;Maresme;08126;Montgat;1;3;A;;729;426;303;1;3;422;425
8;Barcelona;21;Maresme;08126;Montgat;1;3;B;;886;476;410;0;1;475;476
8;Barcelona;21;Maresme;08126;Montgat;1;4;A;;532;266;266;3;9;254;263
8;Barcelona;21;Maresme;08126;Montgat;1;4;B;;612;305;307;1;7;297;304
8;Barcelona;14;Berguedà;08132;Montmajor;1;1;U;;436;331;105;1;2;328;330
8;Barcelona;6;Anoia;08133;Montmaneu;1;1;U;;210;118;92;1;0;117;117
43;Tarragona;12;Baix Penedès;43090;Montmell, el;1;1;U;;194;114;80;0;0;114;114
8;Barcelona;41;Vallès Oriental;08135;Montmeló;1;1;U;;923;427;496;0;6;421;427
8;Barcelona;41;Vallès Oriental;08135;Montmeló;1;2;A;;613;326;287;1;9;316;325
8;Barcelona;41;Vallès Oriental;08135;Montmeló;1;2;B;;845;433;412;3;5;425;430
8;Barcelona;41;Vallès Oriental;08135;Montmeló;1;3;A;;803;449;354;0;8;441;449
8;Barcelona;41;Vallès Oriental;08135;Montmeló;1;3;B;;944;505;439;1;4;500;504
8;Barcelona;41;Vallès Oriental;08135;Montmeló;1;4;U;;861;415;446;2;5;408;413
8;Barcelona;41;Vallès Oriental;08135;Montmeló;1;5;U;;668;383;285;4;8;371;379
25;Lleida;33;Segrià;25142;Montoliu de Lleida;1;1;U;;362;236;126;0;2;234;236
25;Lleida;32;Segarra;25141;Montoliu de Segarra;1;1;U;;177;127;50;1;2;124;126
8;Barcelona;41;Vallès Oriental;08136;Montornès del Vallès;1;1;A;;366;183;183;2;2;179;181
8;Barcelona;41;Vallès Oriental;08136;Montornès del Vallès;1;1;B;;435;203;232;0;0;203;203
8;Barcelona;41;Vallès Oriental;08136;Montornès del Vallès;1;2;A;;605;345;260;0;5;340;345
8;Barcelona;41;Vallès Oriental;08136;Montornès del Vallès;1;2;B;;683;392;291;0;4;388;392
8;Barcelona;41;Vallès Oriental;08136;Montornès del Vallès;1;3;A;;611;288;323;4;9;275;284
8;Barcelona;41;Vallès Oriental;08136;Montornès del Vallès;1;3;B;;720;338;382;2;6;330;336
8;Barcelona;41;Vallès Oriental;08136;Montornès del Vallès;1;4;A;;460;243;217;1;6;236;242
8;Barcelona;41;Vallès Oriental;08136;Montornès del Vallès;1;4;B;;471;259;212;2;3;254;257
8;Barcelona;41;Vallès Oriental;08136;Montornès del Vallès;1;5;A;;488;252;236;2;0;250;250
8;Barcelona;41;Vallès Oriental;08136;Montornès del Vallès;1;5;B;;589;293;296;1;5;287;292
8;Barcelona;41;Vallès Oriental;08136;Montornès del Vallès;2;1;A;;467;191;276;2;0;189;189
8;Barcelona;41;Vallès Oriental;08136;Montornès del Vallès;2;1;B;;516;258;258;4;3;251;254
8;Barcelona;41;Vallès Oriental;08136;Montornès del Vallès;2;2;A;;388;200;188;1;3;196;199
8;Barcelona;41;Vallès Oriental;08136;Montornès del Vallès;2;2;B;;396;202;194;2;2;198;200
8;Barcelona;41;Vallès Oriental;08136;Montornès del Vallès;2;3;A;;417;231;186;0;3;228;231
8;Barcelona;41;Vallès Oriental;08136;Montornès del Vallès;2;3;B;;498;258;240;2;3;253;256
25;Lleida;32;Segarra;25143;Montornès de Segarra;1;1;U;;109;72;37;0;0;72;72
43;Tarragona;1;Alt Camp;43091;Mont-ral;1;1;U;;120;39;81;0;2;37;39
17;Girona;10;Baix Empordà;17110;Mont-ras;1;1;U;;1030;721;309;2;7;712;719
43;Tarragona;8;Baix Camp;43092;Mont-roig del Camp;1;1;A;;941;592;349;5;6;581;587
43;Tarragona;8;Baix Camp;43092;Mont-roig del Camp;1;1;B;;988;669;319;4;8;657;665
43;Tarragona;8;Baix Camp;43092;Mont-roig del Camp;1;2;A;;676;238;438;2;2;234;236
43;Tarragona;8;Baix Camp;43092;Mont-roig del Camp;1;2;B;;711;249;462;3;3;243;246
43;Tarragona;8;Baix Camp;43092;Mont-roig del Camp;1;2;C;;261;118;143;1;0;117;117
8;Barcelona;41;Vallès Oriental;08137;Montseny;1;1;U;;219;151;68;0;1;150;151
43;Tarragona;30;Ribera d'Ebre;43093;Móra d'Ebre;1;1;A;;736;493;243;7;7;479;486
43;Tarragona;30;Ribera d'Ebre;43093;Móra d'Ebre;1;1;B;;695;446;249;1;10;435;445
43;Tarragona;30;Ribera d'Ebre;43093;Móra d'Ebre;1;2;U;;857;540;317;5;8;527;535
43;Tarragona;30;Ribera d'Ebre;43093;Móra d'Ebre;2;1;A;;492;331;161;2;4;325;329
43;Tarragona;30;Ribera d'Ebre;43093;Móra d'Ebre;2;1;B;;572;355;217;2;7;346;353
43;Tarragona;30;Ribera d'Ebre;43094;Móra la Nova;1;1;A;;566;373;193;6;6;361;367
43;Tarragona;30;Ribera d'Ebre;43094;Móra la Nova;1;1;B;;597;389;208;9;8;372;380
43;Tarragona;30;Ribera d'Ebre;43094;Móra la Nova;2;1;U;;986;659;327;0;13;646;659
43;Tarragona;36;Tarragonès;43095;Morell, el;1;1;A;;826;536;290;0;6;530;536
43;Tarragona;36;Tarragonès;43095;Morell, el;1;1;B;;896;522;374;3;4;515;519
43;Tarragona;29;Priorat;43096;Morera de Montsant, la;1;1;U;;99;90;9;0;2;88;90
8;Barcelona;24;Osona;08129;Muntanyola;1;1;U;;154;96;58;0;1;95;96
8;Barcelona;7;Bages;08139;Mura;1;1;U;;214;130;84;1;1;128;129
25;Lleida;38;Urgell;25145;Nalec;1;1;U;;89;73;16;0;0;73;73
25;Lleida;39;Consell General d'Aran;25025;Naut Aran;1;1;A;;412;272;140;1;7;264;271
25;Lleida;39;Consell General d'Aran;25025;Naut Aran;1;1;B;;596;330;266;3;6;321;327
8;Barcelona;7;Bages;08140;Navarcles;1;1;A;;960;635;325;1;5;629;634
8;Barcelona;7;Bages;08140;Navarcles;1;1;B;;1190;754;436;3;6;745;751
8;Barcelona;7;Bages;08140;Navarcles;1;2;A;;864;590;274;8;1;581;582
8;Barcelona;7;Bages;08140;Navarcles;1;2;B;;1001;668;333;1;2;665;667
8;Barcelona;7;Bages;08141;Navàs;1;1;A;;489;359;130;6;1;352;353
8;Barcelona;7;Bages;08141;Navàs;1;1;B;;550;389;161;3;4;382;386
8;Barcelona;7;Bages;08141;Navàs;1;2;U;;714;456;258;2;2;452;454
8;Barcelona;7;Bages;08141;Navàs;1;3;A;;548;299;249;1;3;295;298
8;Barcelona;7;Bages;08141;Navàs;1;3;B;;679;412;267;0;5;407;412
8;Barcelona;7;Bages;08141;Navàs;1;4;U;;970;631;339;5;3;623;626
8;Barcelona;7;Bages;08141;Navàs;2;1;U;;510;368;142;0;2;366;368
17;Girona;2;Alt Empordà;17111;Navata;1;1;U;;553;348;205;1;5;342;347
25;Lleida;35;Solsonès;25146;Navès;1;1;U;;255;167;88;1;3;163;166
8;Barcelona;14;Berguedà;08142;Nou de Berguedà, la;1;1;U;;118;86;32;0;3;83;86
43;Tarragona;36;Tarragonès;43097;Nou de Gaià, la;1;1;U;;312;226;86;4;5;217;222
43;Tarragona;1;Alt Camp;43098;Nulles;1;1;U;;293;159;134;0;3;156;159
25;Lleida;35;Solsonès;25148;Odèn;1;1;U;;263;151;112;0;0;151;151
8;Barcelona;6;Anoia;08143;Òdena;1;1;A;;606;381;225;1;0;380;380
8;Barcelona;6;Anoia;08143;Òdena;1;1;B;;758;482;276;5;3;474;477
8;Barcelona;6;Anoia;08143;Òdena;1;2;U;;640;403;237;2;4;397;401
17;Girona;31;Ripollès;17112;Ogassa;1;1;U;;238;166;72;2;0;164;164
8;Barcelona;3;Alt Penedès;08145;Olèrdola;1;1;U;;580;360;220;1;4;355;359
8;Barcelona;3;Alt Penedès;08145;Olèrdola;1;2;U;;729;551;178;6;5;540;545
8;Barcelona;3;Alt Penedès;08146;Olesa de Bonesvalls;1;1;U;;348;219;129;0;0;219;219
8;Barcelona;11;Baix Llobregat;08147;Olesa de Montserrat;1;1;A;;719;390;329;1;7;382;389
8;Barcelona;11;Baix Llobregat;08147;Olesa de Montserrat;1;1;B;;883;460;423;4;6;450;456
8;Barcelona;11;Baix Llobregat;08147;Olesa de Montserrat;1;2;A;;631;366;265;0;1;365;366
8;Barcelona;11;Baix Llobregat;08147;Olesa de Montserrat;1;2;B;;701;410;291;0;3;407;410
8;Barcelona;11;Baix Llobregat;08147;Olesa de Montserrat;1;3;A;;431;279;152;0;0;279;279
8;Barcelona;11;Baix Llobregat;08147;Olesa de Montserrat;1;3;B;;511;335;176;0;3;332;335
8;Barcelona;11;Baix Llobregat;08147;Olesa de Montserrat;1;4;A;;736;472;264;0;9;463;472
8;Barcelona;11;Baix Llobregat;08147;Olesa de Montserrat;1;4;B;;796;473;323;0;1;472;473
8;Barcelona;11;Baix Llobregat;08147;Olesa de Montserrat;1;5;A;;688;403;285;1;1;401;402
8;Barcelona;11;Baix Llobregat;08147;Olesa de Montserrat;1;5;B;;616;376;240;1;7;368;375
8;Barcelona;11;Baix Llobregat;08147;Olesa de Montserrat;1;6;A;;614;353;261;1;5;347;352
8;Barcelona;11;Baix Llobregat;08147;Olesa de Montserrat;1;6;B;;583;319;264;0;5;314;319
8;Barcelona;11;Baix Llobregat;08147;Olesa de Montserrat;1;7;A;;543;315;228;0;5;310;315
8;Barcelona;11;Baix Llobregat;08147;Olesa de Montserrat;1;7;B;;726;438;288;1;2;435;437
8;Barcelona;11;Baix Llobregat;08147;Olesa de Montserrat;1;8;A;;698;462;236;3;1;458;459
8;Barcelona;11;Baix Llobregat;08147;Olesa de Montserrat;1;8;B;;740;477;263;2;8;467;475
8;Barcelona;11;Baix Llobregat;08147;Olesa de Montserrat;1;9;A;;428;215;213;0;0;215;215
8;Barcelona;11;Baix Llobregat;08147;Olesa de Montserrat;1;9;B;;506;234;272;0;2;232;234
25;Lleida;4;Alt Urgell;25149;Oliana;1;1;A;;737;549;188;3;1;545;546
25;Lleida;4;Alt Urgell;25149;Oliana;1;1;B;;879;668;211;2;5;661;666
25;Lleida;23;Noguera;25150;Oliola;1;1;U;;186;115;71;1;1;113;114
25;Lleida;35;Solsonès;25151;Olius;1;1;U;;378;239;139;1;7;231;238
8;Barcelona;17;Garraf;08148;Olivella;1;1;U;;306;152;154;0;0;152;152
8;Barcelona;24;Osona;08149;Olost;1;1;U;;783;595;188;0;5;590;595
17;Girona;19;Garrotxa;17114;Olot;1;1;U;;801;487;314;1;7;479;486
17;Girona;19;Garrotxa;17114;Olot;1;2;A;;553;369;184;0;18;351;369
17;Girona;19;Garrotxa;17114;Olot;1;2;B;;569;358;211;0;7;351;358
17;Girona;19;Garrotxa;17114;Olot;1;3;U;;906;563;343;3;5;555;560
17;Girona;19;Garrotxa;17114;Olot;1;4;A;;602;390;212;6;9;375;384
17;Girona;19;Garrotxa;17114;Olot;1;4;B;;589;360;229;4;11;345;356
17;Girona;19;Garrotxa;17114;Olot;2;1;A;;475;307;168;3;5;299;304
17;Girona;19;Garrotxa;17114;Olot;2;1;B;;466;315;151;3;3;309;312
17;Girona;19;Garrotxa;17114;Olot;2;2;U;;803;557;246;2;17;538;555
17;Girona;19;Garrotxa;17114;Olot;2;3;A;;715;457;258;6;9;442;451
17;Girona;19;Garrotxa;17114;Olot;2;3;B;;412;267;145;2;2;263;265
17;Girona;19;Garrotxa;17114;Olot;2;3;C;;738;469;269;2;8;459;467
17;Girona;19;Garrotxa;17114;Olot;2;4;A;;572;378;194;7;9;362;371
17;Girona;19;Garrotxa;17114;Olot;2;4;B;;619;392;227;1;5;386;391
17;Girona;19;Garrotxa;17114;Olot;3;1;A;;555;368;187;5;9;354;363
17;Girona;19;Garrotxa;17114;Olot;3;1;B;;360;219;141;0;3;216;219
17;Girona;19;Garrotxa;17114;Olot;3;1;C;;608;387;221;0;8;379;387
17;Girona;19;Garrotxa;17114;Olot;3;2;A;;585;400;185;3;10;387;397
17;Girona;19;Garrotxa;17114;Olot;3;2;B;;638;418;220;2;5;411;416
17;Girona;19;Garrotxa;17114;Olot;4;1;U;;808;419;389;6;6;407;413
17;Girona;19;Garrotxa;17114;Olot;4;2;A;;775;532;243;7;13;512;525
17;Girona;19;Garrotxa;17114;Olot;4;2;B;;799;517;282;2;10;505;515
17;Girona;19;Garrotxa;17114;Olot;4;3;A;;535;344;191;5;3;336;339
17;Girona;19;Garrotxa;17114;Olot;4;3;B;;631;390;241;3;9;378;387
17;Girona;19;Garrotxa;17114;Olot;4;4;A;;476;321;155;4;5;312;317
17;Girona;19;Garrotxa;17114;Olot;4;4;B;;503;337;166;6;8;323;331
17;Girona;19;Garrotxa;17114;Olot;5;1;A;;662;426;236;1;9;416;425
17;Girona;19;Garrotxa;17114;Olot;5;1;B;;679;434;245;5;11;418;429
17;Girona;19;Garrotxa;17114;Olot;5;2;A;;656;435;221;0;9;426;435
17;Girona;19;Garrotxa;17114;Olot;5;2;B;;347;235;112;0;4;231;235
17;Girona;19;Garrotxa;17114;Olot;5;2;C;;597;388;209;0;10;378;388
17;Girona;19;Garrotxa;17114;Olot;5;3;U;;612;383;229;1;1;381;382
17;Girona;19;Garrotxa;17114;Olot;5;4;A;;665;425;240;2;8;415;423
17;Girona;19;Garrotxa;17114;Olot;5;4;B;;499;288;211;0;2;286;288
17;Girona;19;Garrotxa;17114;Olot;5;4;C;;746;473;273;3;0;470;470
25;Lleida;32;Segarra;25152;Oluges, les;1;1;U;;196;110;86;0;1;109;110
8;Barcelona;14;Berguedà;08144;Olvan;1;1;A;;395;240;155;0;0;240;240
8;Barcelona;14;Berguedà;08144;Olvan;1;1;B;;469;320;149;1;4;315;319
25;Lleida;18;Garrigues;25153;Omellons, els;1;1;U;;230;145;85;1;3;141;144
25;Lleida;38;Urgell;25154;Omells de na Gaia, els;1;1;U;;137;82;55;0;1;81;82
17;Girona;2;Alt Empordà;17115;Ordis;1;1;U;;230;151;79;1;5;145;150
25;Lleida;4;Alt Urgell;25155;Organyà;1;1;U;;869;645;224;1;1;643;644
8;Barcelona;24;Osona;08150;Orís;1;1;U;;179;103;76;0;1;102;103
8;Barcelona;24;Osona;08151;Oristà;1;1;U;;728;449;279;0;3;446;449
8;Barcelona;6;Anoia;08152;Orpí;1;1;U;;120;100;20;0;0;100;100
8;Barcelona;21;Maresme;08153;Òrrius;1;1;U;;305;238;67;0;3;235;238
25;Lleida;23;Noguera;25156;Os de Balaguer;1;1;A;;413;260;153;1;1;258;259
25;Lleida;23;Noguera;25156;Os de Balaguer;1;1;B;;249;155;94;3;0;152;152
17;Girona;34;Selva;17116;Osor;1;1;U;;410;293;117;0;2;291;293
25;Lleida;38;Urgell;25157;Ossó de Sió;1;1;U;;203;133;70;0;3;130;133
8;Barcelona;3;Alt Penedès;08154;Pacs del Penedès;1;1;U;;340;240;100;1;1;238;239
8;Barcelona;21;Maresme;08155;Palafolls;1;1;A;;643;327;316;1;0;326;326
8;Barcelona;21;Maresme;08155;Palafolls;1;1;B;;821;472;349;9;3;460;463
8;Barcelona;21;Maresme;08155;Palafolls;1;2;A;;519;301;218;3;3;295;298
8;Barcelona;21;Maresme;08155;Palafolls;1;2;B;;623;347;276;2;7;338;345
17;Girona;10;Baix Empordà;17117;Palafrugell;1;1;A;;560;372;188;7;3;362;365
17;Girona;10;Baix Empordà;17117;Palafrugell;1;1;B;;468;277;191;5;1;271;272
17;Girona;10;Baix Empordà;17117;Palafrugell;1;1;C;;591;381;210;0;6;375;381
17;Girona;10;Baix Empordà;17117;Palafrugell;1;2;A;;539;346;193;3;0;343;343
17;Girona;10;Baix Empordà;17117;Palafrugell;1;2;B;;494;298;196;1;5;292;297
17;Girona;10;Baix Empordà;17117;Palafrugell;1;2;C;;663;443;220;6;0;437;437
17;Girona;10;Baix Empordà;17117;Palafrugell;1;3;A;;398;256;142;2;2;252;254
17;Girona;10;Baix Empordà;17117;Palafrugell;1;3;B;;378;222;156;1;2;219;221
17;Girona;10;Baix Empordà;17117;Palafrugell;1;3;C;;431;280;151;3;4;273;277
17;Girona;10;Baix Empordà;17117;Palafrugell;1;4;A;;483;313;170;0;8;305;313
17;Girona;10;Baix Empordà;17117;Palafrugell;1;4;B;;479;297;182;0;3;294;297
17;Girona;10;Baix Empordà;17117;Palafrugell;2;1;A;;697;391;306;2;9;380;389
17;Girona;10;Baix Empordà;17117;Palafrugell;2;1;B;;610;350;260;3;6;341;347
17;Girona;10;Baix Empordà;17117;Palafrugell;2;1;C;;693;402;291;6;1;395;396
17;Girona;10;Baix Empordà;17117;Palafrugell;2;2;A;;507;330;177;4;5;321;326
17;Girona;10;Baix Empordà;17117;Palafrugell;2;2;B;;511;294;217;1;10;283;293
17;Girona;10;Baix Empordà;17117;Palafrugell;2;2;C;;708;433;275;1;3;429;432
17;Girona;10;Baix Empordà;17117;Palafrugell;2;3;U;;700;437;263;2;5;430;435
17;Girona;10;Baix Empordà;17117;Palafrugell;3;1;A;;807;499;308;2;5;492;497
17;Girona;10;Baix Empordà;17117;Palafrugell;3;1;B;;821;503;318;4;8;491;499
17;Girona;10;Baix Empordà;17117;Palafrugell;3;2;A;;531;376;155;5;2;369;371
17;Girona;10;Baix Empordà;17117;Palafrugell;3;2;B;;539;379;160;2;6;371;377
17;Girona;10;Baix Empordà;17117;Palafrugell;3;2;C;;269;181;88;3;2;176;178
17;Girona;10;Baix Empordà;17118;Palamós;1;1;A;;643;427;216;7;1;419;420
17;Girona;10;Baix Empordà;17118;Palamós;1;1;B;;731;466;265;3;3;460;463
17;Girona;10;Baix Empordà;17118;Palamós;1;2;A;;639;387;252;0;10;377;387
17;Girona;10;Baix Empordà;17118;Palamós;1;2;B;;721;427;294;2;1;424;425
17;Girona;10;Baix Empordà;17118;Palamós;1;3;A;;639;371;268;0;7;364;371
17;Girona;10;Baix Empordà;17118;Palamós;1;3;B;;756;444;312;1;1;442;443
17;Girona;10;Baix Empordà;17118;Palamós;1;4;U;;678;426;252;4;1;421;422
17;Girona;10;Baix Empordà;17118;Palamós;2;1;A;;791;466;325;0;14;452;466
17;Girona;10;Baix Empordà;17118;Palamós;2;1;B;;851;462;389;7;2;453;455
17;Girona;10;Baix Empordà;17118;Palamós;3;1;A;;331;195;136;2;7;186;193
17;Girona;10;Baix Empordà;17118;Palamós;3;1;B;;889;529;360;4;0;525;525
17;Girona;10;Baix Empordà;17118;Palamós;3;1;C;;758;415;343;0;2;413;415
17;Girona;10;Baix Empordà;17118;Palamós;4;1;A;;913;538;375;4;2;532;534
17;Girona;10;Baix Empordà;17118;Palamós;4;1;B;;1007;587;420;6;5;576;581
25;Lleida;27;Pla d'Urgell;25158;Palau d'Anglesola, el;1;1;U;;1292;843;449;9;13;821;834
17;Girona;2;Alt Empordà;17119;Palau de Santa Eulàlia;1;1;U;;72;46;26;0;0;46;46
17;Girona;10;Baix Empordà;17121;Palau-sator;1;1;U;;246;171;75;0;1;170;171
17;Girona;2;Alt Empordà;17120;Palau-saverdera;1;1;U;;575;462;113;2;6;454;460
8;Barcelona;40;Vallès Occidental;08156;Palau-solità i Plegamans;1;1;A;;546;291;255;0;3;288;291
8;Barcelona;40;Vallès Occidental;08156;Palau-solità i Plegamans;1;1;B;;510;262;248;1;4;257;261
8;Barcelona;40;Vallès Occidental;08156;Palau-solità i Plegamans;1;1;C;;634;360;274;0;4;356;360
8;Barcelona;40;Vallès Occidental;08156;Palau-solità i Plegamans;1;2;A;;683;355;328;2;2;351;353
8;Barcelona;40;Vallès Occidental;08156;Palau-solità i Plegamans;1;2;B;;989;454;535;2;2;450;452
8;Barcelona;40;Vallès Occidental;08156;Palau-solità i Plegamans;1;2;C;;344;191;153;1;3;187;190
8;Barcelona;40;Vallès Occidental;08156;Palau-solità i Plegamans;1;2;D;;677;374;303;1;2;371;373
8;Barcelona;40;Vallès Occidental;08156;Palau-solità i Plegamans;1;3;A;;547;279;268;0;3;276;279
8;Barcelona;40;Vallès Occidental;08156;Palau-solità i Plegamans;1;3;B;;592;314;278;0;7;307;314
43;Tarragona;36;Tarragonès;43100;Pallaresos, els;1;1;U;;472;288;184;2;12;274;286
8;Barcelona;11;Baix Llobregat;08157;Pallejà;1;1;A;;589;333;256;1;3;329;332
8;Barcelona;11;Baix Llobregat;08157;Pallejà;1;1;B;;669;371;298;1;2;368;370
8;Barcelona;11;Baix Llobregat;08157;Pallejà;1;1;C;;691;370;321;2;1;367;368
8;Barcelona;11;Baix Llobregat;08157;Pallejà;1;2;A;;661;354;307;0;4;350;354
8;Barcelona;11;Baix Llobregat;08157;Pallejà;1;2;B;;742;374;368;0;1;373;374
8;Barcelona;11;Baix Llobregat;08157;Pallejà;1;3;A;;671;356;315;1;3;352;355
8;Barcelona;11;Baix Llobregat;08157;Pallejà;1;3;B;;729;384;345;0;3;381;384
43;Tarragona;30;Ribera d'Ebre;43099;Palma d'Ebre, la;1;1;U;;401;289;112;0;1;288;289
17;Girona;28;Pla de l'Estany;17123;Palol de Revardit;1;1;U;;304;206;98;1;9;196;205
17;Girona;10;Baix Empordà;17124;Pals;1;1;A;;602;446;156;1;7;438;445
17;Girona;10;Baix Empordà;17124;Pals;1;1;B;;708;543;165;1;6;536;542
8;Barcelona;11;Baix Llobregat;08158;Papiol, el;1;1;A;;648;395;253;2;5;388;393
8;Barcelona;11;Baix Llobregat;08158;Papiol, el;1;1;B;;707;386;321;0;4;382;386
8;Barcelona;11;Baix Llobregat;08158;Papiol, el;1;2;A;;580;331;249;0;3;328;331
8;Barcelona;11;Baix Llobregat;08158;Papiol, el;1;2;B;;627;372;255;2;2;368;370
17;Girona;31;Ripollès;17125;Pardines;1;1;U;;115;71;44;0;0;71;71
8;Barcelona;41;Vallès Oriental;08159;Parets del Vallès;1;1;A;;521;305;216;1;1;303;304
8;Barcelona;41;Vallès Oriental;08159;Parets del Vallès;1;1;B;;642;339;303;0;1;338;339
8;Barcelona;41;Vallès Oriental;08159;Parets del Vallès;1;1;C;;703;429;274;0;2;427;429
8;Barcelona;41;Vallès Oriental;08159;Parets del Vallès;1;2;A;;550;344;206;1;3;340;343
8;Barcelona;41;Vallès Oriental;08159;Parets del Vallès;1;2;B;;738;465;273;1;3;461;464
8;Barcelona;41;Vallès Oriental;08159;Parets del Vallès;2;1;U;;812;323;489;0;7;316;323
8;Barcelona;41;Vallès Oriental;08159;Parets del Vallès;2;2;U;;739;369;370;0;1;368;369
8;Barcelona;41;Vallès Oriental;08159;Parets del Vallès;2;3;A;;557;254;303;0;4;250;254
8;Barcelona;41;Vallès Oriental;08159;Parets del Vallès;2;3;B;;594;308;286;1;2;305;307
8;Barcelona;41;Vallès Oriental;08159;Parets del Vallès;2;4;A;;685;523;162;0;0;523;523
8;Barcelona;41;Vallès Oriental;08159;Parets del Vallès;2;4;B;;844;401;443;3;1;397;398
8;Barcelona;41;Vallès Oriental;08159;Parets del Vallès;2;5;U;;868;408;460;1;7;400;407
17;Girona;10;Baix Empordà;17126;Parlavà;1;1;U;;275;204;71;1;4;199;203
43;Tarragona;16;Conca de Barberà;43101;Passanant i Belltall;1;1;U;;173;102;71;1;2;99;101
17;Girona;2;Alt Empordà;17128;Pau;1;1;U;;246;156;90;0;4;152;156
43;Tarragona;9;Baix Ebre;43102;Paüls;1;1;U;;585;459;126;0;2;457;459
17;Girona;2;Alt Empordà;17129;Pedret i Marzà;1;1;U;;107;63;44;0;0;63;63
25;Lleida;23;Noguera;25164;Penelles;1;1;U;;484;323;161;1;0;322;322
17;Girona;10;Baix Empordà;17130;Pera, la;1;1;U;;315;239;76;3;2;234;236
8;Barcelona;24;Osona;08160;Perafita;1;1;U;;287;206;81;0;3;203;206
43;Tarragona;36;Tarragonès;43103;Perafort;1;1;U;;393;217;176;0;1;216;217
17;Girona;2;Alt Empordà;17132;Peralada;1;1;A;;765;561;204;3;14;544;558
17;Girona;2;Alt Empordà;17132;Peralada;1;1;B;;185;112;73;2;2;108;110
25;Lleida;4;Alt Urgell;25165;Peramola;1;1;U;;332;250;82;0;1;249;250
43;Tarragona;9;Baix Ebre;43104;Perelló, el;1;1;U;;734;508;226;10;4;494;498
43;Tarragona;9;Baix Ebre;43104;Perelló, el;1;2;A;;442;319;123;0;5;314;319
43;Tarragona;9;Baix Ebre;43104;Perelló, el;1;2;B;;583;433;150;1;2;430;432
8;Barcelona;6;Anoia;08161;Piera;1;1;U;;487;309;178;3;3;303;306
8;Barcelona;6;Anoia;08161;Piera;1;2;A;;680;437;243;5;3;429;432
8;Barcelona;6;Anoia;08161;Piera;1;2;B;;644;391;253;0;1;390;391
8;Barcelona;6;Anoia;08161;Piera;1;3;A;;725;403;322;1;5;397;402
8;Barcelona;6;Anoia;08161;Piera;1;3;B;;777;448;329;5;1;442;443
8;Barcelona;6;Anoia;08161;Piera;1;4;U;;505;293;212;2;4;287;291
8;Barcelona;6;Anoia;08161;Piera;1;5;U;;883;457;426;1;0;456;456
43;Tarragona;16;Conca de Barberà;43105;Piles, les;1;1;U;;100;70;30;3;2;65;67
8;Barcelona;21;Maresme;08163;Pineda de Mar;1;1;A;;849;451;398;5;6;440;446
8;Barcelona;21;Maresme;08163;Pineda de Mar;1;1;B;;1044;598;446;1;9;588;597
8;Barcelona;21;Maresme;08163;Pineda de Mar;1;2;A;;903;534;369;3;5;526;531
8;Barcelona;21;Maresme;08163;Pineda de Mar;1;2;B;;1023;559;464;4;5;550;555
8;Barcelona;21;Maresme;08163;Pineda de Mar;1;3;A;;628;372;256;3;2;367;369
8;Barcelona;21;Maresme;08163;Pineda de Mar;1;3;B;;619;333;286;1;9;323;332
8;Barcelona;21;Maresme;08163;Pineda de Mar;1;3;C;;829;496;333;2;3;491;494
8;Barcelona;21;Maresme;08163;Pineda de Mar;1;4;A;;579;299;280;0;2;297;299
8;Barcelona;21;Maresme;08163;Pineda de Mar;1;4;B;;646;316;330;0;3;313;316
8;Barcelona;21;Maresme;08163;Pineda de Mar;1;5;A;;491;260;231;0;0;260;260
8;Barcelona;21;Maresme;08163;Pineda de Mar;1;5;B;;666;333;333;0;2;331;333
8;Barcelona;21;Maresme;08163;Pineda de Mar;1;6;U;;749;371;378;0;3;368;371
8;Barcelona;21;Maresme;08163;Pineda de Mar;1;7;A;;632;357;275;1;1;355;356
8;Barcelona;21;Maresme;08163;Pineda de Mar;1;7;B;;825;473;352;2;2;469;471
8;Barcelona;21;Maresme;08163;Pineda de Mar;1;8;A;;669;362;307;3;5;354;359
8;Barcelona;21;Maresme;08163;Pineda de Mar;1;8;B;;893;480;413;3;6;471;477
43;Tarragona;37;Terra Alta;43106;Pinell de Brai, el;1;1;U;;959;548;411;3;5;540;545
25;Lleida;35;Solsonès;25166;Pinell de Solsonès;1;1;U;;217;151;66;1;0;150;150
25;Lleida;35;Solsonès;25167;Pinós;1;1;U;;327;201;126;0;5;196;201
43;Tarragona;16;Conca de Barberà;43107;Pira;1;1;U;;271;213;58;2;3;208;211
8;Barcelona;3;Alt Penedès;08164;Pla del Penedès, el;1;1;U;;822;532;290;3;4;525;529
43;Tarragona;1;Alt Camp;43108;Pla de Santa Maria, el;1;1;A;;639;430;209;13;7;410;417
43;Tarragona;1;Alt Camp;43108;Pla de Santa Maria, el;1;1;B;;622;393;229;9;8;376;384
17;Girona;19;Garrotxa;17133;Planes d'Hostoles, les;1;1;A;;760;529;231;4;6;519;525
17;Girona;19;Garrotxa;17133;Planes d'Hostoles, les;1;1;B;;713;523;190;4;3;516;519
17;Girona;31;Ripollès;17134;Planoles;1;1;U;;258;155;103;0;0;155;155
25;Lleida;32;Segarra;25911;Plans de Sió, els;1;1;U;;579;396;183;2;5;389;394
25;Lleida;27;Pla d'Urgell;25168;Poal, el;1;1;U;;549;411;138;0;1;410;411
25;Lleida;18;Garrigues;25169;Pobla de Cérvoles, la;1;1;U;;170;126;44;2;1;123;124
8;Barcelona;6;Anoia;08165;Pobla de Claramunt, la;1;1;U;;1306;909;397;11;0;898;898
8;Barcelona;14;Berguedà;08166;Pobla de Lillet, la;1;1;U;;517;359;158;5;1;353;354
8;Barcelona;14;Berguedà;08166;Pobla de Lillet, la;1;2;A;;527;357;170;2;6;349;355
8;Barcelona;14;Berguedà;08166;Pobla de Lillet, la;1;2;B;;434;309;125;1;0;308;308
43;Tarragona;36;Tarragonès;43109;Pobla de Mafumet, la;1;1;U;;673;420;253;5;2;413;415
43;Tarragona;37;Terra Alta;43110;Pobla de Massaluca, la;1;1;U;;413;261;152;2;1;258;259
43;Tarragona;36;Tarragonès;43111;Pobla de Montornès, la;1;1;U;;668;419;249;6;4;409;413
25;Lleida;25;Pallars Jussà;25171;Pobla de Segur, la;1;1;U;;1131;737;394;2;14;721;735
25;Lleida;25;Pallars Jussà;25171;Pobla de Segur, la;1;2;A;;676;454;222;3;2;449;451
25;Lleida;25;Pallars Jussà;25171;Pobla de Segur, la;1;2;B;;759;488;271;5;8;475;483
43;Tarragona;29;Priorat;43112;Poboleda;1;1;U;;305;160;145;0;0;160;160
8;Barcelona;40;Vallès Occidental;08167;Polinyà;1;1;A;;997;479;518;1;1;477;478
8;Barcelona;40;Vallès Occidental;08167;Polinyà;1;1;B;;575;293;282;1;1;291;292
8;Barcelona;40;Vallès Occidental;08167;Polinyà;1;1;C;;806;417;389;6;0;411;411
43;Tarragona;1;Alt Camp;43113;Pont d'Armentera, el;1;1;U;;492;393;99;3;4;386;390
25;Lleida;4;Alt Urgell;25030;Pont de Bar, el;1;1;U;;158;82;76;0;0;82;82
17;Girona;2;Alt Empordà;17135;Pont de Molins;1;1;U;;271;147;124;0;1;146;147
25;Lleida;5;Alta Ribagorça;25173;Pont de Suert, el;1;1;U;;985;578;407;4;9;565;574
25;Lleida;5;Alta Ribagorça;25173;Pont de Suert, el;1;2;U;;918;558;360;6;5;547;552
8;Barcelona;7;Bages;08182;Pont de Vilomara i Rocafort, el;1;1;A;;707;442;265;0;0;442;442
8;Barcelona;7;Bages;08182;Pont de Vilomara i Rocafort, el;1;1;B;;974;616;358;1;1;614;615
43;Tarragona;16;Conca de Barberà;43141;Pontils;1;1;U;;100;70;30;0;0;70;70
8;Barcelona;3;Alt Penedès;08168;Pontons;1;1;U;;192;134;58;0;0;134;134
17;Girona;2;Alt Empordà;17136;Pontós;1;1;U;;159;103;56;2;0;101;101
25;Lleida;23;Noguera;25172;Ponts;1;1;U;;909;598;311;10;2;586;588
25;Lleida;23;Noguera;25172;Ponts;1;2;U;;880;552;328;9;5;538;543
17;Girona;28;Pla de l'Estany;17137;Porqueres;1;1;U;;726;436;290;4;7;425;432
17;Girona;28;Pla de l'Estany;17137;Porqueres;1;2;A;;757;534;223;3;3;528;531
17;Girona;28;Pla de l'Estany;17137;Porqueres;1;2;B;;870;580;290;2;6;572;578
43;Tarragona;29;Priorat;43114;Porrera;1;1;U;;379;223;156;3;1;219;220
17;Girona;2;Alt Empordà;17138;Portbou;1;1;A;;767;490;277;5;11;474;485
17;Girona;2;Alt Empordà;17138;Portbou;1;1;B;;810;509;301;1;11;497;508
17;Girona;2;Alt Empordà;17140;Port de la Selva, el;1;1;U;;652;484;168;4;5;475;480
25;Lleida;33;Segrià;25174;Portella, la;1;1;U;;491;344;147;2;3;339;342
43;Tarragona;29;Priorat;43115;Pradell de la Teixeta;1;1;U;;218;133;85;5;4;124;128
43;Tarragona;8;Baix Camp;43116;Prades;1;1;U;;447;260;187;1;5;254;259
43;Tarragona;37;Terra Alta;43117;Prat de Comte;1;1;U;;199;159;40;0;0;159;159
8;Barcelona;11;Baix Llobregat;08169;Prat de Llobregat, el;1;1;A;;668;322;346;1;1;320;321
8;Barcelona;11;Baix Llobregat;08169;Prat de Llobregat, el;1;1;B;;740;409;331;3;4;402;406
8;Barcelona;11;Baix Llobregat;08169;Prat de Llobregat, el;1;2;A;;671;365;306;0;3;362;365
8;Barcelona;11;Baix Llobregat;08169;Prat de Llobregat, el;1;2;B;;753;387;366;1;4;382;386
8;Barcelona;11;Baix Llobregat;08169;Prat de Llobregat, el;1;3;U;;992;530;462;1;3;526;529
8;Barcelona;11;Baix Llobregat;08169;Prat de Llobregat, el;1;4;A;;789;374;415;3;6;365;371
8;Barcelona;11;Baix Llobregat;08169;Prat de Llobregat, el;1;4;B;;885;444;441;2;6;436;442
8;Barcelona;11;Baix Llobregat;08169;Prat de Llobregat, el;1;5;A;;584;273;311;0;1;272;273
8;Barcelona;11;Baix Llobregat;08169;Prat de Llobregat, el;1;5;B;;653;308;345;2;2;304;306
8;Barcelona;11;Baix Llobregat;08169;Prat de Llobregat, el;2;1;A;;769;438;331;0;6;432;438
8;Barcelona;11;Baix Llobregat;08169;Prat de Llobregat, el;2;1;B;;884;442;442;4;3;435;438
8;Barcelona;11;Baix Llobregat;08169;Prat de Llobregat, el;2;2;A;;750;360;390;2;3;355;358
8;Barcelona;11;Baix Llobregat;08169;Prat de Llobregat, el;2;2;B;;823;396;427;0;4;392;396
8;Barcelona;11;Baix Llobregat;08169;Prat de Llobregat, el;2;3;A;;622;292;330;1;5;286;291
8;Barcelona;11;Baix Llobregat;08169;Prat de Llobregat, el;2;3;B;;623;276;347;0;4;272;276
8;Barcelona;11;Baix Llobregat;08169;Prat de Llobregat, el;2;4;A;;752;287;465;2;4;281;285
8;Barcelona;11;Baix Llobregat;08169;Prat de Llobregat, el;2;4;B;;895;364;531;1;5;358;363
8;Barcelona;11;Baix Llobregat;08169;Prat de Llobregat, el;2;5;A;;698;289;409;0;4;285;289
8;Barcelona;11;Baix Llobregat;08169;Prat de Llobregat, el;2;5;B;;813;353;460;1;4;348;352
8;Barcelona;11;Baix Llobregat;08169;Prat de Llobregat, el;2;6;A;;628;279;349;2;5;272;277
8;Barcelona;11;Baix Llobregat;08169;Prat de Llobregat, el;2;6;B;;648;276;372;5;3;268;271
8;Barcelona;11;Baix Llobregat;08169;Prat de Llobregat, el;2;7;A;;507;243;264;2;1;240;241
8;Barcelona;11;Baix Llobregat;08169;Prat de Llobregat, el;2;7;B;;546;252;294;1;1;250;251
8;Barcelona;11;Baix Llobregat;08169;Prat de Llobregat, el;3;1;A;;607;304;303;0;6;298;304
8;Barcelona;11;Baix Llobregat;08169;Prat de Llobregat, el;3;1;B;;652;332;320;0;4;328;332
8;Barcelona;11;Baix Llobregat;08169;Prat de Llobregat, el;3;10;A;;661;212;449;1;2;209;211
8;Barcelona;11;Baix Llobregat;08169;Prat de Llobregat, el;3;10;B;;689;235;454;0;2;233;235
8;Barcelona;11;Baix Llobregat;08169;Prat de Llobregat, el;3;2;U;;1003;348;655;0;6;342;348
8;Barcelona;11;Baix Llobregat;08169;Prat de Llobregat, el;3;3;A;;671;267;404;0;8;259;267
8;Barcelona;11;Baix Llobregat;08169;Prat de Llobregat, el;3;3;B;;717;308;409;0;7;301;308
8;Barcelona;11;Baix Llobregat;08169;Prat de Llobregat, el;3;4;A;;649;289;360;3;2;284;286
8;Barcelona;11;Baix Llobregat;08169;Prat de Llobregat, el;3;4;B;;812;380;432;0;7;373;380
8;Barcelona;11;Baix Llobregat;08169;Prat de Llobregat, el;3;5;A;;903;397;506;2;5;390;395
8;Barcelona;11;Baix Llobregat;08169;Prat de Llobregat, el;3;5;B;;943;439;504;1;4;434;438
8;Barcelona;11;Baix Llobregat;08169;Prat de Llobregat, el;3;6;A;;436;163;273;0;3;160;163
8;Barcelona;11;Baix Llobregat;08169;Prat de Llobregat, el;3;6;B;;607;225;382;1;1;223;224
8;Barcelona;11;Baix Llobregat;08169;Prat de Llobregat, el;3;7;A;;730;286;444;1;2;283;285
8;Barcelona;11;Baix Llobregat;08169;Prat de Llobregat, el;3;7;B;;825;311;514;2;3;306;309
8;Barcelona;11;Baix Llobregat;08169;Prat de Llobregat, el;3;8;A;;693;236;457;3;4;229;233
8;Barcelona;11;Baix Llobregat;08169;Prat de Llobregat, el;3;8;B;;839;248;591;1;2;245;247
8;Barcelona;11;Baix Llobregat;08169;Prat de Llobregat, el;3;9;A;;790;295;495;1;3;291;294
8;Barcelona;11;Baix Llobregat;08169;Prat de Llobregat, el;3;9;B;;861;272;589;1;6;265;271
8;Barcelona;11;Baix Llobregat;08169;Prat de Llobregat, el;4;1;U;;917;424;493;1;8;415;423
8;Barcelona;11;Baix Llobregat;08169;Prat de Llobregat, el;4;2;U;;825;208;617;0;2;206;208
8;Barcelona;11;Baix Llobregat;08169;Prat de Llobregat, el;4;3;A;;778;280;498;1;0;279;279
8;Barcelona;11;Baix Llobregat;08169;Prat de Llobregat, el;4;3;B;;916;342;574;3;2;337;339
8;Barcelona;11;Baix Llobregat;08169;Prat de Llobregat, el;4;4;U;;319;129;190;1;1;127;128
8;Barcelona;11;Baix Llobregat;08169;Prat de Llobregat, el;4;5;A;;798;274;524;0;2;272;274
8;Barcelona;11;Baix Llobregat;08169;Prat de Llobregat, el;4;5;B;;966;353;613;3;2;348;350
8;Barcelona;11;Baix Llobregat;08169;Prat de Llobregat, el;4;6;U;;878;170;708;1;1;168;169
8;Barcelona;11;Baix Llobregat;08169;Prat de Llobregat, el;4;7;U;;853;106;747;1;2;103;105
8;Barcelona;11;Baix Llobregat;08169;Prat de Llobregat, el;5;1;A;;607;283;324;2;3;278;281
8;Barcelona;11;Baix Llobregat;08169;Prat de Llobregat, el;5;1;B;;599;310;289;1;3;306;309
8;Barcelona;11;Baix Llobregat;08169;Prat de Llobregat, el;5;2;A;;586;267;319;1;2;264;266
8;Barcelona;11;Baix Llobregat;08169;Prat de Llobregat, el;5;2;B;;617;283;334;0;3;280;283
8;Barcelona;11;Baix Llobregat;08169;Prat de Llobregat, el;5;3;A;;543;208;335;1;0;207;207
8;Barcelona;11;Baix Llobregat;08169;Prat de Llobregat, el;5;3;B;;604;213;391;2;0;211;211
8;Barcelona;11;Baix Llobregat;08169;Prat de Llobregat, el;5;4;U;;854;360;494;3;4;353;357
8;Barcelona;11;Baix Llobregat;08169;Prat de Llobregat, el;5;5;A;;695;302;393;1;3;298;301
8;Barcelona;11;Baix Llobregat;08169;Prat de Llobregat, el;5;5;B;;795;351;444;5;1;345;346
8;Barcelona;11;Baix Llobregat;08169;Prat de Llobregat, el;5;6;A;;661;277;384;2;0;275;275
8;Barcelona;11;Baix Llobregat;08169;Prat de Llobregat, el;5;6;B;;739;305;434;0;0;305;305
8;Barcelona;11;Baix Llobregat;08169;Prat de Llobregat, el;5;7;A;;734;329;405;3;2;324;326
8;Barcelona;11;Baix Llobregat;08169;Prat de Llobregat, el;5;7;B;;926;371;555;5;0;366;366
8;Barcelona;11;Baix Llobregat;08169;Prat de Llobregat, el;5;8;A;;505;223;282;0;0;223;223
8;Barcelona;11;Baix Llobregat;08169;Prat de Llobregat, el;5;8;B;;708;294;414;0;4;290;294
43;Tarragona;8;Baix Camp;43118;Pratdip;1;1;U;;367;281;86;2;1;278;279
8;Barcelona;24;Osona;08171;Prats de Lluçanès;1;1;A;;1024;646;378;3;5;638;643
8;Barcelona;24;Osona;08171;Prats de Lluçanès;1;1;B;;1008;585;423;0;8;577;585
8;Barcelona;6;Anoia;08170;Prats de Rei, els;1;1;U;;470;341;129;2;2;337;339
25;Lleida;15;Cerdanya;25175;Prats i Sansor;1;1;U;;106;71;35;0;1;70;71
25;Lleida;38;Urgell;25176;Preixana;1;1;U;;404;272;132;1;3;268;271
25;Lleida;23;Noguera;25177;Preixens;1;1;U;;480;320;160;1;5;314;319
8;Barcelona;21;Maresme;08230;Premià de Dalt;1;1;A;;775;528;247;1;4;523;527
8;Barcelona;21;Maresme;08230;Premià de Dalt;1;1;B;;866;613;253;2;7;604;611
8;Barcelona;21;Maresme;08230;Premià de Dalt;1;2;A;;711;380;331;2;7;371;378
8;Barcelona;21;Maresme;08230;Premià de Dalt;1;2;B;;929;485;444;1;6;478;484
8;Barcelona;21;Maresme;08230;Premià de Dalt;1;3;A;;559;285;274;0;2;283;285
8;Barcelona;21;Maresme;08230;Premià de Dalt;1;3;B;;633;312;321;3;2;307;309
8;Barcelona;21;Maresme;08230;Premià de Dalt;1;4;U;;537;350;187;0;0;350;350
8;Barcelona;21;Maresme;08172;Premià de Mar;1;1;U;;1176;656;520;2;8;646;654
8;Barcelona;21;Maresme;08172;Premià de Mar;1;2;A;;753;457;296;2;9;446;455
8;Barcelona;21;Maresme;08172;Premià de Mar;1;2;B;;828;493;335;0;7;486;493
8;Barcelona;21;Maresme;08172;Premià de Mar;1;3;A;;810;430;380;1;4;425;429
8;Barcelona;21;Maresme;08172;Premià de Mar;1;3;B;;875;449;426;0;6;443;449
8;Barcelona;21;Maresme;08172;Premià de Mar;2;1;A;;644;395;249;0;4;391;395
8;Barcelona;21;Maresme;08172;Premià de Mar;2;1;B;;829;491;338;2;6;483;489
8;Barcelona;21;Maresme;08172;Premià de Mar;2;2;A;;747;383;364;1;4;378;382
8;Barcelona;21;Maresme;08172;Premià de Mar;2;2;B;;1011;501;510;0;2;499;501
8;Barcelona;21;Maresme;08172;Premià de Mar;2;3;A;;582;281;301;0;2;279;281
8;Barcelona;21;Maresme;08172;Premià de Mar;2;3;B;;722;340;382;1;8;331;339
8;Barcelona;21;Maresme;08172;Premià de Mar;2;4;A;;564;275;289;0;2;273;275
8;Barcelona;21;Maresme;08172;Premià de Mar;2;4;B;;692;340;352;1;5;334;339
8;Barcelona;21;Maresme;08172;Premià de Mar;3;1;A;;874;506;368;1;6;499;505
8;Barcelona;21;Maresme;08172;Premià de Mar;3;1;B;;1215;661;554;0;11;650;661
8;Barcelona;21;Maresme;08172;Premià de Mar;3;2;A;;791;401;390;0;4;397;401
8;Barcelona;21;Maresme;08172;Premià de Mar;3;2;B;;822;389;433;0;5;384;389
8;Barcelona;21;Maresme;08172;Premià de Mar;3;3;A;;745;385;360;1;5;379;384
8;Barcelona;21;Maresme;08172;Premià de Mar;3;3;B;;906;457;449;3;7;447;454
8;Barcelona;21;Maresme;08172;Premià de Mar;3;4;U;;846;479;367;4;3;472;475
8;Barcelona;21;Maresme;08172;Premià de Mar;3;5;A;;537;262;275;0;2;260;262
8;Barcelona;21;Maresme;08172;Premià de Mar;3;5;B;;686;347;339;1;3;343;346
17;Girona;19;Garrotxa;17139;Preses, les;1;1;A;;603;462;141;6;9;447;456
17;Girona;19;Garrotxa;17139;Preses, les;1;1;B;;436;311;125;0;6;305;311
25;Lleida;15;Cerdanya;25179;Prullans;1;1;U;;164;119;45;1;0;118;118
17;Girona;15;Cerdanya;17141;Puigcerdà;1;1;A;;545;306;239;0;4;302;306
17;Girona;15;Cerdanya;17141;Puigcerdà;1;1;B;;545;319;226;2;3;314;317
17;Girona;15;Cerdanya;17141;Puigcerdà;1;2;A;;610;403;207;2;5;396;401
17;Girona;15;Cerdanya;17141;Puigcerdà;1;2;B;;688;443;245;3;4;436;440
17;Girona;15;Cerdanya;17141;Puigcerdà;1;3;A;;626;322;304;3;6;313;319
17;Girona;15;Cerdanya;17141;Puigcerdà;1;3;B;;725;377;348;6;11;360;371
17;Girona;15;Cerdanya;17141;Puigcerdà;1;4;A;;661;380;281;7;14;359;373
17;Girona;15;Cerdanya;17141;Puigcerdà;1;4;B;;674;387;287;4;4;379;383
8;Barcelona;3;Alt Penedès;08174;Puigdàlber;1;1;U;;237;189;48;0;2;187;189
25;Lleida;18;Garrigues;25180;Puiggròs;1;1;U;;227;168;59;2;5;161;166
43;Tarragona;1;Alt Camp;43119;Puigpelat;1;1;U;;362;202;160;0;5;197;202
8;Barcelona;14;Berguedà;08175;Puig-reig;1;1;A;;900;628;272;2;6;620;626
8;Barcelona;14;Berguedà;08175;Puig-reig;1;1;B;;945;654;291;1;8;645;653
8;Barcelona;14;Berguedà;08175;Puig-reig;1;2;A;;567;392;175;0;3;389;392
8;Barcelona;14;Berguedà;08175;Puig-reig;1;2;B;;693;456;237;4;3;449;452
8;Barcelona;14;Berguedà;08175;Puig-reig;2;1;A;;289;222;67;2;3;217;220
8;Barcelona;14;Berguedà;08175;Puig-reig;2;1;B;;303;152;151;0;0;152;152
8;Barcelona;14;Berguedà;08175;Puig-reig;2;1;C;;367;289;78;1;2;286;288
25;Lleida;38;Urgell;25181;Puigverd d'Agramunt;1;1;U;;201;124;77;1;0;123;123
25;Lleida;33;Segrià;25182;Puigverd de Lleida;1;1;U;;797;499;298;2;6;491;497
8;Barcelona;6;Anoia;08176;Pujalt;1;1;U;;147;107;40;1;2;104;106
8;Barcelona;14;Berguedà;08177;Quar, la;1;1;U;;31;20;11;0;0;20;20
17;Girona;20;Gironès;17142;Quart;1;1;A;;471;302;169;0;0;302;302
17;Girona;20;Gironès;17142;Quart;1;1;B;;540;366;174;0;5;361;366
17;Girona;20;Gironès;17142;Quart;1;1;C;;464;281;183;0;0;281;281
17;Girona;31;Ripollès;17043;Queralbs;1;1;U;;191;156;35;1;0;155;155
43;Tarragona;1;Alt Camp;43120;Querol;1;1;U;;144;60;84;0;0;60;60
17;Girona;2;Alt Empordà;17143;Rabós;1;1;U;;124;81;43;2;2;77;79
8;Barcelona;7;Bages;08178;Rajadell;1;1;U;;265;189;76;2;1;186;187
43;Tarragona;30;Ribera d'Ebre;43121;Rasquera;1;1;U;;734;344;390;15;1;328;329
17;Girona;10;Baix Empordà;17144;Regencós;1;1;U;;217;170;47;0;0;170;170
8;Barcelona;40;Vallès Occidental;08179;Rellinars;1;1;U;;190;133;57;0;0;133;133
43;Tarragona;36;Tarragonès;43122;Renau;1;1;U;;53;37;16;0;0;37;37
43;Tarragona;8;Baix Camp;43123;Reus;1;1;U;;644;372;272;1;6;365;371
43;Tarragona;8;Baix Camp;43123;Reus;1;2;U;;502;286;216;4;3;279;282
43;Tarragona;8;Baix Camp;43123;Reus;1;3;A;;490;292;198;1;4;287;291
43;Tarragona;8;Baix Camp;43123;Reus;1;3;B;;385;221;164;0;2;219;221
43;Tarragona;8;Baix Camp;43123;Reus;1;3;C;;463;276;187;0;0;276;276
43;Tarragona;8;Baix Camp;43123;Reus;1;4;A;;549;359;190;0;3;356;359
43;Tarragona;8;Baix Camp;43123;Reus;1;4;B;;450;286;164;1;5;280;285
43;Tarragona;8;Baix Camp;43123;Reus;1;4;C;;552;354;198;1;7;346;353
43;Tarragona;8;Baix Camp;43123;Reus;10;1;U;;534;275;259;2;1;272;273
43;Tarragona;8;Baix Camp;43123;Reus;2;1;U;;725;388;337;0;3;385;388
43;Tarragona;8;Baix Camp;43123;Reus;2;10;A;;486;294;192;2;4;288;292
43;Tarragona;8;Baix Camp;43123;Reus;2;10;B;;478;246;232;4;5;237;242
43;Tarragona;8;Baix Camp;43123;Reus;2;10;C;;530;291;239;0;4;287;291
43;Tarragona;8;Baix Camp;43123;Reus;2;11;A;;514;308;206;0;3;305;308
43;Tarragona;8;Baix Camp;43123;Reus;2;11;B;;641;333;308;2;7;324;331
43;Tarragona;8;Baix Camp;43123;Reus;2;2;A;;586;359;227;1;10;348;358
43;Tarragona;8;Baix Camp;43123;Reus;2;2;B;;512;292;220;1;4;287;291
43;Tarragona;8;Baix Camp;43123;Reus;2;2;C;;573;317;256;2;5;310;315
43;Tarragona;8;Baix Camp;43123;Reus;2;3;A;;552;311;241;3;7;301;308
43;Tarragona;8;Baix Camp;43123;Reus;2;3;B;;592;337;255;1;9;327;336
43;Tarragona;8;Baix Camp;43123;Reus;2;3;C;;591;308;283;2;9;297;306
43;Tarragona;8;Baix Camp;43123;Reus;2;4;U;;715;366;349;2;4;360;364
43;Tarragona;8;Baix Camp;43123;Reus;2;5;A;;386;221;165;0;4;217;221
43;Tarragona;8;Baix Camp;43123;Reus;2;5;B;;443;253;190;5;2;246;248
43;Tarragona;8;Baix Camp;43123;Reus;2;6;A;;500;238;262;0;2;236;238
43;Tarragona;8;Baix Camp;43123;Reus;2;6;B;;580;308;272;1;3;304;307
43;Tarragona;8;Baix Camp;43123;Reus;2;7;A;;521;298;223;0;3;295;298
43;Tarragona;8;Baix Camp;43123;Reus;2;7;B;;567;316;251;1;1;314;315
43;Tarragona;8;Baix Camp;43123;Reus;2;8;A;;623;336;287;1;2;333;335
43;Tarragona;8;Baix Camp;43123;Reus;2;8;B;;578;254;324;2;6;246;252
43;Tarragona;8;Baix Camp;43123;Reus;2;8;C;;645;332;313;2;6;324;330
43;Tarragona;8;Baix Camp;43123;Reus;2;9;A;;587;368;219;3;9;356;365
43;Tarragona;8;Baix Camp;43123;Reus;2;9;B;;486;315;171;2;6;307;313
43;Tarragona;8;Baix Camp;43123;Reus;2;9;C;;639;403;236;0;12;391;403
43;Tarragona;8;Baix Camp;43123;Reus;3;1;A;;496;252;244;0;4;248;252
43;Tarragona;8;Baix Camp;43123;Reus;3;1;B;;489;271;218;1;4;266;270
43;Tarragona;8;Baix Camp;43123;Reus;3;10;A;;402;169;233;0;1;168;169
43;Tarragona;8;Baix Camp;43123;Reus;3;10;B;;498;197;301;2;0;195;195
43;Tarragona;8;Baix Camp;43123;Reus;3;10;C;;471;227;244;4;0;223;223
43;Tarragona;8;Baix Camp;43123;Reus;3;11;A;;606;277;329;6;6;265;271
43;Tarragona;8;Baix Camp;43123;Reus;3;11;B;;645;275;370;1;7;267;274
43;Tarragona;8;Baix Camp;43123;Reus;3;12;A;;542;283;259;0;2;281;283
43;Tarragona;8;Baix Camp;43123;Reus;3;12;B;;645;340;305;0;4;336;340
43;Tarragona;8;Baix Camp;43123;Reus;3;13;U;;537;231;306;0;3;228;231
43;Tarragona;8;Baix Camp;43123;Reus;3;2;U;;525;268;257;1;10;257;267
43;Tarragona;8;Baix Camp;43123;Reus;3;3;A;;457;245;212;3;2;240;242
43;Tarragona;8;Baix Camp;43123;Reus;3;3;B;;546;286;260;0;4;282;286
43;Tarragona;8;Baix Camp;43123;Reus;3;4;A;;420;197;223;7;1;189;190
43;Tarragona;8;Baix Camp;43123;Reus;3;4;B;;474;246;228;2;9;235;244
43;Tarragona;8;Baix Camp;43123;Reus;3;5;A;;459;259;200;0;0;259;259
43;Tarragona;8;Baix Camp;43123;Reus;3;5;B;;523;312;211;1;8;303;311
43;Tarragona;8;Baix Camp;43123;Reus;3;6;U;;501;318;183;2;3;313;316
43;Tarragona;8;Baix Camp;43123;Reus;3;7;U;;537;251;286;4;0;247;247
43;Tarragona;8;Baix Camp;43123;Reus;3;8;A;;596;338;258;1;4;333;337
43;Tarragona;8;Baix Camp;43123;Reus;3;8;B;;679;372;307;3;4;365;369
43;Tarragona;8;Baix Camp;43123;Reus;3;9;A;;595;318;277;2;3;313;316
43;Tarragona;8;Baix Camp;43123;Reus;3;9;B;;629;313;316;3;4;306;310
43;Tarragona;8;Baix Camp;43123;Reus;4;1;A;;369;187;182;2;3;182;185
43;Tarragona;8;Baix Camp;43123;Reus;4;1;B;;406;205;201;1;2;202;204
43;Tarragona;8;Baix Camp;43123;Reus;4;2;A;;455;261;194;2;3;256;259
43;Tarragona;8;Baix Camp;43123;Reus;4;2;B;;405;216;189;5;5;206;211
43;Tarragona;8;Baix Camp;43123;Reus;4;2;C;;447;231;216;2;6;223;229
43;Tarragona;8;Baix Camp;43123;Reus;4;3;U;;672;337;335;9;5;323;328
43;Tarragona;8;Baix Camp;43123;Reus;4;4;A;;465;258;207;0;2;256;258
43;Tarragona;8;Baix Camp;43123;Reus;4;4;B;;541;267;274;3;1;263;264
43;Tarragona;8;Baix Camp;43123;Reus;4;5;A;;607;278;329;3;0;275;275
43;Tarragona;8;Baix Camp;43123;Reus;4;5;B;;663;302;361;1;2;299;301
43;Tarragona;8;Baix Camp;43123;Reus;4;6;A;;477;255;222;6;2;247;249
43;Tarragona;8;Baix Camp;43123;Reus;4;6;B;;465;234;231;1;1;232;233
43;Tarragona;8;Baix Camp;43123;Reus;4;6;C;;511;258;253;2;1;255;256
43;Tarragona;8;Baix Camp;43123;Reus;5;1;A;;631;331;300;3;0;328;328
43;Tarragona;8;Baix Camp;43123;Reus;5;1;B;;654;344;310;1;5;338;343
43;Tarragona;8;Baix Camp;43123;Reus;5;2;A;;429;214;215;0;0;214;214
43;Tarragona;8;Baix Camp;43123;Reus;5;2;B;;513;239;274;0;3;236;239
43;Tarragona;8;Baix Camp;43123;Reus;5;2;C;;516;234;282;0;5;229;234
43;Tarragona;8;Baix Camp;43123;Reus;5;3;A;;534;298;236;6;3;289;292
43;Tarragona;8;Baix Camp;43123;Reus;5;3;B;;591;299;292;1;1;297;298
43;Tarragona;8;Baix Camp;43123;Reus;5;4;A;;498;270;228;1;4;265;269
43;Tarragona;8;Baix Camp;43123;Reus;5;4;B;;597;310;287;0;3;307;310
43;Tarragona;8;Baix Camp;43123;Reus;5;5;A;;480;279;201;5;3;271;274
43;Tarragona;8;Baix Camp;43123;Reus;5;5;B;;555;315;240;5;8;302;310
43;Tarragona;8;Baix Camp;43123;Reus;5;5;C;;627;341;286;1;5;335;340
43;Tarragona;8;Baix Camp;43123;Reus;5;6;U;;506;262;244;1;2;259;261
43;Tarragona;8;Baix Camp;43123;Reus;6;1;A;;363;216;147;1;1;214;215
43;Tarragona;8;Baix Camp;43123;Reus;6;1;B;;380;204;176;2;3;199;202
43;Tarragona;8;Baix Camp;43123;Reus;6;10;U;;635;361;274;5;4;352;356
43;Tarragona;8;Baix Camp;43123;Reus;6;11;A;;526;332;194;0;6;326;332
43;Tarragona;8;Baix Camp;43123;Reus;6;11;B;;550;344;206;2;5;337;342
43;Tarragona;8;Baix Camp;43123;Reus;6;2;A;;570;342;228;0;3;339;342
43;Tarragona;8;Baix Camp;43123;Reus;6;2;B;;459;282;177;0;5;277;282
43;Tarragona;8;Baix Camp;43123;Reus;6;2;C;;575;352;223;1;8;343;351
43;Tarragona;8;Baix Camp;43123;Reus;6;3;A;;471;292;179;2;6;284;290
43;Tarragona;8;Baix Camp;43123;Reus;6;3;B;;376;222;154;2;4;216;220
43;Tarragona;8;Baix Camp;43123;Reus;6;3;C;;450;273;177;3;6;264;270
43;Tarragona;8;Baix Camp;43123;Reus;6;4;A;;548;346;202;2;3;341;344
43;Tarragona;8;Baix Camp;43123;Reus;6;4;B;;531;323;208;1;4;318;322
43;Tarragona;8;Baix Camp;43123;Reus;6;4;C;;559;346;213;2;8;336;344
43;Tarragona;8;Baix Camp;43123;Reus;6;5;U;;685;295;390;5;3;287;290
43;Tarragona;8;Baix Camp;43123;Reus;6;6;A;;614;391;223;2;3;386;389
43;Tarragona;8;Baix Camp;43123;Reus;6;6;B;;662;395;267;3;4;388;392
43;Tarragona;8;Baix Camp;43123;Reus;6;7;A;;512;326;186;1;8;317;325
43;Tarragona;8;Baix Camp;43123;Reus;6;7;B;;661;406;255;3;1;402;403
43;Tarragona;8;Baix Camp;43123;Reus;6;8;A;;381;197;184;1;3;193;196
43;Tarragona;8;Baix Camp;43123;Reus;6;8;B;;448;224;224;0;7;217;224
43;Tarragona;8;Baix Camp;43123;Reus;6;9;U;;647;321;326;0;5;316;321
43;Tarragona;8;Baix Camp;43123;Reus;7;1;A;;423;163;260;1;0;162;162
43;Tarragona;8;Baix Camp;43123;Reus;7;1;B;;504;186;318;2;2;182;184
43;Tarragona;8;Baix Camp;43123;Reus;7;1;C;;461;184;277;2;0;182;182
43;Tarragona;8;Baix Camp;43123;Reus;7;2;A;;337;157;180;0;0;157;157
43;Tarragona;8;Baix Camp;43123;Reus;7;2;B;;375;172;203;1;1;170;171
43;Tarragona;8;Baix Camp;43123;Reus;7;3;A;;396;201;195;2;4;195;199
43;Tarragona;8;Baix Camp;43123;Reus;7;3;B;;440;237;203;3;2;232;234
43;Tarragona;8;Baix Camp;43123;Reus;8;1;A;;436;213;223;0;0;213;213
43;Tarragona;8;Baix Camp;43123;Reus;8;1;B;;550;274;276;0;2;272;274
43;Tarragona;8;Baix Camp;43123;Reus;8;1;C;;514;262;252;0;3;259;262
43;Tarragona;8;Baix Camp;43123;Reus;8;2;A;;444;221;223;0;3;218;221
43;Tarragona;8;Baix Camp;43123;Reus;8;2;B;;386;193;193;0;2;191;193
43;Tarragona;8;Baix Camp;43123;Reus;8;3;U;;570;234;336;4;1;229;230
43;Tarragona;8;Baix Camp;43123;Reus;8;4;A;;385;170;215;0;2;168;170
43;Tarragona;8;Baix Camp;43123;Reus;8;4;B;;483;213;270;9;3;201;204
43;Tarragona;8;Baix Camp;43123;Reus;8;5;U;;672;333;339;9;4;320;324
43;Tarragona;8;Baix Camp;43123;Reus;8;6;A;;392;207;185;1;1;205;206
43;Tarragona;8;Baix Camp;43123;Reus;8;6;B;;445;202;243;3;2;197;199
43;Tarragona;8;Baix Camp;43123;Reus;9;1;A;;537;291;246;0;3;288;291
43;Tarragona;8;Baix Camp;43123;Reus;9;1;B;;591;345;246;1;4;340;344
25;Lleida;26;Pallars Sobirà;25183;Rialp;1;1;U;;386;245;141;1;0;244;244
43;Tarragona;1;Alt Camp;43124;Riba, la;1;1;U;;728;519;209;4;2;513;515
43;Tarragona;30;Ribera d'Ebre;43125;Riba-roja d'Ebre;1;1;A;;796;466;330;0;3;463;466
43;Tarragona;30;Ribera d'Ebre;43125;Riba-roja d'Ebre;1;1;B;;561;295;266;0;0;295;295
25;Lleida;32;Segarra;25905;Ribera d'Ondara;1;1;U;;408;300;108;1;2;297;299
25;Lleida;4;Alt Urgell;25185;Ribera d'Urgellet;1;1;U;;725;387;338;1;1;385;386
17;Girona;31;Ripollès;17145;Ribes de Freser;1;1;A;;410;289;121;0;1;288;289
17;Girona;31;Ripollès;17145;Ribes de Freser;1;1;B;;610;435;175;2;4;429;433
17;Girona;31;Ripollès;17145;Ribes de Freser;1;2;A;;402;296;106;1;5;290;295
17;Girona;31;Ripollès;17145;Ribes de Freser;1;2;B;;594;412;182;6;7;399;406
17;Girona;34;Selva;17146;Riells i Viabrea;1;1;U;;761;484;277;16;1;467;468
43;Tarragona;36;Tarragonès;43126;Riera de Gaià, la;1;1;U;;743;520;223;5;3;512;515
25;Lleida;35;Solsonès;25186;Riner;1;1;U;;220;157;63;0;3;154;157
17;Girona;31;Ripollès;17147;Ripoll;1;1;U;;608;393;215;1;2;390;392
17;Girona;31;Ripollès;17147;Ripoll;1;2;U;;915;546;369;2;10;534;544
17;Girona;31;Ripollès;17147;Ripoll;2;1;U;;950;679;271;0;11;668;679
17;Girona;31;Ripollès;17147;Ripoll;2;2;A;;605;372;233;2;0;370;370
17;Girona;31;Ripollès;17147;Ripoll;2;2;B;;712;475;237;4;1;470;471
17;Girona;31;Ripollès;17147;Ripoll;3;1;U;;891;586;305;2;5;579;584
17;Girona;31;Ripollès;17147;Ripoll;3;2;U;;781;521;260;5;5;511;516
17;Girona;31;Ripollès;17147;Ripoll;3;3;A;;644;427;217;3;4;420;424
17;Girona;31;Ripollès;17147;Ripoll;3;3;B;;774;545;229;0;5;540;545
17;Girona;31;Ripollès;17147;Ripoll;3;4;A;;649;403;246;1;5;397;402
17;Girona;31;Ripollès;17147;Ripoll;3;4;B;;766;468;298;5;4;459;463
17;Girona;31;Ripollès;17147;Ripoll;4;1;U;;975;603;372;0;4;599;603
8;Barcelona;40;Vallès Occidental;08180;Ripollet;1;1;A;;589;234;355;1;1;232;233
8;Barcelona;40;Vallès Occidental;08180;Ripollet;1;1;B;;670;309;361;0;3;306;309
8;Barcelona;40;Vallès Occidental;08180;Ripollet;1;2;A;;759;399;360;0;9;390;399
8;Barcelona;40;Vallès Occidental;08180;Ripollet;1;2;B;;1043;565;478;2;10;553;563
8;Barcelona;40;Vallès Occidental;08180;Ripollet;1;3;A;;606;296;310;5;4;287;291
8;Barcelona;40;Vallès Occidental;08180;Ripollet;1;3;B;;793;368;425;1;7;360;367
8;Barcelona;40;Vallès Occidental;08180;Ripollet;1;4;A;;511;301;210;1;2;298;300
8;Barcelona;40;Vallès Occidental;08180;Ripollet;1;4;B;;585;342;243;0;4;338;342
8;Barcelona;40;Vallès Occidental;08180;Ripollet;1;5;A;;564;217;347;1;4;212;216
8;Barcelona;40;Vallès Occidental;08180;Ripollet;1;5;B;;695;290;405;4;0;286;286
8;Barcelona;40;Vallès Occidental;08180;Ripollet;1;6;A;;665;277;388;1;2;274;276
8;Barcelona;40;Vallès Occidental;08180;Ripollet;1;6;B;;854;326;528;3;5;318;323
8;Barcelona;40;Vallès Occidental;08180;Ripollet;1;7;A;;792;273;519;2;3;268;271
8;Barcelona;40;Vallès Occidental;08180;Ripollet;1;7;B;;881;330;551;7;3;320;323
8;Barcelona;40;Vallès Occidental;08180;Ripollet;1;8;A;;595;248;347;1;1;246;247
8;Barcelona;40;Vallès Occidental;08180;Ripollet;1;8;B;;713;297;416;0;1;296;297
8;Barcelona;40;Vallès Occidental;08180;Ripollet;2;1;A;;538;229;309;0;1;228;229
8;Barcelona;40;Vallès Occidental;08180;Ripollet;2;1;B;;756;340;416;1;4;335;339
8;Barcelona;40;Vallès Occidental;08180;Ripollet;2;2;A;;545;247;298;0;2;245;247
8;Barcelona;40;Vallès Occidental;08180;Ripollet;2;2;B;;654;280;374;1;11;268;279
8;Barcelona;40;Vallès Occidental;08180;Ripollet;2;3;A;;686;308;378;2;1;305;306
8;Barcelona;40;Vallès Occidental;08180;Ripollet;2;3;B;;830;376;454;0;6;370;376
8;Barcelona;40;Vallès Occidental;08180;Ripollet;2;4;A;;650;300;350;0;2;298;300
8;Barcelona;40;Vallès Occidental;08180;Ripollet;2;4;B;;703;321;382;0;6;315;321
8;Barcelona;40;Vallès Occidental;08180;Ripollet;2;5;A;;552;257;295;0;2;255;257
8;Barcelona;40;Vallès Occidental;08180;Ripollet;2;5;B;;645;259;386;4;1;254;255
8;Barcelona;40;Vallès Occidental;08180;Ripollet;2;6;A;;595;241;354;0;4;237;241
8;Barcelona;40;Vallès Occidental;08180;Ripollet;2;6;B;;801;345;456;0;4;341;345
8;Barcelona;40;Vallès Occidental;08180;Ripollet;2;7;A;;522;235;287;1;3;231;234
8;Barcelona;40;Vallès Occidental;08180;Ripollet;2;7;B;;642;296;346;2;2;292;294
17;Girona;34;Selva;17148;Riudarenes;1;1;U;;910;617;293;14;7;596;603
17;Girona;19;Garrotxa;17149;Riudaura;1;1;U;;311;222;89;4;5;213;218
43;Tarragona;8;Baix Camp;43127;Riudecanyes;1;1;U;;491;339;152;1;4;334;338
43;Tarragona;8;Baix Camp;43128;Riudecols;1;1;U;;755;545;210;4;6;535;541
17;Girona;34;Selva;17150;Riudellots de la Selva;1;1;U;;985;692;293;3;10;679;689
43;Tarragona;8;Baix Camp;43129;Riudoms;1;1;A;;576;324;252;5;6;313;319
43;Tarragona;8;Baix Camp;43129;Riudoms;1;1;B;;522;290;232;1;5;284;289
43;Tarragona;8;Baix Camp;43129;Riudoms;2;1;A;;492;281;211;5;2;274;276
43;Tarragona;8;Baix Camp;43129;Riudoms;2;1;B;;466;287;179;2;5;280;285
43;Tarragona;8;Baix Camp;43129;Riudoms;2;2;A;;822;456;366;7;2;447;449
43;Tarragona;8;Baix Camp;43129;Riudoms;2;2;B;;813;456;357;0;6;450;456
17;Girona;2;Alt Empordà;17151;Riumors;1;1;U;;170;105;65;0;0;105;105
8;Barcelona;41;Vallès Oriental;08181;Roca del Vallès, la;1;1;A;;505;267;238;2;2;263;265
8;Barcelona;41;Vallès Oriental;08181;Roca del Vallès, la;1;1;B;;560;297;263;3;0;294;294
8;Barcelona;41;Vallès Oriental;08181;Roca del Vallès, la;1;1;C;;375;250;125;2;2;246;248
8;Barcelona;41;Vallès Oriental;08181;Roca del Vallès, la;1;2;A;;769;418;351;1;8;409;417
8;Barcelona;41;Vallès Oriental;08181;Roca del Vallès, la;1;2;B;;839;454;385;1;5;448;453
8;Barcelona;41;Vallès Oriental;08181;Roca del Vallès, la;1;3;A;;666;366;300;0;7;359;366
8;Barcelona;41;Vallès Oriental;08181;Roca del Vallès, la;1;3;B;;824;421;403;0;6;415;421
43;Tarragona;16;Conca de Barberà;43130;Rocafort de Queralt;1;1;U;;225;154;71;2;3;149;152
43;Tarragona;36;Tarragonès;43131;Roda de Berà;1;1;A;;722;451;271;3;4;444;448
43;Tarragona;36;Tarragonès;43131;Roda de Berà;1;1;B;;878;525;353;4;5;516;521
8;Barcelona;24;Osona;08183;Roda de Ter;1;1;A;;631;403;228;1;6;396;402
8;Barcelona;24;Osona;08183;Roda de Ter;1;1;B;;678;420;258;0;3;417;420
8;Barcelona;24;Osona;08183;Roda de Ter;1;2;U;;714;484;230;0;3;481;484
8;Barcelona;24;Osona;08183;Roda de Ter;1;3;U;;949;655;294;1;5;649;654
8;Barcelona;24;Osona;08183;Roda de Ter;2;1;U;;826;542;284;3;0;539;539
43;Tarragona;1;Alt Camp;43132;Rodonyà;1;1;U;;311;187;124;1;1;185;186
43;Tarragona;9;Baix Ebre;43133;Roquetes;1;1;A;;750;451;299;3;12;436;448
43;Tarragona;9;Baix Ebre;43133;Roquetes;1;1;B;;549;291;258;0;9;282;291
43;Tarragona;9;Baix Ebre;43133;Roquetes;1;2;U;;934;492;442;4;10;478;488
43;Tarragona;9;Baix Ebre;43133;Roquetes;2;1;A;;901;484;417;5;4;475;479
43;Tarragona;9;Baix Ebre;43133;Roquetes;2;1;B;;745;420;325;6;4;410;414
43;Tarragona;9;Baix Ebre;43133;Roquetes;2;2;U;;761;360;401;2;13;345;358
17;Girona;2;Alt Empordà;17152;Roses;1;1;U;;784;462;322;4;2;456;458
17;Girona;2;Alt Empordà;17152;Roses;1;2;A;;583;315;268;1;4;310;314
17;Girona;2;Alt Empordà;17152;Roses;1;2;B;;671;351;320;2;3;346;349
17;Girona;2;Alt Empordà;17152;Roses;1;2;C;;681;341;340;3;1;337;338
17;Girona;2;Alt Empordà;17152;Roses;1;3;U;;832;344;488;3;4;337;341
17;Girona;2;Alt Empordà;17152;Roses;2;1;U;;830;477;353;5;3;469;472
17;Girona;2;Alt Empordà;17152;Roses;2;2;A;;572;347;225;1;7;339;346
17;Girona;2;Alt Empordà;17152;Roses;2;2;B;;627;337;290;1;4;332;336
17;Girona;2;Alt Empordà;17152;Roses;2;2;C;;635;362;273;0;4;358;362
17;Girona;2;Alt Empordà;17152;Roses;2;3;A;;753;430;323;4;15;411;426
17;Girona;2;Alt Empordà;17152;Roses;2;3;B;;769;440;329;4;4;432;436
25;Lleida;33;Segrià;25189;Rosselló;1;1;A;;651;415;236;0;2;413;415
25;Lleida;33;Segrià;25189;Rosselló;1;1;B;;595;375;220;1;6;368;374
43;Tarragona;1;Alt Camp;43134;Rourell, el;1;1;U;;233;168;65;1;3;164;167
8;Barcelona;40;Vallès Occidental;08184;Rubí;1;1;A;;525;226;299;1;1;224;225
8;Barcelona;40;Vallès Occidental;08184;Rubí;1;1;B;;686;259;427;0;5;254;259
8;Barcelona;40;Vallès Occidental;08184;Rubí;1;2;A;;911;338;573;3;2;333;335
8;Barcelona;40;Vallès Occidental;08184;Rubí;1;2;B;;1079;421;658;4;5;412;417
8;Barcelona;40;Vallès Occidental;08184;Rubí;2;1;A;;664;239;425;3;1;235;236
8;Barcelona;40;Vallès Occidental;08184;Rubí;2;1;B;;823;277;546;0;1;276;277
8;Barcelona;40;Vallès Occidental;08184;Rubí;3;1;A;;425;181;244;0;1;180;181
8;Barcelona;40;Vallès Occidental;08184;Rubí;3;1;B;;517;238;279;0;2;236;238
8;Barcelona;40;Vallès Occidental;08184;Rubí;3;2;U;;638;244;394;1;2;241;243
8;Barcelona;40;Vallès Occidental;08184;Rubí;3;3;A;;474;194;280;0;0;194;194
8;Barcelona;40;Vallès Occidental;08184;Rubí;3;3;B;;622;231;391;0;5;226;231
8;Barcelona;40;Vallès Occidental;08184;Rubí;3;4;A;;731;298;433;0;5;293;298
8;Barcelona;40;Vallès Occidental;08184;Rubí;3;4;B;;800;329;471;1;1;327;328
8;Barcelona;40;Vallès Occidental;08184;Rubí;3;5;A;;695;307;388;4;3;300;303
8;Barcelona;40;Vallès Occidental;08184;Rubí;3;5;B;;898;383;515;0;2;381;383
8;Barcelona;40;Vallès Occidental;08184;Rubí;3;6;A;;586;259;327;1;5;253;258
8;Barcelona;40;Vallès Occidental;08184;Rubí;3;6;B;;650;280;370;0;1;279;280
8;Barcelona;40;Vallès Occidental;08184;Rubí;3;7;A;;428;187;241;1;4;182;186
8;Barcelona;40;Vallès Occidental;08184;Rubí;3;7;B;;514;220;294;2;4;214;218
8;Barcelona;40;Vallès Occidental;08184;Rubí;3;8;A;;702;318;384;0;3;315;318
8;Barcelona;40;Vallès Occidental;08184;Rubí;3;8;B;;835;412;423;0;1;411;412
8;Barcelona;40;Vallès Occidental;08184;Rubí;4;1;A;;579;310;269;0;5;305;310
8;Barcelona;40;Vallès Occidental;08184;Rubí;4;1;B;;662;334;328;2;1;331;332
8;Barcelona;40;Vallès Occidental;08184;Rubí;4;10;A;;636;239;397;0;3;236;239
8;Barcelona;40;Vallès Occidental;08184;Rubí;4;10;B;;785;271;514;4;1;266;267
8;Barcelona;40;Vallès Occidental;08184;Rubí;4;11;A;;494;216;278;1;3;212;215
8;Barcelona;40;Vallès Occidental;08184;Rubí;4;11;B;;587;248;339;0;4;244;248
8;Barcelona;40;Vallès Occidental;08184;Rubí;4;11;C;;626;276;350;0;2;274;276
8;Barcelona;40;Vallès Occidental;08184;Rubí;4;12;A;;527;200;327;0;4;196;200
8;Barcelona;40;Vallès Occidental;08184;Rubí;4;12;B;;628;252;376;0;2;250;252
8;Barcelona;40;Vallès Occidental;08184;Rubí;4;12;C;;617;245;372;0;2;243;245
8;Barcelona;40;Vallès Occidental;08184;Rubí;4;13;A;;564;247;317;0;2;245;247
8;Barcelona;40;Vallès Occidental;08184;Rubí;4;13;B;;644;294;350;1;0;293;293
8;Barcelona;40;Vallès Occidental;08184;Rubí;4;13;C;;629;250;379;1;3;246;249
8;Barcelona;40;Vallès Occidental;08184;Rubí;4;14;A;;514;178;336;0;2;176;178
8;Barcelona;40;Vallès Occidental;08184;Rubí;4;14;B;;595;219;376;5;2;212;214
8;Barcelona;40;Vallès Occidental;08184;Rubí;4;15;A;;461;190;271;0;1;189;190
8;Barcelona;40;Vallès Occidental;08184;Rubí;4;15;B;;696;287;409;0;2;285;287
8;Barcelona;40;Vallès Occidental;08184;Rubí;4;15;C;;627;265;362;0;2;263;265
8;Barcelona;40;Vallès Occidental;08184;Rubí;4;16;A;;652;241;411;1;5;235;240
8;Barcelona;40;Vallès Occidental;08184;Rubí;4;16;B;;844;289;555;2;2;285;287
8;Barcelona;40;Vallès Occidental;08184;Rubí;4;16;C;;392;152;240;1;4;147;151
8;Barcelona;40;Vallès Occidental;08184;Rubí;4;18;A;;474;238;236;2;4;232;236
8;Barcelona;40;Vallès Occidental;08184;Rubí;4;18;B;;462;233;229;3;2;228;230
8;Barcelona;40;Vallès Occidental;08184;Rubí;4;2;A;;438;255;183;0;4;251;255
8;Barcelona;40;Vallès Occidental;08184;Rubí;4;2;B;;526;315;211;0;10;305;315
8;Barcelona;40;Vallès Occidental;08184;Rubí;4;3;U;;767;327;440;2;7;318;325
8;Barcelona;40;Vallès Occidental;08184;Rubí;4;4;A;;644;281;363;0;1;280;281
8;Barcelona;40;Vallès Occidental;08184;Rubí;4;4;B;;722;337;385;1;1;335;336
8;Barcelona;40;Vallès Occidental;08184;Rubí;4;5;A;;634;358;276;1;6;351;357
8;Barcelona;40;Vallès Occidental;08184;Rubí;4;5;B;;670;371;299;0;5;366;371
8;Barcelona;40;Vallès Occidental;08184;Rubí;4;6;A;;553;269;284;0;1;268;269
8;Barcelona;40;Vallès Occidental;08184;Rubí;4;6;B;;611;284;327;1;1;282;283
8;Barcelona;40;Vallès Occidental;08184;Rubí;4;7;A;;501;253;248;0;3;250;253
8;Barcelona;40;Vallès Occidental;08184;Rubí;4;7;B;;658;326;332;1;2;323;325
8;Barcelona;40;Vallès Occidental;08184;Rubí;4;8;A;;847;342;505;1;1;340;341
8;Barcelona;40;Vallès Occidental;08184;Rubí;4;8;B;;1012;419;593;0;5;414;419
8;Barcelona;40;Vallès Occidental;08184;Rubí;4;9;A;;411;182;229;0;2;180;182
8;Barcelona;40;Vallès Occidental;08184;Rubí;4;9;B;;554;241;313;0;1;240;241
8;Barcelona;6;Anoia;08185;Rubió;1;1;U;;106;43;63;0;1;42;43
17;Girona;10;Baix Empordà;17153;Rupià;1;1;U;;171;121;50;1;3;117;120
8;Barcelona;24;Osona;08901;Rupit i Pruit;1;1;U;;264;199;65;0;3;196;199
8;Barcelona;40;Vallès Occidental;08187;Sabadell;1;1;U;;783;556;227;1;5;550;555
8;Barcelona;40;Vallès Occidental;08187;Sabadell;1;10;U;;697;465;232;0;4;461;465
8;Barcelona;40;Vallès Occidental;08187;Sabadell;1;11;U;;894;599;295;1;9;589;598
8;Barcelona;40;Vallès Occidental;08187;Sabadell;1;12;A;;716;491;225;0;5;486;491
8;Barcelona;40;Vallès Occidental;08187;Sabadell;1;12;B;;905;587;318;2;2;583;585
8;Barcelona;40;Vallès Occidental;08187;Sabadell;1;13;U;;904;547;357;0;4;543;547
8;Barcelona;40;Vallès Occidental;08187;Sabadell;1;14;A;;607;416;191;1;1;414;415
8;Barcelona;40;Vallès Occidental;08187;Sabadell;1;14;B;;744;518;226;0;5;513;518
8;Barcelona;40;Vallès Occidental;08187;Sabadell;1;15;U;;1256;888;368;0;15;873;888
8;Barcelona;40;Vallès Occidental;08187;Sabadell;1;16;U;;1193;827;366;0;14;813;827
8;Barcelona;40;Vallès Occidental;08187;Sabadell;1;17;A;;559;332;227;1;3;328;331
8;Barcelona;40;Vallès Occidental;08187;Sabadell;1;17;B;;783;482;301;1;5;476;481
8;Barcelona;40;Vallès Occidental;08187;Sabadell;1;18;U;;867;465;402;0;4;461;465
8;Barcelona;40;Vallès Occidental;08187;Sabadell;1;19;A;;614;413;201;0;4;409;413
8;Barcelona;40;Vallès Occidental;08187;Sabadell;1;19;B;;665;425;240;0;4;421;425
8;Barcelona;40;Vallès Occidental;08187;Sabadell;1;2;A;;697;479;218;1;4;474;478
8;Barcelona;40;Vallès Occidental;08187;Sabadell;1;2;B;;838;609;229;1;7;601;608
8;Barcelona;40;Vallès Occidental;08187;Sabadell;1;20;U;;1124;614;510;5;0;609;609
8;Barcelona;40;Vallès Occidental;08187;Sabadell;1;21;U;;921;542;379;0;3;539;542
8;Barcelona;40;Vallès Occidental;08187;Sabadell;1;22;U;;1281;735;546;3;7;725;732
8;Barcelona;40;Vallès Occidental;08187;Sabadell;1;23;A;;571;301;270;1;8;292;300
8;Barcelona;40;Vallès Occidental;08187;Sabadell;1;23;B;;694;389;305;0;4;385;389
8;Barcelona;40;Vallès Occidental;08187;Sabadell;1;24;U;;1139;574;565;0;7;567;574
8;Barcelona;40;Vallès Occidental;08187;Sabadell;1;25;A;;594;326;268;0;7;319;326
8;Barcelona;40;Vallès Occidental;08187;Sabadell;1;25;B;;657;338;319;0;9;329;338
8;Barcelona;40;Vallès Occidental;08187;Sabadell;1;26;U;;843;513;330;0;8;505;513
8;Barcelona;40;Vallès Occidental;08187;Sabadell;1;27;U;;793;468;325;0;10;458;468
8;Barcelona;40;Vallès Occidental;08187;Sabadell;1;28;A;;620;341;279;1;5;335;340
8;Barcelona;40;Vallès Occidental;08187;Sabadell;1;28;B;;790;401;389;0;5;396;401
8;Barcelona;40;Vallès Occidental;08187;Sabadell;1;29;A;;673;397;276;0;3;394;397
8;Barcelona;40;Vallès Occidental;08187;Sabadell;1;29;B;;808;449;359;0;11;438;449
8;Barcelona;40;Vallès Occidental;08187;Sabadell;1;3;U;;863;598;265;5;2;591;593
8;Barcelona;40;Vallès Occidental;08187;Sabadell;1;4;U;;1196;780;416;1;6;773;779
8;Barcelona;40;Vallès Occidental;08187;Sabadell;1;5;A;;679;464;215;1;5;458;463
8;Barcelona;40;Vallès Occidental;08187;Sabadell;1;5;B;;688;441;247;0;5;436;441
8;Barcelona;40;Vallès Occidental;08187;Sabadell;1;6;U;;1172;814;358;0;4;810;814
8;Barcelona;40;Vallès Occidental;08187;Sabadell;1;7;U;;857;599;258;0;7;592;599
8;Barcelona;40;Vallès Occidental;08187;Sabadell;1;8;U;;978;680;298;2;7;671;678
8;Barcelona;40;Vallès Occidental;08187;Sabadell;1;9;U;;1267;846;421;1;7;838;845
8;Barcelona;40;Vallès Occidental;08187;Sabadell;2;1;U;;1208;831;377;0;8;823;831
8;Barcelona;40;Vallès Occidental;08187;Sabadell;2;10;U;;320;112;208;0;0;112;112
8;Barcelona;40;Vallès Occidental;08187;Sabadell;2;11;U;;792;266;526;0;1;265;266
8;Barcelona;40;Vallès Occidental;08187;Sabadell;2;12;A;;670;318;352;0;3;315;318
8;Barcelona;40;Vallès Occidental;08187;Sabadell;2;12;B;;846;380;466;0;5;375;380
8;Barcelona;40;Vallès Occidental;08187;Sabadell;2;13;U;;979;526;453;2;8;516;524
8;Barcelona;40;Vallès Occidental;08187;Sabadell;2;14;A;;764;308;456;1;3;304;307
8;Barcelona;40;Vallès Occidental;08187;Sabadell;2;14;B;;870;410;460;1;6;403;409
8;Barcelona;40;Vallès Occidental;08187;Sabadell;2;15;U;;1166;563;603;0;8;555;563
8;Barcelona;40;Vallès Occidental;08187;Sabadell;2;16;A;;697;451;246;1;5;445;450
8;Barcelona;40;Vallès Occidental;08187;Sabadell;2;16;B;;709;471;238;1;14;456;470
8;Barcelona;40;Vallès Occidental;08187;Sabadell;2;2;U;;1016;673;343;1;6;666;672
8;Barcelona;40;Vallès Occidental;08187;Sabadell;2;3;U;;1281;670;611;0;4;666;670
8;Barcelona;40;Vallès Occidental;08187;Sabadell;2;4;A;;639;402;237;0;4;398;402
8;Barcelona;40;Vallès Occidental;08187;Sabadell;2;4;B;;840;528;312;2;11;515;526
8;Barcelona;40;Vallès Occidental;08187;Sabadell;2;5;U;;1426;880;546;1;8;871;879
8;Barcelona;40;Vallès Occidental;08187;Sabadell;2;6;A;;593;373;220;3;0;370;370
8;Barcelona;40;Vallès Occidental;08187;Sabadell;2;6;B;;828;529;299;4;0;525;525
8;Barcelona;40;Vallès Occidental;08187;Sabadell;2;7;U;;1204;734;470;0;5;729;734
8;Barcelona;40;Vallès Occidental;08187;Sabadell;2;8;U;;1148;691;457;1;5;685;690
8;Barcelona;40;Vallès Occidental;08187;Sabadell;2;9;A;;620;382;238;1;2;379;381
8;Barcelona;40;Vallès Occidental;08187;Sabadell;2;9;B;;725;434;291;0;3;431;434
8;Barcelona;40;Vallès Occidental;08187;Sabadell;3;1;U;;1173;550;623;4;4;542;546
8;Barcelona;40;Vallès Occidental;08187;Sabadell;3;10;U;;662;330;332;0;3;327;330
8;Barcelona;40;Vallès Occidental;08187;Sabadell;3;11;U;;1083;519;564;3;3;513;516
8;Barcelona;40;Vallès Occidental;08187;Sabadell;3;12;U;;914;476;438;1;2;473;475
8;Barcelona;40;Vallès Occidental;08187;Sabadell;3;13;U;;1097;508;589;2;0;506;506
8;Barcelona;40;Vallès Occidental;08187;Sabadell;3;14;A;;720;384;336;1;3;380;383
8;Barcelona;40;Vallès Occidental;08187;Sabadell;3;14;B;;881;430;451;0;4;426;430
8;Barcelona;40;Vallès Occidental;08187;Sabadell;3;15;A;;602;278;324;1;3;274;277
8;Barcelona;40;Vallès Occidental;08187;Sabadell;3;15;B;;782;353;429;0;1;352;353
8;Barcelona;40;Vallès Occidental;08187;Sabadell;3;16;A;;573;245;328;1;3;241;244
8;Barcelona;40;Vallès Occidental;08187;Sabadell;3;16;B;;698;361;337;0;2;359;361
8;Barcelona;40;Vallès Occidental;08187;Sabadell;3;17;A;;612;281;331;0;3;278;281
8;Barcelona;40;Vallès Occidental;08187;Sabadell;3;17;B;;768;361;407;6;4;351;355
8;Barcelona;40;Vallès Occidental;08187;Sabadell;3;18;U;;1018;491;527;0;2;489;491
8;Barcelona;40;Vallès Occidental;08187;Sabadell;3;19;A;;630;304;326;0;2;302;304
8;Barcelona;40;Vallès Occidental;08187;Sabadell;3;19;B;;818;357;461;2;4;351;355
8;Barcelona;40;Vallès Occidental;08187;Sabadell;3;2;U;;1141;475;666;4;12;459;471
8;Barcelona;40;Vallès Occidental;08187;Sabadell;3;20;U;;828;361;467;0;4;357;361
8;Barcelona;40;Vallès Occidental;08187;Sabadell;3;21;A;;601;309;292;0;2;307;309
8;Barcelona;40;Vallès Occidental;08187;Sabadell;3;21;B;;702;313;389;1;2;310;312
8;Barcelona;40;Vallès Occidental;08187;Sabadell;3;22;U;;870;386;484;2;9;375;384
8;Barcelona;40;Vallès Occidental;08187;Sabadell;3;23;U;;726;344;382;0;5;339;344
8;Barcelona;40;Vallès Occidental;08187;Sabadell;3;3;A;;619;248;371;1;0;247;247
8;Barcelona;40;Vallès Occidental;08187;Sabadell;3;3;B;;811;351;460;0;6;345;351
8;Barcelona;40;Vallès Occidental;08187;Sabadell;3;4;A;;579;293;286;2;1;290;291
8;Barcelona;40;Vallès Occidental;08187;Sabadell;3;4;B;;857;422;435;5;4;413;417
8;Barcelona;40;Vallès Occidental;08187;Sabadell;3;5;A;;778;332;446;1;1;330;331
8;Barcelona;40;Vallès Occidental;08187;Sabadell;3;5;B;;1023;491;532;2;6;483;489
8;Barcelona;40;Vallès Occidental;08187;Sabadell;3;6;U;;1049;485;564;1;8;476;484
8;Barcelona;40;Vallès Occidental;08187;Sabadell;3;7;U;;836;418;418;0;2;416;418
8;Barcelona;40;Vallès Occidental;08187;Sabadell;3;8;U;;974;450;524;0;2;448;450
8;Barcelona;40;Vallès Occidental;08187;Sabadell;3;9;U;;810;393;417;1;1;391;392
8;Barcelona;40;Vallès Occidental;08187;Sabadell;4;1;U;;1081;462;619;0;4;458;462
8;Barcelona;40;Vallès Occidental;08187;Sabadell;4;10;A;;598;264;334;0;5;259;264
8;Barcelona;40;Vallès Occidental;08187;Sabadell;4;10;B;;708;304;404;0;0;304;304
8;Barcelona;40;Vallès Occidental;08187;Sabadell;4;11;A;;787;342;445;1;6;335;341
8;Barcelona;40;Vallès Occidental;08187;Sabadell;4;11;B;;894;338;556;0;4;334;338
8;Barcelona;40;Vallès Occidental;08187;Sabadell;4;12;A;;787;345;442;2;8;335;343
8;Barcelona;40;Vallès Occidental;08187;Sabadell;4;12;B;;998;457;541;3;2;452;454
8;Barcelona;40;Vallès Occidental;08187;Sabadell;4;13;U;;1050;415;635;2;3;410;413
8;Barcelona;40;Vallès Occidental;08187;Sabadell;4;14;U;;1170;574;596;0;10;564;574
8;Barcelona;40;Vallès Occidental;08187;Sabadell;4;15;U;;952;425;527;1;4;420;424
8;Barcelona;40;Vallès Occidental;08187;Sabadell;4;16;U;;1224;566;658;3;9;554;563
8;Barcelona;40;Vallès Occidental;08187;Sabadell;4;17;A;;683;302;381;2;2;298;300
8;Barcelona;40;Vallès Occidental;08187;Sabadell;4;17;B;;891;450;441;1;6;443;449
8;Barcelona;40;Vallès Occidental;08187;Sabadell;4;18;U;;641;317;324;0;2;315;317
8;Barcelona;40;Vallès Occidental;08187;Sabadell;4;19;A;;620;259;361;0;0;259;259
8;Barcelona;40;Vallès Occidental;08187;Sabadell;4;19;B;;746;321;425;3;4;314;318
8;Barcelona;40;Vallès Occidental;08187;Sabadell;4;2;U;;1220;578;642;1;0;577;577
8;Barcelona;40;Vallès Occidental;08187;Sabadell;4;20;U;;1175;482;693;1;3;478;481
8;Barcelona;40;Vallès Occidental;08187;Sabadell;4;3;U;;1021;462;559;0;3;459;462
8;Barcelona;40;Vallès Occidental;08187;Sabadell;4;4;A;;689;333;356;0;6;327;333
8;Barcelona;40;Vallès Occidental;08187;Sabadell;4;4;B;;794;386;408;0;5;381;386
8;Barcelona;40;Vallès Occidental;08187;Sabadell;4;5;A;;673;348;325;0;5;343;348
8;Barcelona;40;Vallès Occidental;08187;Sabadell;4;5;B;;877;431;446;1;4;426;430
8;Barcelona;40;Vallès Occidental;08187;Sabadell;4;6;A;;517;237;280;0;0;237;237
8;Barcelona;40;Vallès Occidental;08187;Sabadell;4;6;B;;626;260;366;0;0;260;260
8;Barcelona;40;Vallès Occidental;08187;Sabadell;4;7;U;;918;455;463;2;5;448;453
8;Barcelona;40;Vallès Occidental;08187;Sabadell;4;8;A;;622;331;291;4;1;326;327
8;Barcelona;40;Vallès Occidental;08187;Sabadell;4;8;B;;713;367;346;2;4;361;365
8;Barcelona;40;Vallès Occidental;08187;Sabadell;4;9;U;;795;387;408;0;4;383;387
8;Barcelona;40;Vallès Occidental;08187;Sabadell;5;1;U;;1157;650;507;0;8;642;650
8;Barcelona;40;Vallès Occidental;08187;Sabadell;5;10;U;;795;389;406;0;5;384;389
8;Barcelona;40;Vallès Occidental;08187;Sabadell;5;11;U;;746;356;390;3;4;349;353
8;Barcelona;40;Vallès Occidental;08187;Sabadell;5;12;U;;992;498;494;3;5;490;495
8;Barcelona;40;Vallès Occidental;08187;Sabadell;5;13;U;;991;487;504;1;3;483;486
8;Barcelona;40;Vallès Occidental;08187;Sabadell;5;2;U;;792;456;336;1;1;454;455
8;Barcelona;40;Vallès Occidental;08187;Sabadell;5;3;A;;680;423;257;2;6;415;421
8;Barcelona;40;Vallès Occidental;08187;Sabadell;5;3;B;;638;422;216;1;2;419;421
8;Barcelona;40;Vallès Occidental;08187;Sabadell;5;4;U;;658;368;290;1;6;361;367
8;Barcelona;40;Vallès Occidental;08187;Sabadell;5;5;U;;1015;590;425;1;7;582;589
8;Barcelona;40;Vallès Occidental;08187;Sabadell;5;6;U;;970;627;343;1;7;619;626
8;Barcelona;40;Vallès Occidental;08187;Sabadell;5;7;U;;1142;552;590;9;4;539;543
8;Barcelona;40;Vallès Occidental;08187;Sabadell;5;8;U;;923;525;398;1;5;519;524
8;Barcelona;40;Vallès Occidental;08187;Sabadell;5;9;U;;1088;564;524;1;8;555;563
8;Barcelona;40;Vallès Occidental;08187;Sabadell;6;1;U;;536;288;248;1;3;284;287
8;Barcelona;40;Vallès Occidental;08187;Sabadell;6;10;U;;1061;469;592;0;6;463;469
8;Barcelona;40;Vallès Occidental;08187;Sabadell;6;11;U;;1193;497;696;1;11;485;496
8;Barcelona;40;Vallès Occidental;08187;Sabadell;6;12;U;;1224;586;638;3;6;577;583
8;Barcelona;40;Vallès Occidental;08187;Sabadell;6;13;U;;1043;427;616;2;2;423;425
8;Barcelona;40;Vallès Occidental;08187;Sabadell;6;14;U;;543;283;260;0;3;280;283
8;Barcelona;40;Vallès Occidental;08187;Sabadell;6;15;U;;1188;494;694;3;5;486;491
8;Barcelona;40;Vallès Occidental;08187;Sabadell;6;16;A;;674;386;288;0;7;379;386
8;Barcelona;40;Vallès Occidental;08187;Sabadell;6;16;B;;777;411;366;1;2;408;410
8;Barcelona;40;Vallès Occidental;08187;Sabadell;6;17;A;;666;318;348;0;0;318;318
8;Barcelona;40;Vallès Occidental;08187;Sabadell;6;17;B;;868;441;427;1;3;437;440
8;Barcelona;40;Vallès Occidental;08187;Sabadell;6;18;U;;1134;619;515;2;12;605;617
8;Barcelona;40;Vallès Occidental;08187;Sabadell;6;19;U;;765;440;325;0;4;436;440
8;Barcelona;40;Vallès Occidental;08187;Sabadell;6;2;A;;584;281;303;0;3;278;281
8;Barcelona;40;Vallès Occidental;08187;Sabadell;6;2;B;;758;387;371;0;5;382;387
8;Barcelona;40;Vallès Occidental;08187;Sabadell;6;20;U;;1023;482;541;0;5;477;482
8;Barcelona;40;Vallès Occidental;08187;Sabadell;6;21;U;;915;477;438;4;4;469;473
8;Barcelona;40;Vallès Occidental;08187;Sabadell;6;22;A;;599;282;317;0;6;276;282
8;Barcelona;40;Vallès Occidental;08187;Sabadell;6;22;B;;769;372;397;3;5;364;369
8;Barcelona;40;Vallès Occidental;08187;Sabadell;6;23;A;;664;307;357;0;4;303;307
8;Barcelona;40;Vallès Occidental;08187;Sabadell;6;23;B;;786;394;392;2;3;389;392
8;Barcelona;40;Vallès Occidental;08187;Sabadell;6;3;U;;505;254;251;2;0;252;252
8;Barcelona;40;Vallès Occidental;08187;Sabadell;6;4;U;;794;422;372;2;7;413;420
8;Barcelona;40;Vallès Occidental;08187;Sabadell;6;5;U;;1054;498;556;0;1;497;498
8;Barcelona;40;Vallès Occidental;08187;Sabadell;6;6;U;;858;383;475;0;4;379;383
8;Barcelona;40;Vallès Occidental;08187;Sabadell;6;7;U;;910;455;455;2;4;449;453
8;Barcelona;40;Vallès Occidental;08187;Sabadell;6;8;A;;757;377;380;0;4;373;377
8;Barcelona;40;Vallès Occidental;08187;Sabadell;6;8;B;;856;421;435;0;4;417;421
8;Barcelona;40;Vallès Occidental;08187;Sabadell;6;9;A;;792;378;414;1;1;376;377
8;Barcelona;40;Vallès Occidental;08187;Sabadell;6;9;B;;936;392;544;1;3;388;391
8;Barcelona;40;Vallès Occidental;08187;Sabadell;7;1;U;;980;519;461;0;3;516;519
8;Barcelona;40;Vallès Occidental;08187;Sabadell;7;2;U;;1102;658;444;3;1;654;655
8;Barcelona;40;Vallès Occidental;08187;Sabadell;7;3;U;;1409;703;706;1;3;699;702
8;Barcelona;40;Vallès Occidental;08187;Sabadell;7;4;U;;774;423;351;0;7;416;423
8;Barcelona;40;Vallès Occidental;08187;Sabadell;7;5;U;;667;392;275;0;0;392;392
8;Barcelona;40;Vallès Occidental;08187;Sabadell;7;6;U;;638;355;283;6;5;344;349
8;Barcelona;14;Berguedà;08188;Sagàs;1;1;U;;153;98;55;1;2;95;97
25;Lleida;25;Pallars Jussà;25190;Salàs de Pallars;1;1;U;;301;211;90;1;3;207;210
8;Barcelona;14;Berguedà;08190;Saldes;1;1;U;;277;177;100;0;1;176;177
17;Girona;19;Garrotxa;17154;Sales de Llierca;1;1;U;;45;27;18;0;0;27;27
8;Barcelona;7;Bages;08191;Sallent;1;1;U;;619;413;206;1;3;409;412
8;Barcelona;7;Bages;08191;Sallent;1;2;U;;740;452;288;1;1;450;451
8;Barcelona;7;Bages;08191;Sallent;1;3;A;;536;353;183;1;3;349;352
8;Barcelona;7;Bages;08191;Sallent;1;3;B;;586;381;205;4;0;377;377
8;Barcelona;7;Bages;08191;Sallent;1;4;A;;473;256;217;2;1;253;254
8;Barcelona;7;Bages;08191;Sallent;1;4;B;;503;277;226;6;5;266;271
8;Barcelona;7;Bages;08191;Sallent;1;5;U;;794;505;289;1;1;503;504
8;Barcelona;7;Bages;08191;Sallent;1;6;U;;742;455;287;2;7;446;453
8;Barcelona;7;Bages;08191;Sallent;1;7;U;;611;331;280;0;4;327;331
8;Barcelona;7;Bages;08191;Sallent;2;1;U;;712;398;314;0;6;392;398
43;Tarragona;36;Tarragonès;43135;Salomó;1;1;U;;392;308;84;2;4;302;306
43;Tarragona;36;Tarragonès;43905;Salou;1;1;A;;770;328;442;10;3;315;318
43;Tarragona;36;Tarragonès;43905;Salou;1;1;B;;878;388;490;12;8;368;376
43;Tarragona;36;Tarragonès;43905;Salou;1;2;A;;763;308;455;6;4;298;302
43;Tarragona;36;Tarragonès;43905;Salou;1;2;B;;810;315;495;7;3;305;308
43;Tarragona;36;Tarragonès;43905;Salou;1;3;A;;562;266;296;4;6;256;262
43;Tarragona;36;Tarragonès;43905;Salou;1;3;B;;561;263;298;2;6;255;261
43;Tarragona;36;Tarragonès;43905;Salou;1;4;A;;759;348;411;15;1;332;333
43;Tarragona;36;Tarragonès;43905;Salou;1;4;B;;817;374;443;12;8;354;362
17;Girona;20;Gironès;17155;Salt;1;1;U;;1232;810;422;1;8;801;809
17;Girona;20;Gironès;17155;Salt;1;2;U;;890;587;303;7;7;573;580
17;Girona;20;Gironès;17155;Salt;1;3;U;;1194;672;522;0;6;666;672
17;Girona;20;Gironès;17155;Salt;1;4;A;;791;485;306;3;7;475;482
17;Girona;20;Gironès;17155;Salt;1;4;B;;930;568;362;3;12;553;565
17;Girona;20;Gironès;17155;Salt;1;5;A;;726;366;360;0;4;362;366
17;Girona;20;Gironès;17155;Salt;1;5;B;;860;442;418;0;2;440;442
17;Girona;20;Gironès;17155;Salt;1;6;A;;630;349;281;1;4;344;348
17;Girona;20;Gironès;17155;Salt;1;6;B;;744;400;344;1;2;397;399
17;Girona;20;Gironès;17155;Salt;1;7;U;;1069;576;493;5;17;554;571
17;Girona;20;Gironès;17155;Salt;1;8;U;;769;467;302;1;8;458;466
17;Girona;20;Gironès;17155;Salt;2;1;A;;572;333;239;1;3;329;332
17;Girona;20;Gironès;17155;Salt;2;1;B;;651;400;251;4;0;396;396
17;Girona;20;Gironès;17155;Salt;2;2;U;;1136;629;507;3;7;619;626
17;Girona;20;Gironès;17155;Salt;2;3;U;;1231;672;559;6;6;660;666
17;Girona;20;Gironès;17155;Salt;2;4;U;;1152;418;734;2;3;413;416
17;Girona;20;Gironès;17155;Salt;2;5;U;;822;550;272;2;4;544;548
17;Girona;20;Gironès;17155;Salt;2;6;U;;894;422;472;3;3;416;419
25;Lleida;32;Segarra;25191;Sanaüja;1;1;U;;397;289;108;1;7;281;288
43;Tarragona;22;Montsià;43138;Santa Bàrbara;1;1;A;;858;626;232;2;10;614;624
43;Tarragona;22;Montsià;43138;Santa Bàrbara;1;1;B;;736;541;195;4;6;531;537
43;Tarragona;22;Montsià;43138;Santa Bàrbara;2;1;A;;557;392;165;3;7;382;389
43;Tarragona;22;Montsià;43138;Santa Bàrbara;2;1;B;;527;339;188;3;3;333;336
8;Barcelona;24;Osona;08243;Santa Cecília de Voltregà;1;1;U;;143;120;23;0;0;120;120
8;Barcelona;11;Baix Llobregat;08244;Santa Coloma de Cervelló;1;1;A;;689;379;310;1;2;376;378
8;Barcelona;11;Baix Llobregat;08244;Santa Coloma de Cervelló;1;1;B;;948;553;395;2;7;544;551
8;Barcelona;11;Baix Llobregat;08244;Santa Coloma de Cervelló;1;2;U;;685;445;240;0;11;434;445
17;Girona;34;Selva;17180;Santa Coloma de Farners;1;1;A;;699;442;257;0;7;435;442
17;Girona;34;Selva;17180;Santa Coloma de Farners;1;1;B;;691;411;280;1;9;401;410
17;Girona;34;Selva;17180;Santa Coloma de Farners;1;2;A;;540;343;197;3;0;340;340
17;Girona;34;Selva;17180;Santa Coloma de Farners;1;2;B;;512;288;224;2;1;285;286
17;Girona;34;Selva;17180;Santa Coloma de Farners;1;3;A;;676;455;221;5;7;443;450
17;Girona;34;Selva;17180;Santa Coloma de Farners;1;3;B;;691;422;269;0;3;419;422
17;Girona;34;Selva;17180;Santa Coloma de Farners;1;4;A;;657;370;287;1;3;366;369
17;Girona;34;Selva;17180;Santa Coloma de Farners;1;4;B;;777;454;323;1;6;447;453
17;Girona;34;Selva;17180;Santa Coloma de Farners;1;5;A;;509;285;224;1;6;278;284
17;Girona;34;Selva;17180;Santa Coloma de Farners;1;5;B;;580;342;238;0;12;330;342
8;Barcelona;13;Barcelonès;08245;Santa Coloma de Gramenet;1;1;U;;967;551;416;0;12;539;551
8;Barcelona;13;Barcelonès;08245;Santa Coloma de Gramenet;1;10;A;;616;259;357;0;0;259;259
8;Barcelona;13;Barcelonès;08245;Santa Coloma de Gramenet;1;10;B;;715;287;428;15;0;272;272
8;Barcelona;13;Barcelonès;08245;Santa Coloma de Gramenet;1;11;A;;528;236;292;1;2;233;235
8;Barcelona;13;Barcelonès;08245;Santa Coloma de Gramenet;1;11;B;;581;253;328;3;2;248;250
8;Barcelona;13;Barcelonès;08245;Santa Coloma de Gramenet;1;12;U;;823;357;466;0;2;355;357
8;Barcelona;13;Barcelonès;08245;Santa Coloma de Gramenet;1;13;A;;529;233;296;1;3;229;232
8;Barcelona;13;Barcelonès;08245;Santa Coloma de Gramenet;1;13;B;;550;252;298;2;1;249;250
8;Barcelona;13;Barcelonès;08245;Santa Coloma de Gramenet;1;13;C;;512;237;275;0;4;233;237
8;Barcelona;13;Barcelonès;08245;Santa Coloma de Gramenet;1;14;U;;812;413;399;4;1;408;409
8;Barcelona;13;Barcelonès;08245;Santa Coloma de Gramenet;1;15;U;;765;349;416;0;6;343;349
8;Barcelona;13;Barcelonès;08245;Santa Coloma de Gramenet;1;16;U;;797;347;450;0;3;344;347
8;Barcelona;13;Barcelonès;08245;Santa Coloma de Gramenet;1;17;A;;679;267;412;0;0;267;267
8;Barcelona;13;Barcelonès;08245;Santa Coloma de Gramenet;1;17;B;;825;324;501;4;3;317;320
8;Barcelona;13;Barcelonès;08245;Santa Coloma de Gramenet;1;18;A;;585;257;328;2;3;252;255
8;Barcelona;13;Barcelonès;08245;Santa Coloma de Gramenet;1;18;B;;644;295;349;3;0;292;292
8;Barcelona;13;Barcelonès;08245;Santa Coloma de Gramenet;1;19;A;;636;269;367;0;2;267;269
8;Barcelona;13;Barcelonès;08245;Santa Coloma de Gramenet;1;19;B;;700;270;430;0;2;268;270
8;Barcelona;13;Barcelonès;08245;Santa Coloma de Gramenet;1;2;U;;718;329;389;0;5;324;329
8;Barcelona;13;Barcelonès;08245;Santa Coloma de Gramenet;1;3;A;;540;236;304;0;2;234;236
8;Barcelona;13;Barcelonès;08245;Santa Coloma de Gramenet;1;3;B;;672;285;387;1;1;283;284
8;Barcelona;13;Barcelonès;08245;Santa Coloma de Gramenet;1;4;U;;780;349;431;1;3;345;348
8;Barcelona;13;Barcelonès;08245;Santa Coloma de Gramenet;1;5;U;;783;376;407;0;3;373;376
8;Barcelona;13;Barcelonès;08245;Santa Coloma de Gramenet;1;6;U;;809;313;496;6;0;307;307
8;Barcelona;13;Barcelonès;08245;Santa Coloma de Gramenet;1;7;U;;676;274;402;0;2;272;274
8;Barcelona;13;Barcelonès;08245;Santa Coloma de Gramenet;1;8;U;;686;318;368;0;1;317;318
8;Barcelona;13;Barcelonès;08245;Santa Coloma de Gramenet;1;9;A;;558;242;316;1;3;238;241
8;Barcelona;13;Barcelonès;08245;Santa Coloma de Gramenet;1;9;B;;629;260;369;0;0;260;260
8;Barcelona;13;Barcelonès;08245;Santa Coloma de Gramenet;2;1;U;;963;432;531;0;5;427;432
8;Barcelona;13;Barcelonès;08245;Santa Coloma de Gramenet;2;10;U;;764;317;447;3;0;314;314
8;Barcelona;13;Barcelonès;08245;Santa Coloma de Gramenet;2;11;A;;597;199;398;0;2;197;199
8;Barcelona;13;Barcelonès;08245;Santa Coloma de Gramenet;2;11;B;;680;252;428;0;1;251;252
8;Barcelona;13;Barcelonès;08245;Santa Coloma de Gramenet;2;2;A;;470;196;274;1;1;194;195
8;Barcelona;13;Barcelonès;08245;Santa Coloma de Gramenet;2;2;B;;546;222;324;1;3;218;221
8;Barcelona;13;Barcelonès;08245;Santa Coloma de Gramenet;2;2;C;;478;207;271;1;4;202;206
8;Barcelona;13;Barcelonès;08245;Santa Coloma de Gramenet;2;3;A;;615;232;383;0;1;231;232
8;Barcelona;13;Barcelonès;08245;Santa Coloma de Gramenet;2;3;B;;783;258;525;0;3;255;258
8;Barcelona;13;Barcelonès;08245;Santa Coloma de Gramenet;2;4;A;;550;208;342;3;0;205;205
8;Barcelona;13;Barcelonès;08245;Santa Coloma de Gramenet;2;4;B;;652;238;414;1;2;235;237
8;Barcelona;13;Barcelonès;08245;Santa Coloma de Gramenet;2;5;A;;565;245;320;1;3;241;244
8;Barcelona;13;Barcelonès;08245;Santa Coloma de Gramenet;2;5;B;;658;297;361;0;2;295;297
8;Barcelona;13;Barcelonès;08245;Santa Coloma de Gramenet;2;6;A;;603;248;355;1;2;245;247
8;Barcelona;13;Barcelonès;08245;Santa Coloma de Gramenet;2;6;B;;677;309;368;1;4;304;308
8;Barcelona;13;Barcelonès;08245;Santa Coloma de Gramenet;2;7;A;;528;192;336;0;2;190;192
8;Barcelona;13;Barcelonès;08245;Santa Coloma de Gramenet;2;7;B;;570;204;366;1;1;202;203
8;Barcelona;13;Barcelonès;08245;Santa Coloma de Gramenet;2;7;C;;557;196;361;0;5;191;196
8;Barcelona;13;Barcelonès;08245;Santa Coloma de Gramenet;2;8;A;;587;251;336;0;7;244;251
8;Barcelona;13;Barcelonès;08245;Santa Coloma de Gramenet;2;8;B;;726;296;430;4;5;287;292
8;Barcelona;13;Barcelonès;08245;Santa Coloma de Gramenet;2;9;U;;1104;475;629;0;0;475;475
8;Barcelona;13;Barcelonès;08245;Santa Coloma de Gramenet;3;1;U;;874;321;553;0;6;315;321
8;Barcelona;13;Barcelonès;08245;Santa Coloma de Gramenet;3;10;U;;509;206;303;1;1;204;205
8;Barcelona;13;Barcelonès;08245;Santa Coloma de Gramenet;3;11;U;;803;367;436;1;7;359;366
8;Barcelona;13;Barcelonès;08245;Santa Coloma de Gramenet;3;12;A;;596;237;359;2;2;233;235
8;Barcelona;13;Barcelonès;08245;Santa Coloma de Gramenet;3;12;B;;822;337;485;3;4;330;334
8;Barcelona;13;Barcelonès;08245;Santa Coloma de Gramenet;3;13;A;;456;182;274;1;4;177;181
8;Barcelona;13;Barcelonès;08245;Santa Coloma de Gramenet;3;13;B;;566;204;362;0;1;203;204
8;Barcelona;13;Barcelonès;08245;Santa Coloma de Gramenet;3;13;C;;589;223;366;0;2;221;223
8;Barcelona;13;Barcelonès;08245;Santa Coloma de Gramenet;3;14;U;;970;396;574;0;8;388;396
8;Barcelona;13;Barcelonès;08245;Santa Coloma de Gramenet;3;15;A;;507;198;309;1;2;195;197
8;Barcelona;13;Barcelonès;08245;Santa Coloma de Gramenet;3;15;B;;539;217;322;0;3;214;217
8;Barcelona;13;Barcelonès;08245;Santa Coloma de Gramenet;3;16;U;;938;403;535;0;2;401;403
8;Barcelona;13;Barcelonès;08245;Santa Coloma de Gramenet;3;17;U;;970;273;697;5;0;268;268
8;Barcelona;13;Barcelonès;08245;Santa Coloma de Gramenet;3;2;U;;626;234;392;3;1;230;231
8;Barcelona;13;Barcelonès;08245;Santa Coloma de Gramenet;3;3;U;;986;390;596;1;1;388;389
8;Barcelona;13;Barcelonès;08245;Santa Coloma de Gramenet;3;4;A;;546;195;351;1;3;191;194
8;Barcelona;13;Barcelonès;08245;Santa Coloma de Gramenet;3;4;B;;652;254;398;1;0;253;253
8;Barcelona;13;Barcelonès;08245;Santa Coloma de Gramenet;3;5;A;;579;184;395;1;3;180;183
8;Barcelona;13;Barcelonès;08245;Santa Coloma de Gramenet;3;5;B;;679;225;454;1;3;221;224
8;Barcelona;13;Barcelonès;08245;Santa Coloma de Gramenet;3;6;U;;1022;403;619;0;10;393;403
8;Barcelona;13;Barcelonès;08245;Santa Coloma de Gramenet;3;7;A;;501;223;278;2;4;217;221
8;Barcelona;13;Barcelonès;08245;Santa Coloma de Gramenet;3;7;B;;647;244;403;2;0;242;242
8;Barcelona;13;Barcelonès;08245;Santa Coloma de Gramenet;3;7;C;;509;187;322;0;4;183;187
8;Barcelona;13;Barcelonès;08245;Santa Coloma de Gramenet;3;8;U;;744;336;408;3;1;332;333
8;Barcelona;13;Barcelonès;08245;Santa Coloma de Gramenet;3;9;U;;977;431;546;0;6;425;431
8;Barcelona;13;Barcelonès;08245;Santa Coloma de Gramenet;4;1;U;;941;407;534;0;2;405;407
8;Barcelona;13;Barcelonès;08245;Santa Coloma de Gramenet;4;10;A;;525;207;318;0;4;203;207
8;Barcelona;13;Barcelonès;08245;Santa Coloma de Gramenet;4;10;B;;631;274;357;0;5;269;274
8;Barcelona;13;Barcelonès;08245;Santa Coloma de Gramenet;4;11;U;;1102;496;606;3;2;491;493
8;Barcelona;13;Barcelonès;08245;Santa Coloma de Gramenet;4;12;U;;989;490;499;0;2;488;490
8;Barcelona;13;Barcelonès;08245;Santa Coloma de Gramenet;4;13;A;;460;181;279;1;7;173;180
8;Barcelona;13;Barcelonès;08245;Santa Coloma de Gramenet;4;13;B;;521;202;319;0;3;199;202
8;Barcelona;13;Barcelonès;08245;Santa Coloma de Gramenet;4;14;A;;528;199;329;0;1;198;199
8;Barcelona;13;Barcelonès;08245;Santa Coloma de Gramenet;4;14;B;;639;250;389;1;3;246;249
8;Barcelona;13;Barcelonès;08245;Santa Coloma de Gramenet;4;14;C;;621;273;348;0;5;268;273
8;Barcelona;13;Barcelonès;08245;Santa Coloma de Gramenet;4;15;A;;606;226;380;2;1;223;224
8;Barcelona;13;Barcelonès;08245;Santa Coloma de Gramenet;4;15;B;;745;311;434;2;7;302;309
8;Barcelona;13;Barcelonès;08245;Santa Coloma de Gramenet;4;16;A;;729;299;430;0;2;297;299
8;Barcelona;13;Barcelonès;08245;Santa Coloma de Gramenet;4;16;B;;891;366;525;2;5;359;364
8;Barcelona;13;Barcelonès;08245;Santa Coloma de Gramenet;4;2;A;;559;276;283;1;2;273;275
8;Barcelona;13;Barcelonès;08245;Santa Coloma de Gramenet;4;2;B;;568;287;281;0;2;285;287
8;Barcelona;13;Barcelonès;08245;Santa Coloma de Gramenet;4;3;U;;1006;395;611;1;7;387;394
8;Barcelona;13;Barcelonès;08245;Santa Coloma de Gramenet;4;4;A;;530;222;308;0;2;220;222
8;Barcelona;13;Barcelonès;08245;Santa Coloma de Gramenet;4;4;B;;623;249;374;0;3;246;249
8;Barcelona;13;Barcelonès;08245;Santa Coloma de Gramenet;4;5;U;;907;346;561;1;6;339;345
8;Barcelona;13;Barcelonès;08245;Santa Coloma de Gramenet;4;6;A;;540;246;294;1;1;244;245
8;Barcelona;13;Barcelonès;08245;Santa Coloma de Gramenet;4;6;B;;680;317;363;0;8;309;317
8;Barcelona;13;Barcelonès;08245;Santa Coloma de Gramenet;4;7;A;;645;274;371;0;5;269;274
8;Barcelona;13;Barcelonès;08245;Santa Coloma de Gramenet;4;7;B;;746;308;438;2;3;303;306
8;Barcelona;13;Barcelonès;08245;Santa Coloma de Gramenet;4;8;A;;444;208;236;0;3;205;208
8;Barcelona;13;Barcelonès;08245;Santa Coloma de Gramenet;4;8;B;;506;212;294;1;1;210;211
8;Barcelona;13;Barcelonès;08245;Santa Coloma de Gramenet;4;8;C;;545;269;276;3;2;264;266
8;Barcelona;13;Barcelonès;08245;Santa Coloma de Gramenet;4;9;A;;672;275;397;0;3;272;275
8;Barcelona;13;Barcelonès;08245;Santa Coloma de Gramenet;4;9;B;;782;331;451;1;2;328;330
8;Barcelona;13;Barcelonès;08245;Santa Coloma de Gramenet;5;1;U;;867;361;506;1;7;353;360
8;Barcelona;13;Barcelonès;08245;Santa Coloma de Gramenet;5;10;U;;717;279;438;1;2;276;278
8;Barcelona;13;Barcelonès;08245;Santa Coloma de Gramenet;5;11;A;;563;219;344;0;0;219;219
8;Barcelona;13;Barcelonès;08245;Santa Coloma de Gramenet;5;11;B;;644;250;394;1;4;245;249
8;Barcelona;13;Barcelonès;08245;Santa Coloma de Gramenet;5;12;U;;876;341;535;2;1;338;339
8;Barcelona;13;Barcelonès;08245;Santa Coloma de Gramenet;5;13;A;;557;195;362;0;3;192;195
8;Barcelona;13;Barcelonès;08245;Santa Coloma de Gramenet;5;13;B;;569;221;348;0;1;220;221
8;Barcelona;13;Barcelonès;08245;Santa Coloma de Gramenet;5;14;A;;578;208;370;0;2;206;208
8;Barcelona;13;Barcelonès;08245;Santa Coloma de Gramenet;5;14;B;;664;237;427;0;3;234;237
8;Barcelona;13;Barcelonès;08245;Santa Coloma de Gramenet;5;15;A;;526;183;343;0;3;180;183
8;Barcelona;13;Barcelonès;08245;Santa Coloma de Gramenet;5;15;B;;665;226;439;0;2;224;226
8;Barcelona;13;Barcelonès;08245;Santa Coloma de Gramenet;5;16;U;;854;306;548;0;0;306;306
8;Barcelona;13;Barcelonès;08245;Santa Coloma de Gramenet;5;17;U;;736;210;526;0;0;210;210
8;Barcelona;13;Barcelonès;08245;Santa Coloma de Gramenet;5;18;A;;413;129;284;1;1;127;128
8;Barcelona;13;Barcelonès;08245;Santa Coloma de Gramenet;5;18;B;;497;167;330;0;3;164;167
8;Barcelona;13;Barcelonès;08245;Santa Coloma de Gramenet;5;19;U;;915;392;523;2;4;386;390
8;Barcelona;13;Barcelonès;08245;Santa Coloma de Gramenet;5;2;A;;628;243;385;0;3;240;243
8;Barcelona;13;Barcelonès;08245;Santa Coloma de Gramenet;5;2;B;;754;287;467;0;9;278;287
8;Barcelona;13;Barcelonès;08245;Santa Coloma de Gramenet;5;3;U;;806;341;465;1;2;338;340
8;Barcelona;13;Barcelonès;08245;Santa Coloma de Gramenet;5;4;U;;747;319;428;0;2;317;319
8;Barcelona;13;Barcelonès;08245;Santa Coloma de Gramenet;5;5;A;;562;223;339;2;2;219;221
8;Barcelona;13;Barcelonès;08245;Santa Coloma de Gramenet;5;5;B;;576;195;381;1;0;194;194
8;Barcelona;13;Barcelonès;08245;Santa Coloma de Gramenet;5;6;U;;926;365;561;0;1;364;365
8;Barcelona;13;Barcelonès;08245;Santa Coloma de Gramenet;5;7;U;;982;415;567;1;5;409;414
8;Barcelona;13;Barcelonès;08245;Santa Coloma de Gramenet;5;8;U;;852;280;572;1;2;277;279
8;Barcelona;13;Barcelonès;08245;Santa Coloma de Gramenet;5;9;U;;965;354;611;2;7;345;352
8;Barcelona;13;Barcelonès;08245;Santa Coloma de Gramenet;6;1;U;;593;252;341;2;2;248;250
8;Barcelona;13;Barcelonès;08245;Santa Coloma de Gramenet;6;10;U;;828;321;507;1;2;318;320
8;Barcelona;13;Barcelonès;08245;Santa Coloma de Gramenet;6;11;U;;832;314;518;0;1;313;314
8;Barcelona;13;Barcelonès;08245;Santa Coloma de Gramenet;6;12;U;;768;361;407;5;2;354;356
8;Barcelona;13;Barcelonès;08245;Santa Coloma de Gramenet;6;13;U;;584;245;339;0;3;242;245
8;Barcelona;13;Barcelonès;08245;Santa Coloma de Gramenet;6;14;A;;491;195;296;0;2;193;195
8;Barcelona;13;Barcelonès;08245;Santa Coloma de Gramenet;6;14;B;;604;233;371;1;0;232;232
8;Barcelona;13;Barcelonès;08245;Santa Coloma de Gramenet;6;15;U;;614;258;356;1;3;254;257
8;Barcelona;13;Barcelonès;08245;Santa Coloma de Gramenet;6;16;U;;656;207;449;0;3;204;207
8;Barcelona;13;Barcelonès;08245;Santa Coloma de Gramenet;6;17;U;;805;276;529;0;2;274;276
8;Barcelona;13;Barcelonès;08245;Santa Coloma de Gramenet;6;2;U;;841;331;510;2;3;326;329
8;Barcelona;13;Barcelonès;08245;Santa Coloma de Gramenet;6;3;A;;476;207;269;0;0;207;207
8;Barcelona;13;Barcelonès;08245;Santa Coloma de Gramenet;6;3;B;;585;282;303;0;0;282;282
8;Barcelona;13;Barcelonès;08245;Santa Coloma de Gramenet;6;4;U;;1017;450;567;1;7;442;449
8;Barcelona;13;Barcelonès;08245;Santa Coloma de Gramenet;6;5;U;;902;438;464;0;3;435;438
8;Barcelona;13;Barcelonès;08245;Santa Coloma de Gramenet;6;6;U;;687;321;366;0;3;318;321
8;Barcelona;13;Barcelonès;08245;Santa Coloma de Gramenet;6;7;U;;531;215;316;0;2;213;215
8;Barcelona;13;Barcelonès;08245;Santa Coloma de Gramenet;6;8;U;;1099;446;653;2;5;439;444
8;Barcelona;13;Barcelonès;08245;Santa Coloma de Gramenet;6;9;U;;536;221;315;1;2;218;220
43;Tarragona;16;Conca de Barberà;43139;Santa Coloma de Queralt;1;1;A;;706;479;227;5;6;468;474
43;Tarragona;16;Conca de Barberà;43139;Santa Coloma de Queralt;1;1;B;;781;522;259;7;8;507;515
43;Tarragona;16;Conca de Barberà;43139;Santa Coloma de Queralt;2;1;U;;567;356;211;0;8;348;356
17;Girona;10;Baix Empordà;17181;Santa Cristina d'Aro;1;1;U;;1309;804;505;6;5;793;798
8;Barcelona;13;Barcelonès;08194;Sant Adrià de Besòs;1;1;A;;518;238;280;1;4;233;237
8;Barcelona;13;Barcelonès;08194;Sant Adrià de Besòs;1;1;B;;571;263;308;0;8;255;263
8;Barcelona;13;Barcelonès;08194;Sant Adrià de Besòs;1;2;A;;558;256;302;0;6;250;256
8;Barcelona;13;Barcelonès;08194;Sant Adrià de Besòs;1;2;B;;552;290;262;1;4;285;289
8;Barcelona;13;Barcelonès;08194;Sant Adrià de Besòs;1;3;A;;489;203;286;0;1;202;203
8;Barcelona;13;Barcelonès;08194;Sant Adrià de Besòs;1;3;B;;667;265;402;0;2;263;265
8;Barcelona;13;Barcelonès;08194;Sant Adrià de Besòs;1;4;A;;662;269;393;1;2;266;268
8;Barcelona;13;Barcelonès;08194;Sant Adrià de Besòs;1;4;B;;711;311;400;0;4;307;311
8;Barcelona;13;Barcelonès;08194;Sant Adrià de Besòs;1;5;A;;768;342;426;3;7;332;339
8;Barcelona;13;Barcelonès;08194;Sant Adrià de Besòs;1;5;B;;897;413;484;0;0;413;413
8;Barcelona;13;Barcelonès;08194;Sant Adrià de Besòs;1;6;A;;523;257;266;3;3;251;254
8;Barcelona;13;Barcelonès;08194;Sant Adrià de Besòs;1;6;B;;591;296;295;0;3;293;296
8;Barcelona;13;Barcelonès;08194;Sant Adrià de Besòs;2;1;A;;568;273;295;1;2;270;272
8;Barcelona;13;Barcelonès;08194;Sant Adrià de Besòs;2;1;B;;634;310;324;1;6;303;309
8;Barcelona;13;Barcelonès;08194;Sant Adrià de Besòs;2;2;A;;607;241;366;1;3;237;240
8;Barcelona;13;Barcelonès;08194;Sant Adrià de Besòs;2;2;B;;701;257;444;0;2;255;257
8;Barcelona;13;Barcelonès;08194;Sant Adrià de Besòs;2;3;U;;886;342;544;0;5;337;342
8;Barcelona;13;Barcelonès;08194;Sant Adrià de Besòs;2;4;A;;712;327;385;4;2;321;323
8;Barcelona;13;Barcelonès;08194;Sant Adrià de Besòs;2;4;B;;861;370;491;1;5;364;369
8;Barcelona;13;Barcelonès;08194;Sant Adrià de Besòs;3;1;U;;617;304;313;1;3;300;303
8;Barcelona;13;Barcelonès;08194;Sant Adrià de Besòs;4;1;U;;524;183;341;0;1;182;183
8;Barcelona;13;Barcelonès;08194;Sant Adrià de Besòs;5;1;A;;714;239;475;4;1;234;235
8;Barcelona;13;Barcelonès;08194;Sant Adrià de Besòs;5;1;B;;775;276;499;3;6;267;273
8;Barcelona;13;Barcelonès;08194;Sant Adrià de Besòs;5;2;A;;734;279;455;0;3;276;279
8;Barcelona;13;Barcelonès;08194;Sant Adrià de Besòs;5;2;B;;789;296;493;0;4;292;296
8;Barcelona;13;Barcelonès;08194;Sant Adrià de Besòs;5;3;U;;967;451;516;6;3;442;445
8;Barcelona;13;Barcelonès;08194;Sant Adrià de Besòs;5;4;A;;603;272;331;0;6;266;272
8;Barcelona;13;Barcelonès;08194;Sant Adrià de Besòs;5;4;B;;678;286;392;1;8;277;285
8;Barcelona;13;Barcelonès;08194;Sant Adrià de Besòs;6;1;U;;439;166;273;0;4;162;166
8;Barcelona;13;Barcelonès;08194;Sant Adrià de Besòs;6;2;A;;757;233;524;0;0;233;233
8;Barcelona;13;Barcelonès;08194;Sant Adrià de Besòs;6;2;B;;621;206;415;1;2;203;205
8;Barcelona;13;Barcelonès;08194;Sant Adrià de Besòs;6;3;U;;560;164;396;2;0;162;162
8;Barcelona;13;Barcelonès;08194;Sant Adrià de Besòs;6;4;A;;846;231;615;0;1;230;231
8;Barcelona;13;Barcelonès;08194;Sant Adrià de Besòs;6;4;B;;530;164;366;0;0;164;164
8;Barcelona;13;Barcelonès;08194;Sant Adrià de Besòs;6;5;A;;658;275;383;1;1;273;274
8;Barcelona;13;Barcelonès;08194;Sant Adrià de Besòs;6;5;B;;726;325;401;0;1;324;325
8;Barcelona;13;Barcelonès;08194;Sant Adrià de Besòs;6;6;A;;755;232;523;0;3;229;232
8;Barcelona;13;Barcelonès;08194;Sant Adrià de Besòs;6;6;B;;703;219;484;3;1;215;216
8;Barcelona;13;Barcelonès;08194;Sant Adrià de Besòs;6;7;U;;1084;339;745;3;4;332;336
8;Barcelona;24;Osona;08246;Santa Eugènia de Berga;1;1;U;;1159;815;344;1;6;808;814
8;Barcelona;24;Osona;08247;Santa Eulàlia de Riuprimer;1;1;U;;654;459;195;0;5;454;459
8;Barcelona;41;Vallès Oriental;08248;Santa Eulàlia de Ronçana;1;1;A;;695;396;299;2;2;392;394
8;Barcelona;41;Vallès Oriental;08248;Santa Eulàlia de Ronçana;1;1;B;;678;391;287;4;5;382;387
8;Barcelona;41;Vallès Oriental;08248;Santa Eulàlia de Ronçana;1;2;A;;529;351;178;0;3;348;351
8;Barcelona;41;Vallès Oriental;08248;Santa Eulàlia de Ronçana;1;2;B;;533;315;218;1;3;311;314
8;Barcelona;3;Alt Penedès;08249;Santa Fe del Penedès;1;1;U;;167;135;32;1;0;134;134
8;Barcelona;24;Osona;08195;Sant Agustí de Lluçanès;1;1;U;;94;70;24;0;1;69;70
17;Girona;2;Alt Empordà;17182;Santa Llogaia d'Àlguema;1;1;U;;247;161;86;0;0;161;161
8;Barcelona;6;Anoia;08250;Santa Margarida de Montbui;1;1;U;;602;377;225;0;3;374;377
8;Barcelona;6;Anoia;08250;Santa Margarida de Montbui;1;2;A;;763;317;446;1;5;311;316
8;Barcelona;6;Anoia;08250;Santa Margarida de Montbui;1;2;B;;791;382;409;0;10;372;382
8;Barcelona;6;Anoia;08250;Santa Margarida de Montbui;1;3;U;;835;385;450;1;5;379;384
8;Barcelona;6;Anoia;08250;Santa Margarida de Montbui;1;4;A;;552;257;295;0;4;253;257
8;Barcelona;6;Anoia;08250;Santa Margarida de Montbui;1;4;B;;627;288;339;0;3;285;288
8;Barcelona;6;Anoia;08250;Santa Margarida de Montbui;1;5;A;;878;409;469;1;1;407;408
8;Barcelona;6;Anoia;08250;Santa Margarida de Montbui;1;5;B;;916;428;488;5;0;423;423
8;Barcelona;6;Anoia;08250;Santa Margarida de Montbui;1;6;U;;894;371;523;0;3;368;371
8;Barcelona;3;Alt Penedès;08251;Santa Margarida i els Monjos;1;1;A;;667;454;213;3;7;444;451
8;Barcelona;3;Alt Penedès;08251;Santa Margarida i els Monjos;1;1;B;;627;410;217;0;6;404;410
8;Barcelona;3;Alt Penedès;08251;Santa Margarida i els Monjos;1;1;C;;806;538;268;1;4;533;537
8;Barcelona;3;Alt Penedès;08251;Santa Margarida i els Monjos;1;2;U;;809;510;299;4;4;502;506
8;Barcelona;;;08258;Santa Maria d'Oló;1;1;U;;804;577;227;0;2;575;577
8;Barcelona;24;Osona;08253;Santa Maria de Besora;1;1;U;;172;113;59;0;0;113;113
8;Barcelona;41;Vallès Oriental;08256;Santa Maria de Martorelles;1;1;U;;381;249;132;0;2;247;249
8;Barcelona;14;Berguedà;08255;Santa Maria de Merlès;1;1;U;;170;95;75;1;1;93;94
8;Barcelona;6;Anoia;08257;Santa Maria de Miralles;1;1;U;;98;65;33;0;1;64;65
8;Barcelona;41;Vallès Oriental;08259;Santa Maria de Palautordera;1;1;A;;775;551;224;2;6;543;549
8;Barcelona;41;Vallès Oriental;08259;Santa Maria de Palautordera;1;1;B;;779;580;199;1;6;573;579
8;Barcelona;41;Vallès Oriental;08259;Santa Maria de Palautordera;1;2;A;;621;439;182;2;6;431;437
8;Barcelona;41;Vallès Oriental;08259;Santa Maria de Palautordera;1;2;B;;687;458;229;2;2;454;456
8;Barcelona;41;Vallès Oriental;08259;Santa Maria de Palautordera;1;3;A;;333;226;107;0;2;224;226
8;Barcelona;41;Vallès Oriental;08259;Santa Maria de Palautordera;1;3;B;;586;368;218;2;6;360;366
8;Barcelona;11;Baix Llobregat;08196;Sant Andreu de la Barca;1;1;A;;920;437;483;3;3;431;434
8;Barcelona;11;Baix Llobregat;08196;Sant Andreu de la Barca;1;1;B;;998;490;508;0;10;480;490
8;Barcelona;11;Baix Llobregat;08196;Sant Andreu de la Barca;1;2;A;;652;264;388;1;1;262;263
8;Barcelona;11;Baix Llobregat;08196;Sant Andreu de la Barca;1;2;B;;826;329;497;0;2;327;329
8;Barcelona;11;Baix Llobregat;08196;Sant Andreu de la Barca;1;3;A;;839;380;459;1;4;375;379
8;Barcelona;11;Baix Llobregat;08196;Sant Andreu de la Barca;1;3;B;;1006;437;569;2;1;434;435
8;Barcelona;11;Baix Llobregat;08196;Sant Andreu de la Barca;1;4;A;;573;262;311;0;1;261;262
8;Barcelona;11;Baix Llobregat;08196;Sant Andreu de la Barca;1;4;B;;725;346;379;1;6;339;345
8;Barcelona;11;Baix Llobregat;08196;Sant Andreu de la Barca;1;5;A;;791;336;455;1;3;332;335
8;Barcelona;11;Baix Llobregat;08196;Sant Andreu de la Barca;1;5;B;;931;427;504;0;3;424;427
8;Barcelona;11;Baix Llobregat;08196;Sant Andreu de la Barca;1;6;A;;781;356;425;2;2;352;354
8;Barcelona;11;Baix Llobregat;08196;Sant Andreu de la Barca;1;6;B;;952;444;508;5;4;435;439
8;Barcelona;11;Baix Llobregat;08196;Sant Andreu de la Barca;1;7;A;;492;228;264;2;3;223;226
8;Barcelona;11;Baix Llobregat;08196;Sant Andreu de la Barca;1;7;B;;646;317;329;2;6;309;315
8;Barcelona;21;Maresme;08197;Sant Andreu de Llavaneres;1;1;A;;572;416;156;1;6;409;415
8;Barcelona;21;Maresme;08197;Sant Andreu de Llavaneres;1;1;B;;373;245;128;1;1;243;244
8;Barcelona;21;Maresme;08197;Sant Andreu de Llavaneres;1;1;C;;544;377;167;0;3;374;377
8;Barcelona;21;Maresme;08197;Sant Andreu de Llavaneres;1;1;D;;410;289;121;0;2;287;289
8;Barcelona;21;Maresme;08197;Sant Andreu de Llavaneres;1;2;U;;582;376;206;1;3;372;375
8;Barcelona;21;Maresme;08197;Sant Andreu de Llavaneres;2;1;A;;491;307;184;0;1;306;307
8;Barcelona;21;Maresme;08197;Sant Andreu de Llavaneres;2;1;B;;500;313;187;0;3;310;313
17;Girona;20;Gironès;17157;Sant Andreu Salou;1;1;U;;115;91;24;1;2;88;90
17;Girona;19;Garrotxa;17183;Sant Aniol de Finestres;1;1;U;;233;163;70;0;1;162;163
8;Barcelona;41;Vallès Oriental;08198;Sant Antoni de Vilamajor;1;1;A;;796;512;284;2;1;509;510
8;Barcelona;41;Vallès Oriental;08198;Sant Antoni de Vilamajor;1;1;B;;898;543;355;5;0;538;538
43;Tarragona;12;Baix Penedès;43140;Santa Oliva;1;1;A;;815;452;363;9;2;441;443
43;Tarragona;12;Baix Penedès;43140;Santa Oliva;1;1;B;;286;166;120;2;1;163;164
17;Girona;19;Garrotxa;17184;Santa Pau;1;1;A;;558;365;193;3;3;359;362
17;Girona;19;Garrotxa;17184;Santa Pau;1;1;B;;552;365;187;2;4;359;363
8;Barcelona;40;Vallès Occidental;08260;Santa Perpètua de Mogoda;1;1;U;;1742;867;875;6;7;854;861
8;Barcelona;40;Vallès Occidental;08260;Santa Perpètua de Mogoda;1;2;U;;1744;827;917;6;6;815;821
8;Barcelona;40;Vallès Occidental;08260;Santa Perpètua de Mogoda;1;3;U;;1171;622;549;2;6;614;620
8;Barcelona;40;Vallès Occidental;08260;Santa Perpètua de Mogoda;1;4;U;;1765;583;1182;6;3;574;577
8;Barcelona;40;Vallès Occidental;08260;Santa Perpètua de Mogoda;1;5;U;;653;256;397;0;3;253;256
8;Barcelona;40;Vallès Occidental;08260;Santa Perpètua de Mogoda;1;6;U;;888;406;482;0;1;405;406
8;Barcelona;40;Vallès Occidental;08260;Santa Perpètua de Mogoda;1;7;U;;876;374;502;0;4;370;374
8;Barcelona;40;Vallès Occidental;08260;Santa Perpètua de Mogoda;1;8;U;;1780;781;999;9;5;767;772
8;Barcelona;40;Vallès Occidental;08260;Santa Perpètua de Mogoda;1;9;U;;1468;584;884;2;4;578;582
8;Barcelona;21;Maresme;08261;Santa Susanna;1;1;U;;716;454;262;5;0;449;449
8;Barcelona;24;Osona;08199;Sant Bartomeu del Grau;1;1;U;;859;514;345;7;2;505;507
8;Barcelona;11;Baix Llobregat;08200;Sant Boi de Llobregat;1;1;A;;530;254;276;0;2;252;254
8;Barcelona;11;Baix Llobregat;08200;Sant Boi de Llobregat;1;1;B;;574;296;278;2;4;290;294
8;Barcelona;11;Baix Llobregat;08200;Sant Boi de Llobregat;1;2;A;;782;365;417;0;5;360;365
8;Barcelona;11;Baix Llobregat;08200;Sant Boi de Llobregat;1;2;B;;867;405;462;0;3;402;405
8;Barcelona;11;Baix Llobregat;08200;Sant Boi de Llobregat;1;3;A;;519;249;270;6;0;243;243
8;Barcelona;11;Baix Llobregat;08200;Sant Boi de Llobregat;1;3;B;;633;321;312;0;5;316;321
8;Barcelona;11;Baix Llobregat;08200;Sant Boi de Llobregat;1;4;A;;595;252;343;2;2;248;250
8;Barcelona;11;Baix Llobregat;08200;Sant Boi de Llobregat;1;4;B;;798;333;465;2;3;328;331
8;Barcelona;11;Baix Llobregat;08200;Sant Boi de Llobregat;1;5;A;;633;189;444;2;4;183;187
8;Barcelona;11;Baix Llobregat;08200;Sant Boi de Llobregat;1;5;B;;643;222;421;0;2;220;222
8;Barcelona;11;Baix Llobregat;08200;Sant Boi de Llobregat;1;6;A;;437;224;213;0;3;221;224
8;Barcelona;11;Baix Llobregat;08200;Sant Boi de Llobregat;1;6;B;;663;311;352;5;4;302;306
8;Barcelona;11;Baix Llobregat;08200;Sant Boi de Llobregat;1;7;A;;547;252;295;0;0;252;252
8;Barcelona;11;Baix Llobregat;08200;Sant Boi de Llobregat;1;7;B;;637;317;320;3;4;310;314
8;Barcelona;11;Baix Llobregat;08200;Sant Boi de Llobregat;2;1;A;;546;172;374;0;2;170;172
8;Barcelona;11;Baix Llobregat;08200;Sant Boi de Llobregat;2;1;B;;670;225;445;2;3;220;223
8;Barcelona;11;Baix Llobregat;08200;Sant Boi de Llobregat;2;1;C;;651;202;449;0;1;201;202
8;Barcelona;11;Baix Llobregat;08200;Sant Boi de Llobregat;2;10;A;;700;324;376;1;0;323;323
8;Barcelona;11;Baix Llobregat;08200;Sant Boi de Llobregat;2;10;B;;875;438;437;0;4;434;438
8;Barcelona;11;Baix Llobregat;08200;Sant Boi de Llobregat;2;11;A;;616;258;358;0;2;256;258
8;Barcelona;11;Baix Llobregat;08200;Sant Boi de Llobregat;2;11;B;;812;317;495;0;4;313;317
8;Barcelona;11;Baix Llobregat;08200;Sant Boi de Llobregat;2;11;C;;753;274;479;1;0;273;273
8;Barcelona;11;Baix Llobregat;08200;Sant Boi de Llobregat;2;12;A;;539;231;308;0;4;227;231
8;Barcelona;11;Baix Llobregat;08200;Sant Boi de Llobregat;2;12;B;;672;279;393;1;1;277;278
8;Barcelona;11;Baix Llobregat;08200;Sant Boi de Llobregat;2;12;C;;581;248;333;0;7;241;248
8;Barcelona;11;Baix Llobregat;08200;Sant Boi de Llobregat;2;13;A;;936;419;517;3;6;410;416
8;Barcelona;11;Baix Llobregat;08200;Sant Boi de Llobregat;2;13;B;;1100;520;580;4;2;514;516
8;Barcelona;11;Baix Llobregat;08200;Sant Boi de Llobregat;2;2;A;;627;276;351;0;1;275;276
8;Barcelona;11;Baix Llobregat;08200;Sant Boi de Llobregat;2;2;B;;739;280;459;1;2;277;279
8;Barcelona;11;Baix Llobregat;08200;Sant Boi de Llobregat;2;3;A;;719;273;446;1;0;272;272
8;Barcelona;11;Baix Llobregat;08200;Sant Boi de Llobregat;2;3;B;;936;351;585;0;1;350;351
8;Barcelona;11;Baix Llobregat;08200;Sant Boi de Llobregat;2;4;U;;1000;409;591;0;2;407;409
8;Barcelona;11;Baix Llobregat;08200;Sant Boi de Llobregat;2;5;A;;492;217;275;0;3;214;217
8;Barcelona;11;Baix Llobregat;08200;Sant Boi de Llobregat;2;5;B;;627;275;352;1;4;270;274
8;Barcelona;11;Baix Llobregat;08200;Sant Boi de Llobregat;2;6;A;;782;330;452;0;1;329;330
8;Barcelona;11;Baix Llobregat;08200;Sant Boi de Llobregat;2;6;B;;994;419;575;2;7;410;417
8;Barcelona;11;Baix Llobregat;08200;Sant Boi de Llobregat;2;7;U;;983;443;540;2;4;437;441
8;Barcelona;11;Baix Llobregat;08200;Sant Boi de Llobregat;2;8;A;;466;250;216;0;1;249;250
8;Barcelona;11;Baix Llobregat;08200;Sant Boi de Llobregat;2;8;B;;629;332;297;1;1;330;331
8;Barcelona;11;Baix Llobregat;08200;Sant Boi de Llobregat;2;9;A;;723;338;385;0;3;335;338
8;Barcelona;11;Baix Llobregat;08200;Sant Boi de Llobregat;2;9;B;;724;322;402;3;0;319;319
8;Barcelona;11;Baix Llobregat;08200;Sant Boi de Llobregat;3;1;A;;600;333;267;0;1;332;333
8;Barcelona;11;Baix Llobregat;08200;Sant Boi de Llobregat;3;1;B;;580;308;272;1;3;304;307
8;Barcelona;11;Baix Llobregat;08200;Sant Boi de Llobregat;3;2;A;;649;281;368;0;3;278;281
8;Barcelona;11;Baix Llobregat;08200;Sant Boi de Llobregat;3;2;B;;785;330;455;0;0;330;330
8;Barcelona;11;Baix Llobregat;08200;Sant Boi de Llobregat;3;3;A;;773;374;399;2;6;366;372
8;Barcelona;11;Baix Llobregat;08200;Sant Boi de Llobregat;3;3;B;;933;433;500;0;10;423;433
8;Barcelona;11;Baix Llobregat;08200;Sant Boi de Llobregat;3;4;U;;630;331;299;0;1;330;331
8;Barcelona;11;Baix Llobregat;08200;Sant Boi de Llobregat;3;5;A;;725;339;386;0;5;334;339
8;Barcelona;11;Baix Llobregat;08200;Sant Boi de Llobregat;3;5;B;;982;489;493;1;7;481;488
8;Barcelona;11;Baix Llobregat;08200;Sant Boi de Llobregat;3;6;U;;990;531;459;1;5;525;530
8;Barcelona;11;Baix Llobregat;08200;Sant Boi de Llobregat;3;7;A;;766;419;347;0;4;415;419
8;Barcelona;11;Baix Llobregat;08200;Sant Boi de Llobregat;3;7;B;;872;437;435;0;5;432;437
8;Barcelona;11;Baix Llobregat;08200;Sant Boi de Llobregat;3;8;U;;619;309;310;0;2;307;309
8;Barcelona;11;Baix Llobregat;08200;Sant Boi de Llobregat;3;9;A;;515;300;215;1;0;299;299
8;Barcelona;11;Baix Llobregat;08200;Sant Boi de Llobregat;3;9;B;;659;361;298;2;2;357;359
8;Barcelona;11;Baix Llobregat;08200;Sant Boi de Llobregat;4;1;A;;583;209;374;0;0;209;209
8;Barcelona;11;Baix Llobregat;08200;Sant Boi de Llobregat;4;1;B;;746;265;481;1;0;264;264
8;Barcelona;11;Baix Llobregat;08200;Sant Boi de Llobregat;4;2;A;;742;320;422;1;6;313;319
8;Barcelona;11;Baix Llobregat;08200;Sant Boi de Llobregat;4;2;B;;825;425;400;3;2;420;422
8;Barcelona;11;Baix Llobregat;08200;Sant Boi de Llobregat;4;3;A;;540;239;301;0;3;236;239
8;Barcelona;11;Baix Llobregat;08200;Sant Boi de Llobregat;4;3;B;;692;296;396;1;5;290;295
8;Barcelona;11;Baix Llobregat;08200;Sant Boi de Llobregat;4;3;C;;668;291;377;3;5;283;288
8;Barcelona;11;Baix Llobregat;08200;Sant Boi de Llobregat;4;4;A;;520;250;270;0;1;249;250
8;Barcelona;11;Baix Llobregat;08200;Sant Boi de Llobregat;4;4;B;;600;266;334;0;2;264;266
8;Barcelona;11;Baix Llobregat;08200;Sant Boi de Llobregat;4;5;A;;609;293;316;1;2;290;292
8;Barcelona;11;Baix Llobregat;08200;Sant Boi de Llobregat;4;5;B;;747;333;414;2;2;329;331
8;Barcelona;11;Baix Llobregat;08200;Sant Boi de Llobregat;4;6;A;;884;339;545;2;4;333;337
8;Barcelona;11;Baix Llobregat;08200;Sant Boi de Llobregat;4;6;B;;954;374;580;0;9;365;374
8;Barcelona;11;Baix Llobregat;08200;Sant Boi de Llobregat;4;7;A;;608;248;360;1;3;244;247
8;Barcelona;11;Baix Llobregat;08200;Sant Boi de Llobregat;4;7;B;;698;294;404;1;5;288;293
8;Barcelona;11;Baix Llobregat;08200;Sant Boi de Llobregat;4;8;A;;627;234;393;2;3;229;232
8;Barcelona;11;Baix Llobregat;08200;Sant Boi de Llobregat;4;8;B;;716;300;416;1;1;298;299
8;Barcelona;11;Baix Llobregat;08200;Sant Boi de Llobregat;5;1;A;;737;303;434;4;2;297;299
8;Barcelona;11;Baix Llobregat;08200;Sant Boi de Llobregat;5;1;B;;965;425;540;1;4;420;424
8;Barcelona;11;Baix Llobregat;08200;Sant Boi de Llobregat;5;2;A;;604;233;371;0;0;233;233
8;Barcelona;11;Baix Llobregat;08200;Sant Boi de Llobregat;5;2;B;;681;298;383;1;0;297;297
8;Barcelona;11;Baix Llobregat;08200;Sant Boi de Llobregat;5;3;U;;823;309;514;1;1;307;308
8;Barcelona;11;Baix Llobregat;08200;Sant Boi de Llobregat;5;4;A;;451;218;233;3;4;211;215
8;Barcelona;11;Baix Llobregat;08200;Sant Boi de Llobregat;5;4;B;;591;296;295;1;4;291;295
8;Barcelona;11;Baix Llobregat;08200;Sant Boi de Llobregat;6;1;U;;642;298;344;1;1;296;297
8;Barcelona;11;Baix Llobregat;08200;Sant Boi de Llobregat;6;2;A;;634;279;355;1;6;272;278
8;Barcelona;11;Baix Llobregat;08200;Sant Boi de Llobregat;6;2;B;;821;375;446;2;0;373;373
8;Barcelona;11;Baix Llobregat;08200;Sant Boi de Llobregat;6;3;A;;554;236;318;0;0;236;236
8;Barcelona;11;Baix Llobregat;08200;Sant Boi de Llobregat;6;3;B;;645;281;364;1;3;277;280
8;Barcelona;24;Osona;08201;Sant Boi de Lluçanès;1;1;U;;419;296;123;0;0;296;296
43;Tarragona;22;Montsià;43136;Sant Carles de la Ràpita;1;1;U;;1206;706;500;7;9;690;699
43;Tarragona;22;Montsià;43136;Sant Carles de la Ràpita;1;2;U;;774;423;351;13;1;409;410
43;Tarragona;22;Montsià;43136;Sant Carles de la Ràpita;1;3;U;;1081;610;471;3;7;600;607
43;Tarragona;22;Montsià;43136;Sant Carles de la Ràpita;1;4;U;;1148;655;493;3;5;647;652
43;Tarragona;22;Montsià;43136;Sant Carles de la Ràpita;1;5;U;;755;420;335;1;5;414;419
43;Tarragona;22;Montsià;43136;Sant Carles de la Ràpita;2;1;U;;792;457;335;0;6;451;457
43;Tarragona;22;Montsià;43136;Sant Carles de la Ràpita;2;2;U;;820;492;328;1;5;486;491
43;Tarragona;22;Montsià;43136;Sant Carles de la Ràpita;2;3;U;;962;580;382;1;6;573;579
43;Tarragona;22;Montsià;43136;Sant Carles de la Ràpita;2;4;U;;754;433;321;3;6;424;430
8;Barcelona;21;Maresme;08203;Sant Cebrià de Vallalta;1;1;U;;632;466;166;0;3;463;466
8;Barcelona;41;Vallès Oriental;08202;Sant Celoni;1;1;A;;884;628;256;2;4;622;626
8;Barcelona;41;Vallès Oriental;08202;Sant Celoni;1;1;B;;1060;742;318;0;7;735;742
8;Barcelona;41;Vallès Oriental;08202;Sant Celoni;1;2;A;;412;276;136;0;6;270;276
8;Barcelona;41;Vallès Oriental;08202;Sant Celoni;1;2;B;;531;351;180;0;4;347;351
8;Barcelona;41;Vallès Oriental;08202;Sant Celoni;1;3;A;;600;361;239;1;2;358;360
8;Barcelona;41;Vallès Oriental;08202;Sant Celoni;1;3;B;;855;485;370;1;6;478;484
8;Barcelona;41;Vallès Oriental;08202;Sant Celoni;1;4;A;;630;358;272;0;6;352;358
8;Barcelona;41;Vallès Oriental;08202;Sant Celoni;1;4;B;;781;416;365;1;3;412;415
8;Barcelona;41;Vallès Oriental;08202;Sant Celoni;1;5;A;;859;500;359;0;7;493;500
8;Barcelona;41;Vallès Oriental;08202;Sant Celoni;1;5;B;;1184;669;515;0;3;666;669
8;Barcelona;41;Vallès Oriental;08202;Sant Celoni;1;6;A;;571;378;193;2;3;373;376
8;Barcelona;41;Vallès Oriental;08202;Sant Celoni;1;6;B;;771;456;315;1;8;447;455
8;Barcelona;41;Vallès Oriental;08202;Sant Celoni;2;1;A;;376;243;133;0;0;243;243
8;Barcelona;41;Vallès Oriental;08202;Sant Celoni;2;1;B;;296;160;136;0;1;159;160
8;Barcelona;11;Baix Llobregat;08204;Sant Climent de Llobregat;1;1;A;;651;415;236;1;2;412;414
8;Barcelona;11;Baix Llobregat;08204;Sant Climent de Llobregat;1;1;B;;548;354;194;1;0;353;353
8;Barcelona;11;Baix Llobregat;08204;Sant Climent de Llobregat;1;1;C;;572;371;201;0;2;369;371
17;Girona;2;Alt Empordà;17158;Sant Climent Sescebes;1;1;U;;434;284;150;2;7;275;282
8;Barcelona;40;Vallès Occidental;08205;Sant Cugat del Vallès;1;1;A;;745;406;339;2;3;401;404
8;Barcelona;40;Vallès Occidental;08205;Sant Cugat del Vallès;1;1;B;;741;438;303;3;0;435;435
8;Barcelona;40;Vallès Occidental;08205;Sant Cugat del Vallès;1;2;A;;611;341;270;0;8;333;341
8;Barcelona;40;Vallès Occidental;08205;Sant Cugat del Vallès;1;2;B;;650;308;342;0;9;299;308
8;Barcelona;40;Vallès Occidental;08205;Sant Cugat del Vallès;1;2;C;;638;349;289;0;7;342;349
8;Barcelona;40;Vallès Occidental;08205;Sant Cugat del Vallès;1;3;A;;721;435;286;3;6;426;432
8;Barcelona;40;Vallès Occidental;08205;Sant Cugat del Vallès;1;3;B;;733;423;310;0;5;418;423
8;Barcelona;40;Vallès Occidental;08205;Sant Cugat del Vallès;1;4;A;;775;503;272;0;15;488;503
8;Barcelona;40;Vallès Occidental;08205;Sant Cugat del Vallès;1;4;B;;844;499;345;2;6;491;497
8;Barcelona;40;Vallès Occidental;08205;Sant Cugat del Vallès;1;5;U;;302;154;148;0;0;154;154
8;Barcelona;40;Vallès Occidental;08205;Sant Cugat del Vallès;1;6;A;;516;280;236;2;2;276;278
8;Barcelona;40;Vallès Occidental;08205;Sant Cugat del Vallès;1;6;B;;646;380;266;4;8;368;376
8;Barcelona;40;Vallès Occidental;08205;Sant Cugat del Vallès;1;6;C;;643;371;272;2;5;364;369
8;Barcelona;40;Vallès Occidental;08205;Sant Cugat del Vallès;1;7;A;;629;360;269;3;4;353;357
8;Barcelona;40;Vallès Occidental;08205;Sant Cugat del Vallès;1;7;B;;815;418;397;1;6;411;417
8;Barcelona;40;Vallès Occidental;08205;Sant Cugat del Vallès;1;8;A;;539;285;254;1;2;282;284
8;Barcelona;40;Vallès Occidental;08205;Sant Cugat del Vallès;1;8;B;;565;311;254;0;2;309;311
8;Barcelona;40;Vallès Occidental;08205;Sant Cugat del Vallès;1;8;C;;596;336;260;1;4;331;335
8;Barcelona;40;Vallès Occidental;08205;Sant Cugat del Vallès;1;9;A;;629;435;194;1;15;419;434
8;Barcelona;40;Vallès Occidental;08205;Sant Cugat del Vallès;1;9;B;;526;311;215;0;6;305;311
8;Barcelona;40;Vallès Occidental;08205;Sant Cugat del Vallès;1;9;C;;752;475;277;1;11;463;474
8;Barcelona;40;Vallès Occidental;08205;Sant Cugat del Vallès;2;1;A;;775;527;248;2;10;515;525
8;Barcelona;40;Vallès Occidental;08205;Sant Cugat del Vallès;2;1;B;;866;576;290;2;17;557;574
8;Barcelona;40;Vallès Occidental;08205;Sant Cugat del Vallès;2;2;A;;586;361;225;0;9;352;361
8;Barcelona;40;Vallès Occidental;08205;Sant Cugat del Vallès;2;2;B;;619;406;213;0;10;396;406
8;Barcelona;40;Vallès Occidental;08205;Sant Cugat del Vallès;2;3;A;;701;428;273;2;10;416;426
8;Barcelona;40;Vallès Occidental;08205;Sant Cugat del Vallès;2;3;B;;665;390;275;0;7;383;390
8;Barcelona;40;Vallès Occidental;08205;Sant Cugat del Vallès;2;3;C;;792;505;287;0;15;490;505
8;Barcelona;40;Vallès Occidental;08205;Sant Cugat del Vallès;2;4;A;;688;439;249;0;13;426;439
8;Barcelona;40;Vallès Occidental;08205;Sant Cugat del Vallès;2;4;B;;567;371;196;1;14;356;370
8;Barcelona;40;Vallès Occidental;08205;Sant Cugat del Vallès;2;4;C;;749;513;236;1;11;501;512
8;Barcelona;40;Vallès Occidental;08205;Sant Cugat del Vallès;2;5;A;;550;333;217;0;3;330;333
8;Barcelona;40;Vallès Occidental;08205;Sant Cugat del Vallès;2;5;B;;548;316;232;0;2;314;316
8;Barcelona;40;Vallès Occidental;08205;Sant Cugat del Vallès;2;6;U;;252;155;97;0;1;154;155
8;Barcelona;40;Vallès Occidental;08205;Sant Cugat del Vallès;3;1;A;;565;304;261;1;7;296;303
8;Barcelona;40;Vallès Occidental;08205;Sant Cugat del Vallès;3;1;B;;601;337;264;0;4;333;337
8;Barcelona;40;Vallès Occidental;08205;Sant Cugat del Vallès;3;2;A;;836;494;342;0;7;487;494
8;Barcelona;40;Vallès Occidental;08205;Sant Cugat del Vallès;3;2;B;;879;515;364;2;10;503;513
8;Barcelona;40;Vallès Occidental;08205;Sant Cugat del Vallès;4;1;U;;723;421;302;3;8;410;418
8;Barcelona;40;Vallès Occidental;08205;Sant Cugat del Vallès;4;2;A;;668;292;376;6;5;281;286
8;Barcelona;40;Vallès Occidental;08205;Sant Cugat del Vallès;4;2;B;;680;316;364;1;7;308;315
8;Barcelona;40;Vallès Occidental;08205;Sant Cugat del Vallès;5;1;A;;524;309;215;0;2;307;309
8;Barcelona;40;Vallès Occidental;08205;Sant Cugat del Vallès;5;1;B;;556;357;199;1;2;354;356
8;Barcelona;40;Vallès Occidental;08205;Sant Cugat del Vallès;5;2;A;;483;241;242;2;2;237;239
8;Barcelona;40;Vallès Occidental;08205;Sant Cugat del Vallès;5;2;B;;582;305;277;1;1;303;304
8;Barcelona;40;Vallès Occidental;08205;Sant Cugat del Vallès;6;1;U;;670;223;447;1;3;219;222
8;Barcelona;3;Alt Penedès;08206;Sant Cugat Sesgarrigues;1;1;U;;581;420;161;11;1;408;409
25;Lleida;25;Pallars Jussà;25196;Sant Esteve de la Sarga;1;1;U;;119;52;67;0;1;51;52
8;Barcelona;41;Vallès Oriental;08207;Sant Esteve de Palautordera;1;1;U;;872;602;270;1;7;594;601
8;Barcelona;11;Baix Llobregat;08208;Sant Esteve Sesrovires;1;1;A;;963;579;384;1;3;575;578
8;Barcelona;11;Baix Llobregat;08208;Sant Esteve Sesrovires;1;1;B;;1007;624;383;1;6;617;623
17;Girona;34;Selva;17159;Sant Feliu de Buixalleu;1;1;U;;473;345;128;1;4;340;344
8;Barcelona;41;Vallès Oriental;08210;Sant Feliu de Codines;1;1;U;;561;405;156;0;5;400;405
8;Barcelona;41;Vallès Oriental;08210;Sant Feliu de Codines;1;2;U;;839;550;289;0;11;539;550
8;Barcelona;41;Vallès Oriental;08210;Sant Feliu de Codines;2;1;U;;820;473;347;1;2;470;472
8;Barcelona;41;Vallès Oriental;08210;Sant Feliu de Codines;2;2;U;;698;454;244;4;2;448;450
17;Girona;10;Baix Empordà;17160;Sant Feliu de Guíxols;1;1;A;;558;334;224;3;3;328;331
17;Girona;10;Baix Empordà;17160;Sant Feliu de Guíxols;1;1;B;;632;390;242;1;3;386;389
17;Girona;10;Baix Empordà;17160;Sant Feliu de Guíxols;1;2;A;;464;318;146;4;1;313;314
17;Girona;10;Baix Empordà;17160;Sant Feliu de Guíxols;1;2;B;;582;401;181;1;3;397;400
17;Girona;10;Baix Empordà;17160;Sant Feliu de Guíxols;2;1;A;;532;324;208;3;3;318;321
17;Girona;10;Baix Empordà;17160;Sant Feliu de Guíxols;2;1;B;;601;354;247;1;3;350;353
17;Girona;10;Baix Empordà;17160;Sant Feliu de Guíxols;2;2;A;;725;461;264;1;3;457;460
17;Girona;10;Baix Empordà;17160;Sant Feliu de Guíxols;2;2;B;;984;616;368;2;9;605;614
17;Girona;10;Baix Empordà;17160;Sant Feliu de Guíxols;2;3;A;;616;344;272;1;1;342;343
17;Girona;10;Baix Empordà;17160;Sant Feliu de Guíxols;2;3;B;;797;453;344;3;6;444;450
17;Girona;10;Baix Empordà;17160;Sant Feliu de Guíxols;2;4;A;;655;382;273;3;1;378;379
17;Girona;10;Baix Empordà;17160;Sant Feliu de Guíxols;2;4;B;;932;561;371;2;12;547;559
17;Girona;10;Baix Empordà;17160;Sant Feliu de Guíxols;3;1;A;;803;518;285;3;3;512;515
17;Girona;10;Baix Empordà;17160;Sant Feliu de Guíxols;3;1;B;;910;549;361;1;5;543;548
17;Girona;10;Baix Empordà;17160;Sant Feliu de Guíxols;3;2;A;;846;533;313;1;1;531;532
17;Girona;10;Baix Empordà;17160;Sant Feliu de Guíxols;3;2;B;;1053;635;418;1;6;628;634
17;Girona;10;Baix Empordà;17160;Sant Feliu de Guíxols;4;1;A;;601;368;233;2;4;362;366
17;Girona;10;Baix Empordà;17160;Sant Feliu de Guíxols;4;1;B;;631;369;262;0;2;367;369
8;Barcelona;11;Baix Llobregat;08211;Sant Feliu de Llobregat;1;1;A;;696;467;229;1;8;458;466
8;Barcelona;11;Baix Llobregat;08211;Sant Feliu de Llobregat;1;1;B;;725;446;279;5;8;433;441
8;Barcelona;11;Baix Llobregat;08211;Sant Feliu de Llobregat;1;2;A;;496;330;166;0;5;325;330
8;Barcelona;11;Baix Llobregat;08211;Sant Feliu de Llobregat;1;2;B;;605;386;219;3;4;379;383
8;Barcelona;11;Baix Llobregat;08211;Sant Feliu de Llobregat;1;3;A;;471;291;180;0;2;289;291
8;Barcelona;11;Baix Llobregat;08211;Sant Feliu de Llobregat;1;3;B;;584;345;239;0;8;337;345
8;Barcelona;11;Baix Llobregat;08211;Sant Feliu de Llobregat;1;4;U;;725;326;399;6;2;318;320
8;Barcelona;11;Baix Llobregat;08211;Sant Feliu de Llobregat;2;1;A;;480;267;213;0;2;265;267
8;Barcelona;11;Baix Llobregat;08211;Sant Feliu de Llobregat;2;1;B;;546;330;216;0;3;327;330
8;Barcelona;11;Baix Llobregat;08211;Sant Feliu de Llobregat;2;2;U;;717;343;374;2;3;338;341
8;Barcelona;11;Baix Llobregat;08211;Sant Feliu de Llobregat;2;3;A;;572;280;292;0;5;275;280
8;Barcelona;11;Baix Llobregat;08211;Sant Feliu de Llobregat;2;3;B;;586;272;314;3;3;266;269
8;Barcelona;11;Baix Llobregat;08211;Sant Feliu de Llobregat;2;4;U;;721;357;364;1;3;353;356
8;Barcelona;11;Baix Llobregat;08211;Sant Feliu de Llobregat;2;5;U;;818;492;326;1;7;484;491
8;Barcelona;11;Baix Llobregat;08211;Sant Feliu de Llobregat;2;6;A;;677;333;344;0;6;327;333
8;Barcelona;11;Baix Llobregat;08211;Sant Feliu de Llobregat;2;6;B;;807;387;420;0;3;384;387
8;Barcelona;11;Baix Llobregat;08211;Sant Feliu de Llobregat;2;7;A;;606;313;293;0;3;310;313
8;Barcelona;11;Baix Llobregat;08211;Sant Feliu de Llobregat;2;7;B;;648;324;324;0;7;317;324
8;Barcelona;11;Baix Llobregat;08211;Sant Feliu de Llobregat;3;1;A;;539;280;259;1;3;276;279
8;Barcelona;11;Baix Llobregat;08211;Sant Feliu de Llobregat;3;1;B;;643;333;310;0;8;325;333
8;Barcelona;11;Baix Llobregat;08211;Sant Feliu de Llobregat;3;1;C;;589;322;267;1;6;315;321
8;Barcelona;11;Baix Llobregat;08211;Sant Feliu de Llobregat;3;2;A;;571;301;270;0;7;294;301
8;Barcelona;11;Baix Llobregat;08211;Sant Feliu de Llobregat;3;2;B;;620;295;325;1;3;291;294
8;Barcelona;11;Baix Llobregat;08211;Sant Feliu de Llobregat;3;2;C;;777;404;373;1;4;399;403
8;Barcelona;11;Baix Llobregat;08211;Sant Feliu de Llobregat;3;3;A;;578;314;264;0;2;312;314
8;Barcelona;11;Baix Llobregat;08211;Sant Feliu de Llobregat;3;3;B;;631;360;271;4;5;351;356
8;Barcelona;11;Baix Llobregat;08211;Sant Feliu de Llobregat;3;4;U;;488;292;196;5;3;284;287
8;Barcelona;11;Baix Llobregat;08211;Sant Feliu de Llobregat;3;5;A;;644;354;290;0;5;349;354
8;Barcelona;11;Baix Llobregat;08211;Sant Feliu de Llobregat;3;5;B;;763;423;340;2;8;413;421
8;Barcelona;11;Baix Llobregat;08211;Sant Feliu de Llobregat;4;1;U;;930;438;492;5;5;428;433
8;Barcelona;11;Baix Llobregat;08211;Sant Feliu de Llobregat;4;2;A;;451;208;243;2;3;203;206
8;Barcelona;11;Baix Llobregat;08211;Sant Feliu de Llobregat;4;2;B;;650;335;315;0;7;328;335
8;Barcelona;11;Baix Llobregat;08211;Sant Feliu de Llobregat;4;3;U;;946;402;544;2;2;398;400
8;Barcelona;11;Baix Llobregat;08211;Sant Feliu de Llobregat;4;4;A;;604;278;326;2;3;273;276
8;Barcelona;11;Baix Llobregat;08211;Sant Feliu de Llobregat;4;4;B;;683;288;395;2;6;280;286
8;Barcelona;11;Baix Llobregat;08211;Sant Feliu de Llobregat;4;5;U;;600;273;327;0;0;273;273
8;Barcelona;11;Baix Llobregat;08211;Sant Feliu de Llobregat;5;1;A;;512;182;330;2;3;177;180
8;Barcelona;11;Baix Llobregat;08211;Sant Feliu de Llobregat;5;1;B;;633;228;405;0;3;225;228
8;Barcelona;11;Baix Llobregat;08211;Sant Feliu de Llobregat;5;2;U;;787;243;544;3;2;238;240
8;Barcelona;11;Baix Llobregat;08211;Sant Feliu de Llobregat;6;1;A;;489;208;281;0;3;205;208
8;Barcelona;11;Baix Llobregat;08211;Sant Feliu de Llobregat;6;1;B;;715;285;430;0;4;281;285
8;Barcelona;11;Baix Llobregat;08211;Sant Feliu de Llobregat;6;1;C;;677;272;405;0;4;268;272
8;Barcelona;11;Baix Llobregat;08211;Sant Feliu de Llobregat;6;2;U;;835;410;425;0;5;405;410
8;Barcelona;11;Baix Llobregat;08211;Sant Feliu de Llobregat;6;3;U;;777;382;395;3;1;378;379
17;Girona;19;Garrotxa;17161;Sant Feliu de Pallerols;1;1;A;;421;321;100;0;3;318;321
17;Girona;19;Garrotxa;17161;Sant Feliu de Pallerols;1;1;B;;457;355;102;2;6;347;353
8;Barcelona;7;Bages;08212;Sant Feliu Sasserra;1;1;U;;514;385;129;2;2;381;383
17;Girona;19;Garrotxa;17162;Sant Ferriol;1;1;U;;155;90;65;0;0;90;90
8;Barcelona;41;Vallès Oriental;08209;Sant Fost de Campsentelles;1;1;A;;490;281;209;1;0;280;280
8;Barcelona;41;Vallès Oriental;08209;Sant Fost de Campsentelles;1;1;B;;618;341;277;5;1;335;336
8;Barcelona;41;Vallès Oriental;08209;Sant Fost de Campsentelles;1;2;A;;498;266;232;5;1;260;261
8;Barcelona;41;Vallès Oriental;08209;Sant Fost de Campsentelles;1;2;B;;673;362;311;0;7;355;362
8;Barcelona;41;Vallès Oriental;08209;Sant Fost de Campsentelles;1;3;A;;675;376;299;1;1;374;375
8;Barcelona;41;Vallès Oriental;08209;Sant Fost de Campsentelles;1;3;B;;728;367;361;0;5;362;367
8;Barcelona;7;Bages;08213;Sant Fruitós de Bages;1;1;A;;677;415;262;5;3;407;410
8;Barcelona;7;Bages;08213;Sant Fruitós de Bages;1;1;B;;604;363;241;3;2;358;360
8;Barcelona;7;Bages;08213;Sant Fruitós de Bages;1;1;C;;754;484;270;1;2;481;483
8;Barcelona;7;Bages;08213;Sant Fruitós de Bages;1;2;A;;547;328;219;0;2;326;328
8;Barcelona;7;Bages;08213;Sant Fruitós de Bages;1;2;B;;514;311;203;0;2;309;311
8;Barcelona;7;Bages;08213;Sant Fruitós de Bages;1;2;C;;579;349;230;0;6;343;349
17;Girona;20;Gironès;17163;Sant Gregori;1;1;A;;1192;838;354;5;7;826;833
17;Girona;20;Gironès;17163;Sant Gregori;1;1;B;;270;184;86;1;4;179;183
25;Lleida;32;Segarra;25192;Sant Guim de Freixenet;1;1;U;;848;645;203;10;5;630;635
25;Lleida;32;Segarra;25197;Sant Guim de la Plana;1;1;U;;172;120;52;0;1;119;120
17;Girona;34;Selva;17164;Sant Hilari Sacalm;1;1;A;;722;492;230;0;1;491;492
17;Girona;34;Selva;17164;Sant Hilari Sacalm;1;1;B;;1000;697;303;3;4;690;694
17;Girona;34;Selva;17164;Sant Hilari Sacalm;1;2;A;;851;547;304;2;4;541;545
17;Girona;34;Selva;17164;Sant Hilari Sacalm;1;2;B;;1028;683;345;2;5;676;681
8;Barcelona;24;Osona;08215;Sant Hipòlit de Voltregà;1;1;U;;734;491;243;4;7;480;487
8;Barcelona;24;Osona;08215;Sant Hipòlit de Voltregà;1;2;U;;886;657;229;2;5;650;655
8;Barcelona;24;Osona;08215;Sant Hipòlit de Voltregà;1;3;U;;806;525;281;0;4;521;525
8;Barcelona;21;Maresme;08193;Sant Iscle de Vallalta;1;1;U;;413;287;126;1;3;283;286
43;Tarragona;22;Montsià;43902;Sant Jaume d'Enveja;1;1;A;;755;406;349;0;6;400;406
43;Tarragona;22;Montsià;43902;Sant Jaume d'Enveja;1;1;B;;400;304;96;0;6;298;304
43;Tarragona;22;Montsià;43902;Sant Jaume d'Enveja;1;2;A;;781;484;297;4;5;475;480
43;Tarragona;22;Montsià;43902;Sant Jaume d'Enveja;1;2;B;;730;450;280;7;2;441;443
8;Barcelona;14;Berguedà;08216;Sant Jaume de Frontanyà;1;1;U;;17;11;6;0;0;11;11
17;Girona;19;Garrotxa;17165;Sant Jaume de Llierca;1;1;U;;646;439;207;2;5;432;437
43;Tarragona;12;Baix Penedès;43137;Sant Jaume dels Domenys;1;1;U;;979;600;379;8;3;589;592
17;Girona;31;Ripollès;17167;Sant Joan de les Abadesses;1;1;A;;339;236;103;3;1;232;233
17;Girona;31;Ripollès;17167;Sant Joan de les Abadesses;1;1;B;;419;313;106;3;1;309;310
17;Girona;31;Ripollès;17167;Sant Joan de les Abadesses;1;2;A;;500;352;148;1;6;345;351
17;Girona;31;Ripollès;17167;Sant Joan de les Abadesses;1;2;B;;636;449;187;6;2;441;443
17;Girona;31;Ripollès;17167;Sant Joan de les Abadesses;1;2;C;;408;285;123;1;1;283;284
17;Girona;31;Ripollès;17167;Sant Joan de les Abadesses;1;3;A;;433;303;130;1;3;299;302
17;Girona;31;Ripollès;17167;Sant Joan de les Abadesses;1;3;B;;488;349;139;0;3;346;349
17;Girona;20;Gironès;17168;Sant Joan de Mollet;1;1;U;;251;186;65;2;2;182;184
8;Barcelona;11;Baix Llobregat;08217;Sant Joan Despí;1;1;U;;646;346;300;0;6;340;346
8;Barcelona;11;Baix Llobregat;08217;Sant Joan Despí;1;2;A;;671;373;298;0;3;370;373
8;Barcelona;11;Baix Llobregat;08217;Sant Joan Despí;1;2;B;;717;340;377;3;1;336;337
8;Barcelona;11;Baix Llobregat;08217;Sant Joan Despí;1;2;C;;772;378;394;0;3;375;378
8;Barcelona;11;Baix Llobregat;08217;Sant Joan Despí;1;3;A;;736;379;357;1;1;377;378
8;Barcelona;11;Baix Llobregat;08217;Sant Joan Despí;1;3;B;;760;382;378;1;1;380;381
8;Barcelona;11;Baix Llobregat;08217;Sant Joan Despí;1;3;C;;820;455;365;2;1;452;453
8;Barcelona;11;Baix Llobregat;08217;Sant Joan Despí;1;4;A;;709;397;312;0;5;392;397
8;Barcelona;11;Baix Llobregat;08217;Sant Joan Despí;1;4;B;;654;355;299;0;1;354;355
8;Barcelona;11;Baix Llobregat;08217;Sant Joan Despí;1;4;C;;718;401;317;0;4;397;401
8;Barcelona;11;Baix Llobregat;08217;Sant Joan Despí;1;5;A;;393;229;164;0;0;229;229
8;Barcelona;11;Baix Llobregat;08217;Sant Joan Despí;1;5;B;;454;257;197;2;5;250;255
8;Barcelona;11;Baix Llobregat;08217;Sant Joan Despí;1;5;C;;507;299;208;5;3;291;294
8;Barcelona;11;Baix Llobregat;08217;Sant Joan Despí;2;1;U;;460;280;180;0;3;277;280
8;Barcelona;11;Baix Llobregat;08217;Sant Joan Despí;2;2;A;;555;312;243;0;1;311;312
8;Barcelona;11;Baix Llobregat;08217;Sant Joan Despí;2;2;B;;624;320;304;2;3;315;318
8;Barcelona;11;Baix Llobregat;08217;Sant Joan Despí;2;3;U;;747;395;352;1;4;390;394
8;Barcelona;11;Baix Llobregat;08217;Sant Joan Despí;2;4;A;;572;278;294;0;4;274;278
8;Barcelona;11;Baix Llobregat;08217;Sant Joan Despí;2;4;B;;720;346;374;0;2;344;346
8;Barcelona;11;Baix Llobregat;08217;Sant Joan Despí;3;1;A;;427;238;189;2;1;235;236
8;Barcelona;11;Baix Llobregat;08217;Sant Joan Despí;3;1;B;;540;267;273;1;2;264;266
8;Barcelona;11;Baix Llobregat;08217;Sant Joan Despí;3;1;C;;435;221;214;1;1;219;220
8;Barcelona;11;Baix Llobregat;08217;Sant Joan Despí;3;2;A;;697;358;339;0;8;350;358
8;Barcelona;11;Baix Llobregat;08217;Sant Joan Despí;3;2;B;;735;389;346;3;6;380;386
8;Barcelona;11;Baix Llobregat;08217;Sant Joan Despí;3;3;A;;598;373;225;1;2;370;372
8;Barcelona;11;Baix Llobregat;08217;Sant Joan Despí;3;3;B;;780;437;343;0;2;435;437
8;Barcelona;11;Baix Llobregat;08217;Sant Joan Despí;3;3;C;;751;413;338;1;9;403;412
8;Barcelona;11;Baix Llobregat;08217;Sant Joan Despí;3;4;A;;785;428;357;3;1;424;425
8;Barcelona;11;Baix Llobregat;08217;Sant Joan Despí;3;4;B;;924;492;432;0;8;484;492
8;Barcelona;11;Baix Llobregat;08217;Sant Joan Despí;4;1;U;;613;320;293;0;7;313;320
8;Barcelona;7;Bages;08218;Sant Joan de Vilatorrada;1;1;A;;574;361;213;4;4;353;357
8;Barcelona;7;Bages;08218;Sant Joan de Vilatorrada;1;1;B;;586;363;223;4;7;352;359
8;Barcelona;7;Bages;08218;Sant Joan de Vilatorrada;1;1;C;;726;457;269;1;7;449;456
8;Barcelona;7;Bages;08218;Sant Joan de Vilatorrada;1;2;U;;781;446;335;2;5;439;444
8;Barcelona;7;Bages;08218;Sant Joan de Vilatorrada;1;3;A;;500;334;166;1;0;333;333
8;Barcelona;7;Bages;08218;Sant Joan de Vilatorrada;1;3;B;;555;365;190;5;2;358;360
8;Barcelona;7;Bages;08218;Sant Joan de Vilatorrada;1;4;U;;193;129;64;0;2;127;129
8;Barcelona;7;Bages;08218;Sant Joan de Vilatorrada;1;5;U;;807;522;285;2;2;518;520
8;Barcelona;7;Bages;08218;Sant Joan de Vilatorrada;1;6;A;;620;314;306;0;3;311;314
8;Barcelona;7;Bages;08218;Sant Joan de Vilatorrada;1;6;B;;814;434;380;0;2;432;434
17;Girona;19;Garrotxa;17185;Sant Joan les Fonts;1;1;A;;511;374;137;10;6;358;364
17;Girona;19;Garrotxa;17185;Sant Joan les Fonts;1;1;B;;523;380;143;7;10;363;373
17;Girona;19;Garrotxa;17185;Sant Joan les Fonts;1;2;U;;604;433;171;1;6;426;432
17;Girona;19;Garrotxa;17185;Sant Joan les Fonts;1;3;A;;488;343;145;3;4;336;340
17;Girona;19;Garrotxa;17185;Sant Joan les Fonts;1;3;B;;204;133;71;1;3;129;132
17;Girona;20;Gironès;17166;Sant Jordi Desvalls;1;1;U;;480;345;135;2;3;340;343
17;Girona;34;Selva;17903;Sant Julià del Llor i Bonmatí;1;1;U;;743;510;233;5;7;498;505
17;Girona;20;Gironès;17169;Sant Julià de Ramis;1;1;A;;864;567;297;5;3;559;562
17;Girona;20;Gironès;17169;Sant Julià de Ramis;1;1;B;;515;353;162;2;10;341;351
8;Barcelona;24;Osona;08220;Sant Julià de Vilatorta;1;1;A;;673;511;162;1;5;505;510
8;Barcelona;24;Osona;08220;Sant Julià de Vilatorta;1;1;B;;736;579;157;0;6;573;579
8;Barcelona;11;Baix Llobregat;08221;Sant Just Desvern;1;1;A;;825;499;326;0;4;495;499
8;Barcelona;11;Baix Llobregat;08221;Sant Just Desvern;1;1;B;;879;464;415;0;10;454;464
8;Barcelona;11;Baix Llobregat;08221;Sant Just Desvern;1;2;A;;489;292;197;1;2;289;291
8;Barcelona;11;Baix Llobregat;08221;Sant Just Desvern;1;2;B;;531;301;230;3;3;295;298
8;Barcelona;11;Baix Llobregat;08221;Sant Just Desvern;1;3;A;;761;489;272;4;7;478;485
8;Barcelona;11;Baix Llobregat;08221;Sant Just Desvern;1;3;B;;792;503;289;2;6;495;501
8;Barcelona;11;Baix Llobregat;08221;Sant Just Desvern;1;4;A;;774;408;366;3;5;400;405
8;Barcelona;11;Baix Llobregat;08221;Sant Just Desvern;1;4;B;;917;442;475;0;4;438;442
8;Barcelona;11;Baix Llobregat;08221;Sant Just Desvern;1;5;A;;870;511;359;0;4;507;511
8;Barcelona;11;Baix Llobregat;08221;Sant Just Desvern;1;5;B;;1046;586;460;0;7;579;586
8;Barcelona;11;Baix Llobregat;08221;Sant Just Desvern;1;6;A;;832;491;341;0;7;484;491
8;Barcelona;11;Baix Llobregat;08221;Sant Just Desvern;1;6;B;;968;541;427;0;8;533;541
8;Barcelona;11;Baix Llobregat;08221;Sant Just Desvern;1;7;U;;367;176;191;2;1;173;174
8;Barcelona;3;Alt Penedès;08222;Sant Llorenç d'Hortons;1;1;U;;851;549;302;0;4;545;549
17;Girona;2;Alt Empordà;17171;Sant Llorenç de la Muga;1;1;U;;150;98;52;0;1;97;98
25;Lleida;35;Solsonès;25193;Sant Llorenç de Morunys;1;1;U;;708;506;202;5;5;496;501
8;Barcelona;40;Vallès Occidental;08223;Sant Llorenç Savall;1;1;A;;660;414;246;0;1;413;414
8;Barcelona;40;Vallès Occidental;08223;Sant Llorenç Savall;1;1;B;;863;531;332;3;4;524;528
8;Barcelona;24;Osona;08225;Sant Martí d'Albars;1;1;U;;107;79;28;0;0;79;79
8;Barcelona;24;Osona;08224;Sant Martí de Centelles;1;1;U;;535;375;160;1;5;369;374
17;Girona;20;Gironès;17172;Sant Martí de Llémena;1;1;U;;306;182;124;0;1;181;182
25;Lleida;38;Urgell;25902;Sant Martí de Riucorb;1;1;U;;675;383;292;3;6;374;380
8;Barcelona;6;Anoia;08226;Sant Martí de Tous;1;1;U;;790;593;197;0;6;587;593
8;Barcelona;3;Alt Penedès;08227;Sant Martí Sarroca;1;1;A;;603;378;225;2;3;373;376
8;Barcelona;3;Alt Penedès;08227;Sant Martí Sarroca;1;1;B;;773;504;269;4;7;493;500
8;Barcelona;3;Alt Penedès;08227;Sant Martí Sarroca;1;2;U;;551;380;171;1;0;379;379
8;Barcelona;6;Anoia;08228;Sant Martí Sesgueioles;1;1;U;;299;215;84;3;4;208;212
17;Girona;20;Gironès;17173;Sant Martí Vell;1;1;U;;166;129;37;0;0;129;129
8;Barcelona;7;Bages;08229;Sant Mateu de Bages;1;1;A;;203;125;78;0;2;123;125
8;Barcelona;7;Bages;08229;Sant Mateu de Bages;1;1;B;;271;234;37;0;2;232;234
17;Girona;28;Pla de l'Estany;17174;Sant Miquel de Campmajor;1;1;U;;187;134;53;1;3;130;133
17;Girona;2;Alt Empordà;17175;Sant Miquel de Fluvià;1;1;U;;423;294;129;2;0;292;292
17;Girona;2;Alt Empordà;17176;Sant Mori;1;1;U;;106;83;23;0;1;82;83
17;Girona;31;Ripollès;17177;Sant Pau de Segúries;1;1;U;;517;412;105;3;5;404;409
8;Barcelona;7;Bages;08192;Santpedor;1;1;A;;987;679;308;5;4;670;674
8;Barcelona;7;Bages;08192;Santpedor;1;1;B;;1079;702;377;1;3;698;701
8;Barcelona;7;Bages;08192;Santpedor;1;2;U;;1334;877;457;4;8;865;873
8;Barcelona;17;Garraf;08231;Sant Pere de Ribes;1;1;A;;835;399;436;5;5;389;394
8;Barcelona;17;Garraf;08231;Sant Pere de Ribes;1;1;B;;1052;519;533;0;9;510;519
8;Barcelona;17;Garraf;08231;Sant Pere de Ribes;1;2;A;;745;361;384;0;3;358;361
8;Barcelona;17;Garraf;08231;Sant Pere de Ribes;1;2;B;;911;442;469;3;2;437;439
8;Barcelona;17;Garraf;08231;Sant Pere de Ribes;1;3;A;;650;363;287;4;8;351;359
8;Barcelona;17;Garraf;08231;Sant Pere de Ribes;1;3;B;;746;370;376;2;12;356;368
8;Barcelona;17;Garraf;08231;Sant Pere de Ribes;1;4;A;;807;328;479;3;2;323;325
8;Barcelona;17;Garraf;08231;Sant Pere de Ribes;1;4;B;;951;397;554;1;0;396;396
8;Barcelona;17;Garraf;08231;Sant Pere de Ribes;1;5;A;;515;257;258;0;1;256;257
8;Barcelona;17;Garraf;08231;Sant Pere de Ribes;1;5;B;;752;350;402;1;3;346;349
8;Barcelona;17;Garraf;08231;Sant Pere de Ribes;1;6;A;;545;251;294;0;1;250;251
8;Barcelona;17;Garraf;08231;Sant Pere de Ribes;1;6;B;;708;329;379;2;0;327;327
8;Barcelona;17;Garraf;08231;Sant Pere de Ribes;1;7;A;;635;262;373;1;1;260;261
8;Barcelona;17;Garraf;08231;Sant Pere de Ribes;1;7;B;;823;342;481;2;4;336;340
8;Barcelona;3;Alt Penedès;08232;Sant Pere de Riudebitlles;1;1;A;;860;602;258;6;1;595;596
8;Barcelona;3;Alt Penedès;08232;Sant Pere de Riudebitlles;1;1;B;;903;628;275;5;9;614;623
8;Barcelona;24;Osona;08233;Sant Pere de Torelló;1;1;U;;667;492;175;0;0;492;492
8;Barcelona;24;Osona;08233;Sant Pere de Torelló;1;2;U;;936;608;328;1;0;607;607
8;Barcelona;41;Vallès Oriental;08234;Sant Pere de Vilamajor;1;1;U;;939;553;386;0;7;546;553
17;Girona;2;Alt Empordà;17178;Sant Pere Pescador;1;1;U;;958;651;307;2;10;639;649
8;Barcelona;6;Anoia;08189;Sant Pere Sallavinera;1;1;U;;152;117;35;0;0;117;117
8;Barcelona;21;Maresme;08235;Sant Pol de Mar;1;1;U;;945;663;282;7;6;650;656
8;Barcelona;21;Maresme;08235;Sant Pol de Mar;1;2;U;;1024;739;285;0;6;733;739
8;Barcelona;3;Alt Penedès;08236;Sant Quintí de Mediona;1;1;A;;590;374;216;5;3;366;369
8;Barcelona;3;Alt Penedès;08236;Sant Quintí de Mediona;1;1;B;;666;444;222;1;5;438;443
8;Barcelona;24;Osona;08237;Sant Quirze de Besora;1;1;U;;1005;739;266;2;6;731;737
8;Barcelona;24;Osona;08237;Sant Quirze de Besora;1;2;U;;675;509;166;2;1;506;507
8;Barcelona;40;Vallès Occidental;08238;Sant Quirze del Vallès;1;1;A;;592;364;228;0;3;361;364
8;Barcelona;40;Vallès Occidental;08238;Sant Quirze del Vallès;1;1;B;;632;338;294;0;1;337;338
8;Barcelona;40;Vallès Occidental;08238;Sant Quirze del Vallès;1;1;C;;645;345;300;1;1;343;344
8;Barcelona;40;Vallès Occidental;08238;Sant Quirze del Vallès;1;2;U;;914;552;362;0;13;539;552
8;Barcelona;40;Vallès Occidental;08238;Sant Quirze del Vallès;1;3;U;;865;459;406;0;9;450;459
8;Barcelona;40;Vallès Occidental;08238;Sant Quirze del Vallès;1;4;A;;836;505;331;2;10;493;503
8;Barcelona;40;Vallès Occidental;08238;Sant Quirze del Vallès;1;4;B;;1031;595;436;5;11;579;590
8;Barcelona;40;Vallès Occidental;08238;Sant Quirze del Vallès;1;5;U;;874;442;432;0;3;439;442
8;Barcelona;;;08239;Sant Quirze Safaja;1;1;U;;196;128;68;0;1;127;128
25;Lleida;32;Segarra;25194;Sant Ramon;1;1;U;;471;328;143;2;2;324;326
8;Barcelona;3;Alt Penedès;08240;Sant Sadurní d'Anoia;1;1;A;;611;413;198;3;4;406;410
8;Barcelona;3;Alt Penedès;08240;Sant Sadurní d'Anoia;1;1;B;;504;329;175;2;2;325;327
8;Barcelona;3;Alt Penedès;08240;Sant Sadurní d'Anoia;1;1;C;;733;519;214;7;1;511;512
8;Barcelona;3;Alt Penedès;08240;Sant Sadurní d'Anoia;1;2;A;;622;420;202;1;7;412;419
8;Barcelona;3;Alt Penedès;08240;Sant Sadurní d'Anoia;1;2;B;;729;515;214;0;7;508;515
8;Barcelona;3;Alt Penedès;08240;Sant Sadurní d'Anoia;1;3;U;;908;587;321;2;3;582;585
8;Barcelona;3;Alt Penedès;08240;Sant Sadurní d'Anoia;1;4;A;;480;346;134;0;7;339;346
8;Barcelona;3;Alt Penedès;08240;Sant Sadurní d'Anoia;1;4;B;;467;360;107;3;4;353;357
8;Barcelona;3;Alt Penedès;08240;Sant Sadurní d'Anoia;2;1;A;;490;337;153;0;2;335;337
8;Barcelona;3;Alt Penedès;08240;Sant Sadurní d'Anoia;2;1;B;;556;394;162;1;3;390;393
8;Barcelona;3;Alt Penedès;08240;Sant Sadurní d'Anoia;2;2;A;;521;341;180;1;3;337;340
8;Barcelona;3;Alt Penedès;08240;Sant Sadurní d'Anoia;2;2;B;;559;364;195;2;6;356;362
8;Barcelona;24;Osona;08241;Sant Sadurní d'Osormort;1;1;U;;69;48;21;0;0;48;48
8;Barcelona;7;Bages;08098;Sant Salvador de Guardiola;1;1;U;;904;552;352;2;4;546;550
8;Barcelona;7;Bages;08262;Sant Vicenç de Castellet;1;1;A;;556;308;248;2;5;301;306
8;Barcelona;7;Bages;08262;Sant Vicenç de Castellet;1;1;B;;620;361;259;1;3;357;360
8;Barcelona;7;Bages;08262;Sant Vicenç de Castellet;1;1;C;;666;363;303;2;7;354;361
8;Barcelona;7;Bages;08262;Sant Vicenç de Castellet;1;2;A;;548;365;183;1;2;362;364
8;Barcelona;7;Bages;08262;Sant Vicenç de Castellet;1;2;B;;682;432;250;5;4;423;427
8;Barcelona;7;Bages;08262;Sant Vicenç de Castellet;2;1;A;;775;439;336;2;5;432;437
8;Barcelona;7;Bages;08262;Sant Vicenç de Castellet;2;1;B;;970;546;424;3;6;537;543
8;Barcelona;7;Bages;08262;Sant Vicenç de Castellet;2;2;A;;580;366;214;2;1;363;364
8;Barcelona;7;Bages;08262;Sant Vicenç de Castellet;2;2;B;;591;343;248;3;2;338;340
8;Barcelona;11;Baix Llobregat;08263;Sant Vicenç dels Horts;1;1;A;;825;395;430;1;4;390;394
8;Barcelona;11;Baix Llobregat;08263;Sant Vicenç dels Horts;1;1;B;;1041;500;541;1;4;495;499
8;Barcelona;11;Baix Llobregat;08263;Sant Vicenç dels Horts;1;2;A;;528;339;189;0;1;338;339
8;Barcelona;11;Baix Llobregat;08263;Sant Vicenç dels Horts;1;2;B;;684;387;297;0;0;387;387
8;Barcelona;11;Baix Llobregat;08263;Sant Vicenç dels Horts;1;3;A;;820;474;346;0;2;472;474
8;Barcelona;11;Baix Llobregat;08263;Sant Vicenç dels Horts;1;3;B;;952;515;437;0;3;512;515
8;Barcelona;11;Baix Llobregat;08263;Sant Vicenç dels Horts;1;4;A;;497;254;243;0;1;253;254
8;Barcelona;11;Baix Llobregat;08263;Sant Vicenç dels Horts;1;4;B;;529;288;241;0;2;286;288
8;Barcelona;11;Baix Llobregat;08263;Sant Vicenç dels Horts;1;5;A;;662;352;310;1;0;351;351
8;Barcelona;11;Baix Llobregat;08263;Sant Vicenç dels Horts;1;5;B;;802;446;356;2;1;443;444
8;Barcelona;11;Baix Llobregat;08263;Sant Vicenç dels Horts;1;6;A;;737;330;407;2;3;325;328
8;Barcelona;11;Baix Llobregat;08263;Sant Vicenç dels Horts;1;6;B;;823;343;480;1;4;338;342
8;Barcelona;11;Baix Llobregat;08263;Sant Vicenç dels Horts;1;7;U;;909;473;436;0;1;472;473
8;Barcelona;11;Baix Llobregat;08263;Sant Vicenç dels Horts;2;1;U;;863;319;544;0;3;316;319
8;Barcelona;11;Baix Llobregat;08263;Sant Vicenç dels Horts;2;2;U;;1011;481;530;0;5;476;481
8;Barcelona;11;Baix Llobregat;08263;Sant Vicenç dels Horts;2;3;U;;741;292;449;0;2;290;292
8;Barcelona;11;Baix Llobregat;08263;Sant Vicenç dels Horts;3;1;A;;543;227;316;0;8;219;227
8;Barcelona;11;Baix Llobregat;08263;Sant Vicenç dels Horts;3;1;B;;657;315;342;1;4;310;314
8;Barcelona;11;Baix Llobregat;08263;Sant Vicenç dels Horts;3;2;U;;899;302;597;2;0;300;300
8;Barcelona;11;Baix Llobregat;08263;Sant Vicenç dels Horts;4;1;A;;591;257;334;1;1;255;256
8;Barcelona;11;Baix Llobregat;08263;Sant Vicenç dels Horts;4;1;B;;617;257;360;0;3;254;257
8;Barcelona;21;Maresme;08264;Sant Vicenç de Montalt;1;1;A;;695;488;207;0;4;484;488
8;Barcelona;21;Maresme;08264;Sant Vicenç de Montalt;1;1;B;;649;418;231;0;4;414;418
8;Barcelona;24;Osona;08265;Sant Vicenç de Torelló;1;1;U;;1004;663;341;3;3;657;660
8;Barcelona;24;Osona;08265;Sant Vicenç de Torelló;1;2;U;;425;306;119;0;0;306;306
43;Tarragona;16;Conca de Barberà;43142;Sarral;1;1;U;;1128;755;373;13;11;731;742
17;Girona;20;Gironès;17186;Sarrià de Ter;1;1;A;;715;484;231;3;3;478;481
17;Girona;20;Gironès;17186;Sarrià de Ter;1;1;B;;905;623;282;4;5;614;619
17;Girona;20;Gironès;17186;Sarrià de Ter;1;2;A;;441;291;150;0;3;288;291
17;Girona;20;Gironès;17186;Sarrià de Ter;1;2;B;;593;387;206;5;3;379;382
25;Lleida;25;Pallars Jussà;25201;Sarroca de Bellera;1;1;U;;126;82;44;1;2;79;81
25;Lleida;33;Segrià;25200;Sarroca de Lleida;1;1;U;;416;283;133;0;0;283;283
17;Girona;2;Alt Empordà;17187;Saus, Camallera i Llampaies;1;1;U;;566;357;209;4;3;350;353
43;Tarragona;16;Conca de Barberà;43143;Savallà del Comtat;1;1;U;;50;39;11;0;0;39;39
43;Tarragona;36;Tarragonès;43144;Secuita, la;1;1;U;;762;471;291;0;5;466;471
43;Tarragona;8;Baix Camp;43145;Selva del Camp, la;1;1;U;;898;631;267;1;7;623;630
43;Tarragona;8;Baix Camp;43145;Selva del Camp, la;2;1;A;;885;643;242;9;7;627;634
43;Tarragona;8;Baix Camp;43145;Selva del Camp, la;2;1;B;;960;741;219;5;9;727;736
17;Girona;2;Alt Empordà;17188;Selva de Mar, la;1;1;U;;142;103;39;2;0;101;101
43;Tarragona;16;Conca de Barberà;43146;Senan;1;1;U;;24;20;4;0;0;20;20
43;Tarragona;22;Montsià;43044;Sénia, la;1;1;A;;761;440;321;7;4;429;433
43;Tarragona;22;Montsià;43044;Sénia, la;1;1;B;;834;470;364;4;3;463;466
43;Tarragona;22;Montsià;43044;Sénia, la;2;1;A;;704;435;269;2;6;427;433
43;Tarragona;22;Montsià;43044;Sénia, la;2;1;B;;759;451;308;3;5;443;448
43;Tarragona;22;Montsià;43044;Sénia, la;2;2;U;;722;398;324;0;9;389;398
25;Lleida;25;Pallars Jussà;25202;Senterada;1;1;U;;101;73;28;0;1;72;73
25;Lleida;23;Noguera;25035;Sentiu de Sió, la;1;1;U;;389;269;120;2;7;260;267
8;Barcelona;40;Vallès Occidental;08267;Sentmenat;1;1;A;;840;477;363;7;8;462;470
8;Barcelona;40;Vallès Occidental;08267;Sentmenat;1;1;B;;990;559;431;4;3;552;555
8;Barcelona;40;Vallès Occidental;08267;Sentmenat;1;2;A;;557;330;227;7;4;319;323
8;Barcelona;40;Vallès Occidental;08267;Sentmenat;1;2;B;;709;445;264;7;7;431;438
8;Barcelona;40;Vallès Occidental;08267;Sentmenat;1;2;C;;317;164;153;0;2;162;164
17;Girona;28;Pla de l'Estany;17190;Serinyà;1;1;U;;580;392;188;5;3;384;387
25;Lleida;33;Segrià;25204;Seròs;1;1;U;;638;390;248;8;3;379;382
25;Lleida;33;Segrià;25204;Seròs;1;2;U;;915;586;329;9;14;563;577
17;Girona;10;Baix Empordà;17191;Serra de Daró;1;1;U;;154;115;39;0;0;115;115
17;Girona;31;Ripollès;17192;Setcases;1;1;U;;124;88;36;2;0;86;86
25;Lleida;4;Alt Urgell;25203;Seu d'Urgell, la;1;1;U;;1068;532;536;5;9;518;527
25;Lleida;4;Alt Urgell;25203;Seu d'Urgell, la;1;2;U;;1167;672;495;0;13;659;672
25;Lleida;4;Alt Urgell;25203;Seu d'Urgell, la;1;3;U;;965;469;496;0;6;463;469
25;Lleida;4;Alt Urgell;25203;Seu d'Urgell, la;1;4;A;;738;409;329;1;6;402;408
25;Lleida;4;Alt Urgell;25203;Seu d'Urgell, la;1;4;B;;789;446;343;2;6;438;444
25;Lleida;4;Alt Urgell;25203;Seu d'Urgell, la;1;5;U;;1172;672;500;5;13;654;667
25;Lleida;4;Alt Urgell;25203;Seu d'Urgell, la;1;6;U;;870;531;339;0;10;521;531
25;Lleida;4;Alt Urgell;25203;Seu d'Urgell, la;1;7;U;;1079;577;502;2;7;568;575
25;Lleida;4;Alt Urgell;25203;Seu d'Urgell, la;1;8;U;;459;286;173;0;6;280;286
8;Barcelona;24;Osona;08269;Seva;1;1;U;;749;612;137;0;4;608;612
8;Barcelona;24;Osona;08269;Seva;1;2;U;;646;481;165;0;3;478;481
25;Lleida;27;Pla d'Urgell;25205;Sidamon;1;1;U;;364;307;57;2;1;304;305
17;Girona;34;Selva;17193;Sils;1;1;A;;622;384;238;3;2;379;381
17;Girona;34;Selva;17193;Sils;1;1;B;;651;396;255;0;2;394;396
17;Girona;34;Selva;17193;Sils;1;1;C;;563;376;187;2;4;370;374
8;Barcelona;17;Garraf;08270;Sitges;1;1;U;;858;528;330;1;3;524;527
8;Barcelona;17;Garraf;08270;Sitges;1;2;A;;855;513;342;2;5;506;511
8;Barcelona;17;Garraf;08270;Sitges;1;2;B;;1032;601;431;2;3;596;599
8;Barcelona;17;Garraf;08270;Sitges;1;3;U;;647;364;283;2;9;353;362
8;Barcelona;17;Garraf;08270;Sitges;2;1;A;;579;386;193;1;4;381;385
8;Barcelona;17;Garraf;08270;Sitges;2;1;B;;821;560;261;0;7;553;560
8;Barcelona;17;Garraf;08270;Sitges;2;2;A;;674;394;280;2;4;388;392
8;Barcelona;17;Garraf;08270;Sitges;2;2;B;;841;481;360;1;3;477;480
8;Barcelona;17;Garraf;08270;Sitges;2;3;A;;675;365;310;1;2;362;364
8;Barcelona;17;Garraf;08270;Sitges;2;3;B;;914;526;388;1;4;521;525
8;Barcelona;17;Garraf;08270;Sitges;2;4;A;;754;448;306;4;7;437;444
8;Barcelona;17;Garraf;08270;Sitges;2;4;B;;961;499;462;7;0;492;492
8;Barcelona;17;Garraf;08270;Sitges;2;5;A;;877;559;318;1;0;558;558
8;Barcelona;17;Garraf;08270;Sitges;2;5;B;;349;159;190;0;3;156;159
17;Girona;2;Alt Empordà;17052;Siurana;1;1;U;;143;67;76;0;0;67;67
8;Barcelona;24;Osona;08271;Sobremunt;1;1;U;;78;49;29;0;1;48;49
25;Lleida;18;Garrigues;25206;Soleràs, el;1;1;U;;400;298;102;0;2;296;298
43;Tarragona;16;Conca de Barberà;43147;Solivella;1;1;U;;605;450;155;4;6;440;446
25;Lleida;35;Solsonès;25207;Solsona;1;1;A;;713;439;274;1;12;426;438
25;Lleida;35;Solsonès;25207;Solsona;1;1;B;;906;538;368;2;20;516;536
25;Lleida;35;Solsonès;25207;Solsona;1;2;A;;850;475;375;1;5;469;474
25;Lleida;35;Solsonès;25207;Solsona;1;2;B;;999;544;455;4;7;533;540
25;Lleida;35;Solsonès;25207;Solsona;2;1;U;;795;533;262;1;9;523;532
25;Lleida;35;Solsonès;25207;Solsona;2;2;U;;1077;662;415;3;4;655;659
8;Barcelona;24;Osona;08272;Sora;1;1;U;;185;126;59;0;4;122;126
25;Lleida;26;Pallars Sobirà;25208;Soriguera;1;1;U;;256;122;134;2;0;120;120
25;Lleida;26;Pallars Sobirà;25209;Sort;1;1;U;;1286;813;473;3;5;805;810
25;Lleida;33;Segrià;25210;Soses;1;1;U;;1179;768;411;2;9;757;766
8;Barcelona;3;Alt Penedès;08273;Subirats;1;1;U;;599;411;188;2;18;391;409
8;Barcelona;3;Alt Penedès;08273;Subirats;1;2;A;;377;280;97;2;0;278;278
8;Barcelona;3;Alt Penedès;08273;Subirats;1;2;B;;246;152;94;0;1;151;152
8;Barcelona;3;Alt Penedès;08273;Subirats;1;3;U;;581;440;141;0;3;437;440
25;Lleida;33;Segrià;25211;Sudanell;1;1;U;;628;299;329;1;2;296;298
25;Lleida;33;Segrià;25212;Sunyer;1;1;U;;255;174;81;0;3;171;174
8;Barcelona;7;Bages;08274;Súria;1;1;A;;765;563;202;0;3;560;563
8;Barcelona;7;Bages;08274;Súria;1;1;B;;784;572;212;0;7;565;572
8;Barcelona;7;Bages;08274;Súria;1;2;U;;626;442;184;1;6;435;441
8;Barcelona;7;Bages;08274;Súria;1;3;U;;449;281;168;2;4;275;279
8;Barcelona;7;Bages;08274;Súria;1;4;A;;749;507;242;5;2;500;502
8;Barcelona;7;Bages;08274;Súria;1;4;B;;787;555;232;1;6;548;554
8;Barcelona;7;Bages;08274;Súria;1;5;A;;573;403;170;2;6;395;401
8;Barcelona;7;Bages;08274;Súria;1;5;B;;591;417;174;1;1;415;416
17;Girona;34;Selva;17194;Susqueda;1;1;U;;97;55;42;0;0;55;55
8;Barcelona;41;Vallès Oriental;08276;Tagamanent;1;1;U;;132;93;39;0;6;87;93
8;Barcelona;7;Bages;08277;Talamanca;1;1;U;;61;47;14;0;0;47;47
25;Lleida;25;Pallars Jussà;25215;Talarn;1;1;U;;310;198;112;0;2;196;198
25;Lleida;32;Segarra;25216;Talavera;1;1;U;;290;202;88;0;2;200;202
17;Girona;10;Baix Empordà;17195;Tallada d'Empordà, la;1;1;U;;290;180;110;0;4;176;180
8;Barcelona;24;Osona;08278;Taradell;1;1;A;;794;573;221;9;8;556;564
8;Barcelona;24;Osona;08278;Taradell;1;1;B;;884;648;236;6;2;640;642
8;Barcelona;24;Osona;08278;Taradell;1;2;A;;778;559;219;0;3;556;559
8;Barcelona;24;Osona;08278;Taradell;1;2;B;;474;305;169;0;4;301;305
8;Barcelona;24;Osona;08278;Taradell;1;2;C;;607;430;177;2;3;425;428
43;Tarragona;36;Tarragonès;43148;Tarragona;1;1;U;;654;330;324;2;0;328;328
43;Tarragona;36;Tarragonès;43148;Tarragona;1;2;A;;480;307;173;0;4;303;307
43;Tarragona;36;Tarragonès;43148;Tarragona;1;2;B;;527;284;243;0;4;280;284
43;Tarragona;36;Tarragonès;43148;Tarragona;2;1;U;;609;314;295;1;0;313;313
43;Tarragona;36;Tarragonès;43148;Tarragona;2;2;U;;712;429;283;0;5;424;429
43;Tarragona;36;Tarragonès;43148;Tarragona;3;1;U;;548;318;230;1;1;316;317
43;Tarragona;36;Tarragonès;43148;Tarragona;3;2;U;;576;320;256;0;3;317;320
43;Tarragona;36;Tarragonès;43148;Tarragona;3;3;U;;619;393;226;1;3;389;392
43;Tarragona;36;Tarragonès;43148;Tarragona;3;4;U;;1169;675;494;3;7;665;672
43;Tarragona;36;Tarragonès;43148;Tarragona;4;1;U;;779;462;317;1;7;454;461
43;Tarragona;36;Tarragonès;43148;Tarragona;4;10;A;;670;362;308;3;2;357;359
43;Tarragona;36;Tarragonès;43148;Tarragona;4;10;B;;773;430;343;2;9;419;428
43;Tarragona;36;Tarragonès;43148;Tarragona;4;11;U;;708;410;298;2;3;405;408
43;Tarragona;36;Tarragonès;43148;Tarragona;4;12;U;;916;545;371;2;2;541;543
43;Tarragona;36;Tarragonès;43148;Tarragona;4;13;U;;700;350;350;3;2;345;347
43;Tarragona;36;Tarragonès;43148;Tarragona;4;14;A;;739;446;293;1;6;439;445
43;Tarragona;36;Tarragonès;43148;Tarragona;4;14;B;;903;505;398;2;6;497;503
43;Tarragona;36;Tarragonès;43148;Tarragona;4;15;U;;644;363;281;0;7;356;363
43;Tarragona;36;Tarragonès;43148;Tarragona;4;2;U;;871;544;327;0;9;535;544
43;Tarragona;36;Tarragonès;43148;Tarragona;4;3;U;;885;533;352;1;8;524;532
43;Tarragona;36;Tarragonès;43148;Tarragona;4;4;A;;578;341;237;1;2;338;340
43;Tarragona;36;Tarragonès;43148;Tarragona;4;4;B;;670;409;261;0;6;403;409
43;Tarragona;36;Tarragonès;43148;Tarragona;4;5;U;;1093;653;440;5;5;643;648
43;Tarragona;36;Tarragonès;43148;Tarragona;4;6;A;;594;355;239;3;5;347;352
43;Tarragona;36;Tarragonès;43148;Tarragona;4;6;B;;653;387;266;0;4;383;387
43;Tarragona;36;Tarragonès;43148;Tarragona;4;7;U;;883;533;350;0;13;520;533
43;Tarragona;36;Tarragonès;43148;Tarragona;4;8;A;;778;463;315;1;11;451;462
43;Tarragona;36;Tarragonès;43148;Tarragona;4;8;B;;740;460;280;0;7;453;460
43;Tarragona;36;Tarragonès;43148;Tarragona;4;9;A;;604;375;229;1;7;367;374
43;Tarragona;36;Tarragonès;43148;Tarragona;4;9;B;;694;409;285;1;3;405;408
43;Tarragona;36;Tarragonès;43148;Tarragona;5;1;A;;544;341;203;0;5;336;341
43;Tarragona;36;Tarragonès;43148;Tarragona;5;1;B;;600;400;200;1;12;387;399
43;Tarragona;36;Tarragonès;43148;Tarragona;5;2;A;;583;347;236;3;0;344;344
43;Tarragona;36;Tarragonès;43148;Tarragona;5;2;B;;621;388;233;3;3;382;385
43;Tarragona;36;Tarragonès;43148;Tarragona;5;3;A;;647;376;271;3;7;366;373
43;Tarragona;36;Tarragonès;43148;Tarragona;5;3;B;;756;415;341;2;7;406;413
43;Tarragona;36;Tarragonès;43148;Tarragona;5;4;U;;966;518;448;0;7;511;518
43;Tarragona;36;Tarragonès;43148;Tarragona;5;5;A;;518;247;271;0;3;244;247
43;Tarragona;36;Tarragonès;43148;Tarragona;5;5;B;;596;317;279;2;7;308;315
43;Tarragona;36;Tarragonès;43148;Tarragona;5;6;U;;855;366;489;4;3;359;362
43;Tarragona;36;Tarragonès;43148;Tarragona;5;7;U;;967;531;436;0;7;524;531
43;Tarragona;36;Tarragonès;43148;Tarragona;5;8;A;;679;388;291;1;12;375;387
43;Tarragona;36;Tarragonès;43148;Tarragona;5;8;B;;843;457;386;2;3;452;455
43;Tarragona;36;Tarragonès;43148;Tarragona;5;9;U;;656;440;216;0;11;429;440
43;Tarragona;36;Tarragonès;43148;Tarragona;6;1;A;;622;364;258;1;5;358;363
43;Tarragona;36;Tarragonès;43148;Tarragona;6;1;B;;727;398;329;1;8;389;397
43;Tarragona;36;Tarragonès;43148;Tarragona;6;10;A;;617;372;245;1;10;361;371
43;Tarragona;36;Tarragonès;43148;Tarragona;6;10;B;;538;307;231;1;5;301;306
43;Tarragona;36;Tarragonès;43148;Tarragona;6;10;C;;604;360;244;2;3;355;358
43;Tarragona;36;Tarragonès;43148;Tarragona;6;11;A;;542;303;239;0;4;299;303
43;Tarragona;36;Tarragonès;43148;Tarragona;6;11;B;;457;253;204;0;1;252;253
43;Tarragona;36;Tarragonès;43148;Tarragona;6;11;C;;614;349;265;1;5;343;348
43;Tarragona;36;Tarragonès;43148;Tarragona;6;12;U;;545;366;179;0;7;359;366
43;Tarragona;36;Tarragonès;43148;Tarragona;6;13;A;;622;375;247;0;4;371;375
43;Tarragona;36;Tarragonès;43148;Tarragona;6;13;B;;533;299;234;1;1;297;298
43;Tarragona;36;Tarragonès;43148;Tarragona;6;13;C;;615;377;238;1;3;373;376
43;Tarragona;36;Tarragonès;43148;Tarragona;6;14;U;;806;454;352;0;6;448;454
43;Tarragona;36;Tarragonès;43148;Tarragona;6;15;U;;1000;517;483;1;4;512;516
43;Tarragona;36;Tarragonès;43148;Tarragona;6;2;U;;702;401;301;1;9;391;400
43;Tarragona;36;Tarragonès;43148;Tarragona;6;3;A;;623;322;301;1;5;316;321
43;Tarragona;36;Tarragonès;43148;Tarragona;6;3;B;;568;252;316;0;4;248;252
43;Tarragona;36;Tarragonès;43148;Tarragona;6;3;C;;544;267;277;1;5;261;266
43;Tarragona;36;Tarragonès;43148;Tarragona;6;4;U;;831;505;326;1;3;501;504
43;Tarragona;36;Tarragonès;43148;Tarragona;6;5;U;;510;271;239;4;2;265;267
43;Tarragona;36;Tarragonès;43148;Tarragona;6;6;U;;838;456;382;0;5;451;456
43;Tarragona;36;Tarragonès;43148;Tarragona;6;7;U;;544;281;263;0;2;279;281
43;Tarragona;36;Tarragonès;43148;Tarragona;6;8;U;;1050;670;380;1;14;655;669
43;Tarragona;36;Tarragonès;43148;Tarragona;6;9;A;;621;371;250;0;8;363;371
43;Tarragona;36;Tarragonès;43148;Tarragona;6;9;B;;746;410;336;0;10;400;410
43;Tarragona;36;Tarragonès;43148;Tarragona;7;1;U;;688;347;341;2;6;339;345
43;Tarragona;36;Tarragonès;43148;Tarragona;7;10;A;;613;317;296;0;2;315;317
43;Tarragona;36;Tarragonès;43148;Tarragona;7;10;B;;748;372;376;2;4;366;370
43;Tarragona;36;Tarragonès;43148;Tarragona;7;11;A;;733;361;372;1;1;359;360
43;Tarragona;36;Tarragonès;43148;Tarragona;7;11;B;;799;417;382;2;5;410;415
43;Tarragona;36;Tarragonès;43148;Tarragona;7;12;U;;918;456;462;0;4;452;456
43;Tarragona;36;Tarragonès;43148;Tarragona;7;13;U;;1102;591;511;0;12;579;591
43;Tarragona;36;Tarragonès;43148;Tarragona;7;2;U;;974;528;446;1;4;523;527
43;Tarragona;36;Tarragonès;43148;Tarragona;7;3;A;;637;299;338;0;1;298;299
43;Tarragona;36;Tarragonès;43148;Tarragona;7;3;B;;784;360;424;0;2;358;360
43;Tarragona;36;Tarragonès;43148;Tarragona;7;4;A;;800;421;379;1;4;416;420
43;Tarragona;36;Tarragonès;43148;Tarragona;7;4;B;;850;451;399;0;4;447;451
43;Tarragona;36;Tarragonès;43148;Tarragona;7;5;U;;1055;526;529;0;3;523;526
43;Tarragona;36;Tarragonès;43148;Tarragona;7;6;U;;1040;568;472;3;7;558;565
43;Tarragona;36;Tarragonès;43148;Tarragona;7;7;A;;626;386;240;5;15;366;381
43;Tarragona;36;Tarragonès;43148;Tarragona;7;7;B;;567;249;318;1;4;244;248
43;Tarragona;36;Tarragonès;43148;Tarragona;7;8;A;;886;492;394;0;12;480;492
43;Tarragona;36;Tarragonès;43148;Tarragona;7;8;B;;981;537;444;0;11;526;537
43;Tarragona;36;Tarragonès;43148;Tarragona;7;9;U;;809;425;384;4;1;420;421
43;Tarragona;36;Tarragonès;43148;Tarragona;8;1;A;;665;323;342;1;0;322;322
43;Tarragona;36;Tarragonès;43148;Tarragona;8;1;B;;709;348;361;0;5;343;348
43;Tarragona;36;Tarragonès;43148;Tarragona;8;10;A;;701;262;439;1;2;259;261
43;Tarragona;36;Tarragonès;43148;Tarragona;8;10;B;;646;233;413;2;1;230;231
43;Tarragona;36;Tarragonès;43148;Tarragona;8;2;A;;584;296;288;0;0;296;296
43;Tarragona;36;Tarragonès;43148;Tarragona;8;2;B;;666;354;312;4;1;349;350
43;Tarragona;36;Tarragonès;43148;Tarragona;8;3;A;;641;302;339;6;5;291;296
43;Tarragona;36;Tarragonès;43148;Tarragona;8;3;B;;759;357;402;2;3;352;355
43;Tarragona;36;Tarragonès;43148;Tarragona;8;4;A;;637;323;314;1;2;320;322
43;Tarragona;36;Tarragonès;43148;Tarragona;8;4;B;;642;363;279;3;5;355;360
43;Tarragona;36;Tarragonès;43148;Tarragona;8;5;U;;789;422;367;0;7;415;422
43;Tarragona;36;Tarragonès;43148;Tarragona;8;6;U;;1091;562;529;5;9;548;557
43;Tarragona;36;Tarragonès;43148;Tarragona;8;7;A;;799;403;396;3;8;392;400
43;Tarragona;36;Tarragonès;43148;Tarragona;8;7;B;;922;453;469;3;6;444;450
43;Tarragona;36;Tarragonès;43148;Tarragona;8;8;A;;764;193;571;2;3;188;191
43;Tarragona;36;Tarragonès;43148;Tarragona;8;8;B;;779;252;527;2;2;248;250
43;Tarragona;36;Tarragonès;43148;Tarragona;8;9;U;;916;408;508;1;3;404;407
43;Tarragona;36;Tarragonès;43148;Tarragona;9;1;U;;894;438;456;0;1;437;438
43;Tarragona;36;Tarragonès;43148;Tarragona;9;10;U;;894;435;459;2;4;429;433
43;Tarragona;36;Tarragonès;43148;Tarragona;9;2;U;;960;480;480;1;0;479;479
43;Tarragona;36;Tarragonès;43148;Tarragona;9;3;U;;985;511;474;1;2;508;510
43;Tarragona;36;Tarragonès;43148;Tarragona;9;4;U;;991;478;513;4;2;472;474
43;Tarragona;36;Tarragonès;43148;Tarragona;9;5;U;;882;472;410;3;4;465;469
43;Tarragona;36;Tarragonès;43148;Tarragona;9;6;A;;727;391;336;3;3;385;388
43;Tarragona;36;Tarragonès;43148;Tarragona;9;6;B;;922;511;411;2;6;503;509
43;Tarragona;36;Tarragonès;43148;Tarragona;9;7;U;;756;448;308;0;2;446;448
43;Tarragona;36;Tarragonès;43148;Tarragona;9;8;U;;774;380;394;0;2;378;380
43;Tarragona;36;Tarragonès;43148;Tarragona;9;9;U;;556;290;266;1;1;288;289
25;Lleida;38;Urgell;25217;Tàrrega;1;1;U;;1021;598;423;4;9;585;594
25;Lleida;38;Urgell;25217;Tàrrega;1;2;U;;803;491;312;7;12;472;484
25;Lleida;38;Urgell;25217;Tàrrega;2;1;U;;766;440;326;3;9;428;437
25;Lleida;38;Urgell;25217;Tàrrega;2;2;A;;667;413;254;3;4;406;410
25;Lleida;38;Urgell;25217;Tàrrega;2;2;B;;751;491;260;3;8;480;488
25;Lleida;38;Urgell;25217;Tàrrega;3;1;A;;674;416;258;2;7;407;414
25;Lleida;38;Urgell;25217;Tàrrega;3;1;B;;881;510;371;0;8;502;510
25;Lleida;38;Urgell;25217;Tàrrega;3;2;U;;840;548;292;15;12;521;533
25;Lleida;38;Urgell;25217;Tàrrega;4;1;U;;803;486;317;7;18;461;479
25;Lleida;38;Urgell;25217;Tàrrega;4;2;A;;517;319;198;1;8;310;318
25;Lleida;38;Urgell;25217;Tàrrega;4;2;B;;619;403;216;8;8;387;395
25;Lleida;38;Urgell;25217;Tàrrega;5;1;A;;248;166;82;0;1;165;166
25;Lleida;38;Urgell;25217;Tàrrega;5;1;B;;184;119;65;0;2;117;119
25;Lleida;38;Urgell;25217;Tàrrega;5;1;C;;218;142;76;3;6;133;139
25;Lleida;18;Garrigues;25218;Tarrés;1;1;U;;80;61;19;0;0;61;61
25;Lleida;32;Segarra;25219;Tarroja de Segarra;1;1;U;;172;130;42;0;3;127;130
8;Barcelona;24;Osona;08275;Tavèrnoles;1;1;U;;160;122;38;1;0;121;121
8;Barcelona;24;Osona;08280;Tavertet;1;1;U;;113;65;48;0;0;65;65
8;Barcelona;21;Maresme;08281;Teià;1;1;U;;1024;646;378;1;4;641;645
8;Barcelona;21;Maresme;08281;Teià;1;2;U;;941;658;283;4;6;648;654
8;Barcelona;21;Maresme;08281;Teià;1;3;U;;717;393;324;2;5;386;391
25;Lleida;23;Noguera;25220;Térmens;1;1;A;;459;269;190;0;2;267;269
25;Lleida;23;Noguera;25220;Térmens;1;1;B;;655;416;239;1;1;414;415
17;Girona;2;Alt Empordà;17196;Terrades;1;1;U;;150;89;61;0;0;89;89
8;Barcelona;40;Vallès Occidental;08279;Terrassa;1;1;A;;705;518;187;1;5;512;517
8;Barcelona;40;Vallès Occidental;08279;Terrassa;1;1;B;;619;464;155;2;2;460;462
8;Barcelona;40;Vallès Occidental;08279;Terrassa;1;10;U;;449;293;156;0;5;288;293
8;Barcelona;40;Vallès Occidental;08279;Terrassa;1;11;U;;684;348;336;0;4;344;348
8;Barcelona;40;Vallès Occidental;08279;Terrassa;1;12;A;;773;435;338;0;6;429;435
8;Barcelona;40;Vallès Occidental;08279;Terrassa;1;12;B;;893;462;431;2;4;456;460
8;Barcelona;40;Vallès Occidental;08279;Terrassa;1;13;U;;465;208;257;0;1;207;208
8;Barcelona;40;Vallès Occidental;08279;Terrassa;1;14;A;;491;231;260;0;9;222;231
8;Barcelona;40;Vallès Occidental;08279;Terrassa;1;14;B;;591;278;313;0;1;277;278
8;Barcelona;40;Vallès Occidental;08279;Terrassa;1;14;C;;640;300;340;0;5;295;300
8;Barcelona;40;Vallès Occidental;08279;Terrassa;1;15;A;;784;408;376;0;6;402;408
8;Barcelona;40;Vallès Occidental;08279;Terrassa;1;15;B;;1007;545;462;0;9;536;545
8;Barcelona;40;Vallès Occidental;08279;Terrassa;1;16;A;;647;390;257;1;5;384;389
8;Barcelona;40;Vallès Occidental;08279;Terrassa;1;16;B;;709;451;258;1;5;445;450
8;Barcelona;40;Vallès Occidental;08279;Terrassa;1;17;A;;830;560;270;2;8;550;558
8;Barcelona;40;Vallès Occidental;08279;Terrassa;1;17;B;;1007;685;322;1;13;671;684
8;Barcelona;40;Vallès Occidental;08279;Terrassa;1;18;U;;409;264;145;3;3;258;261
8;Barcelona;40;Vallès Occidental;08279;Terrassa;1;2;U;;706;473;233;3;7;463;470
8;Barcelona;40;Vallès Occidental;08279;Terrassa;1;3;U;;416;305;111;0;4;301;305
8;Barcelona;40;Vallès Occidental;08279;Terrassa;1;4;A;;507;345;162;1;5;339;344
8;Barcelona;40;Vallès Occidental;08279;Terrassa;1;4;B;;498;329;169;2;4;323;327
8;Barcelona;40;Vallès Occidental;08279;Terrassa;1;5;A;;654;421;233;0;9;412;421
8;Barcelona;40;Vallès Occidental;08279;Terrassa;1;5;B;;706;423;283;1;11;411;422
8;Barcelona;40;Vallès Occidental;08279;Terrassa;1;6;A;;750;527;223;0;5;522;527
8;Barcelona;40;Vallès Occidental;08279;Terrassa;1;6;B;;824;571;253;1;6;564;570
8;Barcelona;40;Vallès Occidental;08279;Terrassa;1;7;A;;538;364;174;0;3;361;364
8;Barcelona;40;Vallès Occidental;08279;Terrassa;1;7;B;;596;384;212;0;1;383;384
8;Barcelona;40;Vallès Occidental;08279;Terrassa;1;8;U;;817;522;295;3;5;514;519
8;Barcelona;40;Vallès Occidental;08279;Terrassa;1;9;U;;791;535;256;3;6;526;532
8;Barcelona;40;Vallès Occidental;08279;Terrassa;2;1;A;;618;300;318;3;7;290;297
8;Barcelona;40;Vallès Occidental;08279;Terrassa;2;1;B;;765;393;372;0;2;391;393
8;Barcelona;40;Vallès Occidental;08279;Terrassa;2;10;U;;503;258;245;2;2;254;256
8;Barcelona;40;Vallès Occidental;08279;Terrassa;2;11;U;;691;320;371;2;1;317;318
8;Barcelona;40;Vallès Occidental;08279;Terrassa;2;12;U;;510;285;225;1;0;284;284
8;Barcelona;40;Vallès Occidental;08279;Terrassa;2;13;U;;669;333;336;0;5;328;333
8;Barcelona;40;Vallès Occidental;08279;Terrassa;2;14;A;;855;345;510;0;3;342;345
8;Barcelona;40;Vallès Occidental;08279;Terrassa;2;14;B;;895;378;517;1;3;374;377
8;Barcelona;40;Vallès Occidental;08279;Terrassa;2;2;A;;504;240;264;0;0;240;240
8;Barcelona;40;Vallès Occidental;08279;Terrassa;2;2;B;;682;338;344;0;3;335;338
8;Barcelona;40;Vallès Occidental;08279;Terrassa;2;3;U;;907;511;396;2;5;504;509
8;Barcelona;40;Vallès Occidental;08279;Terrassa;2;4;A;;562;272;290;5;1;266;267
8;Barcelona;40;Vallès Occidental;08279;Terrassa;2;4;B;;773;340;433;0;0;340;340
8;Barcelona;40;Vallès Occidental;08279;Terrassa;2;5;A;;488;249;239;0;7;242;249
8;Barcelona;40;Vallès Occidental;08279;Terrassa;2;5;B;;584;283;301;0;3;280;283
8;Barcelona;40;Vallès Occidental;08279;Terrassa;2;6;U;;947;471;476;0;3;468;471
8;Barcelona;40;Vallès Occidental;08279;Terrassa;2;7;U;;586;292;294;0;5;287;292
8;Barcelona;40;Vallès Occidental;08279;Terrassa;2;8;U;;884;424;460;0;3;421;424
8;Barcelona;40;Vallès Occidental;08279;Terrassa;2;9;U;;904;430;474;0;4;426;430
8;Barcelona;40;Vallès Occidental;08279;Terrassa;3;1;U;;988;542;446;2;8;532;540
8;Barcelona;40;Vallès Occidental;08279;Terrassa;3;10;A;;631;218;413;0;0;218;218
8;Barcelona;40;Vallès Occidental;08279;Terrassa;3;10;B;;784;291;493;0;2;289;291
8;Barcelona;40;Vallès Occidental;08279;Terrassa;3;11;A;;500;191;309;1;4;186;190
8;Barcelona;40;Vallès Occidental;08279;Terrassa;3;11;B;;656;214;442;1;5;208;213
8;Barcelona;40;Vallès Occidental;08279;Terrassa;3;12;A;;627;210;417;0;3;207;210
8;Barcelona;40;Vallès Occidental;08279;Terrassa;3;12;B;;712;247;465;0;2;245;247
8;Barcelona;40;Vallès Occidental;08279;Terrassa;3;13;U;;474;158;316;2;0;156;156
8;Barcelona;40;Vallès Occidental;08279;Terrassa;3;14;A;;595;251;344;6;1;244;245
8;Barcelona;40;Vallès Occidental;08279;Terrassa;3;14;B;;804;345;459;7;2;336;338
8;Barcelona;40;Vallès Occidental;08279;Terrassa;3;15;A;;590;284;306;1;1;282;283
8;Barcelona;40;Vallès Occidental;08279;Terrassa;3;15;B;;744;314;430;3;5;306;311
8;Barcelona;40;Vallès Occidental;08279;Terrassa;3;15;C;;789;382;407;5;5;372;377
8;Barcelona;40;Vallès Occidental;08279;Terrassa;3;16;U;;945;394;551;1;13;380;393
8;Barcelona;40;Vallès Occidental;08279;Terrassa;3;17;A;;484;203;281;17;5;181;186
8;Barcelona;40;Vallès Occidental;08279;Terrassa;3;17;B;;621;250;371;24;4;222;226
8;Barcelona;40;Vallès Occidental;08279;Terrassa;3;18;U;;680;276;404;0;2;274;276
8;Barcelona;40;Vallès Occidental;08279;Terrassa;3;2;A;;551;283;268;1;5;277;282
8;Barcelona;40;Vallès Occidental;08279;Terrassa;3;2;B;;556;230;326;0;5;225;230
8;Barcelona;40;Vallès Occidental;08279;Terrassa;3;2;C;;602;298;304;0;0;298;298
8;Barcelona;40;Vallès Occidental;08279;Terrassa;3;3;A;;408;178;230;6;3;169;172
8;Barcelona;40;Vallès Occidental;08279;Terrassa;3;3;B;;511;218;293;5;5;208;213
8;Barcelona;40;Vallès Occidental;08279;Terrassa;3;4;U;;868;395;473;18;7;370;377
8;Barcelona;40;Vallès Occidental;08279;Terrassa;3;5;A;;547;289;258;0;1;288;289
8;Barcelona;40;Vallès Occidental;08279;Terrassa;3;5;B;;698;353;345;1;10;342;352
8;Barcelona;40;Vallès Occidental;08279;Terrassa;3;6;U;;775;471;304;2;4;465;469
8;Barcelona;40;Vallès Occidental;08279;Terrassa;3;7;U;;551;331;220;1;4;326;330
8;Barcelona;40;Vallès Occidental;08279;Terrassa;3;8;A;;776;320;456;0;3;317;320
8;Barcelona;40;Vallès Occidental;08279;Terrassa;3;8;B;;997;380;617;1;1;378;379
8;Barcelona;40;Vallès Occidental;08279;Terrassa;3;9;U;;743;330;413;2;0;328;328
8;Barcelona;40;Vallès Occidental;08279;Terrassa;4;1;A;;546;337;209;4;2;331;333
8;Barcelona;40;Vallès Occidental;08279;Terrassa;4;1;B;;582;383;199;0;5;378;383
8;Barcelona;40;Vallès Occidental;08279;Terrassa;4;10;U;;730;361;369;0;2;359;361
8;Barcelona;40;Vallès Occidental;08279;Terrassa;4;11;U;;591;323;268;1;2;320;322
8;Barcelona;40;Vallès Occidental;08279;Terrassa;4;12;A;;472;261;211;0;6;255;261
8;Barcelona;40;Vallès Occidental;08279;Terrassa;4;12;B;;597;306;291;0;1;305;306
8;Barcelona;40;Vallès Occidental;08279;Terrassa;4;13;A;;484;285;199;3;0;282;282
8;Barcelona;40;Vallès Occidental;08279;Terrassa;4;13;B;;552;305;247;1;1;303;304
8;Barcelona;40;Vallès Occidental;08279;Terrassa;4;14;A;;786;513;273;1;7;505;512
8;Barcelona;40;Vallès Occidental;08279;Terrassa;4;14;B;;781;522;259;2;8;512;520
8;Barcelona;40;Vallès Occidental;08279;Terrassa;4;15;U;;1019;680;339;0;8;672;680
8;Barcelona;40;Vallès Occidental;08279;Terrassa;4;16;A;;509;352;157;1;4;347;351
8;Barcelona;40;Vallès Occidental;08279;Terrassa;4;16;B;;566;374;192;0;3;371;374
8;Barcelona;40;Vallès Occidental;08279;Terrassa;4;17;U;;618;390;228;0;5;385;390
8;Barcelona;40;Vallès Occidental;08279;Terrassa;4;18;A;;603;371;232;2;6;363;369
8;Barcelona;40;Vallès Occidental;08279;Terrassa;4;18;B;;797;460;337;8;0;452;452
8;Barcelona;40;Vallès Occidental;08279;Terrassa;4;19;A;;531;261;270;1;1;259;260
8;Barcelona;40;Vallès Occidental;08279;Terrassa;4;19;B;;723;344;379;1;1;342;343
8;Barcelona;40;Vallès Occidental;08279;Terrassa;4;19;C;;640;319;321;0;1;318;319
8;Barcelona;40;Vallès Occidental;08279;Terrassa;4;2;A;;552;337;215;3;0;334;334
8;Barcelona;40;Vallès Occidental;08279;Terrassa;4;2;B;;578;370;208;0;4;366;370
8;Barcelona;40;Vallès Occidental;08279;Terrassa;4;20;U;;817;368;449;0;3;365;368
8;Barcelona;40;Vallès Occidental;08279;Terrassa;4;3;A;;478;283;195;3;1;279;280
8;Barcelona;40;Vallès Occidental;08279;Terrassa;4;3;B;;610;352;258;0;2;350;352
8;Barcelona;40;Vallès Occidental;08279;Terrassa;4;4;A;;528;280;248;0;0;280;280
8;Barcelona;40;Vallès Occidental;08279;Terrassa;4;4;B;;590;306;284;0;3;303;306
8;Barcelona;40;Vallès Occidental;08279;Terrassa;4;5;A;;774;375;399;0;3;372;375
8;Barcelona;40;Vallès Occidental;08279;Terrassa;4;5;B;;919;443;476;0;3;440;443
8;Barcelona;40;Vallès Occidental;08279;Terrassa;4;6;A;;498;248;250;2;3;243;246
8;Barcelona;40;Vallès Occidental;08279;Terrassa;4;6;B;;576;321;255;1;5;315;320
8;Barcelona;40;Vallès Occidental;08279;Terrassa;4;7;A;;706;299;407;1;0;298;298
8;Barcelona;40;Vallès Occidental;08279;Terrassa;4;7;B;;924;453;471;1;2;450;452
8;Barcelona;40;Vallès Occidental;08279;Terrassa;4;8;A;;569;257;312;1;1;255;256
8;Barcelona;40;Vallès Occidental;08279;Terrassa;4;8;B;;844;398;446;5;1;392;393
8;Barcelona;40;Vallès Occidental;08279;Terrassa;4;9;U;;633;287;346;0;1;286;287
8;Barcelona;40;Vallès Occidental;08279;Terrassa;5;1;U;;640;291;349;0;2;289;291
8;Barcelona;40;Vallès Occidental;08279;Terrassa;5;10;A;;644;330;314;0;2;328;330
8;Barcelona;40;Vallès Occidental;08279;Terrassa;5;10;B;;682;290;392;1;6;283;289
8;Barcelona;40;Vallès Occidental;08279;Terrassa;5;11;A;;834;440;394;1;3;436;439
8;Barcelona;40;Vallès Occidental;08279;Terrassa;5;11;B;;1010;527;483;1;6;520;526
8;Barcelona;40;Vallès Occidental;08279;Terrassa;5;12;U;;651;323;328;4;2;317;319
8;Barcelona;40;Vallès Occidental;08279;Terrassa;5;13;A;;382;149;233;1;0;148;148
8;Barcelona;40;Vallès Occidental;08279;Terrassa;5;13;B;;458;176;282;1;1;174;175
8;Barcelona;40;Vallès Occidental;08279;Terrassa;5;14;A;;529;278;251;2;1;275;276
8;Barcelona;40;Vallès Occidental;08279;Terrassa;5;14;B;;676;327;349;1;4;322;326
8;Barcelona;40;Vallès Occidental;08279;Terrassa;5;14;C;;644;317;327;2;2;313;315
8;Barcelona;40;Vallès Occidental;08279;Terrassa;5;15;A;;597;273;324;1;1;271;272
8;Barcelona;40;Vallès Occidental;08279;Terrassa;5;15;B;;742;340;402;0;5;335;340
8;Barcelona;40;Vallès Occidental;08279;Terrassa;5;16;A;;676;325;351;4;0;321;321
8;Barcelona;40;Vallès Occidental;08279;Terrassa;5;16;B;;953;490;463;2;7;481;488
8;Barcelona;40;Vallès Occidental;08279;Terrassa;5;17;U;;695;339;356;0;4;335;339
8;Barcelona;40;Vallès Occidental;08279;Terrassa;5;18;A;;458;245;213;0;3;242;245
8;Barcelona;40;Vallès Occidental;08279;Terrassa;5;18;B;;660;323;337;1;4;318;322
8;Barcelona;40;Vallès Occidental;08279;Terrassa;5;19;U;;866;374;492;1;5;368;373
8;Barcelona;40;Vallès Occidental;08279;Terrassa;5;2;A;;591;259;332;1;2;256;258
8;Barcelona;40;Vallès Occidental;08279;Terrassa;5;2;B;;826;350;476;1;4;345;349
8;Barcelona;40;Vallès Occidental;08279;Terrassa;5;20;A;;645;309;336;1;4;304;308
8;Barcelona;40;Vallès Occidental;08279;Terrassa;5;20;B;;765;399;366;0;7;392;399
8;Barcelona;40;Vallès Occidental;08279;Terrassa;5;20;C;;893;450;443;1;2;447;449
8;Barcelona;40;Vallès Occidental;08279;Terrassa;5;3;A;;648;387;261;1;2;384;386
8;Barcelona;40;Vallès Occidental;08279;Terrassa;5;3;B;;815;471;344;2;3;466;469
8;Barcelona;40;Vallès Occidental;08279;Terrassa;5;4;A;;654;374;280;2;2;370;372
8;Barcelona;40;Vallès Occidental;08279;Terrassa;5;4;B;;737;408;329;0;3;405;408
8;Barcelona;40;Vallès Occidental;08279;Terrassa;5;5;U;;686;396;290;6;3;387;390
8;Barcelona;40;Vallès Occidental;08279;Terrassa;5;6;A;;776;479;297;2;9;468;477
8;Barcelona;40;Vallès Occidental;08279;Terrassa;5;6;B;;899;526;373;1;2;523;525
8;Barcelona;40;Vallès Occidental;08279;Terrassa;5;7;A;;534;316;218;0;3;313;316
8;Barcelona;40;Vallès Occidental;08279;Terrassa;5;7;B;;642;367;275;0;5;362;367
8;Barcelona;40;Vallès Occidental;08279;Terrassa;5;8;A;;565;347;218;1;5;341;346
8;Barcelona;40;Vallès Occidental;08279;Terrassa;5;8;B;;646;377;269;1;8;368;376
8;Barcelona;40;Vallès Occidental;08279;Terrassa;5;9;A;;660;392;268;0;1;391;392
8;Barcelona;40;Vallès Occidental;08279;Terrassa;5;9;B;;697;385;312;4;6;375;381
8;Barcelona;40;Vallès Occidental;08279;Terrassa;6;1;U;;950;453;497;0;2;451;453
8;Barcelona;40;Vallès Occidental;08279;Terrassa;6;10;A;;524;202;322;0;2;200;202
8;Barcelona;40;Vallès Occidental;08279;Terrassa;6;10;B;;770;316;454;2;6;308;314
8;Barcelona;40;Vallès Occidental;08279;Terrassa;6;11;A;;555;211;344;0;3;208;211
8;Barcelona;40;Vallès Occidental;08279;Terrassa;6;11;B;;677;265;412;0;4;261;265
8;Barcelona;40;Vallès Occidental;08279;Terrassa;6;12;A;;471;236;235;0;0;236;236
8;Barcelona;40;Vallès Occidental;08279;Terrassa;6;12;B;;695;335;360;0;5;330;335
8;Barcelona;40;Vallès Occidental;08279;Terrassa;6;13;U;;825;388;437;2;2;384;386
8;Barcelona;40;Vallès Occidental;08279;Terrassa;6;14;A;;404;158;246;2;0;156;156
8;Barcelona;40;Vallès Occidental;08279;Terrassa;6;14;B;;467;199;268;1;2;196;198
8;Barcelona;40;Vallès Occidental;08279;Terrassa;6;15;U;;480;278;202;0;3;275;278
8;Barcelona;40;Vallès Occidental;08279;Terrassa;6;16;U;;480;228;252;0;1;227;228
8;Barcelona;40;Vallès Occidental;08279;Terrassa;6;17;U;;493;231;262;0;1;230;231
8;Barcelona;40;Vallès Occidental;08279;Terrassa;6;18;U;;764;371;393;2;1;368;369
8;Barcelona;40;Vallès Occidental;08279;Terrassa;6;19;U;;713;339;374;0;4;335;339
8;Barcelona;40;Vallès Occidental;08279;Terrassa;6;2;A;;542;253;289;0;2;251;253
8;Barcelona;40;Vallès Occidental;08279;Terrassa;6;2;B;;750;340;410;0;1;339;340
8;Barcelona;40;Vallès Occidental;08279;Terrassa;6;20;U;;759;396;363;1;5;390;395
8;Barcelona;40;Vallès Occidental;08279;Terrassa;6;21;U;;595;320;275;1;1;318;319
8;Barcelona;40;Vallès Occidental;08279;Terrassa;6;22;A;;782;361;421;3;1;357;358
8;Barcelona;40;Vallès Occidental;08279;Terrassa;6;22;B;;955;400;555;4;3;393;396
8;Barcelona;40;Vallès Occidental;08279;Terrassa;6;23;A;;485;224;261;3;5;216;221
8;Barcelona;40;Vallès Occidental;08279;Terrassa;6;23;B;;722;299;423;3;0;296;296
8;Barcelona;40;Vallès Occidental;08279;Terrassa;6;24;A;;766;343;423;10;3;330;333
8;Barcelona;40;Vallès Occidental;08279;Terrassa;6;24;B;;1058;420;638;5;7;408;415
8;Barcelona;40;Vallès Occidental;08279;Terrassa;6;3;A;;649;280;369;1;5;274;279
8;Barcelona;40;Vallès Occidental;08279;Terrassa;6;3;B;;909;382;527;0;8;374;382
8;Barcelona;40;Vallès Occidental;08279;Terrassa;6;4;A;;352;188;164;0;6;182;188
8;Barcelona;40;Vallès Occidental;08279;Terrassa;6;4;B;;474;209;265;0;10;199;209
8;Barcelona;40;Vallès Occidental;08279;Terrassa;6;5;U;;739;302;437;2;2;298;300
8;Barcelona;40;Vallès Occidental;08279;Terrassa;6;6;U;;604;296;308;18;2;276;278
8;Barcelona;40;Vallès Occidental;08279;Terrassa;6;8;A;;618;294;324;0;4;290;294
8;Barcelona;40;Vallès Occidental;08279;Terrassa;6;8;B;;828;413;415;1;6;406;412
8;Barcelona;40;Vallès Occidental;08279;Terrassa;6;9;A;;550;234;316;0;2;232;234
8;Barcelona;40;Vallès Occidental;08279;Terrassa;6;9;B;;769;317;452;0;3;314;317
8;Barcelona;40;Vallès Occidental;08279;Terrassa;6;9;C;;762;308;454;3;10;295;305
8;Barcelona;21;Maresme;08282;Tiana;1;1;A;;396;264;132;1;2;261;263
8;Barcelona;21;Maresme;08282;Tiana;1;1;B;;457;290;167;2;0;288;288
8;Barcelona;21;Maresme;08282;Tiana;1;2;A;;530;344;186;2;3;339;342
8;Barcelona;21;Maresme;08282;Tiana;1;2;B;;708;440;268;1;7;432;439
8;Barcelona;21;Maresme;08282;Tiana;1;3;A;;695;434;261;0;6;428;434
8;Barcelona;21;Maresme;08282;Tiana;1;3;B;;689;446;243;1;4;441;445
25;Lleida;26;Pallars Sobirà;25221;Tírvia;1;1;U;;95;60;35;0;3;57;60
25;Lleida;23;Noguera;25222;Tiurana;1;1;U;;206;130;76;2;0;128;128
43;Tarragona;9;Baix Ebre;43149;Tivenys;1;1;U;;863;621;242;4;0;617;617
43;Tarragona;30;Ribera d'Ebre;43150;Tivissa;1;1;A;;1173;762;411;8;11;743;754
43;Tarragona;30;Ribera d'Ebre;43150;Tivissa;1;1;B;;279;176;103;0;4;172;176
8;Barcelona;24;Osona;08283;Tona;1;1;A;;480;321;159;1;1;319;320
8;Barcelona;24;Osona;08283;Tona;1;1;B;;578;398;180;2;1;395;396
8;Barcelona;24;Osona;08283;Tona;1;2;A;;850;579;271;1;9;569;578
8;Barcelona;24;Osona;08283;Tona;1;2;B;;1063;696;367;5;12;679;691
8;Barcelona;24;Osona;08283;Tona;1;3;A;;628;419;209;0;4;415;419
8;Barcelona;24;Osona;08283;Tona;1;3;B;;631;457;174;5;3;449;452
25;Lleida;32;Segarra;25223;Torà;1;1;U;;941;605;336;4;5;596;601
8;Barcelona;21;Maresme;08284;Tordera;1;1;A;;660;472;188;1;1;470;471
8;Barcelona;21;Maresme;08284;Tordera;1;1;B;;886;657;229;2;4;651;655
8;Barcelona;21;Maresme;08284;Tordera;1;2;A;;617;395;222;0;5;390;395
8;Barcelona;21;Maresme;08284;Tordera;1;2;B;;837;537;300;1;2;534;536
8;Barcelona;21;Maresme;08284;Tordera;1;3;A;;392;256;136;0;1;255;256
8;Barcelona;21;Maresme;08284;Tordera;1;3;B;;545;351;194;1;1;349;350
8;Barcelona;21;Maresme;08284;Tordera;2;1;A;;739;466;273;2;3;461;464
8;Barcelona;21;Maresme;08284;Tordera;2;1;B;;881;546;335;1;6;539;545
8;Barcelona;21;Maresme;08284;Tordera;2;2;A;;354;203;151;2;2;199;201
8;Barcelona;21;Maresme;08284;Tordera;2;2;B;;456;250;206;1;2;247;249
8;Barcelona;24;Osona;08285;Torelló;1;1;A;;477;299;178;1;1;297;298
8;Barcelona;24;Osona;08285;Torelló;1;1;B;;548;331;217;2;0;329;329
8;Barcelona;24;Osona;08285;Torelló;1;2;U;;1352;879;473;2;6;871;877
8;Barcelona;24;Osona;08285;Torelló;1;3;U;;884;613;271;0;9;604;613
8;Barcelona;24;Osona;08285;Torelló;1;4;U;;982;579;403;0;7;572;579
8;Barcelona;24;Osona;08285;Torelló;2;1;U;;864;517;347;4;1;512;513
8;Barcelona;24;Osona;08285;Torelló;2;2;U;;982;614;368;0;10;604;614
8;Barcelona;24;Osona;08285;Torelló;2;3;A;;478;290;188;3;0;287;287
8;Barcelona;24;Osona;08285;Torelló;2;3;B;;563;339;224;2;0;337;337
8;Barcelona;24;Osona;08285;Torelló;2;4;U;;982;561;421;2;0;559;559
8;Barcelona;24;Osona;08285;Torelló;2;5;A;;492;311;181;0;7;304;311
8;Barcelona;24;Osona;08285;Torelló;2;5;B;;666;409;257;3;0;406;406
25;Lleida;18;Garrigues;25224;Torms, els;1;1;U;;178;120;58;0;2;118;120
25;Lleida;38;Urgell;25225;Tornabous;1;1;U;;767;519;248;3;9;507;516
25;Lleida;33;Segrià;25226;Torrebesses;1;1;U;;306;190;116;1;2;187;189
25;Lleida;25;Pallars Jussà;25227;Torre de Cabdella, la;1;1;U;;639;377;262;3;8;366;374
8;Barcelona;6;Anoia;08286;Torre de Claramunt, la;1;1;U;;1300;764;536;2;0;762;762
43;Tarragona;29;Priorat;43151;Torre de Fontaubella, la;1;1;U;;57;35;22;1;1;33;34
43;Tarragona;30;Ribera d'Ebre;43152;Torre de l'Espanyol, la;1;1;U;;614;487;127;2;4;481;485
43;Tarragona;36;Tarragonès;43153;Torredembarra;1;1;A;;807;489;318;1;7;481;488
43;Tarragona;36;Tarragonès;43153;Torredembarra;1;1;B;;1047;613;434;0;11;602;613
43;Tarragona;36;Tarragonès;43153;Torredembarra;1;2;A;;868;479;389;1;5;473;478
43;Tarragona;36;Tarragonès;43153;Torredembarra;1;2;B;;1050;618;432;4;3;611;614
43;Tarragona;36;Tarragonès;43153;Torredembarra;1;3;U;;762;427;335;3;0;424;424
43;Tarragona;36;Tarragonès;43153;Torredembarra;1;4;U;;628;349;279;1;4;344;348
25;Lleida;33;Segrià;25228;Torrefarrera;1;1;U;;1141;792;349;3;5;784;789
25;Lleida;32;Segarra;25907;Torrefeta i Florejacs;1;1;U;;632;394;238;3;4;387;391
25;Lleida;27;Pla d'Urgell;25230;Torregrossa;1;1;U;;630;478;152;4;2;472;474
25;Lleida;27;Pla d'Urgell;25230;Torregrossa;1;2;A;;601;435;166;7;1;427;428
25;Lleida;27;Pla d'Urgell;25230;Torregrossa;1;2;B;;613;450;163;2;0;448;448
25;Lleida;23;Noguera;25231;Torrelameu;1;1;U;;493;340;153;1;3;336;339
8;Barcelona;3;Alt Penedès;08287;Torrelavit;1;1;U;;907;603;304;4;7;592;599
8;Barcelona;3;Alt Penedès;08288;Torrelles de Foix;1;1;U;;1052;629;423;6;3;620;623
8;Barcelona;11;Baix Llobregat;08289;Torrelles de Llobregat;1;1;A;;751;422;329;0;1;421;422
8;Barcelona;11;Baix Llobregat;08289;Torrelles de Llobregat;1;1;B;;968;596;372;2;3;591;594
17;Girona;10;Baix Empordà;17197;Torrent;1;1;U;;144;87;57;0;0;87;87
25;Lleida;33;Segrià;25232;Torres de Segre;1;1;A;;721;466;255;0;5;461;466
25;Lleida;33;Segrià;25232;Torres de Segre;1;1;B;;804;493;311;5;4;484;488
25;Lleida;33;Segrià;25233;Torre-serona;1;1;U;;242;163;79;0;1;162;163
17;Girona;2;Alt Empordà;17198;Torroella de Fluvià;1;1;U;;245;149;96;0;2;147;149
17;Girona;10;Baix Empordà;17199;Torroella de Montgrí;1;1;A;;515;346;169;0;6;340;346
17;Girona;10;Baix Empordà;17199;Torroella de Montgrí;1;1;B;;367;226;141;5;6;215;221
17;Girona;10;Baix Empordà;17199;Torroella de Montgrí;1;1;C;;490;305;185;2;4;299;303
17;Girona;10;Baix Empordà;17199;Torroella de Montgrí;1;2;A;;657;393;264;2;5;386;391
17;Girona;10;Baix Empordà;17199;Torroella de Montgrí;1;2;B;;449;252;197;2;8;242;250
17;Girona;10;Baix Empordà;17199;Torroella de Montgrí;1;2;C;;661;422;239;0;6;416;422
17;Girona;10;Baix Empordà;17199;Torroella de Montgrí;1;3;U;;952;559;393;1;9;549;558
17;Girona;10;Baix Empordà;17199;Torroella de Montgrí;1;4;U;;1075;617;458;3;5;609;614
43;Tarragona;29;Priorat;43154;Torroja del Priorat;1;1;U;;114;88;26;1;0;87;87
17;Girona;19;Garrotxa;17200;Tortellà;1;1;U;;590;402;188;3;5;394;399
43;Tarragona;9;Baix Ebre;43155;Tortosa;1;1;U;;945;510;435;9;14;487;501
43;Tarragona;9;Baix Ebre;43155;Tortosa;1;2;U;;527;323;204;2;9;312;321
43;Tarragona;9;Baix Ebre;43155;Tortosa;1;3;A;;658;399;259;8;17;374;391
43;Tarragona;9;Baix Ebre;43155;Tortosa;1;3;B;;588;348;240;4;7;337;344
43;Tarragona;9;Baix Ebre;43155;Tortosa;1;4;A;;653;352;301;0;6;346;352
43;Tarragona;9;Baix Ebre;43155;Tortosa;1;4;B;;611;353;258;7;12;334;346
43;Tarragona;9;Baix Ebre;43155;Tortosa;1;5;U;;608;289;319;3;5;281;286
43;Tarragona;9;Baix Ebre;43155;Tortosa;1;6;U;;1074;625;449;8;18;599;617
43;Tarragona;9;Baix Ebre;43155;Tortosa;1;7;U;;895;517;378;4;14;499;513
43;Tarragona;9;Baix Ebre;43155;Tortosa;2;1;U;;896;401;495;7;7;387;394
43;Tarragona;9;Baix Ebre;43155;Tortosa;2;2;U;;609;303;306;9;8;286;294
43;Tarragona;9;Baix Ebre;43155;Tortosa;2;3;A;;742;407;335;9;16;382;398
43;Tarragona;9;Baix Ebre;43155;Tortosa;2;3;B;;714;358;356;2;16;340;356
43;Tarragona;9;Baix Ebre;43155;Tortosa;2;4;U;;799;378;421;7;22;349;371
43;Tarragona;9;Baix Ebre;43155;Tortosa;2;5;U;;859;585;274;257;7;321;328
43;Tarragona;9;Baix Ebre;43155;Tortosa;3;1;U;;1163;519;644;7;18;494;512
43;Tarragona;9;Baix Ebre;43155;Tortosa;3;2;U;;967;499;468;4;4;491;495
43;Tarragona;9;Baix Ebre;43155;Tortosa;3;3;A;;545;246;299;2;2;242;244
43;Tarragona;9;Baix Ebre;43155;Tortosa;3;3;B;;514;241;273;0;7;234;241
43;Tarragona;9;Baix Ebre;43155;Tortosa;3;4;U;;1053;492;561;5;11;476;487
43;Tarragona;9;Baix Ebre;43155;Tortosa;4;1;A;;853;373;480;0;17;356;373
43;Tarragona;9;Baix Ebre;43155;Tortosa;4;1;B;;716;376;340;3;16;357;373
43;Tarragona;9;Baix Ebre;43155;Tortosa;4;2;A;;500;258;242;1;8;249;257
43;Tarragona;9;Baix Ebre;43155;Tortosa;4;2;B;;414;198;216;2;7;189;196
43;Tarragona;9;Baix Ebre;43155;Tortosa;4;2;C;;467;227;240;2;5;220;225
43;Tarragona;9;Baix Ebre;43155;Tortosa;4;3;U;;1460;527;933;2;13;512;525
43;Tarragona;9;Baix Ebre;43155;Tortosa;4;4;A;;553;275;278;3;7;265;272
43;Tarragona;9;Baix Ebre;43155;Tortosa;4;4;B;;493;266;227;1;4;261;265
43;Tarragona;9;Baix Ebre;43155;Tortosa;4;5;U;;838;446;392;3;7;436;443
43;Tarragona;9;Baix Ebre;43155;Tortosa;4;6;U;;764;426;338;2;5;419;424
43;Tarragona;9;Baix Ebre;43155;Tortosa;4;7;A;;484;293;191;1;18;274;292
43;Tarragona;9;Baix Ebre;43155;Tortosa;4;7;B;;279;135;144;1;4;130;134
17;Girona;31;Ripollès;17201;Toses;1;1;U;;152;92;60;2;0;90;90
17;Girona;34;Selva;17202;Tossa de Mar;1;1;U;;873;526;347;7;4;515;519
17;Girona;34;Selva;17202;Tossa de Mar;1;2;U;;788;494;294;1;8;485;493
17;Girona;34;Selva;17202;Tossa de Mar;1;3;U;;1228;788;440;8;8;772;780
25;Lleida;25;Pallars Jussà;25234;Tremp;1;1;U;;932;578;354;8;4;566;570
25;Lleida;25;Pallars Jussà;25234;Tremp;1;2;U;;858;524;334;4;3;517;520
25;Lleida;25;Pallars Jussà;25234;Tremp;2;1;U;;1133;778;355;0;8;770;778
25;Lleida;25;Pallars Jussà;25234;Tremp;2;2;U;;1010;613;397;4;8;601;609
25;Lleida;25;Pallars Jussà;25234;Tremp;3;1;U;;558;300;258;0;2;298;300
17;Girona;10;Baix Empordà;17204;Ullà;1;1;U;;590;349;241;6;0;343;343
8;Barcelona;40;Vallès Occidental;08290;Ullastrell;1;1;U;;738;587;151;4;11;572;583
17;Girona;10;Baix Empordà;17205;Ullastret;1;1;U;;224;148;76;0;0;148;148
43;Tarragona;22;Montsià;43156;Ulldecona;1;1;U;;843;574;269;0;18;556;574
43;Tarragona;22;Montsià;43156;Ulldecona;1;2;A;;743;493;250;11;5;477;482
43;Tarragona;22;Montsià;43156;Ulldecona;1;2;B;;838;596;242;14;3;579;582
43;Tarragona;22;Montsià;43156;Ulldecona;2;1;U;;605;420;185;4;3;413;416
43;Tarragona;22;Montsià;43156;Ulldecona;2;2;U;;683;490;193;7;0;483;483
43;Tarragona;22;Montsià;43156;Ulldecona;3;1;U;;513;286;227;0;6;280;286
43;Tarragona;29;Priorat;43157;Ulldemolins;1;1;U;;473;285;188;3;2;280;282
17;Girona;10;Baix Empordà;17203;Ultramort;1;1;U;;173;117;56;2;0;115;115
17;Girona;15;Cerdanya;17206;Urús;1;1;U;;101;78;23;0;1;77;78
8;Barcelona;40;Vallès Occidental;08291;Vacarisses;1;1;U;;704;479;225;6;12;461;473
17;Girona;2;Alt Empordà;17014;Vajol, la;1;1;U;;60;40;20;0;1;39;40
8;Barcelona;6;Anoia;08292;Vallbona d'Anoia;1;1;U;;821;622;199;6;3;613;616
25;Lleida;38;Urgell;25238;Vallbona de les Monges;1;1;U;;266;164;102;4;1;159;160
8;Barcelona;14;Berguedà;08293;Vallcebre;1;1;U;;272;160;112;0;1;159;160
43;Tarragona;16;Conca de Barberà;43158;Vallclara;1;1;U;;88;63;25;1;1;61;62
17;Girona;19;Garrotxa;17207;Vall d'en Bas, la;1;1;A;;801;578;223;1;15;562;577
17;Girona;19;Garrotxa;17207;Vall d'en Bas, la;1;1;B;;235;177;58;1;3;173;176
17;Girona;19;Garrotxa;17207;Vall d'en Bas, la;1;2;A;;802;520;282;12;10;498;508
17;Girona;19;Garrotxa;17207;Vall d'en Bas, la;1;2;B;;245;169;76;0;2;167;169
17;Girona;19;Garrotxa;17208;Vall de Bianya, la;1;1;A;;448;330;118;2;4;324;328
17;Girona;19;Garrotxa;17208;Vall de Bianya, la;1;1;B;;446;324;122;1;10;313;323
25;Lleida;5;Alta Ribagorça;25043;Vall de Boí, la;1;1;U;;502;236;266;6;0;230;230
25;Lleida;26;Pallars Sobirà;25901;Vall de Cardós;1;1;U;;272;185;87;0;4;181;185
25;Lleida;23;Noguera;25240;Vallfogona de Balaguer;1;1;A;;752;490;262;3;4;483;487
25;Lleida;23;Noguera;25240;Vallfogona de Balaguer;1;1;B;;388;233;155;0;2;231;233
17;Girona;31;Ripollès;17170;Vallfogona de Ripollès;1;1;U;;202;134;68;0;3;131;134
43;Tarragona;16;Conca de Barberà;43159;Vallfogona de Riucorb;1;1;U;;105;76;29;2;0;74;74
8;Barcelona;41;Vallès Oriental;08294;Vallgorguina;1;1;U;;624;401;223;4;7;390;397
8;Barcelona;11;Baix Llobregat;08295;Vallirana;1;1;A;;557;353;204;0;2;351;353
8;Barcelona;11;Baix Llobregat;08295;Vallirana;1;1;B;;520;345;175;1;6;338;344
8;Barcelona;11;Baix Llobregat;08295;Vallirana;1;2;A;;558;360;198;2;2;356;358
8;Barcelona;11;Baix Llobregat;08295;Vallirana;1;2;B;;584;359;225;0;1;358;359
8;Barcelona;11;Baix Llobregat;08295;Vallirana;1;3;A;;384;237;147;0;5;232;237
8;Barcelona;11;Baix Llobregat;08295;Vallirana;1;3;B;;338;218;120;0;4;214;218
8;Barcelona;11;Baix Llobregat;08295;Vallirana;1;4;A;;673;340;333;1;5;334;339
8;Barcelona;11;Baix Llobregat;08295;Vallirana;1;4;B;;600;300;300;2;5;293;298
8;Barcelona;11;Baix Llobregat;08295;Vallirana;1;5;U;;562;245;317;0;2;243;245
17;Girona;10;Baix Empordà;17209;Vall-llobrega;1;1;U;;186;139;47;0;4;135;139
43;Tarragona;1;Alt Camp;43160;Vallmoll;1;1;A;;357;251;106;1;1;249;250
43;Tarragona;1;Alt Camp;43160;Vallmoll;1;1;B;;438;297;141;4;3;290;293
8;Barcelona;41;Vallès Oriental;08296;Vallromanes;1;1;U;;501;325;176;0;4;321;325
43;Tarragona;1;Alt Camp;43161;Valls;1;1;A;;547;322;225;3;4;315;319
43;Tarragona;1;Alt Camp;43161;Valls;1;1;B;;572;327;245;0;2;325;327
43;Tarragona;1;Alt Camp;43161;Valls;2;1;A;;426;229;197;1;2;226;228
43;Tarragona;1;Alt Camp;43161;Valls;2;1;B;;576;327;249;2;2;323;325
43;Tarragona;1;Alt Camp;43161;Valls;3;1;A;;795;494;301;3;4;487;491
43;Tarragona;1;Alt Camp;43161;Valls;3;1;B;;976;534;442;2;4;528;532
43;Tarragona;1;Alt Camp;43161;Valls;4;1;U;;897;599;298;4;5;590;595
43;Tarragona;1;Alt Camp;43161;Valls;4;2;A;;1568;836;732;10;8;818;826
43;Tarragona;1;Alt Camp;43161;Valls;4;2;B;;397;278;119;1;7;270;277
43;Tarragona;1;Alt Camp;43161;Valls;5;1;A;;836;602;234;3;3;596;599
43;Tarragona;1;Alt Camp;43161;Valls;5;1;B;;1039;708;331;3;5;700;705
43;Tarragona;1;Alt Camp;43161;Valls;5;2;A;;545;370;175;2;1;367;368
43;Tarragona;1;Alt Camp;43161;Valls;5;2;B;;511;307;204;1;2;304;306
43;Tarragona;1;Alt Camp;43161;Valls;5;2;C;;630;409;221;0;3;406;409
43;Tarragona;1;Alt Camp;43161;Valls;5;3;U;;676;341;335;5;1;335;336
43;Tarragona;1;Alt Camp;43161;Valls;6;1;A;;782;458;324;0;4;454;458
43;Tarragona;1;Alt Camp;43161;Valls;6;1;B;;905;522;383;0;6;516;522
43;Tarragona;1;Alt Camp;43161;Valls;6;2;U;;851;514;337;2;7;505;512
43;Tarragona;1;Alt Camp;43161;Valls;6;3;A;;571;334;237;0;8;326;334
43;Tarragona;1;Alt Camp;43161;Valls;6;3;B;;648;420;228;1;13;406;419
43;Tarragona;1;Alt Camp;43161;Valls;6;4;U;;966;566;400;5;8;553;561
25;Lleida;4;Alt Urgell;25906;Valls d'Aguilar, les;1;1;U;;193;101;92;0;1;100;101
25;Lleida;4;Alt Urgell;25239;Valls de Valira, les;1;1;U;;636;290;346;0;2;288;290
43;Tarragona;8;Baix Camp;43162;Vandellòs i l'Hospitalet de l'Infant;1;1;U;;938;606;332;1;6;599;605
43;Tarragona;8;Baix Camp;43162;Vandellòs i l'Hospitalet de l'Infant;1;2;U;;1635;811;824;10;20;781;801
43;Tarragona;8;Baix Camp;43162;Vandellòs i l'Hospitalet de l'Infant;1;3;U;;816;497;319;3;4;490;494
25;Lleida;4;Alt Urgell;25909;Vansa i Fórnols, la;1;1;U;;137;69;68;0;1;68;69
8;Barcelona;6;Anoia;08297;Veciana;1;1;U;;153;96;57;0;0;96;96
43;Tarragona;12;Baix Penedès;43163;Vendrell, el;1;1;A;;504;341;163;1;0;340;340
43;Tarragona;12;Baix Penedès;43163;Vendrell, el;1;1;B;;553;360;193;2;2;356;358
43;Tarragona;12;Baix Penedès;43163;Vendrell, el;1;2;U;;877;535;342;1;0;534;534
43;Tarragona;12;Baix Penedès;43163;Vendrell, el;2;1;U;;909;551;358;0;7;544;551
43;Tarragona;12;Baix Penedès;43163;Vendrell, el;2;2;A;;516;339;177;0;4;335;339
43;Tarragona;12;Baix Penedès;43163;Vendrell, el;2;2;B;;737;458;279;3;1;454;455
43;Tarragona;12;Baix Penedès;43163;Vendrell, el;2;3;A;;751;388;363;1;2;385;387
43;Tarragona;12;Baix Penedès;43163;Vendrell, el;2;3;B;;957;509;448;3;4;502;506
43;Tarragona;12;Baix Penedès;43163;Vendrell, el;3;1;A;;721;462;259;1;6;455;461
43;Tarragona;12;Baix Penedès;43163;Vendrell, el;3;1;B;;920;588;332;2;1;585;586
43;Tarragona;12;Baix Penedès;43163;Vendrell, el;3;2;A;;760;394;366;0;6;388;394
43;Tarragona;12;Baix Penedès;43163;Vendrell, el;3;2;B;;871;483;388;1;7;475;482
43;Tarragona;12;Baix Penedès;43163;Vendrell, el;3;3;A;;675;309;366;4;1;304;305
43;Tarragona;12;Baix Penedès;43163;Vendrell, el;3;3;B;;776;347;429;5;6;336;342
43;Tarragona;12;Baix Penedès;43163;Vendrell, el;3;4;U;;983;603;380;6;7;590;597
17;Girona;2;Alt Empordà;17210;Ventalló;1;1;U;;427;267;160;1;2;264;266
25;Lleida;38;Urgell;25242;Verdú;1;1;U;;798;510;288;6;1;503;504
17;Girona;10;Baix Empordà;17211;Verges;1;1;U;;940;641;299;4;7;630;637
43;Tarragona;36;Tarragonès;43164;Vespella de Gaià;1;1;U;;77;55;22;0;1;54;55
8;Barcelona;24;Osona;08298;Vic;1;1;U;;644;403;241;3;2;398;400
8;Barcelona;24;Osona;08298;Vic;1;2;U;;831;457;374;2;8;447;455
8;Barcelona;24;Osona;08298;Vic;1;3;U;;689;453;236;4;3;446;449
8;Barcelona;24;Osona;08298;Vic;2;1;U;;812;518;294;2;6;510;516
8;Barcelona;24;Osona;08298;Vic;2;2;A;;645;442;203;0;5;437;442
8;Barcelona;24;Osona;08298;Vic;2;2;B;;791;553;238;1;10;542;552
8;Barcelona;24;Osona;08298;Vic;2;3;A;;631;400;231;4;0;396;396
8;Barcelona;24;Osona;08298;Vic;2;3;B;;852;574;278;4;6;564;570
8;Barcelona;24;Osona;08298;Vic;2;4;A;;636;451;185;2;4;445;449
8;Barcelona;24;Osona;08298;Vic;2;4;B;;826;569;257;2;5;562;567
8;Barcelona;24;Osona;08298;Vic;3;1;A;;655;457;198;3;7;447;454
8;Barcelona;24;Osona;08298;Vic;3;1;B;;658;472;186;3;5;464;469
8;Barcelona;24;Osona;08298;Vic;3;10;U;;513;317;196;3;5;309;314
8;Barcelona;24;Osona;08298;Vic;3;11;U;;947;523;424;0;7;516;523
8;Barcelona;24;Osona;08298;Vic;3;2;U;;973;626;347;2;11;613;624
8;Barcelona;24;Osona;08298;Vic;3;3;A;;603;370;233;1;4;365;369
8;Barcelona;24;Osona;08298;Vic;3;3;B;;773;468;305;1;5;462;467
8;Barcelona;24;Osona;08298;Vic;3;4;U;;919;612;307;2;1;609;610
8;Barcelona;24;Osona;08298;Vic;3;5;A;;598;349;249;3;4;342;346
8;Barcelona;24;Osona;08298;Vic;3;5;B;;644;379;265;2;3;374;377
8;Barcelona;24;Osona;08298;Vic;3;6;A;;472;295;177;0;3;292;295
8;Barcelona;24;Osona;08298;Vic;3;6;B;;594;342;252;4;5;333;338
8;Barcelona;24;Osona;08298;Vic;3;7;A;;568;388;180;1;6;381;387
8;Barcelona;24;Osona;08298;Vic;3;7;B;;661;448;213;0;7;441;448
8;Barcelona;24;Osona;08298;Vic;3;8;A;;549;305;244;1;4;300;304
8;Barcelona;24;Osona;08298;Vic;3;8;B;;585;349;236;1;3;345;348
8;Barcelona;24;Osona;08298;Vic;3;9;U;;671;470;201;0;2;468;470
8;Barcelona;24;Osona;08298;Vic;4;1;A;;652;418;234;1;6;411;417
8;Barcelona;24;Osona;08298;Vic;4;1;B;;761;479;282;5;7;467;474
8;Barcelona;24;Osona;08298;Vic;4;2;A;;664;418;246;24;2;392;394
8;Barcelona;24;Osona;08298;Vic;4;2;B;;842;567;275;11;8;548;556
8;Barcelona;24;Osona;08298;Vic;4;3;A;;546;334;212;3;4;327;331
8;Barcelona;24;Osona;08298;Vic;4;3;B;;779;482;297;3;8;471;479
8;Barcelona;24;Osona;08298;Vic;5;1;U;;508;358;150;0;4;354;358
17;Girona;24;Osona;17212;Vidrà;1;1;U;;152;91;61;0;0;91;91
17;Girona;34;Selva;17213;Vidreres;1;1;A;;653;467;186;0;0;467;467
17;Girona;34;Selva;17213;Vidreres;1;1;B;;679;463;216;0;4;459;463
17;Girona;34;Selva;17213;Vidreres;1;2;U;;762;484;278;0;4;480;484
17;Girona;34;Selva;17213;Vidreres;1;3;U;;882;519;363;5;5;509;514
25;Lleida;39;Consell General d'Aran;25243;Vielha e Mijaran;1;1;A;;836;452;384;9;6;437;443
25;Lleida;39;Consell General d'Aran;25243;Vielha e Mijaran;1;1;B;;909;486;423;8;7;471;478
25;Lleida;39;Consell General d'Aran;25243;Vielha e Mijaran;1;2;A;;277;185;92;0;2;183;185
25;Lleida;39;Consell General d'Aran;25243;Vielha e Mijaran;1;2;B;;340;161;179;0;2;159;161
25;Lleida;39;Consell General d'Aran;25243;Vielha e Mijaran;1;2;C;;263;129;134;0;1;128;129
43;Tarragona;1;Alt Camp;43165;Vilabella;1;1;U;;672;515;157;4;5;506;511
17;Girona;2;Alt Empordà;17214;Vilabertran;1;1;U;;637;383;254;3;4;376;380
17;Girona;20;Gironès;17215;Vilablareix;1;1;U;;759;507;252;3;3;501;504
8;Barcelona;14;Berguedà;08299;Vilada;1;1;U;;484;305;179;1;5;299;304
17;Girona;2;Alt Empordà;17217;Viladamat;1;1;U;;307;230;77;0;2;228;230
17;Girona;20;Gironès;17216;Viladasens;1;1;U;;160;114;46;0;2;112;114
8;Barcelona;11;Baix Llobregat;08301;Viladecans;1;1;A;;765;358;407;0;1;357;358
8;Barcelona;11;Baix Llobregat;08301;Viladecans;1;1;B;;944;431;513;1;3;427;430
8;Barcelona;11;Baix Llobregat;08301;Viladecans;1;10;A;;592;282;310;3;6;273;279
8;Barcelona;11;Baix Llobregat;08301;Viladecans;1;10;B;;691;354;337;3;3;348;351
8;Barcelona;11;Baix Llobregat;08301;Viladecans;1;11;U;;1383;626;757;5;6;615;621
8;Barcelona;11;Baix Llobregat;08301;Viladecans;1;2;A;;584;255;329;1;1;253;254
8;Barcelona;11;Baix Llobregat;08301;Viladecans;1;2;B;;719;302;417;2;9;291;300
8;Barcelona;11;Baix Llobregat;08301;Viladecans;1;3;A;;616;317;299;0;4;313;317
8;Barcelona;11;Baix Llobregat;08301;Viladecans;1;3;B;;659;324;335;2;3;319;322
8;Barcelona;11;Baix Llobregat;08301;Viladecans;1;4;U;;1136;514;622;1;6;507;513
8;Barcelona;11;Baix Llobregat;08301;Viladecans;1;5;U;;534;311;223;1;0;310;310
8;Barcelona;11;Baix Llobregat;08301;Viladecans;1;6;A;;633;270;363;4;1;265;266
8;Barcelona;11;Baix Llobregat;08301;Viladecans;1;6;B;;718;337;381;2;3;332;335
8;Barcelona;11;Baix Llobregat;08301;Viladecans;1;7;U;;1113;539;574;2;3;534;537
8;Barcelona;11;Baix Llobregat;08301;Viladecans;1;8;A;;737;376;361;0;3;373;376
8;Barcelona;11;Baix Llobregat;08301;Viladecans;1;8;B;;964;441;523;4;1;436;437
8;Barcelona;11;Baix Llobregat;08301;Viladecans;1;9;U;;905;436;469;1;4;431;435
8;Barcelona;11;Baix Llobregat;08301;Viladecans;2;1;A;;661;269;392;2;1;266;267
8;Barcelona;11;Baix Llobregat;08301;Viladecans;2;1;B;;887;369;518;3;4;362;366
8;Barcelona;11;Baix Llobregat;08301;Viladecans;2;10;U;;1141;475;666;0;9;466;475
8;Barcelona;11;Baix Llobregat;08301;Viladecans;2;11;U;;1143;372;771;0;3;369;372
8;Barcelona;11;Baix Llobregat;08301;Viladecans;2;12;U;;1146;486;660;0;10;476;486
8;Barcelona;11;Baix Llobregat;08301;Viladecans;2;13;A;;541;237;304;0;1;236;237
8;Barcelona;11;Baix Llobregat;08301;Viladecans;2;13;B;;651;273;378;0;1;272;273
8;Barcelona;11;Baix Llobregat;08301;Viladecans;2;14;U;;746;266;480;1;8;257;265
8;Barcelona;11;Baix Llobregat;08301;Viladecans;2;15;A;;681;254;427;0;2;252;254
8;Barcelona;11;Baix Llobregat;08301;Viladecans;2;15;B;;817;300;517;0;2;298;300
8;Barcelona;11;Baix Llobregat;08301;Viladecans;2;16;U;;1088;524;564;1;3;520;523
8;Barcelona;11;Baix Llobregat;08301;Viladecans;2;17;U;;1184;405;779;2;7;396;403
8;Barcelona;11;Baix Llobregat;08301;Viladecans;2;2;A;;716;268;448;0;1;267;268
8;Barcelona;11;Baix Llobregat;08301;Viladecans;2;2;B;;812;315;497;0;1;314;315
8;Barcelona;11;Baix Llobregat;08301;Viladecans;2;2;C;;879;315;564;0;3;312;315
8;Barcelona;11;Baix Llobregat;08301;Viladecans;2;3;A;;623;277;346;3;6;268;274
8;Barcelona;11;Baix Llobregat;08301;Viladecans;2;3;B;;811;378;433;0;2;376;378
8;Barcelona;11;Baix Llobregat;08301;Viladecans;2;4;U;;762;305;457;4;0;301;301
8;Barcelona;11;Baix Llobregat;08301;Viladecans;2;5;A;;576;297;279;1;3;293;296
8;Barcelona;11;Baix Llobregat;08301;Viladecans;2;5;B;;748;378;370;1;7;370;377
8;Barcelona;11;Baix Llobregat;08301;Viladecans;2;6;A;;491;232;259;3;1;228;229
8;Barcelona;11;Baix Llobregat;08301;Viladecans;2;6;B;;691;318;373;2;3;313;316
8;Barcelona;11;Baix Llobregat;08301;Viladecans;2;6;C;;668;291;377;1;0;290;290
8;Barcelona;11;Baix Llobregat;08301;Viladecans;2;7;A;;535;245;290;0;6;239;245
8;Barcelona;11;Baix Llobregat;08301;Viladecans;2;7;B;;682;313;369;0;5;308;313
8;Barcelona;11;Baix Llobregat;08301;Viladecans;2;8;A;;603;264;339;2;5;257;262
8;Barcelona;11;Baix Llobregat;08301;Viladecans;2;8;B;;756;334;422;2;6;326;332
8;Barcelona;11;Baix Llobregat;08301;Viladecans;2;9;U;;1212;448;764;0;4;444;448
8;Barcelona;40;Vallès Occidental;08300;Viladecavalls;1;1;U;;1238;709;529;7;6;696;702
8;Barcelona;40;Vallès Occidental;08300;Viladecavalls;1;2;U;;1282;582;700;5;13;564;577
17;Girona;28;Pla de l'Estany;17218;Vilademuls;1;1;A;;317;209;108;7;1;201;202
17;Girona;28;Pla de l'Estany;17218;Vilademuls;1;1;B;;340;240;100;4;1;235;236
17;Girona;24;Osona;17220;Viladrau;1;1;U;;652;533;119;17;4;512;516
17;Girona;2;Alt Empordà;17221;Vilafant;1;1;A;;614;381;233;1;5;375;380
17;Girona;2;Alt Empordà;17221;Vilafant;1;1;B;;525;272;253;2;1;269;270
17;Girona;2;Alt Empordà;17221;Vilafant;1;1;C;;889;512;377;2;3;507;510
8;Barcelona;3;Alt Penedès;08305;Vilafranca del Penedès;1;1;A;;633;401;232;1;5;395;400
8;Barcelona;3;Alt Penedès;08305;Vilafranca del Penedès;1;1;B;;916;570;346;4;5;561;566
8;Barcelona;3;Alt Penedès;08305;Vilafranca del Penedès;1;2;A;;708;425;283;5;8;412;420
8;Barcelona;3;Alt Penedès;08305;Vilafranca del Penedès;1;2;B;;825;482;343;3;7;472;479
8;Barcelona;3;Alt Penedès;08305;Vilafranca del Penedès;2;1;A;;699;390;309;3;5;382;387
8;Barcelona;3;Alt Penedès;08305;Vilafranca del Penedès;2;1;B;;864;466;398;2;7;457;464
8;Barcelona;3;Alt Penedès;08305;Vilafranca del Penedès;2;2;U;;1001;555;446;1;5;549;554
8;Barcelona;3;Alt Penedès;08305;Vilafranca del Penedès;2;3;A;;538;316;222;2;6;308;314
8;Barcelona;3;Alt Penedès;08305;Vilafranca del Penedès;2;3;B;;638;372;266;6;4;362;366
8;Barcelona;3;Alt Penedès;08305;Vilafranca del Penedès;2;4;A;;658;386;272;1;4;381;385
8;Barcelona;3;Alt Penedès;08305;Vilafranca del Penedès;2;4;B;;739;458;281;3;5;450;455
8;Barcelona;3;Alt Penedès;08305;Vilafranca del Penedès;2;5;A;;602;406;196;2;3;401;404
8;Barcelona;3;Alt Penedès;08305;Vilafranca del Penedès;2;5;B;;768;522;246;1;8;513;521
8;Barcelona;3;Alt Penedès;08305;Vilafranca del Penedès;2;6;U;;1015;562;453;1;5;556;561
8;Barcelona;3;Alt Penedès;08305;Vilafranca del Penedès;3;1;A;;835;517;318;1;4;512;516
8;Barcelona;3;Alt Penedès;08305;Vilafranca del Penedès;3;1;B;;965;603;362;1;9;593;602
8;Barcelona;3;Alt Penedès;08305;Vilafranca del Penedès;3;2;U;;851;600;251;3;6;591;597
8;Barcelona;3;Alt Penedès;08305;Vilafranca del Penedès;3;3;A;;772;416;356;1;4;411;415
8;Barcelona;3;Alt Penedès;08305;Vilafranca del Penedès;3;3;B;;892;541;351;1;4;536;540
8;Barcelona;3;Alt Penedès;08305;Vilafranca del Penedès;4;1;A;;557;374;183;3;0;371;371
8;Barcelona;3;Alt Penedès;08305;Vilafranca del Penedès;4;1;B;;631;411;220;0;4;407;411
8;Barcelona;3;Alt Penedès;08305;Vilafranca del Penedès;4;2;A;;599;394;205;2;4;388;392
8;Barcelona;3;Alt Penedès;08305;Vilafranca del Penedès;4;2;B;;755;526;229;4;5;517;522
8;Barcelona;3;Alt Penedès;08305;Vilafranca del Penedès;4;3;A;;690;420;270;2;7;411;418
8;Barcelona;3;Alt Penedès;08305;Vilafranca del Penedès;4;3;B;;743;469;274;2;3;464;467
8;Barcelona;3;Alt Penedès;08305;Vilafranca del Penedès;4;4;A;;577;381;196;3;4;374;378
8;Barcelona;3;Alt Penedès;08305;Vilafranca del Penedès;4;4;B;;684;422;262;2;6;414;420
8;Barcelona;3;Alt Penedès;08305;Vilafranca del Penedès;4;5;U;;577;381;196;1;4;376;380
8;Barcelona;3;Alt Penedès;08305;Vilafranca del Penedès;4;6;U;;936;638;298;0;4;634;638
25;Lleida;38;Urgell;25244;Vilagrassa;1;1;U;;339;239;100;1;0;238;238
17;Girona;2;Alt Empordà;17223;Vilajuïga;1;1;U;;547;380;167;2;4;374;378
43;Tarragona;37;Terra Alta;43175;Vilalba dels Arcs;1;1;U;;669;450;219;5;8;437;445
8;Barcelona;41;Vallès Oriental;08306;Vilalba Sasserra;1;1;U;;236;165;71;1;0;164;164
25;Lleida;5;Alta Ribagorça;25245;Vilaller;1;1;U;;484;292;192;1;1;290;291
43;Tarragona;36;Tarragonès;43166;Vilallonga del Camp;1;1;U;;916;611;305;2;4;605;609
17;Girona;31;Ripollès;17224;Vilallonga de Ter;1;1;U;;381;305;76;0;2;303;305
17;Girona;2;Alt Empordà;17225;Vilamacolum;1;1;U;;210;119;91;0;1;118;119
17;Girona;2;Alt Empordà;17226;Vilamalla;1;1;U;;518;310;208;1;9;300;309
17;Girona;2;Alt Empordà;17227;Vilamaniscle;1;1;U;;102;73;29;0;0;73;73
25;Lleida;39;Consell General d'Aran;25247;Vilamòs;1;1;U;;73;47;26;0;2;45;47
17;Girona;2;Alt Empordà;17228;Vilanant;1;1;U;;224;112;112;1;2;109;111
43;Tarragona;8;Baix Camp;43167;Vilanova d'Escornalbou;1;1;U;;333;232;101;2;5;225;230
25;Lleida;27;Pla d'Urgell;25248;Vilanova de Bellpuig;1;1;U;;993;679;314;16;15;648;663
25;Lleida;23;Noguera;25249;Vilanova de l'Aguda;1;1;U;;238;133;105;1;1;131;132
25;Lleida;33;Segrià;25254;Vilanova de la Barca;1;1;U;;745;475;270;1;4;470;474
8;Barcelona;6;Anoia;08302;Vilanova del Camí;1;1;A;;625;329;296;0;3;326;329
8;Barcelona;6;Anoia;08302;Vilanova del Camí;1;1;B;;724;380;344;4;3;373;376
8;Barcelona;6;Anoia;08302;Vilanova del Camí;1;2;A;;714;367;347;0;3;364;367
8;Barcelona;6;Anoia;08302;Vilanova del Camí;1;2;B;;704;369;335;0;3;366;369
8;Barcelona;6;Anoia;08302;Vilanova del Camí;1;3;A;;551;269;282;0;1;268;269
8;Barcelona;6;Anoia;08302;Vilanova del Camí;1;3;B;;614;306;308;2;3;301;304
8;Barcelona;6;Anoia;08302;Vilanova del Camí;1;4;A;;688;377;311;0;2;375;377
8;Barcelona;6;Anoia;08302;Vilanova del Camí;1;4;B;;776;385;391;1;1;383;384
8;Barcelona;6;Anoia;08302;Vilanova del Camí;1;5;A;;684;364;320;1;5;358;363
8;Barcelona;6;Anoia;08302;Vilanova del Camí;1;5;B;;710;336;374;1;5;330;335
8;Barcelona;41;Vallès Oriental;08902;Vilanova del Vallès;1;1;U;;1156;680;476;3;5;672;677
25;Lleida;23;Noguera;25250;Vilanova de Meià;1;1;U;;423;271;152;1;1;269;270
43;Tarragona;16;Conca de Barberà;43168;Vilanova de Prades;1;1;U;;129;81;48;0;1;80;81
8;Barcelona;24;Osona;08303;Vilanova de Sau;1;1;U;;268;179;89;0;2;177;179
25;Lleida;33;Segrià;25251;Vilanova de Segrià;1;1;U;;579;392;187;0;9;383;392
8;Barcelona;17;Garraf;08307;Vilanova i la Geltrú;1;1;U;;1394;769;625;2;4;763;767
8;Barcelona;17;Garraf;08307;Vilanova i la Geltrú;1;2;U;;1562;912;650;4;5;903;908
8;Barcelona;17;Garraf;08307;Vilanova i la Geltrú;1;3;A;;838;490;348;4;3;483;486
8;Barcelona;17;Garraf;08307;Vilanova i la Geltrú;1;3;B;;959;566;393;5;2;559;561
8;Barcelona;17;Garraf;08307;Vilanova i la Geltrú;1;4;U;;819;523;296;1;5;517;522
8;Barcelona;17;Garraf;08307;Vilanova i la Geltrú;1;5;U;;896;540;356;7;3;530;533
8;Barcelona;17;Garraf;08307;Vilanova i la Geltrú;1;6;U;;1291;720;571;4;2;714;716
8;Barcelona;17;Garraf;08307;Vilanova i la Geltrú;1;7;A;;656;372;284;1;3;368;371
8;Barcelona;17;Garraf;08307;Vilanova i la Geltrú;1;7;B;;764;439;325;0;1;438;439
8;Barcelona;17;Garraf;08307;Vilanova i la Geltrú;1;8;U;;1508;867;641;9;0;858;858
8;Barcelona;17;Garraf;08307;Vilanova i la Geltrú;1;9;U;;1479;744;735;5;5;734;739
8;Barcelona;17;Garraf;08307;Vilanova i la Geltrú;2;1;U;;1140;706;434;0;6;700;706
8;Barcelona;17;Garraf;08307;Vilanova i la Geltrú;2;2;A;;805;459;346;1;4;454;458
8;Barcelona;17;Garraf;08307;Vilanova i la Geltrú;2;2;B;;885;481;404;2;4;475;479
8;Barcelona;17;Garraf;08307;Vilanova i la Geltrú;2;3;U;;872;544;328;2;4;538;542
8;Barcelona;17;Garraf;08307;Vilanova i la Geltrú;2;4;A;;826;479;347;3;3;473;476
8;Barcelona;17;Garraf;08307;Vilanova i la Geltrú;2;4;B;;989;558;431;1;4;553;557
8;Barcelona;17;Garraf;08307;Vilanova i la Geltrú;2;5;U;;1683;849;834;1;6;842;848
8;Barcelona;17;Garraf;08307;Vilanova i la Geltrú;2;6;U;;1230;634;596;1;2;631;633
8;Barcelona;17;Garraf;08307;Vilanova i la Geltrú;3;1;U;;637;380;257;1;2;377;379
8;Barcelona;17;Garraf;08307;Vilanova i la Geltrú;3;2;U;;880;538;342;3;3;532;535
8;Barcelona;17;Garraf;08307;Vilanova i la Geltrú;3;3;U;;837;446;391;5;4;437;441
8;Barcelona;17;Garraf;08307;Vilanova i la Geltrú;3;4;A;;655;363;292;2;2;359;361
8;Barcelona;17;Garraf;08307;Vilanova i la Geltrú;3;4;B;;708;375;333;0;1;374;375
8;Barcelona;17;Garraf;08307;Vilanova i la Geltrú;3;5;U;;994;441;553;1;1;439;440
8;Barcelona;17;Garraf;08307;Vilanova i la Geltrú;4;1;U;;1032;644;388;0;6;638;644
8;Barcelona;17;Garraf;08307;Vilanova i la Geltrú;4;10;U;;993;535;458;3;1;531;532
8;Barcelona;17;Garraf;08307;Vilanova i la Geltrú;4;2;U;;730;428;302;0;4;424;428
8;Barcelona;17;Garraf;08307;Vilanova i la Geltrú;4;3;U;;1151;537;614;4;3;530;533
8;Barcelona;17;Garraf;08307;Vilanova i la Geltrú;4;4;A;;742;402;340;3;1;398;399
8;Barcelona;17;Garraf;08307;Vilanova i la Geltrú;4;4;B;;921;505;416;2;2;501;503
8;Barcelona;17;Garraf;08307;Vilanova i la Geltrú;4;5;A;;864;411;453;3;1;407;408
8;Barcelona;17;Garraf;08307;Vilanova i la Geltrú;4;5;B;;1051;529;522;0;9;520;529
8;Barcelona;17;Garraf;08307;Vilanova i la Geltrú;4;6;A;;741;408;333;0;1;407;408
8;Barcelona;17;Garraf;08307;Vilanova i la Geltrú;4;6;B;;945;499;446;0;3;496;499
8;Barcelona;17;Garraf;08307;Vilanova i la Geltrú;4;7;U;;660;292;368;3;0;289;289
8;Barcelona;17;Garraf;08307;Vilanova i la Geltrú;4;8;U;;1233;631;602;2;7;622;629
8;Barcelona;17;Garraf;08307;Vilanova i la Geltrú;4;9;U;;807;468;339;1;4;463;467
43;Tarragona;8;Baix Camp;43169;Vilaplana;1;1;U;;449;318;131;6;5;307;312
43;Tarragona;1;Alt Camp;43170;Vila-rodona;1;1;U;;847;526;321;5;12;509;521
17;Girona;2;Alt Empordà;17230;Vila-sacra;1;1;U;;326;211;115;1;7;203;210
25;Lleida;27;Pla d'Urgell;25252;Vila-sana;1;1;U;;444;266;178;1;22;243;265
43;Tarragona;36;Tarragonès;43171;Vila-seca;1;1;A;;712;467;245;3;2;462;464
43;Tarragona;36;Tarragonès;43171;Vila-seca;1;1;B;;428;282;146;0;0;282;282
43;Tarragona;36;Tarragonès;43171;Vila-seca;1;2;A;;468;299;169;0;2;297;299
43;Tarragona;36;Tarragonès;43171;Vila-seca;1;2;B;;607;380;227;0;8;372;380
43;Tarragona;36;Tarragonès;43171;Vila-seca;1;2;C;;656;420;236;3;5;412;417
43;Tarragona;36;Tarragonès;43171;Vila-seca;1;3;A;;395;238;157;0;4;234;238
43;Tarragona;36;Tarragonès;43171;Vila-seca;1;3;B;;544;354;190;1;5;348;353
43;Tarragona;36;Tarragonès;43171;Vila-seca;1;4;A;;392;279;113;2;8;269;277
43;Tarragona;36;Tarragonès;43171;Vila-seca;1;4;B;;488;328;160;1;2;325;327
43;Tarragona;36;Tarragonès;43171;Vila-seca;1;5;A;;543;352;191;1;2;349;351
43;Tarragona;36;Tarragonès;43171;Vila-seca;1;5;B;;649;387;262;3;12;372;384
43;Tarragona;36;Tarragonès;43171;Vila-seca;1;6;A;;643;400;243;1;0;399;399
43;Tarragona;36;Tarragonès;43171;Vila-seca;1;6;B;;711;426;285;5;4;417;421
43;Tarragona;36;Tarragonès;43171;Vila-seca;1;7;U;;654;374;280;2;0;372;372
43;Tarragona;36;Tarragonès;43171;Vila-seca;1;8;U;;620;240;380;0;3;237;240
8;Barcelona;21;Maresme;08214;Vilassar de Dalt;1;1;U;;714;426;288;4;7;415;422
8;Barcelona;21;Maresme;08214;Vilassar de Dalt;1;2;U;;838;500;338;2;3;495;498
8;Barcelona;21;Maresme;08214;Vilassar de Dalt;1;3;A;;559;316;243;3;2;311;313
8;Barcelona;21;Maresme;08214;Vilassar de Dalt;1;3;B;;532;335;197;5;1;329;330
8;Barcelona;21;Maresme;08214;Vilassar de Dalt;1;4;U;;545;329;216;2;1;326;327
8;Barcelona;21;Maresme;08214;Vilassar de Dalt;2;1;A;;746;466;280;3;6;457;463
8;Barcelona;21;Maresme;08214;Vilassar de Dalt;2;1;B;;694;460;234;1;6;453;459
8;Barcelona;21;Maresme;08214;Vilassar de Dalt;2;2;U;;770;492;278;0;0;492;492
8;Barcelona;21;Maresme;08219;Vilassar de Mar;1;1;A;;622;363;259;1;4;358;362
8;Barcelona;21;Maresme;08219;Vilassar de Mar;1;1;B;;752;454;298;0;4;450;454
8;Barcelona;21;Maresme;08219;Vilassar de Mar;1;2;A;;650;415;235;2;8;405;413
8;Barcelona;21;Maresme;08219;Vilassar de Mar;1;2;B;;874;527;347;1;8;518;526
8;Barcelona;21;Maresme;08219;Vilassar de Mar;1;3;A;;507;273;234;1;0;272;272
8;Barcelona;21;Maresme;08219;Vilassar de Mar;1;3;B;;631;351;280;1;6;344;350
8;Barcelona;21;Maresme;08219;Vilassar de Mar;2;1;A;;658;421;237;2;6;413;419
8;Barcelona;21;Maresme;08219;Vilassar de Mar;2;1;B;;644;399;245;6;3;390;393
8;Barcelona;21;Maresme;08219;Vilassar de Mar;2;2;A;;691;430;261;0;7;423;430
8;Barcelona;21;Maresme;08219;Vilassar de Mar;2;2;B;;790;468;322;3;6;459;465
8;Barcelona;21;Maresme;08219;Vilassar de Mar;3;1;A;;466;318;148;1;7;310;317
8;Barcelona;21;Maresme;08219;Vilassar de Mar;3;1;B;;550;353;197;0;9;344;353
8;Barcelona;21;Maresme;08219;Vilassar de Mar;3;2;A;;704;410;294;0;3;407;410
8;Barcelona;21;Maresme;08219;Vilassar de Mar;3;2;B;;705;386;319;1;4;381;385
17;Girona;2;Alt Empordà;17222;Vilaür;1;1;U;;86;66;20;0;0;66;66
43;Tarragona;16;Conca de Barberà;43172;Vilaverd;1;1;U;;335;279;56;2;1;276;277
43;Tarragona;29;Priorat;43173;Vilella Alta, la;1;1;U;;116;82;34;1;1;80;81
43;Tarragona;29;Priorat;43174;Vilella Baixa, la;1;1;U;;152;99;53;0;0;99;99
17;Girona;34;Selva;17233;Vilobí d'Onyar;1;1;A;;944;575;369;1;2;572;574
17;Girona;34;Selva;17233;Vilobí d'Onyar;1;1;B;;650;406;244;2;5;399;404
8;Barcelona;3;Alt Penedès;08304;Vilobí del Penedès;1;1;U;;650;468;182;1;4;463;467
17;Girona;10;Baix Empordà;17232;Vilopriu;1;1;U;;149;77;72;0;0;77;77
25;Lleida;18;Garrigues;25253;Vilosell, el;1;1;U;;175;134;41;1;0;133;133
43;Tarragona;16;Conca de Barberà;43176;Vimbodí i Poblet;1;1;U;;930;647;283;2;11;634;645
25;Lleida;18;Garrigues;25255;Vinaixa;1;1;U;;600;405;195;3;7;395;402
43;Tarragona;30;Ribera d'Ebre;43177;Vinebre;1;1;U;;359;250;109;2;1;247;248
43;Tarragona;8;Baix Camp;43178;Vinyols i els Arcs;1;1;U;;630;443;187;3;2;438;440
8;Barcelona;14;Berguedà;08308;Viver i Serrateix;1;1;U;;164;131;33;1;0;130;130
43;Tarragona;9;Baix Ebre;43052;Xerta;1;1;U;;1039;783;256;7;9;767;776
8;Barcelona;98;Residents Absents;08998;Residents Absents;1;1;U;;17023;5084;11939;13;7;5064;5071
17;Girona;98;Residents Absents;17998;Residents Absents;1;1;U;;1589;420;1169;9;6;405;411
25;Lleida;98;Residents Absents;25998;Residents Absents;1;1;U;;2322;848;1474;2;3;843;846
43;Tarragona;98;Residents Absents;43998;Residents Absents;1;1;U;;1762;527;1235;1;1;525;526
