﻿Codi Província;Nom Província;Codi Comarca;Nom Comarca;Codi Municipi;Nom Municipi;Districte;Secció;Mesa;Població;Cens;Participació 13:00;Participació 18:00;Participació 20:00;Abstenció;Vots nuls;Vots en blanc;Vots a candidatures;Vots vàlids
25;Lleida;25;Pallars Jussà;25001;Abella de la Conca;1;1;U;;144;20;43;72;72;0;1;71;72
8;Barcelona;11;Baix Llobregat;08001;Abrera;1;1;A;;383;85;191;220;163;3;2;215;217
8;Barcelona;11;Baix Llobregat;08001;Abrera;1;1;B;;395;93;169;219;176;3;4;212;216
8;Barcelona;11;Baix Llobregat;08001;Abrera;1;1;C;;420;107;179;236;184;1;3;232;235
8;Barcelona;11;Baix Llobregat;08001;Abrera;1;2;A;;505;122;213;284;221;0;5;279;284
8;Barcelona;11;Baix Llobregat;08001;Abrera;1;2;B;;471;113;198;284;187;1;8;275;283
8;Barcelona;11;Baix Llobregat;08001;Abrera;1;2;C;;641;145;257;367;274;1;8;358;366
8;Barcelona;11;Baix Llobregat;08001;Abrera;1;2;D;;483;117;202;266;217;1;3;262;265
8;Barcelona;11;Baix Llobregat;08001;Abrera;1;3;U;;701;159;268;394;307;0;4;390;394
8;Barcelona;11;Baix Llobregat;08001;Abrera;1;4;A;;468;99;187;244;224;1;2;241;243
8;Barcelona;11;Baix Llobregat;08001;Abrera;1;4;B;;448;109;196;270;178;0;2;268;270
8;Barcelona;11;Baix Llobregat;08001;Abrera;1;5;A;;681;138;262;339;342;3;5;331;336
8;Barcelona;11;Baix Llobregat;08001;Abrera;1;5;B;;740;146;293;399;341;3;6;390;396
8;Barcelona;11;Baix Llobregat;08001;Abrera;1;7;A;;948;195;355;461;487;7;7;447;454
8;Barcelona;11;Baix Llobregat;08001;Abrera;1;7;B;;580;108;185;251;329;0;4;247;251
25;Lleida;23;Noguera;25002;Àger;1;1;U;;459;109;224;294;165;1;5;288;293
25;Lleida;38;Urgell;25003;Agramunt;1;1;U;;689;149;303;413;276;2;8;403;411
25;Lleida;38;Urgell;25003;Agramunt;1;2;U;;770;175;359;481;289;2;10;469;479
25;Lleida;38;Urgell;25003;Agramunt;1;3;A;;581;114;279;353;228;6;17;330;347
25;Lleida;38;Urgell;25003;Agramunt;1;3;B;;693;148;309;416;277;2;14;400;414
25;Lleida;38;Urgell;25003;Agramunt;1;4;A;;529;117;239;321;208;2;7;312;319
25;Lleida;38;Urgell;25003;Agramunt;1;4;B;;581;138;266;349;232;1;8;340;348
8;Barcelona;7;Bages;08002;Aguilar de Segarra;1;1;U;;200;52;108;137;63;2;5;130;135
17;Girona;2;Alt Empordà;17001;Agullana;1;1;U;;594;194;364;405;189;3;6;396;402
8;Barcelona;41;Vallès Oriental;08014;Aiguafreda;1;1;A;;870;244;462;588;282;0;14;574;588
8;Barcelona;41;Vallès Oriental;08014;Aiguafreda;1;1;B;;1009;292;573;702;307;2;18;682;700
43;Tarragona;1;Alt Camp;43001;Aiguamúrcia;1;1;A;;272;76;155;197;75;2;5;190;195
43;Tarragona;1;Alt Camp;43001;Aiguamúrcia;1;1;B;;372;74;165;222;150;0;2;220;222
17;Girona;20;Gironès;17002;Aiguaviva;1;1;U;;471;117;253;317;154;2;6;309;315
25;Lleida;33;Segrià;25038;Aitona;1;1;U;;806;213;424;535;271;5;2;528;530
25;Lleida;33;Segrià;25038;Aitona;1;2;U;;935;188;432;567;368;2;4;561;565
25;Lleida;33;Segrià;25004;Alamús, els;1;1;U;;566;195;353;425;141;3;3;419;422
25;Lleida;4;Alt Urgell;25005;Alàs i Cerc;1;1;U;;331;84;193;232;99;0;4;228;232
25;Lleida;18;Garrigues;25006;Albagés, l';1;1;U;;409;125;216;265;144;4;2;259;261
17;Girona;2;Alt Empordà;17003;Albanyà;1;1;U;;101;29;55;65;36;0;3;62;65
25;Lleida;33;Segrià;25007;Albatàrrec;1;1;A;;613;141;291;378;235;2;1;375;376
25;Lleida;33;Segrià;25007;Albatàrrec;1;1;B;;499;101;206;274;225;1;3;270;273
25;Lleida;23;Noguera;25008;Albesa;1;1;A;;633;133;314;397;236;5;12;380;392
25;Lleida;23;Noguera;25008;Albesa;1;1;B;;605;120;296;390;215;2;10;378;388
25;Lleida;18;Garrigues;25009;Albi, l';1;1;U;;674;175;383;464;210;6;11;447;458
43;Tarragona;12;Baix Penedès;43002;Albinyana;1;1;A;;476;132;233;283;193;4;5;274;279
43;Tarragona;12;Baix Penedès;43002;Albinyana;1;1;B;;557;130;222;276;281;0;0;276;276
43;Tarragona;12;Baix Penedès;43002;Albinyana;1;1;C;;635;149;285;378;257;4;5;369;374
43;Tarragona;8;Baix Camp;43003;Albiol, l';1;1;U;;238;55;90;130;108;3;1;126;127
17;Girona;10;Baix Empordà;17004;Albons;1;1;U;;474;171;269;313;161;1;4;308;312
43;Tarragona;22;Montsià;43004;Alcanar;1;1;U;;828;197;372;469;359;7;5;457;462
43;Tarragona;22;Montsià;43004;Alcanar;1;2;A;;615;125;270;360;255;3;7;350;357
43;Tarragona;22;Montsià;43004;Alcanar;1;2;B;;665;147;287;394;271;1;10;383;393
43;Tarragona;22;Montsià;43004;Alcanar;1;3;A;;693;140;263;343;350;0;1;342;343
43;Tarragona;22;Montsià;43004;Alcanar;1;3;B;;618;128;220;287;331;0;8;279;287
43;Tarragona;22;Montsià;43004;Alcanar;1;4;U;;894;166;410;519;375;11;16;492;508
43;Tarragona;22;Montsià;43004;Alcanar;2;1;A;;526;108;193;255;271;2;5;248;253
43;Tarragona;22;Montsià;43004;Alcanar;2;1;B;;554;100;206;268;286;2;7;259;266
43;Tarragona;22;Montsià;43004;Alcanar;2;2;U;;636;140;245;307;329;3;8;296;304
43;Tarragona;22;Montsià;43004;Alcanar;2;3;U;;420;94;163;198;222;1;4;193;197
25;Lleida;33;Segrià;25010;Alcanó;1;1;U;;221;44;93;125;96;1;7;117;124
25;Lleida;33;Segrià;25011;Alcarràs;1;1;A;;1002;178;404;532;470;3;17;512;529
25;Lleida;33;Segrià;25011;Alcarràs;1;1;B;;918;178;393;508;410;2;12;494;506
25;Lleida;33;Segrià;25011;Alcarràs;1;2;A;;878;195;349;455;423;0;6;449;455
25;Lleida;33;Segrià;25011;Alcarràs;1;2;B;;827;148;300;410;417;0;9;401;410
25;Lleida;33;Segrià;25011;Alcarràs;1;3;U;;732;116;242;348;384;0;3;345;348
25;Lleida;33;Segrià;25012;Alcoletge;1;1;A;;861;221;421;507;354;4;11;492;503
25;Lleida;33;Segrià;25012;Alcoletge;1;1;B;;862;211;449;523;339;4;10;509;519
43;Tarragona;1;Alt Camp;43005;Alcover;1;1;A;;870;164;360;505;365;3;13;489;502
43;Tarragona;1;Alt Camp;43005;Alcover;1;1;B;;973;184;383;543;430;1;6;536;542
43;Tarragona;1;Alt Camp;43005;Alcover;2;1;A;;775;131;292;412;363;4;4;404;408
43;Tarragona;1;Alt Camp;43005;Alcover;2;1;B;;765;153;289;395;370;2;5;388;393
43;Tarragona;9;Baix Ebre;43904;Aldea, l';1;1;A;;839;222;346;440;399;13;4;423;427
43;Tarragona;9;Baix Ebre;43904;Aldea, l';1;1;B;;759;166;292;387;372;1;4;382;386
43;Tarragona;9;Baix Ebre;43904;Aldea, l';1;2;A;;730;147;304;400;330;5;6;389;395
43;Tarragona;9;Baix Ebre;43904;Aldea, l';1;2;B;;518;125;237;300;218;1;11;288;299
43;Tarragona;9;Baix Ebre;43006;Aldover;1;1;U;;746;136;333;438;308;0;11;427;438
43;Tarragona;8;Baix Camp;43007;Aleixar, l';1;1;U;;621;146;334;422;199;1;6;415;421
8;Barcelona;21;Maresme;08003;Alella;1;1;A;;791;207;415;518;273;3;11;504;515
8;Barcelona;21;Maresme;08003;Alella;1;1;B;;885;231;449;574;311;2;10;562;572
8;Barcelona;21;Maresme;08003;Alella;1;2;A;;781;196;382;497;284;2;9;486;495
8;Barcelona;21;Maresme;08003;Alella;1;2;B;;955;216;448;575;380;4;20;551;571
8;Barcelona;21;Maresme;08003;Alella;1;3;A;;847;233;446;581;266;2;18;561;579
8;Barcelona;21;Maresme;08003;Alella;1;3;B;;962;258;496;638;324;0;19;619;638
8;Barcelona;21;Maresme;08003;Alella;1;4;A;;705;194;350;446;259;1;10;435;445
8;Barcelona;21;Maresme;08003;Alella;1;4;B;;834;207;411;507;327;3;12;492;504
43;Tarragona;9;Baix Ebre;43008;Alfara de Carles;1;1;U;;310;59;173;233;77;4;3;226;229
25;Lleida;33;Segrià;25013;Alfarràs;1;1;A;;648;126;296;390;258;3;8;379;387
25;Lleida;33;Segrià;25013;Alfarràs;1;1;B;;719;149;317;394;325;1;9;384;393
25;Lleida;33;Segrià;25013;Alfarràs;1;2;A;;488;102;183;230;258;5;2;223;225
25;Lleida;33;Segrià;25013;Alfarràs;1;2;B;;593;124;235;298;295;0;3;295;298
25;Lleida;33;Segrià;25014;Alfés;1;1;U;;281;59;126;178;103;2;3;173;176
43;Tarragona;8;Baix Camp;43009;Alforja;1;1;A;;577;150;297;368;209;6;12;350;362
43;Tarragona;8;Baix Camp;43009;Alforja;1;1;B;;710;172;353;432;278;3;10;419;429
25;Lleida;23;Noguera;25015;Algerri;1;1;U;;428;125;242;297;131;1;5;291;296
25;Lleida;33;Segrià;25016;Alguaire;1;1;A;;566;144;259;340;226;3;4;333;337
25;Lleida;33;Segrià;25016;Alguaire;1;1;B;;634;168;290;360;274;0;3;357;360
25;Lleida;33;Segrià;25016;Alguaire;1;2;A;;513;110;245;305;208;2;7;296;303
25;Lleida;33;Segrià;25016;Alguaire;1;2;B;;578;134;271;328;250;0;7;321;328
25;Lleida;26;Pallars Sobirà;25017;Alins;1;1;U;;233;44;127;163;70;0;2;161;163
43;Tarragona;1;Alt Camp;43010;Alió;1;1;U;;300;94;168;208;92;2;2;204;206
25;Lleida;33;Segrià;25019;Almacelles;1;1;U;;824;183;340;449;375;5;10;434;444
25;Lleida;33;Segrià;25019;Almacelles;1;2;A;;615;121;260;339;276;1;7;331;338
25;Lleida;33;Segrià;25019;Almacelles;1;2;B;;763;165;320;410;353;3;5;402;407
25;Lleida;33;Segrià;25019;Almacelles;2;1;A;;487;118;210;270;217;3;8;259;267
25;Lleida;33;Segrià;25019;Almacelles;2;1;B;;602;113;232;314;288;2;9;303;312
25;Lleida;33;Segrià;25019;Almacelles;2;2;A;;617;122;275;346;271;2;9;335;344
25;Lleida;33;Segrià;25019;Almacelles;2;2;B;;730;135;295;384;346;1;10;373;383
25;Lleida;33;Segrià;25020;Almatret;1;1;U;;399;85;208;258;141;1;4;253;257
25;Lleida;33;Segrià;25021;Almenar;1;1;U;;709;131;256;338;371;0;8;330;338
25;Lleida;33;Segrià;25021;Almenar;2;1;A;;500;105;223;289;211;0;9;280;289
25;Lleida;33;Segrià;25021;Almenar;2;1;B;;657;126;285;372;285;0;7;365;372
25;Lleida;33;Segrià;25021;Almenar;2;2;U;;921;160;385;505;416;1;12;492;504
43;Tarragona;8;Baix Camp;43011;Almoster;1;1;A;;308;76;139;201;107;0;2;199;201
43;Tarragona;8;Baix Camp;43011;Almoster;1;1;B;;303;72;150;200;103;1;6;193;199
43;Tarragona;8;Baix Camp;43011;Almoster;1;1;C;;324;70;172;237;87;5;5;227;232
25;Lleida;23;Noguera;25022;Alòs de Balaguer;1;1;U;;143;30;84;112;31;0;5;107;112
17;Girona;15;Cerdanya;17006;Alp;1;1;A;;545;128;231;318;227;1;10;307;317
17;Girona;15;Cerdanya;17006;Alp;1;1;B;;536;128;200;291;245;4;1;286;287
8;Barcelona;24;Osona;08004;Alpens;1;1;U;;233;70;153;185;48;0;9;176;185
25;Lleida;33;Segrià;25023;Alpicat;1;1;A;;652;141;278;383;269;0;8;375;383
25;Lleida;33;Segrià;25023;Alpicat;1;1;B;;640;127;275;367;273;0;8;359;367
25;Lleida;33;Segrià;25023;Alpicat;1;1;C;;694;154;297;413;281;1;17;395;412
25;Lleida;33;Segrià;25023;Alpicat;1;2;A;;693;133;304;412;281;0;3;409;412
25;Lleida;33;Segrià;25023;Alpicat;1;2;B;;697;144;339;449;248;2;13;434;447
25;Lleida;33;Segrià;25023;Alpicat;1;2;C;;722;163;334;454;268;1;13;440;453
43;Tarragona;36;Tarragonès;43012;Altafulla;1;1;A;;566;154;273;361;205;3;4;354;358
43;Tarragona;36;Tarragonès;43012;Altafulla;1;1;B;;443;120;215;272;171;2;2;268;270
43;Tarragona;36;Tarragonès;43012;Altafulla;1;1;C;;594;161;277;381;213;2;4;375;379
43;Tarragona;36;Tarragonès;43012;Altafulla;1;1;D;;547;155;270;361;186;1;11;349;360
43;Tarragona;36;Tarragonès;43012;Altafulla;1;2;A;;389;96;160;208;181;0;4;204;208
43;Tarragona;36;Tarragonès;43012;Altafulla;1;2;B;;536;133;221;287;249;2;6;279;285
25;Lleida;26;Pallars Sobirà;25024;Alt Àneu;1;1;U;;370;67;164;238;132;2;8;228;236
17;Girona;34;Selva;17007;Amer;1;1;A;;580;216;319;377;203;6;6;365;371
17;Girona;34;Selva;17007;Amer;1;1;B;;592;202;312;380;212;1;2;377;379
17;Girona;34;Selva;17007;Amer;1;1;C;;675;237;379;442;233;4;14;424;438
8;Barcelona;41;Vallès Oriental;08005;Ametlla del Vallès, l';1;1;A;;518;113;222;299;219;0;5;294;299
8;Barcelona;41;Vallès Oriental;08005;Ametlla del Vallès, l';1;1;B;;651;145;272;376;275;1;8;367;375
8;Barcelona;41;Vallès Oriental;08005;Ametlla del Vallès, l';1;1;C;;496;80;198;285;211;1;5;279;284
8;Barcelona;41;Vallès Oriental;08005;Ametlla del Vallès, l';1;1;D;;533;139;235;296;237;1;4;291;295
8;Barcelona;41;Vallès Oriental;08005;Ametlla del Vallès, l';1;2;A;;541;172;317;377;164;2;15;360;375
8;Barcelona;41;Vallès Oriental;08005;Ametlla del Vallès, l';1;2;B;;621;188;353;417;204;4;20;393;413
8;Barcelona;41;Vallès Oriental;08005;Ametlla del Vallès, l';1;3;A;;727;178;354;462;265;0;15;447;462
8;Barcelona;41;Vallès Oriental;08005;Ametlla del Vallès, l';1;3;B;;658;158;302;393;265;1;7;385;392
8;Barcelona;41;Vallès Oriental;08005;Ametlla del Vallès, l';1;3;C;;619;160;316;407;212;1;11;395;406
43;Tarragona;9;Baix Ebre;43013;Ametlla de Mar, l';1;1;A;;461;133;244;307;154;4;5;298;303
43;Tarragona;9;Baix Ebre;43013;Ametlla de Mar, l';1;1;B;;493;173;255;309;184;5;1;303;304
43;Tarragona;9;Baix Ebre;43013;Ametlla de Mar, l';1;1;C;;399;130;212;257;142;1;3;253;256
43;Tarragona;9;Baix Ebre;43013;Ametlla de Mar, l';1;2;A;;549;177;291;356;193;0;8;348;356
43;Tarragona;9;Baix Ebre;43013;Ametlla de Mar, l';1;2;B;;531;189;272;340;191;2;3;335;338
43;Tarragona;9;Baix Ebre;43013;Ametlla de Mar, l';1;3;A;;491;137;207;271;220;4;3;264;267
43;Tarragona;9;Baix Ebre;43013;Ametlla de Mar, l';1;3;B;;369;103;160;211;158;0;0;211;211
43;Tarragona;9;Baix Ebre;43013;Ametlla de Mar, l';1;3;C;;546;142;223;294;252;0;5;289;294
43;Tarragona;9;Baix Ebre;43013;Ametlla de Mar, l';1;3;D;;392;105;151;197;195;0;2;195;197
43;Tarragona;9;Baix Ebre;43906;Ampolla, l';1;1;A;;259;90;155;187;72;3;0;184;184
43;Tarragona;9;Baix Ebre;43906;Ampolla, l';1;1;B;;348;101;191;254;94;0;4;250;254
43;Tarragona;9;Baix Ebre;43906;Ampolla, l';1;1;C;;402;136;216;262;140;0;7;255;262
43;Tarragona;9;Baix Ebre;43906;Ampolla, l';1;1;D;;348;104;179;225;123;5;3;217;220
43;Tarragona;9;Baix Ebre;43906;Ampolla, l';1;1;E;;323;85;147;198;125;2;7;189;196
43;Tarragona;22;Montsià;43014;Amposta;1;1;A;;294;77;119;165;129;0;3;162;165
43;Tarragona;22;Montsià;43014;Amposta;1;1;B;;331;99;152;196;135;0;4;192;196
43;Tarragona;22;Montsià;43014;Amposta;1;2;A;;522;157;257;312;210;0;1;311;312
43;Tarragona;22;Montsià;43014;Amposta;1;2;B;;571;160;252;320;251;3;4;313;317
43;Tarragona;22;Montsià;43014;Amposta;2;1;U;;742;254;404;495;247;2;15;478;493
43;Tarragona;22;Montsià;43014;Amposta;2;2;A;;357;102;182;211;146;1;4;206;210
43;Tarragona;22;Montsià;43014;Amposta;2;2;B;;374;104;179;217;157;1;4;212;216
43;Tarragona;22;Montsià;43014;Amposta;3;1;A;;455;131;222;278;177;2;11;265;276
43;Tarragona;22;Montsià;43014;Amposta;3;1;B;;404;125;200;246;158;0;5;241;246
43;Tarragona;22;Montsià;43014;Amposta;3;2;A;;610;151;254;303;307;0;2;301;303
43;Tarragona;22;Montsià;43014;Amposta;3;2;B;;688;156;281;344;344;0;6;338;344
43;Tarragona;22;Montsià;43014;Amposta;4;1;A;;531;140;236;307;224;1;3;303;306
43;Tarragona;22;Montsià;43014;Amposta;4;1;B;;538;144;249;307;231;1;3;303;306
43;Tarragona;22;Montsià;43014;Amposta;4;2;A;;573;148;284;351;222;2;4;345;349
43;Tarragona;22;Montsià;43014;Amposta;4;2;B;;553;160;260;337;216;1;4;332;336
43;Tarragona;22;Montsià;43014;Amposta;4;3;A;;610;158;284;360;250;1;9;350;359
43;Tarragona;22;Montsià;43014;Amposta;4;3;B;;468;115;189;261;207;3;3;255;258
43;Tarragona;22;Montsià;43014;Amposta;4;3;C;;573;148;263;337;236;2;8;327;335
43;Tarragona;22;Montsià;43014;Amposta;4;4;A;;665;143;280;388;277;2;17;369;386
43;Tarragona;22;Montsià;43014;Amposta;4;4;B;;477;103;205;277;200;0;6;271;277
43;Tarragona;22;Montsià;43014;Amposta;4;4;C;;678;160;296;399;279;2;7;390;397
43;Tarragona;22;Montsià;43014;Amposta;4;5;A;;588;111;201;281;307;1;3;277;280
43;Tarragona;22;Montsià;43014;Amposta;4;5;B;;536;108;197;277;259;0;6;271;277
43;Tarragona;22;Montsià;43014;Amposta;4;5;C;;576;99;200;280;296;0;8;272;280
43;Tarragona;22;Montsià;43014;Amposta;4;6;A;;543;126;198;278;265;1;5;272;277
43;Tarragona;22;Montsià;43014;Amposta;4;6;B;;601;108;193;266;335;3;9;254;263
17;Girona;34;Selva;17008;Anglès;1;1;A;;505;121;229;273;232;1;3;269;272
17;Girona;34;Selva;17008;Anglès;1;1;B;;493;106;228;270;223;1;5;264;269
17;Girona;34;Selva;17008;Anglès;1;2;A;;793;227;400;449;344;3;3;443;446
17;Girona;34;Selva;17008;Anglès;1;2;B;;786;218;407;464;322;2;10;452;462
17;Girona;34;Selva;17008;Anglès;1;3;A;;607;174;309;353;254;2;4;347;351
17;Girona;34;Selva;17008;Anglès;1;3;B;;630;160;292;342;288;1;4;337;341
25;Lleida;38;Urgell;25027;Anglesola;1;1;A;;464;121;259;317;147;1;7;309;316
25;Lleida;38;Urgell;25027;Anglesola;1;1;B;;590;151;342;412;178;3;5;404;409
25;Lleida;18;Garrigues;25029;Arbeca;1;1;U;;853;206;443;567;286;3;12;552;564
25;Lleida;18;Garrigues;25029;Arbeca;1;2;U;;960;201;485;646;314;7;12;627;639
43;Tarragona;12;Baix Penedès;43016;Arboç, l';1;1;A;;394;115;194;240;154;1;5;234;239
43;Tarragona;12;Baix Penedès;43016;Arboç, l';1;1;B;;580;136;238;306;274;0;7;299;306
43;Tarragona;12;Baix Penedès;43016;Arboç, l';1;1;C;;520;138;243;304;216;2;2;300;302
43;Tarragona;12;Baix Penedès;43016;Arboç, l';1;2;A;;567;138;258;335;232;1;5;329;334
43;Tarragona;12;Baix Penedès;43016;Arboç, l';1;2;B;;690;151;287;352;338;4;4;344;348
43;Tarragona;12;Baix Penedès;43016;Arboç, l';1;2;C;;574;148;271;342;232;3;8;331;339
43;Tarragona;8;Baix Camp;43015;Arbolí;1;1;U;;96;35;46;67;29;0;1;66;67
17;Girona;34;Selva;17009;Arbúcies;1;1;A;;745;189;374;440;305;3;6;431;437
17;Girona;34;Selva;17009;Arbúcies;1;1;B;;808;194;410;490;318;3;9;478;487
17;Girona;34;Selva;17009;Arbúcies;1;2;A;;790;256;435;519;271;2;15;502;517
17;Girona;34;Selva;17009;Arbúcies;1;2;B;;788;205;426;516;272;4;8;504;512
17;Girona;34;Selva;17009;Arbúcies;2;1;U;;933;234;496;614;319;11;4;599;603
8;Barcelona;21;Maresme;08006;Arenys de Mar;1;1;A;;733;246;389;480;253;2;5;473;478
8;Barcelona;21;Maresme;08006;Arenys de Mar;1;1;B;;866;293;475;586;280;2;11;573;584
8;Barcelona;21;Maresme;08006;Arenys de Mar;1;2;A;;631;209;356;414;217;1;5;408;413
8;Barcelona;21;Maresme;08006;Arenys de Mar;1;2;B;;673;183;333;411;262;0;15;396;411
8;Barcelona;21;Maresme;08006;Arenys de Mar;1;2;C;;714;224;382;467;247;3;9;455;464
8;Barcelona;21;Maresme;08006;Arenys de Mar;1;3;A;;442;134;234;275;167;3;11;261;272
8;Barcelona;21;Maresme;08006;Arenys de Mar;1;3;B;;536;140;271;342;194;1;3;338;341
8;Barcelona;21;Maresme;08006;Arenys de Mar;2;1;A;;595;198;298;369;226;2;11;356;367
8;Barcelona;21;Maresme;08006;Arenys de Mar;2;1;B;;665;210;337;410;255;2;7;401;408
8;Barcelona;21;Maresme;08006;Arenys de Mar;2;2;A;;653;215;367;439;214;1;6;432;438
8;Barcelona;21;Maresme;08006;Arenys de Mar;2;2;B;;732;253;419;506;226;3;6;497;503
8;Barcelona;21;Maresme;08006;Arenys de Mar;2;3;A;;578;158;274;346;232;2;9;335;344
8;Barcelona;21;Maresme;08006;Arenys de Mar;2;3;B;;714;224;378;439;275;0;13;426;439
8;Barcelona;21;Maresme;08006;Arenys de Mar;2;4;A;;626;170;285;356;270;2;4;350;354
8;Barcelona;21;Maresme;08006;Arenys de Mar;2;4;B;;729;172;311;378;351;3;5;370;375
8;Barcelona;21;Maresme;08006;Arenys de Mar;2;4;C;;727;164;303;373;354;2;2;369;371
8;Barcelona;21;Maresme;08007;Arenys de Munt;1;1;A;;381;127;194;226;155;1;8;217;225
8;Barcelona;21;Maresme;08007;Arenys de Munt;1;1;B;;461;161;266;313;148;0;16;297;313
8;Barcelona;21;Maresme;08007;Arenys de Munt;1;2;A;;576;174;292;370;206;1;6;363;369
8;Barcelona;21;Maresme;08007;Arenys de Munt;1;2;B;;432;134;208;267;165;1;6;260;266
8;Barcelona;21;Maresme;08007;Arenys de Munt;1;2;C;;637;198;337;408;229;1;12;395;407
8;Barcelona;21;Maresme;08007;Arenys de Munt;1;2;D;;622;186;338;412;210;0;13;399;412
8;Barcelona;21;Maresme;08007;Arenys de Munt;2;1;A;;689;210;382;470;219;1;7;462;469
8;Barcelona;21;Maresme;08007;Arenys de Munt;2;1;B;;707;200;373;466;241;2;12;452;464
8;Barcelona;21;Maresme;08007;Arenys de Munt;2;2;A;;586;144;263;323;263;0;3;320;323
8;Barcelona;21;Maresme;08007;Arenys de Munt;2;2;B;;747;218;340;434;313;1;5;428;433
17;Girona;19;Garrotxa;17010;Argelaguer;1;1;U;;313;110;173;209;104;1;7;201;208
8;Barcelona;6;Anoia;08008;Argençola;1;1;U;;190;55;99;154;36;4;36;114;150
43;Tarragona;8;Baix Camp;43017;Argentera, l';1;1;U;;135;20;77;98;37;0;0;98;98
8;Barcelona;21;Maresme;08009;Argentona;1;1;A;;813;223;395;508;305;3;6;499;505
8;Barcelona;21;Maresme;08009;Argentona;1;1;B;;894;202;382;494;400;0;14;480;494
8;Barcelona;21;Maresme;08009;Argentona;1;1;C;;877;216;397;514;363;1;8;505;513
8;Barcelona;21;Maresme;08009;Argentona;1;2;A;;880;231;420;578;302;3;17;558;575
8;Barcelona;21;Maresme;08009;Argentona;1;2;B;;813;225;416;543;270;4;8;531;539
8;Barcelona;21;Maresme;08009;Argentona;1;2;C;;798;235;415;517;281;4;10;503;513
8;Barcelona;21;Maresme;08009;Argentona;1;3;A;;397;100;184;228;169;1;2;225;227
8;Barcelona;21;Maresme;08009;Argentona;1;3;B;;504;104;214;266;238;1;6;259;265
8;Barcelona;21;Maresme;08009;Argentona;2;1;A;;800;172;366;471;329;1;13;457;470
8;Barcelona;21;Maresme;08009;Argentona;2;1;B;;904;214;433;538;366;0;9;529;538
8;Barcelona;21;Maresme;08009;Argentona;2;2;A;;448;133;248;304;144;2;2;300;302
8;Barcelona;21;Maresme;08009;Argentona;2;2;B;;503;142;280;344;159;4;10;330;340
17;Girona;2;Alt Empordà;17011;Armentera, l';1;1;U;;619;217;369;425;194;2;9;414;423
43;Tarragona;37;Terra Alta;43018;Arnes;1;1;U;;455;173;325;372;83;4;3;365;368
25;Lleida;39;Consell General d'Aran;25031;Arres;1;1;U;;55;10;19;29;26;0;1;28;29
25;Lleida;4;Alt Urgell;25032;Arsèguel;1;1;U;;81;14;36;52;29;1;0;51;51
8;Barcelona;7;Bages;08010;Artés;1;1;A;;451;120;219;264;187;2;7;255;262
8;Barcelona;7;Bages;08010;Artés;1;1;B;;560;141;252;297;263;3;10;284;294
8;Barcelona;7;Bages;08010;Artés;2;1;A;;774;214;395;489;285;4;8;477;485
8;Barcelona;7;Bages;08010;Artés;2;1;B;;652;169;310;372;280;3;3;366;369
8;Barcelona;7;Bages;08010;Artés;2;1;C;;920;276;482;592;328;5;17;570;587
8;Barcelona;7;Bages;08010;Artés;2;2;U;;600;177;295;365;235;3;10;352;362
25;Lleida;33;Segrià;25033;Artesa de Lleida;1;1;A;;598;152;310;411;187;4;12;395;407
25;Lleida;33;Segrià;25033;Artesa de Lleida;1;1;B;;534;134;253;327;207;4;1;322;323
25;Lleida;23;Noguera;25034;Artesa de Segre;1;1;A;;607;168;327;412;195;1;8;403;411
25;Lleida;23;Noguera;25034;Artesa de Segre;1;1;B;;730;178;366;479;251;9;11;459;470
25;Lleida;23;Noguera;25034;Artesa de Segre;1;2;U;;655;169;318;393;262;1;13;379;392
25;Lleida;23;Noguera;25034;Artesa de Segre;2;1;U;;570;130;241;333;237;2;10;321;331
43;Tarragona;30;Ribera d'Ebre;43019;Ascó;1;1;A;;606;133;308;403;203;4;9;390;399
43;Tarragona;30;Ribera d'Ebre;43019;Ascó;1;1;B;;718;162;340;447;271;5;5;437;442
25;Lleida;33;Segrià;25036;Aspa;1;1;U;;231;59;123;142;89;4;7;131;138
25;Lleida;23;Noguera;25037;Avellanes i Santa Linya, les;1;1;U;;425;87;205;261;164;1;5;255;260
8;Barcelona;14;Berguedà;08011;Avià;1;1;A;;828;202;435;547;281;3;12;532;544
8;Barcelona;14;Berguedà;08011;Avià;1;1;B;;858;236;475;569;289;2;21;546;567
8;Barcelona;7;Bages;08012;Avinyó;1;1;A;;824;231;526;621;203;3;14;604;618
8;Barcelona;7;Bages;08012;Avinyó;1;1;B;;821;232;501;616;205;2;11;603;614
8;Barcelona;3;Alt Penedès;08013;Avinyonet del Penedès;1;1;A;;592;135;270;356;236;1;6;349;355
8;Barcelona;3;Alt Penedès;08013;Avinyonet del Penedès;1;1;B;;617;136;293;386;231;1;6;379;385
17;Girona;2;Alt Empordà;17012;Avinyonet de Puigventós;1;1;U;;965;213;386;468;497;3;8;457;465
8;Barcelona;13;Barcelonès;08015;Badalona;1;1;A;;519;158;285;364;155;4;5;355;360
8;Barcelona;13;Barcelonès;08015;Badalona;1;1;B;;591;191;326;394;197;5;7;382;389
8;Barcelona;13;Barcelonès;08015;Badalona;1;2;A;;436;147;249;297;139;0;3;294;297
8;Barcelona;13;Barcelonès;08015;Badalona;1;2;B;;547;195;300;361;186;2;1;358;359
8;Barcelona;13;Barcelonès;08015;Badalona;1;3;U;;773;226;431;532;241;3;15;514;529
8;Barcelona;13;Barcelonès;08015;Badalona;1;4;U;;672;200;388;487;185;0;9;478;487
8;Barcelona;13;Barcelonès;08015;Badalona;1;5;A;;536;179;276;361;175;0;8;353;361
8;Barcelona;13;Barcelonès;08015;Badalona;1;5;B;;611;221;341;431;180;2;11;418;429
8;Barcelona;13;Barcelonès;08015;Badalona;1;7;A;;466;124;257;320;146;0;3;317;320
8;Barcelona;13;Barcelonès;08015;Badalona;1;7;B;;538;138;293;375;163;1;12;362;374
8;Barcelona;13;Barcelonès;08015;Badalona;1;8;U;;527;172;328;387;140;1;9;377;386
8;Barcelona;13;Barcelonès;08015;Badalona;2;1;A;;512;137;224;289;223;0;9;280;289
8;Barcelona;13;Barcelonès;08015;Badalona;2;1;B;;552;144;234;306;246;0;9;297;306
8;Barcelona;13;Barcelonès;08015;Badalona;2;10;A;;554;108;190;238;316;0;1;237;238
8;Barcelona;13;Barcelonès;08015;Badalona;2;10;B;;624;124;216;265;359;1;4;260;264
8;Barcelona;13;Barcelonès;08015;Badalona;2;11;A;;597;116;196;260;337;0;4;256;260
8;Barcelona;13;Barcelonès;08015;Badalona;2;11;B;;705;153;261;352;353;1;7;344;351
8;Barcelona;13;Barcelonès;08015;Badalona;2;12;U;;850;179;308;401;449;2;9;390;399
8;Barcelona;13;Barcelonès;08015;Badalona;2;13;A;;419;69;127;162;257;3;3;156;159
8;Barcelona;13;Barcelonès;08015;Badalona;2;13;B;;536;93;177;218;318;3;1;214;215
8;Barcelona;13;Barcelonès;08015;Badalona;2;14;U;;429;95;166;212;217;0;8;204;212
8;Barcelona;13;Barcelonès;08015;Badalona;2;15;A;;413;104;174;202;211;0;2;200;202
8;Barcelona;13;Barcelonès;08015;Badalona;2;15;B;;455;109;185;212;243;0;7;205;212
8;Barcelona;13;Barcelonès;08015;Badalona;2;2;A;;671;192;358;459;212;0;8;451;459
8;Barcelona;13;Barcelonès;08015;Badalona;2;2;B;;679;201;393;483;196;0;6;477;483
8;Barcelona;13;Barcelonès;08015;Badalona;2;3;U;;670;204;374;465;205;3;9;453;462
8;Barcelona;13;Barcelonès;08015;Badalona;2;4;A;;751;230;426;528;223;3;8;517;525
8;Barcelona;13;Barcelonès;08015;Badalona;2;4;B;;767;219;426;532;235;2;5;525;530
8;Barcelona;13;Barcelonès;08015;Badalona;2;5;U;;470;105;182;224;246;0;3;221;224
8;Barcelona;13;Barcelonès;08015;Badalona;2;6;U;;524;104;180;214;310;2;0;212;212
8;Barcelona;13;Barcelonès;08015;Badalona;2;7;U;;553;96;169;215;338;0;7;208;215
8;Barcelona;13;Barcelonès;08015;Badalona;2;8;A;;864;217;432;564;300;3;17;544;561
8;Barcelona;13;Barcelonès;08015;Badalona;2;8;B;;906;250;461;569;337;1;13;555;568
8;Barcelona;13;Barcelonès;08015;Badalona;2;9;U;;811;208;295;347;464;3;4;340;344
8;Barcelona;13;Barcelonès;08015;Badalona;3;1;U;;463;100;147;194;269;2;0;192;192
8;Barcelona;13;Barcelonès;08015;Badalona;3;10;U;;832;242;404;483;349;2;7;474;481
8;Barcelona;13;Barcelonès;08015;Badalona;3;11;A;;458;117;208;252;206;0;7;245;252
8;Barcelona;13;Barcelonès;08015;Badalona;3;11;B;;473;115;210;269;204;1;3;265;268
8;Barcelona;13;Barcelonès;08015;Badalona;3;12;A;;469;122;220;296;173;1;7;288;295
8;Barcelona;13;Barcelonès;08015;Badalona;3;12;B;;526;159;254;338;188;10;8;320;328
8;Barcelona;13;Barcelonès;08015;Badalona;3;2;A;;559;141;258;326;233;1;5;320;325
8;Barcelona;13;Barcelonès;08015;Badalona;3;2;B;;646;148;280;361;285;1;6;354;360
8;Barcelona;13;Barcelonès;08015;Badalona;3;3;A;;619;138;263;342;277;1;5;336;341
8;Barcelona;13;Barcelonès;08015;Badalona;3;3;B;;721;151;309;383;338;2;4;377;381
8;Barcelona;13;Barcelonès;08015;Badalona;3;4;A;;842;189;364;486;356;0;12;474;486
8;Barcelona;13;Barcelonès;08015;Badalona;3;4;B;;1035;284;501;638;397;2;12;624;636
8;Barcelona;13;Barcelonès;08015;Badalona;3;5;A;;486;108;190;241;245;0;7;234;241
8;Barcelona;13;Barcelonès;08015;Badalona;3;5;B;;553;137;215;280;273;0;3;277;280
8;Barcelona;13;Barcelonès;08015;Badalona;3;6;U;;872;273;452;575;297;2;12;561;573
8;Barcelona;13;Barcelonès;08015;Badalona;3;7;A;;457;116;209;290;167;1;7;282;289
8;Barcelona;13;Barcelonès;08015;Badalona;3;7;B;;530;154;292;387;143;0;11;376;387
8;Barcelona;13;Barcelonès;08015;Badalona;3;8;U;;536;147;263;321;215;1;6;314;320
8;Barcelona;13;Barcelonès;08015;Badalona;3;9;U;;473;158;254;320;153;1;7;312;319
8;Barcelona;13;Barcelonès;08015;Badalona;4;1;A;;679;126;228;302;377;0;3;299;302
8;Barcelona;13;Barcelonès;08015;Badalona;4;1;B;;798;136;253;352;446;0;13;339;352
8;Barcelona;13;Barcelonès;08015;Badalona;4;10;A;;417;102;162;193;224;2;3;188;191
8;Barcelona;13;Barcelonès;08015;Badalona;4;10;B;;487;107;177;210;277;4;0;206;206
8;Barcelona;13;Barcelonès;08015;Badalona;4;11;A;;495;104;203;244;251;0;5;239;244
8;Barcelona;13;Barcelonès;08015;Badalona;4;11;B;;612;126;232;277;335;0;6;271;277
8;Barcelona;13;Barcelonès;08015;Badalona;4;12;A;;493;107;186;236;257;0;4;232;236
8;Barcelona;13;Barcelonès;08015;Badalona;4;12;B;;600;138;217;285;315;0;9;276;285
8;Barcelona;13;Barcelonès;08015;Badalona;4;13;A;;419;68;146;207;212;2;1;204;205
8;Barcelona;13;Barcelonès;08015;Badalona;4;13;B;;520;106;202;262;258;0;6;256;262
8;Barcelona;13;Barcelonès;08015;Badalona;4;14;A;;840;157;341;466;374;1;9;456;465
8;Barcelona;13;Barcelonès;08015;Badalona;4;14;B;;1048;205;419;582;466;2;7;573;580
8;Barcelona;13;Barcelonès;08015;Badalona;4;15;A;;493;95;179;241;252;0;5;236;241
8;Barcelona;13;Barcelonès;08015;Badalona;4;15;B;;586;119;222;297;289;0;9;288;297
8;Barcelona;13;Barcelonès;08015;Badalona;4;16;A;;578;103;210;300;278;1;3;296;299
8;Barcelona;13;Barcelonès;08015;Badalona;4;16;B;;743;185;296;396;347;1;7;388;395
8;Barcelona;13;Barcelonès;08015;Badalona;4;2;A;;542;143;239;290;252;1;5;284;289
8;Barcelona;13;Barcelonès;08015;Badalona;4;2;B;;671;170;306;371;300;2;11;358;369
8;Barcelona;13;Barcelonès;08015;Badalona;4;3;A;;489;124;209;266;223;0;11;255;266
8;Barcelona;13;Barcelonès;08015;Badalona;4;3;B;;514;117;220;285;229;1;7;277;284
8;Barcelona;13;Barcelonès;08015;Badalona;4;4;A;;541;149;257;320;221;1;5;314;319
8;Barcelona;13;Barcelonès;08015;Badalona;4;4;B;;669;168;282;351;318;9;0;342;342
8;Barcelona;13;Barcelonès;08015;Badalona;4;4;C;;579;134;221;301;278;0;7;294;301
8;Barcelona;13;Barcelonès;08015;Badalona;4;5;A;;500;130;202;253;247;3;7;243;250
8;Barcelona;13;Barcelonès;08015;Badalona;4;5;B;;586;99;213;286;300;2;7;277;284
8;Barcelona;13;Barcelonès;08015;Badalona;4;6;A;;760;138;259;322;438;0;4;318;322
8;Barcelona;13;Barcelonès;08015;Badalona;4;6;B;;964;193;336;430;534;3;14;413;427
8;Barcelona;13;Barcelonès;08015;Badalona;4;7;A;;686;154;300;278;408;0;4;274;278
8;Barcelona;13;Barcelonès;08015;Badalona;4;7;B;;823;186;325;386;437;0;6;380;386
8;Barcelona;13;Barcelonès;08015;Badalona;4;8;A;;561;104;203;442;119;1;12;429;441
8;Barcelona;13;Barcelonès;08015;Badalona;4;8;B;;662;138;230;309;353;0;6;303;309
8;Barcelona;13;Barcelonès;08015;Badalona;4;9;U;;728;154;299;404;324;0;14;390;404
8;Barcelona;13;Barcelonès;08015;Badalona;5;1;A;;803;256;415;531;272;6;10;515;525
8;Barcelona;13;Barcelonès;08015;Badalona;5;1;B;;957;282;512;636;321;1;9;626;635
8;Barcelona;13;Barcelonès;08015;Badalona;5;2;U;;712;225;434;515;197;2;8;505;513
8;Barcelona;13;Barcelonès;08015;Badalona;5;3;A;;852;228;402;527;325;1;8;518;526
8;Barcelona;13;Barcelonès;08015;Badalona;5;3;B;;891;244;442;569;322;0;10;559;569
8;Barcelona;13;Barcelonès;08015;Badalona;5;4;A;;825;216;358;449;376;2;8;439;447
8;Barcelona;13;Barcelonès;08015;Badalona;5;4;B;;876;221;374;473;403;2;4;467;471
8;Barcelona;13;Barcelonès;08015;Badalona;5;5;A;;728;229;332;424;304;0;8;416;424
8;Barcelona;13;Barcelonès;08015;Badalona;5;5;B;;804;244;358;447;357;1;8;438;446
8;Barcelona;13;Barcelonès;08015;Badalona;5;6;U;;1015;348;569;704;311;2;16;686;702
8;Barcelona;13;Barcelonès;08015;Badalona;6;1;A;;513;125;208;256;257;0;5;251;256
8;Barcelona;13;Barcelonès;08015;Badalona;6;1;B;;551;133;217;287;264;0;6;281;287
8;Barcelona;13;Barcelonès;08015;Badalona;6;2;A;;395;84;159;215;180;0;1;214;215
8;Barcelona;13;Barcelonès;08015;Badalona;6;2;B;;555;99;240;320;235;0;7;313;320
8;Barcelona;13;Barcelonès;08015;Badalona;6;2;C;;361;66;140;189;172;1;1;187;188
8;Barcelona;13;Barcelonès;08015;Badalona;6;3;A;;445;81;133;160;285;1;1;158;159
8;Barcelona;13;Barcelonès;08015;Badalona;6;3;B;;529;108;175;206;323;2;6;198;204
8;Barcelona;13;Barcelonès;08015;Badalona;6;4;A;;473;91;155;178;295;2;3;173;176
8;Barcelona;13;Barcelonès;08015;Badalona;6;4;B;;618;115;185;231;387;1;3;227;230
8;Barcelona;13;Barcelonès;08015;Badalona;6;5;A;;540;77;155;197;343;1;1;195;196
8;Barcelona;13;Barcelonès;08015;Badalona;6;5;B;;681;121;210;255;426;3;2;250;252
8;Barcelona;13;Barcelonès;08015;Badalona;6;6;A;;396;80;117;143;253;0;3;140;143
8;Barcelona;13;Barcelonès;08015;Badalona;6;6;B;;513;116;165;197;316;0;6;191;197
8;Barcelona;13;Barcelonès;08015;Badalona;7;1;A;;535;94;175;230;305;0;3;227;230
8;Barcelona;13;Barcelonès;08015;Badalona;7;1;B;;709;153;249;320;389;2;4;314;318
8;Barcelona;13;Barcelonès;08015;Badalona;7;10;U;;629;111;197;247;382;1;4;242;246
8;Barcelona;13;Barcelonès;08015;Badalona;7;11;A;;525;99;173;221;304;0;2;219;221
8;Barcelona;13;Barcelonès;08015;Badalona;7;11;B;;611;131;208;256;355;0;5;251;256
8;Barcelona;13;Barcelonès;08015;Badalona;7;12;A;;497;116;165;205;292;0;4;201;205
8;Barcelona;13;Barcelonès;08015;Badalona;7;12;B;;599;108;192;249;350;10;6;233;239
8;Barcelona;13;Barcelonès;08015;Badalona;7;13;U;;810;138;225;264;546;1;1;262;263
8;Barcelona;13;Barcelonès;08015;Badalona;7;14;A;;614;99;163;201;413;3;2;196;198
8;Barcelona;13;Barcelonès;08015;Badalona;7;14;B;;724;104;196;249;475;1;4;244;248
8;Barcelona;13;Barcelonès;08015;Badalona;7;15;U;;666;118;194;235;431;2;8;225;233
8;Barcelona;13;Barcelonès;08015;Badalona;7;17;U;;556;96;166;205;351;0;3;202;205
8;Barcelona;13;Barcelonès;08015;Badalona;7;18;A;;598;87;187;255;343;0;7;248;255
8;Barcelona;13;Barcelonès;08015;Badalona;7;18;B;;728;103;218;304;424;2;6;296;302
8;Barcelona;13;Barcelonès;08015;Badalona;7;19;U;;452;81;144;192;260;0;1;191;192
8;Barcelona;13;Barcelonès;08015;Badalona;7;2;A;;627;121;235;318;309;1;7;310;317
8;Barcelona;13;Barcelonès;08015;Badalona;7;2;B;;647;134;242;314;333;1;2;311;313
8;Barcelona;13;Barcelonès;08015;Badalona;7;2;C;;612;123;236;306;306;0;7;299;306
8;Barcelona;13;Barcelonès;08015;Badalona;7;20;A;;430;114;180;207;223;1;3;203;206
8;Barcelona;13;Barcelonès;08015;Badalona;7;20;B;;494;126;203;238;256;2;2;234;236
8;Barcelona;13;Barcelonès;08015;Badalona;7;21;U;;774;148;260;353;421;1;6;346;352
8;Barcelona;13;Barcelonès;08015;Badalona;7;22;U;;619;174;278;362;257;10;1;351;352
8;Barcelona;13;Barcelonès;08015;Badalona;7;23;A;;721;198;360;458;263;1;5;452;457
8;Barcelona;13;Barcelonès;08015;Badalona;7;23;B;;899;247;452;568;331;3;14;551;565
8;Barcelona;13;Barcelonès;08015;Badalona;7;24;A;;546;125;231;297;249;0;10;287;297
8;Barcelona;13;Barcelonès;08015;Badalona;7;24;B;;738;186;326;403;335;0;11;392;403
8;Barcelona;13;Barcelonès;08015;Badalona;7;25;U;;461;44;94;129;332;0;3;126;129
8;Barcelona;13;Barcelonès;08015;Badalona;7;26;U;;483;88;147;173;310;0;1;172;173
8;Barcelona;13;Barcelonès;08015;Badalona;7;27;A;;464;70;130;156;308;2;2;152;154
8;Barcelona;13;Barcelonès;08015;Badalona;7;27;B;;501;78;138;163;338;0;2;161;163
8;Barcelona;13;Barcelonès;08015;Badalona;7;28;A;;651;101;174;229;422;0;1;228;229
8;Barcelona;13;Barcelonès;08015;Badalona;7;28;B;;821;145;252;333;488;2;11;320;331
8;Barcelona;13;Barcelonès;08015;Badalona;7;29;A;;501;107;178;248;253;0;5;243;248
8;Barcelona;13;Barcelonès;08015;Badalona;7;29;B;;693;150;275;359;334;1;10;348;358
8;Barcelona;13;Barcelonès;08015;Badalona;7;29;C;;643;135;241;300;343;0;11;289;300
8;Barcelona;13;Barcelonès;08015;Badalona;7;3;A;;550;140;232;278;272;1;2;275;277
8;Barcelona;13;Barcelonès;08015;Badalona;7;3;B;;637;159;255;314;323;1;12;301;313
8;Barcelona;13;Barcelonès;08015;Badalona;7;30;A;;712;108;246;348;364;0;2;346;348
8;Barcelona;13;Barcelonès;08015;Badalona;7;30;B;;846;150;323;445;401;0;12;433;445
8;Barcelona;13;Barcelonès;08015;Badalona;7;31;A;;486;69;146;192;294;0;3;189;192
8;Barcelona;13;Barcelonès;08015;Badalona;7;31;B;;616;109;186;265;351;0;1;264;265
8;Barcelona;13;Barcelonès;08015;Badalona;7;4;U;;848;228;393;485;363;3;5;477;482
8;Barcelona;13;Barcelonès;08015;Badalona;7;5;U;;649;133;226;296;353;1;1;294;295
8;Barcelona;13;Barcelonès;08015;Badalona;7;6;U;;772;186;358;424;348;0;13;411;424
8;Barcelona;13;Barcelonès;08015;Badalona;7;7;U;;655;93;176;214;441;2;3;209;212
8;Barcelona;13;Barcelonès;08015;Badalona;7;8;A;;425;65;109;139;286;2;7;130;137
8;Barcelona;13;Barcelonès;08015;Badalona;7;8;B;;487;85;141;173;314;0;7;166;173
8;Barcelona;13;Barcelonès;08015;Badalona;7;9;U;;489;84;123;164;325;0;0;164;164
8;Barcelona;13;Barcelonès;08015;Badalona;8;1;U;;551;77;123;169;382;0;3;166;169
8;Barcelona;13;Barcelonès;08015;Badalona;8;10;A;;557;103;160;202;355;1;6;195;201
8;Barcelona;13;Barcelonès;08015;Badalona;8;10;B;;617;118;199;242;375;0;5;237;242
8;Barcelona;13;Barcelonès;08015;Badalona;8;11;U;;710;123;226;298;412;1;9;288;297
8;Barcelona;13;Barcelonès;08015;Badalona;8;12;A;;582;131;255;341;241;3;9;329;338
8;Barcelona;13;Barcelonès;08015;Badalona;8;12;B;;652;144;283;359;293;0;8;351;359
8;Barcelona;13;Barcelonès;08015;Badalona;8;12;C;;604;155;278;355;249;1;6;348;354
8;Barcelona;13;Barcelonès;08015;Badalona;8;13;U;;696;109;207;289;407;3;3;283;286
8;Barcelona;13;Barcelonès;08015;Badalona;8;2;A;;535;103;193;253;282;1;5;247;252
8;Barcelona;13;Barcelonès;08015;Badalona;8;2;B;;712;154;253;331;381;0;8;323;331
8;Barcelona;13;Barcelonès;08015;Badalona;8;2;C;;636;127;223;290;346;0;8;282;290
8;Barcelona;13;Barcelonès;08015;Badalona;8;3;A;;726;137;256;337;389;0;5;332;337
8;Barcelona;13;Barcelonès;08015;Badalona;8;3;B;;859;165;287;381;478;2;4;375;379
8;Barcelona;13;Barcelonès;08015;Badalona;8;4;U;;623;108;204;253;370;1;3;249;252
8;Barcelona;13;Barcelonès;08015;Badalona;8;5;U;;765;111;221;269;496;1;6;262;268
8;Barcelona;13;Barcelonès;08015;Badalona;8;6;A;;662;126;244;306;356;0;5;301;306
8;Barcelona;13;Barcelonès;08015;Badalona;8;6;B;;784;141;274;360;424;0;9;351;360
8;Barcelona;13;Barcelonès;08015;Badalona;8;7;A;;453;81;128;154;299;0;4;150;154
8;Barcelona;13;Barcelonès;08015;Badalona;8;7;B;;497;95;154;194;303;0;1;193;194
8;Barcelona;13;Barcelonès;08015;Badalona;8;8;A;;746;108;209;274;472;0;7;267;274
8;Barcelona;13;Barcelonès;08015;Badalona;8;8;B;;838;132;269;352;486;0;9;343;352
8;Barcelona;13;Barcelonès;08015;Badalona;8;9;A;;485;97;169;220;265;0;5;215;220
8;Barcelona;13;Barcelonès;08015;Badalona;8;9;B;;547;107;186;239;308;0;12;227;239
8;Barcelona;13;Barcelonès;08015;Badalona;9;1;U;;445;111;177;204;241;0;9;195;204
8;Barcelona;13;Barcelonès;08015;Badalona;9;10;A;;527;101;173;259;268;4;3;252;255
8;Barcelona;13;Barcelonès;08015;Badalona;9;10;B;;675;146;217;283;392;0;3;280;283
8;Barcelona;13;Barcelonès;08015;Badalona;9;11;U;;741;209;311;364;377;1;10;353;363
8;Barcelona;13;Barcelonès;08015;Badalona;9;12;U;;518;142;221;261;257;1;6;254;260
8;Barcelona;13;Barcelonès;08015;Badalona;9;13;U;;634;147;229;283;351;0;4;279;283
8;Barcelona;13;Barcelonès;08015;Badalona;9;14;A;;569;121;221;282;287;1;7;274;281
8;Barcelona;13;Barcelonès;08015;Badalona;9;14;B;;704;172;272;340;364;1;9;330;339
8;Barcelona;13;Barcelonès;08015;Badalona;9;15;U;;591;118;200;250;341;1;2;247;249
8;Barcelona;13;Barcelonès;08015;Badalona;9;16;A;;655;119;194;267;388;0;9;258;267
8;Barcelona;13;Barcelonès;08015;Badalona;9;16;B;;674;138;225;288;386;0;8;280;288
8;Barcelona;13;Barcelonès;08015;Badalona;9;17;U;;464;56;103;125;339;1;4;120;124
8;Barcelona;13;Barcelonès;08015;Badalona;9;18;U;;491;109;189;222;269;3;3;216;219
8;Barcelona;13;Barcelonès;08015;Badalona;9;19;A;;394;91;142;181;213;0;5;176;181
8;Barcelona;13;Barcelonès;08015;Badalona;9;19;B;;474;83;154;209;265;1;4;204;208
8;Barcelona;13;Barcelonès;08015;Badalona;9;2;A;;540;72;127;152;388;1;3;148;151
8;Barcelona;13;Barcelonès;08015;Badalona;9;2;B;;497;73;138;151;346;0;1;150;151
8;Barcelona;13;Barcelonès;08015;Badalona;9;20;U;;573;106;222;276;297;2;6;268;274
8;Barcelona;13;Barcelonès;08015;Badalona;9;21;A;;540;120;210;263;277;2;9;252;261
8;Barcelona;13;Barcelonès;08015;Badalona;9;21;B;;582;102;182;250;332;0;4;246;250
8;Barcelona;13;Barcelonès;08015;Badalona;9;22;A;;488;142;201;259;229;1;8;250;258
8;Barcelona;13;Barcelonès;08015;Badalona;9;22;B;;581;145;228;277;304;1;4;272;276
8;Barcelona;13;Barcelonès;08015;Badalona;9;23;U;;517;128;192;226;291;0;6;220;226
8;Barcelona;13;Barcelonès;08015;Badalona;9;24;A;;788;147;270;358;430;0;5;353;358
8;Barcelona;13;Barcelonès;08015;Badalona;9;24;B;;884;175;305;401;483;9;3;389;392
8;Barcelona;13;Barcelonès;08015;Badalona;9;25;A;;432;88;156;190;242;2;1;187;188
8;Barcelona;13;Barcelonès;08015;Badalona;9;25;B;;461;82;145;184;277;0;4;180;184
8;Barcelona;13;Barcelonès;08015;Badalona;9;26;A;;468;109;193;246;222;0;6;240;246
8;Barcelona;13;Barcelonès;08015;Badalona;9;26;B;;542;118;203;236;306;4;3;229;232
8;Barcelona;13;Barcelonès;08015;Badalona;9;27;U;;667;137;211;283;384;3;8;272;280
8;Barcelona;13;Barcelonès;08015;Badalona;9;28;A;;781;100;178;243;538;4;8;231;239
8;Barcelona;13;Barcelonès;08015;Badalona;9;28;B;;803;80;175;224;579;0;4;220;224
8;Barcelona;13;Barcelonès;08015;Badalona;9;29;U;;792;157;271;326;466;1;6;319;325
8;Barcelona;13;Barcelonès;08015;Badalona;9;3;U;;662;92;172;241;421;0;0;241;241
8;Barcelona;13;Barcelonès;08015;Badalona;9;30;U;;850;173;280;325;525;1;9;315;324
8;Barcelona;13;Barcelonès;08015;Badalona;9;31;A;;414;70;130;184;230;2;3;179;182
8;Barcelona;13;Barcelonès;08015;Badalona;9;31;B;;471;88;159;207;264;2;2;203;205
8;Barcelona;13;Barcelonès;08015;Badalona;9;32;U;;679;135;201;241;438;1;2;238;240
8;Barcelona;13;Barcelonès;08015;Badalona;9;33;A;;580;111;198;243;337;1;3;239;242
8;Barcelona;13;Barcelonès;08015;Badalona;9;33;B;;773;147;256;311;462;2;6;303;309
8;Barcelona;13;Barcelonès;08015;Badalona;9;34;A;;734;151;265;344;390;1;13;330;343
8;Barcelona;13;Barcelonès;08015;Badalona;9;34;B;;813;184;315;402;411;0;7;395;402
8;Barcelona;13;Barcelonès;08015;Badalona;9;35;A;;513;104;185;231;282;1;3;227;230
8;Barcelona;13;Barcelonès;08015;Badalona;9;35;B;;653;126;211;255;398;0;8;247;255
8;Barcelona;13;Barcelonès;08015;Badalona;9;36;A;;499;76;129;186;313;2;1;183;184
8;Barcelona;13;Barcelonès;08015;Badalona;9;36;B;;510;90;158;203;307;0;3;200;203
8;Barcelona;13;Barcelonès;08015;Badalona;9;37;U;;654;94;158;192;462;2;0;190;190
8;Barcelona;13;Barcelonès;08015;Badalona;9;38;U;;793;131;255;324;469;0;3;321;324
8;Barcelona;13;Barcelonès;08015;Badalona;9;4;A;;522;60;103;132;390;0;0;132;132
8;Barcelona;13;Barcelonès;08015;Badalona;9;4;B;;467;70;112;132;335;1;3;128;131
8;Barcelona;13;Barcelonès;08015;Badalona;9;42;U;;797;93;146;169;628;0;0;169;169
8;Barcelona;13;Barcelonès;08015;Badalona;9;43;A;;658;130;227;317;341;1;4;312;316
8;Barcelona;13;Barcelonès;08015;Badalona;9;43;B;;796;125;247;345;451;0;6;339;345
8;Barcelona;13;Barcelonès;08015;Badalona;9;44;U;;756;130;207;283;473;0;4;279;283
8;Barcelona;13;Barcelonès;08015;Badalona;9;45;A;;603;112;193;246;357;1;8;237;245
8;Barcelona;13;Barcelonès;08015;Badalona;9;45;B;;730;135;241;314;416;4;7;303;310
8;Barcelona;13;Barcelonès;08015;Badalona;9;46;U;;632;118;205;246;386;1;9;236;245
8;Barcelona;13;Barcelonès;08015;Badalona;9;47;U;;778;105;208;272;506;2;3;267;270
8;Barcelona;13;Barcelonès;08015;Badalona;9;48;U;;870;157;283;370;500;0;9;361;370
8;Barcelona;13;Barcelonès;08015;Badalona;9;49;A;;518;117;205;253;265;1;1;251;252
8;Barcelona;13;Barcelonès;08015;Badalona;9;49;B;;553;112;215;269;284;2;5;262;267
8;Barcelona;13;Barcelonès;08015;Badalona;9;5;A;;376;74;116;140;236;0;4;136;140
8;Barcelona;13;Barcelonès;08015;Badalona;9;5;B;;497;77;151;192;305;1;2;189;191
8;Barcelona;13;Barcelonès;08015;Badalona;9;50;U;;663;119;229;273;390;10;1;262;263
8;Barcelona;13;Barcelonès;08015;Badalona;9;52;U;;718;146;240;308;410;0;9;299;308
8;Barcelona;13;Barcelonès;08015;Badalona;9;53;U;;849;185;305;381;468;1;11;369;380
8;Barcelona;13;Barcelonès;08015;Badalona;9;54;A;;404;67;127;175;229;0;4;171;175
8;Barcelona;13;Barcelonès;08015;Badalona;9;54;B;;553;89;171;227;326;0;5;222;227
8;Barcelona;13;Barcelonès;08015;Badalona;9;55;U;;689;161;267;325;364;0;9;316;325
8;Barcelona;13;Barcelonès;08015;Badalona;9;56;U;;426;57;92;125;301;0;1;124;125
8;Barcelona;13;Barcelonès;08015;Badalona;9;57;A;;432;81;144;194;238;0;4;190;194
8;Barcelona;13;Barcelonès;08015;Badalona;9;57;B;;526;100;182;230;296;1;2;227;229
8;Barcelona;13;Barcelonès;08015;Badalona;9;58;A;;548;93;203;261;287;0;7;254;261
8;Barcelona;13;Barcelonès;08015;Badalona;9;58;B;;670;126;241;311;359;0;6;305;311
8;Barcelona;13;Barcelonès;08015;Badalona;9;59;A;;419;86;150;195;224;0;2;193;195
8;Barcelona;13;Barcelonès;08015;Badalona;9;59;B;;485;123;200;252;233;0;3;249;252
8;Barcelona;13;Barcelonès;08015;Badalona;9;6;A;;494;72;134;168;326;2;0;166;166
8;Barcelona;13;Barcelonès;08015;Badalona;9;6;B;;489;93;154;184;305;4;0;180;180
8;Barcelona;13;Barcelonès;08015;Badalona;9;8;A;;585;112;177;196;389;0;2;194;196
8;Barcelona;13;Barcelonès;08015;Badalona;9;8;B;;648;106;182;225;423;1;2;222;224
8;Barcelona;13;Barcelonès;08015;Badalona;9;9;A;;422;149;207;197;225;3;2;192;194
8;Barcelona;13;Barcelonès;08015;Badalona;9;9;B;;517;177;240;294;223;3;4;287;291
8;Barcelona;40;Vallès Occidental;08904;Badia del Vallès;1;1;A;;419;78;129;167;252;0;5;162;167
8;Barcelona;40;Vallès Occidental;08904;Badia del Vallès;1;1;B;;491;118;188;246;245;0;4;242;246
8;Barcelona;40;Vallès Occidental;08904;Badia del Vallès;1;10;A;;427;79;149;185;242;0;5;180;185
8;Barcelona;40;Vallès Occidental;08904;Badia del Vallès;1;10;B;;415;96;154;185;230;0;6;179;185
8;Barcelona;40;Vallès Occidental;08904;Badia del Vallès;1;11;A;;481;111;169;213;268;1;1;211;212
8;Barcelona;40;Vallès Occidental;08904;Badia del Vallès;1;11;B;;499;110;177;222;277;0;6;216;222
8;Barcelona;40;Vallès Occidental;08904;Badia del Vallès;1;12;A;;458;88;148;201;257;0;3;198;201
8;Barcelona;40;Vallès Occidental;08904;Badia del Vallès;1;12;B;;452;70;129;185;267;1;2;182;184
8;Barcelona;40;Vallès Occidental;08904;Badia del Vallès;1;2;U;;754;117;199;262;492;0;4;258;262
8;Barcelona;40;Vallès Occidental;08904;Badia del Vallès;1;3;A;;481;92;162;197;284;0;1;196;197
8;Barcelona;40;Vallès Occidental;08904;Badia del Vallès;1;3;B;;506;95;167;208;298;0;1;207;208
8;Barcelona;40;Vallès Occidental;08904;Badia del Vallès;1;4;A;;455;80;121;149;306;3;0;146;146
8;Barcelona;40;Vallès Occidental;08904;Badia del Vallès;1;4;B;;507;80;129;172;335;1;5;166;171
8;Barcelona;40;Vallès Occidental;08904;Badia del Vallès;1;5;A;;451;60;105;141;310;0;2;139;141
8;Barcelona;40;Vallès Occidental;08904;Badia del Vallès;1;5;B;;467;68;117;159;308;1;3;155;158
8;Barcelona;40;Vallès Occidental;08904;Badia del Vallès;1;6;A;;574;101;176;223;351;0;2;221;223
8;Barcelona;40;Vallès Occidental;08904;Badia del Vallès;1;6;B;;618;109;196;254;364;2;5;247;252
8;Barcelona;40;Vallès Occidental;08904;Badia del Vallès;1;7;A;;465;90;154;193;272;0;3;190;193
8;Barcelona;40;Vallès Occidental;08904;Badia del Vallès;1;7;B;;397;85;132;172;225;0;2;170;172
8;Barcelona;40;Vallès Occidental;08904;Badia del Vallès;1;8;A;;506;82;130;178;328;2;6;170;176
8;Barcelona;40;Vallès Occidental;08904;Badia del Vallès;1;8;B;;386;73;125;164;222;1;3;160;163
8;Barcelona;40;Vallès Occidental;08904;Badia del Vallès;1;9;A;;484;91;150;184;300;1;5;178;183
8;Barcelona;40;Vallès Occidental;08904;Badia del Vallès;1;9;B;;412;70;122;157;255;0;4;153;157
8;Barcelona;14;Berguedà;08016;Bagà;1;1;A;;862;222;416;527;335;3;12;512;524
8;Barcelona;14;Berguedà;08016;Bagà;1;1;B;;976;265;513;645;331;2;11;632;643
25;Lleida;26;Pallars Sobirà;25039;Baix Pallars;1;1;U;;316;87;150;209;107;0;3;206;209
25;Lleida;23;Noguera;25040;Balaguer;1;1;A;;415;121;199;242;173;3;1;238;239
25;Lleida;23;Noguera;25040;Balaguer;1;1;B;;422;145;222;261;161;2;3;256;259
25;Lleida;23;Noguera;25040;Balaguer;1;2;U;;889;203;411;537;352;2;9;526;535
25;Lleida;23;Noguera;25040;Balaguer;2;1;A;;365;49;92;99;266;2;0;97;97
25;Lleida;23;Noguera;25040;Balaguer;2;1;B;;276;68;117;144;132;3;5;136;141
25;Lleida;23;Noguera;25040;Balaguer;2;1;C;;327;45;90;122;205;1;2;119;121
25;Lleida;23;Noguera;25040;Balaguer;3;1;A;;907;212;395;515;392;5;7;503;510
25;Lleida;23;Noguera;25040;Balaguer;3;1;B;;938;218;413;525;413;5;9;511;520
25;Lleida;23;Noguera;25040;Balaguer;3;2;U;;814;161;326;454;360;7;14;433;447
25;Lleida;23;Noguera;25040;Balaguer;4;1;A;;631;193;336;421;210;6;7;408;415
25;Lleida;23;Noguera;25040;Balaguer;4;1;B;;690;176;364;464;226;4;6;454;460
25;Lleida;23;Noguera;25040;Balaguer;4;2;A;;674;158;313;388;286;2;12;374;386
25;Lleida;23;Noguera;25040;Balaguer;4;2;B;;760;194;373;477;283;3;10;464;474
25;Lleida;23;Noguera;25040;Balaguer;4;3;A;;535;112;260;342;193;2;7;333;340
25;Lleida;23;Noguera;25040;Balaguer;4;3;B;;608;138;312;399;209;1;8;390;398
25;Lleida;23;Noguera;25040;Balaguer;4;4;A;;688;150;310;426;262;3;6;417;423
25;Lleida;23;Noguera;25040;Balaguer;4;4;B;;860;212;430;554;306;1;13;540;553
8;Barcelona;24;Osona;08017;Balenyà;1;1;A;;643;183;342;414;229;3;6;405;411
8;Barcelona;24;Osona;08017;Balenyà;1;1;B;;584;167;296;353;231;1;6;346;352
8;Barcelona;24;Osona;08017;Balenyà;1;1;C;;735;207;403;473;262;2;5;466;471
8;Barcelona;24;Osona;08017;Balenyà;1;2;U;;711;170;355;429;282;4;7;418;425
8;Barcelona;7;Bages;08018;Balsareny;1;1;A;;702;142;337;409;293;4;4;401;405
8;Barcelona;7;Bages;08018;Balsareny;1;1;B;;640;150;341;404;236;3;7;394;401
8;Barcelona;7;Bages;08018;Balsareny;1;2;A;;505;114;228;281;224;3;8;270;278
8;Barcelona;7;Bages;08018;Balsareny;1;2;B;;540;150;279;318;222;3;8;307;315
8;Barcelona;7;Bages;08018;Balsareny;1;3;U;;342;125;186;214;128;0;6;208;214
43;Tarragona;12;Baix Penedès;43020;Banyeres del Penedès;1;1;A;;615;161;293;352;263;3;3;346;349
43;Tarragona;12;Baix Penedès;43020;Banyeres del Penedès;1;1;B;;665;154;286;356;309;3;8;345;353
43;Tarragona;12;Baix Penedès;43020;Banyeres del Penedès;1;1;C;;677;174;323;391;286;5;3;383;386
17;Girona;28;Pla de l'Estany;17015;Banyoles;1;1;A;;564;180;284;351;213;3;6;342;348
17;Girona;28;Pla de l'Estany;17015;Banyoles;1;1;B;;619;224;351;425;194;4;7;414;421
17;Girona;28;Pla de l'Estany;17015;Banyoles;1;2;U;;635;200;383;447;188;7;10;430;440
17;Girona;28;Pla de l'Estany;17015;Banyoles;1;3;U;;841;304;468;535;306;7;10;518;528
17;Girona;28;Pla de l'Estany;17015;Banyoles;1;4;A;;561;170;307;359;202;5;5;349;354
17;Girona;28;Pla de l'Estany;17015;Banyoles;1;4;B;;649;217;345;401;248;3;12;386;398
17;Girona;28;Pla de l'Estany;17015;Banyoles;1;5;A;;485;139;254;309;176;3;12;294;306
17;Girona;28;Pla de l'Estany;17015;Banyoles;1;5;B;;517;152;289;336;181;0;6;330;336
17;Girona;28;Pla de l'Estany;17015;Banyoles;2;1;A;;609;215;326;394;215;5;18;371;389
17;Girona;28;Pla de l'Estany;17015;Banyoles;2;1;B;;693;223;368;450;243;8;16;426;442
17;Girona;28;Pla de l'Estany;17015;Banyoles;2;2;U;;821;305;475;577;244;3;12;562;574
17;Girona;28;Pla de l'Estany;17015;Banyoles;2;3;A;;631;197;334;413;218;4;4;405;409
17;Girona;28;Pla de l'Estany;17015;Banyoles;2;3;B;;670;216;353;430;240;8;12;410;422
17;Girona;28;Pla de l'Estany;17015;Banyoles;2;4;U;;516;168;283;336;180;2;10;324;334
17;Girona;28;Pla de l'Estany;17015;Banyoles;2;5;U;;795;267;442;536;259;3;18;515;533
17;Girona;28;Pla de l'Estany;17015;Banyoles;3;1;A;;589;203;357;402;187;2;10;390;400
17;Girona;28;Pla de l'Estany;17015;Banyoles;3;1;B;;641;230;374;438;203;3;7;428;435
17;Girona;28;Pla de l'Estany;17015;Banyoles;3;2;U;;759;204;359;420;339;1;22;397;419
25;Lleida;27;Pla d'Urgell;25041;Barbens;1;1;U;;644;177;327;417;227;7;9;401;410
43;Tarragona;16;Conca de Barberà;43021;Barberà de la Conca;1;1;U;;382;94;168;212;170;5;5;202;207
8;Barcelona;40;Vallès Occidental;08252;Barberà del Vallès;1;1;A;;974;185;358;514;460;0;17;497;514
8;Barcelona;40;Vallès Occidental;08252;Barberà del Vallès;1;1;B;;931;163;329;472;459;2;12;458;470
8;Barcelona;40;Vallès Occidental;08252;Barberà del Vallès;1;10;A;;562;108;225;284;278;1;3;280;283
8;Barcelona;40;Vallès Occidental;08252;Barberà del Vallès;1;10;B;;629;115;225;320;309;2;2;316;318
8;Barcelona;40;Vallès Occidental;08252;Barberà del Vallès;1;11;A;;714;139;262;380;334;2;7;371;378
8;Barcelona;40;Vallès Occidental;08252;Barberà del Vallès;1;11;B;;623;113;239;313;310;1;4;308;312
8;Barcelona;40;Vallès Occidental;08252;Barberà del Vallès;1;18;U;;805;147;264;358;447;0;7;351;358
8;Barcelona;40;Vallès Occidental;08252;Barberà del Vallès;1;19;A;;603;126;208;289;314;1;10;278;288
8;Barcelona;40;Vallès Occidental;08252;Barberà del Vallès;1;19;B;;507;95;186;258;249;0;8;250;258
8;Barcelona;40;Vallès Occidental;08252;Barberà del Vallès;1;2;U;;869;155;275;380;489;1;6;373;379
8;Barcelona;40;Vallès Occidental;08252;Barberà del Vallès;1;20;U;;817;159;294;386;431;2;4;380;384
8;Barcelona;40;Vallès Occidental;08252;Barberà del Vallès;1;21;A;;523;104;198;261;262;1;5;255;260
8;Barcelona;40;Vallès Occidental;08252;Barberà del Vallès;1;21;B;;503;74;169;230;273;0;4;226;230
8;Barcelona;40;Vallès Occidental;08252;Barberà del Vallès;1;22;A;;897;180;355;497;400;3;7;487;494
8;Barcelona;40;Vallès Occidental;08252;Barberà del Vallès;1;22;B;;823;184;369;471;352;0;7;464;471
8;Barcelona;40;Vallès Occidental;08252;Barberà del Vallès;1;23;U;;645;142;284;369;276;0;4;365;369
8;Barcelona;40;Vallès Occidental;08252;Barberà del Vallès;1;24;U;;743;171;285;383;360;3;6;374;380
8;Barcelona;40;Vallès Occidental;08252;Barberà del Vallès;1;25;U;;849;172;311;424;425;3;11;410;421
8;Barcelona;40;Vallès Occidental;08252;Barberà del Vallès;1;26;A;;847;150;308;429;418;4;4;421;425
8;Barcelona;40;Vallès Occidental;08252;Barberà del Vallès;1;26;B;;720;146;272;380;340;0;11;369;380
8;Barcelona;40;Vallès Occidental;08252;Barberà del Vallès;1;27;U;;643;135;272;358;285;3;17;338;355
8;Barcelona;40;Vallès Occidental;08252;Barberà del Vallès;1;28;U;;580;99;197;288;292;1;3;284;287
8;Barcelona;40;Vallès Occidental;08252;Barberà del Vallès;1;3;A;;668;118;225;288;380;0;3;285;288
8;Barcelona;40;Vallès Occidental;08252;Barberà del Vallès;1;3;B;;544;103;177;235;309;0;2;233;235
8;Barcelona;40;Vallès Occidental;08252;Barberà del Vallès;1;4;A;;564;111;199;272;292;0;4;268;272
8;Barcelona;40;Vallès Occidental;08252;Barberà del Vallès;1;4;B;;562;130;219;293;269;0;6;287;293
8;Barcelona;40;Vallès Occidental;08252;Barberà del Vallès;1;5;A;;561;111;198;251;310;1;4;246;250
8;Barcelona;40;Vallès Occidental;08252;Barberà del Vallès;1;5;B;;509;90;188;249;260;0;4;245;249
8;Barcelona;40;Vallès Occidental;08252;Barberà del Vallès;1;6;U;;879;172;330;442;437;3;6;433;439
8;Barcelona;40;Vallès Occidental;08252;Barberà del Vallès;1;7;U;;763;154;308;406;357;5;5;396;401
8;Barcelona;40;Vallès Occidental;08252;Barberà del Vallès;1;8;A;;534;98;177;231;303;2;4;225;229
8;Barcelona;40;Vallès Occidental;08252;Barberà del Vallès;1;8;B;;461;91;164;225;236;0;0;225;225
8;Barcelona;40;Vallès Occidental;08252;Barberà del Vallès;1;9;U;;667;126;241;327;340;2;5;320;325
8;Barcelona;13;Barcelonès;08019;Barcelona;1;1;U;;372;97;142;199;173;1;1;197;198
8;Barcelona;13;Barcelonès;08019;Barcelona;1;100;U;;872;195;318;365;507;1;4;360;364
8;Barcelona;13;Barcelonès;08019;Barcelona;1;103;U;;712;144;282;353;359;2;11;340;351
8;Barcelona;13;Barcelonès;08019;Barcelona;1;104;U;;639;135;308;247;392;3;4;240;244
8;Barcelona;13;Barcelonès;08019;Barcelona;1;105;U;;621;119;193;231;390;1;3;227;230
8;Barcelona;13;Barcelonès;08019;Barcelona;1;109;U;;979;208;338;390;589;1;10;379;389
8;Barcelona;13;Barcelonès;08019;Barcelona;1;11;U;;1157;286;479;569;588;3;12;554;566
8;Barcelona;13;Barcelonès;08019;Barcelona;1;112;U;;743;175;277;329;414;0;7;322;329
8;Barcelona;13;Barcelonès;08019;Barcelona;1;114;U;;443;102;163;183;260;0;5;178;183
8;Barcelona;13;Barcelonès;08019;Barcelona;1;115;U;;966;204;328;390;576;1;8;381;389
8;Barcelona;13;Barcelonès;08019;Barcelona;1;116;U;;584;93;159;198;386;0;6;192;198
8;Barcelona;13;Barcelonès;08019;Barcelona;1;118;U;;626;123;215;259;367;1;2;256;258
8;Barcelona;13;Barcelonès;08019;Barcelona;1;120;U;;732;180;266;331;401;2;5;324;329
8;Barcelona;13;Barcelonès;08019;Barcelona;1;122;U;;462;89;148;191;271;0;6;185;191
8;Barcelona;13;Barcelonès;08019;Barcelona;1;123;U;;589;177;284;340;249;0;3;337;340
8;Barcelona;13;Barcelonès;08019;Barcelona;1;124;U;;638;133;213;251;387;0;7;244;251
8;Barcelona;13;Barcelonès;08019;Barcelona;1;126;U;;610;190;273;313;297;3;5;305;310
8;Barcelona;13;Barcelonès;08019;Barcelona;1;127;U;;595;144;247;311;284;0;6;305;311
8;Barcelona;13;Barcelonès;08019;Barcelona;1;129;U;;474;145;218;262;212;0;4;258;262
8;Barcelona;13;Barcelonès;08019;Barcelona;1;13;U;;740;192;305;355;385;3;4;348;352
8;Barcelona;13;Barcelonès;08019;Barcelona;1;130;U;;667;168;308;319;348;2;4;313;317
8;Barcelona;13;Barcelonès;08019;Barcelona;1;132;U;;524;144;243;295;229;2;9;284;293
8;Barcelona;13;Barcelonès;08019;Barcelona;1;134;U;;622;156;237;286;336;0;5;281;286
8;Barcelona;13;Barcelonès;08019;Barcelona;1;137;U;;386;8;137;158;228;3;3;152;155
8;Barcelona;13;Barcelonès;08019;Barcelona;1;138;U;;376;96;143;169;207;1;5;163;168
8;Barcelona;13;Barcelonès;08019;Barcelona;1;139;U;;529;127;229;274;255;3;8;263;271
8;Barcelona;13;Barcelonès;08019;Barcelona;1;14;U;;983;237;407;475;508;4;9;462;471
8;Barcelona;13;Barcelonès;08019;Barcelona;1;140;U;;467;114;202;225;242;0;6;219;225
8;Barcelona;13;Barcelonès;08019;Barcelona;1;141;U;;447;131;183;226;221;1;1;224;225
8;Barcelona;13;Barcelonès;08019;Barcelona;1;142;U;;516;124;213;252;264;1;14;237;251
8;Barcelona;13;Barcelonès;08019;Barcelona;1;144;U;;579;159;256;296;283;0;2;294;296
8;Barcelona;13;Barcelonès;08019;Barcelona;1;146;U;;664;183;296;350;314;1;4;345;349
8;Barcelona;13;Barcelonès;08019;Barcelona;1;148;U;;628;187;319;399;229;3;8;388;396
8;Barcelona;13;Barcelonès;08019;Barcelona;1;150;U;;485;144;235;280;205;0;9;271;280
8;Barcelona;13;Barcelonès;08019;Barcelona;1;151;U;;531;127;232;286;245;2;3;281;284
8;Barcelona;13;Barcelonès;08019;Barcelona;1;18;U;;511;100;163;198;313;0;0;198;198
8;Barcelona;13;Barcelonès;08019;Barcelona;1;19;U;;603;137;222;263;340;0;1;262;263
8;Barcelona;13;Barcelonès;08019;Barcelona;1;2;U;;436;95;165;207;229;1;6;200;206
8;Barcelona;13;Barcelonès;08019;Barcelona;1;20;U;;612;139;215;253;359;0;2;251;253
8;Barcelona;13;Barcelonès;08019;Barcelona;1;22;U;;399;97;155;169;230;1;2;166;168
8;Barcelona;13;Barcelonès;08019;Barcelona;1;23;A;;745;172;320;361;384;2;6;353;359
8;Barcelona;13;Barcelonès;08019;Barcelona;1;23;B;;691;211;271;328;363;1;9;318;327
8;Barcelona;13;Barcelonès;08019;Barcelona;1;25;U;;615;170;272;347;268;1;11;335;346
8;Barcelona;13;Barcelonès;08019;Barcelona;1;27;U;;695;194;339;392;303;1;9;382;391
8;Barcelona;13;Barcelonès;08019;Barcelona;1;29;U;;805;223;371;431;374;1;6;424;430
8;Barcelona;13;Barcelonès;08019;Barcelona;1;3;U;;532;125;193;226;306;0;1;225;226
8;Barcelona;13;Barcelonès;08019;Barcelona;1;31;U;;514;108;186;231;283;1;8;222;230
8;Barcelona;13;Barcelonès;08019;Barcelona;1;32;U;;354;88;148;192;162;0;2;190;192
8;Barcelona;13;Barcelonès;08019;Barcelona;1;33;U;;458;108;180;210;248;0;6;204;210
8;Barcelona;13;Barcelonès;08019;Barcelona;1;34;U;;678;171;171;360;318;0;10;350;360
8;Barcelona;13;Barcelonès;08019;Barcelona;1;36;U;;668;212;317;381;287;4;10;367;377
8;Barcelona;13;Barcelonès;08019;Barcelona;1;38;U;;511;112;182;233;278;1;3;229;232
8;Barcelona;13;Barcelonès;08019;Barcelona;1;39;U;;650;180;316;392;258;0;4;388;392
8;Barcelona;13;Barcelonès;08019;Barcelona;1;40;U;;817;207;332;378;439;0;2;376;378
8;Barcelona;13;Barcelonès;08019;Barcelona;1;43;U;;377;84;143;179;198;0;8;171;179
8;Barcelona;13;Barcelonès;08019;Barcelona;1;45;U;;1233;315;541;654;579;3;19;632;651
8;Barcelona;13;Barcelonès;08019;Barcelona;1;46;U;;818;200;295;362;456;1;10;351;361
8;Barcelona;13;Barcelonès;08019;Barcelona;1;48;U;;477;118;184;229;248;2;3;224;227
8;Barcelona;13;Barcelonès;08019;Barcelona;1;5;U;;411;100;150;180;231;1;4;175;179
8;Barcelona;13;Barcelonès;08019;Barcelona;1;50;U;;728;235;361;413;315;3;3;407;410
8;Barcelona;13;Barcelonès;08019;Barcelona;1;52;U;;503;125;238;280;223;1;8;271;279
8;Barcelona;13;Barcelonès;08019;Barcelona;1;53;U;;577;139;231;274;303;1;8;265;273
8;Barcelona;13;Barcelonès;08019;Barcelona;1;54;U;;438;97;167;207;231;2;3;202;205
8;Barcelona;13;Barcelonès;08019;Barcelona;1;55;U;;385;88;158;190;195;0;5;185;190
8;Barcelona;13;Barcelonès;08019;Barcelona;1;56;U;;789;245;386;478;311;1;11;466;477
8;Barcelona;13;Barcelonès;08019;Barcelona;1;58;U;;587;175;315;367;220;2;8;357;365
8;Barcelona;13;Barcelonès;08019;Barcelona;1;59;U;;516;122;210;260;256;1;6;253;259
8;Barcelona;13;Barcelonès;08019;Barcelona;1;6;U;;551;115;182;211;340;0;0;211;211
8;Barcelona;13;Barcelonès;08019;Barcelona;1;61;U;;615;165;286;351;264;1;9;341;350
8;Barcelona;13;Barcelonès;08019;Barcelona;1;63;U;;839;270;440;541;298;1;11;529;540
8;Barcelona;13;Barcelonès;08019;Barcelona;1;66;U;;641;141;247;301;340;1;7;293;300
8;Barcelona;13;Barcelonès;08019;Barcelona;1;68;U;;1533;152;268;317;1216;2;12;303;315
8;Barcelona;13;Barcelonès;08019;Barcelona;1;69;U;;550;174;265;299;251;2;6;291;297
8;Barcelona;13;Barcelonès;08019;Barcelona;1;7;U;;534;114;185;230;304;1;1;228;229
8;Barcelona;13;Barcelonès;08019;Barcelona;1;71;U;;611;125;220;281;330;2;8;271;279
8;Barcelona;13;Barcelonès;08019;Barcelona;1;73;U;;1223;307;499;611;612;12;13;586;599
8;Barcelona;13;Barcelonès;08019;Barcelona;1;77;U;;673;191;313;367;306;3;9;355;364
8;Barcelona;13;Barcelonès;08019;Barcelona;1;79;U;;513;118;202;229;284;0;4;225;229
8;Barcelona;13;Barcelonès;08019;Barcelona;1;8;U;;547;159;237;251;296;0;8;243;251
8;Barcelona;13;Barcelonès;08019;Barcelona;1;82;U;;622;156;277;326;296;3;3;320;323
8;Barcelona;13;Barcelonès;08019;Barcelona;1;83;U;;753;201;300;378;375;6;5;367;372
8;Barcelona;13;Barcelonès;08019;Barcelona;1;86;U;;398;115;230;194;204;1;4;189;193
8;Barcelona;13;Barcelonès;08019;Barcelona;1;87;U;;696;155;233;272;424;5;4;263;267
8;Barcelona;13;Barcelonès;08019;Barcelona;1;88;U;;489;133;235;306;183;1;8;297;305
8;Barcelona;13;Barcelonès;08019;Barcelona;1;89;U;;748;210;316;363;385;3;9;351;360
8;Barcelona;13;Barcelonès;08019;Barcelona;1;9;U;;785;227;323;386;399;5;3;378;381
8;Barcelona;13;Barcelonès;08019;Barcelona;1;91;U;;710;166;249;299;411;1;4;294;298
8;Barcelona;13;Barcelonès;08019;Barcelona;1;94;U;;720;171;281;340;380;0;4;336;340
8;Barcelona;13;Barcelonès;08019;Barcelona;1;95;U;;860;180;300;351;509;0;9;342;351
8;Barcelona;13;Barcelonès;08019;Barcelona;1;97;U;;528;92;179;212;316;2;6;204;210
8;Barcelona;13;Barcelonès;08019;Barcelona;1;99;U;;475;104;159;182;293;4;2;176;178
8;Barcelona;13;Barcelonès;08019;Barcelona;10;1;U;;1075;249;516;673;402;1;14;658;672
8;Barcelona;13;Barcelonès;08019;Barcelona;10;10;A;;744;237;387;472;272;2;4;466;470
8;Barcelona;13;Barcelonès;08019;Barcelona;10;10;B;;614;189;312;390;224;0;6;384;390
8;Barcelona;13;Barcelonès;08019;Barcelona;10;100;U;;525;156;256;320;205;0;8;312;320
8;Barcelona;13;Barcelonès;08019;Barcelona;10;101;A;;843;214;396;495;348;0;7;488;495
8;Barcelona;13;Barcelonès;08019;Barcelona;10;101;B;;896;223;382;482;414;0;6;476;482
8;Barcelona;13;Barcelonès;08019;Barcelona;10;101;C;;875;212;375;472;403;0;8;464;472
8;Barcelona;13;Barcelonès;08019;Barcelona;10;102;A;;711;221;363;478;233;0;20;458;478
8;Barcelona;13;Barcelonès;08019;Barcelona;10;102;B;;587;162;292;379;208;0;10;369;379
8;Barcelona;13;Barcelonès;08019;Barcelona;10;103;A;;780;233;371;473;307;2;14;457;471
8;Barcelona;13;Barcelonès;08019;Barcelona;10;103;B;;669;201;312;404;265;1;10;393;403
8;Barcelona;13;Barcelonès;08019;Barcelona;10;104;U;;725;235;356;426;299;1;4;421;425
8;Barcelona;13;Barcelonès;08019;Barcelona;10;105;U;;1022;293;525;652;370;4;10;638;648
8;Barcelona;13;Barcelonès;08019;Barcelona;10;106;U;;1103;296;572;688;415;7;20;661;681
8;Barcelona;13;Barcelonès;08019;Barcelona;10;107;U;;617;163;296;363;254;2;7;354;361
8;Barcelona;13;Barcelonès;08019;Barcelona;10;108;U;;621;200;324;403;218;0;9;394;403
8;Barcelona;13;Barcelonès;08019;Barcelona;10;109;U;;738;243;379;457;281;2;11;444;455
8;Barcelona;13;Barcelonès;08019;Barcelona;10;11;U;;1103;326;624;754;349;3;21;730;751
8;Barcelona;13;Barcelonès;08019;Barcelona;10;110;U;;585;182;284;341;244;3;7;331;338
8;Barcelona;13;Barcelonès;08019;Barcelona;10;111;U;;849;242;432;520;329;1;14;505;519
8;Barcelona;13;Barcelonès;08019;Barcelona;10;113;A;;668;210;328;412;256;0;4;408;412
8;Barcelona;13;Barcelonès;08019;Barcelona;10;113;B;;610;181;232;376;234;0;8;368;376
8;Barcelona;13;Barcelonès;08019;Barcelona;10;115;U;;772;216;380;468;304;2;8;458;466
8;Barcelona;13;Barcelonès;08019;Barcelona;10;116;U;;998;282;518;639;359;4;7;628;635
8;Barcelona;13;Barcelonès;08019;Barcelona;10;117;U;;557;173;295;347;210;0;5;342;347
8;Barcelona;13;Barcelonès;08019;Barcelona;10;118;U;;848;244;421;514;334;2;14;498;512
8;Barcelona;13;Barcelonès;08019;Barcelona;10;120;U;;589;182;298;356;233;3;5;348;353
8;Barcelona;13;Barcelonès;08019;Barcelona;10;121;U;;845;282;468;558;287;3;18;537;555
8;Barcelona;13;Barcelonès;08019;Barcelona;10;122;U;;1014;305;529;680;334;0;12;668;680
8;Barcelona;13;Barcelonès;08019;Barcelona;10;123;U;;987;303;493;591;396;1;11;579;590
8;Barcelona;13;Barcelonès;08019;Barcelona;10;125;U;;514;161;293;352;162;2;8;342;350
8;Barcelona;13;Barcelonès;08019;Barcelona;10;126;U;;441;135;228;276;165;0;8;268;276
8;Barcelona;13;Barcelonès;08019;Barcelona;10;127;U;;994;272;483;591;403;3;10;578;588
8;Barcelona;13;Barcelonès;08019;Barcelona;10;129;U;;496;145;247;311;185;1;10;300;310
8;Barcelona;13;Barcelonès;08019;Barcelona;10;130;U;;886;252;458;558;328;3;11;544;555
8;Barcelona;13;Barcelonès;08019;Barcelona;10;132;U;;454;136;224;284;170;0;1;283;284
8;Barcelona;13;Barcelonès;08019;Barcelona;10;133;U;;1173;354;625;831;342;6;15;810;825
8;Barcelona;13;Barcelonès;08019;Barcelona;10;134;U;;755;217;387;471;284;1;8;462;470
8;Barcelona;13;Barcelonès;08019;Barcelona;10;135;U;;885;267;442;524;361;5;9;510;519
8;Barcelona;13;Barcelonès;08019;Barcelona;10;137;U;;517;157;253;314;203;4;10;300;310
8;Barcelona;13;Barcelonès;08019;Barcelona;10;138;U;;838;283;474;561;277;1;13;547;560
8;Barcelona;13;Barcelonès;08019;Barcelona;10;139;U;;753;217;283;485;268;1;16;468;484
8;Barcelona;13;Barcelonès;08019;Barcelona;10;14;U;;1115;324;596;751;364;0;21;730;751
8;Barcelona;13;Barcelonès;08019;Barcelona;10;140;U;;1099;349;600;723;376;0;14;709;723
8;Barcelona;13;Barcelonès;08019;Barcelona;10;142;U;;748;234;380;462;286;1;13;448;461
8;Barcelona;13;Barcelonès;08019;Barcelona;10;143;U;;432;134;219;261;171;2;6;253;259
8;Barcelona;13;Barcelonès;08019;Barcelona;10;144;U;;706;208;357;455;251;3;8;444;452
8;Barcelona;13;Barcelonès;08019;Barcelona;10;145;U;;789;216;367;441;348;0;6;435;441
8;Barcelona;13;Barcelonès;08019;Barcelona;10;146;U;;688;185;314;401;287;0;3;398;401
8;Barcelona;13;Barcelonès;08019;Barcelona;10;147;U;;666;206;364;429;237;1;5;423;428
8;Barcelona;13;Barcelonès;08019;Barcelona;10;149;U;;816;237;412;521;295;1;9;511;520
8;Barcelona;13;Barcelonès;08019;Barcelona;10;150;U;;926;285;517;592;334;3;15;574;589
8;Barcelona;13;Barcelonès;08019;Barcelona;10;151;U;;640;201;334;411;229;1;5;405;410
8;Barcelona;13;Barcelonès;08019;Barcelona;10;152;U;;1109;345;567;701;408;3;26;672;698
8;Barcelona;13;Barcelonès;08019;Barcelona;10;154;U;;956;304;523;626;330;0;12;614;626
8;Barcelona;13;Barcelonès;08019;Barcelona;10;155;U;;1171;348;580;703;468;7;12;684;696
8;Barcelona;13;Barcelonès;08019;Barcelona;10;156;A;;695;184;354;454;241;0;8;446;454
8;Barcelona;13;Barcelonès;08019;Barcelona;10;156;B;;608;175;314;385;223;1;5;379;384
8;Barcelona;13;Barcelonès;08019;Barcelona;10;158;U;;543;143;247;320;223;0;9;311;320
8;Barcelona;13;Barcelonès;08019;Barcelona;10;160;U;;1047;292;484;602;445;1;8;593;601
8;Barcelona;13;Barcelonès;08019;Barcelona;10;161;U;;1164;320;575;710;454;3;22;685;707
8;Barcelona;13;Barcelonès;08019;Barcelona;10;163;A;;795;215;386;479;316;3;11;465;476
8;Barcelona;13;Barcelonès;08019;Barcelona;10;163;B;;700;182;357;425;275;0;11;414;425
8;Barcelona;13;Barcelonès;08019;Barcelona;10;164;A;;680;181;349;427;253;0;8;419;427
8;Barcelona;13;Barcelonès;08019;Barcelona;10;164;B;;646;173;322;398;248;1;10;387;397
8;Barcelona;13;Barcelonès;08019;Barcelona;10;165;U;;829;248;397;478;351;0;10;468;478
8;Barcelona;13;Barcelonès;08019;Barcelona;10;166;U;;840;245;403;488;352;1;5;482;487
8;Barcelona;13;Barcelonès;08019;Barcelona;10;168;U;;683;176;283;339;344;4;6;329;335
8;Barcelona;13;Barcelonès;08019;Barcelona;10;170;U;;764;227;371;426;338;1;10;415;425
8;Barcelona;13;Barcelonès;08019;Barcelona;10;172;U;;668;187;331;411;257;1;13;397;410
8;Barcelona;13;Barcelonès;08019;Barcelona;10;173;A;;717;203;364;466;251;0;9;457;466
8;Barcelona;13;Barcelonès;08019;Barcelona;10;173;B;;662;167;315;420;242;2;10;408;418
8;Barcelona;13;Barcelonès;08019;Barcelona;10;174;U;;1231;30;545;721;510;5;11;705;716
8;Barcelona;13;Barcelonès;08019;Barcelona;10;175;U;;877;272;455;502;375;0;8;494;502
8;Barcelona;13;Barcelonès;08019;Barcelona;10;176;U;;1203;306;516;654;549;11;16;627;643
8;Barcelona;13;Barcelonès;08019;Barcelona;10;177;U;;499;191;299;324;175;1;2;321;323
8;Barcelona;13;Barcelonès;08019;Barcelona;10;178;U;;755;260;393;466;289;1;13;452;465
8;Barcelona;13;Barcelonès;08019;Barcelona;10;18;U;;767;210;331;397;370;1;6;390;396
8;Barcelona;13;Barcelonès;08019;Barcelona;10;180;U;;895;335;482;552;343;5;9;538;547
8;Barcelona;13;Barcelonès;08019;Barcelona;10;182;U;;417;175;223;252;165;0;4;248;252
8;Barcelona;13;Barcelonès;08019;Barcelona;10;183;A;;881;254;415;511;370;1;11;499;510
8;Barcelona;13;Barcelonès;08019;Barcelona;10;183;B;;811;222;374;487;324;0;10;477;487
8;Barcelona;13;Barcelonès;08019;Barcelona;10;184;U;;1044;318;543;647;397;2;11;634;645
8;Barcelona;13;Barcelonès;08019;Barcelona;10;185;U;;890;245;415;566;324;0;18;548;566
8;Barcelona;13;Barcelonès;08019;Barcelona;10;186;U;;413;171;248;298;115;1;3;294;297
8;Barcelona;13;Barcelonès;08019;Barcelona;10;187;U;;675;216;342;406;269;2;7;397;404
8;Barcelona;13;Barcelonès;08019;Barcelona;10;189;U;;546;169;267;318;228;0;4;314;318
8;Barcelona;13;Barcelonès;08019;Barcelona;10;190;U;;616;178;312;364;252;0;7;357;364
8;Barcelona;13;Barcelonès;08019;Barcelona;10;191;U;;888;271;473;583;305;3;8;572;580
8;Barcelona;13;Barcelonès;08019;Barcelona;10;192;A;;699;201;345;408;291;2;12;394;406
8;Barcelona;13;Barcelonès;08019;Barcelona;10;192;B;;652;191;313;378;274;1;4;373;377
8;Barcelona;13;Barcelonès;08019;Barcelona;10;194;U;;1246;250;464;580;666;4;13;563;576
8;Barcelona;13;Barcelonès;08019;Barcelona;10;195;A;;698;195;296;371;327;2;2;367;369
8;Barcelona;13;Barcelonès;08019;Barcelona;10;195;B;;708;172;301;376;332;1;5;370;375
8;Barcelona;13;Barcelonès;08019;Barcelona;10;197;U;;860;307;481;583;277;7;9;567;576
8;Barcelona;13;Barcelonès;08019;Barcelona;10;198;U;;699;218;349;425;274;1;3;421;424
8;Barcelona;13;Barcelonès;08019;Barcelona;10;199;U;;994;286;463;572;422;0;9;563;572
8;Barcelona;13;Barcelonès;08019;Barcelona;10;2;U;;1215;354;612;747;468;2;22;723;745
8;Barcelona;13;Barcelonès;08019;Barcelona;10;20;U;;576;162;237;289;287;3;5;281;286
8;Barcelona;13;Barcelonès;08019;Barcelona;10;200;U;;776;237;349;432;344;0;7;425;432
8;Barcelona;13;Barcelonès;08019;Barcelona;10;201;U;;403;121;176;228;175;2;5;221;226
8;Barcelona;13;Barcelonès;08019;Barcelona;10;202;A;;826;215;308;482;344;3;11;468;479
8;Barcelona;13;Barcelonès;08019;Barcelona;10;202;B;;683;162;308;396;287;1;13;382;395
8;Barcelona;13;Barcelonès;08019;Barcelona;10;203;U;;547;141;276;301;246;0;3;298;301
8;Barcelona;13;Barcelonès;08019;Barcelona;10;204;U;;588;137;266;320;268;2;5;313;318
8;Barcelona;13;Barcelonès;08019;Barcelona;10;205;U;;436;154;204;252;184;0;2;250;252
8;Barcelona;13;Barcelonès;08019;Barcelona;10;206;U;;996;230;430;565;431;3;9;553;562
8;Barcelona;13;Barcelonès;08019;Barcelona;10;207;U;;1205;330;600;747;458;1;22;724;746
8;Barcelona;13;Barcelonès;08019;Barcelona;10;208;U;;680;206;329;400;280;0;13;387;400
8;Barcelona;13;Barcelonès;08019;Barcelona;10;209;U;;774;215;390;491;283;0;11;480;491
8;Barcelona;13;Barcelonès;08019;Barcelona;10;21;A;;802;248;382;483;319;2;14;467;481
8;Barcelona;13;Barcelonès;08019;Barcelona;10;21;B;;698;222;339;420;278;4;10;406;416
8;Barcelona;13;Barcelonès;08019;Barcelona;10;210;U;;769;182;333;431;338;3;14;414;428
8;Barcelona;13;Barcelonès;08019;Barcelona;10;211;U;;1104;294;496;633;471;8;19;606;625
8;Barcelona;13;Barcelonès;08019;Barcelona;10;212;U;;915;202;342;474;441;3;10;461;471
8;Barcelona;13;Barcelonès;08019;Barcelona;10;213;U;;677;147;261;314;363;1;8;305;313
8;Barcelona;13;Barcelonès;08019;Barcelona;10;214;U;;933;267;378;454;479;3;3;448;451
8;Barcelona;13;Barcelonès;08019;Barcelona;10;215;U;;708;157;277;343;365;0;9;334;343
8;Barcelona;13;Barcelonès;08019;Barcelona;10;217;U;;583;143;215;252;331;0;1;251;252
8;Barcelona;13;Barcelonès;08019;Barcelona;10;218;U;;586;187;248;296;290;4;2;290;292
8;Barcelona;13;Barcelonès;08019;Barcelona;10;22;A;;1047;315;538;689;358;1;20;668;688
8;Barcelona;13;Barcelonès;08019;Barcelona;10;22;B;;974;303;488;648;326;5;14;629;643
8;Barcelona;13;Barcelonès;08019;Barcelona;10;220;U;;771;225;359;423;348;1;7;415;422
8;Barcelona;13;Barcelonès;08019;Barcelona;10;221;U;;628;156;243;309;319;0;6;303;309
8;Barcelona;13;Barcelonès;08019;Barcelona;10;222;U;;648;191;280;336;312;2;7;327;334
8;Barcelona;13;Barcelonès;08019;Barcelona;10;223;A;;693;165;264;330;363;0;1;329;330
8;Barcelona;13;Barcelonès;08019;Barcelona;10;223;B;;578;128;222;289;289;3;5;281;286
8;Barcelona;13;Barcelonès;08019;Barcelona;10;224;U;;1203;320;575;695;508;0;22;673;695
8;Barcelona;13;Barcelonès;08019;Barcelona;10;225;U;;940;202;358;481;459;0;13;468;481
8;Barcelona;13;Barcelonès;08019;Barcelona;10;226;U;;836;209;312;393;443;4;1;388;389
8;Barcelona;13;Barcelonès;08019;Barcelona;10;227;U;;743;137;229;270;473;3;1;266;267
8;Barcelona;13;Barcelonès;08019;Barcelona;10;229;U;;520;161;252;315;205;3;3;309;312
8;Barcelona;13;Barcelonès;08019;Barcelona;10;23;U;;927;266;441;528;399;11;15;502;517
8;Barcelona;13;Barcelonès;08019;Barcelona;10;230;A;;902;242;440;527;375;3;11;513;524
8;Barcelona;13;Barcelonès;08019;Barcelona;10;230;B;;709;177;326;401;308;1;4;396;400
8;Barcelona;13;Barcelonès;08019;Barcelona;10;231;U;;880;261;456;538;342;0;8;530;538
8;Barcelona;13;Barcelonès;08019;Barcelona;10;232;A;;923;284;537;715;208;3;14;698;712
8;Barcelona;13;Barcelonès;08019;Barcelona;10;232;B;;826;240;498;627;199;6;20;601;621
8;Barcelona;13;Barcelonès;08019;Barcelona;10;233;U;;900;305;553;690;210;3;23;664;687
8;Barcelona;13;Barcelonès;08019;Barcelona;10;25;U;;621;213;336;400;221;1;15;384;399
8;Barcelona;13;Barcelonès;08019;Barcelona;10;26;U;;1122;319;514;619;503;10;3;606;609
8;Barcelona;13;Barcelonès;08019;Barcelona;10;28;U;;1052;325;506;625;427;4;17;604;621
8;Barcelona;13;Barcelonès;08019;Barcelona;10;3;U;;448;93;183;236;212;0;6;230;236
8;Barcelona;13;Barcelonès;08019;Barcelona;10;30;U;;450;120;209;263;187;2;2;259;261
8;Barcelona;13;Barcelonès;08019;Barcelona;10;31;U;;665;196;344;443;222;3;9;431;440
8;Barcelona;13;Barcelonès;08019;Barcelona;10;34;U;;578;180;289;368;210;2;7;359;366
8;Barcelona;13;Barcelonès;08019;Barcelona;10;35;U;;649;216;357;439;210;3;8;428;436
8;Barcelona;13;Barcelonès;08019;Barcelona;10;36;U;;621;171;290;358;263;2;9;347;356
8;Barcelona;13;Barcelonès;08019;Barcelona;10;37;U;;491;111;196;250;241;4;7;239;246
8;Barcelona;13;Barcelonès;08019;Barcelona;10;38;U;;568;136;229;293;275;0;6;287;293
8;Barcelona;13;Barcelonès;08019;Barcelona;10;39;U;;432;91;167;228;204;0;3;225;228
8;Barcelona;13;Barcelonès;08019;Barcelona;10;4;U;;861;234;416;529;332;0;12;517;529
8;Barcelona;13;Barcelonès;08019;Barcelona;10;40;A;;1303;346;708;817;486;2;24;791;815
8;Barcelona;13;Barcelonès;08019;Barcelona;10;40;B;;1147;334;600;754;393;2;21;731;752
8;Barcelona;13;Barcelonès;08019;Barcelona;10;41;A;;759;243;416;507;252;0;12;495;507
8;Barcelona;13;Barcelonès;08019;Barcelona;10;41;B;;707;196;436;437;270;0;7;430;437
8;Barcelona;13;Barcelonès;08019;Barcelona;10;43;U;;1204;290;612;704;500;0;12;692;704
8;Barcelona;13;Barcelonès;08019;Barcelona;10;45;U;;797;246;387;476;321;3;8;465;473
8;Barcelona;13;Barcelonès;08019;Barcelona;10;46;U;;1034;293;551;611;423;2;11;598;609
8;Barcelona;13;Barcelonès;08019;Barcelona;10;47;U;;699;184;327;415;284;0;10;405;415
8;Barcelona;13;Barcelonès;08019;Barcelona;10;48;U;;696;182;346;426;270;1;8;417;425
8;Barcelona;13;Barcelonès;08019;Barcelona;10;49;U;;1158;350;614;733;425;1;16;716;732
8;Barcelona;13;Barcelonès;08019;Barcelona;10;5;U;;1044;244;517;664;380;3;8;653;661
8;Barcelona;13;Barcelonès;08019;Barcelona;10;50;U;;620;205;305;378;242;0;5;373;378
8;Barcelona;13;Barcelonès;08019;Barcelona;10;51;U;;1135;306;533;644;491;4;15;625;640
8;Barcelona;13;Barcelonès;08019;Barcelona;10;54;U;;472;149;220;251;221;4;4;243;247
8;Barcelona;13;Barcelonès;08019;Barcelona;10;56;A;;857;285;463;558;299;4;11;543;554
8;Barcelona;13;Barcelonès;08019;Barcelona;10;56;B;;867;286;444;539;328;0;14;525;539
8;Barcelona;13;Barcelonès;08019;Barcelona;10;57;A;;798;206;334;418;380;1;10;407;417
8;Barcelona;13;Barcelonès;08019;Barcelona;10;57;B;;762;173;279;339;423;1;11;327;338
8;Barcelona;13;Barcelonès;08019;Barcelona;10;58;U;;758;184;342;437;321;8;8;421;429
8;Barcelona;13;Barcelonès;08019;Barcelona;10;59;U;;644;185;287;328;316;0;4;324;328
8;Barcelona;13;Barcelonès;08019;Barcelona;10;6;U;;1099;304;549;673;426;3;20;650;670
8;Barcelona;13;Barcelonès;08019;Barcelona;10;60;A;;1051;286;502;589;462;4;10;575;585
8;Barcelona;13;Barcelonès;08019;Barcelona;10;60;B;;877;244;408;519;358;3;9;507;516
8;Barcelona;13;Barcelonès;08019;Barcelona;10;62;U;;1393;269;524;604;789;3;10;591;601
8;Barcelona;13;Barcelonès;08019;Barcelona;10;65;A;;1129;297;559;664;465;3;20;641;661
8;Barcelona;13;Barcelonès;08019;Barcelona;10;65;B;;1044;200;495;615;429;5;16;594;610
8;Barcelona;13;Barcelonès;08019;Barcelona;10;66;A;;1147;320;582;713;434;0;21;692;713
8;Barcelona;13;Barcelonès;08019;Barcelona;10;66;B;;1169;315;576;723;446;1;13;709;722
8;Barcelona;13;Barcelonès;08019;Barcelona;10;66;C;;1184;351;597;757;427;0;18;739;757
8;Barcelona;13;Barcelonès;08019;Barcelona;10;68;U;;989;241;424;542;447;2;16;524;540
8;Barcelona;13;Barcelonès;08019;Barcelona;10;69;U;;521;130;209;257;264;3;6;248;254
8;Barcelona;13;Barcelonès;08019;Barcelona;10;70;U;;519;110;178;234;285;6;2;226;228
8;Barcelona;13;Barcelonès;08019;Barcelona;10;71;U;;882;215;338;447;435;2;7;438;445
8;Barcelona;13;Barcelonès;08019;Barcelona;10;72;U;;658;201;329;380;278;0;8;372;380
8;Barcelona;13;Barcelonès;08019;Barcelona;10;73;A;;776;178;330;417;359;1;6;410;416
8;Barcelona;13;Barcelonès;08019;Barcelona;10;73;B;;641;147;229;314;327;0;6;308;314
8;Barcelona;13;Barcelonès;08019;Barcelona;10;75;U;;491;134;156;148;343;0;2;146;148
8;Barcelona;13;Barcelonès;08019;Barcelona;10;76;U;;404;97;207;231;173;0;4;227;231
8;Barcelona;13;Barcelonès;08019;Barcelona;10;77;U;;764;163;254;295;469;7;6;282;288
8;Barcelona;13;Barcelonès;08019;Barcelona;10;78;U;;424;83;125;150;274;0;2;148;150
8;Barcelona;13;Barcelonès;08019;Barcelona;10;79;U;;919;246;370;400;519;6;7;387;394
8;Barcelona;13;Barcelonès;08019;Barcelona;10;8;U;;659;162;322;404;255;4;3;397;400
8;Barcelona;13;Barcelonès;08019;Barcelona;10;82;U;;796;218;312;364;432;3;5;356;361
8;Barcelona;13;Barcelonès;08019;Barcelona;10;83;U;;470;96;136;165;305;0;3;162;165
8;Barcelona;13;Barcelonès;08019;Barcelona;10;85;U;;650;166;245;286;364;1;3;282;285
8;Barcelona;13;Barcelonès;08019;Barcelona;10;86;U;;751;184;297;345;406;4;8;333;341
8;Barcelona;13;Barcelonès;08019;Barcelona;10;88;U;;618;188;269;327;291;4;3;320;323
8;Barcelona;13;Barcelonès;08019;Barcelona;10;89;U;;557;172;239;276;281;5;4;267;271
8;Barcelona;13;Barcelonès;08019;Barcelona;10;9;U;;715;253;411;471;244;1;8;462;470
8;Barcelona;13;Barcelonès;08019;Barcelona;10;90;U;;712;162;255;299;413;5;8;286;294
8;Barcelona;13;Barcelonès;08019;Barcelona;10;92;U;;580;188;249;293;287;2;2;289;291
8;Barcelona;13;Barcelonès;08019;Barcelona;10;93;A;;690;145;275;355;335;1;6;348;354
8;Barcelona;13;Barcelonès;08019;Barcelona;10;93;B;;623;140;268;323;300;0;6;317;323
8;Barcelona;13;Barcelonès;08019;Barcelona;10;94;U;;652;206;323;382;270;2;9;371;380
8;Barcelona;13;Barcelonès;08019;Barcelona;10;96;U;;1030;212;376;472;558;1;13;458;471
8;Barcelona;13;Barcelonès;08019;Barcelona;10;98;A;;1172;291;501;621;551;8;15;598;613
8;Barcelona;13;Barcelonès;08019;Barcelona;10;98;B;;984;265;432;531;453;3;8;520;528
8;Barcelona;13;Barcelonès;08019;Barcelona;10;99;A;;1084;368;598;642;442;3;15;624;639
8;Barcelona;13;Barcelonès;08019;Barcelona;10;99;B;;914;235;443;553;361;1;17;535;552
8;Barcelona;13;Barcelonès;08019;Barcelona;2;1;U;;520;150;232;274;246;2;5;267;272
8;Barcelona;13;Barcelonès;08019;Barcelona;2;10;U;;489;141;238;297;192;0;8;289;297
8;Barcelona;13;Barcelonès;08019;Barcelona;2;100;U;;434;101;196;254;180;3;4;247;251
8;Barcelona;13;Barcelonès;08019;Barcelona;2;101;U;;752;233;404;483;269;0;18;465;483
8;Barcelona;13;Barcelonès;08019;Barcelona;2;102;U;;684;214;354;423;261;7;6;410;416
8;Barcelona;13;Barcelonès;08019;Barcelona;2;103;U;;616;137;276;360;256;0;5;355;360
8;Barcelona;13;Barcelonès;08019;Barcelona;2;104;U;;506;158;240;306;200;0;11;295;306
8;Barcelona;13;Barcelonès;08019;Barcelona;2;105;U;;504;158;279;319;185;0;7;312;319
8;Barcelona;13;Barcelonès;08019;Barcelona;2;106;U;;508;144;246;311;197;2;6;303;309
8;Barcelona;13;Barcelonès;08019;Barcelona;2;107;U;;899;324;499;602;297;1;19;582;601
8;Barcelona;13;Barcelonès;08019;Barcelona;2;109;U;;448;125;249;288;160;3;4;281;285
8;Barcelona;13;Barcelonès;08019;Barcelona;2;11;U;;641;197;314;385;256;1;0;384;384
8;Barcelona;13;Barcelonès;08019;Barcelona;2;110;U;;599;191;310;378;221;0;14;364;378
8;Barcelona;13;Barcelonès;08019;Barcelona;2;112;U;;639;226;363;449;190;0;7;442;449
8;Barcelona;13;Barcelonès;08019;Barcelona;2;114;U;;654;213;353;437;217;3;13;421;434
8;Barcelona;13;Barcelonès;08019;Barcelona;2;115;U;;704;224;389;469;235;0;11;458;469
8;Barcelona;13;Barcelonès;08019;Barcelona;2;117;U;;750;252;419;503;247;3;12;488;500
8;Barcelona;13;Barcelonès;08019;Barcelona;2;118;U;;981;330;578;671;310;1;12;658;670
8;Barcelona;13;Barcelonès;08019;Barcelona;2;12;U;;657;194;314;425;232;7;11;407;418
8;Barcelona;13;Barcelonès;08019;Barcelona;2;121;U;;852;281;507;588;264;1;18;569;587
8;Barcelona;13;Barcelonès;08019;Barcelona;2;124;U;;586;190;348;410;176;3;6;401;407
8;Barcelona;13;Barcelonès;08019;Barcelona;2;125;U;;645;190;353;456;189;0;9;447;456
8;Barcelona;13;Barcelonès;08019;Barcelona;2;126;U;;386;155;230;282;104;0;9;273;282
8;Barcelona;13;Barcelonès;08019;Barcelona;2;127;U;;591;196;334;391;200;0;11;380;391
8;Barcelona;13;Barcelonès;08019;Barcelona;2;128;U;;883;315;515;586;297;10;10;566;576
8;Barcelona;13;Barcelonès;08019;Barcelona;2;129;U;;865;278;505;617;248;4;15;598;613
8;Barcelona;13;Barcelonès;08019;Barcelona;2;13;U;;1065;309;566;718;347;3;7;708;715
8;Barcelona;13;Barcelonès;08019;Barcelona;2;130;U;;596;195;317;385;211;1;9;375;384
8;Barcelona;13;Barcelonès;08019;Barcelona;2;131;U;;670;182;302;375;295;4;8;363;371
8;Barcelona;13;Barcelonès;08019;Barcelona;2;132;U;;989;318;531;681;308;3;16;662;678
8;Barcelona;13;Barcelonès;08019;Barcelona;2;133;U;;1211;361;676;839;372;3;20;816;836
8;Barcelona;13;Barcelonès;08019;Barcelona;2;134;U;;999;315;576;678;321;2;8;668;676
8;Barcelona;13;Barcelonès;08019;Barcelona;2;135;U;;860;254;494;587;273;0;12;575;587
8;Barcelona;13;Barcelonès;08019;Barcelona;2;137;U;;1020;383;589;739;281;5;10;724;734
8;Barcelona;13;Barcelonès;08019;Barcelona;2;138;A;;707;232;378;457;250;0;17;440;457
8;Barcelona;13;Barcelonès;08019;Barcelona;2;138;B;;634;207;331;407;227;0;8;399;407
8;Barcelona;13;Barcelonès;08019;Barcelona;2;14;U;;625;182;346;417;208;2;7;408;415
8;Barcelona;13;Barcelonès;08019;Barcelona;2;140;U;;932;253;420;536;396;1;9;526;535
8;Barcelona;13;Barcelonès;08019;Barcelona;2;141;U;;654;167;307;381;273;5;11;365;376
8;Barcelona;13;Barcelonès;08019;Barcelona;2;142;U;;637;222;342;426;211;2;3;421;424
8;Barcelona;13;Barcelonès;08019;Barcelona;2;143;U;;774;243;389;464;310;1;10;453;463
8;Barcelona;13;Barcelonès;08019;Barcelona;2;144;U;;896;277;482;626;270;1;12;613;625
8;Barcelona;13;Barcelonès;08019;Barcelona;2;145;U;;1210;346;640;801;409;1;17;783;800
8;Barcelona;13;Barcelonès;08019;Barcelona;2;146;A;;719;196;361;459;260;2;8;449;457
8;Barcelona;13;Barcelonès;08019;Barcelona;2;146;B;;574;175;312;383;191;1;11;371;382
8;Barcelona;13;Barcelonès;08019;Barcelona;2;148;U;;1080;352;642;788;292;0;31;757;788
8;Barcelona;13;Barcelonès;08019;Barcelona;2;149;U;;720;201;364;438;282;1;13;424;437
8;Barcelona;13;Barcelonès;08019;Barcelona;2;15;U;;927;291;516;602;325;0;15;587;602
8;Barcelona;13;Barcelonès;08019;Barcelona;2;151;U;;610;180;305;374;236;0;3;371;374
8;Barcelona;13;Barcelonès;08019;Barcelona;2;152;U;;718;212;362;456;262;4;9;443;452
8;Barcelona;13;Barcelonès;08019;Barcelona;2;153;U;;552;149;280;356;196;1;7;348;355
8;Barcelona;13;Barcelonès;08019;Barcelona;2;154;U;;765;257;438;520;245;0;9;511;520
8;Barcelona;13;Barcelonès;08019;Barcelona;2;155;U;;760;245;430;513;247;0;16;497;513
8;Barcelona;13;Barcelonès;08019;Barcelona;2;156;U;;522;165;271;333;189;0;9;324;333
8;Barcelona;13;Barcelonès;08019;Barcelona;2;157;U;;684;260;425;503;181;0;7;496;503
8;Barcelona;13;Barcelonès;08019;Barcelona;2;158;U;;732;255;440;529;203;1;13;515;528
8;Barcelona;13;Barcelonès;08019;Barcelona;2;159;U;;933;297;542;662;271;1;19;642;661
8;Barcelona;13;Barcelonès;08019;Barcelona;2;161;U;;653;208;369;438;215;1;9;428;437
8;Barcelona;13;Barcelonès;08019;Barcelona;2;162;U;;589;179;344;411;178;0;10;401;411
8;Barcelona;13;Barcelonès;08019;Barcelona;2;163;U;;854;268;471;586;268;0;19;567;586
8;Barcelona;13;Barcelonès;08019;Barcelona;2;167;U;;717;229;379;485;232;1;10;474;484
8;Barcelona;13;Barcelonès;08019;Barcelona;2;168;U;;723;271;420;504;219;5;13;486;499
8;Barcelona;13;Barcelonès;08019;Barcelona;2;169;U;;476;152;231;292;184;0;2;290;292
8;Barcelona;13;Barcelonès;08019;Barcelona;2;17;U;;545;161;288;351;194;1;8;342;350
8;Barcelona;13;Barcelonès;08019;Barcelona;2;170;U;;729;213;406;496;233;0;10;486;496
8;Barcelona;13;Barcelonès;08019;Barcelona;2;171;U;;529;169;292;352;177;1;8;343;351
8;Barcelona;13;Barcelonès;08019;Barcelona;2;172;U;;523;204;311;380;143;4;8;368;376
8;Barcelona;13;Barcelonès;08019;Barcelona;2;173;U;;491;167;277;335;156;0;12;323;335
8;Barcelona;13;Barcelonès;08019;Barcelona;2;174;U;;478;146;273;326;152;1;11;314;325
8;Barcelona;13;Barcelonès;08019;Barcelona;2;175;U;;590;163;322;405;185;0;9;396;405
8;Barcelona;13;Barcelonès;08019;Barcelona;2;176;U;;849;249;422;540;309;2;8;530;538
8;Barcelona;13;Barcelonès;08019;Barcelona;2;177;U;;472;149;248;303;169;2;11;290;301
8;Barcelona;13;Barcelonès;08019;Barcelona;2;178;U;;537;174;309;381;156;3;7;371;378
8;Barcelona;13;Barcelonès;08019;Barcelona;2;179;U;;556;173;297;353;203;2;6;345;351
8;Barcelona;13;Barcelonès;08019;Barcelona;2;18;U;;1049;342;597;715;334;1;24;690;714
8;Barcelona;13;Barcelonès;08019;Barcelona;2;180;U;;752;236;411;499;253;0;8;491;499
8;Barcelona;13;Barcelonès;08019;Barcelona;2;182;U;;1068;337;621;727;341;2;16;709;725
8;Barcelona;13;Barcelonès;08019;Barcelona;2;184;U;;632;205;355;425;207;2;10;413;423
8;Barcelona;13;Barcelonès;08019;Barcelona;2;185;U;;852;295;519;628;224;2;21;605;626
8;Barcelona;13;Barcelonès;08019;Barcelona;2;187;U;;478;157;291;350;128;0;9;341;350
8;Barcelona;13;Barcelonès;08019;Barcelona;2;189;U;;619;237;376;448;171;4;12;432;444
8;Barcelona;13;Barcelonès;08019;Barcelona;2;19;U;;830;235;430;528;302;0;14;514;528
8;Barcelona;13;Barcelonès;08019;Barcelona;2;190;U;;509;202;321;378;131;1;6;371;377
8;Barcelona;13;Barcelonès;08019;Barcelona;2;191;U;;523;156;274;341;182;1;8;332;340
8;Barcelona;13;Barcelonès;08019;Barcelona;2;192;U;;616;192;314;387;229;0;13;374;387
8;Barcelona;13;Barcelonès;08019;Barcelona;2;193;U;;668;198;398;461;207;0;0;461;461
8;Barcelona;13;Barcelonès;08019;Barcelona;2;195;U;;772;236;426;540;232;4;13;523;536
8;Barcelona;13;Barcelonès;08019;Barcelona;2;197;U;;715;234;383;459;256;2;14;443;457
8;Barcelona;13;Barcelonès;08019;Barcelona;2;199;U;;524;162;282;336;188;1;4;331;335
8;Barcelona;13;Barcelonès;08019;Barcelona;2;2;U;;687;220;371;452;235;3;12;437;449
8;Barcelona;13;Barcelonès;08019;Barcelona;2;20;U;;1073;291;496;617;456;1;19;597;616
8;Barcelona;13;Barcelonès;08019;Barcelona;2;201;U;;944;302;519;653;291;0;21;632;653
8;Barcelona;13;Barcelonès;08019;Barcelona;2;203;U;;671;201;372;477;194;1;8;468;476
8;Barcelona;13;Barcelonès;08019;Barcelona;2;206;U;;809;262;483;586;223;2;14;570;584
8;Barcelona;13;Barcelonès;08019;Barcelona;2;207;U;;596;171;322;417;179;0;11;406;417
8;Barcelona;13;Barcelonès;08019;Barcelona;2;209;U;;468;131;243;293;175;1;7;285;292
8;Barcelona;13;Barcelonès;08019;Barcelona;2;21;U;;1035;276;533;642;393;1;13;628;641
8;Barcelona;13;Barcelonès;08019;Barcelona;2;210;U;;920;292;520;637;283;3;21;613;634
8;Barcelona;13;Barcelonès;08019;Barcelona;2;212;U;;860;249;471;573;287;7;13;553;566
8;Barcelona;13;Barcelonès;08019;Barcelona;2;213;U;;693;223;368;470;223;3;15;452;467
8;Barcelona;13;Barcelonès;08019;Barcelona;2;214;U;;690;213;394;468;222;4;10;454;464
8;Barcelona;13;Barcelonès;08019;Barcelona;2;215;U;;869;251;457;622;247;2;13;607;620
8;Barcelona;13;Barcelonès;08019;Barcelona;2;216;U;;775;243;440;532;243;1;10;521;531
8;Barcelona;13;Barcelonès;08019;Barcelona;2;219;U;;759;231;390;478;281;3;10;465;475
8;Barcelona;13;Barcelonès;08019;Barcelona;2;220;A;;683;191;357;490;193;0;8;482;490
8;Barcelona;13;Barcelonès;08019;Barcelona;2;220;B;;600;181;392;429;171;3;13;413;426
8;Barcelona;13;Barcelonès;08019;Barcelona;2;221;U;;953;255;507;618;335;0;20;598;618
8;Barcelona;13;Barcelonès;08019;Barcelona;2;224;U;;552;178;298;375;177;0;6;369;375
8;Barcelona;13;Barcelonès;08019;Barcelona;2;226;U;;548;188;313;398;150;2;8;388;396
8;Barcelona;13;Barcelonès;08019;Barcelona;2;229;U;;606;186;340;431;175;4;14;413;427
8;Barcelona;13;Barcelonès;08019;Barcelona;2;230;U;;903;248;439;526;377;0;19;507;526
8;Barcelona;13;Barcelonès;08019;Barcelona;2;231;U;;608;200;358;453;155;1;8;444;452
8;Barcelona;13;Barcelonès;08019;Barcelona;2;232;U;;514;174;289;361;153;2;6;353;359
8;Barcelona;13;Barcelonès;08019;Barcelona;2;233;U;;727;241;425;536;191;1;10;525;535
8;Barcelona;13;Barcelonès;08019;Barcelona;2;234;U;;574;226;357;421;153;2;7;412;419
8;Barcelona;13;Barcelonès;08019;Barcelona;2;236;U;;897;284;493;610;287;3;12;595;607
8;Barcelona;13;Barcelonès;08019;Barcelona;2;237;U;;667;211;370;442;225;0;8;434;442
8;Barcelona;13;Barcelonès;08019;Barcelona;2;238;U;;819;284;476;588;231;3;10;575;585
8;Barcelona;13;Barcelonès;08019;Barcelona;2;239;U;;776;276;449;535;241;3;10;522;532
8;Barcelona;13;Barcelonès;08019;Barcelona;2;24;U;;674;180;323;418;256;1;11;406;417
8;Barcelona;13;Barcelonès;08019;Barcelona;2;240;U;;1020;300;558;692;328;3;21;668;689
8;Barcelona;13;Barcelonès;08019;Barcelona;2;241;U;;1169;342;652;817;352;0;21;796;817
8;Barcelona;13;Barcelonès;08019;Barcelona;2;243;U;;813;210;397;507;306;3;14;490;504
8;Barcelona;13;Barcelonès;08019;Barcelona;2;244;U;;798;266;468;574;224;1;12;561;573
8;Barcelona;13;Barcelonès;08019;Barcelona;2;246;U;;1098;309;547;671;427;5;18;648;666
8;Barcelona;13;Barcelonès;08019;Barcelona;2;247;U;;941;277;485;590;351;3;17;570;587
8;Barcelona;13;Barcelonès;08019;Barcelona;2;248;U;;937;254;493;613;324;1;10;602;612
8;Barcelona;13;Barcelonès;08019;Barcelona;2;249;U;;869;270;420;502;367;3;7;492;499
8;Barcelona;13;Barcelonès;08019;Barcelona;2;25;U;;1058;297;568;714;344;2;17;695;712
8;Barcelona;13;Barcelonès;08019;Barcelona;2;251;U;;887;253;436;519;368;0;5;514;519
8;Barcelona;13;Barcelonès;08019;Barcelona;2;252;U;;712;229;380;440;272;0;11;429;440
8;Barcelona;13;Barcelonès;08019;Barcelona;2;253;U;;869;261;424;504;365;3;10;491;501
8;Barcelona;13;Barcelonès;08019;Barcelona;2;255;U;;659;211;363;438;221;2;7;429;436
8;Barcelona;13;Barcelonès;08019;Barcelona;2;256;U;;526;153;262;322;204;3;4;315;319
8;Barcelona;13;Barcelonès;08019;Barcelona;2;257;U;;872;274;457;542;330;3;18;521;539
8;Barcelona;13;Barcelonès;08019;Barcelona;2;258;U;;932;301;509;641;291;4;5;632;637
8;Barcelona;13;Barcelonès;08019;Barcelona;2;259;U;;747;209;400;495;252;4;15;476;491
8;Barcelona;13;Barcelonès;08019;Barcelona;2;26;U;;789;241;472;560;229;1;14;545;559
8;Barcelona;13;Barcelonès;08019;Barcelona;2;260;U;;680;241;376;457;223;4;10;443;453
8;Barcelona;13;Barcelonès;08019;Barcelona;2;261;U;;723;233;387;495;228;1;19;475;494
8;Barcelona;13;Barcelonès;08019;Barcelona;2;262;U;;1014;336;582;709;305;2;12;695;707
8;Barcelona;13;Barcelonès;08019;Barcelona;2;264;U;;768;220;390;475;293;0;15;460;475
8;Barcelona;13;Barcelonès;08019;Barcelona;2;265;U;;683;182;360;425;258;2;9;414;423
8;Barcelona;13;Barcelonès;08019;Barcelona;2;266;U;;601;161;283;347;254;2;5;340;345
8;Barcelona;13;Barcelonès;08019;Barcelona;2;267;U;;643;179;310;372;271;1;12;359;371
8;Barcelona;13;Barcelonès;08019;Barcelona;2;268;U;;786;241;416;497;289;4;10;483;493
8;Barcelona;13;Barcelonès;08019;Barcelona;2;269;U;;889;242;470;559;330;0;14;545;559
8;Barcelona;13;Barcelonès;08019;Barcelona;2;27;U;;568;175;287;351;217;3;6;342;348
8;Barcelona;13;Barcelonès;08019;Barcelona;2;271;U;;781;209;341;436;345;1;11;424;435
8;Barcelona;13;Barcelonès;08019;Barcelona;2;272;U;;632;210;316;377;255;0;6;371;377
8;Barcelona;13;Barcelonès;08019;Barcelona;2;273;U;;911;292;486;588;323;0;21;567;588
8;Barcelona;13;Barcelonès;08019;Barcelona;2;274;U;;890;194;432;524;366;0;15;509;524
8;Barcelona;13;Barcelonès;08019;Barcelona;2;275;U;;887;230;446;535;352;2;17;516;533
8;Barcelona;13;Barcelonès;08019;Barcelona;2;276;U;;935;267;479;591;344;7;5;579;584
8;Barcelona;13;Barcelonès;08019;Barcelona;2;277;U;;862;300;496;607;255;2;12;593;605
8;Barcelona;13;Barcelonès;08019;Barcelona;2;278;U;;725;196;408;476;249;1;13;462;475
8;Barcelona;13;Barcelonès;08019;Barcelona;2;279;U;;773;257;408;488;285;0;6;482;488
8;Barcelona;13;Barcelonès;08019;Barcelona;2;28;U;;714;227;396;477;237;4;5;468;473
8;Barcelona;13;Barcelonès;08019;Barcelona;2;280;U;;1222;385;631;773;449;1;16;756;772
8;Barcelona;13;Barcelonès;08019;Barcelona;2;281;U;;679;201;371;472;207;0;15;457;472
8;Barcelona;13;Barcelonès;08019;Barcelona;2;282;U;;868;273;473;621;247;3;23;595;618
8;Barcelona;13;Barcelonès;08019;Barcelona;2;283;U;;877;247;481;582;295;1;15;566;581
8;Barcelona;13;Barcelonès;08019;Barcelona;2;284;U;;884;296;431;528;356;1;13;514;527
8;Barcelona;13;Barcelonès;08019;Barcelona;2;285;U;;1064;330;596;717;347;3;19;695;714
8;Barcelona;13;Barcelonès;08019;Barcelona;2;286;U;;632;210;346;420;212;2;12;406;418
8;Barcelona;13;Barcelonès;08019;Barcelona;2;287;U;;750;239;395;483;267;0;12;471;483
8;Barcelona;13;Barcelonès;08019;Barcelona;2;288;U;;646;195;331;395;251;0;6;389;395
8;Barcelona;13;Barcelonès;08019;Barcelona;2;289;U;;783;232;388;470;313;0;5;465;470
8;Barcelona;13;Barcelonès;08019;Barcelona;2;29;U;;790;259;428;521;269;1;13;507;520
8;Barcelona;13;Barcelonès;08019;Barcelona;2;290;U;;679;215;348;421;258;2;15;404;419
8;Barcelona;13;Barcelonès;08019;Barcelona;2;292;U;;682;210;381;457;225;3;8;446;454
8;Barcelona;13;Barcelonès;08019;Barcelona;2;294;U;;430;144;244;288;142;2;10;276;286
8;Barcelona;13;Barcelonès;08019;Barcelona;2;295;U;;687;184;348;440;247;0;16;424;440
8;Barcelona;13;Barcelonès;08019;Barcelona;2;296;U;;706;205;360;448;258;2;12;434;446
8;Barcelona;13;Barcelonès;08019;Barcelona;2;297;U;;811;217;416;509;302;1;8;500;508
8;Barcelona;13;Barcelonès;08019;Barcelona;2;298;U;;646;181;301;358;288;0;8;350;358
8;Barcelona;13;Barcelonès;08019;Barcelona;2;3;U;;565;140;262;336;229;1;8;327;335
8;Barcelona;13;Barcelonès;08019;Barcelona;2;30;U;;983;308;492;593;390;8;12;573;585
8;Barcelona;13;Barcelonès;08019;Barcelona;2;300;U;;758;233;407;500;258;6;14;480;494
8;Barcelona;13;Barcelonès;08019;Barcelona;2;301;U;;1090;373;619;747;343;0;26;721;747
8;Barcelona;13;Barcelonès;08019;Barcelona;2;302;U;;964;208;484;625;339;3;6;616;622
8;Barcelona;13;Barcelonès;08019;Barcelona;2;303;U;;990;274;585;683;307;4;19;660;679
8;Barcelona;13;Barcelonès;08019;Barcelona;2;304;U;;841;254;417;518;323;1;14;503;517
8;Barcelona;13;Barcelonès;08019;Barcelona;2;305;U;;886;280;462;572;314;0;11;561;572
8;Barcelona;13;Barcelonès;08019;Barcelona;2;306;U;;1060;324;593;739;321;2;9;728;737
8;Barcelona;13;Barcelonès;08019;Barcelona;2;307;A;;735;226;435;519;216;2;10;507;517
8;Barcelona;13;Barcelonès;08019;Barcelona;2;307;B;;668;211;381;465;203;3;9;453;462
8;Barcelona;13;Barcelonès;08019;Barcelona;2;308;U;;989;253;480;599;390;2;21;576;597
8;Barcelona;13;Barcelonès;08019;Barcelona;2;309;U;;695;162;293;367;328;4;4;359;363
8;Barcelona;13;Barcelonès;08019;Barcelona;2;31;U;;811;298;449;531;280;0;13;518;531
8;Barcelona;13;Barcelonès;08019;Barcelona;2;311;U;;860;198;390;546;314;0;15;531;546
8;Barcelona;13;Barcelonès;08019;Barcelona;2;312;U;;769;239;435;532;237;3;12;517;529
8;Barcelona;13;Barcelonès;08019;Barcelona;2;314;U;;609;181;335;412;197;0;14;398;412
8;Barcelona;13;Barcelonès;08019;Barcelona;2;315;U;;946;227;499;631;315;5;19;607;626
8;Barcelona;13;Barcelonès;08019;Barcelona;2;317;U;;1136;288;523;662;474;0;11;651;662
8;Barcelona;13;Barcelonès;08019;Barcelona;2;32;U;;791;258;474;562;229;1;11;550;561
8;Barcelona;13;Barcelonès;08019;Barcelona;2;33;U;;722;239;382;464;258;0;14;450;464
8;Barcelona;13;Barcelonès;08019;Barcelona;2;34;U;;861;262;463;571;290;3;15;553;568
8;Barcelona;13;Barcelonès;08019;Barcelona;2;35;U;;577;176;286;342;235;1;6;335;341
8;Barcelona;13;Barcelonès;08019;Barcelona;2;36;U;;714;238;379;449;265;1;10;438;448
8;Barcelona;13;Barcelonès;08019;Barcelona;2;37;U;;698;220;398;453;245;7;11;435;446
8;Barcelona;13;Barcelonès;08019;Barcelona;2;39;U;;591;147;264;320;271;1;5;314;319
8;Barcelona;13;Barcelonès;08019;Barcelona;2;4;U;;582;183;318;383;199;0;10;373;383
8;Barcelona;13;Barcelonès;08019;Barcelona;2;40;U;;591;185;323;389;202;1;6;382;388
8;Barcelona;13;Barcelonès;08019;Barcelona;2;41;U;;784;236;415;520;264;0;11;509;520
8;Barcelona;13;Barcelonès;08019;Barcelona;2;42;U;;597;201;289;349;248;0;3;346;349
8;Barcelona;13;Barcelonès;08019;Barcelona;2;43;U;;641;197;317;375;266;1;5;369;374
8;Barcelona;13;Barcelonès;08019;Barcelona;2;45;U;;513;147;246;314;199;2;5;307;312
8;Barcelona;13;Barcelonès;08019;Barcelona;2;47;U;;1029;351;495;630;399;0;10;620;630
8;Barcelona;13;Barcelonès;08019;Barcelona;2;49;U;;850;248;430;527;323;0;9;518;527
8;Barcelona;13;Barcelonès;08019;Barcelona;2;5;U;;654;216;361;444;210;0;11;433;444
8;Barcelona;13;Barcelonès;08019;Barcelona;2;51;U;;480;142;269;343;137;2;14;327;341
8;Barcelona;13;Barcelonès;08019;Barcelona;2;52;U;;586;158;303;392;194;1;11;380;391
8;Barcelona;13;Barcelonès;08019;Barcelona;2;53;U;;559;176;296;374;185;2;12;360;372
8;Barcelona;13;Barcelonès;08019;Barcelona;2;54;U;;644;184;320;404;240;0;19;385;404
8;Barcelona;13;Barcelonès;08019;Barcelona;2;55;U;;905;269;469;576;329;2;13;561;574
8;Barcelona;13;Barcelonès;08019;Barcelona;2;56;U;;618;183;310;399;219;2;8;389;397
8;Barcelona;13;Barcelonès;08019;Barcelona;2;57;U;;560;185;304;370;190;3;7;360;367
8;Barcelona;13;Barcelonès;08019;Barcelona;2;59;U;;575;176;294;359;216;1;6;352;358
8;Barcelona;13;Barcelonès;08019;Barcelona;2;6;U;;489;171;254;290;199;0;8;282;290
8;Barcelona;13;Barcelonès;08019;Barcelona;2;60;U;;744;231;361;436;308;2;16;418;434
8;Barcelona;13;Barcelonès;08019;Barcelona;2;61;U;;720;208;388;493;227;1;17;475;492
8;Barcelona;13;Barcelonès;08019;Barcelona;2;62;U;;610;234;349;409;201;4;0;405;405
8;Barcelona;13;Barcelonès;08019;Barcelona;2;63;U;;739;201;407;500;239;2;11;487;498
8;Barcelona;13;Barcelonès;08019;Barcelona;2;65;U;;745;257;431;517;228;1;12;504;516
8;Barcelona;13;Barcelonès;08019;Barcelona;2;66;U;;720;217;420;511;209;2;9;500;509
8;Barcelona;13;Barcelonès;08019;Barcelona;2;67;U;;776;275;463;538;238;2;15;521;536
8;Barcelona;13;Barcelonès;08019;Barcelona;2;68;U;;852;239;426;519;333;0;13;506;519
8;Barcelona;13;Barcelonès;08019;Barcelona;2;7;U;;582;147;240;297;285;4;5;288;293
8;Barcelona;13;Barcelonès;08019;Barcelona;2;70;U;;554;158;262;323;231;1;3;319;322
8;Barcelona;13;Barcelonès;08019;Barcelona;2;71;U;;894;239;424;553;341;2;9;542;551
8;Barcelona;13;Barcelonès;08019;Barcelona;2;72;U;;656;216;343;422;234;1;9;412;421
8;Barcelona;13;Barcelonès;08019;Barcelona;2;73;U;;818;279;487;566;252;0;13;553;566
8;Barcelona;13;Barcelonès;08019;Barcelona;2;74;U;;872;241;426;526;346;2;21;503;524
8;Barcelona;13;Barcelonès;08019;Barcelona;2;75;U;;1092;275;585;713;379;2;9;702;711
8;Barcelona;13;Barcelonès;08019;Barcelona;2;77;U;;856;276;468;575;281;0;10;565;575
8;Barcelona;13;Barcelonès;08019;Barcelona;2;78;U;;591;176;304;374;217;0;7;367;374
8;Barcelona;13;Barcelonès;08019;Barcelona;2;79;U;;898;285;471;589;309;0;8;581;589
8;Barcelona;13;Barcelonès;08019;Barcelona;2;8;U;;639;175;319;380;259;1;8;371;379
8;Barcelona;13;Barcelonès;08019;Barcelona;2;80;U;;940;255;503;639;301;19;2;618;620
8;Barcelona;13;Barcelonès;08019;Barcelona;2;81;U;;811;234;384;499;312;0;10;489;499
8;Barcelona;13;Barcelonès;08019;Barcelona;2;82;U;;893;276;486;569;324;2;10;557;567
8;Barcelona;13;Barcelonès;08019;Barcelona;2;83;U;;608;187;385;393;215;1;6;386;392
8;Barcelona;13;Barcelonès;08019;Barcelona;2;84;U;;1148;348;586;719;429;3;13;703;716
8;Barcelona;13;Barcelonès;08019;Barcelona;2;85;U;;750;214;322;504;246;3;15;486;501
8;Barcelona;13;Barcelonès;08019;Barcelona;2;86;U;;950;278;472;579;371;0;18;561;579
8;Barcelona;13;Barcelonès;08019;Barcelona;2;87;U;;1034;281;503;629;405;10;16;603;619
8;Barcelona;13;Barcelonès;08019;Barcelona;2;89;U;;874;286;507;604;270;7;2;595;597
8;Barcelona;13;Barcelonès;08019;Barcelona;2;9;U;;720;223;384;473;247;5;10;458;468
8;Barcelona;13;Barcelonès;08019;Barcelona;2;90;U;;1002;299;525;646;356;4;22;620;642
8;Barcelona;13;Barcelonès;08019;Barcelona;2;91;U;;535;174;317;374;161;1;9;364;373
8;Barcelona;13;Barcelonès;08019;Barcelona;2;92;U;;968;300;546;664;304;2;15;647;662
8;Barcelona;13;Barcelonès;08019;Barcelona;2;93;U;;887;229;463;583;304;1;16;566;582
8;Barcelona;13;Barcelonès;08019;Barcelona;2;94;U;;967;304;536;634;333;0;17;617;634
8;Barcelona;13;Barcelonès;08019;Barcelona;2;95;U;;1047;352;589;747;300;2;20;725;745
8;Barcelona;13;Barcelonès;08019;Barcelona;2;96;U;;565;200;339;409;156;0;10;399;409
8;Barcelona;13;Barcelonès;08019;Barcelona;2;97;U;;787;253;412;512;275;2;14;496;510
8;Barcelona;13;Barcelonès;08019;Barcelona;2;98;U;;724;240;369;468;256;1;8;459;467
8;Barcelona;13;Barcelonès;08019;Barcelona;2;99;U;;593;192;329;424;169;2;9;413;422
8;Barcelona;13;Barcelonès;08019;Barcelona;3;1;A;;696;167;297;379;317;0;6;373;379
8;Barcelona;13;Barcelonès;08019;Barcelona;3;1;B;;602;188;292;350;252;2;8;340;348
8;Barcelona;13;Barcelonès;08019;Barcelona;3;10;U;;970;232;405;490;480;3;8;479;487
8;Barcelona;13;Barcelonès;08019;Barcelona;3;100;U;;1104;298;546;684;420;4;6;674;680
8;Barcelona;13;Barcelonès;08019;Barcelona;3;101;U;;1110;316;575;692;418;3;18;671;689
8;Barcelona;13;Barcelonès;08019;Barcelona;3;102;U;;703;204;366;420;283;3;9;408;417
8;Barcelona;13;Barcelonès;08019;Barcelona;3;103;U;;736;179;331;396;340;2;8;386;394
8;Barcelona;13;Barcelonès;08019;Barcelona;3;104;U;;843;230;369;488;355;0;9;479;488
8;Barcelona;13;Barcelonès;08019;Barcelona;3;106;U;;412;160;238;271;141;0;3;268;271
8;Barcelona;13;Barcelonès;08019;Barcelona;3;107;U;;1049;313;506;617;432;8;10;599;609
8;Barcelona;13;Barcelonès;08019;Barcelona;3;109;A;;827;228;375;509;318;5;11;493;504
8;Barcelona;13;Barcelonès;08019;Barcelona;3;109;B;;807;194;336;470;337;0;11;459;470
8;Barcelona;13;Barcelonès;08019;Barcelona;3;110;A;;734;213;361;451;283;0;6;445;451
8;Barcelona;13;Barcelonès;08019;Barcelona;3;110;B;;648;183;305;398;250;3;5;390;395
8;Barcelona;13;Barcelonès;08019;Barcelona;3;111;A;;870;225;396;477;393;4;8;465;473
8;Barcelona;13;Barcelonès;08019;Barcelona;3;111;B;;842;198;368;468;374;0;5;463;468
8;Barcelona;13;Barcelonès;08019;Barcelona;3;112;U;;719;189;341;430;289;0;10;420;430
8;Barcelona;13;Barcelonès;08019;Barcelona;3;113;U;;657;183;317;402;255;2;9;391;400
8;Barcelona;13;Barcelonès;08019;Barcelona;3;114;U;;585;183;278;340;245;2;15;323;338
8;Barcelona;13;Barcelonès;08019;Barcelona;3;115;U;;942;263;456;547;395;7;3;537;540
8;Barcelona;13;Barcelonès;08019;Barcelona;3;117;U;;587;183;301;383;204;3;5;375;380
8;Barcelona;13;Barcelonès;08019;Barcelona;3;118;U;;655;294;366;419;236;5;8;406;414
8;Barcelona;13;Barcelonès;08019;Barcelona;3;119;U;;446;126;232;263;183;1;2;260;262
8;Barcelona;13;Barcelonès;08019;Barcelona;3;12;U;;796;181;334;380;416;0;4;376;380
8;Barcelona;13;Barcelonès;08019;Barcelona;3;120;U;;598;194;311;361;237;5;10;346;356
8;Barcelona;13;Barcelonès;08019;Barcelona;3;121;U;;506;157;233;276;230;1;7;268;275
8;Barcelona;13;Barcelonès;08019;Barcelona;3;122;U;;753;269;411;485;268;0;14;471;485
8;Barcelona;13;Barcelonès;08019;Barcelona;3;124;U;;651;209;336;410;241;1;4;405;409
8;Barcelona;13;Barcelonès;08019;Barcelona;3;125;U;;691;224;374;445;246;3;10;432;442
8;Barcelona;13;Barcelonès;08019;Barcelona;3;127;U;;550;167;289;350;200;1;3;346;349
8;Barcelona;13;Barcelonès;08019;Barcelona;3;128;U;;451;145;235;276;175;0;4;272;276
8;Barcelona;13;Barcelonès;08019;Barcelona;3;129;U;;603;203;334;401;202;0;7;394;401
8;Barcelona;13;Barcelonès;08019;Barcelona;3;130;U;;974;228;517;628;346;2;19;607;626
8;Barcelona;13;Barcelonès;08019;Barcelona;3;132;U;;746;232;389;473;273;0;18;455;473
8;Barcelona;13;Barcelonès;08019;Barcelona;3;133;U;;495;149;241;313;182;3;8;302;310
8;Barcelona;13;Barcelonès;08019;Barcelona;3;134;A;;972;272;470;582;390;2;11;569;580
8;Barcelona;13;Barcelonès;08019;Barcelona;3;134;B;;860;246;427;512;348;2;11;499;510
8;Barcelona;13;Barcelonès;08019;Barcelona;3;135;U;;762;208;341;415;347;3;8;404;412
8;Barcelona;13;Barcelonès;08019;Barcelona;3;137;U;;862;231;389;477;385;0;10;467;477
8;Barcelona;13;Barcelonès;08019;Barcelona;3;138;U;;808;227;404;515;293;1;15;499;514
8;Barcelona;13;Barcelonès;08019;Barcelona;3;139;U;;487;166;245;291;196;0;4;287;291
8;Barcelona;13;Barcelonès;08019;Barcelona;3;14;U;;710;194;308;350;360;1;3;346;349
8;Barcelona;13;Barcelonès;08019;Barcelona;3;140;U;;468;143;252;320;148;3;5;312;317
8;Barcelona;13;Barcelonès;08019;Barcelona;3;141;U;;552;122;253;311;241;4;6;301;307
8;Barcelona;13;Barcelonès;08019;Barcelona;3;142;U;;722;237;398;479;243;3;11;465;476
8;Barcelona;13;Barcelonès;08019;Barcelona;3;143;U;;482;173;261;298;184;1;12;285;297
8;Barcelona;13;Barcelonès;08019;Barcelona;3;144;U;;861;218;414;536;325;1;17;518;535
8;Barcelona;13;Barcelonès;08019;Barcelona;3;146;U;;602;186;333;423;179;0;4;419;423
8;Barcelona;13;Barcelonès;08019;Barcelona;3;147;U;;1197;364;645;805;392;1;18;786;804
8;Barcelona;13;Barcelonès;08019;Barcelona;3;148;U;;1080;322;606;735;345;1;19;715;734
8;Barcelona;13;Barcelonès;08019;Barcelona;3;149;U;;860;301;458;560;300;1;19;540;559
8;Barcelona;13;Barcelonès;08019;Barcelona;3;15;U;;499;120;192;248;251;0;8;240;248
8;Barcelona;13;Barcelonès;08019;Barcelona;3;150;U;;687;220;378;446;241;4;9;433;442
8;Barcelona;13;Barcelonès;08019;Barcelona;3;151;U;;756;220;414;498;258;3;8;487;495
8;Barcelona;13;Barcelonès;08019;Barcelona;3;152;U;;508;166;281;329;179;1;5;323;328
8;Barcelona;13;Barcelonès;08019;Barcelona;3;153;U;;1165;335;562;718;447;5;16;697;713
8;Barcelona;13;Barcelonès;08019;Barcelona;3;154;U;;718;215;392;465;253;1;7;457;464
8;Barcelona;13;Barcelonès;08019;Barcelona;3;157;U;;682;229;341;414;268;5;4;405;409
8;Barcelona;13;Barcelonès;08019;Barcelona;3;159;U;;632;203;358;415;217;0;14;401;415
8;Barcelona;13;Barcelonès;08019;Barcelona;3;16;U;;552;126;217;264;288;0;7;257;264
8;Barcelona;13;Barcelonès;08019;Barcelona;3;160;U;;1108;369;612;746;362;4;16;726;742
8;Barcelona;13;Barcelonès;08019;Barcelona;3;162;U;;946;294;521;619;327;1;15;603;618
8;Barcelona;13;Barcelonès;08019;Barcelona;3;163;U;;569;180;319;387;182;2;9;376;385
8;Barcelona;13;Barcelonès;08019;Barcelona;3;164;U;;528;204;313;367;161;0;9;358;367
8;Barcelona;13;Barcelonès;08019;Barcelona;3;165;U;;401;140;212;261;140;1;7;253;260
8;Barcelona;13;Barcelonès;08019;Barcelona;3;167;U;;669;232;383;466;203;1;5;460;465
8;Barcelona;13;Barcelonès;08019;Barcelona;3;168;U;;1203;340;649;800;403;0;8;792;800
8;Barcelona;13;Barcelonès;08019;Barcelona;3;169;U;;1153;336;636;806;347;3;17;786;803
8;Barcelona;13;Barcelonès;08019;Barcelona;3;17;U;;594;149;247;303;291;1;10;292;302
8;Barcelona;13;Barcelonès;08019;Barcelona;3;170;U;;1135;306;557;717;418;7;24;686;710
8;Barcelona;13;Barcelonès;08019;Barcelona;3;172;U;;790;223;406;503;287;1;9;493;502
8;Barcelona;13;Barcelonès;08019;Barcelona;3;173;U;;824;261;417;505;319;1;9;495;504
8;Barcelona;13;Barcelonès;08019;Barcelona;3;176;U;;607;200;337;406;201;0;10;396;406
8;Barcelona;13;Barcelonès;08019;Barcelona;3;177;U;;477;121;213;255;222;2;3;250;253
8;Barcelona;13;Barcelonès;08019;Barcelona;3;178;U;;649;185;328;402;247;3;8;391;399
8;Barcelona;13;Barcelonès;08019;Barcelona;3;179;U;;818;238;346;442;376;0;12;430;442
8;Barcelona;13;Barcelonès;08019;Barcelona;3;18;U;;551;130;218;258;293;1;8;249;257
8;Barcelona;13;Barcelonès;08019;Barcelona;3;180;U;;666;211;372;400;266;1;10;389;399
8;Barcelona;13;Barcelonès;08019;Barcelona;3;182;U;;473;135;216;268;205;0;5;263;268
8;Barcelona;13;Barcelonès;08019;Barcelona;3;183;U;;697;201;308;380;317;2;3;375;378
8;Barcelona;13;Barcelonès;08019;Barcelona;3;184;U;;586;170;304;382;204;5;2;375;377
8;Barcelona;13;Barcelonès;08019;Barcelona;3;185;U;;666;198;296;355;311;3;7;345;352
8;Barcelona;13;Barcelonès;08019;Barcelona;3;186;U;;536;158;251;315;221;1;6;308;314
8;Barcelona;13;Barcelonès;08019;Barcelona;3;188;U;;511;132;265;317;194;1;4;312;316
8;Barcelona;13;Barcelonès;08019;Barcelona;3;189;U;;728;216;350;419;309;2;10;407;417
8;Barcelona;13;Barcelonès;08019;Barcelona;3;19;U;;483;101;192;260;223;1;4;255;259
8;Barcelona;13;Barcelonès;08019;Barcelona;3;191;U;;926;291;465;563;363;0;8;555;563
8;Barcelona;13;Barcelonès;08019;Barcelona;3;192;U;;554;190;306;353;201;1;6;346;352
8;Barcelona;13;Barcelonès;08019;Barcelona;3;193;A;;729;197;362;462;267;0;16;446;462
8;Barcelona;13;Barcelonès;08019;Barcelona;3;193;B;;654;170;304;397;257;0;11;386;397
8;Barcelona;13;Barcelonès;08019;Barcelona;3;195;U;;482;148;234;273;209;1;5;267;272
8;Barcelona;13;Barcelonès;08019;Barcelona;3;196;U;;680;207;323;393;287;4;10;379;389
8;Barcelona;13;Barcelonès;08019;Barcelona;3;197;U;;462;102;193;252;210;2;3;247;250
8;Barcelona;13;Barcelonès;08019;Barcelona;3;198;U;;1032;292;491;601;431;1;13;587;600
8;Barcelona;13;Barcelonès;08019;Barcelona;3;199;U;;500;110;194;248;252;0;4;244;248
8;Barcelona;13;Barcelonès;08019;Barcelona;3;20;U;;563;156;269;311;252;1;2;308;310
8;Barcelona;13;Barcelonès;08019;Barcelona;3;200;U;;722;209;352;408;314;2;11;395;406
8;Barcelona;13;Barcelonès;08019;Barcelona;3;201;U;;1189;310;521;703;486;2;10;691;701
8;Barcelona;13;Barcelonès;08019;Barcelona;3;202;U;;1137;306;524;671;466;0;10;661;671
8;Barcelona;13;Barcelonès;08019;Barcelona;3;204;U;;821;193;363;471;350;0;12;459;471
8;Barcelona;13;Barcelonès;08019;Barcelona;3;205;U;;833;250;422;530;303;2;7;521;528
8;Barcelona;13;Barcelonès;08019;Barcelona;3;207;U;;792;192;367;483;309;2;18;463;481
8;Barcelona;13;Barcelonès;08019;Barcelona;3;208;U;;645;205;339;426;219;1;5;420;425
8;Barcelona;13;Barcelonès;08019;Barcelona;3;209;U;;842;238;440;557;285;0;9;548;557
8;Barcelona;13;Barcelonès;08019;Barcelona;3;210;U;;913;229;418;537;376;1;11;525;536
8;Barcelona;13;Barcelonès;08019;Barcelona;3;22;U;;683;171;288;337;346;0;2;335;337
8;Barcelona;13;Barcelonès;08019;Barcelona;3;23;U;;1119;306;507;586;533;4;12;570;582
8;Barcelona;13;Barcelonès;08019;Barcelona;3;24;U;;499;148;229;290;209;0;9;281;290
8;Barcelona;13;Barcelonès;08019;Barcelona;3;25;U;;694;210;290;353;341;0;6;347;353
8;Barcelona;13;Barcelonès;08019;Barcelona;3;26;U;;406;108;200;234;172;0;3;231;234
8;Barcelona;13;Barcelonès;08019;Barcelona;3;29;U;;524;137;225;283;241;2;8;273;281
8;Barcelona;13;Barcelonès;08019;Barcelona;3;3;U;;828;226;366;426;402;4;10;412;422
8;Barcelona;13;Barcelonès;08019;Barcelona;3;30;U;;752;172;318;405;347;3;14;388;402
8;Barcelona;13;Barcelonès;08019;Barcelona;3;32;U;;781;212;345;406;375;0;3;403;406
8;Barcelona;13;Barcelonès;08019;Barcelona;3;33;U;;579;185;267;309;270;3;7;299;306
8;Barcelona;13;Barcelonès;08019;Barcelona;3;37;U;;642;161;296;347;295;1;6;340;346
8;Barcelona;13;Barcelonès;08019;Barcelona;3;38;U;;903;252;419;485;418;1;10;474;484
8;Barcelona;13;Barcelonès;08019;Barcelona;3;39;U;;815;256;413;472;343;0;10;462;472
8;Barcelona;13;Barcelonès;08019;Barcelona;3;4;U;;926;197;360;463;463;2;7;454;461
8;Barcelona;13;Barcelonès;08019;Barcelona;3;41;U;;550;169;257;285;265;0;3;282;285
8;Barcelona;13;Barcelonès;08019;Barcelona;3;42;U;;554;162;256;305;249;1;6;298;304
8;Barcelona;13;Barcelonès;08019;Barcelona;3;43;U;;783;233;380;452;331;0;14;438;452
8;Barcelona;13;Barcelonès;08019;Barcelona;3;45;U;;708;192;319;387;321;0;10;377;387
8;Barcelona;13;Barcelonès;08019;Barcelona;3;47;U;;617;175;279;336;281;1;12;323;335
8;Barcelona;13;Barcelonès;08019;Barcelona;3;48;U;;773;256;358;434;339;1;2;431;433
8;Barcelona;13;Barcelonès;08019;Barcelona;3;49;U;;613;203;282;321;292;0;12;309;321
8;Barcelona;13;Barcelonès;08019;Barcelona;3;50;U;;913;313;474;575;338;4;10;561;571
8;Barcelona;13;Barcelonès;08019;Barcelona;3;53;U;;435;150;211;256;179;0;4;252;256
8;Barcelona;13;Barcelonès;08019;Barcelona;3;55;U;;664;214;332;387;277;1;5;381;386
8;Barcelona;13;Barcelonès;08019;Barcelona;3;56;U;;492;139;243;287;205;0;5;282;287
8;Barcelona;13;Barcelonès;08019;Barcelona;3;57;U;;997;138;244;325;672;0;4;321;325
8;Barcelona;13;Barcelonès;08019;Barcelona;3;6;U;;650;187;298;364;286;3;3;358;361
8;Barcelona;13;Barcelonès;08019;Barcelona;3;61;U;;906;107;198;230;676;1;4;225;229
8;Barcelona;13;Barcelonès;08019;Barcelona;3;65;U;;617;180;244;333;284;2;7;324;331
8;Barcelona;13;Barcelonès;08019;Barcelona;3;66;U;;698;218;301;390;308;0;14;376;390
8;Barcelona;13;Barcelonès;08019;Barcelona;3;67;U;;505;162;237;305;200;3;9;293;302
8;Barcelona;13;Barcelonès;08019;Barcelona;3;68;A;;669;179;294;382;287;3;5;374;379
8;Barcelona;13;Barcelonès;08019;Barcelona;3;68;B;;615;181;279;356;259;3;7;346;353
8;Barcelona;13;Barcelonès;08019;Barcelona;3;69;A;;1309;346;575;740;569;0;14;726;740
8;Barcelona;13;Barcelonès;08019;Barcelona;3;69;B;;1090;277;457;608;482;10;4;594;598
8;Barcelona;13;Barcelonès;08019;Barcelona;3;7;U;;442;107;174;210;232;2;1;207;208
8;Barcelona;13;Barcelonès;08019;Barcelona;3;71;A;;874;211;436;542;332;0;12;530;542
8;Barcelona;13;Barcelonès;08019;Barcelona;3;71;B;;782;203;370;452;330;0;16;436;452
8;Barcelona;13;Barcelonès;08019;Barcelona;3;72;A;;1359;291;572;735;624;0;9;726;735
8;Barcelona;13;Barcelonès;08019;Barcelona;3;72;B;;1015;250;450;563;452;3;8;552;560
8;Barcelona;13;Barcelonès;08019;Barcelona;3;72;C;;1051;266;473;571;480;5;14;552;566
8;Barcelona;13;Barcelonès;08019;Barcelona;3;72;D;;977;237;421;522;455;4;10;508;518
8;Barcelona;13;Barcelonès;08019;Barcelona;3;72;E;;730;124;323;396;334;0;10;386;396
8;Barcelona;13;Barcelonès;08019;Barcelona;3;73;A;;1151;256;483;608;543;7;12;589;601
8;Barcelona;13;Barcelonès;08019;Barcelona;3;73;B;;1038;234;446;561;477;0;4;557;561
8;Barcelona;13;Barcelonès;08019;Barcelona;3;74;A;;1218;257;440;541;677;0;11;530;541
8;Barcelona;13;Barcelonès;08019;Barcelona;3;74;B;;1070;231;410;512;558;1;9;502;511
8;Barcelona;13;Barcelonès;08019;Barcelona;3;75;A;;770;160;257;315;455;0;5;310;315
8;Barcelona;13;Barcelonès;08019;Barcelona;3;75;B;;666;137;217;253;413;1;3;249;252
8;Barcelona;13;Barcelonès;08019;Barcelona;3;76;U;;789;196;340;431;358;3;11;417;428
8;Barcelona;13;Barcelonès;08019;Barcelona;3;77;U;;846;170;279;358;488;0;4;354;358
8;Barcelona;13;Barcelonès;08019;Barcelona;3;8;U;;880;217;363;425;455;3;19;403;422
8;Barcelona;13;Barcelonès;08019;Barcelona;3;80;U;;677;180;270;317;360;2;1;314;315
8;Barcelona;13;Barcelonès;08019;Barcelona;3;82;A;;781;196;375;448;333;2;3;443;446
8;Barcelona;13;Barcelonès;08019;Barcelona;3;82;B;;670;185;322;390;280;0;11;379;390
8;Barcelona;13;Barcelonès;08019;Barcelona;3;83;U;;840;207;359;447;393;1;12;434;446
8;Barcelona;13;Barcelonès;08019;Barcelona;3;84;U;;522;158;242;308;214;1;8;299;307
8;Barcelona;13;Barcelonès;08019;Barcelona;3;85;U;;727;184;342;419;308;6;4;409;413
8;Barcelona;13;Barcelonès;08019;Barcelona;3;86;U;;717;186;301;402;315;3;6;393;399
8;Barcelona;13;Barcelonès;08019;Barcelona;3;87;U;;531;139;264;321;210;1;5;315;320
8;Barcelona;13;Barcelonès;08019;Barcelona;3;88;U;;741;220;425;476;265;1;6;469;475
8;Barcelona;13;Barcelonès;08019;Barcelona;3;89;U;;434;133;212;261;173;1;6;254;260
8;Barcelona;13;Barcelonès;08019;Barcelona;3;90;U;;570;153;257;324;246;0;4;320;324
8;Barcelona;13;Barcelonès;08019;Barcelona;3;91;U;;1109;263;546;707;402;3;15;689;704
8;Barcelona;13;Barcelonès;08019;Barcelona;3;92;U;;518;168;272;313;205;1;17;295;312
8;Barcelona;13;Barcelonès;08019;Barcelona;3;93;U;;524;153;258;305;219;3;3;299;302
8;Barcelona;13;Barcelonès;08019;Barcelona;3;94;U;;548;148;240;287;261;0;4;283;287
8;Barcelona;13;Barcelonès;08019;Barcelona;3;95;U;;598;139;242;314;284;2;8;304;312
8;Barcelona;13;Barcelonès;08019;Barcelona;3;97;U;;559;174;272;312;247;4;5;303;308
8;Barcelona;13;Barcelonès;08019;Barcelona;3;98;U;;998;246;469;558;440;1;12;545;557
8;Barcelona;13;Barcelonès;08019;Barcelona;4;1;U;;662;192;367;450;212;0;11;439;450
8;Barcelona;13;Barcelonès;08019;Barcelona;4;10;A;;1190;300;656;846;344;7;20;819;839
8;Barcelona;13;Barcelonès;08019;Barcelona;4;10;B;;1133;311;640;830;303;1;18;811;829
8;Barcelona;13;Barcelonès;08019;Barcelona;4;11;A;;686;209;360;461;225;1;5;455;460
8;Barcelona;13;Barcelonès;08019;Barcelona;4;11;B;;662;201;363;450;212;0;10;440;450
8;Barcelona;13;Barcelonès;08019;Barcelona;4;12;U;;492;138;260;314;178;0;4;310;314
8;Barcelona;13;Barcelonès;08019;Barcelona;4;13;U;;908;270;432;520;388;6;11;503;514
8;Barcelona;13;Barcelonès;08019;Barcelona;4;14;U;;621;186;294;384;237;1;6;377;383
8;Barcelona;13;Barcelonès;08019;Barcelona;4;15;U;;538;159;270;334;204;4;3;327;330
8;Barcelona;13;Barcelonès;08019;Barcelona;4;16;A;;743;214;383;468;275;5;9;454;463
8;Barcelona;13;Barcelonès;08019;Barcelona;4;16;B;;713;189;345;425;288;1;10;414;424
8;Barcelona;13;Barcelonès;08019;Barcelona;4;17;U;;414;94;173;222;192;0;5;217;222
8;Barcelona;13;Barcelonès;08019;Barcelona;4;18;U;;1053;250;496;668;385;1;18;649;667
8;Barcelona;13;Barcelonès;08019;Barcelona;4;19;A;;906;289;507;657;249;1;18;638;656
8;Barcelona;13;Barcelonès;08019;Barcelona;4;19;B;;806;279;481;571;235;2;7;562;569
8;Barcelona;13;Barcelonès;08019;Barcelona;4;2;U;;612;170;318;399;213;2;6;391;397
8;Barcelona;13;Barcelonès;08019;Barcelona;4;20;A;;817;2;465;594;223;1;22;571;593
8;Barcelona;13;Barcelonès;08019;Barcelona;4;20;B;;728;220;405;515;213;0;3;512;515
8;Barcelona;13;Barcelonès;08019;Barcelona;4;21;U;;1009;370;611;769;240;4;13;752;765
8;Barcelona;13;Barcelonès;08019;Barcelona;4;22;U;;772;262;441;539;233;0;8;531;539
8;Barcelona;13;Barcelonès;08019;Barcelona;4;23;U;;568;186;321;383;185;0;7;376;383
8;Barcelona;13;Barcelonès;08019;Barcelona;4;24;U;;782;239;407;530;252;2;15;513;528
8;Barcelona;13;Barcelonès;08019;Barcelona;4;25;U;;549;190;308;350;199;3;9;338;347
8;Barcelona;13;Barcelonès;08019;Barcelona;4;26;U;;744;227;414;519;225;1;11;507;518
8;Barcelona;13;Barcelonès;08019;Barcelona;4;27;U;;647;190;319;379;268;0;12;367;379
8;Barcelona;13;Barcelonès;08019;Barcelona;4;28;U;;839;214;371;476;363;1;9;466;475
8;Barcelona;13;Barcelonès;08019;Barcelona;4;29;U;;945;301;501;632;313;2;21;609;630
8;Barcelona;13;Barcelonès;08019;Barcelona;4;3;U;;472;130;242;296;176;0;9;287;296
8;Barcelona;13;Barcelonès;08019;Barcelona;4;30;U;;688;236;346;422;266;3;9;410;419
8;Barcelona;13;Barcelonès;08019;Barcelona;4;32;U;;721;203;370;461;260;1;13;447;460
8;Barcelona;13;Barcelonès;08019;Barcelona;4;33;U;;760;197;396;500;260;2;13;485;498
8;Barcelona;13;Barcelonès;08019;Barcelona;4;34;U;;852;255;456;553;299;3;9;541;550
8;Barcelona;13;Barcelonès;08019;Barcelona;4;35;U;;912;286;460;572;340;2;10;560;570
8;Barcelona;13;Barcelonès;08019;Barcelona;4;36;U;;604;219;352;425;179;0;14;411;425
8;Barcelona;13;Barcelonès;08019;Barcelona;4;37;U;;1050;280;578;728;322;3;29;696;725
8;Barcelona;13;Barcelonès;08019;Barcelona;4;38;U;;646;189;327;409;237;0;9;400;409
8;Barcelona;13;Barcelonès;08019;Barcelona;4;39;U;;672;215;392;489;183;2;8;479;487
8;Barcelona;13;Barcelonès;08019;Barcelona;4;4;U;;666;214;377;456;210;4;14;438;452
8;Barcelona;13;Barcelonès;08019;Barcelona;4;40;A;;701;188;392;506;195;2;8;496;504
8;Barcelona;13;Barcelonès;08019;Barcelona;4;40;B;;734;210;409;521;213;2;13;506;519
8;Barcelona;13;Barcelonès;08019;Barcelona;4;41;U;;1218;318;668;851;367;0;16;835;851
8;Barcelona;13;Barcelonès;08019;Barcelona;4;42;A;;753;239;433;531;222;0;10;521;531
8;Barcelona;13;Barcelonès;08019;Barcelona;4;42;B;;689;220;397;504;185;2;7;495;502
8;Barcelona;13;Barcelonès;08019;Barcelona;4;43;U;;625;175;351;440;185;1;8;431;439
8;Barcelona;13;Barcelonès;08019;Barcelona;4;44;U;;907;289;508;619;288;1;11;607;618
8;Barcelona;13;Barcelonès;08019;Barcelona;4;45;U;;1107;371;593;725;382;1;15;709;724
8;Barcelona;13;Barcelonès;08019;Barcelona;4;48;U;;974;281;530;692;282;0;12;680;692
8;Barcelona;13;Barcelonès;08019;Barcelona;4;5;U;;676;207;354;444;232;1;13;430;443
8;Barcelona;13;Barcelonès;08019;Barcelona;4;50;U;;694;202;367;452;242;1;10;441;451
8;Barcelona;13;Barcelonès;08019;Barcelona;4;51;U;;453;118;241;306;147;1;8;297;305
8;Barcelona;13;Barcelonès;08019;Barcelona;4;52;U;;698;217;398;468;230;1;9;458;467
8;Barcelona;13;Barcelonès;08019;Barcelona;4;53;U;;977;330;573;680;297;4;21;655;676
8;Barcelona;13;Barcelonès;08019;Barcelona;4;54;U;;840;268;460;596;244;3;10;583;593
8;Barcelona;13;Barcelonès;08019;Barcelona;4;55;U;;566;164;323;395;171;1;12;382;394
8;Barcelona;13;Barcelonès;08019;Barcelona;4;57;U;;988;278;533;657;331;0;16;641;657
8;Barcelona;13;Barcelonès;08019;Barcelona;4;58;U;;591;195;344;397;194;2;9;386;395
8;Barcelona;13;Barcelonès;08019;Barcelona;4;6;U;;579;185;306;360;219;2;5;353;358
8;Barcelona;13;Barcelonès;08019;Barcelona;4;60;U;;572;205;335;402;170;2;5;395;400
8;Barcelona;13;Barcelonès;08019;Barcelona;4;61;U;;505;140;276;351;154;2;8;341;349
8;Barcelona;13;Barcelonès;08019;Barcelona;4;62;U;;507;191;304;370;137;0;4;366;370
8;Barcelona;13;Barcelonès;08019;Barcelona;4;63;U;;780;238;443;544;236;2;9;533;542
8;Barcelona;13;Barcelonès;08019;Barcelona;4;65;U;;945;338;570;691;254;2;15;674;689
8;Barcelona;13;Barcelonès;08019;Barcelona;4;66;U;;1087;345;624;769;318;2;22;745;767
8;Barcelona;13;Barcelonès;08019;Barcelona;4;68;U;;562;221;435;409;153;2;6;401;407
8;Barcelona;13;Barcelonès;08019;Barcelona;4;69;U;;998;274;510;641;357;1;13;627;640
8;Barcelona;13;Barcelonès;08019;Barcelona;4;7;A;;757;241;419;531;226;3;12;516;528
8;Barcelona;13;Barcelonès;08019;Barcelona;4;7;B;;680;196;350;431;249;1;4;426;430
8;Barcelona;13;Barcelonès;08019;Barcelona;4;71;A;;880;217;484;635;245;0;12;623;635
8;Barcelona;13;Barcelonès;08019;Barcelona;4;71;B;;687;184;408;526;161;2;5;519;524
8;Barcelona;13;Barcelonès;08019;Barcelona;4;73;U;;1063;275;591;748;315;1;9;738;747
8;Barcelona;13;Barcelonès;08019;Barcelona;4;74;U;;1203;386;713;854;349;4;14;836;850
8;Barcelona;13;Barcelonès;08019;Barcelona;4;75;U;;455;144;284;334;121;1;5;328;333
8;Barcelona;13;Barcelonès;08019;Barcelona;4;76;U;;1063;366;700;797;266;0;21;776;797
8;Barcelona;13;Barcelonès;08019;Barcelona;4;77;A;;742;204;448;551;191;0;7;544;551
8;Barcelona;13;Barcelonès;08019;Barcelona;4;77;B;;606;149;326;418;188;0;5;413;418
8;Barcelona;13;Barcelonès;08019;Barcelona;4;78;U;;813;220;400;502;311;2;3;497;500
8;Barcelona;13;Barcelonès;08019;Barcelona;4;79;U;;894;257;530;660;234;0;6;654;660
8;Barcelona;13;Barcelonès;08019;Barcelona;4;8;U;;882;221;443;593;289;2;17;574;591
8;Barcelona;13;Barcelonès;08019;Barcelona;4;81;U;;871;239;464;613;258;0;26;587;613
8;Barcelona;13;Barcelonès;08019;Barcelona;4;82;U;;678;221;396;478;200;0;8;470;478
8;Barcelona;13;Barcelonès;08019;Barcelona;4;83;A;;1068;252;588;738;330;2;18;718;736
8;Barcelona;13;Barcelonès;08019;Barcelona;4;83;B;;968;305;541;686;282;2;10;674;684
8;Barcelona;13;Barcelonès;08019;Barcelona;5;1;U;;711;238;422;491;220;1;9;481;490
8;Barcelona;13;Barcelonès;08019;Barcelona;5;10;U;;621;179;321;402;219;1;11;390;401
8;Barcelona;13;Barcelonès;08019;Barcelona;5;100;U;;650;197;356;446;204;0;11;435;446
8;Barcelona;13;Barcelonès;08019;Barcelona;5;101;U;;522;158;275;326;196;2;3;321;324
8;Barcelona;13;Barcelonès;08019;Barcelona;5;102;U;;798;243;466;589;209;0;6;583;589
8;Barcelona;13;Barcelonès;08019;Barcelona;5;103;U;;456;184;259;323;133;0;9;314;323
8;Barcelona;13;Barcelonès;08019;Barcelona;5;104;U;;708;236;398;486;222;2;9;475;484
8;Barcelona;13;Barcelonès;08019;Barcelona;5;105;U;;1172;345;710;879;293;2;19;858;877
8;Barcelona;13;Barcelonès;08019;Barcelona;5;106;U;;741;225;434;549;192;6;10;533;543
8;Barcelona;13;Barcelonès;08019;Barcelona;5;107;U;;789;272;475;563;226;0;14;549;563
8;Barcelona;13;Barcelonès;08019;Barcelona;5;109;U;;645;172;380;481;164;0;23;458;481
8;Barcelona;13;Barcelonès;08019;Barcelona;5;11;U;;962;299;535;644;318;0;16;628;644
8;Barcelona;13;Barcelonès;08019;Barcelona;5;110;U;;1000;305;582;706;294;2;12;692;704
8;Barcelona;13;Barcelonès;08019;Barcelona;5;112;U;;1286;334;685;876;410;1;16;859;875
8;Barcelona;13;Barcelonès;08019;Barcelona;5;115;U;;901;225;436;595;306;0;18;577;595
8;Barcelona;13;Barcelonès;08019;Barcelona;5;117;U;;988;326;617;729;259;0;17;712;729
8;Barcelona;13;Barcelonès;08019;Barcelona;5;118;U;;844;310;529;623;221;2;10;611;621
8;Barcelona;13;Barcelonès;08019;Barcelona;5;120;U;;745;242;409;497;248;5;13;479;492
8;Barcelona;13;Barcelonès;08019;Barcelona;5;121;U;;633;201;375;463;170;2;13;448;461
8;Barcelona;13;Barcelonès;08019;Barcelona;5;122;U;;896;277;518;634;262;1;7;626;633
8;Barcelona;13;Barcelonès;08019;Barcelona;5;124;U;;483;145;305;358;125;0;11;347;358
8;Barcelona;13;Barcelonès;08019;Barcelona;5;125;U;;454;136;245;293;161;0;9;284;293
8;Barcelona;13;Barcelonès;08019;Barcelona;5;126;U;;530;157;325;399;131;0;8;391;399
8;Barcelona;13;Barcelonès;08019;Barcelona;5;127;U;;478;169;312;378;100;0;3;375;378
8;Barcelona;13;Barcelonès;08019;Barcelona;5;129;U;;493;187;316;385;108;0;3;382;385
8;Barcelona;13;Barcelonès;08019;Barcelona;5;13;U;;806;240;433;516;290;2;8;506;514
8;Barcelona;13;Barcelonès;08019;Barcelona;5;131;U;;821;296;523;611;210;0;11;600;611
8;Barcelona;13;Barcelonès;08019;Barcelona;5;133;U;;871;295;543;670;201;1;11;658;669
8;Barcelona;13;Barcelonès;08019;Barcelona;5;134;U;;529;155;462;419;110;0;14;405;419
8;Barcelona;13;Barcelonès;08019;Barcelona;5;135;U;;979;316;594;764;215;1;15;748;763
8;Barcelona;13;Barcelonès;08019;Barcelona;5;136;U;;718;253;462;551;167;0;11;540;551
8;Barcelona;13;Barcelonès;08019;Barcelona;5;137;U;;571;188;343;425;146;0;0;425;425
8;Barcelona;13;Barcelonès;08019;Barcelona;5;138;U;;572;211;370;451;121;1;8;442;450
8;Barcelona;13;Barcelonès;08019;Barcelona;5;139;U;;800;243;480;609;191;4;9;596;605
8;Barcelona;13;Barcelonès;08019;Barcelona;5;14;U;;528;178;303;358;170;1;8;349;357
8;Barcelona;13;Barcelonès;08019;Barcelona;5;140;U;;881;281;482;636;245;2;10;624;634
8;Barcelona;13;Barcelonès;08019;Barcelona;5;141;U;;755;248;419;519;236;0;19;500;519
8;Barcelona;13;Barcelonès;08019;Barcelona;5;144;U;;606;205;370;449;157;0;8;441;449
8;Barcelona;13;Barcelonès;08019;Barcelona;5;145;U;;759;256;462;568;191;1;10;557;567
8;Barcelona;13;Barcelonès;08019;Barcelona;5;146;U;;695;206;389;462;233;2;6;454;460
8;Barcelona;13;Barcelonès;08019;Barcelona;5;147;U;;625;208;365;465;160;0;11;454;465
8;Barcelona;13;Barcelonès;08019;Barcelona;5;148;U;;1179;337;697;905;274;3;19;883;902
8;Barcelona;13;Barcelonès;08019;Barcelona;5;149;U;;1219;417;680;844;375;4;18;822;840
8;Barcelona;13;Barcelonès;08019;Barcelona;5;15;U;;806;270;476;586;220;2;22;562;584
8;Barcelona;13;Barcelonès;08019;Barcelona;5;152;U;;453;141;243;291;162;0;14;277;291
8;Barcelona;13;Barcelonès;08019;Barcelona;5;153;U;;522;204;324;405;117;0;5;400;405
8;Barcelona;13;Barcelonès;08019;Barcelona;5;154;U;;589;195;362;443;146;1;8;434;442
8;Barcelona;13;Barcelonès;08019;Barcelona;5;155;U;;539;191;327;391;148;2;3;386;389
8;Barcelona;13;Barcelonès;08019;Barcelona;5;156;U;;837;264;508;618;219;2;23;593;616
8;Barcelona;13;Barcelonès;08019;Barcelona;5;157;U;;669;228;411;502;167;1;18;483;501
8;Barcelona;13;Barcelonès;08019;Barcelona;5;158;U;;777;239;486;608;169;1;13;594;607
8;Barcelona;13;Barcelonès;08019;Barcelona;5;16;U;;796;268;507;567;229;3;20;544;564
8;Barcelona;13;Barcelonès;08019;Barcelona;5;160;U;;1034;339;626;760;274;0;19;741;760
8;Barcelona;13;Barcelonès;08019;Barcelona;5;161;U;;693;205;366;468;225;5;9;454;463
8;Barcelona;13;Barcelonès;08019;Barcelona;5;162;U;;883;250;446;569;314;1;16;552;568
8;Barcelona;13;Barcelonès;08019;Barcelona;5;164;U;;489;151;258;328;161;2;11;315;326
8;Barcelona;13;Barcelonès;08019;Barcelona;5;165;U;;556;200;352;423;133;1;8;414;422
8;Barcelona;13;Barcelonès;08019;Barcelona;5;166;U;;624;217;373;447;177;0;8;439;447
8;Barcelona;13;Barcelonès;08019;Barcelona;5;168;U;;526;184;317;393;133;3;6;384;390
8;Barcelona;13;Barcelonès;08019;Barcelona;5;169;U;;844;271;515;632;212;1;19;612;631
8;Barcelona;13;Barcelonès;08019;Barcelona;5;170;U;;610;184;345;424;186;2;15;407;422
8;Barcelona;13;Barcelonès;08019;Barcelona;5;171;U;;1133;421;700;846;287;1;22;823;845
8;Barcelona;13;Barcelonès;08019;Barcelona;5;174;U;;470;143;221;261;209;0;13;248;261
8;Barcelona;13;Barcelonès;08019;Barcelona;5;175;U;;1111;378;619;734;377;3;0;731;731
8;Barcelona;13;Barcelonès;08019;Barcelona;5;177;U;;479;181;296;363;116;3;8;352;360
8;Barcelona;13;Barcelonès;08019;Barcelona;5;178;U;;895;265;499;607;288;0;15;592;607
8;Barcelona;13;Barcelonès;08019;Barcelona;5;18;U;;604;220;371;454;150;0;5;449;454
8;Barcelona;13;Barcelonès;08019;Barcelona;5;180;U;;615;229;367;438;177;1;11;426;437
8;Barcelona;13;Barcelonès;08019;Barcelona;5;182;U;;1088;281;606;742;346;4;30;708;738
8;Barcelona;13;Barcelonès;08019;Barcelona;5;183;U;;876;205;375;488;388;0;8;480;488
8;Barcelona;13;Barcelonès;08019;Barcelona;5;19;U;;494;166;293;364;130;0;13;351;364
8;Barcelona;13;Barcelonès;08019;Barcelona;5;2;U;;501;155;276;342;159;0;4;338;342
8;Barcelona;13;Barcelonès;08019;Barcelona;5;20;U;;479;155;274;349;130;3;17;329;346
8;Barcelona;13;Barcelonès;08019;Barcelona;5;21;U;;483;150;277;353;130;0;8;345;353
8;Barcelona;13;Barcelonès;08019;Barcelona;5;23;U;;530;180;312;375;155;2;6;367;373
8;Barcelona;13;Barcelonès;08019;Barcelona;5;24;U;;512;211;336;381;131;0;3;378;381
8;Barcelona;13;Barcelonès;08019;Barcelona;5;25;U;;519;189;311;364;155;0;6;358;364
8;Barcelona;13;Barcelonès;08019;Barcelona;5;27;U;;594;192;343;406;188;5;2;399;401
8;Barcelona;13;Barcelonès;08019;Barcelona;5;28;U;;546;186;319;399;147;4;11;384;395
8;Barcelona;13;Barcelonès;08019;Barcelona;5;29;U;;986;338;611;745;241;0;20;725;745
8;Barcelona;13;Barcelonès;08019;Barcelona;5;3;A;;884;279;510;660;224;2;9;649;658
8;Barcelona;13;Barcelonès;08019;Barcelona;5;3;B;;834;278;505;642;192;3;18;621;639
8;Barcelona;13;Barcelonès;08019;Barcelona;5;31;U;;687;247;425;497;190;0;10;487;497
8;Barcelona;13;Barcelonès;08019;Barcelona;5;32;U;;471;169;292;345;126;1;14;330;344
8;Barcelona;13;Barcelonès;08019;Barcelona;5;33;U;;429;159;257;317;112;1;6;310;316
8;Barcelona;13;Barcelonès;08019;Barcelona;5;34;U;;637;198;371;451;186;0;13;438;451
8;Barcelona;13;Barcelonès;08019;Barcelona;5;35;U;;936;290;499;603;333;2;25;576;601
8;Barcelona;13;Barcelonès;08019;Barcelona;5;37;U;;683;234;393;478;205;1;6;471;477
8;Barcelona;13;Barcelonès;08019;Barcelona;5;38;U;;462;149;270;312;150;2;7;303;310
8;Barcelona;13;Barcelonès;08019;Barcelona;5;39;U;;949;292;577;691;258;1;12;678;690
8;Barcelona;13;Barcelonès;08019;Barcelona;5;4;U;;793;208;450;583;210;1;15;567;582
8;Barcelona;13;Barcelonès;08019;Barcelona;5;40;U;;471;175;305;374;97;2;6;366;372
8;Barcelona;13;Barcelonès;08019;Barcelona;5;41;U;;836;262;492;594;242;0;10;584;594
8;Barcelona;13;Barcelonès;08019;Barcelona;5;42;U;;691;216;423;509;182;0;7;502;509
8;Barcelona;13;Barcelonès;08019;Barcelona;5;43;U;;1062;364;665;825;237;0;18;807;825
8;Barcelona;13;Barcelonès;08019;Barcelona;5;45;U;;502;154;295;390;112;0;9;381;390
8;Barcelona;13;Barcelonès;08019;Barcelona;5;46;U;;586;197;353;434;152;0;5;429;434
8;Barcelona;13;Barcelonès;08019;Barcelona;5;47;U;;633;184;376;461;172;0;6;455;461
8;Barcelona;13;Barcelonès;08019;Barcelona;5;48;U;;1013;320;595;747;266;4;18;725;743
8;Barcelona;13;Barcelonès;08019;Barcelona;5;49;U;;603;177;326;410;193;1;11;398;409
8;Barcelona;13;Barcelonès;08019;Barcelona;5;5;U;;838;281;497;626;212;0;5;621;626
8;Barcelona;13;Barcelonès;08019;Barcelona;5;50;U;;574;168;315;403;171;0;10;393;403
8;Barcelona;13;Barcelonès;08019;Barcelona;5;52;U;;653;225;429;518;135;0;8;510;518
8;Barcelona;13;Barcelonès;08019;Barcelona;5;53;U;;479;181;308;381;98;1;7;373;380
8;Barcelona;13;Barcelonès;08019;Barcelona;5;54;U;;644;241;384;448;196;2;9;437;446
8;Barcelona;13;Barcelonès;08019;Barcelona;5;55;U;;786;266;440;551;235;0;15;536;551
8;Barcelona;13;Barcelonès;08019;Barcelona;5;56;U;;487;182;313;367;120;1;15;351;366
8;Barcelona;13;Barcelonès;08019;Barcelona;5;57;U;;514;183;325;385;129;0;16;369;385
8;Barcelona;13;Barcelonès;08019;Barcelona;5;58;U;;777;267;442;537;240;0;18;519;537
8;Barcelona;13;Barcelonès;08019;Barcelona;5;59;U;;454;148;270;349;105;0;9;340;349
8;Barcelona;13;Barcelonès;08019;Barcelona;5;6;U;;934;282;526;658;276;2;9;647;656
8;Barcelona;13;Barcelonès;08019;Barcelona;5;60;U;;641;248;405;464;177;0;5;459;464
8;Barcelona;13;Barcelonès;08019;Barcelona;5;61;U;;711;213;391;494;217;3;8;483;491
8;Barcelona;13;Barcelonès;08019;Barcelona;5;62;U;;640;219;378;476;164;1;9;466;475
8;Barcelona;13;Barcelonès;08019;Barcelona;5;64;U;;583;187;338;396;187;1;6;389;395
8;Barcelona;13;Barcelonès;08019;Barcelona;5;65;U;;835;240;467;570;265;3;18;549;567
8;Barcelona;13;Barcelonès;08019;Barcelona;5;67;U;;831;260;472;573;258;5;24;544;568
8;Barcelona;13;Barcelonès;08019;Barcelona;5;68;U;;493;166;272;321;172;3;9;309;318
8;Barcelona;13;Barcelonès;08019;Barcelona;5;69;U;;1036;348;606;708;328;2;12;694;706
8;Barcelona;13;Barcelonès;08019;Barcelona;5;70;U;;573;18;352;409;164;3;11;395;406
8;Barcelona;13;Barcelonès;08019;Barcelona;5;72;U;;624;220;379;458;166;2;11;445;456
8;Barcelona;13;Barcelonès;08019;Barcelona;5;73;U;;961;323;581;690;271;0;18;672;690
8;Barcelona;13;Barcelonès;08019;Barcelona;5;75;U;;676;209;373;460;216;4;10;446;456
8;Barcelona;13;Barcelonès;08019;Barcelona;5;76;U;;564;207;353;415;149;2;12;401;413
8;Barcelona;13;Barcelonès;08019;Barcelona;5;77;U;;973;292;561;696;277;6;9;681;690
8;Barcelona;13;Barcelonès;08019;Barcelona;5;79;U;;668;250;407;476;192;2;16;458;474
8;Barcelona;13;Barcelonès;08019;Barcelona;5;8;U;;437;158;256;301;136;3;10;288;298
8;Barcelona;13;Barcelonès;08019;Barcelona;5;80;U;;879;257;470;601;278;0;14;587;601
8;Barcelona;13;Barcelonès;08019;Barcelona;5;81;U;;498;154;255;320;178;2;6;312;318
8;Barcelona;13;Barcelonès;08019;Barcelona;5;82;U;;784;265;466;579;205;0;17;562;579
8;Barcelona;13;Barcelonès;08019;Barcelona;5;84;A;;702;183;346;450;252;2;11;437;448
8;Barcelona;13;Barcelonès;08019;Barcelona;5;84;B;;629;181;342;437;192;0;19;418;437
8;Barcelona;13;Barcelonès;08019;Barcelona;5;86;U;;813;237;426;555;258;2;17;536;553
8;Barcelona;13;Barcelonès;08019;Barcelona;5;87;U;;478;160;277;344;134;0;13;331;344
8;Barcelona;13;Barcelonès;08019;Barcelona;5;88;U;;543;184;304;378;165;0;9;369;378
8;Barcelona;13;Barcelonès;08019;Barcelona;5;89;U;;719;225;431;508;211;0;16;492;508
8;Barcelona;13;Barcelonès;08019;Barcelona;5;90;U;;668;202;391;514;154;1;17;496;513
8;Barcelona;13;Barcelonès;08019;Barcelona;5;91;A;;972;266;523;666;306;4;5;657;662
8;Barcelona;13;Barcelonès;08019;Barcelona;5;91;B;;945;278;531;659;286;0;21;638;659
8;Barcelona;13;Barcelonès;08019;Barcelona;5;93;U;;487;143;265;329;158;1;13;315;328
8;Barcelona;13;Barcelonès;08019;Barcelona;5;94;U;;434;151;255;315;119;2;8;305;313
8;Barcelona;13;Barcelonès;08019;Barcelona;5;95;U;;821;165;457;558;263;0;19;539;558
8;Barcelona;13;Barcelonès;08019;Barcelona;5;96;U;;619;263;326;420;199;0;9;411;420
8;Barcelona;13;Barcelonès;08019;Barcelona;5;97;U;;1218;408;730;848;370;5;22;821;843
8;Barcelona;13;Barcelonès;08019;Barcelona;5;98;U;;559;162;290;348;211;2;6;340;346
8;Barcelona;13;Barcelonès;08019;Barcelona;5;99;U;;485;151;266;348;137;1;10;337;347
8;Barcelona;13;Barcelonès;08019;Barcelona;6;1;U;;1091;372;609;732;359;1;19;712;731
8;Barcelona;13;Barcelonès;08019;Barcelona;6;10;U;;675;195;317;385;290;4;10;371;381
8;Barcelona;13;Barcelonès;08019;Barcelona;6;100;U;;698;227;374;451;247;1;7;443;450
8;Barcelona;13;Barcelonès;08019;Barcelona;6;102;U;;605;203;348;423;182;0;6;417;423
8;Barcelona;13;Barcelonès;08019;Barcelona;6;103;U;;796;265;450;556;240;0;15;541;556
8;Barcelona;13;Barcelonès;08019;Barcelona;6;104;U;;613;191;338;400;213;2;9;389;398
8;Barcelona;13;Barcelonès;08019;Barcelona;6;105;U;;661;216;423;444;217;1;11;432;443
8;Barcelona;13;Barcelonès;08019;Barcelona;6;106;U;;738;197;357;438;300;0;14;424;438
8;Barcelona;13;Barcelonès;08019;Barcelona;6;107;U;;933;278;532;644;289;3;12;629;641
8;Barcelona;13;Barcelonès;08019;Barcelona;6;109;U;;663;200;363;446;217;5;8;433;441
8;Barcelona;13;Barcelonès;08019;Barcelona;6;11;U;;863;230;403;505;358;0;9;496;505
8;Barcelona;13;Barcelonès;08019;Barcelona;6;110;U;;868;272;441;547;321;8;24;515;539
8;Barcelona;13;Barcelonès;08019;Barcelona;6;112;U;;810;273;429;530;280;3;13;514;527
8;Barcelona;13;Barcelonès;08019;Barcelona;6;113;U;;759;288;480;569;190;2;9;558;567
8;Barcelona;13;Barcelonès;08019;Barcelona;6;114;A;;812;297;491;594;218;8;10;576;586
8;Barcelona;13;Barcelonès;08019;Barcelona;6;114;B;;776;248;433;555;221;0;8;547;555
8;Barcelona;13;Barcelonès;08019;Barcelona;6;115;U;;1169;385;622;855;314;3;10;842;852
8;Barcelona;13;Barcelonès;08019;Barcelona;6;116;U;;513;195;270;351;162;3;5;343;348
8;Barcelona;13;Barcelonès;08019;Barcelona;6;117;U;;729;245;407;512;217;2;7;503;510
8;Barcelona;13;Barcelonès;08019;Barcelona;6;118;U;;748;261;432;535;213;0;18;517;535
8;Barcelona;13;Barcelonès;08019;Barcelona;6;119;U;;676;265;437;503;173;2;12;489;501
8;Barcelona;13;Barcelonès;08019;Barcelona;6;12;U;;452;119;207;248;204;1;5;242;247
8;Barcelona;13;Barcelonès;08019;Barcelona;6;120;U;;636;225;388;484;152;0;14;470;484
8;Barcelona;13;Barcelonès;08019;Barcelona;6;121;U;;616;207;324;407;209;2;8;397;405
8;Barcelona;13;Barcelonès;08019;Barcelona;6;122;U;;1096;312;596;758;338;1;20;737;757
8;Barcelona;13;Barcelonès;08019;Barcelona;6;124;U;;604;190;298;351;253;0;2;349;351
8;Barcelona;13;Barcelonès;08019;Barcelona;6;125;U;;547;163;290;343;204;0;10;333;343
8;Barcelona;13;Barcelonès;08019;Barcelona;6;127;U;;844;257;421;523;321;0;10;513;523
8;Barcelona;13;Barcelonès;08019;Barcelona;6;128;U;;809;249;473;580;229;2;10;568;578
8;Barcelona;13;Barcelonès;08019;Barcelona;6;129;U;;427;125;205;269;158;1;6;262;268
8;Barcelona;13;Barcelonès;08019;Barcelona;6;13;U;;540;173;283;319;221;0;9;310;319
8;Barcelona;13;Barcelonès;08019;Barcelona;6;130;U;;535;151;271;344;191;2;2;340;342
8;Barcelona;13;Barcelonès;08019;Barcelona;6;131;U;;677;176;286;355;322;0;9;346;355
8;Barcelona;13;Barcelonès;08019;Barcelona;6;132;U;;691;188;296;384;307;1;9;374;383
8;Barcelona;13;Barcelonès;08019;Barcelona;6;133;U;;631;171;291;378;253;1;9;368;377
8;Barcelona;13;Barcelonès;08019;Barcelona;6;134;A;;634;206;350;426;208;0;12;414;426
8;Barcelona;13;Barcelonès;08019;Barcelona;6;134;B;;640;235;363;428;212;1;7;420;427
8;Barcelona;13;Barcelonès;08019;Barcelona;6;136;U;;1056;329;555;678;378;6;13;659;672
8;Barcelona;13;Barcelonès;08019;Barcelona;6;137;U;;548;174;309;342;206;1;7;334;341
8;Barcelona;13;Barcelonès;08019;Barcelona;6;138;U;;784;201;380;468;316;2;10;456;466
8;Barcelona;13;Barcelonès;08019;Barcelona;6;139;U;;598;181;309;376;222;4;10;362;372
8;Barcelona;13;Barcelonès;08019;Barcelona;6;14;U;;711;236;374;439;272;0;7;432;439
8;Barcelona;13;Barcelonès;08019;Barcelona;6;140;U;;644;194;334;422;222;0;7;415;422
8;Barcelona;13;Barcelonès;08019;Barcelona;6;141;U;;538;165;291;358;180;2;9;347;356
8;Barcelona;13;Barcelonès;08019;Barcelona;6;142;U;;1114;313;506;625;489;2;6;617;623
8;Barcelona;13;Barcelonès;08019;Barcelona;6;144;U;;682;187;324;392;290;1;14;377;391
8;Barcelona;13;Barcelonès;08019;Barcelona;6;145;U;;977;279;447;553;424;1;11;541;552
8;Barcelona;13;Barcelonès;08019;Barcelona;6;146;U;;838;208;406;486;352;2;5;479;484
8;Barcelona;13;Barcelonès;08019;Barcelona;6;148;U;;552;147;243;299;253;2;11;286;297
8;Barcelona;13;Barcelonès;08019;Barcelona;6;149;U;;653;162;289;377;276;0;14;363;377
8;Barcelona;13;Barcelonès;08019;Barcelona;6;150;U;;1056;318;588;722;334;0;10;712;722
8;Barcelona;13;Barcelonès;08019;Barcelona;6;152;U;;549;181;312;373;176;2;11;360;371
8;Barcelona;13;Barcelonès;08019;Barcelona;6;153;U;;685;191;350;430;255;4;12;414;426
8;Barcelona;13;Barcelonès;08019;Barcelona;6;154;A;;1021;266;516;626;395;0;13;613;626
8;Barcelona;13;Barcelonès;08019;Barcelona;6;154;B;;871;236;475;575;296;1;12;562;574
8;Barcelona;13;Barcelonès;08019;Barcelona;6;157;A;;764;255;417;518;246;4;16;498;514
8;Barcelona;13;Barcelonès;08019;Barcelona;6;157;B;;669;227;366;455;214;4;9;442;451
8;Barcelona;13;Barcelonès;08019;Barcelona;6;158;U;;1168;290;610;793;375;2;11;780;791
8;Barcelona;13;Barcelonès;08019;Barcelona;6;16;U;;550;153;249;304;246;1;7;296;303
8;Barcelona;13;Barcelonès;08019;Barcelona;6;17;U;;513;140;245;300;213;0;9;291;300
8;Barcelona;13;Barcelonès;08019;Barcelona;6;18;U;;658;206;340;402;256;2;6;394;400
8;Barcelona;13;Barcelonès;08019;Barcelona;6;19;U;;610;180;329;392;218;0;6;386;392
8;Barcelona;13;Barcelonès;08019;Barcelona;6;20;U;;767;242;413;497;270;1;9;487;496
8;Barcelona;13;Barcelonès;08019;Barcelona;6;21;U;;591;193;326;399;192;2;8;389;397
8;Barcelona;13;Barcelonès;08019;Barcelona;6;22;U;;950;313;494;575;375;2;12;561;573
8;Barcelona;13;Barcelonès;08019;Barcelona;6;23;U;;861;284;509;610;251;3;16;591;607
8;Barcelona;13;Barcelonès;08019;Barcelona;6;26;U;;947;333;581;661;286;1;16;644;660
8;Barcelona;13;Barcelonès;08019;Barcelona;6;28;U;;557;154;301;351;206;0;4;347;351
8;Barcelona;13;Barcelonès;08019;Barcelona;6;29;U;;832;278;467;572;260;3;15;554;569
8;Barcelona;13;Barcelonès;08019;Barcelona;6;30;U;;601;182;305;374;227;1;7;366;373
8;Barcelona;13;Barcelonès;08019;Barcelona;6;31;U;;753;263;396;491;262;3;20;468;488
8;Barcelona;13;Barcelonès;08019;Barcelona;6;32;U;;738;222;365;469;269;1;18;450;468
8;Barcelona;13;Barcelonès;08019;Barcelona;6;33;U;;599;193;308;376;223;2;3;371;374
8;Barcelona;13;Barcelonès;08019;Barcelona;6;34;U;;886;321;555;644;242;2;20;622;642
8;Barcelona;13;Barcelonès;08019;Barcelona;6;35;U;;843;226;412;510;333;0;12;498;510
8;Barcelona;13;Barcelonès;08019;Barcelona;6;36;U;;483;173;295;362;121;0;5;357;362
8;Barcelona;13;Barcelonès;08019;Barcelona;6;37;U;;612;210;355;443;169;5;9;429;438
8;Barcelona;13;Barcelonès;08019;Barcelona;6;38;U;;794;244;424;535;259;1;13;521;534
8;Barcelona;13;Barcelonès;08019;Barcelona;6;39;U;;578;191;332;417;161;1;12;404;416
8;Barcelona;13;Barcelonès;08019;Barcelona;6;4;U;;930;298;535;638;292;5;21;612;633
8;Barcelona;13;Barcelonès;08019;Barcelona;6;40;U;;712;220;400;489;223;6;11;472;483
8;Barcelona;13;Barcelonès;08019;Barcelona;6;41;U;;1108;303;611;767;341;3;28;736;764
8;Barcelona;13;Barcelonès;08019;Barcelona;6;42;U;;813;246;431;529;284;4;8;517;525
8;Barcelona;13;Barcelonès;08019;Barcelona;6;43;U;;923;280;512;645;278;1;18;626;644
8;Barcelona;13;Barcelonès;08019;Barcelona;6;44;U;;877;257;472;560;317;5;17;538;555
8;Barcelona;13;Barcelonès;08019;Barcelona;6;45;U;;614;188;301;382;232;0;13;369;382
8;Barcelona;13;Barcelonès;08019;Barcelona;6;47;U;;474;135;269;300;174;1;3;296;299
8;Barcelona;13;Barcelonès;08019;Barcelona;6;48;U;;535;156;272;344;191;1;10;333;343
8;Barcelona;13;Barcelonès;08019;Barcelona;6;49;U;;521;158;245;313;208;0;5;308;313
8;Barcelona;13;Barcelonès;08019;Barcelona;6;50;U;;829;276;450;560;269;2;10;548;558
8;Barcelona;13;Barcelonès;08019;Barcelona;6;52;U;;864;245;453;549;315;3;16;530;546
8;Barcelona;13;Barcelonès;08019;Barcelona;6;54;U;;504;161;298;355;149;2;6;347;353
8;Barcelona;13;Barcelonès;08019;Barcelona;6;55;U;;797;266;506;579;218;2;11;566;577
8;Barcelona;13;Barcelonès;08019;Barcelona;6;56;U;;669;246;386;461;208;3;9;449;458
8;Barcelona;13;Barcelonès;08019;Barcelona;6;57;U;;996;315;555;680;316;2;14;664;678
8;Barcelona;13;Barcelonès;08019;Barcelona;6;58;U;;423;157;268;322;101;2;8;312;320
8;Barcelona;13;Barcelonès;08019;Barcelona;6;59;U;;929;310;501;642;287;3;14;625;639
8;Barcelona;13;Barcelonès;08019;Barcelona;6;6;U;;861;254;445;534;327;1;16;517;533
8;Barcelona;13;Barcelonès;08019;Barcelona;6;60;U;;525;175;278;350;175;0;7;343;350
8;Barcelona;13;Barcelonès;08019;Barcelona;6;61;U;;528;154;276;348;180;2;5;341;346
8;Barcelona;13;Barcelonès;08019;Barcelona;6;63;U;;404;109;192;247;157;0;6;241;247
8;Barcelona;13;Barcelonès;08019;Barcelona;6;64;U;;630;173;305;357;273;0;7;350;357
8;Barcelona;13;Barcelonès;08019;Barcelona;6;66;U;;1056;300;535;651;405;1;14;636;650
8;Barcelona;13;Barcelonès;08019;Barcelona;6;68;U;;630;191;328;382;248;2;10;370;380
8;Barcelona;13;Barcelonès;08019;Barcelona;6;69;U;;883;260;460;569;314;2;10;557;567
8;Barcelona;13;Barcelonès;08019;Barcelona;6;72;U;;910;318;501;606;304;2;12;592;604
8;Barcelona;13;Barcelonès;08019;Barcelona;6;74;U;;853;252;429;533;320;1;7;525;532
8;Barcelona;13;Barcelonès;08019;Barcelona;6;76;U;;523;169;281;346;177;2;3;341;344
8;Barcelona;13;Barcelonès;08019;Barcelona;6;77;U;;498;148;246;302;196;1;3;298;301
8;Barcelona;13;Barcelonès;08019;Barcelona;6;78;U;;721;221;387;478;243;2;4;472;476
8;Barcelona;13;Barcelonès;08019;Barcelona;6;8;U;;847;246;399;496;351;2;12;482;494
8;Barcelona;13;Barcelonès;08019;Barcelona;6;80;U;;887;286;557;555;332;6;13;536;549
8;Barcelona;13;Barcelonès;08019;Barcelona;6;82;U;;787;246;425;526;261;1;15;510;525
8;Barcelona;13;Barcelonès;08019;Barcelona;6;84;U;;549;170;280;338;211;1;3;334;337
8;Barcelona;13;Barcelonès;08019;Barcelona;6;85;U;;583;167;298;376;207;1;9;366;375
8;Barcelona;13;Barcelonès;08019;Barcelona;6;86;U;;833;249;435;524;309;2;11;511;522
8;Barcelona;13;Barcelonès;08019;Barcelona;6;88;U;;935;303;515;622;313;0;19;603;622
8;Barcelona;13;Barcelonès;08019;Barcelona;6;89;U;;738;238;431;532;206;2;7;523;530
8;Barcelona;13;Barcelonès;08019;Barcelona;6;91;U;;392;138;218;259;133;1;5;253;258
8;Barcelona;13;Barcelonès;08019;Barcelona;6;92;U;;500;167;260;316;184;1;9;306;315
8;Barcelona;13;Barcelonès;08019;Barcelona;6;93;U;;555;133;236;289;266;1;4;284;288
8;Barcelona;13;Barcelonès;08019;Barcelona;6;94;U;;579;154;278;334;245;4;3;327;330
8;Barcelona;13;Barcelonès;08019;Barcelona;6;95;U;;534;172;298;360;174;1;7;352;359
8;Barcelona;13;Barcelonès;08019;Barcelona;6;96;U;;478;143;262;324;154;2;10;312;322
8;Barcelona;13;Barcelonès;08019;Barcelona;6;97;U;;839;263;414;533;306;2;13;518;531
8;Barcelona;13;Barcelonès;08019;Barcelona;6;98;U;;726;251;425;497;229;0;9;488;497
8;Barcelona;13;Barcelonès;08019;Barcelona;7;1;A;;836;259;422;530;306;0;10;520;530
8;Barcelona;13;Barcelonès;08019;Barcelona;7;1;B;;677;231;365;435;242;1;9;425;434
8;Barcelona;13;Barcelonès;08019;Barcelona;7;10;U;;833;245;428;548;285;5;18;525;543
8;Barcelona;13;Barcelonès;08019;Barcelona;7;100;U;;762;200;342;437;325;1;15;421;436
8;Barcelona;13;Barcelonès;08019;Barcelona;7;101;U;;564;172;320;393;171;0;15;378;393
8;Barcelona;13;Barcelonès;08019;Barcelona;7;102;U;;454;134;236;283;171;1;8;274;282
8;Barcelona;13;Barcelonès;08019;Barcelona;7;103;U;;611;165;297;364;247;0;5;359;364
8;Barcelona;13;Barcelonès;08019;Barcelona;7;104;U;;961;273;500;618;343;2;22;594;616
8;Barcelona;13;Barcelonès;08019;Barcelona;7;105;U;;554;168;291;348;206;1;6;341;347
8;Barcelona;13;Barcelonès;08019;Barcelona;7;106;U;;623;185;338;430;193;1;9;420;429
8;Barcelona;13;Barcelonès;08019;Barcelona;7;107;U;;507;141;280;371;136;2;5;364;369
8;Barcelona;13;Barcelonès;08019;Barcelona;7;108;U;;591;167;315;389;202;1;12;376;388
8;Barcelona;13;Barcelonès;08019;Barcelona;7;109;U;;679;193;327;410;269;2;11;397;408
8;Barcelona;13;Barcelonès;08019;Barcelona;7;11;U;;690;215;386;460;230;2;6;452;458
8;Barcelona;13;Barcelonès;08019;Barcelona;7;110;U;;1063;281;444;530;533;1;4;525;529
8;Barcelona;13;Barcelonès;08019;Barcelona;7;112;U;;463;134;206;236;227;5;6;225;231
8;Barcelona;13;Barcelonès;08019;Barcelona;7;113;U;;562;125;209;263;299;2;8;253;261
8;Barcelona;13;Barcelonès;08019;Barcelona;7;114;U;;611;150;238;289;322;7;7;275;282
8;Barcelona;13;Barcelonès;08019;Barcelona;7;116;U;;715;145;236;311;404;0;7;304;311
8;Barcelona;13;Barcelonès;08019;Barcelona;7;117;U;;744;177;291;375;369;3;12;360;372
8;Barcelona;13;Barcelonès;08019;Barcelona;7;118;U;;810;152;245;302;508;1;9;292;301
8;Barcelona;13;Barcelonès;08019;Barcelona;7;119;U;;797;140;260;342;455;4;5;333;338
8;Barcelona;13;Barcelonès;08019;Barcelona;7;12;U;;558;170;284;360;198;3;1;356;357
8;Barcelona;13;Barcelonès;08019;Barcelona;7;120;U;;647;154;251;321;326;2;9;310;319
8;Barcelona;13;Barcelonès;08019;Barcelona;7;121;U;;493;96;168;206;287;0;1;205;206
8;Barcelona;13;Barcelonès;08019;Barcelona;7;122;U;;816;148;270;335;481;0;9;326;335
8;Barcelona;13;Barcelonès;08019;Barcelona;7;123;A;;690;153;298;345;345;5;5;335;340
8;Barcelona;13;Barcelonès;08019;Barcelona;7;123;B;;665;172;291;364;301;6;11;347;358
8;Barcelona;13;Barcelonès;08019;Barcelona;7;124;U;;683;155;302;362;321;3;9;350;359
8;Barcelona;13;Barcelonès;08019;Barcelona;7;125;U;;1053;228;417;519;534;1;11;507;518
8;Barcelona;13;Barcelonès;08019;Barcelona;7;127;U;;592;141;230;288;304;3;6;279;285
8;Barcelona;13;Barcelonès;08019;Barcelona;7;128;U;;692;140;255;319;373;1;6;312;318
8;Barcelona;13;Barcelonès;08019;Barcelona;7;129;U;;586;132;242;282;304;0;13;269;282
8;Barcelona;13;Barcelonès;08019;Barcelona;7;13;U;;878;271;472;580;298;2;19;559;578
8;Barcelona;13;Barcelonès;08019;Barcelona;7;130;U;;430;75;124;141;289;0;5;136;141
8;Barcelona;13;Barcelonès;08019;Barcelona;7;131;U;;681;131;222;281;400;1;3;277;280
8;Barcelona;13;Barcelonès;08019;Barcelona;7;132;U;;504;98;179;227;277;2;3;222;225
8;Barcelona;13;Barcelonès;08019;Barcelona;7;133;U;;773;184;314;390;383;0;7;383;390
8;Barcelona;13;Barcelonès;08019;Barcelona;7;134;U;;1115;242;447;541;574;0;15;526;541
8;Barcelona;13;Barcelonès;08019;Barcelona;7;136;U;;422;99;160;212;210;1;2;209;211
8;Barcelona;13;Barcelonès;08019;Barcelona;7;137;U;;765;183;312;389;376;0;10;379;389
8;Barcelona;13;Barcelonès;08019;Barcelona;7;138;U;;564;148;245;301;263;0;8;293;301
8;Barcelona;13;Barcelonès;08019;Barcelona;7;139;U;;850;242;374;468;382;1;7;460;467
8;Barcelona;13;Barcelonès;08019;Barcelona;7;14;U;;881;235;420;513;368;0;7;506;513
8;Barcelona;13;Barcelonès;08019;Barcelona;7;140;U;;456;114;191;242;214;3;3;236;239
8;Barcelona;13;Barcelonès;08019;Barcelona;7;141;U;;599;168;280;328;271;0;4;324;328
8;Barcelona;13;Barcelonès;08019;Barcelona;7;142;U;;957;220;382;471;486;1;7;463;470
8;Barcelona;13;Barcelonès;08019;Barcelona;7;144;U;;1062;285;459;562;500;3;8;551;559
8;Barcelona;13;Barcelonès;08019;Barcelona;7;147;U;;1124;324;573;687;437;3;8;676;684
8;Barcelona;13;Barcelonès;08019;Barcelona;7;148;U;;881;223;390;475;406;9;11;455;466
8;Barcelona;13;Barcelonès;08019;Barcelona;7;15;U;;484;157;250;306;178;0;5;301;306
8;Barcelona;13;Barcelonès;08019;Barcelona;7;150;U;;833;213;368;456;377;2;5;449;454
8;Barcelona;13;Barcelonès;08019;Barcelona;7;151;U;;535;129;208;265;270;2;3;260;263
8;Barcelona;13;Barcelonès;08019;Barcelona;7;152;U;;498;160;255;301;197;3;10;288;298
8;Barcelona;13;Barcelonès;08019;Barcelona;7;155;U;;882;282;453;552;330;10;18;524;542
8;Barcelona;13;Barcelonès;08019;Barcelona;7;157;U;;685;212;331;449;236;4;3;442;445
8;Barcelona;13;Barcelonès;08019;Barcelona;7;158;U;;763;241;419;514;249;1;14;499;513
8;Barcelona;13;Barcelonès;08019;Barcelona;7;159;U;;743;171;331;423;320;1;6;416;422
8;Barcelona;13;Barcelonès;08019;Barcelona;7;16;U;;868;242;415;494;374;1;8;485;493
8;Barcelona;13;Barcelonès;08019;Barcelona;7;160;U;;475;172;256;304;171;1;3;300;303
8;Barcelona;13;Barcelonès;08019;Barcelona;7;161;U;;406;133;231;278;128;1;3;274;277
8;Barcelona;13;Barcelonès;08019;Barcelona;7;162;U;;709;186;307;389;320;0;9;380;389
8;Barcelona;13;Barcelonès;08019;Barcelona;7;163;U;;999;286;470;590;409;5;15;570;585
8;Barcelona;13;Barcelonès;08019;Barcelona;7;165;U;;569;134;245;327;242;0;7;320;327
8;Barcelona;13;Barcelonès;08019;Barcelona;7;166;U;;1185;337;632;801;384;6;18;777;795
8;Barcelona;13;Barcelonès;08019;Barcelona;7;167;U;;823;237;454;545;278;3;16;526;542
8;Barcelona;13;Barcelonès;08019;Barcelona;7;169;U;;667;168;313;396;271;1;7;388;395
8;Barcelona;13;Barcelonès;08019;Barcelona;7;170;U;;1059;282;485;595;464;1;18;576;594
8;Barcelona;13;Barcelonès;08019;Barcelona;7;172;U;;568;152;280;359;209;3;12;344;356
8;Barcelona;13;Barcelonès;08019;Barcelona;7;173;U;;925;261;447;529;396;3;9;517;526
8;Barcelona;13;Barcelonès;08019;Barcelona;7;174;U;;689;217;355;439;250;0;13;426;439
8;Barcelona;13;Barcelonès;08019;Barcelona;7;176;U;;511;163;288;345;166;0;8;337;345
8;Barcelona;13;Barcelonès;08019;Barcelona;7;177;U;;962;305;466;560;402;2;5;553;558
8;Barcelona;13;Barcelonès;08019;Barcelona;7;179;U;;606;184;300;378;228;0;7;371;378
8;Barcelona;13;Barcelonès;08019;Barcelona;7;18;U;;508;146;273;335;173;0;9;326;335
8;Barcelona;13;Barcelonès;08019;Barcelona;7;180;U;;467;136;218;263;204;2;12;249;261
8;Barcelona;13;Barcelonès;08019;Barcelona;7;181;U;;844;189;331;439;405;0;9;430;439
8;Barcelona;13;Barcelonès;08019;Barcelona;7;183;U;;599;136;263;320;279;0;9;311;320
8;Barcelona;13;Barcelonès;08019;Barcelona;7;184;U;;844;230;420;490;354;3;11;476;487
8;Barcelona;13;Barcelonès;08019;Barcelona;7;185;U;;710;240;385;468;242;0;14;454;468
8;Barcelona;13;Barcelonès;08019;Barcelona;7;187;U;;397;79;131;167;230;0;0;167;167
8;Barcelona;13;Barcelonès;08019;Barcelona;7;188;U;;860;173;335;418;442;1;20;397;417
8;Barcelona;13;Barcelonès;08019;Barcelona;7;189;U;;692;167;298;345;347;1;16;328;344
8;Barcelona;13;Barcelonès;08019;Barcelona;7;19;U;;814;222;407;523;291;0;12;511;523
8;Barcelona;13;Barcelonès;08019;Barcelona;7;190;U;;822;267;404;479;343;4;11;464;475
8;Barcelona;13;Barcelonès;08019;Barcelona;7;191;U;;673;214;321;380;293;8;7;365;372
8;Barcelona;13;Barcelonès;08019;Barcelona;7;192;U;;663;228;343;382;281;1;5;376;381
8;Barcelona;13;Barcelonès;08019;Barcelona;7;193;U;;535;109;229;292;243;1;3;288;291
8;Barcelona;13;Barcelonès;08019;Barcelona;7;194;U;;474;178;289;361;113;1;5;355;360
8;Barcelona;13;Barcelonès;08019;Barcelona;7;195;U;;837;210;394;464;373;4;14;446;460
8;Barcelona;13;Barcelonès;08019;Barcelona;7;196;U;;859;240;407;502;357;4;18;480;498
8;Barcelona;13;Barcelonès;08019;Barcelona;7;197;U;;637;225;357;407;230;2;7;398;405
8;Barcelona;13;Barcelonès;08019;Barcelona;7;198;U;;612;223;331;394;218;0;11;383;394
8;Barcelona;13;Barcelonès;08019;Barcelona;7;2;U;;596;174;313;392;204;0;11;381;392
8;Barcelona;13;Barcelonès;08019;Barcelona;7;20;U;;511;124;219;282;229;1;6;275;281
8;Barcelona;13;Barcelonès;08019;Barcelona;7;200;U;;781;214;334;399;382;2;7;390;397
8;Barcelona;13;Barcelonès;08019;Barcelona;7;201;U;;593;170;297;355;238;3;7;345;352
8;Barcelona;13;Barcelonès;08019;Barcelona;7;202;U;;556;202;272;336;220;0;7;329;336
8;Barcelona;13;Barcelonès;08019;Barcelona;7;204;A;;952;272;507;623;329;1;17;605;622
8;Barcelona;13;Barcelonès;08019;Barcelona;7;204;B;;813;234;412;531;282;2;6;523;529
8;Barcelona;13;Barcelonès;08019;Barcelona;7;205;A;;729;182;363;464;265;1;7;456;463
8;Barcelona;13;Barcelonès;08019;Barcelona;7;205;B;;615;166;293;380;235;0;9;371;380
8;Barcelona;13;Barcelonès;08019;Barcelona;7;207;A;;644;174;311;382;262;0;9;373;382
8;Barcelona;13;Barcelonès;08019;Barcelona;7;207;B;;581;156;284;359;222;1;10;348;358
8;Barcelona;13;Barcelonès;08019;Barcelona;7;209;U;;937;221;361;459;478;2;12;445;457
8;Barcelona;13;Barcelonès;08019;Barcelona;7;210;U;;1211;344;548;657;554;1;16;640;656
8;Barcelona;13;Barcelonès;08019;Barcelona;7;211;A;;658;149;255;310;348;1;12;297;309
8;Barcelona;13;Barcelonès;08019;Barcelona;7;211;B;;608;148;244;299;309;1;5;293;298
8;Barcelona;13;Barcelonès;08019;Barcelona;7;213;U;;745;150;256;344;401;1;10;333;343
8;Barcelona;13;Barcelonès;08019;Barcelona;7;214;U;;571;127;207;256;315;4;6;246;252
8;Barcelona;13;Barcelonès;08019;Barcelona;7;215;U;;896;207;328;406;490;4;10;392;402
8;Barcelona;13;Barcelonès;08019;Barcelona;7;217;U;;421;82;162;211;210;1;7;203;210
8;Barcelona;13;Barcelonès;08019;Barcelona;7;218;U;;659;176;296;347;312;0;12;335;347
8;Barcelona;13;Barcelonès;08019;Barcelona;7;219;U;;595;142;228;281;314;3;6;272;278
8;Barcelona;13;Barcelonès;08019;Barcelona;7;220;U;;730;173;288;351;379;1;5;345;350
8;Barcelona;13;Barcelonès;08019;Barcelona;7;221;U;;657;195;311;361;296;2;12;347;359
8;Barcelona;13;Barcelonès;08019;Barcelona;7;23;U;;615;208;325;400;215;1;4;395;399
8;Barcelona;13;Barcelonès;08019;Barcelona;7;24;U;;625;222;313;378;247;0;5;373;378
8;Barcelona;13;Barcelonès;08019;Barcelona;7;26;U;;561;167;291;339;222;2;5;332;337
8;Barcelona;13;Barcelonès;08019;Barcelona;7;27;U;;494;137;265;320;174;0;8;312;320
8;Barcelona;13;Barcelonès;08019;Barcelona;7;28;U;;426;120;234;274;152;1;4;269;273
8;Barcelona;13;Barcelonès;08019;Barcelona;7;29;U;;666;226;348;421;245;0;5;416;421
8;Barcelona;13;Barcelonès;08019;Barcelona;7;3;U;;559;158;293;343;216;1;5;337;342
8;Barcelona;13;Barcelonès;08019;Barcelona;7;31;U;;764;261;396;479;285;3;14;462;476
8;Barcelona;13;Barcelonès;08019;Barcelona;7;32;U;;463;162;268;309;154;2;7;300;307
8;Barcelona;13;Barcelonès;08019;Barcelona;7;33;U;;654;202;357;444;210;1;8;435;443
8;Barcelona;13;Barcelonès;08019;Barcelona;7;34;U;;822;208;372;451;371;6;12;433;445
8;Barcelona;13;Barcelonès;08019;Barcelona;7;36;U;;440;140;223;285;155;0;3;282;285
8;Barcelona;13;Barcelonès;08019;Barcelona;7;37;U;;475;142;257;313;162;2;6;305;311
8;Barcelona;13;Barcelonès;08019;Barcelona;7;38;U;;638;196;335;404;234;5;2;397;399
8;Barcelona;13;Barcelonès;08019;Barcelona;7;39;U;;548;152;280;359;189;0;10;349;359
8;Barcelona;13;Barcelonès;08019;Barcelona;7;4;U;;820;236;431;522;298;3;6;513;519
8;Barcelona;13;Barcelonès;08019;Barcelona;7;40;U;;613;182;355;436;177;1;7;428;435
8;Barcelona;13;Barcelonès;08019;Barcelona;7;41;U;;425;149;212;255;170;0;5;250;255
8;Barcelona;13;Barcelonès;08019;Barcelona;7;42;U;;451;156;235;311;140;4;5;302;307
8;Barcelona;13;Barcelonès;08019;Barcelona;7;43;U;;761;240;400;485;276;0;11;474;485
8;Barcelona;13;Barcelonès;08019;Barcelona;7;44;U;;632;183;339;428;204;3;10;415;425
8;Barcelona;13;Barcelonès;08019;Barcelona;7;45;U;;815;153;443;544;271;2;10;532;542
8;Barcelona;13;Barcelonès;08019;Barcelona;7;47;U;;645;196;310;369;276;0;6;363;369
8;Barcelona;13;Barcelonès;08019;Barcelona;7;48;U;;982;279;520;649;333;1;11;637;648
8;Barcelona;13;Barcelonès;08019;Barcelona;7;50;U;;568;177;301;377;191;0;6;371;377
8;Barcelona;13;Barcelonès;08019;Barcelona;7;51;U;;781;236;397;479;302;1;5;473;478
8;Barcelona;13;Barcelonès;08019;Barcelona;7;52;U;;474;161;247;289;185;0;7;282;289
8;Barcelona;13;Barcelonès;08019;Barcelona;7;53;U;;528;150;281;360;168;1;7;352;359
8;Barcelona;13;Barcelonès;08019;Barcelona;7;54;U;;523;181;295;352;171;4;16;332;348
8;Barcelona;13;Barcelonès;08019;Barcelona;7;55;U;;803;215;404;494;309;0;11;483;494
8;Barcelona;13;Barcelonès;08019;Barcelona;7;56;U;;949;252;412;528;421;2;9;517;526
8;Barcelona;13;Barcelonès;08019;Barcelona;7;57;U;;880;287;463;553;327;2;11;540;551
8;Barcelona;13;Barcelonès;08019;Barcelona;7;58;U;;664;191;328;404;260;1;6;397;403
8;Barcelona;13;Barcelonès;08019;Barcelona;7;60;U;;718;199;328;388;330;0;11;377;388
8;Barcelona;13;Barcelonès;08019;Barcelona;7;62;U;;758;180;340;437;321;1;16;420;436
8;Barcelona;13;Barcelonès;08019;Barcelona;7;64;U;;488;171;281;330;158;0;7;323;330
8;Barcelona;13;Barcelonès;08019;Barcelona;7;65;U;;826;198;346;423;403;1;6;416;422
8;Barcelona;13;Barcelonès;08019;Barcelona;7;66;U;;424;119;178;210;214;0;3;207;210
8;Barcelona;13;Barcelonès;08019;Barcelona;7;67;U;;1072;309;528;654;418;5;15;634;649
8;Barcelona;13;Barcelonès;08019;Barcelona;7;68;U;;545;146;300;346;199;0;7;339;346
8;Barcelona;13;Barcelonès;08019;Barcelona;7;7;U;;615;227;354;435;180;1;2;432;434
8;Barcelona;13;Barcelonès;08019;Barcelona;7;70;U;;570;142;260;316;254;0;5;311;316
8;Barcelona;13;Barcelonès;08019;Barcelona;7;71;U;;478;107;194;267;211;0;8;259;267
8;Barcelona;13;Barcelonès;08019;Barcelona;7;72;A;;736;198;355;434;302;1;7;426;433
8;Barcelona;13;Barcelonès;08019;Barcelona;7;72;B;;672;201;334;424;248;0;13;411;424
8;Barcelona;13;Barcelonès;08019;Barcelona;7;73;U;;760;225;561;498;262;1;3;494;497
8;Barcelona;13;Barcelonès;08019;Barcelona;7;74;U;;602;198;308;373;229;2;3;368;371
8;Barcelona;13;Barcelonès;08019;Barcelona;7;75;U;;710;196;322;383;327;2;10;371;381
8;Barcelona;13;Barcelonès;08019;Barcelona;7;76;U;;801;215;407;506;295;4;9;493;502
8;Barcelona;13;Barcelonès;08019;Barcelona;7;78;U;;1198;390;630;779;419;1;9;769;778
8;Barcelona;13;Barcelonès;08019;Barcelona;7;79;U;;1004;302;484;590;414;6;12;572;584
8;Barcelona;13;Barcelonès;08019;Barcelona;7;8;U;;1312;383;686;836;476;2;25;809;834
8;Barcelona;13;Barcelonès;08019;Barcelona;7;80;U;;587;181;304;372;215;7;8;357;365
8;Barcelona;13;Barcelonès;08019;Barcelona;7;81;U;;817;268;440;566;251;4;13;549;562
8;Barcelona;13;Barcelonès;08019;Barcelona;7;83;U;;552;146;243;306;246;0;5;301;306
8;Barcelona;13;Barcelonès;08019;Barcelona;7;84;U;;833;245;386;477;356;1;9;467;476
8;Barcelona;13;Barcelonès;08019;Barcelona;7;85;U;;785;243;398;502;283;1;14;487;501
8;Barcelona;13;Barcelonès;08019;Barcelona;7;86;U;;750;219;405;493;257;0;13;480;493
8;Barcelona;13;Barcelonès;08019;Barcelona;7;88;U;;918;271;475;576;342;4;10;562;572
8;Barcelona;13;Barcelonès;08019;Barcelona;7;89;U;;852;187;362;421;431;0;5;416;421
8;Barcelona;13;Barcelonès;08019;Barcelona;7;9;U;;842;259;423;506;336;2;13;491;504
8;Barcelona;13;Barcelonès;08019;Barcelona;7;91;U;;708;204;329;382;326;4;19;359;378
8;Barcelona;13;Barcelonès;08019;Barcelona;7;92;U;;627;164;262;316;311;1;6;309;315
8;Barcelona;13;Barcelonès;08019;Barcelona;7;93;A;;211;45;95;123;88;0;0;123;123
8;Barcelona;13;Barcelonès;08019;Barcelona;7;93;B;;751;260;407;492;259;0;13;479;492
8;Barcelona;13;Barcelonès;08019;Barcelona;7;93;C;;957;233;347;417;540;0;5;412;417
8;Barcelona;13;Barcelonès;08019;Barcelona;7;94;U;;667;168;255;316;351;2;10;304;314
8;Barcelona;13;Barcelonès;08019;Barcelona;7;95;U;;1050;248;358;418;632;1;6;411;417
8;Barcelona;13;Barcelonès;08019;Barcelona;7;97;U;;690;146;250;305;385;3;4;298;302
8;Barcelona;13;Barcelonès;08019;Barcelona;7;98;U;;877;222;400;526;351;1;11;514;525
8;Barcelona;13;Barcelonès;08019;Barcelona;8;1;U;;1008;320;520;622;386;4;14;604;618
8;Barcelona;13;Barcelonès;08019;Barcelona;8;10;U;;841;240;371;490;351;2;7;481;488
8;Barcelona;13;Barcelonès;08019;Barcelona;8;100;U;;663;163;265;339;324;1;11;327;338
8;Barcelona;13;Barcelonès;08019;Barcelona;8;101;U;;728;218;342;408;320;1;9;398;407
8;Barcelona;13;Barcelonès;08019;Barcelona;8;102;U;;485;115;184;238;247;0;4;234;238
8;Barcelona;13;Barcelonès;08019;Barcelona;8;103;U;;736;211;338;385;351;2;5;378;383
8;Barcelona;13;Barcelonès;08019;Barcelona;8;104;U;;608;152;227;273;335;1;4;268;272
8;Barcelona;13;Barcelonès;08019;Barcelona;8;107;U;;761;211;318;394;367;4;10;380;390
8;Barcelona;13;Barcelonès;08019;Barcelona;8;108;U;;676;162;258;324;352;1;6;317;323
8;Barcelona;13;Barcelonès;08019;Barcelona;8;109;U;;542;160;237;298;244;7;7;284;291
8;Barcelona;13;Barcelonès;08019;Barcelona;8;11;U;;696;203;332;419;277;0;11;408;419
8;Barcelona;13;Barcelonès;08019;Barcelona;8;111;U;;496;129;189;234;262;1;5;228;233
8;Barcelona;13;Barcelonès;08019;Barcelona;8;112;U;;513;120;188;263;250;4;2;257;259
8;Barcelona;13;Barcelonès;08019;Barcelona;8;113;U;;667;150;266;337;330;0;7;330;337
8;Barcelona;13;Barcelonès;08019;Barcelona;8;114;U;;699;197;310;379;320;2;8;369;377
8;Barcelona;13;Barcelonès;08019;Barcelona;8;115;U;;772;180;300;403;369;0;13;390;403
8;Barcelona;13;Barcelonès;08019;Barcelona;8;116;U;;938;248;417;513;425;2;6;505;511
8;Barcelona;13;Barcelonès;08019;Barcelona;8;117;U;;509;127;224;269;240;1;8;260;268
8;Barcelona;13;Barcelonès;08019;Barcelona;8;119;U;;750;195;321;387;363;1;5;381;386
8;Barcelona;13;Barcelonès;08019;Barcelona;8;12;U;;523;131;258;317;206;0;4;313;317
8;Barcelona;13;Barcelonès;08019;Barcelona;8;121;U;;520;130;220;274;246;1;8;265;273
8;Barcelona;13;Barcelonès;08019;Barcelona;8;122;U;;782;244;370;452;330;5;3;444;447
8;Barcelona;13;Barcelonès;08019;Barcelona;8;123;U;;480;105;175;225;255;2;3;220;223
8;Barcelona;13;Barcelonès;08019;Barcelona;8;124;U;;791;136;216;262;529;1;5;256;261
8;Barcelona;13;Barcelonès;08019;Barcelona;8;126;U;;963;223;341;415;548;1;6;408;414
8;Barcelona;13;Barcelonès;08019;Barcelona;8;127;U;;690;179;291;348;342;0;8;340;348
8;Barcelona;13;Barcelonès;08019;Barcelona;8;129;U;;813;223;329;381;432;2;7;372;379
8;Barcelona;13;Barcelonès;08019;Barcelona;8;13;U;;745;220;358;441;304;0;7;434;441
8;Barcelona;13;Barcelonès;08019;Barcelona;8;131;U;;885;245;387;455;430;3;7;445;452
8;Barcelona;13;Barcelonès;08019;Barcelona;8;133;U;;545;124;218;287;258;3;5;279;284
8;Barcelona;13;Barcelonès;08019;Barcelona;8;134;U;;440;134;222;244;196;0;5;239;244
8;Barcelona;13;Barcelonès;08019;Barcelona;8;135;U;;952;257;464;568;384;0;5;563;568
8;Barcelona;13;Barcelonès;08019;Barcelona;8;136;U;;527;124;216;264;263;0;4;260;264
8;Barcelona;13;Barcelonès;08019;Barcelona;8;138;U;;640;175;306;371;269;1;8;362;370
8;Barcelona;13;Barcelonès;08019;Barcelona;8;14;U;;726;243;362;455;271;4;10;441;451
8;Barcelona;13;Barcelonès;08019;Barcelona;8;140;U;;1070;220;419;551;519;2;13;536;549
8;Barcelona;13;Barcelonès;08019;Barcelona;8;141;U;;733;223;333;411;322;1;5;405;410
8;Barcelona;13;Barcelonès;08019;Barcelona;8;142;A;;718;187;309;392;326;0;7;385;392
8;Barcelona;13;Barcelonès;08019;Barcelona;8;142;B;;598;143;245;314;284;0;8;306;314
8;Barcelona;13;Barcelonès;08019;Barcelona;8;143;U;;953;268;445;557;396;2;9;546;555
8;Barcelona;13;Barcelonès;08019;Barcelona;8;144;U;;1113;255;448;556;557;1;8;547;555
8;Barcelona;13;Barcelonès;08019;Barcelona;8;145;U;;601;155;268;301;300;3;4;294;298
8;Barcelona;13;Barcelonès;08019;Barcelona;8;146;U;;806;198;319;383;423;1;4;378;382
8;Barcelona;13;Barcelonès;08019;Barcelona;8;147;U;;547;138;220;276;271;1;1;274;275
8;Barcelona;13;Barcelonès;08019;Barcelona;8;149;U;;608;168;281;336;272;0;5;331;336
8;Barcelona;13;Barcelonès;08019;Barcelona;8;15;U;;787;227;389;490;297;0;11;479;490
8;Barcelona;13;Barcelonès;08019;Barcelona;8;150;U;;653;166;264;335;318;0;6;329;335
8;Barcelona;13;Barcelonès;08019;Barcelona;8;151;U;;561;111;207;260;301;0;6;254;260
8;Barcelona;13;Barcelonès;08019;Barcelona;8;152;U;;850;225;341;411;439;3;5;403;408
8;Barcelona;13;Barcelonès;08019;Barcelona;8;153;U;;475;100;176;214;261;0;8;206;214
8;Barcelona;13;Barcelonès;08019;Barcelona;8;154;U;;502;117;207;267;235;2;7;258;265
8;Barcelona;13;Barcelonès;08019;Barcelona;8;155;U;;705;200;296;371;334;8;12;351;363
8;Barcelona;13;Barcelonès;08019;Barcelona;8;156;U;;878;229;303;363;515;0;5;358;363
8;Barcelona;13;Barcelonès;08019;Barcelona;8;158;U;;868;224;323;358;510;0;3;355;358
8;Barcelona;13;Barcelonès;08019;Barcelona;8;160;U;;679;150;266;317;362;2;1;314;315
8;Barcelona;13;Barcelonès;08019;Barcelona;8;161;U;;622;152;216;256;366;0;2;254;256
8;Barcelona;13;Barcelonès;08019;Barcelona;8;162;U;;432;80;125;145;287;0;1;144;145
8;Barcelona;13;Barcelonès;08019;Barcelona;8;163;U;;1216;224;352;393;823;1;8;384;392
8;Barcelona;13;Barcelonès;08019;Barcelona;8;164;U;;460;132;186;204;256;2;2;200;202
8;Barcelona;13;Barcelonès;08019;Barcelona;8;166;U;;624;150;218;262;362;2;1;259;260
8;Barcelona;13;Barcelonès;08019;Barcelona;8;167;U;;658;96;200;268;390;1;1;266;267
8;Barcelona;13;Barcelonès;08019;Barcelona;8;168;U;;804;177;295;403;401;1;10;392;402
8;Barcelona;13;Barcelonès;08019;Barcelona;8;17;U;;578;142;271;343;235;1;10;332;342
8;Barcelona;13;Barcelonès;08019;Barcelona;8;170;U;;484;89;170;219;265;2;3;214;217
8;Barcelona;13;Barcelonès;08019;Barcelona;8;171;U;;786;158;249;317;469;3;8;306;314
8;Barcelona;13;Barcelonès;08019;Barcelona;8;172;U;;561;143;210;244;317;0;12;232;244
8;Barcelona;13;Barcelonès;08019;Barcelona;8;173;U;;724;159;303;368;356;2;0;366;366
8;Barcelona;13;Barcelonès;08019;Barcelona;8;174;U;;749;192;288;343;406;0;6;337;343
8;Barcelona;13;Barcelonès;08019;Barcelona;8;176;U;;563;123;213;250;313;0;3;247;250
8;Barcelona;13;Barcelonès;08019;Barcelona;8;178;U;;654;149;265;329;325;5;4;320;324
8;Barcelona;13;Barcelonès;08019;Barcelona;8;18;U;;1177;359;605;739;438;0;20;719;739
8;Barcelona;13;Barcelonès;08019;Barcelona;8;180;U;;575;127;216;266;309;0;7;259;266
8;Barcelona;13;Barcelonès;08019;Barcelona;8;181;U;;535;115;186;231;304;2;3;226;229
8;Barcelona;13;Barcelonès;08019;Barcelona;8;182;U;;445;96;166;212;233;0;3;209;212
8;Barcelona;13;Barcelonès;08019;Barcelona;8;183;U;;643;148;224;281;362;0;4;277;281
8;Barcelona;13;Barcelonès;08019;Barcelona;8;184;U;;564;144;233;285;279;0;5;280;285
8;Barcelona;13;Barcelonès;08019;Barcelona;8;185;U;;668;112;200;243;425;0;1;242;243
8;Barcelona;13;Barcelonès;08019;Barcelona;8;186;U;;746;104;188;240;506;1;7;232;239
8;Barcelona;13;Barcelonès;08019;Barcelona;8;187;U;;446;97;133;154;292;3;2;149;151
8;Barcelona;13;Barcelonès;08019;Barcelona;8;188;U;;494;106;169;217;277;0;10;207;217
8;Barcelona;13;Barcelonès;08019;Barcelona;8;189;U;;926;227;380;448;478;0;10;438;448
8;Barcelona;13;Barcelonès;08019;Barcelona;8;19;U;;945;303;519;626;319;1;14;611;625
8;Barcelona;13;Barcelonès;08019;Barcelona;8;190;U;;1080;217;437;575;505;0;13;562;575
8;Barcelona;13;Barcelonès;08019;Barcelona;8;191;U;;1160;243;452;578;582;6;12;560;572
8;Barcelona;13;Barcelonès;08019;Barcelona;8;192;U;;523;109;182;239;284;0;4;235;239
8;Barcelona;13;Barcelonès;08019;Barcelona;8;193;A;;745;189;298;371;374;2;10;359;369
8;Barcelona;13;Barcelonès;08019;Barcelona;8;193;B;;688;152;252;306;382;3;7;296;303
8;Barcelona;13;Barcelonès;08019;Barcelona;8;194;A;;405;66;98;115;290;0;1;114;115
8;Barcelona;13;Barcelonès;08019;Barcelona;8;194;B;;697;158;264;314;383;3;7;304;311
8;Barcelona;13;Barcelonès;08019;Barcelona;8;195;U;;638;92;167;201;437;2;8;191;199
8;Barcelona;13;Barcelonès;08019;Barcelona;8;196;U;;548;84;137;153;395;0;5;148;153
8;Barcelona;13;Barcelonès;08019;Barcelona;8;198;U;;696;117;189;220;476;2;1;217;218
8;Barcelona;13;Barcelonès;08019;Barcelona;8;2;U;;609;166;275;338;271;1;11;326;337
8;Barcelona;13;Barcelonès;08019;Barcelona;8;20;U;;868;250;425;527;341;5;11;511;522
8;Barcelona;13;Barcelonès;08019;Barcelona;8;200;U;;591;105;179;203;388;0;1;202;203
8;Barcelona;13;Barcelonès;08019;Barcelona;8;202;U;;763;180;279;313;450;1;4;308;312
8;Barcelona;13;Barcelonès;08019;Barcelona;8;203;U;;794;162;279;343;451;5;12;326;338
8;Barcelona;13;Barcelonès;08019;Barcelona;8;205;U;;760;152;257;304;456;1;12;291;303
8;Barcelona;13;Barcelonès;08019;Barcelona;8;207;U;;352;80;127;150;202;0;2;148;150
8;Barcelona;13;Barcelonès;08019;Barcelona;8;208;U;;649;165;263;320;329;1;10;309;319
8;Barcelona;13;Barcelonès;08019;Barcelona;8;209;U;;1007;239;395;473;534;3;8;462;470
8;Barcelona;13;Barcelonès;08019;Barcelona;8;21;U;;624;188;315;382;242;0;4;378;382
8;Barcelona;13;Barcelonès;08019;Barcelona;8;211;U;;939;187;314;378;561;6;13;359;372
8;Barcelona;13;Barcelonès;08019;Barcelona;8;213;A;;770;271;371;446;324;0;7;439;446
8;Barcelona;13;Barcelonès;08019;Barcelona;8;213;B;;663;228;322;380;283;3;5;372;377
8;Barcelona;13;Barcelonès;08019;Barcelona;8;214;U;;1132;276;477;613;519;1;15;597;612
8;Barcelona;13;Barcelonès;08019;Barcelona;8;22;U;;496;170;252;314;182;0;12;302;314
8;Barcelona;13;Barcelonès;08019;Barcelona;8;24;U;;659;213;336;407;252;3;7;397;404
8;Barcelona;13;Barcelonès;08019;Barcelona;8;27;U;;793;211;371;486;307;1;14;471;485
8;Barcelona;13;Barcelonès;08019;Barcelona;8;28;U;;1191;289;537;686;505;3;10;673;683
8;Barcelona;13;Barcelonès;08019;Barcelona;8;29;U;;785;209;340;431;354;1;10;420;430
8;Barcelona;13;Barcelonès;08019;Barcelona;8;3;U;;1104;277;561;675;429;1;17;657;674
8;Barcelona;13;Barcelonès;08019;Barcelona;8;30;U;;1053;273;485;585;468;0;6;579;585
8;Barcelona;13;Barcelonès;08019;Barcelona;8;33;U;;717;195;331;439;278;2;12;425;437
8;Barcelona;13;Barcelonès;08019;Barcelona;8;34;U;;766;243;404;477;289;5;9;463;472
8;Barcelona;13;Barcelonès;08019;Barcelona;8;36;U;;769;217;352;432;337;0;5;427;432
8;Barcelona;13;Barcelonès;08019;Barcelona;8;39;U;;451;141;232;277;174;1;4;272;276
8;Barcelona;13;Barcelonès;08019;Barcelona;8;40;U;;466;142;222;271;195;2;7;262;269
8;Barcelona;13;Barcelonès;08019;Barcelona;8;41;U;;579;188;277;352;227;3;11;338;349
8;Barcelona;13;Barcelonès;08019;Barcelona;8;42;U;;546;169;275;340;206;1;11;328;339
8;Barcelona;13;Barcelonès;08019;Barcelona;8;43;U;;464;180;248;296;168;0;6;290;296
8;Barcelona;13;Barcelonès;08019;Barcelona;8;44;U;;1160;267;496;669;491;0;19;650;669
8;Barcelona;13;Barcelonès;08019;Barcelona;8;45;U;;338;84;132;185;153;0;5;180;185
8;Barcelona;13;Barcelonès;08019;Barcelona;8;46;U;;722;158;237;312;410;0;11;301;312
8;Barcelona;13;Barcelonès;08019;Barcelona;8;47;U;;619;156;268;343;276;1;5;337;342
8;Barcelona;13;Barcelonès;08019;Barcelona;8;48;U;;581;135;223;297;284;4;3;290;293
8;Barcelona;13;Barcelonès;08019;Barcelona;8;49;U;;836;217;336;458;378;2;13;443;456
8;Barcelona;13;Barcelonès;08019;Barcelona;8;5;U;;787;248;400;502;285;4;14;484;498
8;Barcelona;13;Barcelonès;08019;Barcelona;8;50;U;;566;133;236;296;270;0;7;289;296
8;Barcelona;13;Barcelonès;08019;Barcelona;8;51;U;;699;189;318;405;294;1;8;396;404
8;Barcelona;13;Barcelonès;08019;Barcelona;8;52;U;;664;168;276;368;296;2;11;355;366
8;Barcelona;13;Barcelonès;08019;Barcelona;8;53;U;;914;234;408;507;407;3;13;491;504
8;Barcelona;13;Barcelonès;08019;Barcelona;8;54;U;;520;118;223;280;240;0;10;270;280
8;Barcelona;13;Barcelonès;08019;Barcelona;8;55;U;;399;86;151;201;198;0;1;200;201
8;Barcelona;13;Barcelonès;08019;Barcelona;8;56;U;;944;286;411;496;448;3;5;488;493
8;Barcelona;13;Barcelonès;08019;Barcelona;8;57;U;;781;223;358;426;355;1;4;421;425
8;Barcelona;13;Barcelonès;08019;Barcelona;8;58;U;;791;191;315;396;395;2;11;383;394
8;Barcelona;13;Barcelonès;08019;Barcelona;8;6;U;;757;240;403;499;258;1;13;485;498
8;Barcelona;13;Barcelonès;08019;Barcelona;8;60;U;;816;214;334;413;403;0;8;405;413
8;Barcelona;13;Barcelonès;08019;Barcelona;8;62;U;;919;277;435;529;390;2;9;518;527
8;Barcelona;13;Barcelonès;08019;Barcelona;8;64;U;;402;137;199;229;173;3;6;220;226
8;Barcelona;13;Barcelonès;08019;Barcelona;8;65;U;;733;193;323;425;308;3;12;410;422
8;Barcelona;13;Barcelonès;08019;Barcelona;8;66;U;;484;131;193;233;251;2;1;230;231
8;Barcelona;13;Barcelonès;08019;Barcelona;8;67;U;;555;128;202;238;317;0;4;234;238
8;Barcelona;13;Barcelonès;08019;Barcelona;8;68;U;;543;107;189;231;312;5;2;224;226
8;Barcelona;13;Barcelonès;08019;Barcelona;8;7;U;;647;199;326;391;256;1;8;382;390
8;Barcelona;13;Barcelonès;08019;Barcelona;8;70;U;;353;101;156;187;166;0;5;182;187
8;Barcelona;13;Barcelonès;08019;Barcelona;8;71;U;;396;141;207;249;147;0;3;246;249
8;Barcelona;13;Barcelonès;08019;Barcelona;8;72;U;;488;140;229;273;215;2;4;267;271
8;Barcelona;13;Barcelonès;08019;Barcelona;8;73;U;;641;197;287;361;280;0;18;343;361
8;Barcelona;13;Barcelonès;08019;Barcelona;8;74;U;;674;199;392;414;260;6;6;402;408
8;Barcelona;13;Barcelonès;08019;Barcelona;8;76;A;;718;196;316;383;335;3;5;375;380
8;Barcelona;13;Barcelonès;08019;Barcelona;8;76;B;;667;194;299;346;321;0;6;340;346
8;Barcelona;13;Barcelonès;08019;Barcelona;8;77;U;;1185;343;540;619;566;2;10;607;617
8;Barcelona;13;Barcelonès;08019;Barcelona;8;8;A;;729;252;379;462;267;2;18;442;460
8;Barcelona;13;Barcelonès;08019;Barcelona;8;8;B;;655;201;332;407;248;0;16;391;407
8;Barcelona;13;Barcelonès;08019;Barcelona;8;80;U;;1114;330;529;606;508;0;9;597;606
8;Barcelona;13;Barcelonès;08019;Barcelona;8;82;U;;456;127;197;236;220;0;6;230;236
8;Barcelona;13;Barcelonès;08019;Barcelona;8;83;U;;464;151;225;265;199;0;0;265;265
8;Barcelona;13;Barcelonès;08019;Barcelona;8;84;U;;972;280;509;506;466;0;4;502;506
8;Barcelona;13;Barcelonès;08019;Barcelona;8;85;U;;769;176;251;307;462;0;2;305;307
8;Barcelona;13;Barcelonès;08019;Barcelona;8;86;U;;911;205;312;382;529;1;7;374;381
8;Barcelona;13;Barcelonès;08019;Barcelona;8;88;U;;1025;254;464;590;435;0;12;578;590
8;Barcelona;13;Barcelonès;08019;Barcelona;8;89;U;;793;208;390;464;329;4;9;451;460
8;Barcelona;13;Barcelonès;08019;Barcelona;8;90;U;;882;269;436;543;339;0;11;532;543
8;Barcelona;13;Barcelonès;08019;Barcelona;8;91;A;;1286;330;633;781;505;3;8;770;778
8;Barcelona;13;Barcelonès;08019;Barcelona;8;91;B;;1094;253;507;607;487;4;0;603;603
8;Barcelona;13;Barcelonès;08019;Barcelona;8;92;A;;753;250;403;458;295;1;10;447;457
8;Barcelona;13;Barcelonès;08019;Barcelona;8;92;B;;733;212;373;442;291;3;7;432;439
8;Barcelona;13;Barcelonès;08019;Barcelona;8;93;A;;851;195;392;528;323;3;18;507;525
8;Barcelona;13;Barcelonès;08019;Barcelona;8;93;B;;834;217;390;511;323;1;11;499;510
8;Barcelona;13;Barcelonès;08019;Barcelona;8;94;U;;377;140;212;252;125;0;2;250;252
8;Barcelona;13;Barcelonès;08019;Barcelona;8;95;U;;539;212;315;361;178;2;1;358;359
8;Barcelona;13;Barcelonès;08019;Barcelona;8;96;U;;712;190;296;377;335;2;8;367;375
8;Barcelona;13;Barcelonès;08019;Barcelona;8;97;U;;750;194;310;387;363;1;12;374;386
8;Barcelona;13;Barcelonès;08019;Barcelona;8;98;U;;886;256;416;444;442;3;15;426;441
8;Barcelona;13;Barcelonès;08019;Barcelona;9;10;U;;469;133;228;288;181;5;3;280;283
8;Barcelona;13;Barcelonès;08019;Barcelona;9;100;A;;738;201;339;420;318;2;13;405;418
8;Barcelona;13;Barcelonès;08019;Barcelona;9;100;B;;672;161;300;383;289;0;14;369;383
8;Barcelona;13;Barcelonès;08019;Barcelona;9;102;A;;687;179;305;376;311;2;4;370;374
8;Barcelona;13;Barcelonès;08019;Barcelona;9;102;B;;552;147;248;312;240;2;4;306;310
8;Barcelona;13;Barcelonès;08019;Barcelona;9;103;A;;1098;250;459;563;535;0;15;548;563
8;Barcelona;13;Barcelonès;08019;Barcelona;9;103;B;;980;229;414;524;456;0;6;518;524
8;Barcelona;13;Barcelonès;08019;Barcelona;9;104;U;;684;174;301;371;313;0;10;361;371
8;Barcelona;13;Barcelonès;08019;Barcelona;9;105;U;;419;101;164;207;212;1;1;205;206
8;Barcelona;13;Barcelonès;08019;Barcelona;9;106;U;;797;220;381;473;324;0;11;462;473
8;Barcelona;13;Barcelonès;08019;Barcelona;9;107;U;;786;257;433;522;264;1;19;502;521
8;Barcelona;13;Barcelonès;08019;Barcelona;9;108;U;;1099;315;550;671;428;1;12;658;670
8;Barcelona;13;Barcelonès;08019;Barcelona;9;109;U;;931;281;475;582;349;2;15;565;580
8;Barcelona;13;Barcelonès;08019;Barcelona;9;11;U;;859;256;445;568;291;1;8;559;567
8;Barcelona;13;Barcelonès;08019;Barcelona;9;110;U;;1202;302;555;700;502;1;22;677;699
8;Barcelona;13;Barcelonès;08019;Barcelona;9;111;U;;707;228;362;444;263;0;14;430;444
8;Barcelona;13;Barcelonès;08019;Barcelona;9;112;A;;1318;319;673;854;464;1;15;838;853
8;Barcelona;13;Barcelonès;08019;Barcelona;9;112;B;;1216;292;574;751;465;1;14;736;750
8;Barcelona;13;Barcelonès;08019;Barcelona;9;113;U;;1136;315;536;684;452;1;14;669;683
8;Barcelona;13;Barcelonès;08019;Barcelona;9;114;U;;897;289;474;573;324;0;7;566;573
8;Barcelona;13;Barcelonès;08019;Barcelona;9;115;U;;952;296;513;606;346;1;13;592;605
8;Barcelona;13;Barcelonès;08019;Barcelona;9;116;U;;1256;362;670;866;390;2;21;843;864
8;Barcelona;13;Barcelonès;08019;Barcelona;9;118;U;;1152;326;577;734;418;1;16;717;733
8;Barcelona;13;Barcelonès;08019;Barcelona;9;119;U;;826;300;434;523;303;3;13;507;520
8;Barcelona;13;Barcelonès;08019;Barcelona;9;120;U;;874;219;372;496;378;1;14;481;495
8;Barcelona;13;Barcelonès;08019;Barcelona;9;121;U;;767;188;313;416;351;1;8;407;415
8;Barcelona;13;Barcelonès;08019;Barcelona;9;123;U;;604;190;358;417;187;6;4;407;411
8;Barcelona;13;Barcelonès;08019;Barcelona;9;124;U;;547;191;285;354;193;0;3;351;354
8;Barcelona;13;Barcelonès;08019;Barcelona;9;125;U;;750;243;422;555;195;4;8;543;551
8;Barcelona;13;Barcelonès;08019;Barcelona;9;126;U;;1010;315;564;681;329;2;9;670;679
8;Barcelona;13;Barcelonès;08019;Barcelona;9;128;U;;746;171;292;350;396;0;4;346;350
8;Barcelona;13;Barcelonès;08019;Barcelona;9;129;U;;503;113;194;245;258;0;4;241;245
8;Barcelona;13;Barcelonès;08019;Barcelona;9;13;U;;999;309;557;687;312;1;13;673;686
8;Barcelona;13;Barcelonès;08019;Barcelona;9;130;U;;832;182;327;394;438;3;8;383;391
8;Barcelona;13;Barcelonès;08019;Barcelona;9;132;U;;878;221;358;417;461;0;8;409;417
8;Barcelona;13;Barcelonès;08019;Barcelona;9;133;U;;600;163;257;310;290;0;5;305;310
8;Barcelona;13;Barcelonès;08019;Barcelona;9;134;U;;744;198;304;386;358;0;12;374;386
8;Barcelona;13;Barcelonès;08019;Barcelona;9;136;U;;944;251;405;494;450;0;18;476;494
8;Barcelona;13;Barcelonès;08019;Barcelona;9;137;U;;756;171;290;354;402;2;9;343;352
8;Barcelona;13;Barcelonès;08019;Barcelona;9;139;U;;609;146;219;251;358;1;3;247;250
8;Barcelona;13;Barcelonès;08019;Barcelona;9;14;U;;774;237;402;493;281;1;17;475;492
8;Barcelona;13;Barcelonès;08019;Barcelona;9;140;A;;1211;284;529;663;548;2;11;650;661
8;Barcelona;13;Barcelonès;08019;Barcelona;9;140;B;;1013;251;440;553;460;1;18;534;552
8;Barcelona;13;Barcelonès;08019;Barcelona;9;142;U;;751;153;245;298;453;1;7;290;297
8;Barcelona;13;Barcelonès;08019;Barcelona;9;144;U;;1096;207;324;400;696;0;9;391;400
8;Barcelona;13;Barcelonès;08019;Barcelona;9;145;U;;1201;250;431;554;647;0;11;543;554
8;Barcelona;13;Barcelonès;08019;Barcelona;9;146;U;;672;117;229;300;372;4;3;293;296
8;Barcelona;13;Barcelonès;08019;Barcelona;9;147;U;;987;235;384;447;540;0;7;440;447
8;Barcelona;13;Barcelonès;08019;Barcelona;9;148;U;;492;94;160;205;287;0;6;199;205
8;Barcelona;13;Barcelonès;08019;Barcelona;9;149;U;;605;135;224;278;327;0;3;275;278
8;Barcelona;13;Barcelonès;08019;Barcelona;9;15;U;;911;290;503;593;318;1;15;577;592
8;Barcelona;13;Barcelonès;08019;Barcelona;9;150;U;;784;130;237;322;462;3;4;315;319
8;Barcelona;13;Barcelonès;08019;Barcelona;9;151;U;;826;180;308;365;461;0;2;363;365
8;Barcelona;13;Barcelonès;08019;Barcelona;9;154;U;;529;100;191;230;299;0;9;221;230
8;Barcelona;13;Barcelonès;08019;Barcelona;9;17;U;;956;283;515;635;321;1;25;609;634
8;Barcelona;13;Barcelonès;08019;Barcelona;9;18;U;;675;675;675;445;230;0;13;432;445
8;Barcelona;13;Barcelonès;08019;Barcelona;9;19;U;;854;233;399;497;357;1;12;484;496
8;Barcelona;13;Barcelonès;08019;Barcelona;9;2;A;;810;214;381;491;319;3;9;479;488
8;Barcelona;13;Barcelonès;08019;Barcelona;9;2;B;;732;174;330;433;299;3;8;422;430
8;Barcelona;13;Barcelonès;08019;Barcelona;9;20;U;;616;176;282;348;268;0;4;344;348
8;Barcelona;13;Barcelonès;08019;Barcelona;9;21;U;;722;264;412;480;242;0;5;475;480
8;Barcelona;13;Barcelonès;08019;Barcelona;9;22;U;;474;140;253;313;161;1;1;311;312
8;Barcelona;13;Barcelonès;08019;Barcelona;9;23;U;;1092;311;517;632;460;6;21;605;626
8;Barcelona;13;Barcelonès;08019;Barcelona;9;25;U;;935;262;497;619;316;6;26;587;613
8;Barcelona;13;Barcelonès;08019;Barcelona;9;26;A;;848;242;443;537;311;4;9;524;533
8;Barcelona;13;Barcelonès;08019;Barcelona;9;26;B;;766;208;390;482;284;1;6;475;481
8;Barcelona;13;Barcelonès;08019;Barcelona;9;27;U;;1001;307;526;657;344;5;17;635;652
8;Barcelona;13;Barcelonès;08019;Barcelona;9;28;U;;793;233;384;469;324;4;10;455;465
8;Barcelona;13;Barcelonès;08019;Barcelona;9;3;A;;922;256;488;599;323;1;8;590;598
8;Barcelona;13;Barcelonès;08019;Barcelona;9;3;B;;753;207;375;460;293;1;13;446;459
8;Barcelona;13;Barcelonès;08019;Barcelona;9;30;A;;849;195;368;500;349;1;4;495;499
8;Barcelona;13;Barcelonès;08019;Barcelona;9;30;B;;866;208;372;504;362;0;9;495;504
8;Barcelona;13;Barcelonès;08019;Barcelona;9;31;U;;788;216;384;559;229;4;80;475;555
8;Barcelona;13;Barcelonès;08019;Barcelona;9;32;U;;1219;308;549;697;522;11;10;676;686
8;Barcelona;13;Barcelonès;08019;Barcelona;9;33;U;;743;244;420;496;247;3;11;482;493
8;Barcelona;13;Barcelonès;08019;Barcelona;9;35;U;;621;198;331;383;238;4;7;372;379
8;Barcelona;13;Barcelonès;08019;Barcelona;9;36;U;;420;138;241;280;140;2;7;271;278
8;Barcelona;13;Barcelonès;08019;Barcelona;9;37;U;;1113;325;523;665;448;5;8;652;660
8;Barcelona;13;Barcelonès;08019;Barcelona;9;39;A;;874;206;437;557;317;0;14;543;557
8;Barcelona;13;Barcelonès;08019;Barcelona;9;39;B;;858;217;411;530;328;8;7;515;522
8;Barcelona;13;Barcelonès;08019;Barcelona;9;39;C;;888;243;446;555;333;0;5;550;555
8;Barcelona;13;Barcelonès;08019;Barcelona;9;4;U;;1069;294;524;672;397;1;6;665;671
8;Barcelona;13;Barcelonès;08019;Barcelona;9;40;U;;1038;280;493;641;397;6;9;626;635
8;Barcelona;13;Barcelonès;08019;Barcelona;9;41;U;;685;214;346;422;263;5;3;414;417
8;Barcelona;13;Barcelonès;08019;Barcelona;9;42;U;;690;207;348;423;267;1;23;399;422
8;Barcelona;13;Barcelonès;08019;Barcelona;9;43;U;;775;250;403;476;299;5;15;456;471
8;Barcelona;13;Barcelonès;08019;Barcelona;9;44;A;;656;198;339;416;240;7;7;402;409
8;Barcelona;13;Barcelonès;08019;Barcelona;9;44;B;;629;192;314;359;270;1;8;350;358
8;Barcelona;13;Barcelonès;08019;Barcelona;9;45;A;;766;271;423;506;260;0;11;495;506
8;Barcelona;13;Barcelonès;08019;Barcelona;9;45;B;;692;228;350;424;268;3;6;415;421
8;Barcelona;13;Barcelonès;08019;Barcelona;9;46;U;;1043;253;430;530;513;1;7;522;529
8;Barcelona;13;Barcelonès;08019;Barcelona;9;47;A;;638;173;301;399;239;3;7;389;396
8;Barcelona;13;Barcelonès;08019;Barcelona;9;47;B;;637;185;331;418;219;3;14;401;415
8;Barcelona;13;Barcelonès;08019;Barcelona;9;48;U;;1152;292;563;708;444;2;11;695;706
8;Barcelona;13;Barcelonès;08019;Barcelona;9;49;U;;640;210;330;389;251;3;8;378;386
8;Barcelona;13;Barcelonès;08019;Barcelona;9;5;U;;1107;308;546;717;390;0;11;706;717
8;Barcelona;13;Barcelonès;08019;Barcelona;9;51;U;;888;269;397;505;383;0;13;492;505
8;Barcelona;13;Barcelonès;08019;Barcelona;9;52;U;;826;207;368;468;358;2;11;455;466
8;Barcelona;13;Barcelonès;08019;Barcelona;9;54;U;;476;141;236;292;184;0;4;288;292
8;Barcelona;13;Barcelonès;08019;Barcelona;9;55;U;;885;262;446;555;330;3;20;532;552
8;Barcelona;13;Barcelonès;08019;Barcelona;9;57;U;;513;158;273;341;172;1;1;339;340
8;Barcelona;13;Barcelonès;08019;Barcelona;9;59;U;;789;195;373;473;316;3;11;459;470
8;Barcelona;13;Barcelonès;08019;Barcelona;9;6;U;;1151;389;646;762;389;8;11;743;754
8;Barcelona;13;Barcelonès;08019;Barcelona;9;60;U;;1154;335;616;758;396;1;17;740;757
8;Barcelona;13;Barcelonès;08019;Barcelona;9;62;U;;515;171;277;353;162;0;10;343;353
8;Barcelona;13;Barcelonès;08019;Barcelona;9;63;U;;536;200;301;353;183;0;9;344;353
8;Barcelona;13;Barcelonès;08019;Barcelona;9;64;U;;869;310;467;551;318;10;9;532;541
8;Barcelona;13;Barcelonès;08019;Barcelona;9;66;U;;719;230;390;463;256;3;7;453;460
8;Barcelona;13;Barcelonès;08019;Barcelona;9;67;U;;1002;353;535;638;364;2;18;618;636
8;Barcelona;13;Barcelonès;08019;Barcelona;9;69;U;;1077;352;582;709;368;3;9;697;706
8;Barcelona;13;Barcelonès;08019;Barcelona;9;7;U;;1183;372;637;788;395;6;20;762;782
8;Barcelona;13;Barcelonès;08019;Barcelona;9;71;U;;457;129;217;271;186;1;3;267;270
8;Barcelona;13;Barcelonès;08019;Barcelona;9;72;U;;967;323;518;644;323;0;19;625;644
8;Barcelona;13;Barcelonès;08019;Barcelona;9;73;U;;675;215;358;451;224;1;7;443;450
8;Barcelona;13;Barcelonès;08019;Barcelona;9;74;U;;479;147;222;289;190;0;4;285;289
8;Barcelona;13;Barcelonès;08019;Barcelona;9;75;U;;1037;291;498;647;390;5;16;626;642
8;Barcelona;13;Barcelonès;08019;Barcelona;9;77;U;;790;222;415;520;270;0;12;508;520
8;Barcelona;13;Barcelonès;08019;Barcelona;9;79;U;;811;245;447;521;290;0;16;505;521
8;Barcelona;13;Barcelonès;08019;Barcelona;9;80;U;;1263;396;668;812;451;2;17;793;810
8;Barcelona;13;Barcelonès;08019;Barcelona;9;82;U;;872;307;488;595;277;0;15;580;595
8;Barcelona;13;Barcelonès;08019;Barcelona;9;84;U;;950;300;496;631;319;1;12;618;630
8;Barcelona;13;Barcelonès;08019;Barcelona;9;86;A;;768;202;374;468;300;1;13;454;467
8;Barcelona;13;Barcelonès;08019;Barcelona;9;86;B;;713;204;381;480;233;2;14;464;478
8;Barcelona;13;Barcelonès;08019;Barcelona;9;87;U;;636;169;310;376;260;2;5;369;374
8;Barcelona;13;Barcelonès;08019;Barcelona;9;88;U;;516;148;247;305;211;0;8;297;305
8;Barcelona;13;Barcelonès;08019;Barcelona;9;89;U;;1099;357;558;713;386;1;17;695;712
8;Barcelona;13;Barcelonès;08019;Barcelona;9;9;U;;488;135;222;280;208;0;5;275;280
8;Barcelona;13;Barcelonès;08019;Barcelona;9;90;U;;555;163;254;327;228;3;9;315;324
8;Barcelona;13;Barcelonès;08019;Barcelona;9;91;U;;871;291;460;559;312;1;21;537;558
8;Barcelona;13;Barcelonès;08019;Barcelona;9;92;U;;688;189;311;379;309;0;5;374;379
8;Barcelona;13;Barcelonès;08019;Barcelona;9;94;U;;577;186;294;357;220;6;9;342;351
8;Barcelona;13;Barcelonès;08019;Barcelona;9;95;U;;558;164;291;350;208;2;11;337;348
8;Barcelona;13;Barcelonès;08019;Barcelona;9;96;U;;475;165;235;299;176;1;3;295;298
8;Barcelona;13;Barcelonès;08019;Barcelona;9;97;U;;612;195;304;365;247;0;9;356;365
8;Barcelona;13;Barcelonès;08019;Barcelona;9;98;U;;1193;325;598;736;457;2;21;713;734
25;Lleida;23;Noguera;25042;Baronia de Rialb, la;1;1;U;;228;70;115;134;94;1;0;133;133
17;Girona;2;Alt Empordà;17016;Bàscara;1;1;U;;718;234;427;497;221;1;9;487;496
25;Lleida;4;Alt Urgell;25044;Bassella;1;1;U;;208;45;99;131;77;2;7;122;129
43;Tarragona;37;Terra Alta;43022;Batea;1;1;A;;400;126;242;309;91;6;7;296;303
43;Tarragona;37;Terra Alta;43022;Batea;1;1;B;;464;125;261;340;124;3;1;336;337
43;Tarragona;37;Terra Alta;43022;Batea;1;2;A;;382;109;208;282;100;2;1;279;280
43;Tarragona;37;Terra Alta;43022;Batea;1;2;B;;360;104;211;262;98;1;1;260;261
25;Lleida;39;Consell General d'Aran;25045;Bausen;1;1;U;;46;12;29;40;6;0;0;40;40
8;Barcelona;11;Baix Llobregat;08020;Begues;1;1;A;;658;220;364;449;209;0;8;441;449
8;Barcelona;11;Baix Llobregat;08020;Begues;1;1;B;;806;230;431;531;275;2;10;519;529
8;Barcelona;11;Baix Llobregat;08020;Begues;1;2;A;;619;174;318;404;215;0;6;398;404
8;Barcelona;11;Baix Llobregat;08020;Begues;1;2;B;;615;178;341;422;193;0;14;408;422
8;Barcelona;11;Baix Llobregat;08020;Begues;1;3;A;;613;146;270;341;272;1;8;332;340
8;Barcelona;11;Baix Llobregat;08020;Begues;1;3;B;;779;172;343;463;316;0;6;457;463
17;Girona;10;Baix Empordà;17013;Begur;1;1;A;;552;118;219;292;260;1;3;288;291
17;Girona;10;Baix Empordà;17013;Begur;1;1;B;;566;141;212;273;293;2;8;263;271
17;Girona;10;Baix Empordà;17013;Begur;1;2;U;;578;180;314;368;210;2;3;363;366
17;Girona;10;Baix Empordà;17013;Begur;1;3;A;;501;143;255;320;181;0;2;318;320
17;Girona;10;Baix Empordà;17013;Begur;1;3;B;;486;146;251;312;174;4;5;303;308
25;Lleida;38;Urgell;25046;Belianes;1;1;U;;456;140;275;329;127;2;9;318;327
25;Lleida;18;Garrigues;25170;Bellaguarda;1;1;U;;300;60;139;187;113;0;5;182;187
17;Girona;10;Baix Empordà;17018;Bellcaire d'Empordà;1;1;U;;476;141;259;318;158;5;5;308;313
25;Lleida;23;Noguera;25047;Bellcaire d'Urgell;1;1;A;;512;145;279;340;172;5;8;327;335
25;Lleida;23;Noguera;25047;Bellcaire d'Urgell;1;1;B;;568;174;342;420;148;0;6;414;420
25;Lleida;27;Pla d'Urgell;25048;Bell-lloc d'Urgell;1;1;U;;756;202;394;488;268;12;14;462;476
25;Lleida;27;Pla d'Urgell;25048;Bell-lloc d'Urgell;1;2;U;;985;250;518;663;322;12;12;639;651
25;Lleida;23;Noguera;25049;Bellmunt d'Urgell;1;1;U;;181;45;95;126;55;0;4;122;126
43;Tarragona;29;Priorat;43023;Bellmunt del Priorat;1;1;U;;269;86;181;204;65;1;7;196;203
8;Barcelona;6;Anoia;08021;Bellprat;1;1;U;;91;34;48;58;33;0;1;57;58
25;Lleida;38;Urgell;25050;Bellpuig;1;1;A;;692;167;344;438;254;6;10;422;432
25;Lleida;38;Urgell;25050;Bellpuig;1;1;B;;689;170;350;431;258;2;14;415;429
25;Lleida;38;Urgell;25050;Bellpuig;1;2;A;;472;118;253;311;161;4;7;300;307
25;Lleida;38;Urgell;25050;Bellpuig;1;2;B;;569;138;304;393;176;2;3;388;391
25;Lleida;38;Urgell;25050;Bellpuig;1;3;U;;807;223;449;547;260;5;6;536;542
43;Tarragona;12;Baix Penedès;43024;Bellvei;1;1;A;;522;122;215;254;268;0;7;247;254
43;Tarragona;12;Baix Penedès;43024;Bellvei;1;1;B;;727;210;367;442;285;4;12;426;438
25;Lleida;15;Cerdanya;25051;Bellver de Cerdanya;1;1;A;;656;164;331;403;253;3;8;392;400
25;Lleida;15;Cerdanya;25051;Bellver de Cerdanya;1;1;B;;829;70;368;481;348;2;14;465;479
25;Lleida;27;Pla d'Urgell;25052;Bellvís;1;1;A;;894;177;424;601;293;6;9;586;595
25;Lleida;27;Pla d'Urgell;25052;Bellvís;1;1;B;;810;170;404;537;273;2;8;527;535
25;Lleida;33;Segrià;25053;Benavent de Segrià;1;1;U;;975;237;453;577;398;2;13;562;575
43;Tarragona;9;Baix Ebre;43025;Benifallet;1;1;U;;707;165;357;439;268;1;5;433;438
43;Tarragona;30;Ribera d'Ebre;43026;Benissanet;1;1;U;;845;200;435;559;286;1;11;547;558
8;Barcelona;14;Berguedà;08022;Berga;1;1;A;;566;161;267;344;222;3;9;332;341
8;Barcelona;14;Berguedà;08022;Berga;1;1;B;;552;148;248;322;230;4;7;311;318
8;Barcelona;14;Berguedà;08022;Berga;1;2;A;;500;175;267;315;185;2;5;308;313
8;Barcelona;14;Berguedà;08022;Berga;1;2;B;;518;170;263;320;198;4;8;308;316
8;Barcelona;14;Berguedà;08022;Berga;1;3;U;;765;236;413;544;221;1;10;533;543
8;Barcelona;14;Berguedà;08022;Berga;1;4;A;;746;222;371;460;286;5;14;441;455
8;Barcelona;14;Berguedà;08022;Berga;1;4;B;;846;230;400;506;340;4;12;490;502
8;Barcelona;14;Berguedà;08022;Berga;1;5;A;;671;225;368;445;226;1;3;441;444
8;Barcelona;14;Berguedà;08022;Berga;1;5;B;;737;221;383;464;273;13;4;447;451
8;Barcelona;14;Berguedà;08022;Berga;1;6;A;;293;76;122;151;142;0;3;148;151
8;Barcelona;14;Berguedà;08022;Berga;1;6;B;;278;67;133;164;114;0;3;161;164
8;Barcelona;14;Berguedà;08022;Berga;2;1;A;;368;98;143;175;193;0;3;172;175
8;Barcelona;14;Berguedà;08022;Berga;2;1;B;;357;92;138;160;197;1;0;159;159
8;Barcelona;14;Berguedà;08022;Berga;2;2;U;;737;220;338;386;351;2;6;378;384
8;Barcelona;14;Berguedà;08022;Berga;2;3;A;;925;244;406;483;442;3;9;471;480
8;Barcelona;14;Berguedà;08022;Berga;2;3;B;;1137;279;470;555;582;3;6;546;552
8;Barcelona;14;Berguedà;08022;Berga;2;4;A;;634;214;335;398;236;2;5;391;396
8;Barcelona;14;Berguedà;08022;Berga;2;4;B;;718;235;378;449;269;2;17;430;447
8;Barcelona;14;Berguedà;08022;Berga;3;1;A;;239;60;94;122;117;1;5;116;121
8;Barcelona;14;Berguedà;08022;Berga;3;1;B;;353;117;194;240;113;2;8;230;238
8;Barcelona;14;Berguedà;08022;Berga;4;1;U;;571;182;283;360;211;5;10;345;355
17;Girona;19;Garrotxa;17019;Besalú;1;1;A;;532;228;348;398;134;6;5;387;392
17;Girona;19;Garrotxa;17019;Besalú;1;1;B;;653;226;405;469;184;7;10;452;462
17;Girona;19;Garrotxa;17019;Besalú;1;1;C;;571;211;362;417;154;3;15;399;414
17;Girona;20;Gironès;17020;Bescanó;1;1;A;;348;102;205;250;98;0;1;249;250
17;Girona;20;Gironès;17020;Bescanó;1;1;B;;388;98;201;226;162;1;3;222;225
17;Girona;20;Gironès;17020;Bescanó;1;1;C;;301;81;167;198;103;0;2;196;198
17;Girona;20;Gironès;17020;Bescanó;1;2;A;;350;98;184;224;126;0;2;222;224
17;Girona;20;Gironès;17020;Bescanó;1;2;B;;350;112;192;239;111;0;2;237;239
17;Girona;20;Gironès;17020;Bescanó;1;3;A;;453;138;263;318;135;2;5;311;316
17;Girona;20;Gironès;17020;Bescanó;1;3;B;;451;121;236;279;172;3;2;274;276
17;Girona;20;Gironès;17020;Bescanó;1;3;C;;428;132;234;286;142;1;7;278;285
17;Girona;19;Garrotxa;17021;Beuda;1;1;U;;114;43;60;74;40;1;0;73;73
8;Barcelona;41;Vallès Oriental;08023;Bigues i Riells;1;1;A;;1380;318;562;711;669;0;7;704;711
8;Barcelona;41;Vallès Oriental;08023;Bigues i Riells;1;1;B;;942;213;401;504;438;1;9;494;503
8;Barcelona;41;Vallès Oriental;08023;Bigues i Riells;1;1;C;;1097;240;433;553;544;2;7;544;551
8;Barcelona;41;Vallès Oriental;08023;Bigues i Riells;1;1;D;;1011;203;396;512;499;0;4;508;512
8;Barcelona;41;Vallès Oriental;08023;Bigues i Riells;1;1;E;;851;198;368;476;375;0;6;470;476
8;Barcelona;41;Vallès Oriental;08023;Bigues i Riells;1;1;F;;588;170;313;383;205;0;4;379;383
25;Lleida;32;Segarra;25055;Biosca;1;1;U;;209;49;111;145;64;2;1;142;143
17;Girona;10;Baix Empordà;17022;Bisbal d'Empordà, la;1;2;A;;530;158;271;329;201;3;4;322;326
17;Girona;10;Baix Empordà;17022;Bisbal d'Empordà, la;1;2;B;;489;157;262;317;172;6;2;309;311
17;Girona;10;Baix Empordà;17022;Bisbal d'Empordà, la;1;3;A;;556;140;245;316;240;0;6;310;316
17;Girona;10;Baix Empordà;17022;Bisbal d'Empordà, la;1;3;B;;533;145;247;304;229;2;3;299;302
17;Girona;10;Baix Empordà;17022;Bisbal d'Empordà, la;1;4;A;;764;201;351;461;303;1;8;452;460
17;Girona;10;Baix Empordà;17022;Bisbal d'Empordà, la;1;4;B;;752;201;358;477;275;1;19;457;476
17;Girona;10;Baix Empordà;17022;Bisbal d'Empordà, la;2;1;U;;1022;278;486;597;425;7;12;578;590
17;Girona;10;Baix Empordà;17022;Bisbal d'Empordà, la;2;2;A;;496;141;246;283;213;1;6;276;282
17;Girona;10;Baix Empordà;17022;Bisbal d'Empordà, la;2;2;B;;533;157;278;325;208;3;11;311;322
17;Girona;10;Baix Empordà;17022;Bisbal d'Empordà, la;2;3;U;;903;275;456;521;382;1;8;512;520
43;Tarragona;29;Priorat;43027;Bisbal de Falset, la;1;1;U;;197;68;114;135;62;0;3;132;135
43;Tarragona;12;Baix Penedès;43028;Bisbal del Penedès, la;1;1;A;;762;189;294;365;397;6;1;358;359
43;Tarragona;12;Baix Penedès;43028;Bisbal del Penedès, la;1;1;B;;720;151;262;333;387;4;4;325;329
43;Tarragona;12;Baix Penedès;43028;Bisbal del Penedès, la;1;1;C;;861;176;330;414;447;7;5;402;407
17;Girona;2;Alt Empordà;17234;Biure;1;1;U;;183;64;116;137;46;0;0;137;137
43;Tarragona;16;Conca de Barberà;43029;Blancafort;1;1;U;;325;80;186;225;100;4;7;214;221
17;Girona;34;Selva;17023;Blanes;1;1;A;;485;165;261;333;152;3;8;322;330
17;Girona;34;Selva;17023;Blanes;1;1;B;;462;161;261;307;155;5;12;290;302
17;Girona;34;Selva;17023;Blanes;1;2;A;;590;180;305;362;228;3;11;348;359
17;Girona;34;Selva;17023;Blanes;1;2;B;;640;209;352;416;224;8;7;401;408
17;Girona;34;Selva;17023;Blanes;1;2;C;;695;223;373;471;224;5;11;455;466
17;Girona;34;Selva;17023;Blanes;1;4;A;;699;246;353;387;312;2;0;385;385
17;Girona;34;Selva;17023;Blanes;1;4;B;;742;242;351;394;348;3;7;384;391
17;Girona;34;Selva;17023;Blanes;1;6;U;;1252;255;410;513;739;6;8;499;507
17;Girona;34;Selva;17023;Blanes;2;1;A;;795;212;364;447;348;2;10;435;445
17;Girona;34;Selva;17023;Blanes;2;1;B;;810;228;397;469;341;3;8;458;466
17;Girona;34;Selva;17023;Blanes;2;10;A;;813;135;232;287;526;1;2;284;286
17;Girona;34;Selva;17023;Blanes;2;10;B;;755;129;232;272;483;0;6;266;272
17;Girona;34;Selva;17023;Blanes;2;11;A;;743;140;285;369;374;4;9;356;365
17;Girona;34;Selva;17023;Blanes;2;11;B;;666;110;244;305;361;4;6;295;301
17;Girona;34;Selva;17023;Blanes;2;2;U;;903;217;387;489;414;5;12;472;484
17;Girona;34;Selva;17023;Blanes;2;3;A;;622;12;208;272;350;3;6;263;269
17;Girona;34;Selva;17023;Blanes;2;3;B;;645;136;228;285;360;1;4;280;284
17;Girona;34;Selva;17023;Blanes;2;4;A;;794;222;344;408;386;3;7;398;405
17;Girona;34;Selva;17023;Blanes;2;4;B;;769;205;314;374;395;3;11;360;371
17;Girona;34;Selva;17023;Blanes;2;5;A;;893;188;337;433;460;0;8;425;433
17;Girona;34;Selva;17023;Blanes;2;5;B;;833;174;309;384;449;3;5;376;381
17;Girona;34;Selva;17023;Blanes;2;6;A;;923;231;417;529;394;2;15;512;527
17;Girona;34;Selva;17023;Blanes;2;6;B;;876;199;413;494;382;3;13;478;491
17;Girona;34;Selva;17023;Blanes;2;7;A;;541;117;222;280;261;1;4;275;279
17;Girona;34;Selva;17023;Blanes;2;7;B;;634;148;262;308;326;2;6;300;306
17;Girona;34;Selva;17023;Blanes;2;7;C;;607;142;255;297;310;1;8;288;296
17;Girona;34;Selva;17023;Blanes;2;8;A;;832;201;362;452;380;2;5;445;450
17;Girona;34;Selva;17023;Blanes;2;8;B;;767;193;344;425;342;3;11;411;422
17;Girona;34;Selva;17023;Blanes;2;9;U;;686;197;339;394;292;5;4;385;389
17;Girona;34;Selva;17023;Blanes;3;1;A;;528;105;189;236;292;1;2;233;235
17;Girona;34;Selva;17023;Blanes;3;1;B;;566;130;204;252;314;1;2;249;251
17;Girona;34;Selva;17023;Blanes;3;2;A;;449;122;196;232;217;0;2;230;232
17;Girona;34;Selva;17023;Blanes;3;2;B;;480;152;233;261;219;1;7;253;260
17;Girona;34;Selva;17023;Blanes;3;3;A;;509;83;183;227;282;2;2;223;225
17;Girona;34;Selva;17023;Blanes;3;3;B;;545;117;205;243;302;1;7;235;242
17;Girona;34;Selva;17023;Blanes;3;3;C;;275;87;155;173;102;1;1;171;172
17;Girona;34;Selva;17023;Blanes;3;4;A;;424;92;143;181;243;0;1;180;181
17;Girona;34;Selva;17023;Blanes;3;4;B;;1009;194;347;445;564;1;5;439;444
17;Girona;2;Alt Empordà;17029;Boadella i les Escaules;1;1;U;;192;50;87;111;81;1;2;108;110
17;Girona;15;Cerdanya;17024;Bolvir;1;1;U;;249;40;100;142;107;2;7;133;140
43;Tarragona;12;Baix Penedès;43030;Bonastre;1;1;U;;401;105;193;235;166;2;4;229;233
25;Lleida;39;Consell General d'Aran;25057;Bòrdes, es;1;1;U;;207;54;93;119;88;1;2;116;118
17;Girona;20;Gironès;17025;Bordils;1;1;U;;1105;302;601;712;393;2;16;694;710
25;Lleida;18;Garrigues;25058;Borges Blanques, les;1;1;U;;744;180;333;450;294;1;7;442;449
25;Lleida;18;Garrigues;25058;Borges Blanques, les;1;2;A;;499;93;220;313;186;3;8;302;310
25;Lleida;18;Garrigues;25058;Borges Blanques, les;1;2;B;;615;138;288;391;224;3;9;379;388
25;Lleida;18;Garrigues;25058;Borges Blanques, les;2;1;A;;669;165;314;426;243;0;6;420;426
25;Lleida;18;Garrigues;25058;Borges Blanques, les;2;1;B;;705;154;309;430;275;1;14;415;429
25;Lleida;18;Garrigues;25058;Borges Blanques, les;2;2;A;;549;138;256;331;218;1;3;327;330
25;Lleida;18;Garrigues;25058;Borges Blanques, les;2;2;B;;619;133;281;364;255;1;6;357;363
43;Tarragona;8;Baix Camp;43031;Borges del Camp, les;1;1;A;;725;184;375;477;248;0;9;468;477
43;Tarragona;8;Baix Camp;43031;Borges del Camp, les;1;1;B;;748;211;385;488;260;4;0;484;484
17;Girona;2;Alt Empordà;17026;Borrassà;1;1;U;;508;193;322;371;137;7;6;358;364
8;Barcelona;14;Berguedà;08024;Borredà;1;1;U;;385;121;208;259;126;3;9;247;256
25;Lleida;39;Consell General d'Aran;25059;Bossòst;1;1;U;;788;173;370;481;307;6;6;469;475
43;Tarragona;37;Terra Alta;43032;Bot;1;1;U;;644;214;375;455;189;3;3;449;452
43;Tarragona;8;Baix Camp;43033;Botarell;1;1;U;;702;157;349;466;236;2;12;452;464
25;Lleida;18;Garrigues;25056;Bovera;1;1;U;;334;92;174;211;123;4;5;202;207
43;Tarragona;1;Alt Camp;43034;Bràfim;1;1;U;;504;159;306;360;144;2;14;344;358
17;Girona;34;Selva;17027;Breda;1;1;A;;526;138;290;336;190;3;9;324;333
17;Girona;34;Selva;17027;Breda;1;1;B;;584;132;282;346;238;1;8;337;345
17;Girona;34;Selva;17027;Breda;1;1;C;;481;114;262;314;167;4;6;304;310
17;Girona;34;Selva;17027;Breda;1;2;A;;613;162;325;396;217;5;1;390;391
17;Girona;34;Selva;17027;Breda;1;2;B;;700;171;345;434;266;4;8;422;430
8;Barcelona;6;Anoia;08025;Bruc, el;1;1;A;;559;126;251;319;240;0;3;316;319
8;Barcelona;6;Anoia;08025;Bruc, el;1;1;B;;705;127;318;407;298;0;13;394;407
8;Barcelona;24;Osona;08026;Brull, el;1;1;U;;182;65;116;151;31;0;2;149;151
17;Girona;34;Selva;17028;Brunyola i Sant Martí Sapresa;1;1;U;;304;96;159;190;114;2;5;183;188
43;Tarragona;29;Priorat;43035;Cabacés;1;1;U;;288;92;155;187;101;1;3;183;186
25;Lleida;23;Noguera;25060;Cabanabona;1;1;U;;96;26;52;60;36;0;2;58;60
17;Girona;2;Alt Empordà;17031;Cabanelles;1;1;U;;185;42;81;109;76;1;4;104;108
17;Girona;2;Alt Empordà;17030;Cabanes;1;1;U;;649;179;325;382;267;3;6;373;379
8;Barcelona;3;Alt Penedès;08027;Cabanyes, les;1;1;U;;598;181;328;422;176;3;4;415;419
25;Lleida;4;Alt Urgell;25061;Cabó;1;1;U;;93;23;41;49;44;0;0;49;49
43;Tarragona;1;Alt Camp;43036;Cabra del Camp;1;1;U;;719;167;298;337;382;0;6;331;337
8;Barcelona;6;Anoia;08028;Cabrera d'Anoia;1;1;U;;874;198;331;407;467;0;1;406;407
8;Barcelona;21;Maresme;08029;Cabrera de Mar;1;1;A;;885;243;469;605;280;4;10;591;601
8;Barcelona;21;Maresme;08029;Cabrera de Mar;1;1;B;;878;223;450;595;283;0;17;578;595
8;Barcelona;21;Maresme;08029;Cabrera de Mar;1;2;A;;718;181;383;483;235;1;8;474;482
8;Barcelona;21;Maresme;08029;Cabrera de Mar;1;2;B;;710;195;372;473;237;3;4;466;470
8;Barcelona;21;Maresme;08030;Cabrils;1;1;A;;825;229;426;545;280;2;15;528;543
8;Barcelona;21;Maresme;08030;Cabrils;1;1;B;;750;168;366;470;280;0;14;456;470
8;Barcelona;21;Maresme;08030;Cabrils;1;1;C;;775;233;417;514;261;2;20;492;512
8;Barcelona;21;Maresme;08030;Cabrils;1;2;A;;737;178;378;494;243;0;7;487;494
8;Barcelona;21;Maresme;08030;Cabrils;1;2;B;;732;182;364;463;269;1;9;453;462
8;Barcelona;21;Maresme;08030;Cabrils;1;2;C;;664;166;356;452;212;0;11;441;452
17;Girona;2;Alt Empordà;17032;Cadaqués;1;1;A;;795;250;385;456;339;3;7;446;453
17;Girona;2;Alt Empordà;17032;Cadaqués;1;1;B;;791;204;353;437;354;2;13;422;435
8;Barcelona;6;Anoia;08031;Calaf;1;1;U;;567;165;282;338;229;8;4;326;330
8;Barcelona;6;Anoia;08031;Calaf;1;2;A;;604;162;324;422;182;14;4;404;408
8;Barcelona;6;Anoia;08031;Calaf;1;2;B;;539;141;262;321;218;4;6;311;317
8;Barcelona;6;Anoia;08031;Calaf;1;2;C;;663;177;354;453;210;15;7;431;438
43;Tarragona;12;Baix Penedès;43037;Calafell;1;1;A;;747;171;258;325;422;1;5;319;324
43;Tarragona;12;Baix Penedès;43037;Calafell;1;1;B;;691;158;266;324;367;1;7;316;323
43;Tarragona;12;Baix Penedès;43037;Calafell;1;1;C;;726;144;253;309;417;0;5;304;309
43;Tarragona;12;Baix Penedès;43037;Calafell;1;1;D;;718;145;244;305;413;1;7;297;304
43;Tarragona;12;Baix Penedès;43037;Calafell;1;1;E;;239;42;69;97;142;0;1;96;97
43;Tarragona;12;Baix Penedès;43037;Calafell;1;2;A;;542;132;238;270;272;2;1;267;268
43;Tarragona;12;Baix Penedès;43037;Calafell;1;2;B;;623;130;258;320;303;2;4;314;318
43;Tarragona;12;Baix Penedès;43037;Calafell;1;3;A;;452;104;189;237;215;1;3;233;236
43;Tarragona;12;Baix Penedès;43037;Calafell;1;3;B;;439;109;187;235;204;1;3;231;234
43;Tarragona;12;Baix Penedès;43037;Calafell;1;3;C;;736;192;336;419;317;0;6;413;419
43;Tarragona;12;Baix Penedès;43037;Calafell;2;1;A;;481;125;204;264;217;2;2;260;262
43;Tarragona;12;Baix Penedès;43037;Calafell;2;1;B;;385;92;164;214;171;0;11;203;214
43;Tarragona;12;Baix Penedès;43037;Calafell;2;1;C;;585;152;257;327;258;1;5;321;326
43;Tarragona;12;Baix Penedès;43037;Calafell;2;1;D;;594;154;272;347;247;2;8;337;345
43;Tarragona;12;Baix Penedès;43037;Calafell;2;2;A;;621;115;200;261;360;1;2;258;260
43;Tarragona;12;Baix Penedès;43037;Calafell;2;2;B;;736;150;241;297;439;2;6;289;295
43;Tarragona;12;Baix Penedès;43037;Calafell;2;2;C;;708;125;226;296;412;0;5;291;296
43;Tarragona;12;Baix Penedès;43037;Calafell;2;3;A;;592;101;158;204;388;2;2;200;202
43;Tarragona;12;Baix Penedès;43037;Calafell;2;3;B;;579;122;182;216;363;2;2;212;214
43;Tarragona;12;Baix Penedès;43037;Calafell;2;3;C;;543;114;175;216;327;1;1;214;215
43;Tarragona;12;Baix Penedès;43037;Calafell;2;3;D;;410;71;106;128;282;1;0;127;127
43;Tarragona;12;Baix Penedès;43037;Calafell;2;3;E;;385;69;123;162;223;0;2;160;162
43;Tarragona;12;Baix Penedès;43037;Calafell;3;1;A;;700;133;214;271;429;2;3;266;269
43;Tarragona;12;Baix Penedès;43037;Calafell;3;1;B;;757;151;224;284;473;5;3;276;279
43;Tarragona;12;Baix Penedès;43037;Calafell;3;1;C;;796;152;253;308;488;1;7;300;307
8;Barcelona;;;08034;Calders;1;1;U;;672;233;406;472;200;3;9;460;469
8;Barcelona;21;Maresme;08032;Caldes d'Estrac;1;1;A;;898;271;485;583;315;4;12;567;579
8;Barcelona;21;Maresme;08032;Caldes d'Estrac;1;1;B;;998;274;498;601;397;3;8;590;598
17;Girona;34;Selva;17033;Caldes de Malavella;1;1;A;;689;165;309;383;306;4;6;373;379
17;Girona;34;Selva;17033;Caldes de Malavella;1;1;B;;672;179;314;389;283;4;3;382;385
17;Girona;34;Selva;17033;Caldes de Malavella;1;2;A;;1136;198;339;437;699;0;6;431;437
17;Girona;34;Selva;17033;Caldes de Malavella;1;2;B;;1046;202;340;421;625;2;8;411;419
17;Girona;34;Selva;17033;Caldes de Malavella;1;3;U;;939;290;461;568;371;7;9;552;561
8;Barcelona;41;Vallès Oriental;08033;Caldes de Montbui;1;1;A;;505;122;246;326;179;0;0;326;326
8;Barcelona;41;Vallès Oriental;08033;Caldes de Montbui;1;1;B;;608;160;371;381;227;2;7;372;379
8;Barcelona;41;Vallès Oriental;08033;Caldes de Montbui;1;2;A;;543;125;238;296;247;2;6;288;294
8;Barcelona;41;Vallès Oriental;08033;Caldes de Montbui;1;2;B;;587;121;215;289;298;0;2;287;289
8;Barcelona;41;Vallès Oriental;08033;Caldes de Montbui;1;2;C;;518;117;213;268;250;0;8;260;268
8;Barcelona;41;Vallès Oriental;08033;Caldes de Montbui;1;3;U;;706;191;344;436;270;3;7;426;433
8;Barcelona;41;Vallès Oriental;08033;Caldes de Montbui;2;1;A;;560;149;276;361;199;4;13;344;357
8;Barcelona;41;Vallès Oriental;08033;Caldes de Montbui;2;1;B;;557;134;229;313;244;5;10;298;308
8;Barcelona;41;Vallès Oriental;08033;Caldes de Montbui;2;1;C;;591;148;289;386;205;1;5;380;385
8;Barcelona;41;Vallès Oriental;08033;Caldes de Montbui;3;1;A;;637;167;301;385;252;0;9;376;385
8;Barcelona;41;Vallès Oriental;08033;Caldes de Montbui;3;1;B;;721;172;322;419;302;0;7;412;419
8;Barcelona;41;Vallès Oriental;08033;Caldes de Montbui;3;2;U;;646;175;310;392;254;0;11;381;392
8;Barcelona;41;Vallès Oriental;08033;Caldes de Montbui;3;3;A;;676;114;235;336;340;0;8;328;336
8;Barcelona;41;Vallès Oriental;08033;Caldes de Montbui;3;3;B;;716;125;243;330;386;1;7;322;329
8;Barcelona;41;Vallès Oriental;08033;Caldes de Montbui;3;3;C;;711;123;230;323;388;0;12;311;323
8;Barcelona;41;Vallès Oriental;08033;Caldes de Montbui;3;3;D;;759;134;271;367;392;2;9;356;365
8;Barcelona;41;Vallès Oriental;08033;Caldes de Montbui;3;4;A;;561;142;142;355;206;0;7;348;355
8;Barcelona;41;Vallès Oriental;08033;Caldes de Montbui;3;4;B;;658;164;319;405;253;0;4;401;405
8;Barcelona;41;Vallès Oriental;08033;Caldes de Montbui;3;4;C;;630;164;310;398;232;1;5;392;397
8;Barcelona;21;Maresme;08035;Calella;1;1;A;;486;157;251;302;184;1;1;300;301
8;Barcelona;21;Maresme;08035;Calella;1;1;B;;618;165;284;346;272;0;1;345;346
8;Barcelona;21;Maresme;08035;Calella;1;2;U;;806;242;410;511;295;1;12;498;510
8;Barcelona;21;Maresme;08035;Calella;1;3;A;;601;135;216;263;338;0;3;260;263
8;Barcelona;21;Maresme;08035;Calella;1;3;B;;786;193;290;364;422;1;4;359;363
8;Barcelona;21;Maresme;08035;Calella;2;1;U;;702;151;316;410;292;2;12;396;408
8;Barcelona;21;Maresme;08035;Calella;2;2;A;;476;126;219;282;194;4;2;276;278
8;Barcelona;21;Maresme;08035;Calella;2;2;B;;513;111;226;274;239;0;2;272;274
8;Barcelona;21;Maresme;08035;Calella;2;2;C;;539;161;268;346;193;0;6;340;346
8;Barcelona;21;Maresme;08035;Calella;3;1;A;;544;160;258;340;204;2;5;333;338
8;Barcelona;21;Maresme;08035;Calella;3;1;B;;562;146;250;312;250;0;7;305;312
8;Barcelona;21;Maresme;08035;Calella;3;1;C;;596;160;282;362;234;2;4;356;360
8;Barcelona;21;Maresme;08035;Calella;3;2;A;;576;134;256;319;257;0;13;306;319
8;Barcelona;21;Maresme;08035;Calella;3;2;B;;681;173;281;349;332;4;8;337;345
8;Barcelona;21;Maresme;08035;Calella;3;2;C;;651;191;298;359;292;2;4;353;357
8;Barcelona;21;Maresme;08035;Calella;3;3;A;;643;165;285;360;283;1;2;357;359
8;Barcelona;21;Maresme;08035;Calella;3;3;B;;495;101;197;262;233;0;1;261;262
8;Barcelona;21;Maresme;08035;Calella;3;3;C;;799;197;325;413;386;1;2;410;412
8;Barcelona;21;Maresme;08035;Calella;3;3;D;;566;155;248;308;258;0;6;302;308
8;Barcelona;24;Osona;08037;Calldetenes;1;1;A;;833;256;486;578;255;4;10;564;574
8;Barcelona;24;Osona;08037;Calldetenes;1;1;B;;852;256;449;562;290;4;13;545;558
8;Barcelona;7;Bages;08038;Callús;1;1;A;;536;123;290;345;191;0;15;330;345
8;Barcelona;7;Bages;08038;Callús;1;1;B;;678;143;357;433;245;2;12;419;431
17;Girona;10;Baix Empordà;17034;Calonge i Sant Antoni;1;1;A;;508;112;226;272;236;2;3;267;270
17;Girona;10;Baix Empordà;17034;Calonge i Sant Antoni;1;1;B;;608;124;251;309;299;3;2;304;306
17;Girona;10;Baix Empordà;17034;Calonge i Sant Antoni;1;1;C;;682;155;300;371;311;3;8;360;368
17;Girona;10;Baix Empordà;17034;Calonge i Sant Antoni;1;2;A;;533;139;234;290;243;9;4;277;281
17;Girona;10;Baix Empordà;17034;Calonge i Sant Antoni;1;2;B;;580;158;240;298;282;4;7;287;294
17;Girona;10;Baix Empordà;17034;Calonge i Sant Antoni;1;3;A;;606;137;277;330;276;0;14;316;330
17;Girona;10;Baix Empordà;17034;Calonge i Sant Antoni;1;3;B;;538;125;218;276;262;0;15;261;276
17;Girona;10;Baix Empordà;17034;Calonge i Sant Antoni;1;4;A;;557;123;217;276;281;2;6;268;274
17;Girona;10;Baix Empordà;17034;Calonge i Sant Antoni;1;4;B;;638;143;263;319;319;1;6;312;318
17;Girona;10;Baix Empordà;17034;Calonge i Sant Antoni;1;5;U;;921;207;357;438;483;1;4;433;437
8;Barcelona;6;Anoia;08036;Calonge de Segarra;1;1;U;;171;43;101;118;53;1;3;114;117
25;Lleida;23;Noguera;25062;Camarasa;1;1;U;;819;225;424;534;285;2;14;518;532
43;Tarragona;9;Baix Ebre;43903;Camarles;1;1;A;;604;160;280;371;233;1;2;368;370
43;Tarragona;9;Baix Ebre;43903;Camarles;1;1;B;;566;127;244;312;254;1;6;305;311
43;Tarragona;9;Baix Ebre;43903;Camarles;1;1;C;;445;96;171;237;208;0;0;237;237
43;Tarragona;9;Baix Ebre;43903;Camarles;1;2;A;;388;71;130;177;211;0;1;176;177
43;Tarragona;9;Baix Ebre;43903;Camarles;1;2;B;;364;66;125;171;193;0;2;169;171
43;Tarragona;8;Baix Camp;43038;Cambrils;1;1;A;;570;122;211;281;289;1;1;279;280
43;Tarragona;8;Baix Camp;43038;Cambrils;1;1;B;;696;163;280;357;339;0;8;349;357
43;Tarragona;8;Baix Camp;43038;Cambrils;1;2;A;;871;165;321;415;456;3;6;406;412
43;Tarragona;8;Baix Camp;43038;Cambrils;1;2;B;;984;209;378;490;494;3;10;477;487
43;Tarragona;8;Baix Camp;43038;Cambrils;1;3;A;;574;100;226;282;292;1;7;274;281
43;Tarragona;8;Baix Camp;43038;Cambrils;1;3;B;;602;123;222;294;308;1;4;289;293
43;Tarragona;8;Baix Camp;43038;Cambrils;1;3;C;;567;124;223;293;274;1;4;288;292
43;Tarragona;8;Baix Camp;43038;Cambrils;1;4;A;;562;93;179;222;340;0;0;222;222
43;Tarragona;8;Baix Camp;43038;Cambrils;1;4;B;;724;124;226;294;430;1;4;289;293
43;Tarragona;8;Baix Camp;43038;Cambrils;1;4;C;;638;134;232;294;344;2;4;288;292
43;Tarragona;8;Baix Camp;43038;Cambrils;1;5;A;;507;114;195;271;236;0;9;262;271
43;Tarragona;8;Baix Camp;43038;Cambrils;1;5;B;;564;112;206;290;274;1;6;283;289
43;Tarragona;8;Baix Camp;43038;Cambrils;2;1;A;;654;214;327;398;256;1;5;392;397
43;Tarragona;8;Baix Camp;43038;Cambrils;2;1;B;;678;182;307;372;306;2;10;360;370
43;Tarragona;8;Baix Camp;43038;Cambrils;2;2;A;;540;144;228;285;255;2;2;281;283
43;Tarragona;8;Baix Camp;43038;Cambrils;2;2;B;;531;143;226;255;276;0;6;249;255
43;Tarragona;8;Baix Camp;43038;Cambrils;2;3;A;;619;128;242;330;289;0;11;319;330
43;Tarragona;8;Baix Camp;43038;Cambrils;2;3;B;;793;160;341;438;355;1;6;431;437
43;Tarragona;8;Baix Camp;43038;Cambrils;2;4;A;;421;84;142;189;232;0;3;186;189
43;Tarragona;8;Baix Camp;43038;Cambrils;2;4;B;;492;124;177;233;259;1;2;230;232
43;Tarragona;8;Baix Camp;43038;Cambrils;2;5;A;;765;166;302;394;371;2;13;379;392
43;Tarragona;8;Baix Camp;43038;Cambrils;2;5;B;;874;162;320;435;439;0;13;422;435
43;Tarragona;8;Baix Camp;43038;Cambrils;2;6;A;;690;128;225;291;399;0;5;286;291
43;Tarragona;8;Baix Camp;43038;Cambrils;2;6;B;;770;133;245;327;443;3;6;318;324
43;Tarragona;8;Baix Camp;43038;Cambrils;2;7;A;;547;116;225;309;238;0;1;308;309
43;Tarragona;8;Baix Camp;43038;Cambrils;2;7;B;;501;111;210;279;222;1;8;270;278
43;Tarragona;8;Baix Camp;43038;Cambrils;2;7;C;;671;161;287;382;289;0;8;374;382
43;Tarragona;8;Baix Camp;43038;Cambrils;2;7;D;;521;103;204;281;240;0;3;278;281
43;Tarragona;8;Baix Camp;43038;Cambrils;2;8;A;;418;104;154;197;221;1;3;193;196
43;Tarragona;8;Baix Camp;43038;Cambrils;2;8;B;;463;90;156;201;262;0;0;201;201
17;Girona;28;Pla de l'Estany;17035;Camós;1;1;U;;566;178;341;394;172;4;9;381;390
17;Girona;31;Ripollès;17036;Campdevànol;1;1;A;;564;150;284;354;210;4;6;344;350
17;Girona;31;Ripollès;17036;Campdevànol;1;1;B;;628;160;335;432;196;10;14;408;422
17;Girona;31;Ripollès;17036;Campdevànol;1;2;A;;411;122;217;269;142;3;3;263;266
17;Girona;31;Ripollès;17036;Campdevànol;1;2;B;;443;108;208;260;183;2;4;254;258
17;Girona;31;Ripollès;17036;Campdevànol;1;3;A;;434;95;191;250;184;3;6;241;247
17;Girona;31;Ripollès;17036;Campdevànol;1;3;B;;420;108;186;248;172;2;5;241;246
17;Girona;31;Ripollès;17037;Campelles;1;1;U;;101;23;56;71;30;0;3;68;71
8;Barcelona;41;Vallès Oriental;08039;Campins;1;1;U;;286;109;167;205;81;0;12;193;205
17;Girona;20;Gironès;17038;Campllong;1;1;U;;290;81;157;202;88;1;6;195;201
17;Girona;31;Ripollès;17039;Camprodon;1;1;A;;598;193;346;440;158;3;9;428;437
17;Girona;31;Ripollès;17039;Camprodon;1;1;B;;640;206;382;467;173;1;16;450;466
17;Girona;31;Ripollès;17039;Camprodon;1;2;U;;716;194;346;428;288;2;19;407;426
25;Lleida;39;Consell General d'Aran;25063;Canejan;1;1;U;;89;14;30;44;45;0;0;44;44
17;Girona;20;Gironès;17040;Canet d'Adri;1;1;U;;498;156;266;322;176;2;3;317;320
8;Barcelona;21;Maresme;08040;Canet de Mar;1;1;A;;750;219;378;461;289;1;11;449;460
8;Barcelona;21;Maresme;08040;Canet de Mar;1;1;B;;747;215;360;444;303;0;14;430;444
8;Barcelona;21;Maresme;08040;Canet de Mar;1;1;C;;829;254;408;505;324;2;7;496;503
8;Barcelona;21;Maresme;08040;Canet de Mar;1;2;A;;755;228;354;425;330;0;9;416;425
8;Barcelona;21;Maresme;08040;Canet de Mar;1;2;B;;770;202;334;410;360;2;8;400;408
8;Barcelona;21;Maresme;08040;Canet de Mar;1;2;C;;771;236;367;437;334;0;9;428;437
8;Barcelona;21;Maresme;08040;Canet de Mar;1;3;A;;701;203;342;425;276;1;8;416;424
8;Barcelona;21;Maresme;08040;Canet de Mar;1;3;B;;790;227;377;463;327;2;7;454;461
8;Barcelona;21;Maresme;08040;Canet de Mar;1;3;C;;674;206;347;430;244;3;9;418;427
8;Barcelona;21;Maresme;08040;Canet de Mar;1;4;A;;751;198;364;454;297;2;14;438;452
8;Barcelona;21;Maresme;08040;Canet de Mar;1;4;B;;601;169;286;354;247;3;8;343;351
8;Barcelona;21;Maresme;08040;Canet de Mar;1;4;C;;865;205;398;508;357;0;14;494;508
8;Barcelona;21;Maresme;08040;Canet de Mar;1;4;D;;773;164;321;405;368;4;6;395;401
8;Barcelona;41;Vallès Oriental;08041;Canovelles;1;1;A;;596;124;241;305;291;3;5;297;302
8;Barcelona;41;Vallès Oriental;08041;Canovelles;1;1;B;;827;162;313;410;417;3;4;403;407
8;Barcelona;41;Vallès Oriental;08041;Canovelles;1;2;A;;534;132;234;272;262;0;4;268;272
8;Barcelona;41;Vallès Oriental;08041;Canovelles;1;2;B;;645;160;274;338;307;0;9;329;338
8;Barcelona;41;Vallès Oriental;08041;Canovelles;1;3;A;;521;121;193;238;283;1;8;229;237
8;Barcelona;41;Vallès Oriental;08041;Canovelles;1;3;B;;616;142;240;273;343;0;5;268;273
8;Barcelona;41;Vallès Oriental;08041;Canovelles;1;4;U;;981;170;314;401;580;1;5;395;400
8;Barcelona;41;Vallès Oriental;08041;Canovelles;1;5;A;;376;106;171;200;176;1;3;196;199
8;Barcelona;41;Vallès Oriental;08041;Canovelles;1;5;B;;580;132;216;265;315;2;6;257;263
8;Barcelona;41;Vallès Oriental;08041;Canovelles;1;6;A;;579;133;228;295;284;0;2;293;295
8;Barcelona;41;Vallès Oriental;08041;Canovelles;1;6;B;;863;204;381;458;405;0;9;449;458
8;Barcelona;41;Vallès Oriental;08041;Canovelles;1;7;A;;691;157;303;411;280;0;8;403;411
8;Barcelona;41;Vallès Oriental;08041;Canovelles;1;7;B;;870;203;410;505;365;3;10;492;502
8;Barcelona;41;Vallès Oriental;08041;Canovelles;1;8;A;;657;136;286;371;286;0;6;365;371
8;Barcelona;41;Vallès Oriental;08041;Canovelles;1;8;B;;901;187;376;496;405;2;14;480;494
8;Barcelona;41;Vallès Oriental;08042;Cànoves i Samalús;1;1;A;;656;185;316;399;257;1;7;391;398
8;Barcelona;41;Vallès Oriental;08042;Cànoves i Samalús;1;1;B;;704;196;311;389;315;3;9;377;386
8;Barcelona;41;Vallès Oriental;08042;Cànoves i Samalús;1;1;C;;641;166;285;356;285;1;2;353;355
17;Girona;2;Alt Empordà;17041;Cantallops;1;1;U;;218;55;106;131;87;1;2;128;130
8;Barcelona;17;Garraf;08043;Canyelles;1;1;A;;814;220;338;419;395;0;6;413;419
8;Barcelona;17;Garraf;08043;Canyelles;1;1;B;;997;208;371;461;536;0;0;461;461
8;Barcelona;17;Garraf;08043;Canyelles;1;1;C;;840;188;314;413;427;0;5;408;413
43;Tarragona;8;Baix Camp;43039;Capafonts;1;1;U;;111;30;66;81;30;0;1;80;81
43;Tarragona;29;Priorat;43040;Capçanes;1;1;U;;350;97;183;233;117;1;5;227;232
8;Barcelona;6;Anoia;08044;Capellades;1;1;A;;586;126;247;328;258;5;2;321;323
8;Barcelona;6;Anoia;08044;Capellades;1;1;B;;713;132;247;368;345;1;7;360;367
8;Barcelona;6;Anoia;08044;Capellades;1;1;C;;597;138;254;339;258;1;3;335;338
8;Barcelona;6;Anoia;08044;Capellades;2;1;A;;502;132;260;336;166;1;8;327;335
8;Barcelona;6;Anoia;08044;Capellades;2;1;B;;610;137;319;408;202;7;3;398;401
8;Barcelona;6;Anoia;08044;Capellades;2;2;A;;526;132;242;337;189;5;9;323;332
8;Barcelona;6;Anoia;08044;Capellades;2;2;B;;685;184;343;434;251;5;9;420;429
17;Girona;2;Alt Empordà;17042;Capmany;1;1;U;;379;62;244;283;96;3;2;278;280
8;Barcelona;14;Berguedà;08045;Capolat;1;1;U;;67;17;30;47;20;0;1;46;47
8;Barcelona;41;Vallès Oriental;08046;Cardedeu;1;1;A;;517;135;293;360;157;4;11;345;356
8;Barcelona;41;Vallès Oriental;08046;Cardedeu;1;1;B;;468;123;241;303;165;0;6;297;303
8;Barcelona;41;Vallès Oriental;08046;Cardedeu;1;2;A;;677;186;371;469;208;6;13;450;463
8;Barcelona;41;Vallès Oriental;08046;Cardedeu;1;2;B;;682;195;352;442;240;5;13;424;437
8;Barcelona;41;Vallès Oriental;08046;Cardedeu;1;3;A;;523;152;258;337;186;3;4;330;334
8;Barcelona;41;Vallès Oriental;08046;Cardedeu;1;3;B;;552;155;286;354;198;2;11;341;352
8;Barcelona;41;Vallès Oriental;08046;Cardedeu;2;1;A;;540;154;340;316;224;1;9;306;315
8;Barcelona;41;Vallès Oriental;08046;Cardedeu;2;1;B;;603;138;251;331;272;0;8;323;331
8;Barcelona;41;Vallès Oriental;08046;Cardedeu;2;1;C;;633;149;282;360;273;2;0;358;358
8;Barcelona;41;Vallès Oriental;08046;Cardedeu;2;2;A;;556;163;292;349;207;2;9;338;347
8;Barcelona;41;Vallès Oriental;08046;Cardedeu;2;2;B;;529;149;278;332;197;4;11;317;328
8;Barcelona;41;Vallès Oriental;08046;Cardedeu;2;3;A;;659;197;349;438;221;3;10;425;435
8;Barcelona;41;Vallès Oriental;08046;Cardedeu;2;3;B;;611;148;299;381;230;2;6;373;379
8;Barcelona;41;Vallès Oriental;08046;Cardedeu;2;4;A;;658;183;328;408;250;2;14;392;406
8;Barcelona;41;Vallès Oriental;08046;Cardedeu;2;4;B;;702;179;335;418;284;1;12;405;417
8;Barcelona;41;Vallès Oriental;08046;Cardedeu;2;4;C;;696;187;350;442;254;2;15;425;440
8;Barcelona;41;Vallès Oriental;08046;Cardedeu;3;1;A;;637;144;296;365;272;2;7;356;363
8;Barcelona;41;Vallès Oriental;08046;Cardedeu;3;1;B;;688;158;294;358;330;1;12;345;357
8;Barcelona;41;Vallès Oriental;08046;Cardedeu;3;1;C;;716;184;343;404;312;3;4;397;401
8;Barcelona;7;Bages;08047;Cardona;1;1;A;;367;85;176;215;152;2;3;210;213
8;Barcelona;7;Bages;08047;Cardona;1;1;B;;299;71;148;176;123;0;5;171;176
8;Barcelona;7;Bages;08047;Cardona;1;1;C;;361;80;168;205;156;1;9;195;204
8;Barcelona;7;Bages;08047;Cardona;1;2;A;;381;89;192;237;144;4;3;230;233
8;Barcelona;7;Bages;08047;Cardona;1;2;B;;391;102;176;215;176;2;4;209;213
8;Barcelona;7;Bages;08047;Cardona;1;3;A;;689;118;292;371;318;1;11;359;370
8;Barcelona;7;Bages;08047;Cardona;1;3;B;;702;131;316;400;302;2;9;389;398
8;Barcelona;7;Bages;08047;Cardona;2;1;U;;705;149;290;373;332;3;7;363;370
8;Barcelona;7;Bages;08047;Cardona;2;3;U;;471;111;222;275;196;1;5;269;274
8;Barcelona;6;Anoia;08048;Carme;1;1;U;;600;153;341;411;189;0;3;408;411
43;Tarragona;37;Terra Alta;43041;Caseres;1;1;U;;264;54;169;195;69;0;6;189;195
17;Girona;20;Gironès;17044;Cassà de la Selva;1;1;A;;705;202;365;455;250;4;11;440;451
17;Girona;20;Gironès;17044;Cassà de la Selva;1;1;B;;661;213;380;434;227;2;11;421;432
17;Girona;20;Gironès;17044;Cassà de la Selva;1;2;A;;558;158;284;339;219;3;3;333;336
17;Girona;20;Gironès;17044;Cassà de la Selva;1;2;B;;621;147;281;344;277;3;6;335;341
17;Girona;20;Gironès;17044;Cassà de la Selva;2;1;A;;826;255;422;500;326;3;5;492;497
17;Girona;20;Gironès;17044;Cassà de la Selva;2;1;B;;833;269;422;498;335;5;7;486;493
17;Girona;20;Gironès;17044;Cassà de la Selva;2;2;A;;818;300;440;505;313;7;7;491;498
17;Girona;20;Gironès;17044;Cassà de la Selva;2;2;B;;778;220;388;446;332;3;9;434;443
17;Girona;20;Gironès;17044;Cassà de la Selva;2;3;U;;650;213;380;458;192;1;5;452;457
8;Barcelona;14;Berguedà;08049;Casserres;1;1;A;;1129;317;611;747;382;7;17;723;740
8;Barcelona;14;Berguedà;08049;Casserres;1;1;B;;240;57;105;134;106;1;2;131;133
25;Lleida;35;Solsonès;25064;Castellar de la Ribera;1;1;U;;136;38;89;112;24;1;3;108;111
8;Barcelona;14;Berguedà;08050;Castellar del Riu;1;1;U;;119;44;64;85;34;1;2;82;84
8;Barcelona;40;Vallès Occidental;08051;Castellar del Vallès;1;1;U;;882;252;433;546;336;4;8;534;542
8;Barcelona;40;Vallès Occidental;08051;Castellar del Vallès;1;10;A;;482;116;215;296;186;0;9;287;296
8;Barcelona;40;Vallès Occidental;08051;Castellar del Vallès;1;10;B;;551;112;228;331;220;0;9;322;331
8;Barcelona;40;Vallès Occidental;08051;Castellar del Vallès;1;11;U;;643;149;318;413;230;1;15;397;412
8;Barcelona;40;Vallès Occidental;08051;Castellar del Vallès;1;12;U;;633;106;218;280;353;0;4;276;280
8;Barcelona;40;Vallès Occidental;08051;Castellar del Vallès;1;13;A;;550;97;205;288;262;1;6;281;287
8;Barcelona;40;Vallès Occidental;08051;Castellar del Vallès;1;13;B;;700;119;241;355;345;2;11;342;353
8;Barcelona;40;Vallès Occidental;08051;Castellar del Vallès;1;2;A;;815;227;410;521;294;1;5;515;520
8;Barcelona;40;Vallès Occidental;08051;Castellar del Vallès;1;2;B;;1072;273;520;687;385;1;11;675;686
8;Barcelona;40;Vallès Occidental;08051;Castellar del Vallès;1;3;A;;574;160;276;350;224;0;13;337;350
8;Barcelona;40;Vallès Occidental;08051;Castellar del Vallès;1;3;B;;704;171;304;408;296;3;9;396;405
8;Barcelona;40;Vallès Occidental;08051;Castellar del Vallès;1;4;A;;735;194;354;435;300;3;7;425;432
8;Barcelona;40;Vallès Occidental;08051;Castellar del Vallès;1;4;B;;856;192;372;481;375;3;8;470;478
8;Barcelona;40;Vallès Occidental;08051;Castellar del Vallès;1;5;A;;605;184;317;399;206;5;2;392;394
8;Barcelona;40;Vallès Occidental;08051;Castellar del Vallès;1;5;B;;728;237;369;478;250;6;7;465;472
8;Barcelona;40;Vallès Occidental;08051;Castellar del Vallès;1;6;A;;555;103;201;274;281;2;6;266;272
8;Barcelona;40;Vallès Occidental;08051;Castellar del Vallès;1;6;B;;568;103;195;272;296;2;5;265;270
8;Barcelona;40;Vallès Occidental;08051;Castellar del Vallès;1;7;A;;690;161;336;421;269;2;7;412;419
8;Barcelona;40;Vallès Occidental;08051;Castellar del Vallès;1;7;B;;762;145;309;404;358;4;4;396;400
8;Barcelona;40;Vallès Occidental;08051;Castellar del Vallès;1;8;A;;714;172;319;433;281;0;9;424;433
8;Barcelona;40;Vallès Occidental;08051;Castellar del Vallès;1;8;B;;839;194;334;465;374;0;10;455;465
8;Barcelona;40;Vallès Occidental;08051;Castellar del Vallès;1;9;A;;773;210;366;486;287;2;9;475;484
8;Barcelona;40;Vallès Occidental;08051;Castellar del Vallès;1;9;B;;797;207;342;468;329;0;14;454;468
8;Barcelona;14;Berguedà;08052;Castellar de n'Hug;1;1;U;;176;52;84;112;64;0;0;112;112
8;Barcelona;7;Bages;08053;Castellbell i el Vilar;1;1;A;;633;182;338;390;243;2;6;382;388
8;Barcelona;7;Bages;08053;Castellbell i el Vilar;1;1;B;;832;237;408;494;338;0;7;487;494
8;Barcelona;7;Bages;08053;Castellbell i el Vilar;1;2;U;;1337;311;499;611;726;1;10;600;610
8;Barcelona;40;Vallès Occidental;08054;Castellbisbal;1;1;A;;881;183;183;475;406;2;14;459;473
8;Barcelona;40;Vallès Occidental;08054;Castellbisbal;1;1;B;;909;180;380;488;421;1;6;481;487
8;Barcelona;40;Vallès Occidental;08054;Castellbisbal;1;2;A;;1015;210;342;442;573;4;9;429;438
8;Barcelona;40;Vallès Occidental;08054;Castellbisbal;1;2;B;;1018;205;372;458;560;3;7;448;455
8;Barcelona;40;Vallès Occidental;08054;Castellbisbal;1;3;A;;719;178;315;418;301;2;12;404;416
8;Barcelona;40;Vallès Occidental;08054;Castellbisbal;1;3;B;;687;185;334;437;250;2;9;426;435
8;Barcelona;40;Vallès Occidental;08054;Castellbisbal;1;4;A;;721;148;327;451;270;0;8;443;451
8;Barcelona;40;Vallès Occidental;08054;Castellbisbal;1;4;B;;757;174;371;492;265;1;14;477;491
8;Barcelona;40;Vallès Occidental;08054;Castellbisbal;1;5;A;;800;159;317;407;393;1;13;393;406
8;Barcelona;40;Vallès Occidental;08054;Castellbisbal;1;5;B;;755;150;272;362;393;0;5;357;362
8;Barcelona;;;08055;Castellcir;1;1;U;;424;134;222;281;143;2;6;273;279
25;Lleida;18;Garrigues;25067;Castelldans;1;1;U;;789;180;410;509;280;1;12;496;508
8;Barcelona;11;Baix Llobregat;08056;Castelldefels;1;1;U;;693;154;251;306;387;0;2;304;306
8;Barcelona;11;Baix Llobregat;08056;Castelldefels;1;2;A;;610;91;182;239;371;1;5;233;238
8;Barcelona;11;Baix Llobregat;08056;Castelldefels;1;2;B;;651;104;198;252;399;0;5;247;252
8;Barcelona;11;Baix Llobregat;08056;Castelldefels;1;3;A;;897;212;346;448;449;0;17;431;448
8;Barcelona;11;Baix Llobregat;08056;Castelldefels;1;3;B;;1029;220;387;531;498;4;11;516;527
8;Barcelona;11;Baix Llobregat;08056;Castelldefels;1;4;A;;747;150;276;345;402;1;5;339;344
8;Barcelona;11;Baix Llobregat;08056;Castelldefels;1;4;B;;766;156;251;338;428;1;11;326;337
8;Barcelona;11;Baix Llobregat;08056;Castelldefels;1;5;A;;644;127;220;292;352;2;2;288;290
8;Barcelona;11;Baix Llobregat;08056;Castelldefels;1;5;B;;736;146;232;306;430;0;6;300;306
8;Barcelona;11;Baix Llobregat;08056;Castelldefels;1;6;A;;547;139;221;285;262;0;7;278;285
8;Barcelona;11;Baix Llobregat;08056;Castelldefels;1;6;B;;776;171;297;382;394;1;9;372;381
8;Barcelona;11;Baix Llobregat;08056;Castelldefels;1;6;C;;618;150;245;309;309;1;4;304;308
8;Barcelona;11;Baix Llobregat;08056;Castelldefels;1;7;A;;868;162;324;451;417;0;12;439;451
8;Barcelona;11;Baix Llobregat;08056;Castelldefels;1;7;B;;1013;221;401;525;488;1;11;513;524
8;Barcelona;11;Baix Llobregat;08056;Castelldefels;2;1;A;;605;156;258;334;271;0;16;318;334
8;Barcelona;11;Baix Llobregat;08056;Castelldefels;2;1;B;;618;134;223;276;342;2;5;269;274
8;Barcelona;11;Baix Llobregat;08056;Castelldefels;2;2;A;;555;154;230;279;276;0;4;275;279
8;Barcelona;11;Baix Llobregat;08056;Castelldefels;2;2;B;;629;171;269;359;270;0;6;353;359
8;Barcelona;11;Baix Llobregat;08056;Castelldefels;2;3;A;;564;146;245;308;256;0;5;303;308
8;Barcelona;11;Baix Llobregat;08056;Castelldefels;2;3;B;;581;128;236;301;280;0;5;296;301
8;Barcelona;11;Baix Llobregat;08056;Castelldefels;2;4;A;;846;191;359;446;400;2;7;437;444
8;Barcelona;11;Baix Llobregat;08056;Castelldefels;2;4;B;;913;242;408;490;423;2;15;473;488
8;Barcelona;11;Baix Llobregat;08056;Castelldefels;2;5;A;;540;142;223;307;233;0;7;300;307
8;Barcelona;11;Baix Llobregat;08056;Castelldefels;2;5;B;;635;157;279;357;278;2;6;349;355
8;Barcelona;11;Baix Llobregat;08056;Castelldefels;2;6;A;;472;117;186;235;237;0;2;233;235
8;Barcelona;11;Baix Llobregat;08056;Castelldefels;2;6;B;;561;154;240;291;270;0;5;286;291
8;Barcelona;11;Baix Llobregat;08056;Castelldefels;3;1;U;;838;186;291;393;445;0;10;383;393
8;Barcelona;11;Baix Llobregat;08056;Castelldefels;3;2;A;;660;162;304;389;271;1;15;373;388
8;Barcelona;11;Baix Llobregat;08056;Castelldefels;3;2;B;;642;144;280;359;283;0;14;345;359
8;Barcelona;11;Baix Llobregat;08056;Castelldefels;3;3;A;;573;100;184;258;315;2;7;249;256
8;Barcelona;11;Baix Llobregat;08056;Castelldefels;3;3;B;;718;144;250;347;371;3;6;338;344
8;Barcelona;11;Baix Llobregat;08056;Castelldefels;3;3;C;;652;122;235;301;351;1;4;296;300
8;Barcelona;11;Baix Llobregat;08056;Castelldefels;3;4;A;;765;219;356;463;302;3;17;443;460
8;Barcelona;11;Baix Llobregat;08056;Castelldefels;3;4;B;;859;229;388;496;363;1;16;479;495
8;Barcelona;11;Baix Llobregat;08056;Castelldefels;3;5;U;;810;215;425;529;281;3;16;510;526
8;Barcelona;11;Baix Llobregat;08056;Castelldefels;4;1;A;;694;166;319;419;275;2;7;410;417
8;Barcelona;11;Baix Llobregat;08056;Castelldefels;4;1;B;;740;175;361;442;298;1;15;426;441
8;Barcelona;11;Baix Llobregat;08056;Castelldefels;4;1;C;;711;168;325;424;287;1;10;413;423
8;Barcelona;11;Baix Llobregat;08056;Castelldefels;4;2;A;;607;145;240;309;298;1;2;306;308
8;Barcelona;11;Baix Llobregat;08056;Castelldefels;4;2;B;;693;138;258;352;341;0;5;347;352
8;Barcelona;11;Baix Llobregat;08056;Castelldefels;4;3;A;;699;145;258;332;367;1;3;328;331
8;Barcelona;11;Baix Llobregat;08056;Castelldefels;4;3;B;;801;193;331;430;371;2;7;421;428
8;Barcelona;11;Baix Llobregat;08056;Castelldefels;4;4;A;;823;136;262;348;475;0;9;339;348
8;Barcelona;11;Baix Llobregat;08056;Castelldefels;4;4;B;;794;178;284;366;428;4;9;353;362
8;Barcelona;11;Baix Llobregat;08056;Castelldefels;5;1;A;;902;210;377;481;421;1;11;469;480
8;Barcelona;11;Baix Llobregat;08056;Castelldefels;5;1;B;;986;236;451;561;425;0;9;552;561
8;Barcelona;11;Baix Llobregat;08056;Castelldefels;5;2;A;;782;157;301;389;393;0;7;382;389
8;Barcelona;11;Baix Llobregat;08056;Castelldefels;5;2;B;;837;173;331;421;416;1;5;415;420
8;Barcelona;11;Baix Llobregat;08056;Castelldefels;5;3;A;;662;124;237;300;362;1;5;294;299
8;Barcelona;11;Baix Llobregat;08056;Castelldefels;5;3;B;;737;151;264;338;399;1;10;327;337
8;Barcelona;11;Baix Llobregat;08056;Castelldefels;5;4;A;;842;193;396;506;336;0;11;495;506
8;Barcelona;11;Baix Llobregat;08056;Castelldefels;5;4;B;;955;235;450;581;374;0;11;570;581
8;Barcelona;14;Berguedà;08057;Castell de l'Areny;1;1;U;;61;12;33;41;20;0;1;40;41
25;Lleida;25;Pallars Jussà;25904;Castell de Mur;1;1;U;;146;39;86;108;38;0;2;106;108
8;Barcelona;3;Alt Penedès;08058;Castellet i la Gornal;1;1;U;;428;106;210;264;164;4;1;259;260
8;Barcelona;3;Alt Penedès;08058;Castellet i la Gornal;1;2;U;;1112;252;446;531;581;4;10;517;527
17;Girona;19;Garrotxa;17046;Castellfollit de la Roca;1;1;A;;356;128;226;249;107;0;7;242;249
17;Girona;19;Garrotxa;17046;Castellfollit de la Roca;1;1;B;;400;164;262;288;112;1;5;282;287
8;Barcelona;7;Bages;08059;Castellfollit del Boix;1;1;U;;329;82;144;201;128;0;10;191;201
8;Barcelona;6;Anoia;08060;Castellfollit de Riubregós;1;1;U;;170;50;94;119;51;0;5;114;119
8;Barcelona;7;Bages;08061;Castellgalí;1;1;U;;1137;325;532;619;518;4;6;609;615
8;Barcelona;7;Bages;08062;Castellnou de Bages;1;1;U;;690;191;319;415;275;1;13;401;414
25;Lleida;27;Pla d'Urgell;25068;Castellnou de Seana;1;1;U;;613;175;341;403;210;2;6;395;401
17;Girona;2;Alt Empordà;17047;Castelló d'Empúries;1;1;A;;667;177;287;357;310;0;4;353;357
17;Girona;2;Alt Empordà;17047;Castelló d'Empúries;1;1;B;;721;180;298;359;362;3;4;352;356
17;Girona;2;Alt Empordà;17047;Castelló d'Empúries;1;2;A;;593;180;312;377;216;0;6;371;377
17;Girona;2;Alt Empordà;17047;Castelló d'Empúries;1;2;B;;557;175;291;344;213;1;7;336;343
17;Girona;2;Alt Empordà;17047;Castelló d'Empúries;1;3;A;;551;135;222;262;289;1;2;259;261
17;Girona;2;Alt Empordà;17047;Castelló d'Empúries;1;3;B;;559;100;165;218;341;0;0;218;218
17;Girona;2;Alt Empordà;17047;Castelló d'Empúries;1;4;A;;414;58;119;156;258;0;1;155;156
17;Girona;2;Alt Empordà;17047;Castelló d'Empúries;1;4;B;;387;61;118;147;240;2;1;144;145
25;Lleida;23;Noguera;25069;Castelló de Farfanya;1;1;U;;490;84;236;305;185;2;9;294;303
8;Barcelona;6;Anoia;08063;Castellolí;1;1;U;;371;113;223;300;71;0;6;294;300
17;Girona;10;Baix Empordà;17048;Castell-Platja d'Aro;1;1;A;;528;134;263;323;205;4;11;308;319
17;Girona;10;Baix Empordà;17048;Castell-Platja d'Aro;1;1;B;;548;162;274;333;215;6;8;319;327
17;Girona;10;Baix Empordà;17048;Castell-Platja d'Aro;1;2;A;;809;178;296;356;453;1;4;351;355
17;Girona;10;Baix Empordà;17048;Castell-Platja d'Aro;1;2;B;;747;180;284;369;378;2;3;364;367
17;Girona;10;Baix Empordà;17048;Castell-Platja d'Aro;1;3;A;;810;179;318;425;385;2;10;413;423
17;Girona;10;Baix Empordà;17048;Castell-Platja d'Aro;1;3;B;;810;207;335;420;390;5;3;412;415
17;Girona;10;Baix Empordà;17048;Castell-Platja d'Aro;1;4;U;;803;196;306;403;400;0;7;396;403
17;Girona;10;Baix Empordà;17048;Castell-Platja d'Aro;1;5;U;;888;204;376;468;420;5;3;460;463
25;Lleida;38;Urgell;25070;Castellserà;1;1;U;;911;248;504;621;290;3;19;599;618
8;Barcelona;;;08064;Castellterçol;1;1;A;;866;291;518;634;232;4;14;616;630
8;Barcelona;;;08064;Castellterçol;1;1;B;;859;266;483;605;254;10;14;581;595
43;Tarragona;8;Baix Camp;43042;Castellvell del Camp;1;1;A;;555;135;255;343;212;3;5;335;340
43;Tarragona;8;Baix Camp;43042;Castellvell del Camp;1;1;B;;571;143;261;349;222;3;6;340;346
43;Tarragona;8;Baix Camp;43042;Castellvell del Camp;1;1;C;;660;174;392;442;218;0;9;433;442
8;Barcelona;3;Alt Penedès;08065;Castellví de la Marca;1;1;U;;1221;289;645;723;498;7;18;698;716
8;Barcelona;11;Baix Llobregat;08066;Castellví de Rosanes;1;1;A;;417;133;255;305;112;1;4;300;304
8;Barcelona;11;Baix Llobregat;08066;Castellví de Rosanes;1;1;B;;424;91;190;273;151;5;1;267;268
8;Barcelona;11;Baix Llobregat;08066;Castellví de Rosanes;1;1;C;;297;85;166;200;97;0;2;198;200
43;Tarragona;36;Tarragonès;43043;Catllar, el;1;1;A;;636;115;214;289;347;0;9;280;289
43;Tarragona;36;Tarragonès;43043;Catllar, el;1;1;B;;825;185;305;386;439;2;13;371;384
43;Tarragona;36;Tarragonès;43043;Catllar, el;1;2;A;;595;153;256;337;258;1;6;330;336
43;Tarragona;36;Tarragonès;43043;Catllar, el;1;2;B;;665;169;305;356;309;5;9;342;351
25;Lleida;4;Alt Urgell;25071;Cava;1;1;U;;54;16;23;32;22;0;0;32;32
17;Girona;34;Selva;17189;Cellera de Ter, la;1;1;U;;840;285;492;592;248;2;5;585;590
17;Girona;34;Selva;17189;Cellera de Ter, la;1;2;U;;746;258;449;513;233;11;6;496;502
17;Girona;20;Gironès;17049;Celrà;1;1;A;;537;138;281;349;188;0;5;344;349
17;Girona;20;Gironès;17049;Celrà;1;1;B;;569;122;288;343;226;0;7;336;343
17;Girona;20;Gironès;17049;Celrà;1;2;A;;771;182;351;442;329;6;3;433;436
17;Girona;20;Gironès;17049;Celrà;1;2;B;;728;171;341;432;296;3;3;426;429
8;Barcelona;24;Osona;08067;Centelles;1;1;A;;637;170;340;425;212;3;6;416;422
8;Barcelona;24;Osona;08067;Centelles;1;1;B;;638;205;352;431;207;2;6;423;429
8;Barcelona;24;Osona;08067;Centelles;1;2;A;;478;142;246;293;185;3;5;285;290
8;Barcelona;24;Osona;08067;Centelles;1;2;B;;510;179;293;357;153;3;5;349;354
8;Barcelona;24;Osona;08067;Centelles;1;3;A;;538;119;231;311;227;1;11;299;310
8;Barcelona;24;Osona;08067;Centelles;1;3;B;;686;187;374;448;238;5;5;438;443
8;Barcelona;24;Osona;08067;Centelles;1;4;A;;727;201;361;443;284;0;10;433;443
8;Barcelona;24;Osona;08067;Centelles;1;4;B;;639;192;332;418;221;2;7;409;416
8;Barcelona;24;Osona;08067;Centelles;1;4;C;;547;162;289;352;195;3;9;340;349
8;Barcelona;14;Berguedà;08268;Cercs;1;1;A;;294;94;165;187;107;2;0;185;185
8;Barcelona;14;Berguedà;08268;Cercs;1;1;B;;244;81;114;136;108;1;0;135;135
8;Barcelona;14;Berguedà;08268;Cercs;1;2;U;;593;243;351;422;171;10;2;410;412
8;Barcelona;40;Vallès Occidental;08266;Cerdanyola del Vallès;1;1;A;;1197;275;471;613;584;0;14;599;613
8;Barcelona;40;Vallès Occidental;08266;Cerdanyola del Vallès;1;1;B;;1384;303;545;728;656;1;19;708;727
8;Barcelona;40;Vallès Occidental;08266;Cerdanyola del Vallès;1;10;A;;710;160;308;399;311;1;14;384;398
8;Barcelona;40;Vallès Occidental;08266;Cerdanyola del Vallès;1;10;B;;826;192;364;457;369;3;6;448;454
8;Barcelona;40;Vallès Occidental;08266;Cerdanyola del Vallès;1;10;C;;795;172;355;454;341;0;13;441;454
8;Barcelona;40;Vallès Occidental;08266;Cerdanyola del Vallès;1;11;A;;513;93;176;231;282;1;4;226;230
8;Barcelona;40;Vallès Occidental;08266;Cerdanyola del Vallès;1;11;B;;566;94;176;243;323;1;2;240;242
8;Barcelona;40;Vallès Occidental;08266;Cerdanyola del Vallès;1;12;A;;513;125;207;277;236;2;2;273;275
8;Barcelona;40;Vallès Occidental;08266;Cerdanyola del Vallès;1;12;B;;708;177;313;396;312;1;10;385;395
8;Barcelona;40;Vallès Occidental;08266;Cerdanyola del Vallès;1;12;C;;562;130;235;306;256;3;4;299;303
8;Barcelona;40;Vallès Occidental;08266;Cerdanyola del Vallès;1;13;U;;846;187;387;476;370;2;11;463;474
8;Barcelona;40;Vallès Occidental;08266;Cerdanyola del Vallès;1;14;A;;786;165;340;470;316;2;12;456;468
8;Barcelona;40;Vallès Occidental;08266;Cerdanyola del Vallès;1;14;B;;822;161;354;486;336;2;6;478;484
8;Barcelona;40;Vallès Occidental;08266;Cerdanyola del Vallès;1;15;A;;506;99;196;260;246;0;5;255;260
8;Barcelona;40;Vallès Occidental;08266;Cerdanyola del Vallès;1;15;B;;632;121;235;308;324;0;5;303;308
8;Barcelona;40;Vallès Occidental;08266;Cerdanyola del Vallès;1;15;C;;580;106;201;278;302;0;2;276;278
8;Barcelona;40;Vallès Occidental;08266;Cerdanyola del Vallès;1;16;A;;688;153;322;390;298;1;4;385;389
8;Barcelona;40;Vallès Occidental;08266;Cerdanyola del Vallès;1;16;B;;696;184;333;417;279;2;4;411;415
8;Barcelona;40;Vallès Occidental;08266;Cerdanyola del Vallès;1;17;A;;513;109;202;254;259;0;4;250;254
8;Barcelona;40;Vallès Occidental;08266;Cerdanyola del Vallès;1;17;B;;603;123;226;288;315;2;3;283;286
8;Barcelona;40;Vallès Occidental;08266;Cerdanyola del Vallès;1;17;C;;615;107;277;287;328;2;11;274;285
8;Barcelona;40;Vallès Occidental;08266;Cerdanyola del Vallès;1;18;A;;591;135;268;334;257;1;8;325;333
8;Barcelona;40;Vallès Occidental;08266;Cerdanyola del Vallès;1;18;B;;754;205;342;429;325;1;10;418;428
8;Barcelona;40;Vallès Occidental;08266;Cerdanyola del Vallès;1;18;C;;633;127;271;341;292;3;4;334;338
8;Barcelona;40;Vallès Occidental;08266;Cerdanyola del Vallès;1;19;A;;556;121;218;292;264;2;3;287;290
8;Barcelona;40;Vallès Occidental;08266;Cerdanyola del Vallès;1;19;B;;646;167;256;361;285;1;8;352;360
8;Barcelona;40;Vallès Occidental;08266;Cerdanyola del Vallès;1;19;C;;600;151;268;329;271;2;3;324;327
8;Barcelona;40;Vallès Occidental;08266;Cerdanyola del Vallès;1;2;A;;654;157;304;368;286;1;6;361;367
8;Barcelona;40;Vallès Occidental;08266;Cerdanyola del Vallès;1;2;B;;867;222;392;474;393;4;19;451;470
8;Barcelona;40;Vallès Occidental;08266;Cerdanyola del Vallès;1;20;A;;734;200;416;531;203;0;17;514;531
8;Barcelona;40;Vallès Occidental;08266;Cerdanyola del Vallès;1;20;B;;574;171;333;417;157;0;8;409;417
8;Barcelona;40;Vallès Occidental;08266;Cerdanyola del Vallès;1;20;C;;810;179;414;577;233;0;13;564;577
8;Barcelona;40;Vallès Occidental;08266;Cerdanyola del Vallès;1;27;A;;632;159;229;294;338;0;5;289;294
8;Barcelona;40;Vallès Occidental;08266;Cerdanyola del Vallès;1;27;B;;686;171;252;338;348;4;9;325;334
8;Barcelona;40;Vallès Occidental;08266;Cerdanyola del Vallès;1;28;A;;604;150;280;395;209;2;10;383;393
8;Barcelona;40;Vallès Occidental;08266;Cerdanyola del Vallès;1;28;B;;758;208;362;496;262;0;14;482;496
8;Barcelona;40;Vallès Occidental;08266;Cerdanyola del Vallès;1;29;A;;590;133;259;348;242;0;2;346;348
8;Barcelona;40;Vallès Occidental;08266;Cerdanyola del Vallès;1;29;B;;728;162;333;428;300;1;9;418;427
8;Barcelona;40;Vallès Occidental;08266;Cerdanyola del Vallès;1;29;C;;635;121;294;386;249;1;11;374;385
8;Barcelona;40;Vallès Occidental;08266;Cerdanyola del Vallès;1;3;A;;625;172;306;361;264;4;7;350;357
8;Barcelona;40;Vallès Occidental;08266;Cerdanyola del Vallès;1;3;B;;707;197;326;401;306;1;5;395;400
8;Barcelona;40;Vallès Occidental;08266;Cerdanyola del Vallès;1;30;A;;467;110;209;256;211;0;6;250;256
8;Barcelona;40;Vallès Occidental;08266;Cerdanyola del Vallès;1;30;B;;637;155;291;364;273;1;7;356;363
8;Barcelona;40;Vallès Occidental;08266;Cerdanyola del Vallès;1;31;A;;455;103;187;235;220;1;8;226;234
8;Barcelona;40;Vallès Occidental;08266;Cerdanyola del Vallès;1;31;B;;537;115;217;280;257;0;4;276;280
8;Barcelona;40;Vallès Occidental;08266;Cerdanyola del Vallès;1;32;U;;631;147;297;405;226;1;8;396;404
8;Barcelona;40;Vallès Occidental;08266;Cerdanyola del Vallès;1;33;A;;590;135;233;305;285;0;10;295;305
8;Barcelona;40;Vallès Occidental;08266;Cerdanyola del Vallès;1;33;B;;688;115;220;318;370;1;14;303;317
8;Barcelona;40;Vallès Occidental;08266;Cerdanyola del Vallès;1;34;A;;619;146;265;330;289;2;5;323;328
8;Barcelona;40;Vallès Occidental;08266;Cerdanyola del Vallès;1;34;B;;706;154;293;382;324;0;6;376;382
8;Barcelona;40;Vallès Occidental;08266;Cerdanyola del Vallès;1;35;A;;795;180;344;446;349;2;9;435;444
8;Barcelona;40;Vallès Occidental;08266;Cerdanyola del Vallès;1;35;B;;849;167;339;457;392;1;13;443;456
8;Barcelona;40;Vallès Occidental;08266;Cerdanyola del Vallès;1;35;C;;904;194;374;485;419;0;10;475;485
8;Barcelona;40;Vallès Occidental;08266;Cerdanyola del Vallès;1;4;A;;641;174;265;331;310;0;7;324;331
8;Barcelona;40;Vallès Occidental;08266;Cerdanyola del Vallès;1;4;B;;697;200;304;361;336;0;5;356;361
8;Barcelona;40;Vallès Occidental;08266;Cerdanyola del Vallès;1;5;A;;435;115;186;233;202;1;1;231;232
8;Barcelona;40;Vallès Occidental;08266;Cerdanyola del Vallès;1;5;B;;443;114;205;256;187;3;1;252;253
8;Barcelona;40;Vallès Occidental;08266;Cerdanyola del Vallès;1;6;A;;722;174;319;396;326;0;7;389;396
8;Barcelona;40;Vallès Occidental;08266;Cerdanyola del Vallès;1;6;B;;795;202;358;454;341;0;12;442;454
8;Barcelona;40;Vallès Occidental;08266;Cerdanyola del Vallès;1;7;U;;707;175;324;418;289;2;9;407;416
8;Barcelona;40;Vallès Occidental;08266;Cerdanyola del Vallès;1;8;A;;593;148;264;338;255;5;4;329;333
8;Barcelona;40;Vallès Occidental;08266;Cerdanyola del Vallès;1;8;B;;775;196;348;432;343;2;7;423;430
8;Barcelona;40;Vallès Occidental;08266;Cerdanyola del Vallès;1;9;A;;615;128;250;342;273;2;7;333;340
8;Barcelona;40;Vallès Occidental;08266;Cerdanyola del Vallès;1;9;B;;737;203;330;410;327;0;10;400;410
8;Barcelona;11;Baix Llobregat;08068;Cervelló;1;1;A;;580;166;286;363;217;1;10;352;362
8;Barcelona;11;Baix Llobregat;08068;Cervelló;1;1;B;;556;133;265;348;208;0;3;345;348
8;Barcelona;11;Baix Llobregat;08068;Cervelló;1;1;C;;600;171;287;363;237;1;5;357;362
8;Barcelona;11;Baix Llobregat;08068;Cervelló;1;2;A;;667;170;285;364;303;1;4;359;363
8;Barcelona;11;Baix Llobregat;08068;Cervelló;1;2;B;;749;183;304;409;340;2;3;404;407
8;Barcelona;11;Baix Llobregat;08068;Cervelló;1;3;U;;632;142;302;369;263;3;10;356;366
8;Barcelona;11;Baix Llobregat;08068;Cervelló;1;4;A;;678;159;268;361;317;2;3;356;359
8;Barcelona;11;Baix Llobregat;08068;Cervelló;1;4;B;;787;165;296;396;391;1;9;386;395
8;Barcelona;11;Baix Llobregat;08068;Cervelló;1;4;C;;674;137;252;344;330;0;4;340;344
25;Lleida;32;Segarra;25072;Cervera;1;1;A;;420;121;195;237;183;1;3;233;236
25;Lleida;32;Segarra;25072;Cervera;1;1;B;;563;129;239;299;264;2;8;289;297
25;Lleida;32;Segarra;25072;Cervera;2;1;A;;560;160;293;371;189;3;20;348;368
25;Lleida;32;Segarra;25072;Cervera;2;1;B;;610;182;308;400;210;3;10;387;397
25;Lleida;32;Segarra;25072;Cervera;2;2;A;;682;129;298;400;282;4;7;389;396
25;Lleida;32;Segarra;25072;Cervera;2;2;B;;718;177;323;412;306;5;6;401;407
25;Lleida;32;Segarra;25072;Cervera;2;3;A;;415;128;219;278;137;0;9;269;278
25;Lleida;32;Segarra;25072;Cervera;2;3;B;;496;130;245;319;177;0;11;308;319
25;Lleida;32;Segarra;25072;Cervera;3;1;A;;627;140;264;334;293;6;11;317;328
25;Lleida;32;Segarra;25072;Cervera;3;1;B;;797;205;373;452;345;1;9;442;451
25;Lleida;18;Garrigues;25073;Cervià de les Garrigues;1;1;U;;745;180;335;426;319;1;10;415;425
17;Girona;20;Gironès;17050;Cervià de Ter;1;1;U;;621;215;390;452;169;6;7;439;446
17;Girona;2;Alt Empordà;17051;Cistella;1;1;U;;206;46;121;142;64;1;1;140;141
25;Lleida;38;Urgell;25074;Ciutadilla;1;1;U;;190;43;107;135;55;0;5;130;135
25;Lleida;35;Solsonès;25075;Clariana de Cardener;1;1;U;;112;37;55;87;25;0;4;83;87
25;Lleida;18;Garrigues;25076;Cogul, el;1;1;U;;191;52;102;112;79;0;2;110;112
17;Girona;2;Alt Empordà;17054;Colera;1;1;U;;436;113;185;232;204;2;5;225;230
8;Barcelona;11;Baix Llobregat;08069;Collbató;1;1;A;;715;228;404;476;239;4;10;462;472
8;Barcelona;11;Baix Llobregat;08069;Collbató;1;1;B;;745;221;398;492;253;5;8;479;487
8;Barcelona;11;Baix Llobregat;08069;Collbató;1;3;A;;529;157;226;283;246;1;2;280;282
8;Barcelona;11;Baix Llobregat;08069;Collbató;1;3;B;;666;154;268;339;327;12;2;325;327
43;Tarragona;8;Baix Camp;43045;Colldejou;1;1;U;;163;37;117;133;30;0;1;132;133
25;Lleida;4;Alt Urgell;25077;Coll de Nargó;1;1;U;;492;110;233;300;192;0;6;294;300
8;Barcelona;;;08070;Collsuspina;1;1;U;;255;74;155;181;74;0;10;171;181
17;Girona;10;Baix Empordà;17055;Colomers;1;1;U;;174;55;104;134;40;0;2;132;134
25;Lleida;35;Solsonès;25163;Coma i la Pedra, la;1;1;U;;211;49;105;129;82;0;0;129;129
25;Lleida;25;Pallars Jussà;25161;Conca de Dalt;1;1;U;;378;127;193;257;121;2;3;252;255
43;Tarragona;16;Conca de Barberà;43046;Conesa;1;1;U;;115;32;64;79;36;1;2;76;78
43;Tarragona;36;Tarragonès;43047;Constantí;1;1;A;;626;146;270;333;293;1;3;329;332
43;Tarragona;36;Tarragonès;43047;Constantí;1;1;B;;657;145;272;327;330;0;1;326;327
43;Tarragona;36;Tarragonès;43047;Constantí;1;2;A;;501;61;109;134;367;0;1;133;134
43;Tarragona;36;Tarragonès;43047;Constantí;1;2;B;;528;81;140;178;350;1;0;177;177
43;Tarragona;36;Tarragonès;43047;Constantí;2;1;A;;512;100;203;262;250;2;2;258;260
43;Tarragona;36;Tarragonès;43047;Constantí;2;1;B;;556;119;188;238;318;2;4;232;236
43;Tarragona;36;Tarragonès;43047;Constantí;2;1;C;;676;155;284;354;322;4;1;349;350
8;Barcelona;6;Anoia;08071;Copons;1;1;U;;240;77;129;162;78;4;5;153;158
43;Tarragona;37;Terra Alta;43048;Corbera d'Ebre;1;1;U;;876;206;384;512;364;4;9;499;508
8;Barcelona;11;Baix Llobregat;08072;Corbera de Llobregat;1;1;U;;753;163;286;367;386;0;5;362;367
8;Barcelona;11;Baix Llobregat;08072;Corbera de Llobregat;1;10;U;;923;198;373;492;431;3;9;480;489
8;Barcelona;11;Baix Llobregat;08072;Corbera de Llobregat;1;11;U;;769;136;270;375;394;0;6;369;375
8;Barcelona;11;Baix Llobregat;08072;Corbera de Llobregat;1;2;A;;512;116;228;316;196;1;9;306;315
8;Barcelona;11;Baix Llobregat;08072;Corbera de Llobregat;1;2;B;;561;115;242;325;236;1;3;321;324
8;Barcelona;11;Baix Llobregat;08072;Corbera de Llobregat;1;2;C;;483;115;228;293;190;1;5;287;292
8;Barcelona;11;Baix Llobregat;08072;Corbera de Llobregat;1;3;A;;520;120;219;308;212;1;10;297;307
8;Barcelona;11;Baix Llobregat;08072;Corbera de Llobregat;1;3;B;;544;120;221;297;247;1;7;289;296
8;Barcelona;11;Baix Llobregat;08072;Corbera de Llobregat;1;4;U;;562;136;240;319;243;1;6;312;318
8;Barcelona;11;Baix Llobregat;08072;Corbera de Llobregat;1;5;U;;656;119;222;291;365;3;5;283;288
8;Barcelona;11;Baix Llobregat;08072;Corbera de Llobregat;1;6;U;;688;142;231;309;379;2;2;305;307
8;Barcelona;11;Baix Llobregat;08072;Corbera de Llobregat;1;7;U;;709;146;282;364;345;1;8;355;363
8;Barcelona;11;Baix Llobregat;08072;Corbera de Llobregat;1;8;U;;794;189;373;472;322;1;15;456;471
8;Barcelona;11;Baix Llobregat;08072;Corbera de Llobregat;1;9;U;;582;119;225;316;266;0;2;314;316
25;Lleida;33;Segrià;25078;Corbins;1;1;U;;987;254;528;670;317;24;3;643;646
17;Girona;10;Baix Empordà;17057;Corçà;1;1;A;;500;143;259;317;183;0;5;312;317
17;Girona;10;Baix Empordà;17057;Corçà;1;1;B;;490;138;244;311;179;0;1;310;311
8;Barcelona;11;Baix Llobregat;08073;Cornellà de Llobregat;1;1;A;;760;214;410;522;238;0;11;511;522
8;Barcelona;11;Baix Llobregat;08073;Cornellà de Llobregat;1;1;B;;859;240;474;600;259;4;14;582;596
8;Barcelona;11;Baix Llobregat;08073;Cornellà de Llobregat;1;10;A;;481;127;217;299;182;3;9;287;296
8;Barcelona;11;Baix Llobregat;08073;Cornellà de Llobregat;1;10;B;;594;142;296;392;202;4;11;377;388
8;Barcelona;11;Baix Llobregat;08073;Cornellà de Llobregat;1;11;A;;429;97;197;265;164;0;3;262;265
8;Barcelona;11;Baix Llobregat;08073;Cornellà de Llobregat;1;11;B;;458;93;184;259;199;0;5;254;259
8;Barcelona;11;Baix Llobregat;08073;Cornellà de Llobregat;1;12;U;;710;153;303;372;338;1;6;365;371
8;Barcelona;11;Baix Llobregat;08073;Cornellà de Llobregat;1;13;A;;564;126;233;311;253;0;4;307;311
8;Barcelona;11;Baix Llobregat;08073;Cornellà de Llobregat;1;13;B;;551;138;257;329;222;1;14;314;328
8;Barcelona;11;Baix Llobregat;08073;Cornellà de Llobregat;1;14;U;;926;245;449;587;339;1;14;572;586
8;Barcelona;11;Baix Llobregat;08073;Cornellà de Llobregat;1;2;A;;686;171;353;462;224;0;12;450;462
8;Barcelona;11;Baix Llobregat;08073;Cornellà de Llobregat;1;2;B;;757;198;378;480;277;1;6;473;479
8;Barcelona;11;Baix Llobregat;08073;Cornellà de Llobregat;1;3;A;;502;109;226;292;210;3;5;284;289
8;Barcelona;11;Baix Llobregat;08073;Cornellà de Llobregat;1;3;B;;571;126;257;323;248;0;8;315;323
8;Barcelona;11;Baix Llobregat;08073;Cornellà de Llobregat;1;4;A;;680;139;308;382;298;1;11;370;381
8;Barcelona;11;Baix Llobregat;08073;Cornellà de Llobregat;1;4;B;;738;172;326;421;317;4;5;412;417
8;Barcelona;11;Baix Llobregat;08073;Cornellà de Llobregat;1;5;U;;890;193;381;485;405;3;7;475;482
8;Barcelona;11;Baix Llobregat;08073;Cornellà de Llobregat;1;6;U;;572;146;285;359;213;0;2;357;359
8;Barcelona;11;Baix Llobregat;08073;Cornellà de Llobregat;1;7;A;;600;155;305;402;198;1;8;393;401
8;Barcelona;11;Baix Llobregat;08073;Cornellà de Llobregat;1;7;B;;720;168;347;465;255;3;11;451;462
8;Barcelona;11;Baix Llobregat;08073;Cornellà de Llobregat;1;8;A;;623;137;270;352;271;0;6;346;352
8;Barcelona;11;Baix Llobregat;08073;Cornellà de Llobregat;1;8;B;;665;144;286;382;283;3;10;369;379
8;Barcelona;11;Baix Llobregat;08073;Cornellà de Llobregat;1;9;A;;371;105;189;239;132;0;4;235;239
8;Barcelona;11;Baix Llobregat;08073;Cornellà de Llobregat;1;9;B;;392;113;199;237;155;3;5;229;234
8;Barcelona;11;Baix Llobregat;08073;Cornellà de Llobregat;2;1;A;;648;140;283;381;267;0;9;372;381
8;Barcelona;11;Baix Llobregat;08073;Cornellà de Llobregat;2;1;B;;664;1;292;397;267;1;2;394;396
8;Barcelona;11;Baix Llobregat;08073;Cornellà de Llobregat;2;1;C;;676;153;301;413;263;0;4;409;413
8;Barcelona;11;Baix Llobregat;08073;Cornellà de Llobregat;2;2;A;;589;122;248;359;230;1;7;351;358
8;Barcelona;11;Baix Llobregat;08073;Cornellà de Llobregat;2;2;B;;587;146;265;361;226;0;6;355;361
8;Barcelona;11;Baix Llobregat;08073;Cornellà de Llobregat;2;2;C;;603;138;260;354;249;0;5;349;354
8;Barcelona;11;Baix Llobregat;08073;Cornellà de Llobregat;3;1;A;;428;106;191;245;183;1;3;241;244
8;Barcelona;11;Baix Llobregat;08073;Cornellà de Llobregat;3;1;B;;464;124;204;275;189;0;10;265;275
8;Barcelona;11;Baix Llobregat;08073;Cornellà de Llobregat;3;2;A;;373;92;150;200;173;0;4;196;200
8;Barcelona;11;Baix Llobregat;08073;Cornellà de Llobregat;3;2;B;;369;101;167;201;168;0;2;199;201
8;Barcelona;11;Baix Llobregat;08073;Cornellà de Llobregat;3;3;U;;653;153;255;338;315;11;3;324;327
8;Barcelona;11;Baix Llobregat;08073;Cornellà de Llobregat;3;4;A;;669;163;307;416;253;2;12;402;414
8;Barcelona;11;Baix Llobregat;08073;Cornellà de Llobregat;3;4;B;;777;248;322;444;333;4;9;431;440
8;Barcelona;11;Baix Llobregat;08073;Cornellà de Llobregat;3;4;C;;676;172;313;396;280;0;8;388;396
8;Barcelona;11;Baix Llobregat;08073;Cornellà de Llobregat;3;5;U;;854;208;344;468;386;0;6;462;468
8;Barcelona;11;Baix Llobregat;08073;Cornellà de Llobregat;3;6;U;;698;225;347;423;275;2;4;417;421
8;Barcelona;11;Baix Llobregat;08073;Cornellà de Llobregat;3;7;A;;385;100;187;235;150;1;4;230;234
8;Barcelona;11;Baix Llobregat;08073;Cornellà de Llobregat;3;7;B;;449;118;210;262;187;0;9;253;262
8;Barcelona;11;Baix Llobregat;08073;Cornellà de Llobregat;3;8;U;;1050;245;457;576;474;2;12;562;574
8;Barcelona;11;Baix Llobregat;08073;Cornellà de Llobregat;3;9;A;;358;67;124;166;192;0;2;164;166
8;Barcelona;11;Baix Llobregat;08073;Cornellà de Llobregat;3;9;B;;407;93;155;193;214;0;2;191;193
8;Barcelona;11;Baix Llobregat;08073;Cornellà de Llobregat;4;1;A;;525;130;208;286;239;0;6;280;286
8;Barcelona;11;Baix Llobregat;08073;Cornellà de Llobregat;4;1;B;;587;151;259;352;235;3;8;341;349
8;Barcelona;11;Baix Llobregat;08073;Cornellà de Llobregat;4;10;A;;378;118;177;219;159;1;3;215;218
8;Barcelona;11;Baix Llobregat;08073;Cornellà de Llobregat;4;10;B;;434;110;182;248;186;3;2;243;245
8;Barcelona;11;Baix Llobregat;08073;Cornellà de Llobregat;4;11;A;;372;80;155;211;161;0;2;209;211
8;Barcelona;11;Baix Llobregat;08073;Cornellà de Llobregat;4;11;B;;391;103;173;226;165;1;4;221;225
8;Barcelona;11;Baix Llobregat;08073;Cornellà de Llobregat;4;12;A;;499;148;237;303;196;0;6;297;303
8;Barcelona;11;Baix Llobregat;08073;Cornellà de Llobregat;4;12;B;;557;144;243;313;244;2;3;308;311
8;Barcelona;11;Baix Llobregat;08073;Cornellà de Llobregat;4;13;A;;585;169;293;372;213;1;5;366;371
8;Barcelona;11;Baix Llobregat;08073;Cornellà de Llobregat;4;13;B;;623;183;320;372;251;3;5;364;369
8;Barcelona;11;Baix Llobregat;08073;Cornellà de Llobregat;4;14;A;;430;101;189;235;195;0;2;233;235
8;Barcelona;11;Baix Llobregat;08073;Cornellà de Llobregat;4;14;B;;480;108;222;285;195;0;6;279;285
8;Barcelona;11;Baix Llobregat;08073;Cornellà de Llobregat;4;15;A;;325;86;124;179;146;0;1;178;179
8;Barcelona;11;Baix Llobregat;08073;Cornellà de Llobregat;4;15;B;;407;99;183;233;174;0;0;233;233
8;Barcelona;11;Baix Llobregat;08073;Cornellà de Llobregat;4;16;A;;455;89;183;247;208;1;9;237;246
8;Barcelona;11;Baix Llobregat;08073;Cornellà de Llobregat;4;16;B;;535;121;219;301;234;2;5;294;299
8;Barcelona;11;Baix Llobregat;08073;Cornellà de Llobregat;4;17;A;;470;92;187;270;200;0;5;265;270
8;Barcelona;11;Baix Llobregat;08073;Cornellà de Llobregat;4;17;B;;501;124;219;280;221;1;1;278;279
8;Barcelona;11;Baix Llobregat;08073;Cornellà de Llobregat;4;18;U;;680;151;286;369;311;0;10;359;369
8;Barcelona;11;Baix Llobregat;08073;Cornellà de Llobregat;4;19;U;;686;188;315;388;298;3;4;381;385
8;Barcelona;11;Baix Llobregat;08073;Cornellà de Llobregat;4;2;U;;566;121;232;317;249;0;6;311;317
8;Barcelona;11;Baix Llobregat;08073;Cornellà de Llobregat;4;3;A;;581;104;230;315;266;0;2;313;315
8;Barcelona;11;Baix Llobregat;08073;Cornellà de Llobregat;4;3;B;;641;133;257;350;291;2;5;343;348
8;Barcelona;11;Baix Llobregat;08073;Cornellà de Llobregat;4;4;A;;367;124;202;233;134;0;7;226;233
8;Barcelona;11;Baix Llobregat;08073;Cornellà de Llobregat;4;4;B;;429;116;208;262;167;2;10;250;260
8;Barcelona;11;Baix Llobregat;08073;Cornellà de Llobregat;4;5;A;;325;83;175;211;114;0;3;208;211
8;Barcelona;11;Baix Llobregat;08073;Cornellà de Llobregat;4;5;B;;405;100;185;254;151;1;4;249;253
8;Barcelona;11;Baix Llobregat;08073;Cornellà de Llobregat;4;6;A;;504;109;207;277;227;2;4;271;275
8;Barcelona;11;Baix Llobregat;08073;Cornellà de Llobregat;4;6;B;;593;139;257;335;258;1;9;325;334
8;Barcelona;11;Baix Llobregat;08073;Cornellà de Llobregat;4;7;A;;392;102;173;237;155;2;0;235;235
8;Barcelona;11;Baix Llobregat;08073;Cornellà de Llobregat;4;7;B;;468;121;224;266;202;0;4;262;266
8;Barcelona;11;Baix Llobregat;08073;Cornellà de Llobregat;4;8;A;;567;141;243;310;257;3;2;305;307
8;Barcelona;11;Baix Llobregat;08073;Cornellà de Llobregat;4;8;B;;616;156;263;329;287;3;2;324;326
8;Barcelona;11;Baix Llobregat;08073;Cornellà de Llobregat;4;9;U;;668;165;304;391;277;0;7;384;391
8;Barcelona;11;Baix Llobregat;08073;Cornellà de Llobregat;5;1;U;;565;128;224;289;276;0;1;288;289
8;Barcelona;11;Baix Llobregat;08073;Cornellà de Llobregat;5;10;A;;413;91;162;206;207;0;2;204;206
8;Barcelona;11;Baix Llobregat;08073;Cornellà de Llobregat;5;10;B;;467;116;199;248;219;0;6;242;248
8;Barcelona;11;Baix Llobregat;08073;Cornellà de Llobregat;5;2;U;;550;131;205;247;303;1;5;241;246
8;Barcelona;11;Baix Llobregat;08073;Cornellà de Llobregat;5;3;A;;365;86;135;178;187;0;4;174;178
8;Barcelona;11;Baix Llobregat;08073;Cornellà de Llobregat;5;3;B;;388;93;149;191;197;0;0;191;191
8;Barcelona;11;Baix Llobregat;08073;Cornellà de Llobregat;5;4;U;;501;110;203;260;241;2;7;251;258
8;Barcelona;11;Baix Llobregat;08073;Cornellà de Llobregat;5;5;U;;627;147;238;298;329;0;2;296;298
8;Barcelona;11;Baix Llobregat;08073;Cornellà de Llobregat;5;6;A;;388;95;151;203;185;3;4;196;200
8;Barcelona;11;Baix Llobregat;08073;Cornellà de Llobregat;5;6;B;;419;91;165;233;186;0;2;231;233
8;Barcelona;11;Baix Llobregat;08073;Cornellà de Llobregat;5;7;A;;347;79;133;162;185;0;4;158;162
8;Barcelona;11;Baix Llobregat;08073;Cornellà de Llobregat;5;7;B;;435;106;178;218;217;0;5;213;218
8;Barcelona;11;Baix Llobregat;08073;Cornellà de Llobregat;5;8;A;;318;84;128;159;159;2;2;155;157
8;Barcelona;11;Baix Llobregat;08073;Cornellà de Llobregat;5;8;B;;328;89;152;192;136;6;2;184;186
8;Barcelona;11;Baix Llobregat;08073;Cornellà de Llobregat;5;9;U;;653;186;322;409;244;1;6;402;408
8;Barcelona;11;Baix Llobregat;08073;Cornellà de Llobregat;6;1;U;;415;100;160;207;208;3;2;202;204
8;Barcelona;11;Baix Llobregat;08073;Cornellà de Llobregat;6;10;U;;623;142;238;316;307;0;4;312;316
8;Barcelona;11;Baix Llobregat;08073;Cornellà de Llobregat;6;11;U;;387;94;144;191;196;1;2;188;190
8;Barcelona;11;Baix Llobregat;08073;Cornellà de Llobregat;6;12;U;;618;137;248;323;295;1;7;315;322
8;Barcelona;11;Baix Llobregat;08073;Cornellà de Llobregat;6;13;U;;518;218;297;292;226;2;7;283;290
8;Barcelona;11;Baix Llobregat;08073;Cornellà de Llobregat;6;14;U;;629;152;290;331;298;0;6;325;331
8;Barcelona;11;Baix Llobregat;08073;Cornellà de Llobregat;6;15;U;;788;187;388;493;295;1;3;489;492
8;Barcelona;11;Baix Llobregat;08073;Cornellà de Llobregat;6;16;U;;489;123;216;256;233;4;4;248;252
8;Barcelona;11;Baix Llobregat;08073;Cornellà de Llobregat;6;2;A;;340;84;149;193;147;0;3;190;193
8;Barcelona;11;Baix Llobregat;08073;Cornellà de Llobregat;6;2;B;;379;102;178;210;169;1;10;199;209
8;Barcelona;11;Baix Llobregat;08073;Cornellà de Llobregat;6;3;U;;403;85;144;184;219;0;2;182;184
8;Barcelona;11;Baix Llobregat;08073;Cornellà de Llobregat;6;4;U;;454;108;195;241;213;1;3;237;240
8;Barcelona;11;Baix Llobregat;08073;Cornellà de Llobregat;6;5;U;;538;153;227;284;254;0;3;281;284
8;Barcelona;11;Baix Llobregat;08073;Cornellà de Llobregat;6;6;U;;438;116;194;238;200;1;4;233;237
8;Barcelona;11;Baix Llobregat;08073;Cornellà de Llobregat;6;7;A;;331;84;146;192;139;0;2;190;192
8;Barcelona;11;Baix Llobregat;08073;Cornellà de Llobregat;6;7;B;;369;106;163;212;157;0;4;208;212
8;Barcelona;11;Baix Llobregat;08073;Cornellà de Llobregat;6;8;U;;445;125;198;237;208;0;3;234;237
8;Barcelona;11;Baix Llobregat;08073;Cornellà de Llobregat;6;9;A;;489;100;202;285;204;0;0;285;285
8;Barcelona;11;Baix Llobregat;08073;Cornellà de Llobregat;6;9;B;;607;139;255;335;272;0;8;327;335
8;Barcelona;11;Baix Llobregat;08073;Cornellà de Llobregat;6;9;C;;569;117;246;331;238;0;7;324;331
17;Girona;28;Pla de l'Estany;17056;Cornellà del Terri;1;1;A;;842;267;455;558;284;4;12;542;554
17;Girona;28;Pla de l'Estany;17056;Cornellà del Terri;1;1;B;;833;277;478;573;260;4;12;557;569
43;Tarragona;29;Priorat;43049;Cornudella de Montsant;1;1;U;;772;219;480;544;228;3;6;535;541
43;Tarragona;36;Tarragonès;43050;Creixell;1;1;A;;636;181;299;356;280;0;5;351;356
43;Tarragona;36;Tarragonès;43050;Creixell;1;1;B;;614;166;264;313;301;2;4;307;311
43;Tarragona;36;Tarragonès;43050;Creixell;1;1;C;;722;192;300;373;349;2;5;366;371
17;Girona;28;Pla de l'Estany;17058;Crespià;1;1;U;;189;48;84;105;84;0;0;105;105
17;Girona;10;Baix Empordà;17901;Cruïlles, Monells i Sant Sadurní;1;1;A;;498;155;267;303;195;3;5;295;300
17;Girona;10;Baix Empordà;17901;Cruïlles, Monells i Sant Sadurní;1;1;B;;214;68;114;139;75;1;4;134;138
17;Girona;10;Baix Empordà;17901;Cruïlles, Monells i Sant Sadurní;1;1;C;;232;69;136;158;74;1;4;153;157
8;Barcelona;17;Garraf;08074;Cubelles;1;1;U;;719;147;272;339;380;0;13;326;339
8;Barcelona;17;Garraf;08074;Cubelles;1;2;A;;838;202;364;463;375;3;8;452;460
8;Barcelona;17;Garraf;08074;Cubelles;1;2;B;;961;229;370;487;474;4;8;475;483
8;Barcelona;17;Garraf;08074;Cubelles;1;3;A;;777;181;316;385;392;1;8;376;384
8;Barcelona;17;Garraf;08074;Cubelles;1;3;B;;863;211;349;435;428;7;4;424;428
8;Barcelona;17;Garraf;08074;Cubelles;1;4;A;;605;137;233;294;311;0;8;286;294
8;Barcelona;17;Garraf;08074;Cubelles;1;4;B;;735;175;272;349;386;2;8;339;347
8;Barcelona;17;Garraf;08074;Cubelles;1;5;A;;746;190;310;368;378;1;5;362;367
8;Barcelona;17;Garraf;08074;Cubelles;1;5;B;;777;163;261;323;454;1;3;319;322
8;Barcelona;17;Garraf;08074;Cubelles;1;5;C;;843;200;331;396;447;0;10;386;396
8;Barcelona;17;Garraf;08074;Cubelles;1;6;A;;650;122;212;272;378;0;3;269;272
8;Barcelona;17;Garraf;08074;Cubelles;1;6;B;;744;134;225;305;439;1;8;296;304
25;Lleida;23;Noguera;25079;Cubells;1;1;U;;315;91;181;229;86;1;2;226;228
43;Tarragona;12;Baix Penedès;43051;Cunit;1;1;A;;412;85;146;207;205;0;2;205;207
43;Tarragona;12;Baix Penedès;43051;Cunit;1;1;B;;544;130;210;266;278;3;2;261;263
43;Tarragona;12;Baix Penedès;43051;Cunit;1;1;C;;519;123;183;238;281;2;1;235;236
43;Tarragona;12;Baix Penedès;43051;Cunit;1;2;A;;435;117;183;223;212;1;1;221;222
43;Tarragona;12;Baix Penedès;43051;Cunit;1;2;B;;443;95;157;211;232;2;4;205;209
43;Tarragona;12;Baix Penedès;43051;Cunit;1;2;C;;484;99;229;238;246;0;2;236;238
43;Tarragona;12;Baix Penedès;43051;Cunit;1;3;A;;537;125;204;240;297;4;2;234;236
43;Tarragona;12;Baix Penedès;43051;Cunit;1;3;B;;533;110;176;226;307;0;2;224;226
43;Tarragona;12;Baix Penedès;43051;Cunit;1;3;C;;597;128;214;257;340;6;0;251;251
43;Tarragona;12;Baix Penedès;43051;Cunit;1;4;A;;394;78;128;166;228;2;0;164;164
43;Tarragona;12;Baix Penedès;43051;Cunit;1;4;B;;443;94;146;186;257;1;1;184;185
43;Tarragona;12;Baix Penedès;43051;Cunit;1;4;C;;428;78;141;188;240;1;5;182;187
43;Tarragona;12;Baix Penedès;43051;Cunit;1;5;A;;611;128;214;271;340;6;2;263;265
43;Tarragona;12;Baix Penedès;43051;Cunit;1;5;B;;579;150;212;266;313;1;1;264;265
43;Tarragona;12;Baix Penedès;43051;Cunit;1;5;C;;581;139;208;257;324;2;2;253;255
17;Girona;2;Alt Empordà;17060;Darnius;1;1;U;;396;120;235;279;117;1;9;269;278
17;Girona;15;Cerdanya;17061;Das;1;1;U;;148;50;82;108;40;0;7;101;108
43;Tarragona;9;Baix Ebre;43901;Deltebre;1;1;A;;836;186;359;457;379;1;14;442;456
43;Tarragona;9;Baix Ebre;43901;Deltebre;1;1;B;;672;132;277;366;306;1;10;355;365
43;Tarragona;9;Baix Ebre;43901;Deltebre;1;2;A;;710;151;263;371;339;1;9;361;370
43;Tarragona;9;Baix Ebre;43901;Deltebre;1;2;B;;596;118;230;304;292;0;4;300;304
43;Tarragona;9;Baix Ebre;43901;Deltebre;1;2;C;;602;116;190;291;311;1;5;285;290
43;Tarragona;9;Baix Ebre;43901;Deltebre;1;3;A;;561;156;250;317;244;0;6;311;317
43;Tarragona;9;Baix Ebre;43901;Deltebre;1;3;B;;473;107;195;263;210;1;3;259;262
43;Tarragona;9;Baix Ebre;43901;Deltebre;1;4;A;;834;184;333;445;389;0;12;433;445
43;Tarragona;9;Baix Ebre;43901;Deltebre;1;4;B;;567;115;228;288;279;0;6;282;288
43;Tarragona;9;Baix Ebre;43901;Deltebre;1;5;A;;659;114;249;349;310;1;7;341;348
43;Tarragona;9;Baix Ebre;43901;Deltebre;1;5;B;;581;102;208;283;298;0;12;271;283
43;Tarragona;9;Baix Ebre;43901;Deltebre;1;6;A;;873;198;352;455;418;0;7;448;455
43;Tarragona;9;Baix Ebre;43901;Deltebre;1;6;B;;716;138;277;360;356;1;9;350;359
8;Barcelona;21;Maresme;08075;Dosrius;1;1;A;;908;215;409;535;373;2;6;527;533
8;Barcelona;21;Maresme;08075;Dosrius;1;1;B;;897;200;423;534;363;1;10;523;533
8;Barcelona;21;Maresme;08075;Dosrius;1;2;A;;812;157;294;360;452;0;5;355;360
8;Barcelona;21;Maresme;08075;Dosrius;1;2;B;;930;164;326;398;532;0;5;393;398
43;Tarragona;8;Baix Camp;43053;Duesaigües;1;1;U;;191;58;125;144;47;0;1;143;144
17;Girona;2;Alt Empordà;17062;Escala, l';1;1;U;;881;218;416;511;370;4;10;497;507
17;Girona;2;Alt Empordà;17062;Escala, l';1;2;A;;820;181;336;400;420;3;7;390;397
17;Girona;2;Alt Empordà;17062;Escala, l';1;2;B;;747;162;299;364;383;4;1;359;360
17;Girona;2;Alt Empordà;17062;Escala, l';1;3;A;;584;155;267;312;272;0;3;309;312
17;Girona;2;Alt Empordà;17062;Escala, l';1;3;B;;607;153;261;323;284;4;5;314;319
17;Girona;2;Alt Empordà;17062;Escala, l';1;4;U;;1045;261;441;543;502;1;14;528;542
17;Girona;2;Alt Empordà;17062;Escala, l';1;5;U;;1039;221;380;474;565;2;9;463;472
8;Barcelona;11;Baix Llobregat;08076;Esparreguera;1;1;A;;627;161;290;364;263;2;7;355;362
8;Barcelona;11;Baix Llobregat;08076;Esparreguera;1;1;B;;719;163;284;362;357;1;6;355;361
8;Barcelona;11;Baix Llobregat;08076;Esparreguera;1;1;C;;564;144;257;310;254;2;6;302;308
8;Barcelona;11;Baix Llobregat;08076;Esparreguera;1;2;A;;689;171;302;391;298;0;9;382;391
8;Barcelona;11;Baix Llobregat;08076;Esparreguera;1;2;B;;851;201;374;480;371;1;5;474;479
8;Barcelona;11;Baix Llobregat;08076;Esparreguera;1;3;A;;570;165;277;368;202;1;4;363;367
8;Barcelona;11;Baix Llobregat;08076;Esparreguera;1;3;B;;797;219;391;487;310;2;12;473;485
8;Barcelona;11;Baix Llobregat;08076;Esparreguera;1;4;A;;743;194;331;429;314;2;12;415;427
8;Barcelona;11;Baix Llobregat;08076;Esparreguera;1;4;B;;923;204;379;495;428;5;17;473;490
8;Barcelona;11;Baix Llobregat;08076;Esparreguera;1;5;U;;709;168;277;351;358;3;7;341;348
8;Barcelona;11;Baix Llobregat;08076;Esparreguera;1;6;A;;620;117;255;365;255;1;5;359;364
8;Barcelona;11;Baix Llobregat;08076;Esparreguera;1;6;B;;644;143;286;390;254;2;8;380;388
8;Barcelona;11;Baix Llobregat;08076;Esparreguera;2;1;A;;784;201;330;389;395;0;4;385;389
8;Barcelona;11;Baix Llobregat;08076;Esparreguera;2;1;B;;943;201;370;464;479;1;12;451;463
8;Barcelona;11;Baix Llobregat;08076;Esparreguera;2;2;A;;550;112;200;269;281;1;0;268;268
8;Barcelona;11;Baix Llobregat;08076;Esparreguera;2;2;B;;636;170;265;342;294;0;10;332;342
8;Barcelona;11;Baix Llobregat;08076;Esparreguera;2;3;A;;765;204;361;458;307;2;9;447;456
8;Barcelona;11;Baix Llobregat;08076;Esparreguera;2;3;B;;876;251;427;551;325;4;11;536;547
8;Barcelona;11;Baix Llobregat;08076;Esparreguera;2;4;A;;667;137;259;349;318;1;12;336;348
8;Barcelona;11;Baix Llobregat;08076;Esparreguera;2;4;B;;723;170;305;394;329;1;7;386;393
8;Barcelona;11;Baix Llobregat;08076;Esparreguera;2;5;A;;702;118;223;261;441;0;3;258;261
8;Barcelona;11;Baix Llobregat;08076;Esparreguera;2;5;B;;722;125;209;265;457;2;3;260;263
17;Girona;24;Osona;17063;Espinelves;1;1;U;;158;50;100;116;42;1;1;114;115
25;Lleida;18;Garrigues;25081;Espluga Calba, l';1;1;U;;353;94;194;240;113;1;4;235;239
43;Tarragona;16;Conca de Barberà;43054;Espluga de Francolí, l';1;1;A;;652;144;306;426;226;2;7;417;424
43;Tarragona;16;Conca de Barberà;43054;Espluga de Francolí, l';1;1;B;;414;87;196;272;142;4;4;264;268
43;Tarragona;16;Conca de Barberà;43054;Espluga de Francolí, l';1;1;C;;713;161;344;458;255;6;9;443;452
43;Tarragona;16;Conca de Barberà;43054;Espluga de Francolí, l';2;1;A;;527;105;229;314;213;1;5;308;313
43;Tarragona;16;Conca de Barberà;43054;Espluga de Francolí, l';2;1;B;;651;136;286;397;254;3;5;389;394
8;Barcelona;11;Baix Llobregat;08077;Esplugues de Llobregat;1;1;A;;637;207;384;466;171;3;11;452;463
8;Barcelona;11;Baix Llobregat;08077;Esplugues de Llobregat;1;1;B;;696;213;412;497;199;2;9;486;495
8;Barcelona;11;Baix Llobregat;08077;Esplugues de Llobregat;1;2;A;;476;117;230;308;168;5;6;297;303
8;Barcelona;11;Baix Llobregat;08077;Esplugues de Llobregat;1;2;B;;540;152;286;366;174;0;5;361;366
8;Barcelona;11;Baix Llobregat;08077;Esplugues de Llobregat;1;3;A;;658;118;307;386;272;5;7;374;381
8;Barcelona;11;Baix Llobregat;08077;Esplugues de Llobregat;1;3;B;;670;186;324;433;237;1;10;422;432
8;Barcelona;11;Baix Llobregat;08077;Esplugues de Llobregat;1;4;A;;519;125;232;314;205;0;7;307;314
8;Barcelona;11;Baix Llobregat;08077;Esplugues de Llobregat;1;4;B;;540;116;214;301;239;4;7;290;297
8;Barcelona;11;Baix Llobregat;08077;Esplugues de Llobregat;1;5;A;;674;159;295;377;297;0;10;367;377
8;Barcelona;11;Baix Llobregat;08077;Esplugues de Llobregat;1;5;B;;710;172;302;415;295;0;13;402;415
8;Barcelona;11;Baix Llobregat;08077;Esplugues de Llobregat;10;1;A;;479;150;237;286;193;1;10;275;285
8;Barcelona;11;Baix Llobregat;08077;Esplugues de Llobregat;10;1;B;;640;189;312;375;265;1;9;365;374
8;Barcelona;11;Baix Llobregat;08077;Esplugues de Llobregat;10;1;C;;661;187;290;356;305;0;5;351;356
8;Barcelona;11;Baix Llobregat;08077;Esplugues de Llobregat;10;2;A;;560;120;225;301;259;0;8;293;301
8;Barcelona;11;Baix Llobregat;08077;Esplugues de Llobregat;10;2;B;;717;175;301;383;334;3;6;374;380
8;Barcelona;11;Baix Llobregat;08077;Esplugues de Llobregat;10;3;A;;570;140;226;289;281;0;5;284;289
8;Barcelona;11;Baix Llobregat;08077;Esplugues de Llobregat;10;3;B;;599;146;231;296;303;0;1;295;296
8;Barcelona;11;Baix Llobregat;08077;Esplugues de Llobregat;10;3;C;;575;141;220;304;271;1;4;299;303
8;Barcelona;11;Baix Llobregat;08077;Esplugues de Llobregat;10;4;A;;422;86;157;194;228;0;1;193;194
8;Barcelona;11;Baix Llobregat;08077;Esplugues de Llobregat;10;4;B;;517;109;197;241;276;0;6;235;241
8;Barcelona;11;Baix Llobregat;08077;Esplugues de Llobregat;10;5;A;;378;106;156;185;193;0;0;185;185
8;Barcelona;11;Baix Llobregat;08077;Esplugues de Llobregat;10;5;B;;448;104;154;192;256;0;1;191;192
8;Barcelona;11;Baix Llobregat;08077;Esplugues de Llobregat;10;6;A;;622;172;273;345;277;0;7;338;345
8;Barcelona;11;Baix Llobregat;08077;Esplugues de Llobregat;10;6;B;;687;175;281;351;336;0;8;343;351
8;Barcelona;11;Baix Llobregat;08077;Esplugues de Llobregat;10;7;A;;661;181;307;391;270;4;9;378;387
8;Barcelona;11;Baix Llobregat;08077;Esplugues de Llobregat;10;7;B;;711;172;289;388;323;3;14;371;385
8;Barcelona;11;Baix Llobregat;08077;Esplugues de Llobregat;10;8;A;;647;156;233;289;358;2;11;276;287
8;Barcelona;11;Baix Llobregat;08077;Esplugues de Llobregat;10;8;B;;775;175;301;372;403;4;8;360;368
8;Barcelona;11;Baix Llobregat;08077;Esplugues de Llobregat;2;1;A;;548;122;249;344;204;1;9;334;343
8;Barcelona;11;Baix Llobregat;08077;Esplugues de Llobregat;2;1;B;;608;151;274;375;233;2;12;361;373
8;Barcelona;11;Baix Llobregat;08077;Esplugues de Llobregat;2;2;A;;470;101;205;272;198;2;4;266;270
8;Barcelona;11;Baix Llobregat;08077;Esplugues de Llobregat;2;2;B;;566;118;246;325;241;3;7;315;322
8;Barcelona;11;Baix Llobregat;08077;Esplugues de Llobregat;2;3;A;;665;144;294;375;290;0;11;364;375
8;Barcelona;11;Baix Llobregat;08077;Esplugues de Llobregat;2;3;B;;778;157;318;425;353;4;7;414;421
8;Barcelona;11;Baix Llobregat;08077;Esplugues de Llobregat;2;4;A;;547;150;264;352;195;1;8;343;351
8;Barcelona;11;Baix Llobregat;08077;Esplugues de Llobregat;2;4;B;;638;151;264;355;283;0;1;354;355
8;Barcelona;11;Baix Llobregat;08077;Esplugues de Llobregat;2;5;A;;613;150;262;345;268;0;11;334;345
8;Barcelona;11;Baix Llobregat;08077;Esplugues de Llobregat;2;5;B;;697;167;290;379;318;3;5;371;376
8;Barcelona;11;Baix Llobregat;08077;Esplugues de Llobregat;2;6;A;;540;140;259;347;193;0;4;343;347
8;Barcelona;11;Baix Llobregat;08077;Esplugues de Llobregat;2;6;B;;614;129;259;366;248;0;5;361;366
8;Barcelona;11;Baix Llobregat;08077;Esplugues de Llobregat;3;1;A;;503;138;241;315;188;1;3;311;314
8;Barcelona;11;Baix Llobregat;08077;Esplugues de Llobregat;3;1;B;;609;160;299;376;233;1;4;371;375
8;Barcelona;11;Baix Llobregat;08077;Esplugues de Llobregat;3;2;A;;571;147;259;325;246;1;6;318;324
8;Barcelona;11;Baix Llobregat;08077;Esplugues de Llobregat;3;2;B;;630;141;264;346;284;1;8;337;345
8;Barcelona;11;Baix Llobregat;08077;Esplugues de Llobregat;3;2;C;;583;130;246;323;260;1;11;311;322
8;Barcelona;11;Baix Llobregat;08077;Esplugues de Llobregat;4;1;U;;594;139;312;411;183;0;11;400;411
8;Barcelona;11;Baix Llobregat;08077;Esplugues de Llobregat;5;1;U;;489;110;267;326;163;3;4;319;323
8;Barcelona;11;Baix Llobregat;08077;Esplugues de Llobregat;6;1;U;;577;132;271;341;236;1;8;332;340
8;Barcelona;11;Baix Llobregat;08077;Esplugues de Llobregat;7;1;U;;887;204;437;610;277;2;6;602;608
8;Barcelona;11;Baix Llobregat;08077;Esplugues de Llobregat;8;1;A;;628;173;302;383;245;1;5;377;382
8;Barcelona;11;Baix Llobregat;08077;Esplugues de Llobregat;8;1;B;;824;224;382;512;312;0;8;504;512
8;Barcelona;11;Baix Llobregat;08077;Esplugues de Llobregat;8;2;A;;733;199;347;450;283;5;9;436;445
8;Barcelona;11;Baix Llobregat;08077;Esplugues de Llobregat;8;2;B;;896;255;434;551;345;2;13;536;549
8;Barcelona;11;Baix Llobregat;08077;Esplugues de Llobregat;9;1;A;;584;150;255;323;261;3;3;317;320
8;Barcelona;11;Baix Llobregat;08077;Esplugues de Llobregat;9;1;B;;585;127;224;296;289;2;11;283;294
8;Barcelona;11;Baix Llobregat;08077;Esplugues de Llobregat;9;2;A;;693;150;310;404;289;1;6;397;403
8;Barcelona;11;Baix Llobregat;08077;Esplugues de Llobregat;9;2;B;;751;189;348;446;305;0;14;432;446
17;Girona;2;Alt Empordà;17064;Espolla;1;1;U;;325;117;211;252;73;2;2;248;250
17;Girona;28;Pla de l'Estany;17065;Esponellà;1;1;U;;346;109;201;239;107;8;3;228;231
25;Lleida;26;Pallars Sobirà;25082;Espot;1;1;U;;281;50;115;174;107;1;5;168;173
8;Barcelona;14;Berguedà;08078;Espunyola, l';1;1;U;;220;53;132;161;59;0;5;156;161
8;Barcelona;24;Osona;08254;Esquirol, l';1;1;A;;647;210;373;456;191;1;15;440;455
8;Barcelona;24;Osona;08254;Esquirol, l';1;1;B;;688;208;394;492;196;2;13;477;490
8;Barcelona;24;Osona;08254;Esquirol, l';1;1;C;;165;59;95;115;50;2;1;112;113
8;Barcelona;24;Osona;08254;Esquirol, l';1;1;D;;286;95;164;207;79;3;5;199;204
25;Lleida;4;Alt Urgell;25088;Estamariu;1;1;U;;102;16;72;87;15;0;0;87;87
8;Barcelona;;;08079;Estany, l';1;1;U;;325;130;219;250;75;0;9;241;250
25;Lleida;32;Segarra;25085;Estaràs;1;1;U;;157;37;76;97;60;0;4;93;97
25;Lleida;26;Pallars Sobirà;25086;Esterri d'Àneu;1;1;U;;582;169;284;381;201;2;15;364;379
25;Lleida;26;Pallars Sobirà;25087;Esterri de Cardós;1;1;U;;61;16;25;38;23;0;0;38;38
43;Tarragona;29;Priorat;43055;Falset;1;1;A;;408;118;241;299;109;4;6;289;295
43;Tarragona;29;Priorat;43055;Falset;1;1;B;;490;130;277;337;153;1;3;333;336
43;Tarragona;29;Priorat;43055;Falset;2;1;A;;502;134;276;358;144;1;5;352;357
43;Tarragona;29;Priorat;43055;Falset;2;1;B;;601;155;322;425;176;0;12;413;425
17;Girona;2;Alt Empordà;17005;Far d'Empordà, el;1;1;U;;366;101;199;233;133;1;8;224;232
25;Lleida;26;Pallars Sobirà;25089;Farrera;1;1;U;;92;13;34;64;28;1;0;63;63
43;Tarragona;37;Terra Alta;43056;Fatarella, la;1;1;U;;487;86;208;303;184;4;5;294;299
43;Tarragona;37;Terra Alta;43056;Fatarella, la;1;2;U;;506;96;239;328;178;1;8;319;327
43;Tarragona;8;Baix Camp;43057;Febró, la;1;1;U;;49;8;19;33;16;0;2;31;33
8;Barcelona;41;Vallès Oriental;08134;Figaró-Montmany;1;1;U;;726;201;369;448;278;1;13;434;447
8;Barcelona;14;Berguedà;08080;Fígols;1;1;U;;41;19;24;28;13;0;0;28;28
25;Lleida;4;Alt Urgell;25908;Fígols i Alinyà;1;1;U;;239;63;115;170;69;0;4;166;170
43;Tarragona;29;Priorat;43058;Figuera, la;1;1;U;;130;28;60;86;44;0;1;85;86
17;Girona;2;Alt Empordà;17066;Figueres;1;1;U;;665;170;291;350;315;1;4;345;349
17;Girona;2;Alt Empordà;17066;Figueres;1;2;U;;893;308;460;551;342;0;18;533;551
17;Girona;2;Alt Empordà;17066;Figueres;1;3;A;;780;198;368;425;355;1;15;409;424
17;Girona;2;Alt Empordà;17066;Figueres;1;3;B;;831;228;381;441;390;0;4;437;441
17;Girona;2;Alt Empordà;17066;Figueres;1;4;U;;888;260;399;454;434;0;9;445;454
17;Girona;2;Alt Empordà;17066;Figueres;1;5;U;;907;172;311;331;576;0;12;319;331
17;Girona;2;Alt Empordà;17066;Figueres;1;6;A;;774;165;251;291;483;2;6;283;289
17;Girona;2;Alt Empordà;17066;Figueres;1;6;B;;731;166;267;318;413;2;11;305;316
17;Girona;2;Alt Empordà;17066;Figueres;1;7;U;;997;234;369;455;542;6;4;445;449
17;Girona;2;Alt Empordà;17066;Figueres;1;8;U;;720;190;298;350;370;2;9;339;348
17;Girona;2;Alt Empordà;17066;Figueres;2;1;U;;515;166;247;291;224;0;10;281;291
17;Girona;2;Alt Empordà;17066;Figueres;2;2;U;;894;269;424;481;413;0;5;476;481
17;Girona;2;Alt Empordà;17066;Figueres;2;3;U;;756;200;365;436;320;3;9;424;433
17;Girona;2;Alt Empordà;17066;Figueres;2;4;A;;785;214;360;429;356;1;12;416;428
17;Girona;2;Alt Empordà;17066;Figueres;2;4;B;;734;225;351;406;328;4;15;387;402
17;Girona;2;Alt Empordà;17066;Figueres;2;5;U;;535;170;256;302;233;5;8;289;297
17;Girona;2;Alt Empordà;17066;Figueres;3;1;U;;605;211;303;362;243;3;4;355;359
17;Girona;2;Alt Empordà;17066;Figueres;3;2;A;;694;204;315;359;335;1;8;350;358
17;Girona;2;Alt Empordà;17066;Figueres;3;2;B;;322;90;157;193;129;1;1;191;192
17;Girona;2;Alt Empordà;17066;Figueres;3;3;A;;678;201;276;355;323;5;10;340;350
17;Girona;2;Alt Empordà;17066;Figueres;3;3;B;;741;192;300;385;356;5;8;372;380
17;Girona;2;Alt Empordà;17066;Figueres;3;4;U;;882;182;300;322;560;1;3;318;321
17;Girona;2;Alt Empordà;17066;Figueres;3;5;A;;704;214;374;424;280;0;8;416;424
17;Girona;2;Alt Empordà;17066;Figueres;3;5;B;;794;227;354;426;368;0;5;421;426
17;Girona;2;Alt Empordà;17066;Figueres;4;1;A;;529;179;251;296;233;3;2;291;293
17;Girona;2;Alt Empordà;17066;Figueres;4;1;B;;507;160;241;293;214;0;10;283;293
17;Girona;2;Alt Empordà;17066;Figueres;4;2;A;;622;213;324;386;236;2;8;376;384
17;Girona;2;Alt Empordà;17066;Figueres;4;2;B;;673;228;346;408;265;1;6;401;407
17;Girona;2;Alt Empordà;17066;Figueres;4;3;A;;629;163;297;358;271;2;3;353;356
17;Girona;2;Alt Empordà;17066;Figueres;4;3;B;;637;159;271;330;307;1;3;326;329
17;Girona;2;Alt Empordà;17066;Figueres;4;4;A;;820;224;379;461;359;3;5;453;458
17;Girona;2;Alt Empordà;17066;Figueres;4;4;B;;869;232;422;500;369;3;8;489;497
17;Girona;2;Alt Empordà;17066;Figueres;4;5;A;;810;241;378;438;372;4;9;425;434
17;Girona;2;Alt Empordà;17066;Figueres;4;5;B;;830;238;367;447;383;2;11;434;445
17;Girona;2;Alt Empordà;17066;Figueres;4;7;U;;746;214;365;425;321;2;20;403;423
17;Girona;2;Alt Empordà;17066;Figueres;4;8;U;;717;176;288;345;372;3;8;334;342
43;Tarragona;1;Alt Camp;43059;Figuerola del Camp;1;1;U;;251;58;145;169;82;0;2;167;169
17;Girona;20;Gironès;17067;Flaçà;1;1;U;;743;245;415;505;238;1;3;501;504
43;Tarragona;30;Ribera d'Ebre;43060;Flix;1;1;A;;451;135;240;308;143;1;4;303;307
43;Tarragona;30;Ribera d'Ebre;43060;Flix;1;1;B;;521;142;292;362;159;1;9;352;361
43;Tarragona;30;Ribera d'Ebre;43060;Flix;1;2;A;;602;166;303;385;217;1;20;364;384
43;Tarragona;30;Ribera d'Ebre;43060;Flix;1;2;B;;663;157;332;421;242;2;6;413;419
43;Tarragona;30;Ribera d'Ebre;43060;Flix;2;1;A;;448;125;233;288;160;0;6;282;288
43;Tarragona;30;Ribera d'Ebre;43060;Flix;2;1;B;;526;134;271;336;190;0;4;332;336
25;Lleida;18;Garrigues;25092;Floresta, la;1;1;U;;152;59;97;117;35;0;2;115;117
8;Barcelona;34;Selva;08082;Fogars de la Selva;1;1;U;;1039;184;420;509;530;5;2;502;504
8;Barcelona;41;Vallès Oriental;08081;Fogars de Montclús;1;1;U;;344;115;187;236;108;2;4;230;234
17;Girona;10;Baix Empordà;17068;Foixà;1;1;U;;257;88;150;170;87;3;5;162;167
8;Barcelona;24;Osona;08083;Folgueroles;1;1;A;;725;231;470;552;173;3;17;532;549
8;Barcelona;24;Osona;08083;Folgueroles;1;1;B;;807;284;533;618;189;0;17;601;618
25;Lleida;27;Pla d'Urgell;25093;Fondarella;1;1;U;;633;134;354;436;197;0;9;427;436
8;Barcelona;7;Bages;08084;Fonollosa;1;1;A;;300;107;206;236;64;0;5;231;236
8;Barcelona;7;Bages;08084;Fonollosa;1;1;B;;232;53;135;174;58;0;1;173;174
8;Barcelona;7;Bages;08084;Fonollosa;1;1;C;;496;86;163;206;290;0;3;203;206
17;Girona;15;Cerdanya;17069;Fontanals de Cerdanya;1;1;U;;356;101;181;231;125;2;1;228;229
17;Girona;10;Baix Empordà;17070;Fontanilles;1;1;U;;129;41;67;78;51;0;1;77;78
17;Girona;28;Pla de l'Estany;17071;Fontcoberta;1;1;A;;453;136;254;304;149;0;13;291;304
17;Girona;28;Pla de l'Estany;17071;Fontcoberta;1;1;B;;507;148;277;336;171;4;14;318;332
8;Barcelona;3;Alt Penedès;08085;Font-rubí;1;1;U;;1055;275;580;718;337;7;6;705;711
25;Lleida;23;Noguera;25094;Foradada;1;1;U;;164;42;93;115;49;1;2;112;114
17;Girona;10;Baix Empordà;17902;Forallac;1;1;U;;806;263;475;563;243;10;6;547;553
17;Girona;10;Baix Empordà;17902;Forallac;1;2;A;;261;72;148;173;88;1;2;170;172
17;Girona;10;Baix Empordà;17902;Forallac;1;2;B;;350;132;206;256;94;0;9;247;256
43;Tarragona;16;Conca de Barberà;43061;Forès;1;1;U;;58;18;24;34;24;0;1;33;34
17;Girona;20;Gironès;17073;Fornells de la Selva;1;1;A;;712;212;404;494;218;0;9;485;494
17;Girona;20;Gironès;17073;Fornells de la Selva;1;1;B;;730;200;406;512;218;1;8;503;511
17;Girona;2;Alt Empordà;17074;Fortià;1;1;U;;455;141;248;289;166;4;10;275;285
8;Barcelona;41;Vallès Oriental;08086;Franqueses del Vallès, les;1;1;A;;941;239;447;572;369;1;13;558;571
8;Barcelona;41;Vallès Oriental;08086;Franqueses del Vallès, les;1;1;B;;992;222;412;524;468;2;8;514;522
8;Barcelona;41;Vallès Oriental;08086;Franqueses del Vallès, les;1;1;C;;857;241;450;598;259;1;15;582;597
8;Barcelona;41;Vallès Oriental;08086;Franqueses del Vallès, les;1;1;D;;241;49;122;144;97;0;0;144;144
8;Barcelona;41;Vallès Oriental;08086;Franqueses del Vallès, les;1;2;A;;414;82;147;168;246;2;0;166;166
8;Barcelona;41;Vallès Oriental;08086;Franqueses del Vallès, les;1;2;B;;548;108;186;232;316;1;2;229;231
8;Barcelona;41;Vallès Oriental;08086;Franqueses del Vallès, les;1;2;C;;533;97;173;209;324;1;4;204;208
8;Barcelona;41;Vallès Oriental;08086;Franqueses del Vallès, les;1;3;A;;523;120;201;243;280;0;2;241;243
8;Barcelona;41;Vallès Oriental;08086;Franqueses del Vallès, les;1;3;B;;473;90;163;203;270;2;1;200;201
8;Barcelona;41;Vallès Oriental;08086;Franqueses del Vallès, les;1;3;C;;537;118;201;238;299;2;5;231;236
8;Barcelona;41;Vallès Oriental;08086;Franqueses del Vallès, les;1;4;A;;473;106;189;241;232;0;5;236;241
8;Barcelona;41;Vallès Oriental;08086;Franqueses del Vallès, les;1;4;B;;692;175;343;423;269;3;5;415;420
8;Barcelona;41;Vallès Oriental;08086;Franqueses del Vallès, les;1;4;C;;760;158;330;408;352;3;9;396;405
8;Barcelona;41;Vallès Oriental;08086;Franqueses del Vallès, les;1;4;D;;773;164;355;425;348;2;14;409;423
8;Barcelona;41;Vallès Oriental;08086;Franqueses del Vallès, les;1;5;A;;892;158;311;383;509;0;7;376;383
8;Barcelona;41;Vallès Oriental;08086;Franqueses del Vallès, les;1;5;B;;1117;186;397;493;624;1;6;486;492
8;Barcelona;41;Vallès Oriental;08086;Franqueses del Vallès, les;2;1;A;;792;213;434;529;263;2;16;511;527
8;Barcelona;41;Vallès Oriental;08086;Franqueses del Vallès, les;2;1;B;;459;121;269;318;141;3;8;307;315
43;Tarragona;22;Montsià;43062;Freginals;1;1;U;;309;103;161;216;93;0;6;210;216
25;Lleida;38;Urgell;25096;Fuliola, la;1;1;A;;437;113;242;299;138;3;2;294;296
25;Lleida;38;Urgell;25096;Fuliola, la;1;1;B;;561;149;306;384;177;1;1;382;383
25;Lleida;18;Garrigues;25097;Fulleda;1;1;U;;101;52;70;80;21;0;2;78;80
8;Barcelona;7;Bages;08090;Gaià;1;1;U;;123;41;68;86;37;0;4;82;86
43;Tarragona;22;Montsià;43063;Galera, la;1;1;U;;586;124;252;310;276;4;8;298;306
8;Barcelona;40;Vallès Occidental;08087;Gallifa;1;1;U;;159;50;99;127;32;1;7;119;126
43;Tarragona;37;Terra Alta;43064;Gandesa;1;1;A;;643;215;337;444;199;2;11;431;442
43;Tarragona;37;Terra Alta;43064;Gandesa;1;1;B;;656;201;340;424;232;0;14;410;424
43;Tarragona;37;Terra Alta;43064;Gandesa;2;1;A;;412;120;197;274;138;2;2;270;272
43;Tarragona;37;Terra Alta;43064;Gandesa;2;1;B;;438;163;237;297;141;2;5;290;295
43;Tarragona;30;Ribera d'Ebre;43065;Garcia;1;1;U;;452;118;245;299;153;2;5;292;297
43;Tarragona;1;Alt Camp;43066;Garidells, els;1;1;U;;165;40;76;97;68;0;3;94;97
8;Barcelona;41;Vallès Oriental;08088;Garriga, la;1;1;A;;792;221;420;536;256;0;13;523;536
8;Barcelona;41;Vallès Oriental;08088;Garriga, la;1;1;B;;836;260;460;556;280;2;25;529;554
8;Barcelona;41;Vallès Oriental;08088;Garriga, la;1;2;A;;647;160;316;389;258;7;9;373;382
8;Barcelona;41;Vallès Oriental;08088;Garriga, la;1;2;B;;590;139;271;344;246;1;14;329;343
8;Barcelona;41;Vallès Oriental;08088;Garriga, la;1;3;A;;781;181;396;475;306;3;9;463;472
8;Barcelona;41;Vallès Oriental;08088;Garriga, la;1;3;B;;819;189;418;508;311;6;20;482;502
8;Barcelona;41;Vallès Oriental;08088;Garriga, la;2;1;A;;616;187;359;442;174;3;15;424;439
8;Barcelona;41;Vallès Oriental;08088;Garriga, la;2;1;B;;558;167;313;385;173;2;13;370;383
8;Barcelona;41;Vallès Oriental;08088;Garriga, la;2;1;C;;620;208;354;429;191;3;9;417;426
8;Barcelona;41;Vallès Oriental;08088;Garriga, la;2;2;A;;833;229;421;528;305;1;7;520;527
8;Barcelona;41;Vallès Oriental;08088;Garriga, la;2;2;B;;859;198;428;515;344;4;11;500;511
8;Barcelona;41;Vallès Oriental;08088;Garriga, la;2;3;A;;828;222;433;554;274;1;15;538;553
8;Barcelona;41;Vallès Oriental;08088;Garriga, la;2;3;B;;845;200;407;525;320;5;4;516;520
8;Barcelona;41;Vallès Oriental;08088;Garriga, la;2;3;C;;793;197;393;512;281;2;9;501;510
17;Girona;2;Alt Empordà;17075;Garrigàs;1;1;U;;269;81;155;188;81;1;3;184;187
17;Girona;10;Baix Empordà;17076;Garrigoles;1;1;U;;131;50;76;93;38;1;4;88;92
17;Girona;2;Alt Empordà;17077;Garriguella;1;1;U;;538;173;283;331;207;3;4;324;328
8;Barcelona;11;Baix Llobregat;08089;Gavà;1;1;A;;640;166;299;367;273;0;5;362;367
8;Barcelona;11;Baix Llobregat;08089;Gavà;1;1;B;;738;175;321;417;321;0;7;410;417
8;Barcelona;11;Baix Llobregat;08089;Gavà;1;2;A;;572;161;273;340;232;1;7;332;339
8;Barcelona;11;Baix Llobregat;08089;Gavà;1;2;B;;696;209;350;426;270;0;4;422;426
8;Barcelona;11;Baix Llobregat;08089;Gavà;1;3;A;;477;143;234;289;188;3;8;278;286
8;Barcelona;11;Baix Llobregat;08089;Gavà;1;3;B;;504;151;246;293;211;3;4;286;290
8;Barcelona;11;Baix Llobregat;08089;Gavà;1;3;C;;505;164;249;289;216;0;4;285;289
8;Barcelona;11;Baix Llobregat;08089;Gavà;1;4;A;;752;199;309;408;344;3;7;398;405
8;Barcelona;11;Baix Llobregat;08089;Gavà;1;4;B;;863;222;390;491;372;0;18;473;491
8;Barcelona;11;Baix Llobregat;08089;Gavà;1;5;A;;445;103;173;213;232;1;8;204;212
8;Barcelona;11;Baix Llobregat;08089;Gavà;1;5;B;;524;122;200;250;274;2;5;243;248
8;Barcelona;11;Baix Llobregat;08089;Gavà;1;6;U;;544;106;187;212;332;2;6;204;210
8;Barcelona;11;Baix Llobregat;08089;Gavà;1;7;A;;673;126;272;339;334;2;6;331;337
8;Barcelona;11;Baix Llobregat;08089;Gavà;1;7;B;;756;142;286;362;394;1;8;353;361
8;Barcelona;11;Baix Llobregat;08089;Gavà;1;8;A;;699;191;350;451;248;2;12;437;449
8;Barcelona;11;Baix Llobregat;08089;Gavà;1;8;B;;818;199;383;516;302;0;7;509;516
8;Barcelona;11;Baix Llobregat;08089;Gavà;2;1;A;;548;143;268;324;224;1;8;315;323
8;Barcelona;11;Baix Llobregat;08089;Gavà;2;1;B;;562;141;238;314;248;1;9;304;313
8;Barcelona;11;Baix Llobregat;08089;Gavà;2;1;C;;582;150;272;326;256;2;1;323;324
8;Barcelona;11;Baix Llobregat;08089;Gavà;2;10;U;;393;77;143;171;222;0;4;167;171
8;Barcelona;11;Baix Llobregat;08089;Gavà;2;2;U;;865;199;371;481;384;2;7;472;479
8;Barcelona;11;Baix Llobregat;08089;Gavà;2;3;A;;374;100;163;210;164;0;3;207;210
8;Barcelona;11;Baix Llobregat;08089;Gavà;2;3;B;;377;101;172;216;161;0;3;213;216
8;Barcelona;11;Baix Llobregat;08089;Gavà;2;4;A;;658;118;207;263;395;2;8;253;261
8;Barcelona;11;Baix Llobregat;08089;Gavà;2;4;B;;811;147;256;342;469;1;8;333;341
8;Barcelona;11;Baix Llobregat;08089;Gavà;2;5;U;;714;113;205;269;445;1;3;265;268
8;Barcelona;11;Baix Llobregat;08089;Gavà;2;6;A;;680;107;212;276;404;0;7;269;276
8;Barcelona;11;Baix Llobregat;08089;Gavà;2;6;B;;805;143;267;333;472;0;11;322;333
8;Barcelona;11;Baix Llobregat;08089;Gavà;2;7;U;;750;160;274;349;401;1;9;339;348
8;Barcelona;11;Baix Llobregat;08089;Gavà;2;8;A;;670;142;245;336;334;2;2;332;334
8;Barcelona;11;Baix Llobregat;08089;Gavà;2;8;B;;755;167;275;357;398;4;13;340;353
8;Barcelona;11;Baix Llobregat;08089;Gavà;2;9;A;;656;131;236;329;327;0;5;324;329
8;Barcelona;11;Baix Llobregat;08089;Gavà;2;9;B;;766;164;274;383;383;0;0;383;383
8;Barcelona;11;Baix Llobregat;08089;Gavà;3;1;A;;451;102;197;240;211;0;4;236;240
8;Barcelona;11;Baix Llobregat;08089;Gavà;3;1;B;;505;112;204;249;256;0;1;248;249
8;Barcelona;11;Baix Llobregat;08089;Gavà;3;2;U;;900;242;385;492;408;0;6;486;492
8;Barcelona;11;Baix Llobregat;08089;Gavà;3;3;A;;778;154;280;375;403;2;7;366;373
8;Barcelona;11;Baix Llobregat;08089;Gavà;3;3;B;;851;193;332;419;432;3;8;408;416
8;Barcelona;11;Baix Llobregat;08089;Gavà;3;4;A;;547;116;202;239;308;1;3;235;238
8;Barcelona;11;Baix Llobregat;08089;Gavà;3;4;B;;624;126;207;268;356;0;8;260;268
8;Barcelona;11;Baix Llobregat;08089;Gavà;3;5;A;;787;124;221;268;519;1;1;266;267
8;Barcelona;11;Baix Llobregat;08089;Gavà;3;5;B;;688;102;218;288;400;1;8;279;287
8;Barcelona;11;Baix Llobregat;08089;Gavà;3;6;U;;921;198;367;483;438;3;11;469;480
8;Barcelona;11;Baix Llobregat;08089;Gavà;3;7;U;;807;168;336;435;372;0;7;428;435
8;Barcelona;11;Baix Llobregat;08089;Gavà;3;8;A;;885;179;370;511;374;0;9;502;511
8;Barcelona;11;Baix Llobregat;08089;Gavà;3;8;B;;943;215;385;522;421;1;6;515;521
8;Barcelona;11;Baix Llobregat;08089;Gavà;4;1;A;;514;137;234;290;224;0;1;289;290
8;Barcelona;11;Baix Llobregat;08089;Gavà;4;1;B;;637;145;269;337;300;1;9;327;336
8;Barcelona;11;Baix Llobregat;08089;Gavà;4;1;C;;648;163;291;368;280;0;1;367;368
8;Barcelona;11;Baix Llobregat;08089;Gavà;4;2;A;;642;162;259;302;340;0;5;297;302
8;Barcelona;11;Baix Llobregat;08089;Gavà;4;2;B;;723;175;288;342;381;1;3;338;341
25;Lleida;25;Pallars Jussà;25098;Gavet de la Conca;1;1;U;;259;48;147;176;83;0;3;173;176
8;Barcelona;3;Alt Penedès;08091;Gelida;1;1;A;;693;155;308;413;280;2;16;395;411
8;Barcelona;3;Alt Penedès;08091;Gelida;1;1;B;;791;196;338;420;371;0;0;420;420
8;Barcelona;3;Alt Penedès;08091;Gelida;1;2;A;;716;155;322;444;272;5;12;427;439
8;Barcelona;3;Alt Penedès;08091;Gelida;1;2;B;;825;183;356;466;359;5;8;453;461
8;Barcelona;3;Alt Penedès;08091;Gelida;2;1;A;;726;200;365;449;277;4;8;437;445
8;Barcelona;3;Alt Penedès;08091;Gelida;2;1;B;;834;220;401;508;326;6;16;486;502
17;Girona;15;Cerdanya;17078;Ger;1;1;U;;324;100;184;227;97;1;5;221;226
25;Lleida;33;Segrià;25912;Gimenells i el Pla de la Font;1;1;A;;630;123;307;367;263;4;8;355;363
25;Lleida;33;Segrià;25912;Gimenells i el Pla de la Font;1;1;B;;286;60;145;171;115;1;9;161;170
43;Tarragona;30;Ribera d'Ebre;43067;Ginestar;1;1;U;;676;139;365;459;217;5;8;446;454
17;Girona;20;Gironès;17079;Girona;1;1;U;;464;159;234;272;192;0;8;264;272
17;Girona;20;Gironès;17079;Girona;1;2;U;;634;177;276;355;279;2;10;343;353
17;Girona;20;Gironès;17079;Girona;1;3;A;;422;158;226;268;154;0;6;262;268
17;Girona;20;Gironès;17079;Girona;1;3;B;;417;142;225;266;151;1;7;258;265
17;Girona;20;Gironès;17079;Girona;1;4;A;;408;113;164;209;199;2;2;205;207
17;Girona;20;Gironès;17079;Girona;1;4;B;;409;123;181;223;186;2;5;216;221
17;Girona;20;Gironès;17079;Girona;1;5;A;;519;58;91;105;414;0;1;104;105
17;Girona;20;Gironès;17079;Girona;1;5;B;;581;74;118;143;438;0;1;142;143
17;Girona;20;Gironès;17079;Girona;1;6;A;;499;153;227;247;252;0;2;245;247
17;Girona;20;Gironès;17079;Girona;1;6;B;;501;170;239;257;244;0;2;255;257
17;Girona;20;Gironès;17079;Girona;2;1;U;;576;199;319;398;178;0;7;391;398
17;Girona;20;Gironès;17079;Girona;2;10;A;;733;215;375;440;293;0;15;425;440
17;Girona;20;Gironès;17079;Girona;2;10;B;;732;230;402;471;261;1;14;456;470
17;Girona;20;Gironès;17079;Girona;2;11;A;;801;212;357;435;366;2;6;427;433
17;Girona;20;Gironès;17079;Girona;2;11;B;;708;181;315;379;329;4;10;365;375
17;Girona;20;Gironès;17079;Girona;2;12;A;;556;176;310;382;174;3;10;369;379
17;Girona;20;Gironès;17079;Girona;2;12;B;;551;175;316;389;162;2;17;370;387
17;Girona;20;Gironès;17079;Girona;2;13;A;;451;159;259;312;139;1;7;304;311
17;Girona;20;Gironès;17079;Girona;2;13;B;;432;156;243;292;140;1;12;279;291
17;Girona;20;Gironès;17079;Girona;2;14;U;;545;154;256;287;258;3;4;280;284
17;Girona;20;Gironès;17079;Girona;2;15;A;;757;208;380;506;251;4;13;489;502
17;Girona;20;Gironès;17079;Girona;2;15;B;;807;222;417;534;273;1;11;522;533
17;Girona;20;Gironès;17079;Girona;2;16;U;;897;260;522;639;258;3;16;620;636
17;Girona;20;Gironès;17079;Girona;2;17;U;;921;248;488;607;314;2;11;594;605
17;Girona;20;Gironès;17079;Girona;2;18;U;;953;295;512;629;324;3;15;611;626
17;Girona;20;Gironès;17079;Girona;2;19;A;;600;174;318;412;188;3;18;391;409
17;Girona;20;Gironès;17079;Girona;2;19;B;;650;177;344;439;211;1;14;424;438
17;Girona;20;Gironès;17079;Girona;2;2;U;;589;207;329;420;169;2;14;404;418
17;Girona;20;Gironès;17079;Girona;2;20;A;;440;124;232;284;156;2;7;275;282
17;Girona;20;Gironès;17079;Girona;2;20;B;;457;119;233;303;154;1;7;295;302
17;Girona;20;Gironès;17079;Girona;2;21;U;;908;295;518;617;291;0;12;605;617
17;Girona;20;Gironès;17079;Girona;2;3;A;;479;150;251;308;171;3;4;301;305
17;Girona;20;Gironès;17079;Girona;2;3;B;;521;148;278;355;166;1;9;345;354
17;Girona;20;Gironès;17079;Girona;2;4;A;;650;212;372;446;204;6;10;430;440
17;Girona;20;Gironès;17079;Girona;2;4;B;;589;194;336;413;176;2;7;404;411
17;Girona;20;Gironès;17079;Girona;2;5;U;;688;250;391;491;197;4;9;478;487
17;Girona;20;Gironès;17079;Girona;2;6;A;;519;185;304;356;163;2;8;346;354
17;Girona;20;Gironès;17079;Girona;2;6;B;;417;136;221;255;162;2;6;247;253
17;Girona;20;Gironès;17079;Girona;2;6;C;;519;173;278;342;177;2;5;335;340
17;Girona;20;Gironès;17079;Girona;2;7;A;;605;174;335;422;183;1;8;413;421
17;Girona;20;Gironès;17079;Girona;2;7;B;;492;158;268;337;155;2;5;330;335
17;Girona;20;Gironès;17079;Girona;2;8;A;;726;260;450;512;214;3;16;493;509
17;Girona;20;Gironès;17079;Girona;2;8;B;;796;271;453;547;249;2;9;536;545
17;Girona;20;Gironès;17079;Girona;2;9;A;;459;102;205;267;192;3;6;258;264
17;Girona;20;Gironès;17079;Girona;2;9;B;;477;112;194;265;212;1;8;256;264
17;Girona;20;Gironès;17079;Girona;3;1;A;;368;146;213;256;112;0;7;249;256
17;Girona;20;Gironès;17079;Girona;3;1;B;;376;128;216;269;107;0;5;264;269
17;Girona;20;Gironès;17079;Girona;3;10;A;;556;148;257;306;250;3;6;297;303
17;Girona;20;Gironès;17079;Girona;3;10;B;;554;160;251;304;250;1;8;295;303
17;Girona;20;Gironès;17079;Girona;3;11;A;;573;165;250;326;247;3;5;318;323
17;Girona;20;Gironès;17079;Girona;3;11;B;;558;128;202;262;296;3;7;252;259
17;Girona;20;Gironès;17079;Girona;3;11;C;;586;161;260;320;266;3;7;310;317
17;Girona;20;Gironès;17079;Girona;3;12;A;;797;195;325;389;408;4;8;377;385
17;Girona;20;Gironès;17079;Girona;3;12;B;;780;195;322;395;385;0;7;388;395
17;Girona;20;Gironès;17079;Girona;3;13;A;;558;142;267;301;257;0;3;298;301
17;Girona;20;Gironès;17079;Girona;3;13;B;;540;143;237;266;274;0;4;262;266
17;Girona;20;Gironès;17079;Girona;3;14;A;;667;128;247;313;354;3;5;305;310
17;Girona;20;Gironès;17079;Girona;3;14;B;;594;147;239;290;304;3;3;284;287
17;Girona;20;Gironès;17079;Girona;3;15;A;;599;156;266;325;274;3;5;317;322
17;Girona;20;Gironès;17079;Girona;3;15;B;;629;164;285;359;270;2;6;351;357
17;Girona;20;Gironès;17079;Girona;3;16;A;;528;150;272;335;193;2;16;317;333
17;Girona;20;Gironès;17079;Girona;3;16;B;;594;171;303;356;238;2;5;349;354
17;Girona;20;Gironès;17079;Girona;3;17;A;;554;147;259;316;238;0;4;312;316
17;Girona;20;Gironès;17079;Girona;3;17;B;;538;123;216;264;274;0;5;259;264
17;Girona;20;Gironès;17079;Girona;3;18;A;;461;97;187;231;230;0;2;229;231
17;Girona;20;Gironès;17079;Girona;3;18;B;;443;112;197;230;213;1;3;226;229
17;Girona;20;Gironès;17079;Girona;3;2;A;;396;118;193;249;147;0;6;243;249
17;Girona;20;Gironès;17079;Girona;3;2;B;;401;113;211;261;140;5;11;245;256
17;Girona;20;Gironès;17079;Girona;3;3;A;;667;226;375;438;229;2;9;427;436
17;Girona;20;Gironès;17079;Girona;3;3;B;;660;224;357;434;226;6;11;417;428
17;Girona;20;Gironès;17079;Girona;3;4;A;;807;289;467;552;255;0;18;534;552
17;Girona;20;Gironès;17079;Girona;3;4;B;;820;287;464;585;235;2;8;575;583
17;Girona;20;Gironès;17079;Girona;3;5;A;;894;229;455;603;291;1;17;585;602
17;Girona;20;Gironès;17079;Girona;3;5;B;;896;266;461;575;321;2;8;565;573
17;Girona;20;Gironès;17079;Girona;3;6;U;;702;260;413;480;222;0;8;472;480
17;Girona;20;Gironès;17079;Girona;3;7;A;;688;200;305;362;326;2;2;358;360
17;Girona;20;Gironès;17079;Girona;3;7;B;;701;209;324;396;305;0;7;389;396
17;Girona;20;Gironès;17079;Girona;3;8;A;;868;254;410;498;370;2;7;489;496
17;Girona;20;Gironès;17079;Girona;3;8;B;;837;236;395;495;342;3;10;482;492
17;Girona;20;Gironès;17079;Girona;3;9;A;;432;133;196;225;207;1;9;215;224
17;Girona;20;Gironès;17079;Girona;3;9;B;;392;108;166;190;202;0;4;186;190
17;Girona;20;Gironès;17079;Girona;4;1;U;;530;149;246;310;220;5;9;296;305
17;Girona;20;Gironès;17079;Girona;4;2;U;;650;209;327;391;259;6;16;369;385
17;Girona;20;Gironès;17079;Girona;4;3;U;;766;198;327;402;364;5;7;390;397
17;Girona;20;Gironès;17079;Girona;5;1;A;;645;201;367;464;181;6;10;448;458
17;Girona;20;Gironès;17079;Girona;5;1;B;;555;176;322;394;161;3;6;385;391
17;Girona;20;Gironès;17079;Girona;5;1;C;;676;225;411;507;169;3;16;488;504
17;Girona;20;Gironès;17079;Girona;5;2;U;;484;141;203;234;250;1;5;228;233
17;Girona;20;Gironès;17079;Girona;5;3;A;;612;120;215;265;347;2;3;260;263
17;Girona;20;Gironès;17079;Girona;5;3;B;;525;120;209;254;271;1;7;246;253
17;Girona;20;Gironès;17079;Girona;5;4;U;;522;164;263;310;212;1;7;302;309
17;Girona;20;Gironès;17079;Girona;5;5;A;;418;109;192;210;208;1;2;207;209
17;Girona;20;Gironès;17079;Girona;5;5;B;;409;115;188;213;196;2;3;208;211
17;Girona;20;Gironès;17079;Girona;6;1;A;;769;160;334;412;357;2;2;408;410
17;Girona;20;Gironès;17079;Girona;6;1;B;;719;149;314;392;327;0;5;387;392
17;Girona;20;Gironès;17079;Girona;6;2;A;;821;217;377;426;395;0;11;415;426
17;Girona;20;Gironès;17079;Girona;6;2;B;;759;195;357;428;331;1;9;418;427
17;Girona;20;Gironès;17079;Girona;6;3;A;;705;175;287;346;359;1;6;339;345
17;Girona;20;Gironès;17079;Girona;6;3;B;;752;181;300;384;368;0;6;378;384
17;Girona;20;Gironès;17079;Girona;6;4;A;;602;148;265;312;290;5;0;307;307
17;Girona;20;Gironès;17079;Girona;6;4;B;;527;122;221;267;260;0;5;262;267
17;Girona;20;Gironès;17079;Girona;6;5;U;;489;113;176;204;285;2;5;197;202
8;Barcelona;14;Berguedà;08092;Gironella;1;1;A;;593;182;320;381;212;1;8;372;380
8;Barcelona;14;Berguedà;08092;Gironella;1;1;B;;703;220;386;451;252;4;9;438;447
8;Barcelona;14;Berguedà;08092;Gironella;2;1;U;;414;114;192;234;180;3;4;227;231
8;Barcelona;14;Berguedà;08092;Gironella;2;2;A;;518;127;294;327;191;4;4;319;323
8;Barcelona;14;Berguedà;08092;Gironella;2;2;B;;611;136;340;383;228;3;8;372;380
8;Barcelona;14;Berguedà;08092;Gironella;2;3;A;;537;142;274;331;206;4;11;316;327
8;Barcelona;14;Berguedà;08092;Gironella;2;3;B;;596;167;315;376;220;7;14;355;369
8;Barcelona;14;Berguedà;08093;Gisclareny;1;1;U;;33;4;18;25;8;0;1;24;25
43;Tarragona;22;Montsià;43068;Godall;1;1;U;;591;140;311;379;212;3;4;372;376
25;Lleida;27;Pla d'Urgell;25099;Golmés;1;1;A;;552;133;273;330;222;0;8;322;330
25;Lleida;27;Pla d'Urgell;25099;Golmés;1;1;B;;604;146;320;384;220;3;7;374;381
17;Girona;31;Ripollès;17080;Gombrèn;1;1;U;;194;65;105;143;51;0;0;143;143
25;Lleida;14;Berguedà;25100;Gósol;1;1;U;;199;60;101;129;70;1;0;128;128
8;Barcelona;3;Alt Penedès;08094;Granada, la;1;1;A;;645;139;330;430;215;2;4;424;428
8;Barcelona;3;Alt Penedès;08094;Granada, la;1;1;B;;744;159;352;461;283;5;4;452;456
25;Lleida;18;Garrigues;25101;Granadella, la;1;1;U;;655;197;360;431;224;2;4;425;429
8;Barcelona;;;08095;Granera;1;1;U;;72;29;50;60;12;1;1;58;59
25;Lleida;33;Segrià;25102;Granja d'Escarp, la;1;1;U;;826;217;459;525;301;29;9;487;496
8;Barcelona;41;Vallès Oriental;08096;Granollers;1;1;U;;502;189;308;353;149;2;6;345;351
8;Barcelona;41;Vallès Oriental;08096;Granollers;1;10;A;;510;131;234;283;227;0;7;276;283
8;Barcelona;41;Vallès Oriental;08096;Granollers;1;10;B;;662;167;289;355;307;3;2;350;352
8;Barcelona;41;Vallès Oriental;08096;Granollers;1;11;A;;381;94;153;180;201;0;4;176;180
8;Barcelona;41;Vallès Oriental;08096;Granollers;1;11;B;;468;98;166;211;257;2;1;208;209
8;Barcelona;41;Vallès Oriental;08096;Granollers;1;11;C;;370;79;134;160;210;2;2;156;158
8;Barcelona;41;Vallès Oriental;08096;Granollers;1;2;A;;458;171;265;318;140;2;5;311;316
8;Barcelona;41;Vallès Oriental;08096;Granollers;1;2;B;;554;214;358;411;143;2;2;407;409
8;Barcelona;41;Vallès Oriental;08096;Granollers;1;3;A;;416;127;233;281;135;1;5;275;280
8;Barcelona;41;Vallès Oriental;08096;Granollers;1;3;B;;504;147;264;325;179;0;7;318;325
8;Barcelona;41;Vallès Oriental;08096;Granollers;1;3;C;;472;126;259;313;159;3;4;306;310
8;Barcelona;41;Vallès Oriental;08096;Granollers;1;4;U;;381;121;190;222;159;0;3;219;222
8;Barcelona;41;Vallès Oriental;08096;Granollers;1;5;A;;454;154;249;312;142;4;6;302;308
8;Barcelona;41;Vallès Oriental;08096;Granollers;1;5;B;;508;127;261;335;173;0;7;328;335
8;Barcelona;41;Vallès Oriental;08096;Granollers;1;5;C;;488;169;288;356;132;2;4;350;354
8;Barcelona;41;Vallès Oriental;08096;Granollers;1;6;A;;382;108;271;175;207;0;10;165;175
8;Barcelona;41;Vallès Oriental;08096;Granollers;1;6;B;;545;191;279;299;246;4;5;290;295
8;Barcelona;41;Vallès Oriental;08096;Granollers;1;7;A;;530;148;281;366;164;1;9;356;365
8;Barcelona;41;Vallès Oriental;08096;Granollers;1;7;B;;692;171;352;456;236;1;10;445;455
8;Barcelona;41;Vallès Oriental;08096;Granollers;1;8;U;;501;111;190;251;250;0;2;249;251
8;Barcelona;41;Vallès Oriental;08096;Granollers;1;9;A;;405;76;127;164;241;2;2;160;162
8;Barcelona;41;Vallès Oriental;08096;Granollers;1;9;B;;497;99;180;222;275;0;2;220;222
8;Barcelona;41;Vallès Oriental;08096;Granollers;2;1;A;;621;202;318;409;212;0;0;409;409
8;Barcelona;41;Vallès Oriental;08096;Granollers;2;1;B;;658;228;359;438;220;1;6;431;437
8;Barcelona;41;Vallès Oriental;08096;Granollers;2;2;U;;432;159;276;333;99;2;4;327;331
8;Barcelona;41;Vallès Oriental;08096;Granollers;2;3;U;;483;152;267;337;146;2;13;322;335
8;Barcelona;41;Vallès Oriental;08096;Granollers;2;4;A;;548;111;221;295;253;0;4;291;295
8;Barcelona;41;Vallès Oriental;08096;Granollers;2;4;B;;668;150;298;379;289;1;2;376;378
8;Barcelona;41;Vallès Oriental;08096;Granollers;2;4;C;;597;128;259;331;266;1;3;327;330
8;Barcelona;41;Vallès Oriental;08096;Granollers;2;5;U;;885;236;428;505;380;1;11;493;504
8;Barcelona;41;Vallès Oriental;08096;Granollers;2;6;A;;477;137;237;279;198;0;4;275;279
8;Barcelona;41;Vallès Oriental;08096;Granollers;2;6;B;;624;187;321;386;238;5;8;373;381
8;Barcelona;41;Vallès Oriental;08096;Granollers;2;7;A;;443;111;187;248;195;0;5;243;248
8;Barcelona;41;Vallès Oriental;08096;Granollers;2;7;B;;499;130;213;265;234;0;2;263;265
8;Barcelona;41;Vallès Oriental;08096;Granollers;3;1;A;;506;165;271;355;151;0;7;348;355
8;Barcelona;41;Vallès Oriental;08096;Granollers;3;1;B;;448;148;237;302;146;1;1;300;301
8;Barcelona;41;Vallès Oriental;08096;Granollers;3;1;C;;555;190;306;378;177;1;9;368;377
8;Barcelona;41;Vallès Oriental;08096;Granollers;3;2;A;;633;145;258;340;293;2;9;329;338
8;Barcelona;41;Vallès Oriental;08096;Granollers;3;2;B;;778;169;316;386;392;0;6;380;386
8;Barcelona;41;Vallès Oriental;08096;Granollers;3;3;A;;437;110;206;265;172;1;4;260;264
8;Barcelona;41;Vallès Oriental;08096;Granollers;3;3;B;;519;111;229;282;237;0;3;279;282
8;Barcelona;41;Vallès Oriental;08096;Granollers;3;4;A;;664;168;326;419;245;2;15;402;417
8;Barcelona;41;Vallès Oriental;08096;Granollers;3;4;B;;797;210;365;490;307;2;4;484;488
8;Barcelona;41;Vallès Oriental;08096;Granollers;3;5;A;;656;169;308;381;275;0;11;370;381
8;Barcelona;41;Vallès Oriental;08096;Granollers;3;5;B;;700;215;371;431;269;0;11;420;431
8;Barcelona;41;Vallès Oriental;08096;Granollers;3;6;A;;564;143;250;325;239;1;4;320;324
8;Barcelona;41;Vallès Oriental;08096;Granollers;3;6;B;;624;139;250;330;294;0;9;321;330
8;Barcelona;41;Vallès Oriental;08096;Granollers;3;6;C;;651;157;275;361;290;0;9;352;361
8;Barcelona;41;Vallès Oriental;08096;Granollers;3;7;U;;688;188;288;357;331;4;13;340;353
8;Barcelona;41;Vallès Oriental;08096;Granollers;3;8;A;;407;54;125;168;239;2;5;161;166
8;Barcelona;41;Vallès Oriental;08096;Granollers;3;8;B;;508;67;144;190;318;0;4;186;190
8;Barcelona;41;Vallès Oriental;08096;Granollers;3;9;U;;733;176;351;459;274;0;14;445;459
8;Barcelona;41;Vallès Oriental;08096;Granollers;4;1;A;;565;180;326;399;166;0;13;386;399
8;Barcelona;41;Vallès Oriental;08096;Granollers;4;1;B;;541;160;298;358;183;2;11;345;356
8;Barcelona;41;Vallès Oriental;08096;Granollers;4;1;C;;566;172;299;381;185;3;9;369;378
8;Barcelona;41;Vallès Oriental;08096;Granollers;4;10;A;;509;127;248;316;193;0;2;314;316
8;Barcelona;41;Vallès Oriental;08096;Granollers;4;10;B;;672;142;313;407;265;0;3;404;407
8;Barcelona;41;Vallès Oriental;08096;Granollers;4;10;C;;585;128;282;354;231;0;5;349;354
8;Barcelona;41;Vallès Oriental;08096;Granollers;4;10;D;;318;112;199;216;102;4;5;207;212
8;Barcelona;41;Vallès Oriental;08096;Granollers;4;11;A;;536;137;283;346;190;1;4;341;345
8;Barcelona;41;Vallès Oriental;08096;Granollers;4;11;B;;684;191;352;438;246;2;2;434;436
8;Barcelona;41;Vallès Oriental;08096;Granollers;4;2;A;;522;120;226;287;235;1;6;280;286
8;Barcelona;41;Vallès Oriental;08096;Granollers;4;2;B;;605;157;300;396;209;0;7;389;396
8;Barcelona;41;Vallès Oriental;08096;Granollers;4;2;C;;485;124;228;276;209;1;3;272;275
8;Barcelona;41;Vallès Oriental;08096;Granollers;4;3;U;;590;170;272;336;254;3;6;327;333
8;Barcelona;41;Vallès Oriental;08096;Granollers;4;4;U;;714;190;302;364;350;7;1;356;357
8;Barcelona;41;Vallès Oriental;08096;Granollers;4;5;U;;489;145;225;276;213;1;8;267;275
8;Barcelona;41;Vallès Oriental;08096;Granollers;4;6;U;;795;218;381;450;345;2;7;441;448
8;Barcelona;41;Vallès Oriental;08096;Granollers;4;7;A;;482;109;219;280;202;0;8;272;280
8;Barcelona;41;Vallès Oriental;08096;Granollers;4;7;B;;627;134;267;361;266;2;7;352;359
8;Barcelona;41;Vallès Oriental;08096;Granollers;4;7;C;;524;116;252;310;214;1;5;304;309
8;Barcelona;41;Vallès Oriental;08096;Granollers;4;7;D;;179;45;92;116;63;0;1;115;116
8;Barcelona;41;Vallès Oriental;08096;Granollers;4;8;U;;521;141;223;288;233;1;4;283;287
8;Barcelona;41;Vallès Oriental;08096;Granollers;4;9;A;;418;105;170;204;214;3;6;195;201
8;Barcelona;41;Vallès Oriental;08096;Granollers;4;9;B;;486;129;226;263;223;2;4;257;261
25;Lleida;32;Segarra;25103;Granyanella;1;1;U;;149;16;61;75;74;0;5;70;75
25;Lleida;18;Garrigues;25105;Granyena de les Garrigues;1;1;U;;146;50;88;99;47;1;2;96;98
25;Lleida;32;Segarra;25104;Granyena de Segarra;1;1;U;;142;45;74;91;51;0;7;84;91
43;Tarragona;29;Priorat;43069;Gratallops;1;1;U;;199;54;104;140;59;1;2;137;139
8;Barcelona;41;Vallès Oriental;08097;Gualba;1;1;U;;816;226;407;499;317;1;7;491;498
17;Girona;10;Baix Empordà;17081;Gualta;1;1;U;;225;98;150;169;56;2;3;164;167
8;Barcelona;14;Berguedà;08099;Guardiola de Berguedà;1;1;U;;769;230;454;521;248;5;4;512;516
43;Tarragona;29;Priorat;43070;Guiamets, els;1;1;U;;272;84;174;205;67;0;1;204;205
17;Girona;15;Cerdanya;17082;Guils de Cerdanya;1;1;U;;341;88;147;199;142;1;3;195;198
25;Lleida;38;Urgell;25109;Guimerà;1;1;U;;293;61;151;192;101;0;3;189;192
25;Lleida;26;Pallars Sobirà;25903;Guingueta d'Àneu, la;1;1;U;;273;73;134;184;89;1;2;181;183
25;Lleida;32;Segarra;25110;Guissona;1;1;U;;783;192;384;483;300;3;11;469;480
25;Lleida;32;Segarra;25110;Guissona;1;2;A;;528;102;222;294;234;4;3;287;290
25;Lleida;32;Segarra;25110;Guissona;1;2;B;;599;131;270;343;256;2;8;333;341
25;Lleida;32;Segarra;25110;Guissona;1;3;U;;714;163;341;442;272;4;20;418;438
25;Lleida;35;Solsonès;25111;Guixers;1;1;U;;129;32;64;93;36;0;1;92;93
8;Barcelona;24;Osona;08100;Gurb;1;1;A;;667;130;391;510;157;1;16;493;509
8;Barcelona;24;Osona;08100;Gurb;1;1;B;;545;109;303;402;143;1;19;382;401
8;Barcelona;24;Osona;08100;Gurb;1;1;C;;536;110;315;402;134;1;15;386;401
43;Tarragona;37;Terra Alta;43071;Horta de Sant Joan;1;1;U;;985;283;529;691;294;3;14;674;688
8;Barcelona;13;Barcelonès;08101;Hospitalet de Llobregat, l';1;1;U;;1270;281;512;668;602;2;19;647;666
8;Barcelona;13;Barcelonès;08101;Hospitalet de Llobregat, l';1;10;U;;987;244;408;521;466;4;2;515;517
8;Barcelona;13;Barcelonès;08101;Hospitalet de Llobregat, l';1;11;U;;677;198;307;393;284;2;2;389;391
8;Barcelona;13;Barcelonès;08101;Hospitalet de Llobregat, l';1;12;U;;1173;335;556;699;474;2;18;679;697
8;Barcelona;13;Barcelonès;08101;Hospitalet de Llobregat, l';1;13;U;;1108;265;517;660;448;1;17;642;659
8;Barcelona;13;Barcelonès;08101;Hospitalet de Llobregat, l';1;14;A;;596;153;238;295;301;1;2;292;294
8;Barcelona;13;Barcelonès;08101;Hospitalet de Llobregat, l';1;14;B;;643;159;237;320;323;1;4;315;319
8;Barcelona;13;Barcelonès;08101;Hospitalet de Llobregat, l';1;15;U;;975;221;391;501;474;1;6;494;500
8;Barcelona;13;Barcelonès;08101;Hospitalet de Llobregat, l';1;16;A;;539;130;232;297;242;3;2;292;294
8;Barcelona;13;Barcelonès;08101;Hospitalet de Llobregat, l';1;16;B;;638;161;274;344;294;0;8;336;344
8;Barcelona;13;Barcelonès;08101;Hospitalet de Llobregat, l';1;17;A;;713;160;260;338;375;0;4;334;338
8;Barcelona;13;Barcelonès;08101;Hospitalet de Llobregat, l';1;17;B;;799;185;334;426;373;2;13;411;424
8;Barcelona;13;Barcelonès;08101;Hospitalet de Llobregat, l';1;18;A;;633;158;288;350;283;1;6;343;349
8;Barcelona;13;Barcelonès;08101;Hospitalet de Llobregat, l';1;18;B;;649;147;261;356;293;1;8;347;355
8;Barcelona;13;Barcelonès;08101;Hospitalet de Llobregat, l';1;19;U;;1097;288;467;583;514;0;10;573;583
8;Barcelona;13;Barcelonès;08101;Hospitalet de Llobregat, l';1;2;A;;587;140;236;335;252;3;8;324;332
8;Barcelona;13;Barcelonès;08101;Hospitalet de Llobregat, l';1;2;B;;660;170;298;383;277;4;6;373;379
8;Barcelona;13;Barcelonès;08101;Hospitalet de Llobregat, l';1;20;U;;1251;309;533;691;560;0;22;669;691
8;Barcelona;13;Barcelonès;08101;Hospitalet de Llobregat, l';1;21;U;;582;139;239;282;300;2;6;274;280
8;Barcelona;13;Barcelonès;08101;Hospitalet de Llobregat, l';1;22;U;;625;168;282;332;293;1;6;325;331
8;Barcelona;13;Barcelonès;08101;Hospitalet de Llobregat, l';1;23;U;;995;285;515;629;366;1;17;611;628
8;Barcelona;13;Barcelonès;08101;Hospitalet de Llobregat, l';1;24;U;;605;179;303;388;217;1;8;379;387
8;Barcelona;13;Barcelonès;08101;Hospitalet de Llobregat, l';1;25;U;;1094;252;429;550;544;4;12;534;546
8;Barcelona;13;Barcelonès;08101;Hospitalet de Llobregat, l';1;26;U;;790;209;364;455;335;4;5;446;451
8;Barcelona;13;Barcelonès;08101;Hospitalet de Llobregat, l';1;27;U;;614;151;254;314;300;0;7;307;314
8;Barcelona;13;Barcelonès;08101;Hospitalet de Llobregat, l';1;28;U;;733;155;255;338;395;2;5;331;336
8;Barcelona;13;Barcelonès;08101;Hospitalet de Llobregat, l';1;29;U;;800;173;301;375;425;2;4;369;373
8;Barcelona;13;Barcelonès;08101;Hospitalet de Llobregat, l';1;3;U;;564;129;243;310;254;0;5;305;310
8;Barcelona;13;Barcelonès;08101;Hospitalet de Llobregat, l';1;30;U;;785;264;412;500;285;2;2;496;498
8;Barcelona;13;Barcelonès;08101;Hospitalet de Llobregat, l';1;31;U;;1096;247;452;540;556;2;9;529;538
8;Barcelona;13;Barcelonès;08101;Hospitalet de Llobregat, l';1;32;A;;732;140;279;350;382;4;6;340;346
8;Barcelona;13;Barcelonès;08101;Hospitalet de Llobregat, l';1;32;B;;858;152;282;384;474;0;6;378;384
8;Barcelona;13;Barcelonès;08101;Hospitalet de Llobregat, l';1;33;U;;698;224;356;436;262;0;2;434;436
8;Barcelona;13;Barcelonès;08101;Hospitalet de Llobregat, l';1;34;U;;969;253;442;558;411;1;7;550;557
8;Barcelona;13;Barcelonès;08101;Hospitalet de Llobregat, l';1;35;U;;1159;245;430;579;580;5;14;560;574
8;Barcelona;13;Barcelonès;08101;Hospitalet de Llobregat, l';1;36;U;;925;242;430;543;382;2;10;531;541
8;Barcelona;13;Barcelonès;08101;Hospitalet de Llobregat, l';1;37;U;;1036;259;468;574;462;5;11;558;569
8;Barcelona;13;Barcelonès;08101;Hospitalet de Llobregat, l';1;38;U;;612;163;290;356;256;9;2;345;347
8;Barcelona;13;Barcelonès;08101;Hospitalet de Llobregat, l';1;39;U;;640;160;247;310;330;4;0;306;306
8;Barcelona;13;Barcelonès;08101;Hospitalet de Llobregat, l';1;4;U;;676;213;384;437;239;0;7;430;437
8;Barcelona;13;Barcelonès;08101;Hospitalet de Llobregat, l';1;40;U;;679;175;280;343;336;1;6;336;342
8;Barcelona;13;Barcelonès;08101;Hospitalet de Llobregat, l';1;5;U;;913;216;395;517;396;2;14;501;515
8;Barcelona;13;Barcelonès;08101;Hospitalet de Llobregat, l';1;6;A;;679;140;276;343;336;1;5;337;342
8;Barcelona;13;Barcelonès;08101;Hospitalet de Llobregat, l';1;6;B;;814;195;306;390;424;4;7;379;386
8;Barcelona;13;Barcelonès;08101;Hospitalet de Llobregat, l';1;7;A;;589;149;246;298;291;0;7;291;298
8;Barcelona;13;Barcelonès;08101;Hospitalet de Llobregat, l';1;7;B;;680;164;281;355;325;3;10;342;352
8;Barcelona;13;Barcelonès;08101;Hospitalet de Llobregat, l';1;8;U;;1042;338;573;678;364;2;18;658;676
8;Barcelona;13;Barcelonès;08101;Hospitalet de Llobregat, l';1;9;U;;850;262;448;537;313;0;18;519;537
8;Barcelona;13;Barcelonès;08101;Hospitalet de Llobregat, l';2;1;U;;458;139;205;250;208;1;3;246;249
8;Barcelona;13;Barcelonès;08101;Hospitalet de Llobregat, l';2;10;U;;697;205;344;413;284;0;7;406;413
8;Barcelona;13;Barcelonès;08101;Hospitalet de Llobregat, l';2;11;U;;766;202;294;351;415;1;7;343;350
8;Barcelona;13;Barcelonès;08101;Hospitalet de Llobregat, l';2;12;U;;831;223;324;384;447;1;6;377;383
8;Barcelona;13;Barcelonès;08101;Hospitalet de Llobregat, l';2;13;U;;635;168;265;334;301;1;5;328;333
8;Barcelona;13;Barcelonès;08101;Hospitalet de Llobregat, l';2;14;U;;399;109;153;184;215;3;3;178;181
8;Barcelona;13;Barcelonès;08101;Hospitalet de Llobregat, l';2;15;U;;590;141;233;291;299;0;3;288;291
8;Barcelona;13;Barcelonès;08101;Hospitalet de Llobregat, l';2;16;U;;883;213;357;423;460;4;3;416;419
8;Barcelona;13;Barcelonès;08101;Hospitalet de Llobregat, l';2;17;U;;380;95;146;182;198;0;3;179;182
8;Barcelona;13;Barcelonès;08101;Hospitalet de Llobregat, l';2;18;U;;486;135;211;255;231;0;3;252;255
8;Barcelona;13;Barcelonès;08101;Hospitalet de Llobregat, l';2;19;U;;769;239;354;413;356;2;12;399;411
8;Barcelona;13;Barcelonès;08101;Hospitalet de Llobregat, l';2;2;U;;485;140;210;254;231;0;3;251;254
8;Barcelona;13;Barcelonès;08101;Hospitalet de Llobregat, l';2;20;U;;524;133;219;267;257;0;3;264;267
8;Barcelona;13;Barcelonès;08101;Hospitalet de Llobregat, l';2;21;U;;732;158;277;348;384;0;9;339;348
8;Barcelona;13;Barcelonès;08101;Hospitalet de Llobregat, l';2;22;U;;525;135;206;239;286;2;7;230;237
8;Barcelona;13;Barcelonès;08101;Hospitalet de Llobregat, l';2;23;U;;686;188;333;350;336;1;4;345;349
8;Barcelona;13;Barcelonès;08101;Hospitalet de Llobregat, l';2;24;U;;380;81;139;181;199;0;2;179;181
8;Barcelona;13;Barcelonès;08101;Hospitalet de Llobregat, l';2;25;U;;327;88;126;163;164;2;4;157;161
8;Barcelona;13;Barcelonès;08101;Hospitalet de Llobregat, l';2;26;U;;793;202;340;414;379;2;15;397;412
8;Barcelona;13;Barcelonès;08101;Hospitalet de Llobregat, l';2;27;U;;426;125;210;259;167;0;3;256;259
8;Barcelona;13;Barcelonès;08101;Hospitalet de Llobregat, l';2;28;U;;421;124;163;209;212;0;8;201;209
8;Barcelona;13;Barcelonès;08101;Hospitalet de Llobregat, l';2;29;U;;465;124;195;232;233;2;1;229;230
8;Barcelona;13;Barcelonès;08101;Hospitalet de Llobregat, l';2;3;U;;467;119;179;214;253;1;3;210;213
8;Barcelona;13;Barcelonès;08101;Hospitalet de Llobregat, l';2;30;U;;463;91;164;190;273;0;3;187;190
8;Barcelona;13;Barcelonès;08101;Hospitalet de Llobregat, l';2;31;U;;643;173;276;328;315;1;6;321;327
8;Barcelona;13;Barcelonès;08101;Hospitalet de Llobregat, l';2;32;U;;670;193;320;375;295;0;13;362;375
8;Barcelona;13;Barcelonès;08101;Hospitalet de Llobregat, l';2;33;U;;507;164;236;285;222;0;6;279;285
8;Barcelona;13;Barcelonès;08101;Hospitalet de Llobregat, l';2;34;U;;572;163;244;300;272;0;3;297;300
8;Barcelona;13;Barcelonès;08101;Hospitalet de Llobregat, l';2;35;A;;356;95;147;181;175;1;8;172;180
8;Barcelona;13;Barcelonès;08101;Hospitalet de Llobregat, l';2;35;B;;426;123;186;224;202;0;3;221;224
8;Barcelona;13;Barcelonès;08101;Hospitalet de Llobregat, l';2;36;U;;664;207;363;384;280;0;10;374;384
8;Barcelona;13;Barcelonès;08101;Hospitalet de Llobregat, l';2;37;U;;808;194;338;418;390;1;10;407;417
8;Barcelona;13;Barcelonès;08101;Hospitalet de Llobregat, l';2;38;U;;599;171;263;328;271;2;4;322;326
8;Barcelona;13;Barcelonès;08101;Hospitalet de Llobregat, l';2;39;U;;812;227;359;442;370;1;14;427;441
8;Barcelona;13;Barcelonès;08101;Hospitalet de Llobregat, l';2;4;U;;354;96;120;168;186;0;3;165;168
8;Barcelona;13;Barcelonès;08101;Hospitalet de Llobregat, l';2;40;U;;461;127;211;259;202;0;7;252;259
8;Barcelona;13;Barcelonès;08101;Hospitalet de Llobregat, l';2;41;U;;486;113;201;266;220;1;5;260;265
8;Barcelona;13;Barcelonès;08101;Hospitalet de Llobregat, l';2;42;U;;719;194;306;388;331;0;3;385;388
8;Barcelona;13;Barcelonès;08101;Hospitalet de Llobregat, l';2;43;A;;479;129;225;280;199;0;4;276;280
8;Barcelona;13;Barcelonès;08101;Hospitalet de Llobregat, l';2;43;B;;539;147;232;301;238;5;7;289;296
8;Barcelona;13;Barcelonès;08101;Hospitalet de Llobregat, l';2;44;U;;443;115;208;238;205;0;4;234;238
8;Barcelona;13;Barcelonès;08101;Hospitalet de Llobregat, l';2;45;U;;642;167;284;352;290;0;10;342;352
8;Barcelona;13;Barcelonès;08101;Hospitalet de Llobregat, l';2;46;U;;665;189;289;353;312;1;5;347;352
8;Barcelona;13;Barcelonès;08101;Hospitalet de Llobregat, l';2;47;U;;770;213;341;414;356;1;8;405;413
8;Barcelona;13;Barcelonès;08101;Hospitalet de Llobregat, l';2;48;U;;744;184;316;395;349;1;10;384;394
8;Barcelona;13;Barcelonès;08101;Hospitalet de Llobregat, l';2;49;U;;685;201;293;353;332;1;2;350;352
8;Barcelona;13;Barcelonès;08101;Hospitalet de Llobregat, l';2;5;U;;690;178;280;367;323;1;0;366;366
8;Barcelona;13;Barcelonès;08101;Hospitalet de Llobregat, l';2;6;U;;580;187;275;328;252;1;4;323;327
8;Barcelona;13;Barcelonès;08101;Hospitalet de Llobregat, l';2;7;U;;492;147;238;265;227;2;2;261;263
8;Barcelona;13;Barcelonès;08101;Hospitalet de Llobregat, l';2;8;A;;633;156;256;358;275;0;5;353;358
8;Barcelona;13;Barcelonès;08101;Hospitalet de Llobregat, l';2;8;B;;700;202;341;423;277;1;10;412;422
8;Barcelona;13;Barcelonès;08101;Hospitalet de Llobregat, l';2;9;U;;672;193;340;402;270;2;7;393;400
8;Barcelona;13;Barcelonès;08101;Hospitalet de Llobregat, l';3;1;A;;832;205;334;421;411;2;6;413;419
8;Barcelona;13;Barcelonès;08101;Hospitalet de Llobregat, l';3;1;B;;997;248;422;530;467;0;6;524;530
8;Barcelona;13;Barcelonès;08101;Hospitalet de Llobregat, l';3;10;U;;722;200;294;356;366;0;5;351;356
8;Barcelona;13;Barcelonès;08101;Hospitalet de Llobregat, l';3;11;U;;960;254;414;491;469;1;5;485;490
8;Barcelona;13;Barcelonès;08101;Hospitalet de Llobregat, l';3;12;A;;507;138;238;288;219;1;5;282;287
8;Barcelona;13;Barcelonès;08101;Hospitalet de Llobregat, l';3;12;B;;515;161;242;294;221;0;6;288;294
8;Barcelona;13;Barcelonès;08101;Hospitalet de Llobregat, l';3;13;A;;683;153;260;352;331;2;6;344;350
8;Barcelona;13;Barcelonès;08101;Hospitalet de Llobregat, l';3;13;B;;771;179;312;402;369;0;11;391;402
8;Barcelona;13;Barcelonès;08101;Hospitalet de Llobregat, l';3;14;A;;785;170;314;407;378;1;8;398;406
8;Barcelona;13;Barcelonès;08101;Hospitalet de Llobregat, l';3;14;B;;986;215;362;490;496;6;4;480;484
8;Barcelona;13;Barcelonès;08101;Hospitalet de Llobregat, l';3;15;U;;1145;243;444;539;606;5;21;513;534
8;Barcelona;13;Barcelonès;08101;Hospitalet de Llobregat, l';3;16;A;;824;222;406;534;290;0;22;512;534
8;Barcelona;13;Barcelonès;08101;Hospitalet de Llobregat, l';3;16;B;;979;234;461;609;370;4;8;597;605
8;Barcelona;13;Barcelonès;08101;Hospitalet de Llobregat, l';3;17;U;;555;106;213;254;301;5;6;243;249
8;Barcelona;13;Barcelonès;08101;Hospitalet de Llobregat, l';3;18;U;;652;161;280;382;270;0;7;375;382
8;Barcelona;13;Barcelonès;08101;Hospitalet de Llobregat, l';3;19;U;;1096;270;504;577;519;1;15;561;576
8;Barcelona;13;Barcelonès;08101;Hospitalet de Llobregat, l';3;2;U;;1082;252;417;534;548;5;12;517;529
8;Barcelona;13;Barcelonès;08101;Hospitalet de Llobregat, l';3;20;U;;737;213;332;421;316;2;8;411;419
8;Barcelona;13;Barcelonès;08101;Hospitalet de Llobregat, l';3;21;A;;868;240;430;526;342;0;10;516;526
8;Barcelona;13;Barcelonès;08101;Hospitalet de Llobregat, l';3;21;B;;918;254;450;566;352;1;10;555;565
8;Barcelona;13;Barcelonès;08101;Hospitalet de Llobregat, l';3;22;U;;835;192;339;433;402;1;7;425;432
8;Barcelona;13;Barcelonès;08101;Hospitalet de Llobregat, l';3;23;A;;1034;220;403;501;533;2;10;489;499
8;Barcelona;13;Barcelonès;08101;Hospitalet de Llobregat, l';3;23;B;;1228;273;529;660;568;2;11;647;658
8;Barcelona;13;Barcelonès;08101;Hospitalet de Llobregat, l';3;24;U;;592;151;232;290;302;0;6;284;290
8;Barcelona;13;Barcelonès;08101;Hospitalet de Llobregat, l';3;25;A;;680;184;346;434;246;0;6;428;434
8;Barcelona;13;Barcelonès;08101;Hospitalet de Llobregat, l';3;25;B;;775;212;376;476;299;1;14;461;475
8;Barcelona;13;Barcelonès;08101;Hospitalet de Llobregat, l';3;3;A;;596;165;277;338;258;1;7;330;337
8;Barcelona;13;Barcelonès;08101;Hospitalet de Llobregat, l';3;3;B;;599;153;254;311;288;1;5;305;310
8;Barcelona;13;Barcelonès;08101;Hospitalet de Llobregat, l';3;4;U;;934;257;390;474;460;0;6;468;474
8;Barcelona;13;Barcelonès;08101;Hospitalet de Llobregat, l';3;5;U;;1165;337;593;714;451;3;19;692;711
8;Barcelona;13;Barcelonès;08101;Hospitalet de Llobregat, l';3;6;U;;1106;319;531;653;453;3;10;640;650
8;Barcelona;13;Barcelonès;08101;Hospitalet de Llobregat, l';3;7;A;;581;170;301;362;219;2;8;352;360
8;Barcelona;13;Barcelonès;08101;Hospitalet de Llobregat, l';3;7;B;;627;176;310;382;245;0;8;374;382
8;Barcelona;13;Barcelonès;08101;Hospitalet de Llobregat, l';3;8;A;;721;183;312;417;304;0;11;406;417
8;Barcelona;13;Barcelonès;08101;Hospitalet de Llobregat, l';3;8;B;;830;206;406;530;300;1;12;517;529
8;Barcelona;13;Barcelonès;08101;Hospitalet de Llobregat, l';3;9;U;;608;126;276;357;251;0;8;349;357
8;Barcelona;13;Barcelonès;08101;Hospitalet de Llobregat, l';4;1;U;;829;230;386;481;348;0;8;473;481
8;Barcelona;13;Barcelonès;08101;Hospitalet de Llobregat, l';4;10;A;;573;138;242;293;280;0;7;286;293
8;Barcelona;13;Barcelonès;08101;Hospitalet de Llobregat, l';4;10;B;;621;153;237;294;327;0;7;287;294
8;Barcelona;13;Barcelonès;08101;Hospitalet de Llobregat, l';4;11;U;;755;201;329;397;358;1;6;390;396
8;Barcelona;13;Barcelonès;08101;Hospitalet de Llobregat, l';4;12;A;;539;141;239;283;256;2;2;279;281
8;Barcelona;13;Barcelonès;08101;Hospitalet de Llobregat, l';4;12;B;;634;145;274;337;297;0;2;335;337
8;Barcelona;13;Barcelonès;08101;Hospitalet de Llobregat, l';4;13;U;;379;107;169;196;183;6;0;190;190
8;Barcelona;13;Barcelonès;08101;Hospitalet de Llobregat, l';4;14;U;;595;149;263;301;294;0;2;299;301
8;Barcelona;13;Barcelonès;08101;Hospitalet de Llobregat, l';4;15;U;;403;80;135;168;235;0;8;160;168
8;Barcelona;13;Barcelonès;08101;Hospitalet de Llobregat, l';4;16;U;;483;128;217;254;229;0;4;250;254
8;Barcelona;13;Barcelonès;08101;Hospitalet de Llobregat, l';4;17;U;;378;72;124;174;204;2;1;171;172
8;Barcelona;13;Barcelonès;08101;Hospitalet de Llobregat, l';4;18;U;;766;219;331;395;371;0;3;392;395
8;Barcelona;13;Barcelonès;08101;Hospitalet de Llobregat, l';4;19;U;;508;129;184;228;280;0;4;224;228
8;Barcelona;13;Barcelonès;08101;Hospitalet de Llobregat, l';4;2;U;;553;151;218;258;295;0;8;250;258
8;Barcelona;13;Barcelonès;08101;Hospitalet de Llobregat, l';4;20;U;;810;186;312;388;422;0;4;384;388
8;Barcelona;13;Barcelonès;08101;Hospitalet de Llobregat, l';4;21;U;;772;217;308;378;394;0;4;374;378
8;Barcelona;13;Barcelonès;08101;Hospitalet de Llobregat, l';4;22;U;;662;150;235;291;371;0;7;284;291
8;Barcelona;13;Barcelonès;08101;Hospitalet de Llobregat, l';4;23;U;;653;178;253;322;331;0;0;322;322
8;Barcelona;13;Barcelonès;08101;Hospitalet de Llobregat, l';4;24;U;;386;92;158;188;198;3;0;185;185
8;Barcelona;13;Barcelonès;08101;Hospitalet de Llobregat, l';4;25;U;;613;168;263;311;302;1;5;305;310
8;Barcelona;13;Barcelonès;08101;Hospitalet de Llobregat, l';4;26;U;;582;110;201;266;316;0;3;263;266
8;Barcelona;13;Barcelonès;08101;Hospitalet de Llobregat, l';4;27;U;;503;128;198;232;271;0;3;229;232
8;Barcelona;13;Barcelonès;08101;Hospitalet de Llobregat, l';4;28;U;;326;55;99;134;192;1;2;131;133
8;Barcelona;13;Barcelonès;08101;Hospitalet de Llobregat, l';4;29;U;;428;122;175;213;215;0;4;209;213
8;Barcelona;13;Barcelonès;08101;Hospitalet de Llobregat, l';4;3;U;;815;237;370;438;377;0;6;432;438
8;Barcelona;13;Barcelonès;08101;Hospitalet de Llobregat, l';4;30;U;;570;138;203;258;312;2;5;251;256
8;Barcelona;13;Barcelonès;08101;Hospitalet de Llobregat, l';4;31;A;;389;100;160;200;189;1;4;195;199
8;Barcelona;13;Barcelonès;08101;Hospitalet de Llobregat, l';4;31;B;;455;132;202;238;217;0;0;238;238
8;Barcelona;13;Barcelonès;08101;Hospitalet de Llobregat, l';4;32;U;;852;232;373;450;402;8;8;434;442
8;Barcelona;13;Barcelonès;08101;Hospitalet de Llobregat, l';4;33;U;;556;105;179;228;328;1;8;219;227
8;Barcelona;13;Barcelonès;08101;Hospitalet de Llobregat, l';4;34;U;;385;150;150;164;221;2;1;161;162
8;Barcelona;13;Barcelonès;08101;Hospitalet de Llobregat, l';4;35;U;;607;104;218;244;363;1;6;237;243
8;Barcelona;13;Barcelonès;08101;Hospitalet de Llobregat, l';4;36;U;;430;92;148;175;255;0;0;175;175
8;Barcelona;13;Barcelonès;08101;Hospitalet de Llobregat, l';4;37;U;;482;126;207;242;240;0;6;236;242
8;Barcelona;13;Barcelonès;08101;Hospitalet de Llobregat, l';4;38;U;;524;135;208;246;278;1;0;245;245
8;Barcelona;13;Barcelonès;08101;Hospitalet de Llobregat, l';4;39;U;;555;119;216;248;307;0;4;244;248
8;Barcelona;13;Barcelonès;08101;Hospitalet de Llobregat, l';4;4;U;;863;217;349;424;439;1;4;419;423
8;Barcelona;13;Barcelonès;08101;Hospitalet de Llobregat, l';4;40;U;;703;200;313;375;328;0;9;366;375
8;Barcelona;13;Barcelonès;08101;Hospitalet de Llobregat, l';4;41;A;;701;170;278;369;332;1;2;366;368
8;Barcelona;13;Barcelonès;08101;Hospitalet de Llobregat, l';4;41;B;;783;200;336;432;351;3;6;423;429
8;Barcelona;13;Barcelonès;08101;Hospitalet de Llobregat, l';4;42;U;;374;105;173;204;170;1;4;199;203
8;Barcelona;13;Barcelonès;08101;Hospitalet de Llobregat, l';4;5;U;;581;164;233;283;298;0;6;277;283
8;Barcelona;13;Barcelonès;08101;Hospitalet de Llobregat, l';4;6;U;;885;190;347;431;454;2;14;415;429
8;Barcelona;13;Barcelonès;08101;Hospitalet de Llobregat, l';4;7;U;;645;158;231;280;365;0;4;276;280
8;Barcelona;13;Barcelonès;08101;Hospitalet de Llobregat, l';4;8;U;;563;105;194;246;317;0;4;242;246
8;Barcelona;13;Barcelonès;08101;Hospitalet de Llobregat, l';4;9;U;;441;127;188;225;216;0;5;220;225
8;Barcelona;13;Barcelonès;08101;Hospitalet de Llobregat, l';5;1;U;;876;187;361;455;421;1;8;446;454
8;Barcelona;13;Barcelonès;08101;Hospitalet de Llobregat, l';5;10;U;;706;180;284;332;374;0;4;328;332
8;Barcelona;13;Barcelonès;08101;Hospitalet de Llobregat, l';5;11;U;;432;111;168;196;236;0;1;195;196
8;Barcelona;13;Barcelonès;08101;Hospitalet de Llobregat, l';5;12;U;;552;125;215;254;298;0;11;243;254
8;Barcelona;13;Barcelonès;08101;Hospitalet de Llobregat, l';5;13;U;;475;126;185;219;256;1;3;215;218
8;Barcelona;13;Barcelonès;08101;Hospitalet de Llobregat, l';5;14;U;;441;119;183;225;216;1;5;219;224
8;Barcelona;13;Barcelonès;08101;Hospitalet de Llobregat, l';5;15;U;;339;84;124;139;200;0;5;134;139
8;Barcelona;13;Barcelonès;08101;Hospitalet de Llobregat, l';5;16;U;;373;84;127;148;225;3;1;144;145
8;Barcelona;13;Barcelonès;08101;Hospitalet de Llobregat, l';5;17;U;;706;172;267;318;388;0;2;316;318
8;Barcelona;13;Barcelonès;08101;Hospitalet de Llobregat, l';5;18;U;;723;157;251;332;391;1;2;329;331
8;Barcelona;13;Barcelonès;08101;Hospitalet de Llobregat, l';5;19;U;;359;90;131;156;203;0;4;152;156
8;Barcelona;13;Barcelonès;08101;Hospitalet de Llobregat, l';5;2;A;;497;122;200;231;266;0;4;227;231
8;Barcelona;13;Barcelonès;08101;Hospitalet de Llobregat, l';5;2;B;;560;173;242;292;268;1;6;285;291
8;Barcelona;13;Barcelonès;08101;Hospitalet de Llobregat, l';5;20;U;;599;149;229;274;325;2;2;270;272
8;Barcelona;13;Barcelonès;08101;Hospitalet de Llobregat, l';5;21;U;;864;246;419;485;379;0;9;476;485
8;Barcelona;13;Barcelonès;08101;Hospitalet de Llobregat, l';5;22;U;;449;103;160;191;258;0;2;189;191
8;Barcelona;13;Barcelonès;08101;Hospitalet de Llobregat, l';5;23;U;;967;238;391;470;497;3;11;456;467
8;Barcelona;13;Barcelonès;08101;Hospitalet de Llobregat, l';5;24;U;;791;154;252;302;489;0;4;298;302
8;Barcelona;13;Barcelonès;08101;Hospitalet de Llobregat, l';5;25;U;;581;132;200;261;320;4;3;254;257
8;Barcelona;13;Barcelonès;08101;Hospitalet de Llobregat, l';5;26;U;;410;98;156;174;236;1;5;168;173
8;Barcelona;13;Barcelonès;08101;Hospitalet de Llobregat, l';5;27;U;;563;103;163;203;360;0;3;200;203
8;Barcelona;13;Barcelonès;08101;Hospitalet de Llobregat, l';5;28;U;;699;182;308;363;336;1;6;356;362
8;Barcelona;13;Barcelonès;08101;Hospitalet de Llobregat, l';5;29;U;;753;205;292;361;392;2;5;354;359
8;Barcelona;13;Barcelonès;08101;Hospitalet de Llobregat, l';5;3;U;;678;137;267;344;334;0;3;341;344
8;Barcelona;13;Barcelonès;08101;Hospitalet de Llobregat, l';5;30;U;;886;253;401;463;423;0;2;461;463
8;Barcelona;13;Barcelonès;08101;Hospitalet de Llobregat, l';5;31;U;;611;151;237;279;332;1;7;271;278
8;Barcelona;13;Barcelonès;08101;Hospitalet de Llobregat, l';5;32;U;;890;253;358;452;438;3;5;444;449
8;Barcelona;13;Barcelonès;08101;Hospitalet de Llobregat, l';5;33;U;;544;141;225;269;275;0;1;268;269
8;Barcelona;13;Barcelonès;08101;Hospitalet de Llobregat, l';5;34;U;;627;171;274;327;300;5;1;321;322
8;Barcelona;13;Barcelonès;08101;Hospitalet de Llobregat, l';5;35;U;;834;174;331;426;408;3;3;420;423
8;Barcelona;13;Barcelonès;08101;Hospitalet de Llobregat, l';5;36;U;;614;202;278;337;277;1;6;330;336
8;Barcelona;13;Barcelonès;08101;Hospitalet de Llobregat, l';5;37;U;;855;248;383;478;377;2;6;470;476
8;Barcelona;13;Barcelonès;08101;Hospitalet de Llobregat, l';5;38;U;;831;200;347;434;397;2;5;427;432
8;Barcelona;13;Barcelonès;08101;Hospitalet de Llobregat, l';5;4;U;;890;228;355;447;443;1;10;436;446
8;Barcelona;13;Barcelonès;08101;Hospitalet de Llobregat, l';5;5;A;;468;128;198;256;212;0;4;252;256
8;Barcelona;13;Barcelonès;08101;Hospitalet de Llobregat, l';5;5;B;;558;152;253;320;238;0;3;317;320
8;Barcelona;13;Barcelonès;08101;Hospitalet de Llobregat, l';5;6;A;;729;182;299;385;344;2;14;369;383
8;Barcelona;13;Barcelonès;08101;Hospitalet de Llobregat, l';5;6;B;;719;174;286;369;350;1;11;357;368
8;Barcelona;13;Barcelonès;08101;Hospitalet de Llobregat, l';5;7;U;;604;155;264;324;280;0;3;321;324
8;Barcelona;13;Barcelonès;08101;Hospitalet de Llobregat, l';5;8;U;;408;112;182;214;194;1;6;207;213
8;Barcelona;13;Barcelonès;08101;Hospitalet de Llobregat, l';5;9;U;;461;128;205;247;214;0;6;241;247
8;Barcelona;13;Barcelonès;08101;Hospitalet de Llobregat, l';6;1;U;;1021;268;426;543;478;2;16;525;541
8;Barcelona;13;Barcelonès;08101;Hospitalet de Llobregat, l';6;10;A;;465;121;200;252;213;2;5;245;250
8;Barcelona;13;Barcelonès;08101;Hospitalet de Llobregat, l';6;10;B;;475;134;209;264;211;1;3;260;263
8;Barcelona;13;Barcelonès;08101;Hospitalet de Llobregat, l';6;11;A;;605;144;243;304;301;2;4;298;302
8;Barcelona;13;Barcelonès;08101;Hospitalet de Llobregat, l';6;11;B;;652;145;270;327;325;2;5;320;325
8;Barcelona;13;Barcelonès;08101;Hospitalet de Llobregat, l';6;12;U;;801;229;347;427;374;3;28;396;424
8;Barcelona;13;Barcelonès;08101;Hospitalet de Llobregat, l';6;13;A;;440;125;180;231;209;0;2;229;231
8;Barcelona;13;Barcelonès;08101;Hospitalet de Llobregat, l';6;13;B;;494;138;211;260;234;0;2;258;260
8;Barcelona;13;Barcelonès;08101;Hospitalet de Llobregat, l';6;14;U;;751;210;336;389;362;2;11;376;387
8;Barcelona;13;Barcelonès;08101;Hospitalet de Llobregat, l';6;15;U;;654;157;281;353;301;2;10;341;351
8;Barcelona;13;Barcelonès;08101;Hospitalet de Llobregat, l';6;16;A;;867;145;258;342;525;2;7;333;340
8;Barcelona;13;Barcelonès;08101;Hospitalet de Llobregat, l';6;16;B;;974;192;294;356;618;1;5;350;355
8;Barcelona;13;Barcelonès;08101;Hospitalet de Llobregat, l';6;17;U;;779;166;276;352;427;0;12;340;352
8;Barcelona;13;Barcelonès;08101;Hospitalet de Llobregat, l';6;18;U;;450;125;212;257;193;0;13;244;257
8;Barcelona;13;Barcelonès;08101;Hospitalet de Llobregat, l';6;19;U;;1052;270;456;566;486;1;11;554;565
8;Barcelona;13;Barcelonès;08101;Hospitalet de Llobregat, l';6;2;U;;447;99;172;224;223;2;2;220;222
8;Barcelona;13;Barcelonès;08101;Hospitalet de Llobregat, l';6;20;U;;471;131;224;304;167;0;5;299;304
8;Barcelona;13;Barcelonès;08101;Hospitalet de Llobregat, l';6;21;A;;565;150;236;294;271;0;7;287;294
8;Barcelona;13;Barcelonès;08101;Hospitalet de Llobregat, l';6;21;B;;597;153;244;310;287;0;7;303;310
8;Barcelona;13;Barcelonès;08101;Hospitalet de Llobregat, l';6;22;U;;688;138;231;279;409;0;3;276;279
8;Barcelona;13;Barcelonès;08101;Hospitalet de Llobregat, l';6;23;A;;563;157;231;295;268;0;8;287;295
8;Barcelona;13;Barcelonès;08101;Hospitalet de Llobregat, l';6;23;B;;616;166;261;330;286;0;8;322;330
8;Barcelona;13;Barcelonès;08101;Hospitalet de Llobregat, l';6;24;U;;862;187;322;409;453;3;18;388;406
8;Barcelona;13;Barcelonès;08101;Hospitalet de Llobregat, l';6;25;U;;1022;291;488;590;432;0;12;578;590
8;Barcelona;13;Barcelonès;08101;Hospitalet de Llobregat, l';6;26;U;;774;208;300;384;390;1;6;377;383
8;Barcelona;13;Barcelonès;08101;Hospitalet de Llobregat, l';6;27;U;;857;202;337;449;408;0;11;438;449
8;Barcelona;13;Barcelonès;08101;Hospitalet de Llobregat, l';6;28;U;;751;217;316;410;341;0;4;406;410
8;Barcelona;13;Barcelonès;08101;Hospitalet de Llobregat, l';6;29;U;;452;101;183;221;231;0;0;221;221
8;Barcelona;13;Barcelonès;08101;Hospitalet de Llobregat, l';6;3;U;;417;110;183;219;198;0;2;217;219
8;Barcelona;13;Barcelonès;08101;Hospitalet de Llobregat, l';6;30;U;;721;152;269;357;364;2;6;349;355
8;Barcelona;13;Barcelonès;08101;Hospitalet de Llobregat, l';6;31;U;;830;215;355;450;380;1;10;439;449
8;Barcelona;13;Barcelonès;08101;Hospitalet de Llobregat, l';6;32;U;;735;163;260;303;432;2;3;298;301
8;Barcelona;13;Barcelonès;08101;Hospitalet de Llobregat, l';6;4;U;;496;128;201;250;246;0;6;244;250
8;Barcelona;13;Barcelonès;08101;Hospitalet de Llobregat, l';6;5;U;;529;152;247;303;226;2;4;297;301
8;Barcelona;13;Barcelonès;08101;Hospitalet de Llobregat, l';6;6;U;;722;190;287;353;369;1;5;347;352
8;Barcelona;13;Barcelonès;08101;Hospitalet de Llobregat, l';6;7;U;;791;207;340;400;391;4;2;394;396
8;Barcelona;13;Barcelonès;08101;Hospitalet de Llobregat, l';6;8;U;;700;164;270;322;378;1;7;314;321
8;Barcelona;13;Barcelonès;08101;Hospitalet de Llobregat, l';6;9;U;;635;168;269;326;309;0;4;322;326
8;Barcelona;6;Anoia;08162;Hostalets de Pierola, els;1;1;A;;539;114;267;348;191;0;11;337;348
8;Barcelona;6;Anoia;08162;Hostalets de Pierola, els;1;1;B;;583;161;310;375;208;2;3;370;373
8;Barcelona;6;Anoia;08162;Hostalets de Pierola, els;1;1;C;;403;92;154;193;210;1;1;191;192
17;Girona;34;Selva;17083;Hostalric;1;1;A;;398;115;206;253;145;3;2;248;250
17;Girona;34;Selva;17083;Hostalric;1;1;B;;447;125;239;285;162;5;7;273;280
17;Girona;34;Selva;17083;Hostalric;1;2;A;;564;127;249;319;245;1;14;304;318
17;Girona;34;Selva;17083;Hostalric;1;2;B;;687;161;271;346;341;1;7;338;345
17;Girona;34;Selva;17083;Hostalric;1;2;C;;693;151;299;380;313;3;4;373;377
8;Barcelona;6;Anoia;08102;Igualada;1;1;A;;515;146;245;292;223;1;7;284;291
8;Barcelona;6;Anoia;08102;Igualada;1;1;B;;722;185;322;396;326;2;8;386;394
8;Barcelona;6;Anoia;08102;Igualada;2;1;U;;514;147;147;322;192;2;3;317;320
8;Barcelona;6;Anoia;08102;Igualada;2;2;U;;908;294;462;574;334;0;19;555;574
8;Barcelona;6;Anoia;08102;Igualada;2;3;A;;657;197;350;433;224;3;14;416;430
8;Barcelona;6;Anoia;08102;Igualada;2;3;B;;706;192;359;445;261;0;14;431;445
8;Barcelona;6;Anoia;08102;Igualada;3;1;U;;904;236;433;554;350;0;16;538;554
8;Barcelona;6;Anoia;08102;Igualada;3;2;A;;552;124;243;327;225;3;6;318;324
8;Barcelona;6;Anoia;08102;Igualada;3;2;B;;567;164;290;357;210;0;9;348;357
8;Barcelona;6;Anoia;08102;Igualada;3;3;A;;499;164;278;345;154;1;2;342;344
8;Barcelona;6;Anoia;08102;Igualada;3;3;B;;563;163;285;359;204;4;7;348;355
8;Barcelona;6;Anoia;08102;Igualada;3;4;A;;677;186;335;415;262;3;9;403;412
8;Barcelona;6;Anoia;08102;Igualada;3;4;B;;848;280;438;532;316;7;19;506;525
8;Barcelona;6;Anoia;08102;Igualada;3;5;A;;402;97;163;205;197;1;3;201;204
8;Barcelona;6;Anoia;08102;Igualada;3;5;B;;475;131;229;263;212;0;3;260;263
8;Barcelona;6;Anoia;08102;Igualada;3;6;A;;631;171;327;420;211;3;9;408;417
8;Barcelona;6;Anoia;08102;Igualada;3;6;B;;752;218;414;527;225;0;20;507;527
8;Barcelona;6;Anoia;08102;Igualada;3;7;A;;669;177;347;454;215;0;9;445;454
8;Barcelona;6;Anoia;08102;Igualada;3;7;B;;772;230;391;515;257;1;15;499;514
8;Barcelona;6;Anoia;08102;Igualada;3;8;A;;946;206;452;599;347;0;13;586;599
8;Barcelona;6;Anoia;08102;Igualada;3;8;B;;1078;227;504;686;392;2;22;662;684
8;Barcelona;6;Anoia;08102;Igualada;3;9;A;;453;118;228;291;162;1;9;281;290
8;Barcelona;6;Anoia;08102;Igualada;3;9;B;;476;126;233;292;184;0;9;283;292
8;Barcelona;6;Anoia;08102;Igualada;4;1;U;;713;216;340;418;295;2;5;411;416
8;Barcelona;6;Anoia;08102;Igualada;4;2;U;;707;221;371;449;258;2;8;439;447
8;Barcelona;6;Anoia;08102;Igualada;4;3;U;;716;237;377;456;260;1;6;449;455
8;Barcelona;6;Anoia;08102;Igualada;4;4;A;;431;124;218;273;158;3;8;262;270
8;Barcelona;6;Anoia;08102;Igualada;4;4;B;;493;114;223;290;203;3;3;284;287
8;Barcelona;6;Anoia;08102;Igualada;4;5;A;;579;158;275;350;229;1;6;343;349
8;Barcelona;6;Anoia;08102;Igualada;4;5;B;;771;191;367;452;319;4;8;440;448
8;Barcelona;6;Anoia;08102;Igualada;5;1;A;;498;141;254;298;200;1;7;290;297
8;Barcelona;6;Anoia;08102;Igualada;5;1;B;;515;144;277;327;188;0;7;320;327
8;Barcelona;6;Anoia;08102;Igualada;5;2;A;;525;166;263;312;213;0;4;308;312
8;Barcelona;6;Anoia;08102;Igualada;5;2;B;;700;204;359;414;286;0;10;404;414
8;Barcelona;6;Anoia;08102;Igualada;5;3;A;;692;169;339;428;264;0;6;422;428
8;Barcelona;6;Anoia;08102;Igualada;5;3;B;;932;246;453;559;373;3;13;543;556
8;Barcelona;6;Anoia;08102;Igualada;5;4;A;;566;164;278;362;204;1;6;355;361
8;Barcelona;6;Anoia;08102;Igualada;5;4;B;;684;193;347;442;242;0;16;426;442
8;Barcelona;6;Anoia;08102;Igualada;5;5;U;;589;123;227;260;329;1;6;253;259
8;Barcelona;6;Anoia;08102;Igualada;5;6;A;;372;119;163;194;178;1;1;192;193
8;Barcelona;6;Anoia;08102;Igualada;5;6;B;;371;134;182;200;171;2;2;196;198
8;Barcelona;6;Anoia;08102;Igualada;5;7;A;;739;161;354;454;285;1;13;440;453
8;Barcelona;6;Anoia;08102;Igualada;5;7;B;;892;242;436;565;327;2;15;548;563
25;Lleida;25;Pallars Jussà;25115;Isona i Conca Dellà;1;1;A;;627;125;305;411;216;3;10;398;408
25;Lleida;25;Pallars Jussà;25115;Isona i Conca Dellà;1;1;B;;341;43;140;189;152;1;7;181;188
17;Girona;15;Cerdanya;17084;Isòvol;1;1;U;;228;58;114;147;81;0;4;143;147
25;Lleida;27;Pla d'Urgell;25113;Ivars d'Urgell;1;1;U;;622;201;382;462;160;9;11;442;453
25;Lleida;27;Pla d'Urgell;25113;Ivars d'Urgell;1;2;A;;509;113;276;356;153;0;5;351;356
25;Lleida;27;Pla d'Urgell;25113;Ivars d'Urgell;1;2;B;;222;80;145;170;52;1;8;161;169
25;Lleida;23;Noguera;25112;Ivars de Noguera;1;1;U;;300;79;161;203;97;0;1;202;203
25;Lleida;32;Segarra;25114;Ivorra;1;1;U;;120;52;87;96;24;0;1;95;96
17;Girona;10;Baix Empordà;17085;Jafre;1;1;U;;287;119;168;210;77;3;3;204;207
17;Girona;2;Alt Empordà;17086;Jonquera, la;1;1;A;;296;75;133;171;125;0;1;170;171
17;Girona;2;Alt Empordà;17086;Jonquera, la;1;1;B;;304;76;142;175;129;1;2;172;174
17;Girona;2;Alt Empordà;17086;Jonquera, la;1;1;C;;281;68;122;150;131;1;1;148;149
17;Girona;2;Alt Empordà;17086;Jonquera, la;1;1;D;;281;55;129;156;125;0;3;153;156
17;Girona;2;Alt Empordà;17086;Jonquera, la;1;2;A;;308;78;157;180;128;0;2;178;180
17;Girona;2;Alt Empordà;17086;Jonquera, la;1;2;B;;296;81;143;179;117;0;2;177;179
8;Barcelona;6;Anoia;08103;Jorba;1;1;U;;532;141;272;327;205;0;8;319;327
25;Lleida;4;Alt Urgell;25910;Josa i Tuixén;1;1;U;;144;32;58;98;46;0;1;97;98
17;Girona;20;Gironès;17087;Juià;1;1;U;;217;75;146;175;42;0;8;167;175
25;Lleida;18;Garrigues;25118;Juncosa;1;1;U;;422;98;197;254;168;1;2;251;253
25;Lleida;18;Garrigues;25119;Juneda;1;1;A;;708;175;396;506;202;5;10;491;501
25;Lleida;18;Garrigues;25119;Juneda;1;1;B;;709;160;377;494;215;9;15;470;485
25;Lleida;18;Garrigues;25119;Juneda;1;2;A;;458;106;245;336;122;2;6;328;334
25;Lleida;18;Garrigues;25119;Juneda;1;2;B;;481;106;259;355;126;0;17;338;355
25;Lleida;39;Consell General d'Aran;25121;Les;1;1;U;;596;147;278;360;236;2;7;351;358
25;Lleida;27;Pla d'Urgell;25122;Linyola;1;1;A;;433;90;224;288;145;0;13;275;288
25;Lleida;27;Pla d'Urgell;25122;Linyola;1;1;B;;512;123;268;344;168;5;11;328;339
25;Lleida;27;Pla d'Urgell;25122;Linyola;1;2;A;;394;82;191;247;147;1;11;235;246
25;Lleida;27;Pla d'Urgell;25122;Linyola;1;2;B;;607;132;321;410;197;2;12;396;408
8;Barcelona;6;Anoia;08104;Llacuna, la;1;1;U;;697;179;377;466;231;3;4;459;463
17;Girona;2;Alt Empordà;17088;Lladó;1;1;U;;492;140;263;313;179;0;9;304;313
25;Lleida;26;Pallars Sobirà;25123;Lladorre;1;1;U;;196;45;85;139;57;0;2;137;139
25;Lleida;35;Solsonès;25124;Lladurs;1;1;U;;168;45;86;113;55;1;4;108;112
8;Barcelona;41;Vallès Oriental;08105;Llagosta, la;1;1;A;;471;88;151;200;271;0;1;199;200
8;Barcelona;41;Vallès Oriental;08105;Llagosta, la;1;1;B;;650;124;236;298;352;1;5;292;297
8;Barcelona;41;Vallès Oriental;08105;Llagosta, la;1;2;A;;591;125;229;293;298;3;5;285;290
8;Barcelona;41;Vallès Oriental;08105;Llagosta, la;1;2;B;;732;152;293;358;374;1;14;343;357
8;Barcelona;41;Vallès Oriental;08105;Llagosta, la;1;3;A;;479;124;207;259;220;1;3;255;258
8;Barcelona;41;Vallès Oriental;08105;Llagosta, la;1;3;B;;593;152;252;321;272;3;8;310;318
8;Barcelona;41;Vallès Oriental;08105;Llagosta, la;1;4;A;;540;125;230;295;245;0;4;291;295
8;Barcelona;41;Vallès Oriental;08105;Llagosta, la;1;4;B;;595;160;272;335;260;0;2;333;335
8;Barcelona;41;Vallès Oriental;08105;Llagosta, la;1;5;A;;610;130;208;262;348;2;4;256;260
8;Barcelona;41;Vallès Oriental;08105;Llagosta, la;1;5;B;;629;142;221;267;362;1;6;260;266
8;Barcelona;41;Vallès Oriental;08105;Llagosta, la;1;6;A;;453;118;179;221;232;2;9;210;219
8;Barcelona;41;Vallès Oriental;08105;Llagosta, la;1;6;B;;563;157;262;299;264;1;5;293;298
8;Barcelona;41;Vallès Oriental;08105;Llagosta, la;1;7;A;;505;131;230;267;238;1;2;264;266
8;Barcelona;41;Vallès Oriental;08105;Llagosta, la;1;7;B;;567;130;220;263;304;0;5;258;263
8;Barcelona;41;Vallès Oriental;08105;Llagosta, la;1;8;A;;361;74;130;178;183;0;10;168;178
8;Barcelona;41;Vallès Oriental;08105;Llagosta, la;1;8;B;;509;129;200;277;232;2;6;269;275
8;Barcelona;41;Vallès Oriental;08105;Llagosta, la;1;9;A;;519;128;217;287;232;3;9;275;284
8;Barcelona;41;Vallès Oriental;08105;Llagosta, la;1;9;B;;599;154;244;309;290;0;10;299;309
17;Girona;20;Gironès;17089;Llagostera;1;1;A;;628;148;283;340;288;1;6;333;339
17;Girona;20;Gironès;17089;Llagostera;1;1;B;;671;174;313;374;297;4;6;364;370
17;Girona;20;Gironès;17089;Llagostera;1;2;A;;538;130;262;321;217;0;4;317;321
17;Girona;20;Gironès;17089;Llagostera;1;2;B;;653;160;301;374;279;2;8;364;372
17;Girona;20;Gironès;17089;Llagostera;1;3;A;;717;167;297;368;349;0;7;361;368
17;Girona;20;Gironès;17089;Llagostera;1;3;B;;776;148;312;384;392;0;4;380;384
17;Girona;20;Gironès;17089;Llagostera;1;4;A;;599;131;272;337;262;8;4;325;329
17;Girona;20;Gironès;17089;Llagostera;1;4;B;;470;102;230;279;191;2;10;267;277
17;Girona;20;Gironès;17090;Llambilles;1;1;U;;493;140;280;354;139;5;11;338;349
17;Girona;31;Ripollès;17091;Llanars;1;1;U;;452;134;243;297;155;7;11;279;290
17;Girona;2;Alt Empordà;17092;Llançà;1;1;A;;488;125;216;280;208;0;5;275;280
17;Girona;2;Alt Empordà;17092;Llançà;1;1;B;;479;145;216;280;199;0;2;278;280
17;Girona;2;Alt Empordà;17092;Llançà;1;2;A;;366;115;186;228;138;2;1;225;226
17;Girona;2;Alt Empordà;17092;Llançà;1;2;B;;432;102;198;241;191;2;4;235;239
17;Girona;2;Alt Empordà;17092;Llançà;1;2;C;;457;119;204;266;191;6;3;257;260
17;Girona;2;Alt Empordà;17092;Llançà;1;2;D;;339;86;148;180;159;4;3;173;176
17;Girona;2;Alt Empordà;17092;Llançà;1;3;A;;389;111;195;232;157;1;0;231;231
17;Girona;2;Alt Empordà;17092;Llançà;1;3;B;;421;151;223;255;166;0;4;251;255
25;Lleida;33;Segrià;25125;Llardecans;1;1;U;;477;142;281;317;160;2;6;309;315
25;Lleida;26;Pallars Sobirà;25126;Llavorsí;1;1;U;;275;78;143;198;77;0;4;194;198
25;Lleida;33;Segrià;25120;Lleida;1;1;A;;659;210;329;430;229;10;13;407;420
25;Lleida;33;Segrià;25120;Lleida;1;1;B;;748;202;350;463;285;6;16;441;457
25;Lleida;33;Segrià;25120;Lleida;1;10;A;;556;104;203;260;296;0;3;257;260
25;Lleida;33;Segrià;25120;Lleida;1;10;B;;686;137;249;310;376;0;2;308;310
25;Lleida;33;Segrià;25120;Lleida;1;11;A;;537;127;209;270;267;2;7;261;268
25;Lleida;33;Segrià;25120;Lleida;1;11;B;;594;112;196;256;338;1;4;251;255
25;Lleida;33;Segrià;25120;Lleida;1;12;U;;781;166;310;399;382;1;18;380;398
25;Lleida;33;Segrià;25120;Lleida;1;13;A;;699;172;310;398;301;2;6;390;396
25;Lleida;33;Segrià;25120;Lleida;1;13;B;;743;185;317;411;332;3;16;392;408
25;Lleida;33;Segrià;25120;Lleida;1;14;A;;453;80;160;229;224;1;5;223;228
25;Lleida;33;Segrià;25120;Lleida;1;14;B;;498;95;179;247;251;0;7;240;247
25;Lleida;33;Segrià;25120;Lleida;1;3;A;;539;133;229;310;229;2;4;304;308
25;Lleida;33;Segrià;25120;Lleida;1;3;B;;576;150;249;334;242;2;11;321;332
25;Lleida;33;Segrià;25120;Lleida;1;4;A;;731;167;370;415;316;6;13;396;409
25;Lleida;33;Segrià;25120;Lleida;1;4;B;;803;212;308;469;334;1;10;458;468
25;Lleida;33;Segrià;25120;Lleida;1;5;A;;589;115;208;270;319;2;4;264;268
25;Lleida;33;Segrià;25120;Lleida;1;5;B;;901;188;351;418;483;1;7;410;417
25;Lleida;33;Segrià;25120;Lleida;1;6;A;;472;111;191;249;223;1;3;245;248
25;Lleida;33;Segrià;25120;Lleida;1;6;B;;580;126;217;288;292;0;6;282;288
25;Lleida;33;Segrià;25120;Lleida;1;7;A;;983;213;403;517;466;1;10;506;516
25;Lleida;33;Segrià;25120;Lleida;1;7;B;;1090;188;347;500;590;0;8;492;500
25;Lleida;33;Segrià;25120;Lleida;1;8;A;;742;149;290;385;357;1;14;370;384
25;Lleida;33;Segrià;25120;Lleida;1;8;B;;879;183;348;468;411;2;19;447;466
25;Lleida;33;Segrià;25120;Lleida;1;9;A;;410;104;170;221;189;2;1;218;219
25;Lleida;33;Segrià;25120;Lleida;1;9;B;;420;113;182;244;176;0;3;241;244
25;Lleida;33;Segrià;25120;Lleida;2;1;U;;517;135;218;275;242;2;4;269;273
25;Lleida;33;Segrià;25120;Lleida;2;2;A;;541;139;244;314;227;1;6;307;313
25;Lleida;33;Segrià;25120;Lleida;2;2;B;;598;152;262;346;252;2;6;338;344
25;Lleida;33;Segrià;25120;Lleida;2;3;U;;680;175;294;390;290;2;8;380;388
25;Lleida;33;Segrià;25120;Lleida;2;4;A;;599;122;232;313;286;2;7;304;311
25;Lleida;33;Segrià;25120;Lleida;2;4;B;;581;147;259;326;255;0;14;312;326
25;Lleida;33;Segrià;25120;Lleida;2;5;U;;1088;247;441;603;485;6;18;579;597
25;Lleida;33;Segrià;25120;Lleida;2;6;A;;416;119;188;245;171;2;9;234;243
25;Lleida;33;Segrià;25120;Lleida;2;6;B;;528;136;230;296;232;1;10;285;295
25;Lleida;33;Segrià;25120;Lleida;2;7;A;;801;154;311;416;385;2;6;408;414
25;Lleida;33;Segrià;25120;Lleida;2;7;B;;771;170;310;413;358;1;12;400;412
25;Lleida;33;Segrià;25120;Lleida;2;8;A;;477;120;199;273;204;0;6;267;273
25;Lleida;33;Segrià;25120;Lleida;2;8;B;;620;156;274;352;268;0;15;337;352
25;Lleida;33;Segrià;25120;Lleida;2;9;U;;950;217;413;588;362;1;20;567;587
25;Lleida;33;Segrià;25120;Lleida;3;1;A;;420;106;148;178;242;0;2;176;178
25;Lleida;33;Segrià;25120;Lleida;3;1;B;;459;108;156;183;276;0;8;175;183
25;Lleida;33;Segrià;25120;Lleida;3;3;U;;555;180;305;378;177;2;5;371;376
25;Lleida;33;Segrià;25120;Lleida;3;4;A;;493;147;239;322;171;0;7;315;322
25;Lleida;33;Segrià;25120;Lleida;3;4;B;;556;192;316;385;171;0;11;374;385
25;Lleida;33;Segrià;25120;Lleida;3;5;U;;566;148;244;335;231;5;8;322;330
25;Lleida;33;Segrià;25120;Lleida;3;6;A;;508;157;244;320;188;6;9;305;314
25;Lleida;33;Segrià;25120;Lleida;3;6;B;;545;141;247;339;206;1;9;329;338
25;Lleida;33;Segrià;25120;Lleida;3;7;U;;525;124;238;303;222;4;6;293;299
25;Lleida;33;Segrià;25120;Lleida;3;8;U;;773;205;361;470;303;1;11;458;469
25;Lleida;33;Segrià;25120;Lleida;4;1;U;;461;97;147;185;276;1;2;182;184
25;Lleida;33;Segrià;25120;Lleida;4;10;A;;808;112;205;255;553;1;1;253;254
25;Lleida;33;Segrià;25120;Lleida;4;10;B;;618;133;190;230;388;0;4;226;230
25;Lleida;33;Segrià;25120;Lleida;4;11;A;;484;84;131;155;329;2;2;151;153
25;Lleida;33;Segrià;25120;Lleida;4;11;B;;438;82;141;168;270;2;5;161;166
25;Lleida;33;Segrià;25120;Lleida;4;12;U;;607;104;155;187;420;1;1;185;186
25;Lleida;33;Segrià;25120;Lleida;4;13;A;;471;90;167;206;265;0;5;201;206
25;Lleida;33;Segrià;25120;Lleida;4;13;B;;546;112;194;248;298;1;4;243;247
25;Lleida;33;Segrià;25120;Lleida;4;14;U;;735;154;263;334;401;1;5;328;333
25;Lleida;33;Segrià;25120;Lleida;4;15;A;;519;107;200;252;267;0;9;243;252
25;Lleida;33;Segrià;25120;Lleida;4;15;B;;568;139;243;308;260;0;12;296;308
25;Lleida;33;Segrià;25120;Lleida;4;16;A;;529;109;224;290;239;0;5;285;290
25;Lleida;33;Segrià;25120;Lleida;4;16;B;;614;148;256;366;248;2;9;355;364
25;Lleida;33;Segrià;25120;Lleida;4;17;A;;696;175;286;368;328;0;10;358;368
25;Lleida;33;Segrià;25120;Lleida;4;17;B;;744;174;304;391;353;1;8;382;390
25;Lleida;33;Segrià;25120;Lleida;4;2;U;;511;136;240;301;210;2;12;287;299
25;Lleida;33;Segrià;25120;Lleida;4;3;A;;725;225;382;494;231;0;10;484;494
25;Lleida;33;Segrià;25120;Lleida;4;3;B;;822;250;425;532;290;2;17;513;530
25;Lleida;33;Segrià;25120;Lleida;4;4;U;;663;156;281;382;281;1;8;373;381
25;Lleida;33;Segrià;25120;Lleida;4;5;U;;644;175;316;400;244;1;10;389;399
25;Lleida;33;Segrià;25120;Lleida;4;6;A;;589;151;253;341;248;3;10;328;338
25;Lleida;33;Segrià;25120;Lleida;4;6;B;;622;133;272;354;268;3;9;342;351
25;Lleida;33;Segrià;25120;Lleida;4;7;A;;452;100;172;245;207;1;3;241;244
25;Lleida;33;Segrià;25120;Lleida;4;7;B;;493;130;223;282;211;5;2;275;277
25;Lleida;33;Segrià;25120;Lleida;4;8;A;;433;99;171;208;225;0;4;204;208
25;Lleida;33;Segrià;25120;Lleida;4;8;B;;394;104;188;230;164;3;8;219;227
25;Lleida;33;Segrià;25120;Lleida;5;10;U;;832;251;443;568;264;13;2;553;555
25;Lleida;33;Segrià;25120;Lleida;5;11;A;;580;159;295;422;158;0;10;412;422
25;Lleida;33;Segrià;25120;Lleida;5;11;B;;600;148;302;401;199;0;14;387;401
25;Lleida;33;Segrià;25120;Lleida;5;12;U;;756;198;366;477;279;1;18;458;476
25;Lleida;33;Segrià;25120;Lleida;5;2;U;;798;235;386;491;307;4;7;480;487
25;Lleida;33;Segrià;25120;Lleida;5;3;A;;455;129;216;282;173;1;7;274;281
25;Lleida;33;Segrià;25120;Lleida;5;3;B;;505;138;230;301;204;1;3;297;300
25;Lleida;33;Segrià;25120;Lleida;5;4;A;;370;104;185;244;126;1;9;234;243
25;Lleida;33;Segrià;25120;Lleida;5;4;B;;470;152;247;307;163;3;8;296;304
25;Lleida;33;Segrià;25120;Lleida;5;5;A;;417;116;207;273;144;1;3;269;272
25;Lleida;33;Segrià;25120;Lleida;5;5;B;;509;166;252;327;182;1;3;323;326
25;Lleida;33;Segrià;25120;Lleida;5;6;A;;564;115;261;360;204;1;9;350;359
25;Lleida;33;Segrià;25120;Lleida;5;6;B;;706;179;337;458;248;2;14;442;456
25;Lleida;33;Segrià;25120;Lleida;5;7;U;;602;158;258;329;273;3;10;316;326
25;Lleida;33;Segrià;25120;Lleida;5;8;U;;937;229;449;576;361;0;6;570;576
25;Lleida;33;Segrià;25120;Lleida;5;9;U;;802;242;409;526;276;12;3;511;514
25;Lleida;33;Segrià;25120;Lleida;6;1;A;;389;94;138;166;223;1;3;162;165
25;Lleida;33;Segrià;25120;Lleida;6;1;B;;801;204;380;472;329;1;14;457;471
25;Lleida;33;Segrià;25120;Lleida;6;10;A;;530;130;225;297;233;3;4;290;294
25;Lleida;33;Segrià;25120;Lleida;6;10;B;;572;135;229;306;266;1;7;298;305
25;Lleida;33;Segrià;25120;Lleida;6;11;A;;558;145;254;325;233;1;10;314;324
25;Lleida;33;Segrià;25120;Lleida;6;11;B;;551;170;262;333;218;6;9;318;327
25;Lleida;33;Segrià;25120;Lleida;6;12;A;;568;153;272;352;216;1;7;344;351
25;Lleida;33;Segrià;25120;Lleida;6;12;B;;617;145;273;374;243;1;12;361;373
25;Lleida;33;Segrià;25120;Lleida;6;13;A;;464;134;224;304;160;0;4;300;304
25;Lleida;33;Segrià;25120;Lleida;6;13;B;;574;167;280;368;206;1;9;358;367
25;Lleida;33;Segrià;25120;Lleida;6;14;A;;813;170;329;441;372;4;14;423;437
25;Lleida;33;Segrià;25120;Lleida;6;14;B;;902;217;404;522;380;2;16;504;520
25;Lleida;33;Segrià;25120;Lleida;6;15;U;;527;133;249;322;205;0;10;312;322
25;Lleida;33;Segrià;25120;Lleida;6;16;U;;656;183;320;446;210;5;8;433;441
25;Lleida;33;Segrià;25120;Lleida;6;17;A;;558;118;210;266;292;2;8;256;264
25;Lleida;33;Segrià;25120;Lleida;6;17;B;;733;152;278;369;364;2;5;362;367
25;Lleida;33;Segrià;25120;Lleida;6;2;A;;587;192;303;364;223;1;7;356;363
25;Lleida;33;Segrià;25120;Lleida;6;2;B;;628;175;299;381;247;0;7;374;381
25;Lleida;33;Segrià;25120;Lleida;6;3;A;;722;173;306;408;314;0;7;401;408
25;Lleida;33;Segrià;25120;Lleida;6;3;B;;800;206;353;455;345;0;18;437;455
25;Lleida;33;Segrià;25120;Lleida;6;4;A;;526;125;227;311;215;1;4;306;310
25;Lleida;33;Segrià;25120;Lleida;6;4;B;;534;180;268;363;171;1;10;352;362
25;Lleida;33;Segrià;25120;Lleida;6;5;U;;686;208;360;467;219;3;4;460;464
25;Lleida;33;Segrià;25120;Lleida;6;6;U;;898;247;400;504;394;0;22;482;504
25;Lleida;33;Segrià;25120;Lleida;6;7;A;;606;125;228;300;306;0;3;297;300
25;Lleida;33;Segrià;25120;Lleida;6;7;B;;566;115;196;260;306;3;8;249;257
25;Lleida;33;Segrià;25120;Lleida;6;7;C;;630;132;236;309;321;1;6;302;308
25;Lleida;33;Segrià;25120;Lleida;6;9;A;;339;78;180;161;178;0;5;156;161
25;Lleida;33;Segrià;25120;Lleida;6;9;B;;414;115;180;227;187;1;6;220;226
25;Lleida;33;Segrià;25120;Lleida;7;1;A;;657;147;253;346;311;1;9;336;345
25;Lleida;33;Segrià;25120;Lleida;7;1;B;;809;146;301;403;406;3;1;399;400
25;Lleida;33;Segrià;25120;Lleida;7;2;U;;550;87;212;279;271;0;2;277;279
25;Lleida;33;Segrià;25120;Lleida;7;3;A;;571;135;231;308;263;0;8;300;308
25;Lleida;33;Segrià;25120;Lleida;7;3;B;;677;154;286;387;290;0;13;374;387
25;Lleida;33;Segrià;25120;Lleida;7;4;A;;536;122;207;262;274;1;4;257;261
25;Lleida;33;Segrià;25120;Lleida;7;4;B;;679;132;238;313;366;0;2;311;313
25;Lleida;33;Segrià;25120;Lleida;7;4;C;;602;112;201;256;346;1;5;250;255
25;Lleida;33;Segrià;25120;Lleida;7;5;A;;843;155;299;415;428;0;11;404;415
25;Lleida;33;Segrià;25120;Lleida;7;5;B;;987;199;371;491;496;1;6;484;490
25;Lleida;33;Segrià;25120;Lleida;7;6;A;;859;168;310;408;451;0;8;400;408
25;Lleida;33;Segrià;25120;Lleida;7;6;B;;858;170;350;441;417;2;6;433;439
25;Lleida;33;Segrià;25120;Lleida;7;7;A;;732;135;253;353;379;0;6;347;353
25;Lleida;33;Segrià;25120;Lleida;7;7;B;;855;150;301;409;446;1;8;400;408
25;Lleida;33;Segrià;25120;Lleida;8;1;A;;538;121;256;339;199;0;8;331;339
25;Lleida;33;Segrià;25120;Lleida;8;1;B;;837;178;350;436;401;0;15;421;436
25;Lleida;33;Segrià;25120;Lleida;8;2;A;;515;114;260;353;162;2;11;340;351
25;Lleida;33;Segrià;25120;Lleida;8;2;B;;594;150;300;403;191;1;12;390;402
25;Lleida;33;Segrià;25120;Lleida;8;2;C;;400;92;176;240;160;3;8;229;237
25;Lleida;33;Segrià;25120;Lleida;8;2;D;;249;61;141;198;51;1;0;197;197
25;Lleida;33;Segrià;25120;Lleida;8;3;A;;368;96;210;254;114;0;8;246;254
25;Lleida;33;Segrià;25120;Lleida;8;3;B;;484;135;259;316;168;0;2;314;316
25;Lleida;33;Segrià;25120;Lleida;9;1;A;;616;151;297;395;221;1;7;387;394
25;Lleida;33;Segrià;25120;Lleida;9;1;B;;853;191;375;491;362;2;11;478;489
25;Lleida;33;Segrià;25120;Lleida;9;2;A;;809;173;359;450;359;5;10;435;445
25;Lleida;33;Segrià;25120;Lleida;9;2;B;;339;100;245;193;146;0;3;190;193
17;Girona;2;Alt Empordà;17093;Llers;1;1;A;;483;135;236;282;201;2;6;274;280
17;Girona;2;Alt Empordà;17093;Llers;1;1;B;;410;128;211;251;159;4;5;242;247
25;Lleida;15;Cerdanya;25127;Lles de Cerdanya;1;1;U;;214;50;102;128;86;0;1;127;128
8;Barcelona;41;Vallès Oriental;08107;Lliçà d'Amunt;1;1;A;;571;129;261;322;249;0;11;311;322
8;Barcelona;41;Vallès Oriental;08107;Lliçà d'Amunt;1;1;B;;776;179;357;409;367;2;12;395;407
8;Barcelona;41;Vallès Oriental;08107;Lliçà d'Amunt;1;2;A;;435;89;189;240;195;0;5;235;240
8;Barcelona;41;Vallès Oriental;08107;Lliçà d'Amunt;1;2;B;;587;126;276;347;240;1;8;338;346
8;Barcelona;41;Vallès Oriental;08107;Lliçà d'Amunt;1;3;A;;749;148;265;343;406;1;4;338;342
8;Barcelona;41;Vallès Oriental;08107;Lliçà d'Amunt;1;3;B;;904;160;337;428;476;0;14;414;428
8;Barcelona;41;Vallès Oriental;08107;Lliçà d'Amunt;1;4;A;;631;92;202;245;386;1;2;242;244
8;Barcelona;41;Vallès Oriental;08107;Lliçà d'Amunt;1;4;B;;759;128;254;326;433;2;3;321;324
8;Barcelona;41;Vallès Oriental;08107;Lliçà d'Amunt;1;5;A;;538;97;203;248;290;1;5;242;247
8;Barcelona;41;Vallès Oriental;08107;Lliçà d'Amunt;1;5;B;;580;111;203;274;306;0;5;269;274
8;Barcelona;41;Vallès Oriental;08107;Lliçà d'Amunt;1;6;A;;749;141;273;344;405;0;3;341;344
8;Barcelona;41;Vallès Oriental;08107;Lliçà d'Amunt;1;6;B;;812;193;343;402;410;1;14;387;401
8;Barcelona;41;Vallès Oriental;08107;Lliçà d'Amunt;1;7;A;;476;98;193;248;228;0;7;241;248
8;Barcelona;41;Vallès Oriental;08107;Lliçà d'Amunt;1;7;B;;582;151;273;321;261;0;1;320;321
8;Barcelona;41;Vallès Oriental;08107;Lliçà d'Amunt;1;8;A;;460;75;161;201;259;1;1;199;200
8;Barcelona;41;Vallès Oriental;08107;Lliçà d'Amunt;1;8;B;;534;102;186;243;291;6;0;237;237
8;Barcelona;41;Vallès Oriental;08108;Lliçà de Vall;1;1;A;;615;128;260;361;254;3;9;349;358
8;Barcelona;41;Vallès Oriental;08108;Lliçà de Vall;1;1;B;;736;176;325;418;318;0;10;408;418
8;Barcelona;41;Vallès Oriental;08108;Lliçà de Vall;1;2;A;;632;143;259;359;273;4;2;353;355
8;Barcelona;41;Vallès Oriental;08108;Lliçà de Vall;1;2;B;;679;156;288;378;301;0;0;378;378
8;Barcelona;41;Vallès Oriental;08108;Lliçà de Vall;1;3;A;;590;145;258;326;264;2;7;317;324
8;Barcelona;41;Vallès Oriental;08108;Lliçà de Vall;1;3;B;;650;154;280;362;288;0;12;350;362
8;Barcelona;41;Vallès Oriental;08108;Lliçà de Vall;1;4;A;;396;102;179;228;168;0;2;226;228
8;Barcelona;41;Vallès Oriental;08108;Lliçà de Vall;1;4;B;;456;109;215;273;183;1;2;270;272
25;Lleida;25;Pallars Jussà;25128;Llimiana;1;1;U;;148;43;71;93;55;2;0;91;91
8;Barcelona;41;Vallès Oriental;08106;Llinars del Vallès;1;1;A;;501;138;244;295;206;4;5;286;291
8;Barcelona;41;Vallès Oriental;08106;Llinars del Vallès;1;1;B;;463;107;211;261;202;2;4;255;259
8;Barcelona;41;Vallès Oriental;08106;Llinars del Vallès;1;2;A;;624;162;283;356;268;4;11;341;352
8;Barcelona;41;Vallès Oriental;08106;Llinars del Vallès;1;2;B;;682;183;331;394;288;2;8;384;392
8;Barcelona;41;Vallès Oriental;08106;Llinars del Vallès;2;1;A;;753;164;333;433;320;4;14;415;429
8;Barcelona;41;Vallès Oriental;08106;Llinars del Vallès;2;1;B;;695;192;345;446;249;1;8;437;445
8;Barcelona;41;Vallès Oriental;08106;Llinars del Vallès;2;1;C;;731;173;334;436;295;0;8;428;436
8;Barcelona;41;Vallès Oriental;08106;Llinars del Vallès;2;2;A;;669;165;322;409;260;3;4;402;406
8;Barcelona;41;Vallès Oriental;08106;Llinars del Vallès;2;2;B;;602;118;226;306;296;1;4;301;305
8;Barcelona;41;Vallès Oriental;08106;Llinars del Vallès;2;2;C;;666;144;288;367;299;1;7;359;366
17;Girona;15;Cerdanya;17094;Llívia;1;1;U;;944;221;446;557;387;2;8;547;555
43;Tarragona;29;Priorat;43072;Lloar, el;1;1;U;;98;24;57;75;23;0;1;74;75
25;Lleida;35;Solsonès;25129;Llobera;1;1;U;;190;52;95;118;72;1;2;115;117
43;Tarragona;16;Conca de Barberà;43073;Llorac;1;1;U;;95;21;42;60;35;2;1;57;58
43;Tarragona;12;Baix Penedès;43074;Llorenç del Penedès;1;1;A;;470;130;247;306;164;2;10;294;304
43;Tarragona;12;Baix Penedès;43074;Llorenç del Penedès;1;1;B;;468;142;243;303;165;0;11;292;303
43;Tarragona;12;Baix Penedès;43074;Llorenç del Penedès;1;1;C;;634;179;337;423;211;0;9;414;423
17;Girona;34;Selva;17095;Lloret de Mar;1;1;A;;685;125;215;275;410;1;6;268;274
17;Girona;34;Selva;17095;Lloret de Mar;1;1;B;;731;141;244;323;408;1;3;319;322
17;Girona;34;Selva;17095;Lloret de Mar;1;2;A;;551;127;256;303;248;3;7;293;300
17;Girona;34;Selva;17095;Lloret de Mar;1;2;B;;526;119;226;270;256;1;9;260;269
17;Girona;34;Selva;17095;Lloret de Mar;1;3;A;;792;114;227;291;501;0;6;285;291
17;Girona;34;Selva;17095;Lloret de Mar;1;3;B;;728;118;196;256;472;0;6;250;256
17;Girona;34;Selva;17095;Lloret de Mar;2;1;A;;695;205;345;384;311;0;5;379;384
17;Girona;34;Selva;17095;Lloret de Mar;2;1;B;;650;195;331;388;262;0;11;377;388
17;Girona;34;Selva;17095;Lloret de Mar;2;2;A;;648;157;263;312;336;1;6;305;311
17;Girona;34;Selva;17095;Lloret de Mar;2;2;B;;688;175;291;348;340;0;3;345;348
17;Girona;34;Selva;17095;Lloret de Mar;2;3;A;;692;158;284;341;351;5;7;329;336
17;Girona;34;Selva;17095;Lloret de Mar;2;3;B;;728;176;325;396;332;2;4;390;394
17;Girona;34;Selva;17095;Lloret de Mar;3;1;A;;677;128;252;326;351;2;6;318;324
17;Girona;34;Selva;17095;Lloret de Mar;3;1;B;;646;139;253;311;335;0;4;307;311
17;Girona;34;Selva;17095;Lloret de Mar;3;2;A;;798;182;331;391;407;2;6;383;389
17;Girona;34;Selva;17095;Lloret de Mar;3;2;B;;848;182;337;429;419;1;10;418;428
17;Girona;34;Selva;17095;Lloret de Mar;3;3;A;;571;118;206;253;318;0;4;249;253
17;Girona;34;Selva;17095;Lloret de Mar;3;3;B;;630;98;192;252;378;0;5;247;252
17;Girona;34;Selva;17095;Lloret de Mar;3;3;C;;561;105;199;243;318;0;3;240;243
17;Girona;34;Selva;17095;Lloret de Mar;3;4;U;;1043;134;244;321;722;1;6;314;320
17;Girona;34;Selva;17095;Lloret de Mar;4;1;A;;1028;174;336;437;591;2;4;431;435
17;Girona;34;Selva;17095;Lloret de Mar;4;1;B;;955;195;354;436;519;2;5;429;434
17;Girona;34;Selva;17095;Lloret de Mar;4;2;A;;548;90;175;234;314;2;3;229;232
17;Girona;34;Selva;17095;Lloret de Mar;4;2;B;;706;111;209;282;424;2;9;271;280
17;Girona;34;Selva;17095;Lloret de Mar;4;2;C;;596;89;188;244;352;0;7;237;244
17;Girona;31;Ripollès;17096;Llosses, les;1;1;U;;199;42;89;129;70;2;1;126;127
8;Barcelona;24;Osona;08109;Lluçà;1;1;U;;203;61;121;160;43;1;3;156;159
17;Girona;2;Alt Empordà;17102;Maçanet de Cabrenys;1;1;U;;599;199;348;418;181;3;6;409;415
17;Girona;34;Selva;17103;Maçanet de la Selva;1;1;A;;435;106;210;263;172;1;3;259;262
17;Girona;34;Selva;17103;Maçanet de la Selva;1;1;B;;522;124;235;293;229;1;7;285;292
17;Girona;34;Selva;17103;Maçanet de la Selva;1;2;A;;748;120;213;247;501;11;0;236;236
17;Girona;34;Selva;17103;Maçanet de la Selva;1;2;B;;731;147;226;265;466;1;2;262;264
17;Girona;34;Selva;17103;Maçanet de la Selva;1;3;A;;567;95;231;297;270;1;5;291;296
17;Girona;34;Selva;17103;Maçanet de la Selva;1;3;B;;584;95;246;326;258;3;5;318;323
17;Girona;34;Selva;17103;Maçanet de la Selva;1;4;U;;888;162;265;311;577;4;5;302;307
17;Girona;20;Gironès;17097;Madremanya;1;1;U;;168;64;112;127;41;1;7;119;126
17;Girona;19;Garrotxa;17098;Maià de Montcal;1;1;U;;288;117;176;197;91;2;5;190;195
25;Lleida;33;Segrià;25133;Maials;1;1;U;;798;214;452;545;253;2;2;541;543
25;Lleida;38;Urgell;25130;Maldà;1;1;U;;229;79;129;159;70;3;3;153;156
8;Barcelona;21;Maresme;08110;Malgrat de Mar;1;1;A;;669;197;299;371;298;1;9;361;370
8;Barcelona;21;Maresme;08110;Malgrat de Mar;1;1;B;;634;162;251;317;317;2;13;302;315
8;Barcelona;21;Maresme;08110;Malgrat de Mar;1;1;C;;771;201;330;397;374;0;3;394;397
8;Barcelona;21;Maresme;08110;Malgrat de Mar;1;1;D;;655;167;272;338;317;2;10;326;336
8;Barcelona;21;Maresme;08110;Malgrat de Mar;1;2;A;;533;148;247;311;222;1;6;304;310
8;Barcelona;21;Maresme;08110;Malgrat de Mar;1;2;B;;691;191;320;382;309;0;5;377;382
8;Barcelona;21;Maresme;08110;Malgrat de Mar;1;2;C;;703;194;340;408;295;4;7;397;404
8;Barcelona;21;Maresme;08110;Malgrat de Mar;1;3;A;;479;106;186;246;233;0;3;243;246
8;Barcelona;21;Maresme;08110;Malgrat de Mar;1;3;B;;584;126;233;288;296;1;5;282;287
8;Barcelona;21;Maresme;08110;Malgrat de Mar;1;3;C;;552;122;212;260;292;0;1;259;260
8;Barcelona;21;Maresme;08110;Malgrat de Mar;1;4;A;;405;96;170;210;195;0;6;204;210
8;Barcelona;21;Maresme;08110;Malgrat de Mar;1;4;B;;490;113;195;235;255;2;7;226;233
8;Barcelona;21;Maresme;08110;Malgrat de Mar;1;4;C;;522;113;214;257;265;0;6;251;257
8;Barcelona;21;Maresme;08110;Malgrat de Mar;1;5;A;;422;105;182;213;209;0;0;213;213
8;Barcelona;21;Maresme;08110;Malgrat de Mar;1;5;B;;487;101;201;234;253;0;2;232;234
8;Barcelona;21;Maresme;08110;Malgrat de Mar;1;5;C;;460;109;213;240;220;1;5;234;239
8;Barcelona;21;Maresme;08110;Malgrat de Mar;2;1;A;;559;168;278;311;248;1;9;301;310
8;Barcelona;21;Maresme;08110;Malgrat de Mar;2;1;B;;469;133;209;249;220;0;2;247;249
8;Barcelona;21;Maresme;08110;Malgrat de Mar;2;1;C;;698;212;378;394;304;1;6;387;393
8;Barcelona;21;Maresme;08110;Malgrat de Mar;2;1;D;;628;208;320;382;246;1;11;370;381
8;Barcelona;21;Maresme;08110;Malgrat de Mar;2;2;A;;540;160;269;327;213;0;8;319;327
8;Barcelona;21;Maresme;08110;Malgrat de Mar;2;2;B;;516;158;253;309;207;2;6;301;307
8;Barcelona;21;Maresme;08110;Malgrat de Mar;2;2;C;;610;177;294;350;260;2;7;341;348
8;Barcelona;24;Osona;08111;Malla;1;1;U;;218;79;159;185;33;0;11;174;185
8;Barcelona;24;Osona;08112;Manlleu;1;1;A;;595;155;304;375;220;4;12;359;371
8;Barcelona;24;Osona;08112;Manlleu;1;1;B;;739;220;391;503;236;1;11;491;502
8;Barcelona;24;Osona;08112;Manlleu;1;2;U;;603;196;362;431;172;3;12;416;428
8;Barcelona;24;Osona;08112;Manlleu;2;1;A;;625;179;345;407;218;0;16;391;407
8;Barcelona;24;Osona;08112;Manlleu;2;1;B;;685;222;391;464;221;0;9;455;464
8;Barcelona;24;Osona;08112;Manlleu;2;2;A;;582;150;302;371;211;4;15;352;367
8;Barcelona;24;Osona;08112;Manlleu;2;2;B;;727;169;325;404;323;3;16;385;401
8;Barcelona;24;Osona;08112;Manlleu;2;3;A;;411;140;243;290;121;0;6;284;290
8;Barcelona;24;Osona;08112;Manlleu;2;3;B;;453;157;263;311;142;0;13;298;311
8;Barcelona;24;Osona;08112;Manlleu;2;4;A;;509;141;276;322;187;0;13;309;322
8;Barcelona;24;Osona;08112;Manlleu;2;4;B;;534;146;276;335;199;0;14;321;335
8;Barcelona;24;Osona;08112;Manlleu;3;1;A;;760;166;342;442;318;1;17;424;441
8;Barcelona;24;Osona;08112;Manlleu;3;1;B;;679;155;305;382;297;1;9;372;381
8;Barcelona;24;Osona;08112;Manlleu;3;1;C;;679;150;315;384;295;1;12;371;383
8;Barcelona;24;Osona;08112;Manlleu;3;2;A;;721;182;357;452;269;1;9;442;451
8;Barcelona;24;Osona;08112;Manlleu;3;2;B;;766;220;371;475;291;7;5;463;468
8;Barcelona;24;Osona;08112;Manlleu;3;3;A;;547;141;251;299;248;3;8;288;296
8;Barcelona;24;Osona;08112;Manlleu;3;3;B;;597;170;294;332;265;0;8;324;332
8;Barcelona;24;Osona;08112;Manlleu;4;1;U;;639;198;344;408;231;0;10;398;408
8;Barcelona;24;Osona;08112;Manlleu;4;2;A;;564;160;302;369;195;0;12;357;369
8;Barcelona;24;Osona;08112;Manlleu;4;2;B;;698;186;365;453;245;4;10;439;449
8;Barcelona;7;Bages;08113;Manresa;1;1;U;;637;161;258;317;320;3;5;309;314
8;Barcelona;7;Bages;08113;Manresa;1;2;U;;582;158;288;348;234;0;8;340;348
8;Barcelona;7;Bages;08113;Manresa;2;1;U;;672;251;369;441;231;1;16;424;440
8;Barcelona;7;Bages;08113;Manresa;2;10;A;;616;211;334;405;211;3;4;398;402
8;Barcelona;7;Bages;08113;Manresa;2;10;B;;773;274;422;519;254;1;15;503;518
8;Barcelona;7;Bages;08113;Manresa;2;11;A;;551;178;286;349;202;0;12;337;349
8;Barcelona;7;Bages;08113;Manresa;2;11;B;;677;198;341;418;259;0;18;400;418
8;Barcelona;7;Bages;08113;Manresa;2;12;A;;481;134;262;310;171;0;7;303;310
8;Barcelona;7;Bages;08113;Manresa;2;12;B;;571;152;297;371;200;1;6;364;370
8;Barcelona;7;Bages;08113;Manresa;2;13;A;;457;132;224;268;189;1;7;260;267
8;Barcelona;7;Bages;08113;Manresa;2;13;B;;576;190;330;360;216;2;16;342;358
8;Barcelona;7;Bages;08113;Manresa;2;14;U;;504;102;230;272;232;3;9;260;269
8;Barcelona;7;Bages;08113;Manresa;2;2;A;;721;211;396;498;223;4;9;485;494
8;Barcelona;7;Bages;08113;Manresa;2;2;B;;891;280;499;611;280;1;14;596;610
8;Barcelona;7;Bages;08113;Manresa;2;3;A;;651;205;319;405;246;3;8;394;402
8;Barcelona;7;Bages;08113;Manresa;2;3;B;;890;267;458;562;328;0;15;547;562
8;Barcelona;7;Bages;08113;Manresa;2;4;A;;701;240;387;458;243;2;12;444;456
8;Barcelona;7;Bages;08113;Manresa;2;4;B;;890;243;470;580;310;3;10;567;577
8;Barcelona;7;Bages;08113;Manresa;2;5;A;;771;234;391;499;272;1;15;483;498
8;Barcelona;7;Bages;08113;Manresa;2;5;B;;860;234;398;529;331;2;20;507;527
8;Barcelona;7;Bages;08113;Manresa;2;6;U;;599;178;274;331;268;0;4;327;331
8;Barcelona;7;Bages;08113;Manresa;2;7;A;;373;91;139;186;187;0;7;179;186
8;Barcelona;7;Bages;08113;Manresa;2;7;B;;490;151;216;253;237;2;2;249;251
8;Barcelona;7;Bages;08113;Manresa;2;8;U;;594;153;229;291;303;0;5;286;291
8;Barcelona;7;Bages;08113;Manresa;2;9;A;;635;173;310;374;261;0;6;368;374
8;Barcelona;7;Bages;08113;Manresa;2;9;B;;724;213;348;416;308;5;9;402;411
8;Barcelona;7;Bages;08113;Manresa;3;1;U;;601;176;284;336;265;3;7;326;333
8;Barcelona;7;Bages;08113;Manresa;3;2;U;;596;218;306;346;250;2;4;340;344
8;Barcelona;7;Bages;08113;Manresa;3;4;A;;440;132;215;260;180;1;7;252;259
8;Barcelona;7;Bages;08113;Manresa;3;4;B;;564;175;280;339;225;5;4;330;334
8;Barcelona;7;Bages;08113;Manresa;3;5;A;;621;187;306;381;240;1;10;370;380
8;Barcelona;7;Bages;08113;Manresa;3;5;B;;678;181;329;416;262;4;9;403;412
8;Barcelona;7;Bages;08113;Manresa;3;6;A;;341;109;176;217;124;0;7;210;217
8;Barcelona;7;Bages;08113;Manresa;3;6;B;;491;140;238;293;198;0;6;287;293
8;Barcelona;7;Bages;08113;Manresa;4;1;A;;678;221;327;397;281;1;8;388;396
8;Barcelona;7;Bages;08113;Manresa;4;1;B;;748;243;375;448;300;2;13;433;446
8;Barcelona;7;Bages;08113;Manresa;4;11;U;;754;185;350;429;325;2;5;422;427
8;Barcelona;7;Bages;08113;Manresa;4;12;U;;549;139;270;323;226;0;3;320;323
8;Barcelona;7;Bages;08113;Manresa;4;13;A;;508;132;230;308;200;2;11;295;306
8;Barcelona;7;Bages;08113;Manresa;4;13;B;;621;191;305;376;245;1;4;371;375
8;Barcelona;7;Bages;08113;Manresa;4;14;A;;552;155;279;363;189;0;8;355;363
8;Barcelona;7;Bages;08113;Manresa;4;14;B;;700;213;338;428;272;4;10;414;424
8;Barcelona;7;Bages;08113;Manresa;4;3;U;;683;232;355;420;263;1;13;406;419
8;Barcelona;7;Bages;08113;Manresa;4;4;A;;610;201;317;402;208;0;5;397;402
8;Barcelona;7;Bages;08113;Manresa;4;4;B;;876;287;474;580;296;1;7;572;579
8;Barcelona;7;Bages;08113;Manresa;4;5;A;;516;156;271;325;191;0;8;317;325
8;Barcelona;7;Bages;08113;Manresa;4;5;B;;627;195;341;402;225;0;6;396;402
8;Barcelona;7;Bages;08113;Manresa;4;6;A;;594;189;324;398;196;3;8;387;395
8;Barcelona;7;Bages;08113;Manresa;4;6;B;;746;245;435;465;281;0;10;455;465
8;Barcelona;7;Bages;08113;Manresa;4;7;A;;670;171;338;423;247;4;7;412;419
8;Barcelona;7;Bages;08113;Manresa;4;7;B;;792;209;360;460;332;2;8;450;458
8;Barcelona;7;Bages;08113;Manresa;4;8;A;;932;264;484;598;334;1;11;586;597
8;Barcelona;7;Bages;08113;Manresa;4;8;B;;1101;290;533;655;446;3;19;633;652
8;Barcelona;7;Bages;08113;Manresa;4;9;A;;470;119;201;256;214;0;7;249;256
8;Barcelona;7;Bages;08113;Manresa;4;9;B;;632;143;263;336;296;0;13;323;336
8;Barcelona;7;Bages;08113;Manresa;5;1;U;;742;187;327;385;357;0;5;380;385
8;Barcelona;7;Bages;08113;Manresa;5;10;A;;394;130;196;226;168;5;2;219;221
8;Barcelona;7;Bages;08113;Manresa;5;10;B;;501;164;245;280;221;0;3;277;280
8;Barcelona;7;Bages;08113;Manresa;5;11;A;;541;138;237;303;238;4;8;291;299
8;Barcelona;7;Bages;08113;Manresa;5;11;B;;665;157;307;378;287;2;7;369;376
8;Barcelona;7;Bages;08113;Manresa;5;12;U;;710;152;276;337;373;2;4;331;335
8;Barcelona;7;Bages;08113;Manresa;5;13;A;;499;137;235;287;212;1;5;281;286
8;Barcelona;7;Bages;08113;Manresa;5;13;B;;570;171;282;333;237;4;8;321;329
8;Barcelona;7;Bages;08113;Manresa;5;14;A;;610;151;296;366;244;2;10;354;364
8;Barcelona;7;Bages;08113;Manresa;5;14;B;;702;196;360;457;245;0;19;438;457
8;Barcelona;7;Bages;08113;Manresa;5;15;A;;499;81;161;209;290;2;0;207;207
8;Barcelona;7;Bages;08113;Manresa;5;15;B;;591;124;217;271;320;0;4;267;271
8;Barcelona;7;Bages;08113;Manresa;5;16;U;;438;134;199;227;211;0;4;223;227
8;Barcelona;7;Bages;08113;Manresa;5;17;A;;538;102;226;289;249;2;1;286;287
8;Barcelona;7;Bages;08113;Manresa;5;17;B;;802;156;376;449;353;2;12;435;447
8;Barcelona;7;Bages;08113;Manresa;5;18;U;;691;109;204;284;407;0;4;280;284
8;Barcelona;7;Bages;08113;Manresa;5;2;A;;403;101;159;200;203;0;8;192;200
8;Barcelona;7;Bages;08113;Manresa;5;2;B;;499;148;231;268;231;2;6;260;266
8;Barcelona;7;Bages;08113;Manresa;5;3;A;;526;117;215;280;246;1;3;276;279
8;Barcelona;7;Bages;08113;Manresa;5;3;B;;587;139;251;315;272;1;5;309;314
8;Barcelona;7;Bages;08113;Manresa;5;4;U;;545;145;237;314;231;2;6;306;312
8;Barcelona;7;Bages;08113;Manresa;5;5;A;;714;210;316;392;322;1;11;380;391
8;Barcelona;7;Bages;08113;Manresa;5;5;B;;810;213;369;470;340;1;6;463;469
8;Barcelona;7;Bages;08113;Manresa;5;6;A;;608;148;262;318;290;8;1;309;310
8;Barcelona;7;Bages;08113;Manresa;5;6;B;;767;223;363;449;318;2;8;439;447
8;Barcelona;7;Bages;08113;Manresa;5;7;U;;370;76;143;171;199;0;4;167;171
8;Barcelona;7;Bages;08113;Manresa;5;8;U;;777;181;312;421;356;0;9;412;421
8;Barcelona;7;Bages;08113;Manresa;6;1;A;;360;101;157;181;179;0;0;181;181
8;Barcelona;7;Bages;08113;Manresa;6;1;B;;460;129;199;236;224;0;0;236;236
8;Barcelona;7;Bages;08113;Manresa;6;2;U;;821;222;383;458;363;0;8;450;458
43;Tarragona;29;Priorat;43076;Marçà;1;1;U;;497;140;273;343;154;3;7;333;340
43;Tarragona;29;Priorat;43075;Margalef;1;1;U;;108;29;95;72;36;0;6;66;72
8;Barcelona;7;Bages;08242;Marganell;1;1;U;;224;66;113;144;80;0;2;142;144
8;Barcelona;11;Baix Llobregat;08114;Martorell;1;1;A;;496;129;242;299;197;0;5;294;299
8;Barcelona;11;Baix Llobregat;08114;Martorell;1;1;B;;479;105;210;265;214;3;5;257;262
8;Barcelona;11;Baix Llobregat;08114;Martorell;1;2;U;;560;155;249;323;237;1;7;315;322
8;Barcelona;11;Baix Llobregat;08114;Martorell;1;3;A;;430;112;194;245;185;1;5;239;244
8;Barcelona;11;Baix Llobregat;08114;Martorell;1;3;B;;423;130;218;262;161;4;6;252;258
8;Barcelona;11;Baix Llobregat;08114;Martorell;2;3;A;;610;161;263;328;282;1;7;320;327
8;Barcelona;11;Baix Llobregat;08114;Martorell;2;3;B;;598;153;254;312;286;5;6;301;307
8;Barcelona;11;Baix Llobregat;08114;Martorell;2;3;C;;562;133;239;303;259;1;5;297;302
8;Barcelona;11;Baix Llobregat;08114;Martorell;3;10;A;;253;57;118;153;100;0;1;152;153
8;Barcelona;11;Baix Llobregat;08114;Martorell;3;10;B;;300;66;152;200;100;2;6;192;198
8;Barcelona;11;Baix Llobregat;08114;Martorell;3;2;A;;560;181;266;311;249;1;5;305;310
8;Barcelona;11;Baix Llobregat;08114;Martorell;3;2;B;;615;189;261;320;295;0;3;317;320
8;Barcelona;11;Baix Llobregat;08114;Martorell;3;4;A;;417;89;155;202;215;5;1;196;197
8;Barcelona;11;Baix Llobregat;08114;Martorell;3;4;B;;459;130;196;222;237;2;3;217;220
8;Barcelona;11;Baix Llobregat;08114;Martorell;3;4;C;;476;123;205;245;231;0;5;240;245
8;Barcelona;11;Baix Llobregat;08114;Martorell;3;5;A;;471;131;202;240;231;2;2;236;238
8;Barcelona;11;Baix Llobregat;08114;Martorell;3;5;B;;485;148;237;276;209;2;0;274;274
8;Barcelona;11;Baix Llobregat;08114;Martorell;3;6;A;;446;140;206;264;182;1;9;254;263
8;Barcelona;11;Baix Llobregat;08114;Martorell;3;6;B;;438;120;200;254;184;0;2;252;254
8;Barcelona;11;Baix Llobregat;08114;Martorell;3;6;C;;441;135;232;274;167;0;4;270;274
8;Barcelona;11;Baix Llobregat;08114;Martorell;3;7;A;;606;180;306;399;207;0;9;390;399
8;Barcelona;11;Baix Llobregat;08114;Martorell;3;7;B;;617;132;268;343;274;1;4;338;342
8;Barcelona;11;Baix Llobregat;08114;Martorell;3;8;A;;460;108;194;268;192;0;5;263;268
8;Barcelona;11;Baix Llobregat;08114;Martorell;3;8;B;;646;140;297;388;258;1;11;376;387
8;Barcelona;11;Baix Llobregat;08114;Martorell;3;8;C;;459;103;196;264;195;1;6;257;263
8;Barcelona;11;Baix Llobregat;08114;Martorell;4;1;A;;561;114;221;305;256;0;3;302;305
8;Barcelona;11;Baix Llobregat;08114;Martorell;4;1;B;;651;145;270;350;301;1;7;342;349
8;Barcelona;11;Baix Llobregat;08114;Martorell;4;1;C;;563;106;218;293;270;1;5;287;292
8;Barcelona;11;Baix Llobregat;08114;Martorell;4;2;A;;454;101;197;282;172;0;6;276;282
8;Barcelona;11;Baix Llobregat;08114;Martorell;4;2;B;;595;123;238;340;255;0;5;335;340
8;Barcelona;11;Baix Llobregat;08114;Martorell;4;2;C;;523;134;229;314;209;6;5;303;308
8;Barcelona;11;Baix Llobregat;08114;Martorell;4;3;A;;713;164;307;413;300;2;12;399;411
8;Barcelona;11;Baix Llobregat;08114;Martorell;4;3;B;;951;222;374;508;443;0;4;504;508
8;Barcelona;11;Baix Llobregat;08114;Martorell;4;3;C;;718;167;270;380;338;0;4;376;380
8;Barcelona;41;Vallès Oriental;08115;Martorelles;1;1;A;;399;97;164;199;200;0;3;196;199
8;Barcelona;41;Vallès Oriental;08115;Martorelles;1;1;B;;501;126;207;249;252;1;2;246;248
8;Barcelona;41;Vallès Oriental;08115;Martorelles;1;1;C;;569;121;240;299;270;2;4;293;297
8;Barcelona;41;Vallès Oriental;08115;Martorelles;1;2;A;;517;104;217;277;240;1;9;267;276
8;Barcelona;41;Vallès Oriental;08115;Martorelles;1;2;B;;790;188;380;462;328;3;15;444;459
8;Barcelona;41;Vallès Oriental;08115;Martorelles;1;3;A;;558;103;225;275;283;2;5;268;273
8;Barcelona;41;Vallès Oriental;08115;Martorelles;1;3;B;;624;126;294;345;279;1;7;337;344
17;Girona;2;Alt Empordà;17100;Masarac;1;1;U;;204;64;119;147;57;0;2;145;147
43;Tarragona;22;Montsià;43077;Mas de Barberans;1;1;U;;538;159;278;326;212;0;1;325;326
43;Tarragona;22;Montsià;43078;Masdenverge;1;1;U;;792;200;408;532;260;6;12;514;526
8;Barcelona;24;Osona;08116;Masies de Roda, les;1;1;U;;616;177;355;425;191;3;9;413;422
8;Barcelona;24;Osona;08117;Masies de Voltregà, les;1;1;A;;735;190;372;466;269;5;23;438;461
8;Barcelona;24;Osona;08117;Masies de Voltregà, les;1;1;B;;542;155;313;365;177;1;7;357;364
8;Barcelona;24;Osona;08117;Masies de Voltregà, les;1;1;C;;542;159;320;378;164;1;13;364;377
8;Barcelona;24;Osona;08117;Masies de Voltregà, les;2;1;U;;630;173;296;364;266;2;8;354;362
43;Tarragona;12;Baix Penedès;43079;Masllorenç;1;1;U;;366;126;225;269;97;3;4;262;266
8;Barcelona;21;Maresme;08118;Masnou, el;1;1;A;;706;157;330;436;270;1;14;421;435
8;Barcelona;21;Maresme;08118;Masnou, el;1;1;B;;716;159;353;451;265;0;14;437;451
8;Barcelona;21;Maresme;08118;Masnou, el;1;10;A;;531;140;262;337;194;1;4;332;336
8;Barcelona;21;Maresme;08118;Masnou, el;1;10;B;;558;167;285;358;200;2;15;341;356
8;Barcelona;21;Maresme;08118;Masnou, el;1;2;A;;701;212;344;423;278;0;11;412;423
8;Barcelona;21;Maresme;08118;Masnou, el;1;2;B;;845;225;405;503;342;0;13;490;503
8;Barcelona;21;Maresme;08118;Masnou, el;1;3;A;;426;128;221;269;157;3;5;261;266
8;Barcelona;21;Maresme;08118;Masnou, el;1;3;B;;478;127;245;308;170;2;11;295;306
8;Barcelona;21;Maresme;08118;Masnou, el;1;4;A;;638;193;315;409;229;1;7;401;408
8;Barcelona;21;Maresme;08118;Masnou, el;1;4;B;;742;224;382;478;264;1;10;467;477
8;Barcelona;21;Maresme;08118;Masnou, el;1;5;A;;650;174;334;399;251;2;8;389;397
8;Barcelona;21;Maresme;08118;Masnou, el;1;5;B;;745;216;370;456;289;1;10;445;455
8;Barcelona;21;Maresme;08118;Masnou, el;1;6;A;;636;156;267;350;286;0;7;343;350
8;Barcelona;21;Maresme;08118;Masnou, el;1;6;B;;753;83;319;399;354;2;8;389;397
8;Barcelona;21;Maresme;08118;Masnou, el;1;7;A;;618;177;299;362;256;0;15;347;362
8;Barcelona;21;Maresme;08118;Masnou, el;1;7;B;;651;162;302;392;259;0;14;378;392
8;Barcelona;21;Maresme;08118;Masnou, el;1;8;U;;1111;244;497;602;509;1;26;575;601
8;Barcelona;21;Maresme;08118;Masnou, el;1;9;U;;623;211;342;416;207;4;13;399;412
8;Barcelona;21;Maresme;08118;Masnou, el;2;1;A;;665;203;359;455;210;2;8;445;453
8;Barcelona;21;Maresme;08118;Masnou, el;2;1;B;;710;204;393;474;236;1;10;463;473
8;Barcelona;21;Maresme;08118;Masnou, el;2;2;U;;823;233;433;537;286;5;13;519;532
8;Barcelona;21;Maresme;08118;Masnou, el;2;3;A;;507;156;254;315;192;0;5;310;315
8;Barcelona;21;Maresme;08118;Masnou, el;2;3;B;;523;169;278;331;192;3;15;313;328
8;Barcelona;21;Maresme;08118;Masnou, el;2;4;A;;674;183;338;422;252;1;13;408;421
8;Barcelona;21;Maresme;08118;Masnou, el;2;4;B;;792;232;399;491;301;5;14;472;486
43;Tarragona;1;Alt Camp;43080;Masó, la;1;1;U;;249;51;146;181;68;4;9;168;177
43;Tarragona;8;Baix Camp;43081;Maspujols;1;1;U;;416;115;275;322;94;5;7;310;317
8;Barcelona;6;Anoia;08119;Masquefa;1;1;A;;448;95;183;241;207;0;3;238;241
8;Barcelona;6;Anoia;08119;Masquefa;1;1;B;;673;142;260;354;319;0;8;346;354
8;Barcelona;6;Anoia;08119;Masquefa;1;1;C;;702;156;305;401;301;3;9;389;398
8;Barcelona;6;Anoia;08119;Masquefa;1;1;D;;621;134;256;335;286;0;5;330;335
8;Barcelona;6;Anoia;08119;Masquefa;1;1;E;;563;114;226;298;265;1;7;290;297
8;Barcelona;6;Anoia;08119;Masquefa;1;1;F;;505;113;198;271;234;2;7;262;269
8;Barcelona;6;Anoia;08119;Masquefa;1;2;A;;695;121;223;289;406;1;10;278;288
8;Barcelona;6;Anoia;08119;Masquefa;1;2;B;;740;119;237;295;445;3;5;287;292
8;Barcelona;6;Anoia;08119;Masquefa;1;2;C;;721;127;230;310;411;1;1;308;309
43;Tarragona;29;Priorat;43082;Masroig, el;1;1;U;;410;120;249;309;101;5;12;292;304
25;Lleida;33;Segrià;25131;Massalcoreig;1;1;U;;483;136;246;285;198;2;5;278;283
17;Girona;34;Selva;17101;Massanes;1;1;U;;528;127;247;292;236;0;3;289;292
25;Lleida;32;Segarra;25132;Massoteres;1;1;U;;148;38;77;94;54;1;2;91;93
8;Barcelona;40;Vallès Occidental;08120;Matadepera;1;1;A;;768;235;450;564;204;3;9;552;561
8;Barcelona;40;Vallès Occidental;08120;Matadepera;1;1;B;;768;221;430;536;232;0;13;523;536
8;Barcelona;40;Vallès Occidental;08120;Matadepera;1;2;A;;800;216;417;593;207;0;13;580;593
8;Barcelona;40;Vallès Occidental;08120;Matadepera;1;2;B;;805;193;441;576;229;3;15;558;573
8;Barcelona;40;Vallès Occidental;08120;Matadepera;1;3;A;;782;222;389;526;256;2;13;511;524
8;Barcelona;40;Vallès Occidental;08120;Matadepera;1;3;B;;914;248;481;622;292;4;17;601;618
8;Barcelona;40;Vallès Occidental;08120;Matadepera;1;4;A;;581;132;292;399;182;1;7;391;398
8;Barcelona;40;Vallès Occidental;08120;Matadepera;1;4;B;;663;169;331;446;217;3;8;435;443
8;Barcelona;21;Maresme;08121;Mataró;1;1;U;;699;242;386;473;226;2;8;463;471
8;Barcelona;21;Maresme;08121;Mataró;1;2;A;;489;161;257;318;171;1;9;308;317
8;Barcelona;21;Maresme;08121;Mataró;1;2;B;;521;171;254;332;189;1;4;327;331
8;Barcelona;21;Maresme;08121;Mataró;1;3;A;;528;181;304;382;146;1;7;374;381
8;Barcelona;21;Maresme;08121;Mataró;1;3;B;;476;167;277;327;149;0;8;319;327
8;Barcelona;21;Maresme;08121;Mataró;1;4;A;;459;178;272;335;124;0;11;324;335
8;Barcelona;21;Maresme;08121;Mataró;1;4;B;;476;157;282;354;122;1;8;345;353
8;Barcelona;21;Maresme;08121;Mataró;1;5;A;;594;202;364;436;158;1;4;431;435
8;Barcelona;21;Maresme;08121;Mataró;1;5;B;;643;221;379;476;167;0;9;467;476
8;Barcelona;21;Maresme;08121;Mataró;1;6;A;;690;202;397;497;193;0;5;492;497
8;Barcelona;21;Maresme;08121;Mataró;1;6;B;;503;136;267;327;176;1;9;317;326
8;Barcelona;21;Maresme;08121;Mataró;1;6;C;;690;198;384;482;208;3;4;475;479
8;Barcelona;21;Maresme;08121;Mataró;1;7;A;;572;190;314;401;171;2;7;392;399
8;Barcelona;21;Maresme;08121;Mataró;1;7;B;;626;227;375;446;180;0;6;440;446
8;Barcelona;21;Maresme;08121;Mataró;1;8;U;;489;192;300;353;136;0;9;344;353
8;Barcelona;21;Maresme;08121;Mataró;2;1;A;;756;235;402;486;270;1;13;472;485
8;Barcelona;21;Maresme;08121;Mataró;2;1;B;;844;248;462;567;277;0;13;554;567
8;Barcelona;21;Maresme;08121;Mataró;2;10;U;;888;272;479;584;304;3;23;558;581
8;Barcelona;21;Maresme;08121;Mataró;2;11;A;;553;183;295;354;199;0;9;345;354
8;Barcelona;21;Maresme;08121;Mataró;2;11;B;;512;168;281;328;184;2;7;319;326
8;Barcelona;21;Maresme;08121;Mataró;2;12;U;;910;335;500;609;301;8;16;585;601
8;Barcelona;21;Maresme;08121;Mataró;2;2;U;;760;227;374;432;328;1;4;427;431
8;Barcelona;21;Maresme;08121;Mataró;2;3;U;;769;221;356;422;347;4;8;410;418
8;Barcelona;21;Maresme;08121;Mataró;2;4;U;;463;108;186;225;238;0;5;220;225
8;Barcelona;21;Maresme;08121;Mataró;2;5;A;;709;201;330;395;314;3;9;383;392
8;Barcelona;21;Maresme;08121;Mataró;2;5;B;;771;216;353;440;331;0;2;438;440
8;Barcelona;21;Maresme;08121;Mataró;2;6;A;;458;139;214;250;208;1;3;246;249
8;Barcelona;21;Maresme;08121;Mataró;2;6;B;;565;153;249;291;274;0;5;286;291
8;Barcelona;21;Maresme;08121;Mataró;2;7;U;;888;274;449;560;328;2;15;543;558
8;Barcelona;21;Maresme;08121;Mataró;2;8;A;;594;191;341;394;200;2;12;380;392
8;Barcelona;21;Maresme;08121;Mataró;2;8;B;;574;187;321;377;197;2;6;369;375
8;Barcelona;21;Maresme;08121;Mataró;2;9;A;;467;150;254;318;149;0;7;311;318
8;Barcelona;21;Maresme;08121;Mataró;2;9;B;;583;169;296;393;190;0;3;390;393
8;Barcelona;21;Maresme;08121;Mataró;3;1;A;;449;123;211;249;200;0;3;246;249
8;Barcelona;21;Maresme;08121;Mataró;3;1;B;;536;145;257;294;242;0;7;287;294
8;Barcelona;21;Maresme;08121;Mataró;3;10;U;;578;208;338;426;152;1;7;418;425
8;Barcelona;21;Maresme;08121;Mataró;3;11;A;;515;151;249;305;210;0;2;303;305
8;Barcelona;21;Maresme;08121;Mataró;3;11;B;;610;176;304;364;246;0;6;358;364
8;Barcelona;21;Maresme;08121;Mataró;3;12;A;;517;128;243;308;209;0;2;306;308
8;Barcelona;21;Maresme;08121;Mataró;3;12;B;;614;156;283;364;250;1;5;358;363
8;Barcelona;21;Maresme;08121;Mataró;3;13;A;;583;136;256;333;250;2;8;323;331
8;Barcelona;21;Maresme;08121;Mataró;3;13;B;;711;138;276;367;344;2;8;357;365
8;Barcelona;21;Maresme;08121;Mataró;3;13;C;;706;135;268;361;345;1;5;355;360
8;Barcelona;21;Maresme;08121;Mataró;3;14;A;;435;71;168;219;216;0;2;217;219
8;Barcelona;21;Maresme;08121;Mataró;3;14;B;;537;116;222;287;250;0;7;280;287
8;Barcelona;21;Maresme;08121;Mataró;3;2;A;;452;132;197;226;226;1;6;219;225
8;Barcelona;21;Maresme;08121;Mataró;3;2;B;;505;130;216;246;259;2;8;236;244
8;Barcelona;21;Maresme;08121;Mataró;3;3;A;;443;105;170;199;244;1;1;197;198
8;Barcelona;21;Maresme;08121;Mataró;3;3;B;;539;120;221;269;270;0;4;265;269
8;Barcelona;21;Maresme;08121;Mataró;3;4;A;;607;130;215;259;348;1;4;254;258
8;Barcelona;21;Maresme;08121;Mataró;3;4;B;;780;162;287;359;421;2;10;347;357
8;Barcelona;21;Maresme;08121;Mataró;3;5;A;;476;116;183;219;257;2;3;214;217
8;Barcelona;21;Maresme;08121;Mataró;3;5;B;;645;154;237;277;368;3;3;271;274
8;Barcelona;21;Maresme;08121;Mataró;3;6;A;;517;92;185;245;272;0;4;241;245
8;Barcelona;21;Maresme;08121;Mataró;3;6;B;;643;158;270;329;314;2;9;318;327
8;Barcelona;21;Maresme;08121;Mataró;3;7;A;;454;97;183;222;232;0;2;220;222
8;Barcelona;21;Maresme;08121;Mataró;3;7;B;;550;158;240;281;269;0;7;274;281
8;Barcelona;21;Maresme;08121;Mataró;3;8;U;;894;215;385;450;444;1;15;434;449
8;Barcelona;21;Maresme;08121;Mataró;3;9;A;;529;136;237;271;258;1;4;266;270
8;Barcelona;21;Maresme;08121;Mataró;3;9;B;;564;138;233;285;279;3;10;272;282
8;Barcelona;21;Maresme;08121;Mataró;3;9;C;;626;150;249;302;324;0;6;296;302
8;Barcelona;21;Maresme;08121;Mataró;4;1;A;;453;125;215;264;189;0;1;263;264
8;Barcelona;21;Maresme;08121;Mataró;4;1;B;;510;155;258;311;199;0;9;302;311
8;Barcelona;21;Maresme;08121;Mataró;4;2;A;;476;121;190;228;248;1;0;227;227
8;Barcelona;21;Maresme;08121;Mataró;4;2;B;;593;133;234;281;312;1;3;277;280
8;Barcelona;21;Maresme;08121;Mataró;4;3;U;;729;169;302;367;362;0;4;363;367
8;Barcelona;21;Maresme;08121;Mataró;4;4;A;;580;108;215;265;315;0;5;260;265
8;Barcelona;21;Maresme;08121;Mataró;4;4;B;;687;133;262;318;369;0;2;316;318
8;Barcelona;21;Maresme;08121;Mataró;4;4;C;;706;106;237;306;400;0;4;302;306
8;Barcelona;21;Maresme;08121;Mataró;4;5;A;;534;111;211;258;276;0;6;252;258
8;Barcelona;21;Maresme;08121;Mataró;4;5;B;;719;122;235;314;405;0;10;304;314
8;Barcelona;21;Maresme;08121;Mataró;4;5;C;;725;140;270;357;368;0;8;349;357
8;Barcelona;21;Maresme;08121;Mataró;4;6;A;;1018;249;476;542;476;0;14;528;542
8;Barcelona;21;Maresme;08121;Mataró;4;6;B;;1136;267;417;607;529;2;8;597;605
8;Barcelona;21;Maresme;08121;Mataró;4;6;C;;1146;299;493;616;530;1;10;605;615
8;Barcelona;21;Maresme;08121;Mataró;4;7;U;;940;125;274;366;574;0;9;357;366
8;Barcelona;21;Maresme;08121;Mataró;5;1;A;;523;125;218;270;253;0;11;259;270
8;Barcelona;21;Maresme;08121;Mataró;5;1;B;;654;161;267;336;318;1;4;331;335
8;Barcelona;21;Maresme;08121;Mataró;5;1;C;;637;138;276;337;300;3;7;327;334
8;Barcelona;21;Maresme;08121;Mataró;5;10;U;;376;117;158;186;190;0;4;182;186
8;Barcelona;21;Maresme;08121;Mataró;5;11;A;;555;125;201;245;310;1;4;240;244
8;Barcelona;21;Maresme;08121;Mataró;5;11;B;;629;152;238;281;348;0;2;279;281
8;Barcelona;21;Maresme;08121;Mataró;5;12;A;;482;116;199;235;247;0;0;235;235
8;Barcelona;21;Maresme;08121;Mataró;5;12;B;;548;113;200;248;300;0;5;243;248
8;Barcelona;21;Maresme;08121;Mataró;5;13;A;;425;112;178;214;211;2;2;210;212
8;Barcelona;21;Maresme;08121;Mataró;5;13;B;;518;123;201;242;276;1;7;234;241
8;Barcelona;21;Maresme;08121;Mataró;5;13;C;;499;100;168;225;274;1;4;220;224
8;Barcelona;21;Maresme;08121;Mataró;5;14;U;;481;100;177;195;286;0;0;195;195
8;Barcelona;21;Maresme;08121;Mataró;5;15;U;;799;174;299;374;425;0;13;361;374
8;Barcelona;21;Maresme;08121;Mataró;5;16;A;;453;90;160;212;241;0;1;211;212
8;Barcelona;21;Maresme;08121;Mataró;5;16;B;;447;99;168;205;242;0;6;199;205
8;Barcelona;21;Maresme;08121;Mataró;5;17;U;;744;158;314;356;388;1;9;346;355
8;Barcelona;21;Maresme;08121;Mataró;5;18;U;;331;69;115;139;192;0;4;135;139
8;Barcelona;21;Maresme;08121;Mataró;5;19;U;;649;146;238;291;358;1;3;287;290
8;Barcelona;21;Maresme;08121;Mataró;5;2;A;;649;135;228;275;374;0;3;272;275
8;Barcelona;21;Maresme;08121;Mataró;5;2;B;;670;129;220;283;387;0;8;275;283
8;Barcelona;21;Maresme;08121;Mataró;5;20;A;;483;113;179;211;272;0;0;211;211
8;Barcelona;21;Maresme;08121;Mataró;5;20;B;;623;148;242;291;332;0;4;287;291
8;Barcelona;21;Maresme;08121;Mataró;5;21;U;;696;107;229;322;374;1;7;314;321
8;Barcelona;21;Maresme;08121;Mataró;5;3;A;;583;101;208;248;335;0;5;243;248
8;Barcelona;21;Maresme;08121;Mataró;5;3;B;;696;127;252;303;393;0;7;296;303
8;Barcelona;21;Maresme;08121;Mataró;5;4;A;;481;105;194;247;234;2;7;238;245
8;Barcelona;21;Maresme;08121;Mataró;5;4;B;;542;128;232;281;261;0;7;274;281
8;Barcelona;21;Maresme;08121;Mataró;5;5;U;;676;130;262;316;360;0;6;310;316
8;Barcelona;21;Maresme;08121;Mataró;5;6;A;;525;69;123;175;350;0;5;170;175
8;Barcelona;21;Maresme;08121;Mataró;5;6;B;;635;101;185;229;406;0;4;225;229
8;Barcelona;21;Maresme;08121;Mataró;5;7;A;;560;115;200;259;301;0;9;250;259
8;Barcelona;21;Maresme;08121;Mataró;5;7;B;;615;110;218;291;324;0;8;283;291
8;Barcelona;21;Maresme;08121;Mataró;5;8;A;;422;84;122;157;265;1;4;152;156
8;Barcelona;21;Maresme;08121;Mataró;5;8;B;;508;116;176;217;291;0;6;211;217
8;Barcelona;21;Maresme;08121;Mataró;5;9;U;;845;198;306;362;483;2;10;350;360
8;Barcelona;21;Maresme;08121;Mataró;6;1;A;;684;214;341;414;270;0;5;409;414
8;Barcelona;21;Maresme;08121;Mataró;6;1;B;;897;273;449;567;330;0;15;552;567
8;Barcelona;21;Maresme;08121;Mataró;6;10;A;;626;164;281;328;298;1;11;316;327
8;Barcelona;21;Maresme;08121;Mataró;6;10;B;;615;156;268;326;289;0;12;314;326
8;Barcelona;21;Maresme;08121;Mataró;6;10;C;;686;158;284;338;348;2;9;327;336
8;Barcelona;21;Maresme;08121;Mataró;6;11;A;;668;228;352;433;235;0;9;424;433
8;Barcelona;21;Maresme;08121;Mataró;6;11;B;;729;208;368;425;304;0;11;414;425
8;Barcelona;21;Maresme;08121;Mataró;6;11;C;;870;260;440;546;324;0;13;533;546
8;Barcelona;21;Maresme;08121;Mataró;6;12;A;;676;149;283;343;333;0;9;334;343
8;Barcelona;21;Maresme;08121;Mataró;6;12;B;;762;166;292;355;407;1;8;346;354
8;Barcelona;21;Maresme;08121;Mataró;6;13;U;;869;297;404;475;394;1;7;467;474
8;Barcelona;21;Maresme;08121;Mataró;6;2;U;;644;204;343;417;227;1;8;408;416
8;Barcelona;21;Maresme;08121;Mataró;6;3;A;;643;174;350;447;196;1;9;437;446
8;Barcelona;21;Maresme;08121;Mataró;6;3;B;;723;218;389;489;234;0;8;481;489
8;Barcelona;21;Maresme;08121;Mataró;6;4;A;;543;161;291;357;186;2;7;348;355
8;Barcelona;21;Maresme;08121;Mataró;6;4;B;;580;200;317;385;195;1;8;376;384
8;Barcelona;21;Maresme;08121;Mataró;6;5;A;;711;186;308;406;305;1;12;393;405
8;Barcelona;21;Maresme;08121;Mataró;6;5;B;;754;189;326;423;331;1;5;417;422
8;Barcelona;21;Maresme;08121;Mataró;6;6;A;;650;187;317;409;241;0;6;403;409
8;Barcelona;21;Maresme;08121;Mataró;6;6;B;;670;202;351;432;238;0;15;417;432
8;Barcelona;21;Maresme;08121;Mataró;6;7;A;;581;138;247;305;276;3;5;297;302
8;Barcelona;21;Maresme;08121;Mataró;6;7;B;;673;199;335;394;279;6;11;377;388
8;Barcelona;21;Maresme;08121;Mataró;6;8;A;;673;160;281;359;314;5;10;344;354
8;Barcelona;21;Maresme;08121;Mataró;6;8;B;;783;189;355;446;337;3;18;425;443
8;Barcelona;21;Maresme;08121;Mataró;6;9;U;;713;147;238;279;434;0;4;275;279
8;Barcelona;3;Alt Penedès;08122;Mediona;1;1;A;;832;212;379;481;351;3;5;473;478
8;Barcelona;3;Alt Penedès;08122;Mediona;1;1;B;;862;214;379;471;391;6;3;462;465
25;Lleida;23;Noguera;25134;Menàrguens;1;1;U;;696;149;351;434;262;7;4;423;427
17;Girona;15;Cerdanya;17099;Meranges;1;1;U;;78;16;37;55;23;0;1;54;55
17;Girona;19;Garrotxa;17105;Mieres;1;1;U;;256;80;137;180;76;2;3;175;178
43;Tarragona;1;Alt Camp;43083;Milà, el;1;1;U;;150;37;69;102;48;2;2;98;100
25;Lleida;27;Pla d'Urgell;25135;Miralcamp;1;1;U;;1104;247;566;745;359;10;14;721;735
43;Tarragona;30;Ribera d'Ebre;43084;Miravet;1;1;U;;614;182;357;438;176;4;6;428;434
8;Barcelona;;;08138;Moià;1;1;A;;706;193;363;471;235;3;11;457;468
8;Barcelona;;;08138;Moià;1;1;B;;741;202;369;482;259;3;13;466;479
8;Barcelona;;;08138;Moià;1;2;A;;792;189;356;465;327;3;14;448;462
8;Barcelona;;;08138;Moià;1;2;B;;876;261;423;542;334;4;13;525;538
8;Barcelona;;;08138;Moià;1;3;U;;768;198;377;481;287;1;17;463;480
43;Tarragona;29;Priorat;43085;Molar, el;1;1;U;;239;70;149;189;50;0;4;185;189
8;Barcelona;11;Baix Llobregat;08123;Molins de Rei;1;1;A;;400;101;188;250;150;4;6;240;246
8;Barcelona;11;Baix Llobregat;08123;Molins de Rei;1;1;B;;514;133;264;306;208;1;9;296;305
8;Barcelona;11;Baix Llobregat;08123;Molins de Rei;1;2;A;;599;157;301;373;226;2;10;361;371
8;Barcelona;11;Baix Llobregat;08123;Molins de Rei;1;2;B;;732;211;344;430;302;1;9;420;429
8;Barcelona;11;Baix Llobregat;08123;Molins de Rei;1;3;A;;610;184;327;407;203;1;11;395;406
8;Barcelona;11;Baix Llobregat;08123;Molins de Rei;1;3;B;;689;197;342;439;250;1;7;431;438
8;Barcelona;11;Baix Llobregat;08123;Molins de Rei;2;1;A;;691;181;330;411;280;3;9;399;408
8;Barcelona;11;Baix Llobregat;08123;Molins de Rei;2;1;B;;678;200;334;419;259;3;8;408;416
8;Barcelona;11;Baix Llobregat;08123;Molins de Rei;2;1;C;;748;181;343;450;298;5;13;432;445
8;Barcelona;11;Baix Llobregat;08123;Molins de Rei;2;2;A;;545;158;292;372;173;2;6;364;370
8;Barcelona;11;Baix Llobregat;08123;Molins de Rei;2;2;B;;600;147;309;397;203;5;10;382;392
8;Barcelona;11;Baix Llobregat;08123;Molins de Rei;2;3;A;;509;126;237;302;207;2;3;297;300
8;Barcelona;11;Baix Llobregat;08123;Molins de Rei;2;3;B;;558;147;278;343;215;2;5;336;341
8;Barcelona;11;Baix Llobregat;08123;Molins de Rei;2;3;C;;614;179;316;383;231;0;5;378;383
8;Barcelona;11;Baix Llobregat;08123;Molins de Rei;2;4;A;;583;154;269;336;247;2;2;332;334
8;Barcelona;11;Baix Llobregat;08123;Molins de Rei;2;4;B;;635;165;267;350;285;1;6;343;349
8;Barcelona;11;Baix Llobregat;08123;Molins de Rei;3;1;A;;762;198;372;489;273;3;14;472;486
8;Barcelona;11;Baix Llobregat;08123;Molins de Rei;3;1;B;;763;195;378;477;286;3;12;462;474
8;Barcelona;11;Baix Llobregat;08123;Molins de Rei;3;1;C;;904;248;445;583;321;4;14;565;579
8;Barcelona;11;Baix Llobregat;08123;Molins de Rei;3;2;A;;807;235;472;565;242;2;12;551;563
8;Barcelona;11;Baix Llobregat;08123;Molins de Rei;3;2;B;;730;197;387;483;247;1;15;467;482
8;Barcelona;11;Baix Llobregat;08123;Molins de Rei;3;2;C;;858;263;485;599;259;2;12;585;597
8;Barcelona;11;Baix Llobregat;08123;Molins de Rei;3;3;A;;627;170;329;409;218;1;5;403;408
8;Barcelona;11;Baix Llobregat;08123;Molins de Rei;3;3;B;;777;205;379;484;293;0;13;471;484
8;Barcelona;11;Baix Llobregat;08123;Molins de Rei;3;4;A;;789;204;356;466;323;0;10;456;466
8;Barcelona;11;Baix Llobregat;08123;Molins de Rei;3;4;B;;935;219;425;544;391;3;5;536;541
8;Barcelona;11;Baix Llobregat;08123;Molins de Rei;4;1;U;;827;214;350;421;406;2;7;412;419
25;Lleida;27;Pla d'Urgell;25137;Mollerussa;1;1;A;;818;223;406;527;291;2;16;509;525
25;Lleida;27;Pla d'Urgell;25137;Mollerussa;1;1;B;;824;218;396;519;305;2;13;504;517
25;Lleida;27;Pla d'Urgell;25137;Mollerussa;1;2;A;;759;183;391;498;261;4;11;483;494
25;Lleida;27;Pla d'Urgell;25137;Mollerussa;1;2;B;;916;223;481;593;323;0;13;580;593
25;Lleida;27;Pla d'Urgell;25137;Mollerussa;1;3;U;;854;226;400;494;360;5;12;477;489
25;Lleida;27;Pla d'Urgell;25137;Mollerussa;1;4;A;;563;108;261;352;211;2;8;342;350
25;Lleida;27;Pla d'Urgell;25137;Mollerussa;1;4;B;;776;175;360;485;291;2;17;466;483
25;Lleida;27;Pla d'Urgell;25137;Mollerussa;1;5;A;;547;140;266;339;208;0;5;334;339
25;Lleida;27;Pla d'Urgell;25137;Mollerussa;1;5;B;;733;174;314;415;318;5;10;400;410
25;Lleida;27;Pla d'Urgell;25137;Mollerussa;1;6;A;;572;107;216;321;251;2;10;309;319
25;Lleida;27;Pla d'Urgell;25137;Mollerussa;1;6;B;;750;168;345;446;304;3;14;429;443
8;Barcelona;41;Vallès Oriental;08124;Mollet del Vallès;1;1;U;;605;134;237;308;297;1;4;303;307
8;Barcelona;41;Vallès Oriental;08124;Mollet del Vallès;1;2;A;;630;145;257;313;317;0;2;311;313
8;Barcelona;41;Vallès Oriental;08124;Mollet del Vallès;1;2;B;;703;152;268;338;365;1;4;333;337
8;Barcelona;41;Vallès Oriental;08124;Mollet del Vallès;1;3;A;;419;97;170;212;207;1;6;205;211
8;Barcelona;41;Vallès Oriental;08124;Mollet del Vallès;1;3;B;;440;103;172;224;216;0;7;217;224
8;Barcelona;41;Vallès Oriental;08124;Mollet del Vallès;1;3;C;;501;140;214;267;234;1;6;260;266
8;Barcelona;41;Vallès Oriental;08124;Mollet del Vallès;1;4;A;;732;209;372;462;270;0;8;454;462
8;Barcelona;41;Vallès Oriental;08124;Mollet del Vallès;1;4;B;;789;233;393;511;278;2;13;496;509
8;Barcelona;41;Vallès Oriental;08124;Mollet del Vallès;1;5;A;;595;128;211;282;313;0;3;279;282
8;Barcelona;41;Vallès Oriental;08124;Mollet del Vallès;1;5;B;;768;175;289;376;392;1;14;361;375
8;Barcelona;41;Vallès Oriental;08124;Mollet del Vallès;1;6;A;;523;139;236;297;226;2;4;291;295
8;Barcelona;41;Vallès Oriental;08124;Mollet del Vallès;1;6;B;;496;120;190;245;251;0;2;243;245
8;Barcelona;41;Vallès Oriental;08124;Mollet del Vallès;1;6;C;;511;120;211;271;240;0;5;266;271
8;Barcelona;41;Vallès Oriental;08124;Mollet del Vallès;1;7;A;;560;85;171;248;312;2;3;243;246
8;Barcelona;41;Vallès Oriental;08124;Mollet del Vallès;1;7;B;;649;103;201;283;366;6;6;271;277
8;Barcelona;41;Vallès Oriental;08124;Mollet del Vallès;2;1;A;;458;117;207;266;192;0;5;261;266
8;Barcelona;41;Vallès Oriental;08124;Mollet del Vallès;2;1;B;;495;138;224;279;216;0;6;273;279
8;Barcelona;41;Vallès Oriental;08124;Mollet del Vallès;2;1;C;;531;140;227;305;226;0;7;298;305
8;Barcelona;41;Vallès Oriental;08124;Mollet del Vallès;2;2;A;;582;155;265;333;249;0;10;323;333
8;Barcelona;41;Vallès Oriental;08124;Mollet del Vallès;2;2;B;;687;193;306;390;297;0;9;381;390
8;Barcelona;41;Vallès Oriental;08124;Mollet del Vallès;2;3;A;;751;155;283;362;389;0;10;352;362
8;Barcelona;41;Vallès Oriental;08124;Mollet del Vallès;2;3;B;;882;198;338;413;469;2;6;405;411
8;Barcelona;41;Vallès Oriental;08124;Mollet del Vallès;2;4;A;;522;86;170;242;280;1;5;236;241
8;Barcelona;41;Vallès Oriental;08124;Mollet del Vallès;2;4;B;;554;111;194;264;290;3;4;257;261
8;Barcelona;41;Vallès Oriental;08124;Mollet del Vallès;2;5;A;;477;112;186;247;230;0;6;241;247
8;Barcelona;41;Vallès Oriental;08124;Mollet del Vallès;2;5;B;;623;124;240;305;318;1;6;298;304
8;Barcelona;41;Vallès Oriental;08124;Mollet del Vallès;2;6;A;;423;80;151;195;228;1;2;192;194
8;Barcelona;41;Vallès Oriental;08124;Mollet del Vallès;2;6;B;;521;102;167;210;311;0;9;201;210
8;Barcelona;41;Vallès Oriental;08124;Mollet del Vallès;2;7;A;;705;117;217;312;393;3;14;295;309
8;Barcelona;41;Vallès Oriental;08124;Mollet del Vallès;2;7;B;;866;173;283;360;506;2;7;351;358
8;Barcelona;41;Vallès Oriental;08124;Mollet del Vallès;2;8;U;;789;209;374;495;294;1;10;484;494
8;Barcelona;41;Vallès Oriental;08124;Mollet del Vallès;2;9;U;;702;176;308;424;278;1;14;409;423
8;Barcelona;41;Vallès Oriental;08124;Mollet del Vallès;3;1;A;;537;126;211;282;255;0;7;275;282
8;Barcelona;41;Vallès Oriental;08124;Mollet del Vallès;3;1;B;;571;115;222;289;282;2;5;282;287
8;Barcelona;41;Vallès Oriental;08124;Mollet del Vallès;3;1;C;;569;141;244;299;270;1;7;291;298
8;Barcelona;41;Vallès Oriental;08124;Mollet del Vallès;3;10;U;;950;168;300;394;556;1;6;387;393
8;Barcelona;41;Vallès Oriental;08124;Mollet del Vallès;3;11;A;;585;107;204;280;305;1;4;275;279
8;Barcelona;41;Vallès Oriental;08124;Mollet del Vallès;3;11;B;;672;116;206;277;395;0;6;271;277
8;Barcelona;41;Vallès Oriental;08124;Mollet del Vallès;3;12;A;;636;126;208;272;364;0;10;262;272
8;Barcelona;41;Vallès Oriental;08124;Mollet del Vallès;3;12;B;;744;150;281;355;389;0;6;349;355
8;Barcelona;41;Vallès Oriental;08124;Mollet del Vallès;3;13;A;;646;118;209;292;354;0;8;284;292
8;Barcelona;41;Vallès Oriental;08124;Mollet del Vallès;3;13;B;;757;140;260;372;385;2;14;356;370
8;Barcelona;41;Vallès Oriental;08124;Mollet del Vallès;3;13;C;;697;113;216;306;391;1;8;297;305
8;Barcelona;41;Vallès Oriental;08124;Mollet del Vallès;3;14;A;;491;90;171;229;262;0;3;226;229
8;Barcelona;41;Vallès Oriental;08124;Mollet del Vallès;3;14;B;;598;117;202;261;337;1;3;257;260
8;Barcelona;41;Vallès Oriental;08124;Mollet del Vallès;3;2;A;;630;168;243;320;310;0;4;316;320
8;Barcelona;41;Vallès Oriental;08124;Mollet del Vallès;3;2;B;;744;141;286;368;376;3;10;355;365
8;Barcelona;41;Vallès Oriental;08124;Mollet del Vallès;3;3;A;;437;113;192;263;174;3;5;255;260
8;Barcelona;41;Vallès Oriental;08124;Mollet del Vallès;3;3;B;;464;117;194;257;207;1;2;254;256
8;Barcelona;41;Vallès Oriental;08124;Mollet del Vallès;3;4;A;;679;154;273;364;315;0;5;359;364
8;Barcelona;41;Vallès Oriental;08124;Mollet del Vallès;3;4;B;;749;169;300;404;345;1;7;396;403
8;Barcelona;41;Vallès Oriental;08124;Mollet del Vallès;3;5;A;;689;160;300;404;285;1;3;400;403
8;Barcelona;41;Vallès Oriental;08124;Mollet del Vallès;3;5;B;;876;190;370;520;356;3;9;508;517
8;Barcelona;41;Vallès Oriental;08124;Mollet del Vallès;3;6;A;;417;91;166;195;222;1;5;189;194
8;Barcelona;41;Vallès Oriental;08124;Mollet del Vallès;3;6;B;;481;93;149;183;298;0;5;178;183
8;Barcelona;41;Vallès Oriental;08124;Mollet del Vallès;3;7;A;;395;65;122;161;234;0;4;157;161
8;Barcelona;41;Vallès Oriental;08124;Mollet del Vallès;3;7;B;;511;109;161;204;307;0;1;203;204
8;Barcelona;41;Vallès Oriental;08124;Mollet del Vallès;3;7;C;;576;106;185;244;332;1;7;236;243
8;Barcelona;41;Vallès Oriental;08124;Mollet del Vallès;3;8;U;;685;142;269;349;336;1;15;333;348
8;Barcelona;41;Vallès Oriental;08124;Mollet del Vallès;3;9;A;;334;101;144;173;161;0;0;173;173
8;Barcelona;41;Vallès Oriental;08124;Mollet del Vallès;3;9;B;;427;114;190;231;196;2;2;227;229
17;Girona;2;Alt Empordà;17106;Mollet de Peralada;1;1;U;;137;56;78;91;46;0;2;89;91
17;Girona;31;Ripollès;17107;Molló;1;1;U;;299;95;167;203;96;1;6;196;202
25;Lleida;35;Solsonès;25136;Molsosa, la;1;1;U;;111;53;76;102;9;2;1;99;100
8;Barcelona;;;08128;Monistrol de Calders;1;1;U;;563;132;293;357;206;1;8;348;356
8;Barcelona;7;Bages;08127;Monistrol de Montserrat;1;1;U;;677;197;321;406;271;0;7;399;406
8;Barcelona;7;Bages;08127;Monistrol de Montserrat;1;2;A;;745;41;277;367;378;0;11;356;367
8;Barcelona;7;Bages;08127;Monistrol de Montserrat;1;2;B;;816;182;312;427;389;3;9;415;424
17;Girona;19;Garrotxa;17109;Montagut i Oix;1;1;U;;710;198;335;416;294;1;15;400;415
43;Tarragona;16;Conca de Barberà;43086;Montblanc;1;1;U;;614;158;267;340;274;0;11;329;340
43;Tarragona;16;Conca de Barberà;43086;Montblanc;1;2;U;;569;115;229;307;262;2;5;300;305
43;Tarragona;16;Conca de Barberà;43086;Montblanc;2;1;A;;632;136;328;414;218;4;12;398;410
43;Tarragona;16;Conca de Barberà;43086;Montblanc;2;1;B;;730;187;362;468;262;1;5;462;467
43;Tarragona;16;Conca de Barberà;43086;Montblanc;2;2;A;;692;187;347;450;242;6;15;429;444
43;Tarragona;16;Conca de Barberà;43086;Montblanc;2;2;B;;862;222;392;491;371;2;16;473;489
43;Tarragona;16;Conca de Barberà;43086;Montblanc;2;3;A;;454;142;256;304;150;4;8;292;300
43;Tarragona;16;Conca de Barberà;43086;Montblanc;2;3;B;;591;148;297;373;218;4;5;364;369
43;Tarragona;8;Baix Camp;43088;Montbrió del Camp;1;1;A;;688;208;391;455;233;5;10;440;450
43;Tarragona;8;Baix Camp;43088;Montbrió del Camp;1;1;B;;719;204;399;483;236;2;8;473;481
8;Barcelona;40;Vallès Occidental;08125;Montcada i Reixac;1;1;U;;870;243;434;532;338;2;6;524;530
8;Barcelona;40;Vallès Occidental;08125;Montcada i Reixac;1;2;U;;1103;298;576;701;402;2;10;689;699
8;Barcelona;40;Vallès Occidental;08125;Montcada i Reixac;1;4;A;;586;165;266;312;274;0;2;310;312
8;Barcelona;40;Vallès Occidental;08125;Montcada i Reixac;1;4;B;;640;179;286;344;296;4;0;340;340
8;Barcelona;40;Vallès Occidental;08125;Montcada i Reixac;1;5;A;;544;146;239;297;247;0;10;287;297
8;Barcelona;40;Vallès Occidental;08125;Montcada i Reixac;1;5;B;;638;178;290;359;279;6;8;345;353
8;Barcelona;40;Vallès Occidental;08125;Montcada i Reixac;2;1;A;;562;112;184;228;334;2;4;222;226
8;Barcelona;40;Vallès Occidental;08125;Montcada i Reixac;2;1;B;;570;120;173;220;350;0;3;217;220
8;Barcelona;40;Vallès Occidental;08125;Montcada i Reixac;2;2;A;;843;195;358;456;387;1;16;439;455
8;Barcelona;40;Vallès Occidental;08125;Montcada i Reixac;2;2;B;;968;214;369;487;481;1;6;480;486
8;Barcelona;40;Vallès Occidental;08125;Montcada i Reixac;2;3;A;;802;205;376;476;326;2;12;462;474
8;Barcelona;40;Vallès Occidental;08125;Montcada i Reixac;2;3;B;;944;221;420;546;398;0;13;533;546
8;Barcelona;40;Vallès Occidental;08125;Montcada i Reixac;3;1;A;;768;207;350;423;345;0;4;419;423
8;Barcelona;40;Vallès Occidental;08125;Montcada i Reixac;3;1;B;;930;215;396;492;438;1;11;480;491
8;Barcelona;40;Vallès Occidental;08125;Montcada i Reixac;3;2;A;;695;145;254;334;361;0;9;325;334
8;Barcelona;40;Vallès Occidental;08125;Montcada i Reixac;3;2;B;;878;194;318;421;457;0;4;417;421
8;Barcelona;40;Vallès Occidental;08125;Montcada i Reixac;3;3;A;;858;186;358;457;401;0;12;445;457
8;Barcelona;40;Vallès Occidental;08125;Montcada i Reixac;3;3;B;;986;225;417;529;457;1;18;510;528
8;Barcelona;40;Vallès Occidental;08125;Montcada i Reixac;3;4;A;;682;106;227;344;338;1;7;336;343
8;Barcelona;40;Vallès Occidental;08125;Montcada i Reixac;3;4;B;;732;106;251;363;369;3;9;351;360
8;Barcelona;40;Vallès Occidental;08125;Montcada i Reixac;4;1;A;;1022;236;434;537;485;2;12;523;535
8;Barcelona;40;Vallès Occidental;08125;Montcada i Reixac;4;1;B;;1231;246;515;624;607;1;11;612;623
8;Barcelona;40;Vallès Occidental;08125;Montcada i Reixac;5;1;A;;762;148;244;310;452;1;5;304;309
8;Barcelona;40;Vallès Occidental;08125;Montcada i Reixac;5;1;B;;877;180;314;399;478;0;14;385;399
8;Barcelona;40;Vallès Occidental;08125;Montcada i Reixac;5;2;U;;1035;213;381;490;545;2;14;474;488
8;Barcelona;40;Vallès Occidental;08125;Montcada i Reixac;5;3;U;;1017;160;265;346;671;0;10;336;346
8;Barcelona;40;Vallès Occidental;08125;Montcada i Reixac;6;1;A;;1079;219;418;499;580;0;15;484;499
8;Barcelona;40;Vallès Occidental;08125;Montcada i Reixac;6;1;B;;1228;218;413;533;695;2;17;514;531
8;Barcelona;14;Berguedà;08130;Montclar;1;1;U;;94;29;50;63;31;0;1;62;63
25;Lleida;15;Cerdanya;25139;Montellà i Martinet;1;1;U;;493;165;232;308;185;3;12;293;305
8;Barcelona;24;Osona;08131;Montesquiu;1;1;U;;692;239;403;453;239;5;5;443;448
25;Lleida;4;Alt Urgell;25140;Montferrer i Castellbò;1;1;U;;733;177;361;426;307;1;8;417;425
43;Tarragona;1;Alt Camp;43089;Montferri;1;1;U;;203;46;90;109;94;1;1;107;108
25;Lleida;23;Noguera;25138;Montgai;1;1;A;;429;112;252;305;124;1;9;295;304
25;Lleida;23;Noguera;25138;Montgai;1;1;B;;220;57;126;145;75;1;3;141;144
8;Barcelona;21;Maresme;08126;Montgat;1;1;A;;630;135;279;350;280;1;6;343;349
8;Barcelona;21;Maresme;08126;Montgat;1;1;B;;637;136;270;357;280;0;5;352;357
8;Barcelona;21;Maresme;08126;Montgat;1;1;C;;737;131;293;408;329;3;4;401;405
8;Barcelona;21;Maresme;08126;Montgat;1;2;A;;561;131;242;291;270;2;7;282;289
8;Barcelona;21;Maresme;08126;Montgat;1;2;B;;655;150;273;350;305;1;3;346;349
8;Barcelona;21;Maresme;08126;Montgat;1;2;C;;726;193;317;382;344;3;5;374;379
8;Barcelona;21;Maresme;08126;Montgat;1;3;A;;679;189;314;398;281;0;8;390;398
8;Barcelona;21;Maresme;08126;Montgat;1;3;B;;735;192;334;419;316;1;6;412;418
8;Barcelona;21;Maresme;08126;Montgat;1;3;C;;825;246;398;482;343;0;13;469;482
8;Barcelona;21;Maresme;08126;Montgat;1;4;A;;655;134;256;357;298;0;7;350;357
8;Barcelona;21;Maresme;08126;Montgat;1;4;B;;780;166;320;403;377;0;0;403;403
8;Barcelona;14;Berguedà;08132;Montmajor;1;1;U;;400;114;217;266;134;0;4;262;266
8;Barcelona;6;Anoia;08133;Montmaneu;1;1;U;;178;78;102;118;60;1;4;113;117
43;Tarragona;12;Baix Penedès;43090;Montmell, el;1;1;A;;443;78;128;168;275;0;0;168;168
43;Tarragona;12;Baix Penedès;43090;Montmell, el;1;1;B;;540;110;173;224;316;3;5;216;221
8;Barcelona;41;Vallès Oriental;08135;Montmeló;1;1;A;;609;142;249;333;276;1;9;323;332
8;Barcelona;41;Vallès Oriental;08135;Montmeló;1;1;B;;764;148;318;416;348;2;7;407;414
8;Barcelona;41;Vallès Oriental;08135;Montmeló;1;1;C;;639;125;241;343;296;2;6;335;341
8;Barcelona;41;Vallès Oriental;08135;Montmeló;1;2;A;;540;135;228;307;233;0;5;302;307
8;Barcelona;41;Vallès Oriental;08135;Montmeló;1;2;B;;679;188;305;392;287;2;5;385;390
8;Barcelona;41;Vallès Oriental;08135;Montmeló;1;3;A;;727;192;344;431;296;4;8;419;427
8;Barcelona;41;Vallès Oriental;08135;Montmeló;1;3;B;;874;253;429;534;340;4;12;518;530
8;Barcelona;41;Vallès Oriental;08135;Montmeló;1;4;U;;927;214;409;508;419;1;12;495;507
8;Barcelona;41;Vallès Oriental;08135;Montmeló;1;5;U;;946;198;395;529;417;0;19;510;529
25;Lleida;33;Segrià;25142;Montoliu de Lleida;1;1;U;;420;97;228;280;140;1;5;274;279
25;Lleida;32;Segarra;25141;Montoliu de Segarra;1;1;U;;174;28;76;110;64;2;2;106;108
8;Barcelona;41;Vallès Oriental;08136;Montornès del Vallès;1;1;A;;666;114;234;310;356;0;12;298;310
8;Barcelona;41;Vallès Oriental;08136;Montornès del Vallès;1;1;B;;764;132;258;346;418;1;5;340;345
8;Barcelona;41;Vallès Oriental;08136;Montornès del Vallès;1;2;A;;397;79;158;203;194;2;7;194;201
8;Barcelona;41;Vallès Oriental;08136;Montornès del Vallès;1;2;B;;519;107;196;263;256;2;7;254;261
8;Barcelona;41;Vallès Oriental;08136;Montornès del Vallès;1;2;C;;412;78;151;196;216;0;3;193;196
8;Barcelona;41;Vallès Oriental;08136;Montornès del Vallès;1;3;A;;636;142;246;315;321;2;5;308;313
8;Barcelona;41;Vallès Oriental;08136;Montornès del Vallès;1;3;B;;772;142;300;387;385;0;11;376;387
8;Barcelona;41;Vallès Oriental;08136;Montornès del Vallès;1;3;C;;597;110;227;301;296;0;8;293;301
8;Barcelona;41;Vallès Oriental;08136;Montornès del Vallès;1;4;A;;576;126;233;289;287;2;8;279;287
8;Barcelona;41;Vallès Oriental;08136;Montornès del Vallès;1;4;B;;754;135;284;390;364;5;12;373;385
8;Barcelona;41;Vallès Oriental;08136;Montornès del Vallès;1;4;C;;623;135;284;336;287;1;8;327;335
8;Barcelona;41;Vallès Oriental;08136;Montornès del Vallès;1;5;A;;560;118;218;273;287;2;6;265;271
8;Barcelona;41;Vallès Oriental;08136;Montornès del Vallès;1;5;B;;633;135;236;299;334;0;13;286;299
8;Barcelona;41;Vallès Oriental;08136;Montornès del Vallès;1;5;C;;536;114;220;288;248;0;7;281;288
8;Barcelona;41;Vallès Oriental;08136;Montornès del Vallès;2;1;A;;282;54;78;100;182;1;5;94;99
8;Barcelona;41;Vallès Oriental;08136;Montornès del Vallès;2;1;B;;289;70;105;120;169;3;4;113;117
8;Barcelona;41;Vallès Oriental;08136;Montornès del Vallès;2;2;A;;310;71;113;144;166;0;3;141;144
8;Barcelona;41;Vallès Oriental;08136;Montornès del Vallès;2;2;B;;382;93;145;191;191;0;3;188;191
8;Barcelona;41;Vallès Oriental;08136;Montornès del Vallès;2;3;A;;351;81;129;153;198;1;1;151;152
8;Barcelona;41;Vallès Oriental;08136;Montornès del Vallès;2;3;B;;418;87;147;175;243;0;5;170;175
25;Lleida;32;Segarra;25143;Montornès de Segarra;1;1;U;;96;4;26;58;38;1;2;55;57
43;Tarragona;1;Alt Camp;43091;Mont-ral;1;1;U;;149;46;70;90;59;1;1;88;89
17;Girona;10;Baix Empordà;17110;Mont-ras;1;1;A;;675;181;320;382;293;3;8;371;379
17;Girona;10;Baix Empordà;17110;Mont-ras;1;1;B;;679;184;320;388;291;1;10;377;387
43;Tarragona;8;Baix Camp;43092;Mont-roig del Camp;1;1;A;;478;114;222;288;190;3;4;281;285
43;Tarragona;8;Baix Camp;43092;Mont-roig del Camp;1;1;B;;448;125;214;270;178;0;5;265;270
43;Tarragona;8;Baix Camp;43092;Mont-roig del Camp;1;2;U;;851;127;240;331;520;3;6;322;328
43;Tarragona;8;Baix Camp;43092;Mont-roig del Camp;1;3;A;;574;141;272;351;223;3;5;343;348
43;Tarragona;8;Baix Camp;43092;Mont-roig del Camp;1;3;B;;605;152;303;392;213;1;5;386;391
43;Tarragona;8;Baix Camp;43092;Mont-roig del Camp;1;4;A;;827;147;230;273;554;0;4;269;273
43;Tarragona;8;Baix Camp;43092;Mont-roig del Camp;1;4;B;;921;129;240;311;610;0;4;307;311
43;Tarragona;8;Baix Camp;43092;Mont-roig del Camp;1;5;A;;592;119;198;250;342;1;5;244;249
43;Tarragona;8;Baix Camp;43092;Mont-roig del Camp;1;5;B;;693;120;239;298;395;1;1;296;297
8;Barcelona;41;Vallès Oriental;08137;Montseny;1;1;U;;259;78;120;200;59;3;0;197;197
43;Tarragona;30;Ribera d'Ebre;43093;Móra d'Ebre;1;1;A;;646;159;302;411;235;1;7;403;410
43;Tarragona;30;Ribera d'Ebre;43093;Móra d'Ebre;1;1;B;;672;146;314;436;236;1;3;432;435
43;Tarragona;30;Ribera d'Ebre;43093;Móra d'Ebre;1;2;A;;667;141;283;426;241;0;7;419;426
43;Tarragona;30;Ribera d'Ebre;43093;Móra d'Ebre;1;2;B;;688;147;302;432;256;3;14;415;429
43;Tarragona;30;Ribera d'Ebre;43093;Móra d'Ebre;2;1;A;;581;120;250;344;237;2;8;334;342
43;Tarragona;30;Ribera d'Ebre;43093;Móra d'Ebre;2;1;B;;648;147;275;369;279;0;5;364;369
43;Tarragona;30;Ribera d'Ebre;43094;Móra la Nova;1;1;A;;585;147;267;375;210;1;2;372;374
43;Tarragona;30;Ribera d'Ebre;43094;Móra la Nova;1;1;B;;690;188;339;468;222;1;5;462;467
43;Tarragona;30;Ribera d'Ebre;43094;Móra la Nova;2;1;A;;402;111;207;279;123;1;2;276;278
43;Tarragona;30;Ribera d'Ebre;43094;Móra la Nova;2;1;B;;553;163;307;384;169;1;3;380;383
43;Tarragona;36;Tarragonès;43095;Morell, el;1;1;A;;476;104;187;255;221;1;6;248;254
43;Tarragona;36;Tarragonès;43095;Morell, el;1;1;B;;489;123;230;309;180;4;5;300;305
43;Tarragona;36;Tarragonès;43095;Morell, el;1;1;C;;572;147;265;327;245;0;7;320;327
43;Tarragona;36;Tarragonès;43095;Morell, el;1;1;D;;479;103;221;291;188;1;8;282;290
43;Tarragona;29;Priorat;43096;Morera de Montsant, la;1;1;U;;128;39;73;93;35;0;4;89;93
8;Barcelona;24;Osona;08129;Muntanyola;1;1;U;;358;120;187;238;120;0;11;227;238
8;Barcelona;7;Bages;08139;Mura;1;1;U;;198;54;103;150;48;0;4;146;150
25;Lleida;38;Urgell;25145;Nalec;1;1;U;;91;26;58;68;23;0;1;67;68
25;Lleida;39;Consell General d'Aran;25025;Naut Aran;1;1;A;;793;157;307;409;384;5;6;398;404
25;Lleida;39;Consell General d'Aran;25025;Naut Aran;1;1;B;;476;84;208;278;198;1;5;272;277
8;Barcelona;7;Bages;08140;Navarcles;1;1;A;;666;196;346;410;256;2;11;397;408
8;Barcelona;7;Bages;08140;Navarcles;1;1;B;;785;224;380;467;318;3;14;450;464
8;Barcelona;7;Bages;08140;Navarcles;1;2;A;;705;188;390;474;231;0;5;469;474
8;Barcelona;7;Bages;08140;Navarcles;1;2;B;;794;205;322;517;277;5;17;495;512
8;Barcelona;7;Bages;08140;Navarcles;1;3;A;;741;210;411;489;252;0;12;477;489
8;Barcelona;7;Bages;08140;Navarcles;1;3;B;;911;220;460;557;354;2;3;552;555
8;Barcelona;7;Bages;08141;Navàs;1;1;A;;439;132;240;295;144;1;3;291;294
8;Barcelona;7;Bages;08141;Navàs;1;1;B;;501;158;295;358;143;3;8;347;355
8;Barcelona;7;Bages;08141;Navàs;1;2;U;;657;212;373;454;203;1;3;450;453
8;Barcelona;7;Bages;08141;Navàs;1;3;A;;727;202;372;449;278;1;8;440;448
8;Barcelona;7;Bages;08141;Navàs;1;3;B;;898;229;411;505;393;3;4;498;502
8;Barcelona;7;Bages;08141;Navàs;1;4;A;;507;175;284;338;169;2;1;335;336
8;Barcelona;7;Bages;08141;Navàs;1;4;B;;625;208;352;429;196;2;8;419;427
8;Barcelona;7;Bages;08141;Navàs;2;1;U;;232;92;144;170;62;0;4;166;170
17;Girona;2;Alt Empordà;17111;Navata;1;1;U;;656;218;371;458;198;0;13;445;458
25;Lleida;35;Solsonès;25146;Navès;1;1;U;;229;62;131;165;64;3;2;160;162
8;Barcelona;14;Berguedà;08142;Nou de Berguedà, la;1;1;U;;115;24;76;89;26;1;3;85;88
43;Tarragona;36;Tarragonès;43097;Nou de Gaià, la;1;1;U;;330;96;177;224;106;1;4;219;223
43;Tarragona;1;Alt Camp;43098;Nulles;1;1;U;;326;89;172;219;107;3;3;213;216
25;Lleida;35;Solsonès;25148;Odèn;1;1;U;;245;54;114;164;81;0;0;164;164
8;Barcelona;6;Anoia;08143;Òdena;1;1;A;;227;86;142;163;64;0;9;154;163
8;Barcelona;6;Anoia;08143;Òdena;1;1;B;;614;112;281;347;267;1;7;339;346
8;Barcelona;6;Anoia;08143;Òdena;1;1;C;;716;151;337;409;307;0;6;403;409
8;Barcelona;6;Anoia;08143;Òdena;1;2;A;;394;77;158;205;189;0;3;202;205
8;Barcelona;6;Anoia;08143;Òdena;1;2;B;;479;100;197;246;233;1;4;241;245
17;Girona;31;Ripollès;17112;Ogassa;1;1;U;;227;57;118;152;75;0;2;150;152
8;Barcelona;3;Alt Penedès;08145;Olèrdola;1;1;A;;598;150;263;325;273;0;6;319;325
8;Barcelona;3;Alt Penedès;08145;Olèrdola;1;1;B;;751;198;343;440;311;0;8;432;440
8;Barcelona;3;Alt Penedès;08145;Olèrdola;1;2;A;;473;150;275;343;130;0;4;339;343
8;Barcelona;3;Alt Penedès;08145;Olèrdola;1;2;B;;551;178;317;379;172;1;8;370;378
8;Barcelona;3;Alt Penedès;08146;Olesa de Bonesvalls;1;1;A;;567;130;216;268;299;2;3;263;266
8;Barcelona;3;Alt Penedès;08146;Olesa de Bonesvalls;1;1;B;;610;166;265;348;262;2;6;340;346
8;Barcelona;11;Baix Llobregat;08147;Olesa de Montserrat;1;1;A;;606;130;224;292;314;0;0;292;292
8;Barcelona;11;Baix Llobregat;08147;Olesa de Montserrat;1;1;B;;602;133;228;285;317;2;1;282;283
8;Barcelona;11;Baix Llobregat;08147;Olesa de Montserrat;1;1;C;;778;170;290;375;403;7;2;366;368
8;Barcelona;11;Baix Llobregat;08147;Olesa de Montserrat;1;1;D;;619;130;233;303;316;0;5;298;303
8;Barcelona;11;Baix Llobregat;08147;Olesa de Montserrat;1;2;A;;869;232;380;484;385;1;10;473;483
8;Barcelona;11;Baix Llobregat;08147;Olesa de Montserrat;1;2;B;;979;230;425;547;432;6;17;524;541
8;Barcelona;11;Baix Llobregat;08147;Olesa de Montserrat;1;3;A;;452;139;243;296;156;1;4;291;295
8;Barcelona;11;Baix Llobregat;08147;Olesa de Montserrat;1;3;B;;450;136;250;296;154;1;3;292;295
8;Barcelona;11;Baix Llobregat;08147;Olesa de Montserrat;1;4;A;;572;161;282;377;195;2;4;371;375
8;Barcelona;11;Baix Llobregat;08147;Olesa de Montserrat;1;4;B;;569;142;256;330;239;0;7;323;330
8;Barcelona;11;Baix Llobregat;08147;Olesa de Montserrat;1;4;C;;528;127;244;319;209;4;10;305;315
8;Barcelona;11;Baix Llobregat;08147;Olesa de Montserrat;1;5;A;;812;185;364;469;343;5;16;448;464
8;Barcelona;11;Baix Llobregat;08147;Olesa de Montserrat;1;5;B;;976;192;401;522;454;0;10;512;522
8;Barcelona;11;Baix Llobregat;08147;Olesa de Montserrat;1;5;C;;811;142;306;439;372;1;12;426;438
8;Barcelona;11;Baix Llobregat;08147;Olesa de Montserrat;1;6;A;;788;171;319;397;391;5;3;389;392
8;Barcelona;11;Baix Llobregat;08147;Olesa de Montserrat;1;6;B;;907;212;328;441;466;2;6;433;439
8;Barcelona;11;Baix Llobregat;08147;Olesa de Montserrat;1;6;C;;820;172;319;425;395;2;9;414;423
8;Barcelona;11;Baix Llobregat;08147;Olesa de Montserrat;1;7;A;;638;142;274;343;295;4;5;334;339
8;Barcelona;11;Baix Llobregat;08147;Olesa de Montserrat;1;7;B;;827;174;345;441;386;8;6;427;433
8;Barcelona;11;Baix Llobregat;08147;Olesa de Montserrat;1;8;A;;516;136;257;331;185;2;1;328;329
8;Barcelona;11;Baix Llobregat;08147;Olesa de Montserrat;1;8;B;;578;141;241;326;252;0;5;321;326
8;Barcelona;11;Baix Llobregat;08147;Olesa de Montserrat;1;8;C;;541;155;253;323;218;2;3;318;321
8;Barcelona;11;Baix Llobregat;08147;Olesa de Montserrat;1;9;A;;644;148;292;364;280;2;0;362;362
8;Barcelona;11;Baix Llobregat;08147;Olesa de Montserrat;1;9;B;;682;147;269;357;325;1;7;349;356
25;Lleida;4;Alt Urgell;25149;Oliana;1;1;A;;686;249;461;515;171;4;4;507;511
25;Lleida;4;Alt Urgell;25149;Oliana;1;1;B;;814;286;521;603;211;5;9;589;598
25;Lleida;23;Noguera;25150;Oliola;1;1;U;;226;63;112;147;79;0;2;145;147
25;Lleida;35;Solsonès;25151;Olius;1;1;U;;560;150;309;378;182;2;9;367;376
8;Barcelona;17;Garraf;08148;Olivella;1;1;A;;793;154;281;342;451;0;3;339;342
8;Barcelona;17;Garraf;08148;Olivella;1;1;B;;775;165;268;325;450;3;3;319;322
8;Barcelona;17;Garraf;08148;Olivella;1;1;C;;195;49;81;99;96;0;5;94;99
8;Barcelona;24;Osona;08149;Olost;1;1;A;;435;100;272;310;125;2;6;302;308
8;Barcelona;24;Osona;08149;Olost;1;1;B;;557;173;358;425;132;1;3;421;424
17;Girona;19;Garrotxa;17114;Olot;1;1;A;;391;120;171;198;193;0;4;194;198
17;Girona;19;Garrotxa;17114;Olot;1;1;B;;328;94;137;161;167;2;3;156;159
17;Girona;19;Garrotxa;17114;Olot;1;1;C;;404;100;173;199;205;1;6;192;198
17;Girona;19;Garrotxa;17114;Olot;1;2;A;;370;125;182;213;157;2;3;208;211
17;Girona;19;Garrotxa;17114;Olot;1;2;B;;371;128;184;222;149;0;4;218;222
17;Girona;19;Garrotxa;17114;Olot;1;3;A;;389;117;204;252;137;0;1;251;252
17;Girona;19;Garrotxa;17114;Olot;1;3;B;;396;129;218;255;141;0;7;248;255
17;Girona;19;Garrotxa;17114;Olot;1;4;A;;342;115;189;231;111;1;6;224;230
17;Girona;19;Garrotxa;17114;Olot;1;4;B;;330;127;196;231;99;2;4;225;229
17;Girona;19;Garrotxa;17114;Olot;1;5;U;;594;238;342;415;179;3;8;404;412
17;Girona;19;Garrotxa;17114;Olot;1;6;U;;546;193;305;352;194;2;4;346;350
17;Girona;19;Garrotxa;17114;Olot;1;7;A;;563;189;302;350;213;0;16;334;350
17;Girona;19;Garrotxa;17114;Olot;1;7;B;;573;216;310;360;213;0;9;351;360
17;Girona;19;Garrotxa;17114;Olot;2;1;A;;536;158;282;331;205;2;6;323;329
17;Girona;19;Garrotxa;17114;Olot;2;1;B;;519;139;239;290;229;1;7;282;289
17;Girona;19;Garrotxa;17114;Olot;2;1;C;;604;192;307;366;238;5;7;354;361
17;Girona;19;Garrotxa;17114;Olot;2;2;A;;500;150;249;302;198;3;9;290;299
17;Girona;19;Garrotxa;17114;Olot;2;2;B;;500;140;232;286;214;2;14;270;284
17;Girona;19;Garrotxa;17114;Olot;2;2;C;;573;170;286;344;229;4;14;326;340
17;Girona;19;Garrotxa;17114;Olot;2;3;A;;483;145;237;275;208;2;2;271;273
17;Girona;19;Garrotxa;17114;Olot;2;3;B;;514;150;251;291;223;1;7;283;290
17;Girona;19;Garrotxa;17114;Olot;2;4;A;;465;122;221;253;212;1;11;241;252
17;Girona;19;Garrotxa;17114;Olot;2;4;B;;477;154;245;274;203;1;8;265;273
17;Girona;19;Garrotxa;17114;Olot;2;5;A;;483;131;234;268;215;2;4;262;266
17;Girona;19;Garrotxa;17114;Olot;2;5;B;;525;155;268;311;214;2;5;304;309
17;Girona;19;Garrotxa;17114;Olot;3;1;U;;609;151;277;333;276;2;15;316;331
17;Girona;19;Garrotxa;17114;Olot;3;2;A;;673;220;365;428;245;4;5;419;424
17;Girona;19;Garrotxa;17114;Olot;3;2;B;;650;208;370;441;209;1;9;431;440
17;Girona;19;Garrotxa;17114;Olot;3;3;A;;558;177;310;371;187;3;11;357;368
17;Girona;19;Garrotxa;17114;Olot;3;3;B;;540;152;269;337;203;2;9;326;335
17;Girona;19;Garrotxa;17114;Olot;3;3;C;;659;209;328;381;278;4;8;369;377
17;Girona;19;Garrotxa;17114;Olot;4;1;A;;500;130;217;270;230;3;9;258;267
17;Girona;19;Garrotxa;17114;Olot;4;1;B;;554;135;221;274;280;4;5;265;270
17;Girona;19;Garrotxa;17114;Olot;4;2;A;;478;156;247;294;184;1;8;285;293
17;Girona;19;Garrotxa;17114;Olot;4;2;B;;399;113;183;211;188;0;6;205;211
17;Girona;19;Garrotxa;17114;Olot;4;2;C;;443;140;223;264;179;2;5;257;262
17;Girona;19;Garrotxa;17114;Olot;5;1;A;;463;141;234;274;189;0;7;267;274
17;Girona;19;Garrotxa;17114;Olot;5;1;B;;487;155;248;285;202;0;10;275;285
17;Girona;19;Garrotxa;17114;Olot;5;2;A;;512;145;254;336;176;5;13;318;331
17;Girona;19;Garrotxa;17114;Olot;5;2;B;;505;135;264;322;183;0;9;313;322
17;Girona;19;Garrotxa;17114;Olot;5;3;A;;566;166;268;323;243;7;1;315;316
17;Girona;19;Garrotxa;17114;Olot;5;3;B;;502;126;231;300;202;2;13;285;298
17;Girona;19;Garrotxa;17114;Olot;5;3;C;;639;190;318;382;257;3;13;366;379
17;Girona;19;Garrotxa;17114;Olot;5;4;A;;589;193;337;403;186;3;17;383;400
17;Girona;19;Garrotxa;17114;Olot;5;4;B;;590;186;310;375;215;0;23;352;375
25;Lleida;32;Segarra;25152;Oluges, les;1;1;U;;159;54;91;103;56;0;4;99;103
8;Barcelona;14;Berguedà;08144;Olvan;1;1;A;;378;69;186;226;152;4;3;219;222
8;Barcelona;14;Berguedà;08144;Olvan;1;1;B;;393;121;210;260;133;6;6;248;254
25;Lleida;18;Garrigues;25153;Omellons, els;1;1;U;;216;38;126;153;63;3;1;149;150
25;Lleida;38;Urgell;25154;Omells de na Gaia, els;1;1;U;;126;26;59;73;53;0;2;71;73
17;Girona;2;Alt Empordà;17115;Ordis;1;1;U;;273;95;174;206;67;1;6;199;205
25;Lleida;4;Alt Urgell;25155;Organyà;1;1;U;;782;244;405;496;286;3;13;480;493
8;Barcelona;24;Osona;08150;Orís;1;1;U;;239;63;128;157;82;0;7;150;157
8;Barcelona;24;Osona;08151;Oristà;1;1;U;;515;142;294;354;161;5;14;335;349
8;Barcelona;6;Anoia;08152;Orpí;1;1;U;;144;35;85;108;36;0;0;108;108
8;Barcelona;21;Maresme;08153;Òrrius;1;1;U;;390;141;257;304;86;0;5;299;304
25;Lleida;23;Noguera;25156;Os de Balaguer;1;1;A;;378;113;218;269;109;1;6;262;268
25;Lleida;23;Noguera;25156;Os de Balaguer;1;1;B;;367;88;179;233;134;5;11;217;228
17;Girona;34;Selva;17116;Osor;1;1;U;;365;108;195;239;126;0;3;236;239
25;Lleida;38;Urgell;25157;Ossó de Sió;1;1;U;;201;57;114;142;59;0;3;139;142
8;Barcelona;3;Alt Penedès;08154;Pacs del Penedès;1;1;U;;628;222;362;452;176;2;5;445;450
8;Barcelona;21;Maresme;08155;Palafolls;1;1;A;;498;133;237;290;208;0;4;286;290
8;Barcelona;21;Maresme;08155;Palafolls;1;1;B;;626;145;286;350;276;1;5;344;349
8;Barcelona;21;Maresme;08155;Palafolls;1;1;C;;651;170;323;397;254;2;6;389;395
8;Barcelona;21;Maresme;08155;Palafolls;1;2;A;;598;140;265;331;267;1;3;327;330
8;Barcelona;21;Maresme;08155;Palafolls;1;2;B;;725;192;320;390;335;4;4;382;386
8;Barcelona;21;Maresme;08155;Palafolls;1;2;C;;668;144;253;324;344;1;11;312;323
8;Barcelona;21;Maresme;08155;Palafolls;1;2;D;;673;129;258;288;385;1;1;286;287
8;Barcelona;21;Maresme;08155;Palafolls;1;3;A;;676;145;251;294;382;0;6;288;294
8;Barcelona;21;Maresme;08155;Palafolls;1;3;B;;725;153;285;349;376;1;6;342;348
17;Girona;10;Baix Empordà;17117;Palafrugell;1;1;A;;510;152;226;284;226;0;5;279;284
17;Girona;10;Baix Empordà;17117;Palafrugell;1;1;B;;501;126;207;261;240;1;2;258;260
17;Girona;10;Baix Empordà;17117;Palafrugell;1;1;C;;500;150;240;303;197;3;1;299;300
17;Girona;10;Baix Empordà;17117;Palafrugell;1;2;A;;523;124;207;260;263;0;5;255;260
17;Girona;10;Baix Empordà;17117;Palafrugell;1;2;B;;527;126;238;279;248;2;4;273;277
17;Girona;10;Baix Empordà;17117;Palafrugell;1;3;A;;378;101;175;210;168;0;8;202;210
17;Girona;10;Baix Empordà;17117;Palafrugell;1;3;B;;367;101;151;182;185;5;1;176;177
17;Girona;10;Baix Empordà;17117;Palafrugell;1;3;C;;368;101;149;183;185;2;7;174;181
17;Girona;10;Baix Empordà;17117;Palafrugell;1;4;A;;614;147;257;324;290;2;5;317;322
17;Girona;10;Baix Empordà;17117;Palafrugell;1;4;B;;643;143;245;311;332;1;9;301;310
17;Girona;10;Baix Empordà;17117;Palafrugell;1;5;A;;474;127;214;259;215;0;6;253;259
17;Girona;10;Baix Empordà;17117;Palafrugell;1;5;B;;434;118;192;221;213;0;6;215;221
17;Girona;10;Baix Empordà;17117;Palafrugell;2;1;A;;529;151;240;281;248;6;3;272;275
17;Girona;10;Baix Empordà;17117;Palafrugell;2;1;B;;522;112;212;263;259;1;10;252;262
17;Girona;10;Baix Empordà;17117;Palafrugell;2;1;C;;550;163;244;291;259;1;5;285;290
17;Girona;10;Baix Empordà;17117;Palafrugell;2;2;A;;445;137;209;246;199;0;9;237;246
17;Girona;10;Baix Empordà;17117;Palafrugell;2;2;B;;449;132;209;227;222;2;6;219;225
17;Girona;10;Baix Empordà;17117;Palafrugell;2;2;C;;487;149;242;278;209;1;6;271;277
17;Girona;10;Baix Empordà;17117;Palafrugell;2;3;A;;899;205;315;389;510;2;4;383;387
17;Girona;10;Baix Empordà;17117;Palafrugell;2;3;B;;785;203;350;460;325;3;18;439;457
17;Girona;10;Baix Empordà;17117;Palafrugell;3;1;A;;551;142;224;268;283;1;7;260;267
17;Girona;10;Baix Empordà;17117;Palafrugell;3;1;B;;455;125;214;252;203;1;11;240;251
17;Girona;10;Baix Empordà;17117;Palafrugell;3;2;A;;665;181;324;383;282;2;9;372;381
17;Girona;10;Baix Empordà;17117;Palafrugell;3;2;B;;665;189;313;379;286;1;6;372;378
17;Girona;10;Baix Empordà;17117;Palafrugell;3;2;C;;249;76;130;145;104;2;2;141;143
17;Girona;10;Baix Empordà;17117;Palafrugell;3;3;A;;454;99;153;195;259;1;3;191;194
17;Girona;10;Baix Empordà;17117;Palafrugell;3;3;B;;445;72;152;193;252;0;0;193;193
17;Girona;10;Baix Empordà;17118;Palamós;1;1;A;;653;203;313;363;290;2;11;350;361
17;Girona;10;Baix Empordà;17118;Palamós;1;1;B;;633;216;335;382;251;1;11;370;381
17;Girona;10;Baix Empordà;17118;Palamós;1;2;A;;618;182;290;330;288;6;9;315;324
17;Girona;10;Baix Empordà;17118;Palamós;1;2;B;;627;193;312;362;265;4;2;356;358
17;Girona;10;Baix Empordà;17118;Palamós;1;3;A;;585;169;290;334;251;1;3;330;333
17;Girona;10;Baix Empordà;17118;Palamós;1;3;B;;613;153;270;319;294;1;8;310;318
17;Girona;10;Baix Empordà;17118;Palamós;1;4;U;;706;207;333;401;305;6;8;387;395
17;Girona;10;Baix Empordà;17118;Palamós;2;1;A;;459;160;232;273;186;0;5;268;273
17;Girona;10;Baix Empordà;17118;Palamós;2;1;B;;456;150;236;278;178;1;4;273;277
17;Girona;10;Baix Empordà;17118;Palamós;2;2;A;;530;160;247;294;236;6;6;282;288
17;Girona;10;Baix Empordà;17118;Palamós;2;2;B;;558;178;273;318;240;0;3;315;318
17;Girona;10;Baix Empordà;17118;Palamós;3;1;A;;404;82;150;210;194;0;2;208;210
17;Girona;10;Baix Empordà;17118;Palamós;3;1;B;;691;190;320;383;308;2;11;370;381
17;Girona;10;Baix Empordà;17118;Palamós;3;2;A;;522;127;198;252;270;2;4;246;250
17;Girona;10;Baix Empordà;17118;Palamós;3;2;B;;559;132;230;284;275;2;6;276;282
17;Girona;10;Baix Empordà;17118;Palamós;3;3;A;;760;245;370;428;332;5;9;414;423
17;Girona;10;Baix Empordà;17118;Palamós;3;3;B;;736;195;307;396;340;3;7;386;393
17;Girona;10;Baix Empordà;17118;Palamós;4;1;A;;646;145;269;319;327;3;0;316;316
17;Girona;10;Baix Empordà;17118;Palamós;4;1;B;;658;153;265;300;358;0;3;297;300
17;Girona;10;Baix Empordà;17118;Palamós;4;2;A;;453;107;185;230;223;0;6;224;230
17;Girona;10;Baix Empordà;17118;Palamós;4;2;B;;490;129;217;248;242;1;3;244;247
25;Lleida;27;Pla d'Urgell;25158;Palau d'Anglesola, el;1;1;A;;677;143;343;447;230;2;14;431;445
25;Lleida;27;Pla d'Urgell;25158;Palau d'Anglesola, el;1;1;B;;827;169;414;563;264;3;21;539;560
17;Girona;2;Alt Empordà;17119;Palau de Santa Eulàlia;1;1;U;;81;24;48;54;27;0;0;54;54
17;Girona;10;Baix Empordà;17121;Palau-sator;1;1;U;;246;73;127;163;83;1;4;158;162
17;Girona;2;Alt Empordà;17120;Palau-saverdera;1;1;U;;710;216;429;475;235;5;12;458;470
8;Barcelona;40;Vallès Occidental;08156;Palau-solità i Plegamans;1;1;A;;330;88;151;193;137;0;3;190;193
8;Barcelona;40;Vallès Occidental;08156;Palau-solità i Plegamans;1;1;B;;415;101;170;221;194;0;5;216;221
8;Barcelona;40;Vallès Occidental;08156;Palau-solità i Plegamans;1;1;C;;381;104;180;224;157;0;4;220;224
8;Barcelona;40;Vallès Occidental;08156;Palau-solità i Plegamans;1;2;A;;532;90;195;274;258;1;5;268;273
8;Barcelona;40;Vallès Occidental;08156;Palau-solità i Plegamans;1;2;B;;612;114;231;299;313;0;4;295;299
8;Barcelona;40;Vallès Occidental;08156;Palau-solità i Plegamans;1;2;C;;495;117;214;276;219;0;1;275;276
8;Barcelona;40;Vallès Occidental;08156;Palau-solità i Plegamans;1;3;A;;569;118;242;291;278;1;11;279;290
8;Barcelona;40;Vallès Occidental;08156;Palau-solità i Plegamans;1;3;B;;636;161;297;361;275;1;15;345;360
8;Barcelona;40;Vallès Occidental;08156;Palau-solità i Plegamans;1;4;A;;495;95;202;268;227;0;2;266;268
8;Barcelona;40;Vallès Occidental;08156;Palau-solità i Plegamans;1;4;B;;602;126;258;336;266;2;5;329;334
8;Barcelona;40;Vallès Occidental;08156;Palau-solità i Plegamans;1;4;C;;607;130;253;325;282;3;6;316;322
8;Barcelona;40;Vallès Occidental;08156;Palau-solità i Plegamans;1;5;U;;749;231;378;477;272;0;4;473;477
8;Barcelona;40;Vallès Occidental;08156;Palau-solità i Plegamans;1;6;A;;731;137;256;364;367;2;15;347;362
8;Barcelona;40;Vallès Occidental;08156;Palau-solità i Plegamans;1;6;B;;724;153;278;380;344;0;8;372;380
8;Barcelona;40;Vallès Occidental;08156;Palau-solità i Plegamans;1;7;A;;440;118;212;273;167;1;5;267;272
8;Barcelona;40;Vallès Occidental;08156;Palau-solità i Plegamans;1;7;B;;555;159;262;333;222;0;4;329;333
8;Barcelona;40;Vallès Occidental;08156;Palau-solità i Plegamans;1;8;A;;559;117;208;272;287;0;6;266;272
8;Barcelona;40;Vallès Occidental;08156;Palau-solità i Plegamans;1;8;B;;622;134;250;335;287;0;5;330;335
43;Tarragona;36;Tarragonès;43100;Pallaresos, els;1;1;A;;461;120;192;262;199;1;10;251;261
43;Tarragona;36;Tarragonès;43100;Pallaresos, els;1;1;B;;461;108;205;259;202;1;9;249;258
43;Tarragona;36;Tarragonès;43100;Pallaresos, els;1;2;A;;463;87;170;237;226;0;4;233;237
43;Tarragona;36;Tarragonès;43100;Pallaresos, els;1;2;B;;553;90;160;226;327;0;1;225;226
43;Tarragona;36;Tarragonès;43100;Pallaresos, els;1;2;C;;562;96;182;253;309;0;5;248;253
8;Barcelona;11;Baix Llobregat;08157;Pallejà;1;1;A;;488;107;215;284;204;2;5;277;282
8;Barcelona;11;Baix Llobregat;08157;Pallejà;1;1;B;;631;151;265;342;289;2;2;338;340
8;Barcelona;11;Baix Llobregat;08157;Pallejà;1;1;C;;521;101;207;278;243;1;3;274;277
8;Barcelona;11;Baix Llobregat;08157;Pallejà;1;2;A;;619;141;270;331;288;1;3;327;330
8;Barcelona;11;Baix Llobregat;08157;Pallejà;1;2;B;;824;181;322;417;407;1;4;412;416
8;Barcelona;11;Baix Llobregat;08157;Pallejà;1;2;C;;708;161;288;378;330;0;4;374;378
8;Barcelona;11;Baix Llobregat;08157;Pallejà;1;3;A;;752;191;337;436;316;3;7;426;433
8;Barcelona;11;Baix Llobregat;08157;Pallejà;1;3;B;;775;185;330;424;351;1;5;418;423
8;Barcelona;11;Baix Llobregat;08157;Pallejà;1;4;A;;564;150;273;336;228;0;5;331;336
8;Barcelona;11;Baix Llobregat;08157;Pallejà;1;4;B;;650;175;311;404;246;0;10;394;404
8;Barcelona;11;Baix Llobregat;08157;Pallejà;1;5;A;;683;165;319;425;258;0;10;415;425
8;Barcelona;11;Baix Llobregat;08157;Pallejà;1;5;B;;812;170;353;476;336;4;10;462;472
43;Tarragona;30;Ribera d'Ebre;43099;Palma d'Ebre, la;1;1;U;;343;96;295;266;77;0;2;264;266
8;Barcelona;11;Baix Llobregat;08905;Palma de Cervelló, la;1;1;A;;596;172;304;398;198;3;17;378;395
8;Barcelona;11;Baix Llobregat;08905;Palma de Cervelló, la;1;1;B;;596;159;286;390;206;2;12;376;388
8;Barcelona;11;Baix Llobregat;08905;Palma de Cervelló, la;1;2;A;;478;119;227;301;177;5;7;289;296
8;Barcelona;11;Baix Llobregat;08905;Palma de Cervelló, la;1;2;B;;588;129;292;395;193;3;7;385;392
17;Girona;28;Pla de l'Estany;17123;Palol de Revardit;1;1;U;;351;124;223;279;72;4;3;272;275
17;Girona;10;Baix Empordà;17124;Pals;1;1;A;;793;265;420;482;311;2;10;470;480
17;Girona;10;Baix Empordà;17124;Pals;1;1;B;;812;216;418;496;316;0;11;485;496
8;Barcelona;11;Baix Llobregat;08158;Papiol, el;1;1;A;;736;138;319;435;301;2;9;424;433
8;Barcelona;11;Baix Llobregat;08158;Papiol, el;1;1;B;;824;156;258;462;362;5;9;448;457
8;Barcelona;11;Baix Llobregat;08158;Papiol, el;1;2;A;;623;130;336;359;264;3;9;347;356
8;Barcelona;11;Baix Llobregat;08158;Papiol, el;1;2;B;;691;149;304;398;293;2;11;385;396
17;Girona;31;Ripollès;17125;Pardines;1;1;U;;131;26;72;93;38;0;2;91;93
8;Barcelona;41;Vallès Oriental;08159;Parets del Vallès;1;1;A;;516;126;244;292;224;1;7;284;291
8;Barcelona;41;Vallès Oriental;08159;Parets del Vallès;1;1;B;;589;143;280;335;254;0;10;325;335
8;Barcelona;41;Vallès Oriental;08159;Parets del Vallès;1;2;A;;628;147;287;354;274;0;7;347;354
8;Barcelona;41;Vallès Oriental;08159;Parets del Vallès;1;2;B;;786;190;381;473;313;3;8;462;470
8;Barcelona;41;Vallès Oriental;08159;Parets del Vallès;1;3;A;;404;105;198;250;154;0;4;246;250
8;Barcelona;41;Vallès Oriental;08159;Parets del Vallès;1;3;B;;502;139;235;284;218;3;6;275;281
8;Barcelona;41;Vallès Oriental;08159;Parets del Vallès;1;4;A;;364;89;151;214;150;0;3;211;214
8;Barcelona;41;Vallès Oriental;08159;Parets del Vallès;1;4;B;;438;104;187;237;201;0;3;234;237
8;Barcelona;41;Vallès Oriental;08159;Parets del Vallès;2;1;A;;451;102;168;218;233;0;0;218;218
8;Barcelona;41;Vallès Oriental;08159;Parets del Vallès;2;1;B;;515;98;212;265;250;1;7;257;264
8;Barcelona;41;Vallès Oriental;08159;Parets del Vallès;2;2;A;;412;70;149;199;213;0;5;194;199
8;Barcelona;41;Vallès Oriental;08159;Parets del Vallès;2;2;B;;455;105;192;239;216;1;5;233;238
8;Barcelona;41;Vallès Oriental;08159;Parets del Vallès;2;3;A;;735;151;269;359;376;2;11;346;357
8;Barcelona;41;Vallès Oriental;08159;Parets del Vallès;2;3;B;;862;170;316;416;446;1;10;405;415
8;Barcelona;41;Vallès Oriental;08159;Parets del Vallès;2;4;A;;541;118;243;302;239;2;3;297;300
8;Barcelona;41;Vallès Oriental;08159;Parets del Vallès;2;4;B;;674;130;264;350;324;1;8;341;349
8;Barcelona;41;Vallès Oriental;08159;Parets del Vallès;2;5;A;;464;100;205;247;217;0;2;245;247
8;Barcelona;41;Vallès Oriental;08159;Parets del Vallès;2;5;B;;521;109;235;285;236;0;4;281;285
8;Barcelona;41;Vallès Oriental;08159;Parets del Vallès;2;6;A;;605;96;213;285;320;2;7;276;283
8;Barcelona;41;Vallès Oriental;08159;Parets del Vallès;2;6;B;;758;137;277;374;384;0;6;368;374
8;Barcelona;41;Vallès Oriental;08159;Parets del Vallès;2;7;A;;556;110;221;296;260;1;5;290;295
8;Barcelona;41;Vallès Oriental;08159;Parets del Vallès;2;7;B;;699;161;288;384;315;1;10;373;383
17;Girona;10;Baix Empordà;17126;Parlavà;1;1;U;;307;117;164;223;84;4;3;216;219
43;Tarragona;16;Conca de Barberà;43101;Passanant i Belltall;1;1;U;;162;61;80;105;57;3;2;100;102
17;Girona;2;Alt Empordà;17128;Pau;1;1;U;;282;97;178;207;75;1;1;205;206
43;Tarragona;9;Baix Ebre;43102;Paüls;1;1;U;;527;114;336;419;108;3;5;411;416
17;Girona;2;Alt Empordà;17129;Pedret i Marzà;1;1;U;;112;40;58;72;40;0;3;69;72
25;Lleida;23;Noguera;25164;Penelles;1;1;U;;429;105;237;267;162;7;8;252;260
17;Girona;10;Baix Empordà;17130;Pera, la;1;1;U;;347;95;181;248;99;1;5;242;247
8;Barcelona;24;Osona;08160;Perafita;1;1;U;;307;119;195;229;78;6;8;215;223
43;Tarragona;36;Tarragonès;43103;Perafort;1;1;U;;721;178;337;430;291;3;5;422;427
17;Girona;2;Alt Empordà;17132;Peralada;1;1;A;;1011;334;622;688;323;2;12;674;686
17;Girona;2;Alt Empordà;17132;Peralada;1;1;B;;197;51;107;123;74;0;5;118;123
25;Lleida;4;Alt Urgell;25165;Peramola;1;1;U;;304;102;190;216;88;1;10;205;215
43;Tarragona;9;Baix Ebre;43104;Perelló, el;1;1;U;;630;211;339;426;204;4;5;417;422
43;Tarragona;9;Baix Ebre;43104;Perelló, el;1;2;A;;479;158;284;349;130;2;5;342;347
43;Tarragona;9;Baix Ebre;43104;Perelló, el;1;2;B;;648;183;361;459;189;5;11;443;454
8;Barcelona;6;Anoia;08161;Piera;1;1;U;;797;161;321;407;390;1;11;395;406
8;Barcelona;6;Anoia;08161;Piera;1;2;A;;948;209;422;505;443;5;7;493;500
8;Barcelona;6;Anoia;08161;Piera;1;2;B;;945;216;405;510;435;4;8;498;506
8;Barcelona;6;Anoia;08161;Piera;1;3;A;;811;205;369;458;353;6;7;445;452
8;Barcelona;6;Anoia;08161;Piera;1;3;B;;957;256;432;529;428;2;9;518;527
8;Barcelona;6;Anoia;08161;Piera;1;4;A;;381;94;189;237;144;1;6;230;236
8;Barcelona;6;Anoia;08161;Piera;1;4;B;;962;205;357;417;545;3;11;403;414
8;Barcelona;6;Anoia;08161;Piera;1;5;A;;847;197;315;384;463;1;2;381;383
8;Barcelona;6;Anoia;08161;Piera;1;5;B;;1084;236;398;512;572;4;8;500;508
8;Barcelona;6;Anoia;08161;Piera;1;6;U;;1677;295;522;641;1036;0;13;628;641
8;Barcelona;6;Anoia;08161;Piera;1;7;U;;567;139;219;272;295;2;3;267;270
43;Tarragona;16;Conca de Barberà;43105;Piles, les;1;1;U;;163;39;80;112;51;3;4;105;109
8;Barcelona;21;Maresme;08163;Pineda de Mar;1;1;A;;674;207;315;363;311;4;7;352;359
8;Barcelona;21;Maresme;08163;Pineda de Mar;1;1;B;;864;247;386;473;391;3;6;464;470
8;Barcelona;21;Maresme;08163;Pineda de Mar;1;10;A;;444;105;184;222;222;0;3;219;222
8;Barcelona;21;Maresme;08163;Pineda de Mar;1;10;B;;527;151;232;283;244;0;8;275;283
8;Barcelona;21;Maresme;08163;Pineda de Mar;1;11;A;;448;107;204;242;206;1;1;240;241
8;Barcelona;21;Maresme;08163;Pineda de Mar;1;11;B;;568;168;270;320;248;2;7;311;318
8;Barcelona;21;Maresme;08163;Pineda de Mar;1;12;A;;486;116;183;242;244;2;2;238;240
8;Barcelona;21;Maresme;08163;Pineda de Mar;1;12;B;;552;121;214;269;283;1;8;260;268
8;Barcelona;21;Maresme;08163;Pineda de Mar;1;13;A;;543;134;224;286;257;2;2;282;284
8;Barcelona;21;Maresme;08163;Pineda de Mar;1;13;B;;762;200;331;398;364;3;5;390;395
8;Barcelona;21;Maresme;08163;Pineda de Mar;1;2;A;;643;211;305;369;274;1;11;357;368
8;Barcelona;21;Maresme;08163;Pineda de Mar;1;2;B;;731;230;352;428;303;1;9;418;427
8;Barcelona;21;Maresme;08163;Pineda de Mar;1;3;A;;543;151;242;303;240;0;4;299;303
8;Barcelona;21;Maresme;08163;Pineda de Mar;1;3;B;;690;194;311;371;319;0;0;371;371
8;Barcelona;21;Maresme;08163;Pineda de Mar;1;4;A;;594;116;211;257;337;0;4;253;257
8;Barcelona;21;Maresme;08163;Pineda de Mar;1;4;B;;752;163;271;336;416;0;8;328;336
8;Barcelona;21;Maresme;08163;Pineda de Mar;1;4;C;;639;131;232;283;356;0;10;273;283
8;Barcelona;21;Maresme;08163;Pineda de Mar;1;5;A;;702;189;321;361;341;6;2;353;355
8;Barcelona;21;Maresme;08163;Pineda de Mar;1;5;B;;937;204;356;426;511;1;5;420;425
8;Barcelona;21;Maresme;08163;Pineda de Mar;1;5;C;;843;293;347;407;436;4;7;396;403
8;Barcelona;21;Maresme;08163;Pineda de Mar;1;6;A;;467;135;201;234;233;1;3;230;233
8;Barcelona;21;Maresme;08163;Pineda de Mar;1;6;B;;523;174;255;291;232;1;8;282;290
8;Barcelona;21;Maresme;08163;Pineda de Mar;1;7;A;;690;161;289;383;307;4;15;364;379
8;Barcelona;21;Maresme;08163;Pineda de Mar;1;7;B;;837;231;380;469;368;0;10;459;469
8;Barcelona;21;Maresme;08163;Pineda de Mar;1;8;A;;438;105;177;221;217;1;3;217;220
8;Barcelona;21;Maresme;08163;Pineda de Mar;1;8;B;;552;130;218;284;268;1;2;281;283
8;Barcelona;21;Maresme;08163;Pineda de Mar;1;9;A;;731;181;299;365;366;2;6;357;363
8;Barcelona;21;Maresme;08163;Pineda de Mar;1;9;B;;694;191;298;355;339;1;7;347;354
43;Tarragona;37;Terra Alta;43106;Pinell de Brai, el;1;1;U;;900;194;454;636;264;5;5;626;631
25;Lleida;35;Solsonès;25166;Pinell de Solsonès;1;1;U;;178;69;117;144;34;2;5;137;142
25;Lleida;35;Solsonès;25167;Pinós;1;1;U;;274;78;138;199;75;2;7;190;197
43;Tarragona;16;Conca de Barberà;43107;Pira;1;1;U;;367;75;195;241;126;2;6;233;239
8;Barcelona;3;Alt Penedès;08164;Pla del Penedès, el;1;1;U;;707;184;383;489;218;7;5;477;482
43;Tarragona;1;Alt Camp;43108;Pla de Santa Maria, el;1;1;A;;587;152;288;391;196;4;3;384;387
43;Tarragona;1;Alt Camp;43108;Pla de Santa Maria, el;1;1;B;;429;93;189;257;172;0;6;251;257
43;Tarragona;1;Alt Camp;43108;Pla de Santa Maria, el;1;1;C;;554;100;232;335;219;4;9;322;331
17;Girona;19;Garrotxa;17133;Planes d'Hostoles, les;1;1;A;;712;251;418;501;211;3;15;483;498
17;Girona;19;Garrotxa;17133;Planes d'Hostoles, les;1;1;B;;726;235;423;501;225;13;5;483;488
17;Girona;31;Ripollès;17134;Planoles;1;1;U;;236;75;107;150;86;2;4;144;148
25;Lleida;32;Segarra;25911;Plans de Sió, els;1;1;U;;501;121;280;343;158;4;8;331;339
25;Lleida;27;Pla d'Urgell;25168;Poal, el;1;1;U;;516;166;320;392;124;1;9;382;391
25;Lleida;18;Garrigues;25169;Pobla de Cérvoles, la;1;1;U;;206;53;103;139;67;1;6;132;138
8;Barcelona;6;Anoia;08165;Pobla de Claramunt, la;1;1;A;;723;200;355;431;292;3;5;423;428
8;Barcelona;6;Anoia;08165;Pobla de Claramunt, la;1;1;B;;861;250;443;553;308;4;7;542;549
8;Barcelona;14;Berguedà;08166;Pobla de Lillet, la;1;1;U;;373;102;194;238;135;1;4;233;237
8;Barcelona;14;Berguedà;08166;Pobla de Lillet, la;1;2;A;;442;111;227;277;165;1;3;273;276
8;Barcelona;14;Berguedà;08166;Pobla de Lillet, la;1;2;B;;388;133;228;260;128;1;2;257;259
43;Tarragona;36;Tarragonès;43109;Pobla de Mafumet, la;1;1;A;;554;172;247;314;240;4;5;305;310
43;Tarragona;36;Tarragonès;43109;Pobla de Mafumet, la;1;1;B;;629;145;307;361;268;0;7;354;361
43;Tarragona;37;Terra Alta;43110;Pobla de Massaluca, la;1;1;U;;341;61;165;207;134;1;1;205;206
43;Tarragona;36;Tarragonès;43111;Pobla de Montornès, la;1;1;A;;859;202;332;404;455;5;5;394;399
43;Tarragona;36;Tarragonès;43111;Pobla de Montornès, la;1;1;B;;998;235;361;449;549;1;3;445;448
25;Lleida;25;Pallars Jussà;25171;Pobla de Segur, la;1;1;A;;514;150;252;325;189;9;9;307;316
25;Lleida;25;Pallars Jussà;25171;Pobla de Segur, la;1;1;B;;600;176;304;387;213;1;14;372;386
25;Lleida;25;Pallars Jussà;25171;Pobla de Segur, la;1;2;A;;632;209;353;437;195;4;7;426;433
25;Lleida;25;Pallars Jussà;25171;Pobla de Segur, la;1;2;B;;638;201;345;434;204;1;18;415;433
43;Tarragona;29;Priorat;43112;Poboleda;1;1;U;;290;77;140;195;95;0;8;187;195
8;Barcelona;40;Vallès Occidental;08167;Polinyà;1;1;A;;548;94;176;242;306;0;6;236;242
8;Barcelona;40;Vallès Occidental;08167;Polinyà;1;1;B;;529;101;186;247;282;1;6;240;246
8;Barcelona;40;Vallès Occidental;08167;Polinyà;1;1;C;;713;128;274;349;364;1;7;341;348
8;Barcelona;40;Vallès Occidental;08167;Polinyà;1;1;D;;609;145;253;325;284;3;5;317;322
8;Barcelona;40;Vallès Occidental;08167;Polinyà;1;2;A;;332;55;108;128;204;0;3;125;128
8;Barcelona;40;Vallès Occidental;08167;Polinyà;1;2;B;;383;78;133;165;218;0;3;162;165
8;Barcelona;40;Vallès Occidental;08167;Polinyà;1;2;C;;464;65;150;186;278;1;3;182;185
8;Barcelona;40;Vallès Occidental;08167;Polinyà;1;3;A;;500;91;166;235;265;0;3;232;235
8;Barcelona;40;Vallès Occidental;08167;Polinyà;1;3;B;;519;105;193;279;240;0;2;277;279
8;Barcelona;40;Vallès Occidental;08167;Polinyà;1;3;C;;567;113;211;279;288;0;4;275;279
43;Tarragona;1;Alt Camp;43113;Pont d'Armentera, el;1;1;U;;477;149;284;321;156;4;9;308;317
25;Lleida;4;Alt Urgell;25030;Pont de Bar, el;1;1;U;;156;43;83;102;54;0;1;101;102
17;Girona;2;Alt Empordà;17135;Pont de Molins;1;1;U;;361;95;203;237;124;3;2;232;234
25;Lleida;5;Alta Ribagorça;25173;Pont de Suert, el;1;1;A;;539;149;254;321;218;1;6;314;320
25;Lleida;5;Alta Ribagorça;25173;Pont de Suert, el;1;1;B;;608;190;292;366;242;3;4;359;363
25;Lleida;5;Alta Ribagorça;25173;Pont de Suert, el;1;2;U;;646;203;340;369;277;0;5;364;369
8;Barcelona;7;Bages;08182;Pont de Vilomara i Rocafort, el;1;1;A;;697;159;277;358;339;1;5;352;357
8;Barcelona;7;Bages;08182;Pont de Vilomara i Rocafort, el;1;1;B;;951;191;364;457;494;2;14;441;455
8;Barcelona;7;Bages;08182;Pont de Vilomara i Rocafort, el;1;1;C;;910;218;395;498;412;0;22;476;498
43;Tarragona;16;Conca de Barberà;43141;Pontils;1;1;U;;123;27;53;85;38;0;0;85;85
8;Barcelona;3;Alt Penedès;08168;Pontons;1;1;U;;405;102;201;241;164;11;4;226;230
17;Girona;2;Alt Empordà;17136;Pontós;1;1;U;;185;62;114;131;54;1;2;128;130
25;Lleida;23;Noguera;25172;Ponts;1;1;U;;843;292;474;560;283;6;13;541;554
25;Lleida;23;Noguera;25172;Ponts;1;2;A;;548;174;322;380;168;2;13;365;378
25;Lleida;23;Noguera;25172;Ponts;1;2;B;;590;180;338;403;187;5;10;388;398
17;Girona;28;Pla de l'Estany;17137;Porqueres;1;1;U;;582;137;294;350;232;0;16;334;350
17;Girona;28;Pla de l'Estany;17137;Porqueres;1;2;A;;764;218;428;524;240;4;11;509;520
17;Girona;28;Pla de l'Estany;17137;Porqueres;1;2;B;;832;275;448;541;291;1;10;530;540
17;Girona;28;Pla de l'Estany;17137;Porqueres;1;3;A;;543;163;307;369;174;2;7;360;367
17;Girona;28;Pla de l'Estany;17137;Porqueres;1;3;B;;554;157;306;359;195;1;6;352;358
43;Tarragona;29;Priorat;43114;Porrera;1;1;U;;403;96;192;249;154;0;1;248;249
17;Girona;2;Alt Empordà;17138;Portbou;1;1;A;;556;205;312;355;201;2;3;350;353
17;Girona;2;Alt Empordà;17138;Portbou;1;1;B;;546;201;308;341;205;6;1;334;335
17;Girona;2;Alt Empordà;17140;Port de la Selva, el;1;1;U;;670;231;364;454;216;1;10;443;453
25;Lleida;33;Segrià;25174;Portella, la;1;1;U;;478;136;279;319;159;1;5;313;318
43;Tarragona;29;Priorat;43115;Pradell de la Teixeta;1;1;U;;158;35;83;106;52;1;0;105;105
43;Tarragona;8;Baix Camp;43116;Prades;1;1;U;;520;132;266;340;180;2;2;336;338
43;Tarragona;37;Terra Alta;43117;Prat de Comte;1;1;U;;172;44;107;128;44;1;1;126;127
8;Barcelona;11;Baix Llobregat;08169;Prat de Llobregat, el;1;1;A;;578;145;252;349;229;2;4;343;347
8;Barcelona;11;Baix Llobregat;08169;Prat de Llobregat, el;1;1;B;;765;170;312;423;342;3;6;414;420
8;Barcelona;11;Baix Llobregat;08169;Prat de Llobregat, el;1;2;A;;648;204;324;399;249;1;9;389;398
8;Barcelona;11;Baix Llobregat;08169;Prat de Llobregat, el;1;2;B;;723;232;360;447;276;4;9;434;443
8;Barcelona;11;Baix Llobregat;08169;Prat de Llobregat, el;1;3;A;;435;111;209;269;166;3;4;262;266
8;Barcelona;11;Baix Llobregat;08169;Prat de Llobregat, el;1;3;B;;540;141;256;329;211;1;6;322;328
8;Barcelona;11;Baix Llobregat;08169;Prat de Llobregat, el;1;4;A;;666;194;313;366;300;2;10;354;364
8;Barcelona;11;Baix Llobregat;08169;Prat de Llobregat, el;1;4;B;;727;196;314;376;351;3;6;367;373
8;Barcelona;11;Baix Llobregat;08169;Prat de Llobregat, el;1;5;A;;543;154;239;297;246;1;8;288;296
8;Barcelona;11;Baix Llobregat;08169;Prat de Llobregat, el;1;5;B;;632;132;224;279;353;0;8;271;279
8;Barcelona;11;Baix Llobregat;08169;Prat de Llobregat, el;2;1;A;;612;175;294;361;251;0;11;350;361
8;Barcelona;11;Baix Llobregat;08169;Prat de Llobregat, el;2;1;B;;726;206;344;420;306;2;7;411;418
8;Barcelona;11;Baix Llobregat;08169;Prat de Llobregat, el;2;2;A;;693;187;307;383;310;0;9;374;383
8;Barcelona;11;Baix Llobregat;08169;Prat de Llobregat, el;2;2;B;;827;205;352;434;393;2;6;426;432
8;Barcelona;11;Baix Llobregat;08169;Prat de Llobregat, el;2;3;A;;430;97;176;218;212;0;2;216;218
8;Barcelona;11;Baix Llobregat;08169;Prat de Llobregat, el;2;3;B;;502;123;209;241;261;1;4;236;240
8;Barcelona;11;Baix Llobregat;08169;Prat de Llobregat, el;2;4;A;;643;142;234;302;341;1;3;298;301
8;Barcelona;11;Baix Llobregat;08169;Prat de Llobregat, el;2;4;B;;741;163;283;370;371;2;4;364;368
8;Barcelona;11;Baix Llobregat;08169;Prat de Llobregat, el;2;5;A;;649;143;265;330;319;5;7;318;325
8;Barcelona;11;Baix Llobregat;08169;Prat de Llobregat, el;2;5;B;;668;156;291;346;322;1;8;337;345
8;Barcelona;11;Baix Llobregat;08169;Prat de Llobregat, el;2;6;A;;845;210;375;496;349;2;18;476;494
8;Barcelona;11;Baix Llobregat;08169;Prat de Llobregat, el;2;6;B;;873;250;405;518;355;2;17;499;516
8;Barcelona;11;Baix Llobregat;08169;Prat de Llobregat, el;2;7;A;;735;185;312;394;341;3;7;384;391
8;Barcelona;11;Baix Llobregat;08169;Prat de Llobregat, el;2;7;B;;692;164;305;402;290;5;9;388;397
8;Barcelona;11;Baix Llobregat;08169;Prat de Llobregat, el;3;1;A;;520;139;234;309;211;0;8;301;309
8;Barcelona;11;Baix Llobregat;08169;Prat de Llobregat, el;3;1;B;;623;176;294;380;243;0;10;370;380
8;Barcelona;11;Baix Llobregat;08169;Prat de Llobregat, el;3;10;A;;692;111;209;287;405;1;8;278;286
8;Barcelona;11;Baix Llobregat;08169;Prat de Llobregat, el;3;10;B;;668;121;221;282;386;2;8;272;280
8;Barcelona;11;Baix Llobregat;08169;Prat de Llobregat, el;3;11;U;;914;169;289;416;498;2;19;395;414
8;Barcelona;11;Baix Llobregat;08169;Prat de Llobregat, el;3;12;U;;497;127;194;264;233;0;6;258;264
8;Barcelona;11;Baix Llobregat;08169;Prat de Llobregat, el;3;13;U;;559;113;209;269;290;2;2;265;267
8;Barcelona;11;Baix Llobregat;08169;Prat de Llobregat, el;3;2;U;;795;140;270;356;439;4;9;343;352
8;Barcelona;11;Baix Llobregat;08169;Prat de Llobregat, el;3;3;A;;625;124;237;316;309;1;10;305;315
8;Barcelona;11;Baix Llobregat;08169;Prat de Llobregat, el;3;3;B;;666;141;229;301;365;2;11;288;299
8;Barcelona;11;Baix Llobregat;08169;Prat de Llobregat, el;3;4;A;;500;129;205;263;237;0;7;256;263
8;Barcelona;11;Baix Llobregat;08169;Prat de Llobregat, el;3;4;B;;646;140;255;329;317;0;7;322;329
8;Barcelona;11;Baix Llobregat;08169;Prat de Llobregat, el;3;5;A;;799;209;359;446;353;1;10;435;445
8;Barcelona;11;Baix Llobregat;08169;Prat de Llobregat, el;3;5;B;;857;213;368;465;392;1;4;460;464
8;Barcelona;11;Baix Llobregat;08169;Prat de Llobregat, el;3;6;A;;506;98;170;242;264;1;5;236;241
8;Barcelona;11;Baix Llobregat;08169;Prat de Llobregat, el;3;6;B;;619;151;237;298;321;3;9;286;295
8;Barcelona;11;Baix Llobregat;08169;Prat de Llobregat, el;3;7;A;;739;165;314;383;356;1;7;375;382
8;Barcelona;11;Baix Llobregat;08169;Prat de Llobregat, el;3;7;B;;863;178;308;411;452;0;4;407;411
8;Barcelona;11;Baix Llobregat;08169;Prat de Llobregat, el;3;8;A;;763;162;286;366;397;1;9;356;365
8;Barcelona;11;Baix Llobregat;08169;Prat de Llobregat, el;3;8;B;;943;179;326;398;545;2;3;393;396
8;Barcelona;11;Baix Llobregat;08169;Prat de Llobregat, el;3;9;A;;867;174;310;402;465;0;11;391;402
8;Barcelona;11;Baix Llobregat;08169;Prat de Llobregat, el;3;9;B;;897;169;293;390;507;2;8;380;388
8;Barcelona;11;Baix Llobregat;08169;Prat de Llobregat, el;4;1;U;;847;199;337;405;442;6;6;393;399
8;Barcelona;11;Baix Llobregat;08169;Prat de Llobregat, el;4;2;A;;627;97;172;216;411;0;0;216;216
8;Barcelona;11;Baix Llobregat;08169;Prat de Llobregat, el;4;2;B;;701;117;186;226;475;1;4;221;225
8;Barcelona;11;Baix Llobregat;08169;Prat de Llobregat, el;4;3;A;;478;84;144;183;295;0;2;181;183
8;Barcelona;11;Baix Llobregat;08169;Prat de Llobregat, el;4;3;B;;601;109;190;235;366;5;1;229;230
8;Barcelona;11;Baix Llobregat;08169;Prat de Llobregat, el;4;4;U;;992;148;264;310;682;3;6;301;307
8;Barcelona;11;Baix Llobregat;08169;Prat de Llobregat, el;4;5;A;;481;87;119;152;329;0;4;148;152
8;Barcelona;11;Baix Llobregat;08169;Prat de Llobregat, el;4;5;B;;546;114;163;203;343;0;3;200;203
8;Barcelona;11;Baix Llobregat;08169;Prat de Llobregat, el;4;6;U;;836;44;69;89;747;0;1;88;89
8;Barcelona;11;Baix Llobregat;08169;Prat de Llobregat, el;5;1;A;;486;124;213;276;210;1;6;269;275
8;Barcelona;11;Baix Llobregat;08169;Prat de Llobregat, el;5;1;B;;532;154;229;288;244;0;11;277;288
8;Barcelona;11;Baix Llobregat;08169;Prat de Llobregat, el;5;2;A;;524;95;179;239;285;1;6;232;238
8;Barcelona;11;Baix Llobregat;08169;Prat de Llobregat, el;5;2;B;;537;101;215;279;258;1;7;271;278
8;Barcelona;11;Baix Llobregat;08169;Prat de Llobregat, el;5;3;A;;454;81;145;190;264;1;2;187;189
8;Barcelona;11;Baix Llobregat;08169;Prat de Llobregat, el;5;3;B;;505;105;180;229;276;0;3;226;229
8;Barcelona;11;Baix Llobregat;08169;Prat de Llobregat, el;5;4;A;;622;139;268;348;274;1;6;341;347
8;Barcelona;11;Baix Llobregat;08169;Prat de Llobregat, el;5;4;B;;696;140;272;364;332;1;5;358;363
8;Barcelona;11;Baix Llobregat;08169;Prat de Llobregat, el;5;5;A;;683;145;255;318;365;0;6;312;318
8;Barcelona;11;Baix Llobregat;08169;Prat de Llobregat, el;5;5;B;;762;164;267;343;419;1;6;336;342
8;Barcelona;11;Baix Llobregat;08169;Prat de Llobregat, el;5;6;A;;764;166;280;358;406;1;11;346;357
8;Barcelona;11;Baix Llobregat;08169;Prat de Llobregat, el;5;6;B;;844;169;307;409;435;1;7;401;408
8;Barcelona;11;Baix Llobregat;08169;Prat de Llobregat, el;5;7;A;;761;151;264;356;405;4;8;344;352
8;Barcelona;11;Baix Llobregat;08169;Prat de Llobregat, el;5;7;B;;858;178;307;401;457;2;5;394;399
8;Barcelona;11;Baix Llobregat;08169;Prat de Llobregat, el;5;8;A;;563;123;194;289;274;4;5;280;285
8;Barcelona;11;Baix Llobregat;08169;Prat de Llobregat, el;5;8;B;;721;131;251;352;369;2;6;344;350
8;Barcelona;11;Baix Llobregat;08169;Prat de Llobregat, el;5;8;C;;679;169;268;370;309;0;7;363;370
43;Tarragona;8;Baix Camp;43118;Pratdip;1;1;U;;447;154;273;320;127;1;4;315;319
8;Barcelona;24;Osona;08171;Prats de Lluçanès;1;1;A;;512;141;283;322;190;0;8;314;322
8;Barcelona;24;Osona;08171;Prats de Lluçanès;1;1;B;;536;122;272;329;207;2;4;323;327
8;Barcelona;24;Osona;08171;Prats de Lluçanès;1;2;A;;521;159;307;353;168;0;4;349;353
8;Barcelona;24;Osona;08171;Prats de Lluçanès;1;2;B;;590;198;343;403;187;1;13;389;402
8;Barcelona;6;Anoia;08170;Prats de Rei, els;1;1;U;;473;150;279;313;160;1;13;299;312
25;Lleida;15;Cerdanya;25175;Prats i Sansor;1;1;U;;176;43;102;111;65;1;0;110;110
25;Lleida;38;Urgell;25176;Preixana;1;1;U;;359;98;197;248;111;0;5;243;248
25;Lleida;23;Noguera;25177;Preixens;1;1;U;;425;148;232;268;157;5;4;259;263
8;Barcelona;21;Maresme;08230;Premià de Dalt;1;1;A;;700;176;359;464;236;4;8;452;460
8;Barcelona;21;Maresme;08230;Premià de Dalt;1;1;B;;787;241;451;564;223;4;7;553;560
8;Barcelona;21;Maresme;08230;Premià de Dalt;1;2;A;;675;206;349;435;240;1;10;424;434
8;Barcelona;21;Maresme;08230;Premià de Dalt;1;2;B;;850;221;422;513;337;6;3;504;507
8;Barcelona;21;Maresme;08230;Premià de Dalt;1;3;A;;503;92;178;220;283;0;2;218;220
8;Barcelona;21;Maresme;08230;Premià de Dalt;1;3;B;;623;139;244;298;325;2;5;291;296
8;Barcelona;21;Maresme;08230;Premià de Dalt;1;4;A;;661;155;320;438;223;0;8;430;438
8;Barcelona;21;Maresme;08230;Premià de Dalt;1;4;B;;656;172;337;435;221;0;12;423;435
8;Barcelona;21;Maresme;08230;Premià de Dalt;1;5;U;;717;138;272;344;373;1;2;341;343
8;Barcelona;21;Maresme;08230;Premià de Dalt;1;6;A;;542;140;286;370;172;2;10;358;368
8;Barcelona;21;Maresme;08230;Premià de Dalt;1;6;B;;649;170;339;426;223;1;10;415;425
8;Barcelona;21;Maresme;08172;Premià de Mar;1;1;A;;927;284;463;577;350;1;15;561;576
8;Barcelona;21;Maresme;08172;Premià de Mar;1;1;B;;910;250;431;560;350;0;13;547;560
8;Barcelona;21;Maresme;08172;Premià de Mar;1;2;A;;793;249;432;517;276;1;8;508;516
8;Barcelona;21;Maresme;08172;Premià de Mar;1;2;B;;878;260;472;574;304;1;16;557;573
8;Barcelona;21;Maresme;08172;Premià de Mar;1;3;A;;841;259;431;503;338;4;8;491;499
8;Barcelona;21;Maresme;08172;Premià de Mar;1;3;B;;952;312;478;578;374;0;12;566;578
8;Barcelona;21;Maresme;08172;Premià de Mar;2;1;A;;670;224;353;425;245;0;6;419;425
8;Barcelona;21;Maresme;08172;Premià de Mar;2;1;B;;806;251;411;515;291;3;11;501;512
8;Barcelona;21;Maresme;08172;Premià de Mar;2;2;A;;459;121;204;241;218;1;1;239;240
8;Barcelona;21;Maresme;08172;Premià de Mar;2;2;B;;558;132;231;300;258;1;2;297;299
8;Barcelona;21;Maresme;08172;Premià de Mar;2;2;C;;582;152;250;306;276;1;7;298;305
8;Barcelona;21;Maresme;08172;Premià de Mar;2;3;A;;597;161;259;303;294;1;4;298;302
8;Barcelona;21;Maresme;08172;Premià de Mar;2;3;B;;716;194;322;388;328;2;6;380;386
8;Barcelona;21;Maresme;08172;Premià de Mar;2;4;A;;551;108;203;263;288;0;3;260;263
8;Barcelona;21;Maresme;08172;Premià de Mar;2;4;B;;624;143;258;315;309;0;6;309;315
8;Barcelona;21;Maresme;08172;Premià de Mar;3;1;A;;515;146;253;328;187;4;10;314;324
8;Barcelona;21;Maresme;08172;Premià de Mar;3;1;B;;610;177;294;372;238;2;11;359;370
8;Barcelona;21;Maresme;08172;Premià de Mar;3;2;A;;506;129;214;271;235;1;6;264;270
8;Barcelona;21;Maresme;08172;Premià de Mar;3;2;B;;520;127;222;279;241;0;7;272;279
8;Barcelona;21;Maresme;08172;Premià de Mar;3;3;A;;485;144;229;280;205;6;1;273;274
8;Barcelona;21;Maresme;08172;Premià de Mar;3;3;B;;518;145;257;298;220;1;4;293;297
8;Barcelona;21;Maresme;08172;Premià de Mar;3;4;A;;565;159;253;319;246;0;6;313;319
8;Barcelona;21;Maresme;08172;Premià de Mar;3;4;B;;655;141;293;363;292;0;5;358;363
8;Barcelona;21;Maresme;08172;Premià de Mar;3;5;A;;464;112;176;218;246;1;2;215;217
8;Barcelona;21;Maresme;08172;Premià de Mar;3;5;B;;525;129;199;232;293;1;4;227;231
8;Barcelona;21;Maresme;08172;Premià de Mar;3;6;A;;422;103;196;262;160;3;1;258;259
8;Barcelona;21;Maresme;08172;Premià de Mar;3;6;B;;583;140;272;353;230;1;2;350;352
8;Barcelona;21;Maresme;08172;Premià de Mar;3;7;A;;501;134;228;300;201;1;12;287;299
8;Barcelona;21;Maresme;08172;Premià de Mar;3;7;B;;555;138;252;330;225;1;12;317;329
8;Barcelona;21;Maresme;08172;Premià de Mar;3;8;U;;864;227;381;482;382;1;10;471;481
8;Barcelona;21;Maresme;08172;Premià de Mar;3;9;A;;498;137;236;305;193;2;5;298;303
8;Barcelona;21;Maresme;08172;Premià de Mar;3;9;B;;551;165;278;332;219;1;7;324;331
17;Girona;19;Garrotxa;17139;Preses, les;1;1;A;;891;285;524;606;285;9;16;581;597
17;Girona;19;Garrotxa;17139;Preses, les;1;1;B;;438;113;241;285;153;1;12;272;284
25;Lleida;15;Cerdanya;25179;Prullans;1;1;U;;187;49;102;130;57;3;1;126;127
17;Girona;15;Cerdanya;17141;Puigcerdà;1;1;A;;335;69;124;172;163;1;4;167;171
17;Girona;15;Cerdanya;17141;Puigcerdà;1;1;B;;303;56;119;153;150;2;4;147;151
17;Girona;15;Cerdanya;17141;Puigcerdà;1;2;A;;722;192;361;406;316;4;6;396;402
17;Girona;15;Cerdanya;17141;Puigcerdà;1;2;B;;698;152;301;375;323;2;20;353;373
17;Girona;15;Cerdanya;17141;Puigcerdà;1;3;A;;658;132;256;350;308;1;13;336;349
17;Girona;15;Cerdanya;17141;Puigcerdà;1;3;B;;725;143;271;374;351;6;12;356;368
17;Girona;15;Cerdanya;17141;Puigcerdà;1;4;A;;758;157;285;375;383;1;12;362;374
17;Girona;15;Cerdanya;17141;Puigcerdà;1;4;B;;844;198;336;442;402;3;8;431;439
17;Girona;15;Cerdanya;17141;Puigcerdà;1;5;U;;767;138;283;387;380;0;10;377;387
8;Barcelona;3;Alt Penedès;08174;Puigdàlber;1;1;U;;356;101;208;248;108;2;10;236;246
25;Lleida;18;Garrigues;25180;Puiggròs;1;1;U;;236;118;118;158;78;1;2;155;157
43;Tarragona;1;Alt Camp;43119;Puigpelat;1;1;U;;633;136;258;328;305;3;5;320;325
8;Barcelona;14;Berguedà;08175;Puig-reig;1;1;A;;821;256;430;547;274;6;8;533;541
8;Barcelona;14;Berguedà;08175;Puig-reig;1;1;B;;926;290;466;600;326;6;7;587;594
8;Barcelona;14;Berguedà;08175;Puig-reig;1;2;A;;547;162;270;343;204;4;5;334;339
8;Barcelona;14;Berguedà;08175;Puig-reig;1;2;B;;670;200;352;528;142;4;97;427;524
8;Barcelona;14;Berguedà;08175;Puig-reig;2;1;A;;200;78;119;147;53;1;3;143;146
8;Barcelona;14;Berguedà;08175;Puig-reig;2;1;B;;141;32;62;81;60;0;0;81;81
8;Barcelona;14;Berguedà;08175;Puig-reig;2;1;C;;221;55;139;172;49;1;4;167;171
25;Lleida;38;Urgell;25181;Puigverd d'Agramunt;1;1;U;;199;55;118;133;66;6;1;126;127
25;Lleida;33;Segrià;25182;Puigverd de Lleida;1;1;U;;1041;249;502;643;398;3;7;633;640
8;Barcelona;6;Anoia;08176;Pujalt;1;1;U;;169;38;81;118;51;1;2;115;117
8;Barcelona;14;Berguedà;08177;Quar, la;1;1;U;;62;19;30;40;22;0;4;36;40
17;Girona;20;Gironès;17142;Quart;1;1;A;;549;150;300;371;178;1;13;357;370
17;Girona;20;Gironès;17142;Quart;1;1;B;;520;236;361;333;187;1;7;325;332
17;Girona;20;Gironès;17142;Quart;1;2;A;;527;128;284;361;166;6;6;349;355
17;Girona;20;Gironès;17142;Quart;1;2;B;;266;83;133;169;97;0;2;167;169
17;Girona;20;Gironès;17142;Quart;1;2;C;;191;71;99;109;82;0;1;108;109
17;Girona;31;Ripollès;17043;Queralbs;1;1;U;;164;60;102;126;38;1;2;123;125
43;Tarragona;1;Alt Camp;43120;Querol;1;1;U;;347;72;121;149;198;1;1;147;148
17;Girona;2;Alt Empordà;17143;Rabós;1;1;U;;127;51;81;90;37;1;1;88;89
8;Barcelona;7;Bages;08178;Rajadell;1;1;U;;392;95;191;239;153;5;0;234;234
43;Tarragona;30;Ribera d'Ebre;43121;Rasquera;1;1;U;;694;139;320;427;267;4;10;413;423
17;Girona;10;Baix Empordà;17144;Regencós;1;1;U;;219;88;129;151;68;1;0;150;150
8;Barcelona;40;Vallès Occidental;08179;Rellinars;1;1;U;;523;164;272;331;192;4;0;327;327
43;Tarragona;36;Tarragonès;43122;Renau;1;1;U;;64;19;41;47;17;0;1;46;47
43;Tarragona;8;Baix Camp;43123;Reus;1;1;U;;373;112;151;200;173;0;1;199;200
43;Tarragona;8;Baix Camp;43123;Reus;1;2;U;;351;105;157;192;159;0;2;190;192
43;Tarragona;8;Baix Camp;43123;Reus;1;3;A;;447;116;204;266;181;2;5;259;264
43;Tarragona;8;Baix Camp;43123;Reus;1;3;B;;551;149;257;326;225;1;2;323;325
43;Tarragona;8;Baix Camp;43123;Reus;1;4;A;;349;86;158;207;142;2;3;202;205
43;Tarragona;8;Baix Camp;43123;Reus;1;4;B;;317;88;140;191;126;4;5;182;187
43;Tarragona;8;Baix Camp;43123;Reus;1;4;C;;417;120;201;251;166;0;3;248;251
43;Tarragona;8;Baix Camp;43123;Reus;10;1;A;;614;115;222;301;313;1;5;295;300
43;Tarragona;8;Baix Camp;43123;Reus;10;1;B;;787;152;266;385;402;1;13;371;384
43;Tarragona;8;Baix Camp;43123;Reus;2;1;A;;267;64;110;141;126;1;4;136;140
43;Tarragona;8;Baix Camp;43123;Reus;2;1;B;;309;65;120;140;169;1;3;136;139
43;Tarragona;8;Baix Camp;43123;Reus;2;10;A;;531;128;227;302;229;5;3;294;297
43;Tarragona;8;Baix Camp;43123;Reus;2;10;B;;520;128;202;270;250;0;5;265;270
43;Tarragona;8;Baix Camp;43123;Reus;2;10;C;;586;140;254;331;255;0;6;325;331
43;Tarragona;8;Baix Camp;43123;Reus;2;11;A;;377;91;140;188;189;0;1;187;188
43;Tarragona;8;Baix Camp;43123;Reus;2;11;B;;446;101;161;221;225;1;8;212;220
43;Tarragona;8;Baix Camp;43123;Reus;2;12;A;;467;96;205;267;200;1;7;259;266
43;Tarragona;8;Baix Camp;43123;Reus;2;12;B;;563;113;226;301;262;2;7;292;299
43;Tarragona;8;Baix Camp;43123;Reus;2;13;A;;375;107;161;197;178;0;1;196;197
43;Tarragona;8;Baix Camp;43123;Reus;2;13;B;;489;118;206;254;235;3;5;246;251
43;Tarragona;8;Baix Camp;43123;Reus;2;14;A;;270;77;124;150;120;0;6;144;150
43;Tarragona;8;Baix Camp;43123;Reus;2;14;B;;350;80;165;219;131;3;4;212;216
43;Tarragona;8;Baix Camp;43123;Reus;2;15;A;;328;94;165;232;96;1;5;226;231
43;Tarragona;8;Baix Camp;43123;Reus;2;15;B;;374;91;181;229;145;3;9;217;226
43;Tarragona;8;Baix Camp;43123;Reus;2;2;A;;529;151;247;322;207;1;7;314;321
43;Tarragona;8;Baix Camp;43123;Reus;2;2;B;;459;127;202;258;201;2;4;252;256
43;Tarragona;8;Baix Camp;43123;Reus;2;2;C;;519;143;225;284;235;3;6;275;281
43;Tarragona;8;Baix Camp;43123;Reus;2;3;A;;401;91;165;233;168;4;5;224;229
43;Tarragona;8;Baix Camp;43123;Reus;2;3;B;;472;107;204;273;199;0;6;267;273
43;Tarragona;8;Baix Camp;43123;Reus;2;4;U;;548;118;188;243;305;2;1;240;241
43;Tarragona;8;Baix Camp;43123;Reus;2;5;A;;369;95;153;187;182;0;4;183;187
43;Tarragona;8;Baix Camp;43123;Reus;2;5;B;;416;107;168;213;203;1;2;210;212
43;Tarragona;8;Baix Camp;43123;Reus;2;6;A;;537;110;183;251;286;1;4;246;250
43;Tarragona;8;Baix Camp;43123;Reus;2;6;B;;577;123;207;284;293;2;1;281;282
43;Tarragona;8;Baix Camp;43123;Reus;2;6;C;;569;119;199;262;307;2;3;257;260
43;Tarragona;8;Baix Camp;43123;Reus;2;7;A;;453;110;182;234;219;1;6;227;233
43;Tarragona;8;Baix Camp;43123;Reus;2;7;B;;502;141;231;276;226;0;3;273;276
43;Tarragona;8;Baix Camp;43123;Reus;2;8;A;;232;44;77;112;120;0;3;109;112
43;Tarragona;8;Baix Camp;43123;Reus;2;8;B;;206;43;69;96;110;1;3;92;95
43;Tarragona;8;Baix Camp;43123;Reus;2;8;C;;252;47;86;118;134;0;1;117;118
43;Tarragona;8;Baix Camp;43123;Reus;2;9;A;;427;131;227;300;127;0;4;296;300
43;Tarragona;8;Baix Camp;43123;Reus;2;9;B;;439;143;235;295;144;2;4;289;293
43;Tarragona;8;Baix Camp;43123;Reus;3;1;A;;226;67;97;120;106;1;1;118;119
43;Tarragona;8;Baix Camp;43123;Reus;3;1;B;;232;65;93;119;113;0;4;115;119
43;Tarragona;8;Baix Camp;43123;Reus;3;10;A;;367;70;120;157;210;0;4;153;157
43;Tarragona;8;Baix Camp;43123;Reus;3;10;B;;476;90;148;179;297;0;2;177;179
43;Tarragona;8;Baix Camp;43123;Reus;3;10;C;;429;78;130;160;269;0;3;157;160
43;Tarragona;8;Baix Camp;43123;Reus;3;11;A;;501;95;159;205;296;3;3;199;202
43;Tarragona;8;Baix Camp;43123;Reus;3;11;B;;615;103;182;246;369;0;3;243;246
43;Tarragona;8;Baix Camp;43123;Reus;3;11;C;;568;103;180;254;314;0;9;245;254
43;Tarragona;8;Baix Camp;43123;Reus;3;12;A;;287;65;100;145;142;0;6;139;145
43;Tarragona;8;Baix Camp;43123;Reus;3;12;B;;371;91;134;175;196;0;5;170;175
43;Tarragona;8;Baix Camp;43123;Reus;3;12;C;;359;81;125;152;207;0;6;146;152
43;Tarragona;8;Baix Camp;43123;Reus;3;13;A;;468;86;162;213;255;5;3;205;208
43;Tarragona;8;Baix Camp;43123;Reus;3;13;B;;507;103;186;247;260;0;2;245;247
43;Tarragona;8;Baix Camp;43123;Reus;3;2;U;;413;137;206;254;159;1;3;250;253
43;Tarragona;8;Baix Camp;43123;Reus;3;3;A;;402;108;170;211;191;0;3;208;211
43;Tarragona;8;Baix Camp;43123;Reus;3;3;B;;441;112;160;212;229;0;0;212;212
43;Tarragona;8;Baix Camp;43123;Reus;3;4;A;;482;101;169;235;247;0;10;225;235
43;Tarragona;8;Baix Camp;43123;Reus;3;4;B;;559;107;189;260;299;0;4;256;260
43;Tarragona;8;Baix Camp;43123;Reus;3;5;A;;337;97;147;174;163;0;3;171;174
43;Tarragona;8;Baix Camp;43123;Reus;3;5;B;;361;73;143;203;158;3;3;197;200
43;Tarragona;8;Baix Camp;43123;Reus;3;6;U;;394;119;169;206;188;0;2;204;206
43;Tarragona;8;Baix Camp;43123;Reus;3;7;A;;454;82;153;208;246;0;4;204;208
43;Tarragona;8;Baix Camp;43123;Reus;3;7;B;;427;78;149;198;229;0;3;195;198
43;Tarragona;8;Baix Camp;43123;Reus;3;8;A;;415;113;175;226;189;1;8;217;225
43;Tarragona;8;Baix Camp;43123;Reus;3;8;B;;429;106;173;232;197;1;5;226;231
43;Tarragona;8;Baix Camp;43123;Reus;3;8;C;;482;113;194;255;227;2;4;249;253
43;Tarragona;8;Baix Camp;43123;Reus;3;9;A;;421;93;156;204;217;1;5;198;203
43;Tarragona;8;Baix Camp;43123;Reus;3;9;B;;513;137;194;242;271;3;3;236;239
43;Tarragona;8;Baix Camp;43123;Reus;4;1;U;;377;85;155;182;195;1;2;179;181
43;Tarragona;8;Baix Camp;43123;Reus;4;2;A;;410;113;161;219;191;1;4;214;218
43;Tarragona;8;Baix Camp;43123;Reus;4;2;B;;335;91;140;180;155;0;3;177;180
43;Tarragona;8;Baix Camp;43123;Reus;4;2;C;;406;107;166;212;194;2;8;202;210
43;Tarragona;8;Baix Camp;43123;Reus;4;3;U;;487;82;167;213;274;2;3;208;211
43;Tarragona;8;Baix Camp;43123;Reus;4;4;A;;475;118;163;218;257;1;6;211;217
43;Tarragona;8;Baix Camp;43123;Reus;4;4;B;;580;117;184;256;324;0;7;249;256
43;Tarragona;8;Baix Camp;43123;Reus;4;5;A;;332;66;115;168;164;0;1;167;168
43;Tarragona;8;Baix Camp;43123;Reus;4;5;B;;311;69;112;164;147;1;1;162;163
43;Tarragona;8;Baix Camp;43123;Reus;4;6;A;;436;70;149;189;247;2;8;179;187
43;Tarragona;8;Baix Camp;43123;Reus;4;6;B;;413;84;141;185;228;0;2;183;185
43;Tarragona;8;Baix Camp;43123;Reus;4;7;A;;331;60;103;139;192;0;2;137;139
43;Tarragona;8;Baix Camp;43123;Reus;4;7;B;;349;69;119;153;196;1;0;152;152
43;Tarragona;8;Baix Camp;43123;Reus;4;7;C;;381;73;116;160;221;1;2;157;159
43;Tarragona;8;Baix Camp;43123;Reus;4;8;A;;421;76;132;172;249;0;1;171;172
43;Tarragona;8;Baix Camp;43123;Reus;4;8;B;;371;60;109;150;221;0;1;149;150
43;Tarragona;8;Baix Camp;43123;Reus;4;8;C;;408;91;142;188;220;2;2;184;186
43;Tarragona;8;Baix Camp;43123;Reus;5;1;A;;411;93;164;216;195;2;4;210;214
43;Tarragona;8;Baix Camp;43123;Reus;5;1;B;;420;97;161;206;214;0;4;202;206
43;Tarragona;8;Baix Camp;43123;Reus;5;1;C;;421;102;180;219;202;1;4;214;218
43;Tarragona;8;Baix Camp;43123;Reus;5;2;A;;330;83;131;163;167;0;1;162;163
43;Tarragona;8;Baix Camp;43123;Reus;5;2;B;;385;86;146;204;181;0;4;200;204
43;Tarragona;8;Baix Camp;43123;Reus;5;2;C;;404;98;163;217;187;1;4;212;216
43;Tarragona;8;Baix Camp;43123;Reus;5;3;A;;390;88;147;178;212;2;3;173;176
43;Tarragona;8;Baix Camp;43123;Reus;5;3;B;;420;119;171;215;205;5;1;209;210
43;Tarragona;8;Baix Camp;43123;Reus;5;4;A;;473;118;196;249;224;1;6;242;248
43;Tarragona;8;Baix Camp;43123;Reus;5;4;B;;451;92;171;219;232;0;1;218;219
43;Tarragona;8;Baix Camp;43123;Reus;5;4;C;;485;113;173;238;247;0;5;233;238
43;Tarragona;8;Baix Camp;43123;Reus;5;5;A;;369;85;122;170;199;5;1;164;165
43;Tarragona;8;Baix Camp;43123;Reus;5;5;B;;419;107;171;211;208;1;5;205;210
43;Tarragona;8;Baix Camp;43123;Reus;5;5;C;;463;122;176;229;234;2;5;222;227
43;Tarragona;8;Baix Camp;43123;Reus;5;6;U;;462;86;179;239;223;3;8;228;236
43;Tarragona;8;Baix Camp;43123;Reus;5;7;A;;443;93;196;246;197;0;6;240;246
43;Tarragona;8;Baix Camp;43123;Reus;5;7;B;;494;92;185;252;242;0;4;248;252
43;Tarragona;8;Baix Camp;43123;Reus;6;1;A;;340;95;158;205;135;0;5;200;205
43;Tarragona;8;Baix Camp;43123;Reus;6;1;B;;401;99;179;214;187;1;4;209;213
43;Tarragona;8;Baix Camp;43123;Reus;6;10;U;;392;108;157;185;207;2;0;183;183
43;Tarragona;8;Baix Camp;43123;Reus;6;11;A;;496;149;259;334;162;3;5;326;331
43;Tarragona;8;Baix Camp;43123;Reus;6;11;B;;411;102;203;264;147;0;5;259;264
43;Tarragona;8;Baix Camp;43123;Reus;6;11;C;;521;136;261;343;178;0;5;338;343
43;Tarragona;8;Baix Camp;43123;Reus;6;12;A;;412;107;173;238;174;0;3;235;238
43;Tarragona;8;Baix Camp;43123;Reus;6;12;B;;473;128;217;277;196;0;4;273;277
43;Tarragona;8;Baix Camp;43123;Reus;6;13;A;;365;115;183;227;138;1;2;224;226
43;Tarragona;8;Baix Camp;43123;Reus;6;13;B;;360;101;175;217;143;1;4;212;216
43;Tarragona;8;Baix Camp;43123;Reus;6;2;A;;390;107;205;260;130;0;4;256;260
43;Tarragona;8;Baix Camp;43123;Reus;6;2;B;;311;84;154;206;105;0;1;205;206
43;Tarragona;8;Baix Camp;43123;Reus;6;2;C;;408;104;205;285;123;0;2;283;285
43;Tarragona;8;Baix Camp;43123;Reus;6;3;A;;500;135;250;317;183;1;5;311;316
43;Tarragona;8;Baix Camp;43123;Reus;6;3;B;;459;131;213;270;189;0;4;266;270
43;Tarragona;8;Baix Camp;43123;Reus;6;3;C;;535;162;262;332;203;0;4;328;332
43;Tarragona;8;Baix Camp;43123;Reus;6;4;A;;432;135;224;306;126;2;5;299;304
43;Tarragona;8;Baix Camp;43123;Reus;6;4;B;;442;130;225;307;135;0;8;299;307
43;Tarragona;8;Baix Camp;43123;Reus;6;4;C;;503;165;269;372;131;1;8;363;371
43;Tarragona;8;Baix Camp;43123;Reus;6;5;A;;561;94;170;230;331;0;4;226;230
43;Tarragona;8;Baix Camp;43123;Reus;6;5;B;;697;147;242;309;388;0;7;302;309
43;Tarragona;8;Baix Camp;43123;Reus;6;6;A;;585;158;261;348;237;3;3;342;345
43;Tarragona;8;Baix Camp;43123;Reus;6;6;B;;496;144;246;299;197;0;7;292;299
43;Tarragona;8;Baix Camp;43123;Reus;6;6;C;;553;165;264;352;201;0;7;345;352
43;Tarragona;8;Baix Camp;43123;Reus;6;7;A;;442;124;204;276;166;1;4;271;275
43;Tarragona;8;Baix Camp;43123;Reus;6;7;B;;474;113;213;274;200;3;3;268;271
43;Tarragona;8;Baix Camp;43123;Reus;6;8;A;;427;106;200;248;179;1;4;243;247
43;Tarragona;8;Baix Camp;43123;Reus;6;8;B;;447;109;193;249;198;0;5;244;249
43;Tarragona;8;Baix Camp;43123;Reus;6;9;A;;251;46;81;103;148;1;3;99;102
43;Tarragona;8;Baix Camp;43123;Reus;6;9;B;;245;33;70;102;143;2;0;100;100
43;Tarragona;8;Baix Camp;43123;Reus;7;1;A;;399;58;93;120;279;2;0;118;118
43;Tarragona;8;Baix Camp;43123;Reus;7;1;B;;445;72;94;122;323;1;0;121;121
43;Tarragona;8;Baix Camp;43123;Reus;7;1;C;;440;72;113;133;307;0;1;132;133
43;Tarragona;8;Baix Camp;43123;Reus;7;2;A;;621;98;177;236;385;0;5;231;236
43;Tarragona;8;Baix Camp;43123;Reus;7;2;B;;697;101;186;249;448;0;3;246;249
43;Tarragona;8;Baix Camp;43123;Reus;7;2;C;;778;117;205;273;505;0;7;266;273
43;Tarragona;8;Baix Camp;43123;Reus;7;3;A;;436;91;145;194;242;0;5;189;194
43;Tarragona;8;Baix Camp;43123;Reus;7;3;B;;542;99;177;226;316;0;3;223;226
43;Tarragona;8;Baix Camp;43123;Reus;7;3;C;;477;97;152;198;279;0;7;191;198
43;Tarragona;8;Baix Camp;43123;Reus;8;1;A;;240;46;77;95;145;1;4;90;94
43;Tarragona;8;Baix Camp;43123;Reus;8;1;B;;302;65;95;119;183;1;4;114;118
43;Tarragona;8;Baix Camp;43123;Reus;8;1;C;;280;55;84;98;182;0;2;96;98
43;Tarragona;8;Baix Camp;43123;Reus;8;2;A;;506;80;151;200;306;2;4;194;198
43;Tarragona;8;Baix Camp;43123;Reus;8;2;B;;457;83;157;221;236;0;5;216;221
43;Tarragona;8;Baix Camp;43123;Reus;8;3;U;;872;216;358;450;422;2;5;443;448
43;Tarragona;8;Baix Camp;43123;Reus;8;4;A;;436;97;172;211;225;0;6;205;211
43;Tarragona;8;Baix Camp;43123;Reus;8;4;B;;489;94;170;211;278;1;2;208;210
43;Tarragona;8;Baix Camp;43123;Reus;8;5;U;;549;141;198;259;290;2;2;255;257
43;Tarragona;8;Baix Camp;43123;Reus;8;6;A;;604;138;242;309;295;0;8;301;309
43;Tarragona;8;Baix Camp;43123;Reus;8;6;B;;766;168;282;392;374;1;9;382;391
43;Tarragona;8;Baix Camp;43123;Reus;8;7;A;;442;94;176;248;194;1;6;241;247
43;Tarragona;8;Baix Camp;43123;Reus;8;7;B;;512;106;197;274;238;1;5;268;273
43;Tarragona;8;Baix Camp;43123;Reus;8;7;C;;521;103;192;260;261;0;7;253;260
43;Tarragona;8;Baix Camp;43123;Reus;9;1;A;;566;130;252;360;206;2;3;355;358
43;Tarragona;8;Baix Camp;43123;Reus;9;1;B;;650;148;301;415;235;1;14;400;414
43;Tarragona;8;Baix Camp;43123;Reus;9;2;A;;323;28;60;69;254;0;0;69;69
43;Tarragona;8;Baix Camp;43123;Reus;9;2;B;;318;49;69;97;221;0;1;96;97
25;Lleida;26;Pallars Sobirà;25183;Rialp;1;1;U;;503;125;232;332;171;0;8;324;332
43;Tarragona;1;Alt Camp;43124;Riba, la;1;1;U;;572;183;319;375;197;1;5;369;374
43;Tarragona;30;Ribera d'Ebre;43125;Riba-roja d'Ebre;1;1;A;;602;133;274;370;232;1;3;366;369
43;Tarragona;30;Ribera d'Ebre;43125;Riba-roja d'Ebre;1;1;B;;469;79;187;260;209;1;8;251;259
25;Lleida;32;Segarra;25905;Ribera d'Ondara;1;1;U;;400;111;223;266;134;0;8;258;266
25;Lleida;4;Alt Urgell;25185;Ribera d'Urgellet;1;1;U;;722;157;348;412;310;2;9;401;410
17;Girona;31;Ripollès;17145;Ribes de Freser;1;1;A;;446;133;244;312;134;0;7;305;312
17;Girona;31;Ripollès;17145;Ribes de Freser;1;1;B;;343;99;207;248;95;2;5;241;246
17;Girona;31;Ripollès;17145;Ribes de Freser;1;2;A;;487;128;235;312;175;3;12;297;309
17;Girona;31;Ripollès;17145;Ribes de Freser;1;2;B;;412;104;228;289;123;2;4;283;287
17;Girona;34;Selva;17146;Riells i Viabrea;1;1;A;;576;112;239;318;258;0;2;316;318
17;Girona;34;Selva;17146;Riells i Viabrea;1;1;B;;632;161;293;355;277;0;7;348;355
17;Girona;34;Selva;17146;Riells i Viabrea;1;2;A;;599;126;245;305;294;1;2;302;304
17;Girona;34;Selva;17146;Riells i Viabrea;1;2;B;;658;144;274;325;333;0;5;320;325
43;Tarragona;36;Tarragonès;43126;Riera de Gaià, la;1;1;U;;1056;320;558;675;381;5;15;655;670
25;Lleida;35;Solsonès;25186;Riner;1;1;U;;233;70;145;172;61;4;7;161;168
17;Girona;31;Ripollès;17147;Ripoll;1;1;U;;511;156;255;312;199;2;8;302;310
17;Girona;31;Ripollès;17147;Ripoll;1;2;U;;522;153;227;292;230;2;8;282;290
17;Girona;31;Ripollès;17147;Ripoll;2;1;U;;729;227;390;475;254;1;12;462;474
17;Girona;31;Ripollès;17147;Ripoll;2;2;A;;665;201;327;376;289;1;5;370;375
17;Girona;31;Ripollès;17147;Ripoll;2;2;B;;285;76;125;154;131;4;3;147;150
17;Girona;31;Ripollès;17147;Ripoll;3;1;A;;468;117;208;255;213;1;3;251;254
17;Girona;31;Ripollès;17147;Ripoll;3;1;B;;486;132;255;314;172;1;7;306;313
17;Girona;31;Ripollès;17147;Ripoll;3;2;U;;681;187;343;437;244;3;15;419;434
17;Girona;31;Ripollès;17147;Ripoll;3;3;A;;804;240;410;509;295;1;18;490;508
17;Girona;31;Ripollès;17147;Ripoll;3;3;B;;903;260;499;622;281;2;16;604;620
17;Girona;31;Ripollès;17147;Ripoll;3;4;A;;805;200;397;488;317;1;9;478;487
17;Girona;31;Ripollès;17147;Ripoll;3;4;B;;845;230;445;531;314;5;11;515;526
17;Girona;31;Ripollès;17147;Ripoll;4;1;U;;954;250;503;627;327;2;17;608;625
8;Barcelona;40;Vallès Occidental;08180;Ripollet;1;1;A;;662;112;200;280;382;1;5;274;279
8;Barcelona;40;Vallès Occidental;08180;Ripollet;1;1;B;;760;141;251;346;414;0;6;340;346
8;Barcelona;40;Vallès Occidental;08180;Ripollet;1;10;U;;901;175;329;413;488;1;13;399;412
8;Barcelona;40;Vallès Occidental;08180;Ripollet;1;11;A;;554;114;222;280;274;0;3;277;280
8;Barcelona;40;Vallès Occidental;08180;Ripollet;1;11;B;;726;145;258;377;349;0;10;367;377
8;Barcelona;40;Vallès Occidental;08180;Ripollet;1;12;U;;886;158;315;420;466;8;0;412;412
8;Barcelona;40;Vallès Occidental;08180;Ripollet;1;13;A;;623;136;233;320;303;1;6;313;319
8;Barcelona;40;Vallès Occidental;08180;Ripollet;1;13;B;;706;143;263;363;343;0;12;351;363
8;Barcelona;40;Vallès Occidental;08180;Ripollet;1;2;A;;626;173;262;342;284;1;5;336;341
8;Barcelona;40;Vallès Occidental;08180;Ripollet;1;2;B;;788;186;314;402;386;0;3;399;402
8;Barcelona;40;Vallès Occidental;08180;Ripollet;1;3;A;;621;134;266;324;297;0;7;317;324
8;Barcelona;40;Vallès Occidental;08180;Ripollet;1;3;B;;769;179;295;379;390;1;7;371;378
8;Barcelona;40;Vallès Occidental;08180;Ripollet;1;4;A;;634;137;244;311;323;0;4;307;311
8;Barcelona;40;Vallès Occidental;08180;Ripollet;1;4;B;;796;173;319;414;382;0;10;404;414
8;Barcelona;40;Vallès Occidental;08180;Ripollet;1;5;A;;726;129;238;315;411;2;6;307;313
8;Barcelona;40;Vallès Occidental;08180;Ripollet;1;5;B;;890;143;286;374;516;0;7;367;374
8;Barcelona;40;Vallès Occidental;08180;Ripollet;1;6;A;;527;100;197;250;277;1;1;248;249
8;Barcelona;40;Vallès Occidental;08180;Ripollet;1;6;B;;650;128;231;306;344;1;4;301;305
8;Barcelona;40;Vallès Occidental;08180;Ripollet;1;7;A;;822;168;289;371;451;0;7;364;371
8;Barcelona;40;Vallès Occidental;08180;Ripollet;1;7;B;;887;186;322;398;489;0;8;390;398
8;Barcelona;40;Vallès Occidental;08180;Ripollet;1;8;A;;836;160;295;377;459;0;12;365;377
8;Barcelona;40;Vallès Occidental;08180;Ripollet;1;8;B;;933;177;342;439;494;0;7;432;439
8;Barcelona;40;Vallès Occidental;08180;Ripollet;1;9;A;;602;113;206;289;313;0;10;279;289
8;Barcelona;40;Vallès Occidental;08180;Ripollet;1;9;B;;675;136;260;353;322;2;9;342;351
8;Barcelona;40;Vallès Occidental;08180;Ripollet;2;1;A;;545;133;197;260;285;4;7;249;256
8;Barcelona;40;Vallès Occidental;08180;Ripollet;2;1;B;;709;177;266;355;354;0;10;345;355
8;Barcelona;40;Vallès Occidental;08180;Ripollet;2;2;A;;606;125;208;279;327;1;8;270;278
8;Barcelona;40;Vallès Occidental;08180;Ripollet;2;2;B;;694;142;220;328;366;5;8;315;323
8;Barcelona;40;Vallès Occidental;08180;Ripollet;2;3;A;;668;136;223;285;383;1;3;281;284
8;Barcelona;40;Vallès Occidental;08180;Ripollet;2;3;B;;955;203;323;415;540;1;6;408;414
8;Barcelona;40;Vallès Occidental;08180;Ripollet;2;4;A;;591;120;213;273;318;0;4;269;273
8;Barcelona;40;Vallès Occidental;08180;Ripollet;2;4;B;;696;127;254;317;379;1;4;312;316
8;Barcelona;40;Vallès Occidental;08180;Ripollet;2;5;A;;437;89;136;167;270;5;0;162;162
8;Barcelona;40;Vallès Occidental;08180;Ripollet;2;5;B;;497;97;154;205;292;0;5;200;205
8;Barcelona;40;Vallès Occidental;08180;Ripollet;2;6;A;;557;112;184;222;335;0;7;215;222
8;Barcelona;40;Vallès Occidental;08180;Ripollet;2;6;B;;723;151;247;314;409;2;8;304;312
8;Barcelona;40;Vallès Occidental;08180;Ripollet;2;7;A;;422;104;166;199;223;0;1;198;199
8;Barcelona;40;Vallès Occidental;08180;Ripollet;2;7;B;;532;118;193;234;298;1;7;226;233
17;Girona;34;Selva;17148;Riudarenes;1;1;A;;694;166;286;344;350;1;7;336;343
17;Girona;34;Selva;17148;Riudarenes;1;1;B;;686;162;286;358;328;0;11;347;358
17;Girona;19;Garrotxa;17149;Riudaura;1;1;U;;360;117;206;245;115;1;2;242;244
43;Tarragona;8;Baix Camp;43127;Riudecanyes;1;1;U;;676;202;353;456;220;0;10;446;456
25;Lleida;15;Cerdanya;25913;Riu de Cerdanya;1;1;U;;85;28;53;61;24;0;1;60;61
43;Tarragona;8;Baix Camp;43128;Riudecols;1;1;A;;367;78;179;233;134;2;2;229;231
43;Tarragona;8;Baix Camp;43128;Riudecols;1;1;B;;507;112;253;331;176;1;2;328;330
17;Girona;34;Selva;17150;Riudellots de la Selva;1;1;A;;718;212;405;498;220;7;13;478;491
17;Girona;34;Selva;17150;Riudellots de la Selva;1;1;B;;726;184;381;486;240;10;11;465;476
43;Tarragona;8;Baix Camp;43129;Riudoms;1;1;A;;546;116;239;310;236;8;6;296;302
43;Tarragona;8;Baix Camp;43129;Riudoms;1;1;B;;514;106;224;298;216;1;4;293;297
43;Tarragona;8;Baix Camp;43129;Riudoms;2;1;A;;320;86;161;202;118;3;2;197;199
43;Tarragona;8;Baix Camp;43129;Riudoms;2;1;B;;338;94;161;205;133;2;4;199;203
43;Tarragona;8;Baix Camp;43129;Riudoms;2;2;A;;331;77;164;224;107;1;4;219;223
43;Tarragona;8;Baix Camp;43129;Riudoms;2;2;B;;397;101;201;236;161;0;6;230;236
43;Tarragona;8;Baix Camp;43129;Riudoms;2;2;C;;351;62;146;212;139;1;3;208;211
43;Tarragona;8;Baix Camp;43129;Riudoms;2;2;D;;418;95;188;265;153;2;4;259;263
43;Tarragona;8;Baix Camp;43129;Riudoms;2;3;A;;398;79;157;231;167;0;4;227;231
43;Tarragona;8;Baix Camp;43129;Riudoms;2;3;B;;425;93;178;238;187;2;3;233;236
43;Tarragona;8;Baix Camp;43129;Riudoms;2;3;C;;394;87;150;223;171;1;7;215;222
17;Girona;2;Alt Empordà;17151;Riumors;1;1;U;;158;37;78;97;61;0;0;97;97
8;Barcelona;41;Vallès Oriental;08181;Roca del Vallès, la;1;1;U;;737;214;417;507;230;4;2;501;503
8;Barcelona;41;Vallès Oriental;08181;Roca del Vallès, la;1;2;U;;727;121;286;382;345;14;2;366;368
8;Barcelona;41;Vallès Oriental;08181;Roca del Vallès, la;1;3;A;;613;110;256;318;295;1;4;313;317
8;Barcelona;41;Vallès Oriental;08181;Roca del Vallès, la;1;3;B;;796;135;299;400;396;4;4;392;396
8;Barcelona;41;Vallès Oriental;08181;Roca del Vallès, la;1;3;C;;654;144;277;356;298;3;17;336;353
8;Barcelona;41;Vallès Oriental;08181;Roca del Vallès, la;1;4;A;;809;164;300;409;400;1;4;404;408
8;Barcelona;41;Vallès Oriental;08181;Roca del Vallès, la;1;4;B;;817;178;321;435;382;1;7;427;434
8;Barcelona;41;Vallès Oriental;08181;Roca del Vallès, la;1;5;A;;766;157;361;457;309;6;15;436;451
8;Barcelona;41;Vallès Oriental;08181;Roca del Vallès, la;1;5;B;;764;137;310;408;356;5;12;391;403
8;Barcelona;41;Vallès Oriental;08181;Roca del Vallès, la;1;5;C;;748;172;341;443;305;1;6;436;442
43;Tarragona;16;Conca de Barberà;43130;Rocafort de Queralt;1;1;U;;227;70;122;160;67;0;4;156;160
43;Tarragona;36;Tarragonès;43131;Roda de Berà;1;1;A;;734;198;295;368;366;0;6;362;368
43;Tarragona;36;Tarragonès;43131;Roda de Berà;1;1;B;;879;201;305;417;462;2;4;411;415
43;Tarragona;36;Tarragonès;43131;Roda de Berà;1;2;A;;434;88;132;170;264;1;3;166;169
43;Tarragona;36;Tarragonès;43131;Roda de Berà;1;2;B;;524;132;182;225;299;0;7;218;225
43;Tarragona;36;Tarragonès;43131;Roda de Berà;1;3;A;;580;145;257;320;260;1;2;317;319
43;Tarragona;36;Tarragonès;43131;Roda de Berà;1;3;B;;694;156;280;374;320;2;5;367;372
8;Barcelona;24;Osona;08183;Roda de Ter;1;1;A;;606;168;311;361;245;1;12;348;360
8;Barcelona;24;Osona;08183;Roda de Ter;1;1;B;;704;185;335;406;298;3;8;395;403
8;Barcelona;24;Osona;08183;Roda de Ter;1;2;A;;470;140;288;332;138;1;5;326;331
8;Barcelona;24;Osona;08183;Roda de Ter;1;2;B;;583;137;314;377;206;3;8;366;374
8;Barcelona;24;Osona;08183;Roda de Ter;1;3;A;;520;147;270;326;194;0;7;319;326
8;Barcelona;24;Osona;08183;Roda de Ter;1;3;B;;562;162;300;358;204;1;4;353;357
8;Barcelona;24;Osona;08183;Roda de Ter;2;1;U;;801;259;475;543;258;0;10;533;543
43;Tarragona;1;Alt Camp;43132;Rodonyà;1;1;U;;337;92;180;228;109;2;7;219;226
43;Tarragona;9;Baix Ebre;43133;Roquetes;1;1;A;;629;159;260;345;284;1;4;340;344
43;Tarragona;9;Baix Ebre;43133;Roquetes;1;1;B;;458;97;190;256;202;2;6;248;254
43;Tarragona;9;Baix Ebre;43133;Roquetes;1;2;A;;614;115;248;335;279;0;10;325;335
43;Tarragona;9;Baix Ebre;43133;Roquetes;1;2;B;;536;113;205;281;255;0;5;276;281
43;Tarragona;9;Baix Ebre;43133;Roquetes;2;1;A;;629;126;243;340;289;3;9;328;337
43;Tarragona;9;Baix Ebre;43133;Roquetes;2;1;B;;667;139;233;313;354;0;3;310;313
43;Tarragona;9;Baix Ebre;43133;Roquetes;2;1;C;;616;125;257;339;277;1;11;327;338
43;Tarragona;9;Baix Ebre;43133;Roquetes;2;2;A;;690;128;260;353;337;0;5;348;353
43;Tarragona;9;Baix Ebre;43133;Roquetes;2;2;B;;691;124;244;346;345;0;6;340;346
17;Girona;2;Alt Empordà;17152;Roses;1;1;U;;505;158;257;304;201;1;11;292;303
17;Girona;2;Alt Empordà;17152;Roses;1;2;A;;433;103;158;213;220;0;3;210;213
17;Girona;2;Alt Empordà;17152;Roses;1;2;B;;421;95;154;193;228;2;0;191;191
17;Girona;2;Alt Empordà;17152;Roses;1;3;A;;571;122;207;256;315;2;3;251;254
17;Girona;2;Alt Empordà;17152;Roses;1;3;B;;608;122;203;252;356;2;4;246;250
17;Girona;2;Alt Empordà;17152;Roses;1;3;C;;555;112;202;232;323;0;5;227;232
17;Girona;2;Alt Empordà;17152;Roses;1;4;A;;806;197;334;393;413;1;4;388;392
17;Girona;2;Alt Empordà;17152;Roses;1;4;B;;708;154;274;330;378;0;4;326;330
17;Girona;2;Alt Empordà;17152;Roses;1;5;U;;579;127;211;250;329;0;5;245;250
17;Girona;2;Alt Empordà;17152;Roses;2;1;U;;486;150;240;283;203;1;3;279;282
17;Girona;2;Alt Empordà;17152;Roses;2;2;A;;419;138;214;245;174;6;1;238;239
17;Girona;2;Alt Empordà;17152;Roses;2;2;B;;385;103;171;198;187;1;2;195;197
17;Girona;2;Alt Empordà;17152;Roses;2;2;C;;374;100;169;195;179;3;2;190;192
17;Girona;2;Alt Empordà;17152;Roses;2;3;A;;517;120;224;273;244;1;4;268;272
17;Girona;2;Alt Empordà;17152;Roses;2;3;B;;540;119;226;285;255;1;6;278;284
17;Girona;2;Alt Empordà;17152;Roses;2;3;C;;601;156;274;340;261;1;8;331;339
17;Girona;2;Alt Empordà;17152;Roses;2;4;A;;606;148;263;326;280;5;6;315;321
17;Girona;2;Alt Empordà;17152;Roses;2;4;B;;636;148;281;336;300;2;9;325;334
25;Lleida;33;Segrià;25189;Rosselló;1;1;A;;577;136;252;312;265;2;3;307;310
25;Lleida;33;Segrià;25189;Rosselló;1;1;B;;690;173;311;385;305;2;3;380;383
25;Lleida;33;Segrià;25189;Rosselló;1;1;C;;547;122;235;290;257;1;3;286;289
43;Tarragona;1;Alt Camp;43134;Rourell, el;1;1;U;;277;97;165;198;79;4;2;192;194
8;Barcelona;40;Vallès Occidental;08184;Rubí;1;1;A;;671;130;226;310;361;1;4;305;309
8;Barcelona;40;Vallès Occidental;08184;Rubí;1;1;B;;834;148;278;367;467;0;4;363;367
8;Barcelona;40;Vallès Occidental;08184;Rubí;1;1;C;;830;153;293;397;433;2;8;387;395
8;Barcelona;40;Vallès Occidental;08184;Rubí;1;2;A;;648;117;195;253;395;1;1;251;252
8;Barcelona;40;Vallès Occidental;08184;Rubí;1;2;B;;738;147;244;307;431;0;2;305;307
8;Barcelona;40;Vallès Occidental;08184;Rubí;1;3;A;;465;86;164;213;252;0;6;207;213
8;Barcelona;40;Vallès Occidental;08184;Rubí;1;3;B;;668;134;236;316;352;0;6;310;316
8;Barcelona;40;Vallès Occidental;08184;Rubí;2;1;A;;886;165;299;384;502;6;0;378;378
8;Barcelona;40;Vallès Occidental;08184;Rubí;2;1;B;;906;162;292;381;525;1;5;375;380
8;Barcelona;40;Vallès Occidental;08184;Rubí;2;1;C;;965;174;316;411;554;2;4;405;409
8;Barcelona;40;Vallès Occidental;08184;Rubí;2;3;A;;1040;167;327;422;618;0;8;414;422
8;Barcelona;40;Vallès Occidental;08184;Rubí;2;3;B;;1190;169;352;437;753;1;10;426;436
8;Barcelona;40;Vallès Occidental;08184;Rubí;2;3;C;;1220;193;342;426;794;2;5;419;424
8;Barcelona;40;Vallès Occidental;08184;Rubí;3;1;A;;892;201;379;492;400;2;7;483;490
8;Barcelona;40;Vallès Occidental;08184;Rubí;3;1;B;;931;203;355;486;445;1;9;476;485
8;Barcelona;40;Vallès Occidental;08184;Rubí;3;1;C;;1001;225;426;566;435;1;15;550;565
8;Barcelona;40;Vallès Occidental;08184;Rubí;3;2;U;;505;95;163;233;272;2;3;228;231
8;Barcelona;40;Vallès Occidental;08184;Rubí;3;3;A;;381;101;152;189;192;2;1;186;187
8;Barcelona;40;Vallès Occidental;08184;Rubí;3;3;B;;456;127;183;223;233;0;3;220;223
8;Barcelona;40;Vallès Occidental;08184;Rubí;3;4;A;;663;140;270;315;348;2;4;309;313
8;Barcelona;40;Vallès Occidental;08184;Rubí;3;4;B;;698;141;267;345;353;7;7;331;338
8;Barcelona;40;Vallès Occidental;08184;Rubí;3;5;A;;684;168;283;353;331;0;8;345;353
8;Barcelona;40;Vallès Occidental;08184;Rubí;3;5;B;;858;195;337;431;427;2;4;425;429
8;Barcelona;40;Vallès Occidental;08184;Rubí;3;6;A;;611;145;246;301;310;0;10;291;301
8;Barcelona;40;Vallès Occidental;08184;Rubí;3;6;B;;741;178;330;389;352;0;3;386;389
8;Barcelona;40;Vallès Occidental;08184;Rubí;3;7;A;;541;121;230;283;258;2;6;275;281
8;Barcelona;40;Vallès Occidental;08184;Rubí;3;7;B;;660;161;288;356;304;0;12;344;356
8;Barcelona;40;Vallès Occidental;08184;Rubí;3;8;A;;439;102;167;196;243;0;0;196;196
8;Barcelona;40;Vallès Occidental;08184;Rubí;3;8;B;;509;148;220;253;256;0;2;251;253
8;Barcelona;40;Vallès Occidental;08184;Rubí;4;1;A;;485;154;251;296;189;0;11;285;296
8;Barcelona;40;Vallès Occidental;08184;Rubí;4;1;B;;624;214;359;397;227;2;6;389;395
8;Barcelona;40;Vallès Occidental;08184;Rubí;4;10;A;;683;135;211;285;398;1;3;281;284
8;Barcelona;40;Vallès Occidental;08184;Rubí;4;10;B;;833;171;268;331;502;0;5;326;331
8;Barcelona;40;Vallès Occidental;08184;Rubí;4;10;C;;814;143;230;297;517;1;3;293;296
8;Barcelona;40;Vallès Occidental;08184;Rubí;4;11;A;;472;118;201;240;232;1;7;232;239
8;Barcelona;40;Vallès Occidental;08184;Rubí;4;11;B;;611;147;241;306;305;1;3;302;305
8;Barcelona;40;Vallès Occidental;08184;Rubí;4;11;C;;594;154;232;309;285;0;11;298;309
8;Barcelona;40;Vallès Occidental;08184;Rubí;4;12;A;;542;100;176;220;322;6;6;208;214
8;Barcelona;40;Vallès Occidental;08184;Rubí;4;12;B;;716;144;257;319;397;0;10;309;319
8;Barcelona;40;Vallès Occidental;08184;Rubí;4;13;A;;658;158;253;322;336;0;3;319;322
8;Barcelona;40;Vallès Occidental;08184;Rubí;4;13;B;;675;138;259;322;353;1;1;320;321
8;Barcelona;40;Vallès Occidental;08184;Rubí;4;13;C;;689;152;259;326;363;1;7;318;325
8;Barcelona;40;Vallès Occidental;08184;Rubí;4;14;A;;947;180;316;417;530;1;8;408;416
8;Barcelona;40;Vallès Occidental;08184;Rubí;4;14;B;;1049;180;336;439;610;1;5;433;438
8;Barcelona;40;Vallès Occidental;08184;Rubí;4;15;A;;466;92;207;204;262;0;1;203;204
8;Barcelona;40;Vallès Occidental;08184;Rubí;4;15;B;;617;119;207;257;360;0;8;249;257
8;Barcelona;40;Vallès Occidental;08184;Rubí;4;16;A;;787;154;261;345;442;0;7;338;345
8;Barcelona;40;Vallès Occidental;08184;Rubí;4;16;B;;967;169;319;410;557;0;8;402;410
8;Barcelona;40;Vallès Occidental;08184;Rubí;4;16;C;;958;157;334;430;528;1;11;418;429
8;Barcelona;40;Vallès Occidental;08184;Rubí;4;16;D;;308;84;128;144;164;1;2;141;143
8;Barcelona;40;Vallès Occidental;08184;Rubí;4;18;A;;448;128;205;254;194;1;2;251;253
8;Barcelona;40;Vallès Occidental;08184;Rubí;4;18;B;;489;115;199;244;245;2;5;237;242
8;Barcelona;40;Vallès Occidental;08184;Rubí;4;19;A;;461;106;161;192;269;1;4;187;191
8;Barcelona;40;Vallès Occidental;08184;Rubí;4;19;B;;509;98;175;216;293;0;5;211;216
8;Barcelona;40;Vallès Occidental;08184;Rubí;4;2;U;;868;235;426;511;357;5;16;490;506
8;Barcelona;40;Vallès Occidental;08184;Rubí;4;20;U;;995;182;319;409;586;6;7;396;403
8;Barcelona;40;Vallès Occidental;08184;Rubí;4;21;A;;657;126;234;307;350;0;5;302;307
8;Barcelona;40;Vallès Occidental;08184;Rubí;4;21;B;;790;169;276;359;431;1;6;352;358
8;Barcelona;40;Vallès Occidental;08184;Rubí;4;22;U;;1094;241;455;584;510;4;14;566;580
8;Barcelona;40;Vallès Occidental;08184;Rubí;4;3;A;;496;122;198;264;232;1;5;258;263
8;Barcelona;40;Vallès Occidental;08184;Rubí;4;3;B;;567;123;224;288;279;6;1;281;282
8;Barcelona;40;Vallès Occidental;08184;Rubí;4;4;A;;707;122;238;306;401;3;2;301;303
8;Barcelona;40;Vallès Occidental;08184;Rubí;4;4;B;;820;166;275;343;477;2;8;333;341
8;Barcelona;40;Vallès Occidental;08184;Rubí;4;5;A;;523;163;278;343;180;0;6;337;343
8;Barcelona;40;Vallès Occidental;08184;Rubí;4;5;B;;589;181;301;372;217;0;10;362;372
8;Barcelona;40;Vallès Occidental;08184;Rubí;4;6;A;;512;119;228;293;219;1;9;283;292
8;Barcelona;40;Vallès Occidental;08184;Rubí;4;6;B;;569;161;272;330;239;0;12;318;330
8;Barcelona;40;Vallès Occidental;08184;Rubí;4;7;A;;560;155;255;312;248;5;5;302;307
8;Barcelona;40;Vallès Occidental;08184;Rubí;4;7;B;;637;168;292;364;273;3;8;353;361
8;Barcelona;40;Vallès Occidental;08184;Rubí;4;8;U;;798;190;306;382;416;2;11;369;380
8;Barcelona;40;Vallès Occidental;08184;Rubí;4;9;A;;594;100;211;277;317;1;4;272;276
8;Barcelona;40;Vallès Occidental;08184;Rubí;4;9;B;;810;164;297;361;449;1;9;351;360
8;Barcelona;6;Anoia;08185;Rubió;1;1;U;;122;33;66;84;38;0;3;81;84
17;Girona;10;Baix Empordà;17153;Rupià;1;1;U;;160;67;107;124;36;0;3;121;124
8;Barcelona;24;Osona;08901;Rupit i Pruit;1;1;U;;283;113;171;215;68;1;4;210;214
8;Barcelona;40;Vallès Occidental;08187;Sabadell;1;1;U;;544;190;328;396;148;1;9;386;395
8;Barcelona;40;Vallès Occidental;08187;Sabadell;1;10;U;;774;242;426;544;230;1;8;535;543
8;Barcelona;40;Vallès Occidental;08187;Sabadell;1;11;U;;875;279;534;665;210;0;19;646;665
8;Barcelona;40;Vallès Occidental;08187;Sabadell;1;12;U;;892;272;500;613;279;1;10;602;612
8;Barcelona;40;Vallès Occidental;08187;Sabadell;1;13;U;;690;190;364;448;242;2;13;433;446
8;Barcelona;40;Vallès Occidental;08187;Sabadell;1;14;A;;581;173;323;406;175;0;3;403;406
8;Barcelona;40;Vallès Occidental;08187;Sabadell;1;14;B;;687;204;377;502;185;2;10;490;500
8;Barcelona;40;Vallès Occidental;08187;Sabadell;1;15;A;;497;171;281;381;116;2;7;372;379
8;Barcelona;40;Vallès Occidental;08187;Sabadell;1;15;B;;692;317;490;518;174;3;13;502;515
8;Barcelona;40;Vallès Occidental;08187;Sabadell;1;16;A;;659;211;394;486;173;0;7;479;486
8;Barcelona;40;Vallès Occidental;08187;Sabadell;1;16;B;;741;240;436;547;194;1;15;531;546
8;Barcelona;40;Vallès Occidental;08187;Sabadell;1;17;A;;700;179;308;436;264;2;8;426;434
8;Barcelona;40;Vallès Occidental;08187;Sabadell;1;17;B;;856;234;413;544;312;4;16;524;540
8;Barcelona;40;Vallès Occidental;08187;Sabadell;1;18;A;;633;157;290;368;265;1;10;357;367
8;Barcelona;40;Vallès Occidental;08187;Sabadell;1;18;B;;707;170;316;416;291;1;3;412;415
8;Barcelona;40;Vallès Occidental;08187;Sabadell;1;19;A;;641;200;340;441;200;4;6;431;437
8;Barcelona;40;Vallès Occidental;08187;Sabadell;1;19;B;;713;217;362;484;229;7;2;475;477
8;Barcelona;40;Vallès Occidental;08187;Sabadell;1;2;U;;872;324;540;680;192;5;19;656;675
8;Barcelona;40;Vallès Occidental;08187;Sabadell;1;20;A;;544;137;265;349;195;1;10;338;348
8;Barcelona;40;Vallès Occidental;08187;Sabadell;1;20;B;;604;149;292;397;207;4;12;381;393
8;Barcelona;40;Vallès Occidental;08187;Sabadell;1;21;U;;878;319;510;607;271;1;5;601;606
8;Barcelona;40;Vallès Occidental;08187;Sabadell;1;22;A;;651;175;317;397;254;0;11;386;397
8;Barcelona;40;Vallès Occidental;08187;Sabadell;1;22;B;;855;218;395;519;336;2;11;506;517
8;Barcelona;40;Vallès Occidental;08187;Sabadell;1;23;A;;624;174;292;353;271;1;2;350;352
8;Barcelona;40;Vallès Occidental;08187;Sabadell;1;23;B;;802;212;368;453;349;3;12;438;450
8;Barcelona;40;Vallès Occidental;08187;Sabadell;1;24;A;;573;143;264;350;223;3;5;342;347
8;Barcelona;40;Vallès Occidental;08187;Sabadell;1;24;B;;700;155;280;361;339;0;3;358;361
8;Barcelona;40;Vallès Occidental;08187;Sabadell;1;25;A;;526;182;280;337;189;1;6;330;336
8;Barcelona;40;Vallès Occidental;08187;Sabadell;1;25;B;;627;182;296;376;251;0;7;369;376
8;Barcelona;40;Vallès Occidental;08187;Sabadell;1;26;U;;661;231;371;457;204;0;7;450;457
8;Barcelona;40;Vallès Occidental;08187;Sabadell;1;27;U;;762;212;397;493;269;0;9;484;493
8;Barcelona;40;Vallès Occidental;08187;Sabadell;1;28;U;;996;278;505;618;378;4;17;597;614
8;Barcelona;40;Vallès Occidental;08187;Sabadell;1;29;U;;975;240;500;624;351;0;11;613;624
8;Barcelona;40;Vallès Occidental;08187;Sabadell;1;3;U;;750;253;462;563;187;4;9;550;559
8;Barcelona;40;Vallès Occidental;08187;Sabadell;1;30;U;;863;276;513;658;205;0;7;651;658
8;Barcelona;40;Vallès Occidental;08187;Sabadell;1;31;U;;816;290;491;591;225;0;4;587;591
8;Barcelona;40;Vallès Occidental;08187;Sabadell;1;32;U;;956;293;487;647;309;1;13;633;646
8;Barcelona;40;Vallès Occidental;08187;Sabadell;1;33;U;;941;270;459;572;369;2;5;565;570
8;Barcelona;40;Vallès Occidental;08187;Sabadell;1;34;U;;859;242;454;581;278;4;16;561;577
8;Barcelona;40;Vallès Occidental;08187;Sabadell;1;4;A;;762;240;446;552;210;4;11;537;548
8;Barcelona;40;Vallès Occidental;08187;Sabadell;1;4;B;;941;298;537;685;256;2;19;664;683
8;Barcelona;40;Vallès Occidental;08187;Sabadell;1;5;A;;593;277;457;408;185;4;3;401;404
8;Barcelona;40;Vallès Occidental;08187;Sabadell;1;5;B;;638;191;352;456;182;2;13;441;454
8;Barcelona;40;Vallès Occidental;08187;Sabadell;1;6;A;;782;276;458;593;189;0;9;584;593
8;Barcelona;40;Vallès Occidental;08187;Sabadell;1;6;B;;963;200;555;712;251;0;14;698;712
8;Barcelona;40;Vallès Occidental;08187;Sabadell;1;7;A;;707;211;418;536;171;7;10;519;529
8;Barcelona;40;Vallès Occidental;08187;Sabadell;1;7;B;;756;258;467;578;178;0;11;567;578
8;Barcelona;40;Vallès Occidental;08187;Sabadell;1;8;A;;608;320;379;475;133;1;20;454;474
8;Barcelona;40;Vallès Occidental;08187;Sabadell;1;8;B;;707;218;423;525;182;4;9;512;521
8;Barcelona;40;Vallès Occidental;08187;Sabadell;1;9;A;;835;275;475;620;215;1;21;598;619
8;Barcelona;40;Vallès Occidental;08187;Sabadell;1;9;B;;863;280;500;654;209;2;8;644;652
8;Barcelona;40;Vallès Occidental;08187;Sabadell;2;1;A;;557;178;341;432;125;5;8;419;427
8;Barcelona;40;Vallès Occidental;08187;Sabadell;2;1;B;;701;240;415;535;166;2;13;520;533
8;Barcelona;40;Vallès Occidental;08187;Sabadell;2;10;U;;732;220;383;466;266;1;1;464;465
8;Barcelona;40;Vallès Occidental;08187;Sabadell;2;11;U;;643;107;188;228;415;0;2;226;228
8;Barcelona;40;Vallès Occidental;08187;Sabadell;2;12;A;;614;131;221;272;342;2;4;266;270
8;Barcelona;40;Vallès Occidental;08187;Sabadell;2;12;B;;708;181;270;321;387;0;7;314;321
8;Barcelona;40;Vallès Occidental;08187;Sabadell;2;13;U;;882;186;330;407;475;2;12;393;405
8;Barcelona;40;Vallès Occidental;08187;Sabadell;2;14;A;;480;88;153;187;293;0;5;182;187
8;Barcelona;40;Vallès Occidental;08187;Sabadell;2;14;B;;555;120;198;232;323;0;2;230;232
8;Barcelona;40;Vallès Occidental;08187;Sabadell;2;15;A;;505;119;228;270;235;0;4;266;270
8;Barcelona;40;Vallès Occidental;08187;Sabadell;2;15;B;;596;164;289;350;246;1;3;346;349
8;Barcelona;40;Vallès Occidental;08187;Sabadell;2;16;A;;622;176;353;456;166;4;7;445;452
8;Barcelona;40;Vallès Occidental;08187;Sabadell;2;16;B;;687;170;376;496;191;1;14;481;495
8;Barcelona;40;Vallès Occidental;08187;Sabadell;2;17;U;;700;221;367;481;219;2;8;471;479
8;Barcelona;40;Vallès Occidental;08187;Sabadell;2;2;A;;480;140;278;352;128;2;5;345;350
8;Barcelona;40;Vallès Occidental;08187;Sabadell;2;2;B;;548;171;324;405;143;1;9;395;404
8;Barcelona;40;Vallès Occidental;08187;Sabadell;2;3;A;;506;149;239;292;214;3;7;282;289
8;Barcelona;40;Vallès Occidental;08187;Sabadell;2;3;B;;619;180;316;378;241;1;4;373;377
8;Barcelona;40;Vallès Occidental;08187;Sabadell;2;4;A;;638;184;335;428;210;3;9;416;425
8;Barcelona;40;Vallès Occidental;08187;Sabadell;2;4;B;;783;250;460;550;233;4;5;541;546
8;Barcelona;40;Vallès Occidental;08187;Sabadell;2;5;A;;622;178;331;416;206;1;10;405;415
8;Barcelona;40;Vallès Occidental;08187;Sabadell;2;5;B;;751;235;422;499;252;1;11;487;498
8;Barcelona;40;Vallès Occidental;08187;Sabadell;2;6;A;;551;143;260;329;222;0;3;326;329
8;Barcelona;40;Vallès Occidental;08187;Sabadell;2;6;B;;737;211;382;473;264;1;12;460;472
8;Barcelona;40;Vallès Occidental;08187;Sabadell;2;7;A;;598;170;318;391;207;1;13;377;390
8;Barcelona;40;Vallès Occidental;08187;Sabadell;2;7;B;;689;228;380;460;229;2;13;445;458
8;Barcelona;40;Vallès Occidental;08187;Sabadell;2;8;U;;671;163;352;448;223;4;10;434;444
8;Barcelona;40;Vallès Occidental;08187;Sabadell;2;9;U;;913;267;498;646;267;0;27;619;646
8;Barcelona;40;Vallès Occidental;08187;Sabadell;3;1;A;;502;88;169;222;280;3;0;219;219
8;Barcelona;40;Vallès Occidental;08187;Sabadell;3;1;B;;628;128;229;280;348;2;6;272;278
8;Barcelona;40;Vallès Occidental;08187;Sabadell;3;10;U;;730;142;250;321;409;3;3;315;318
8;Barcelona;40;Vallès Occidental;08187;Sabadell;3;11;A;;425;94;161;202;223;6;0;196;196
8;Barcelona;40;Vallès Occidental;08187;Sabadell;3;11;B;;533;129;222;261;272;0;3;258;261
8;Barcelona;40;Vallès Occidental;08187;Sabadell;3;12;A;;466;86;161;216;250;0;7;209;216
8;Barcelona;40;Vallès Occidental;08187;Sabadell;3;12;B;;572;137;231;281;291;0;4;277;281
8;Barcelona;40;Vallès Occidental;08187;Sabadell;3;13;U;;906;183;319;402;504;1;9;392;401
8;Barcelona;40;Vallès Occidental;08187;Sabadell;3;14;A;;573;120;180;229;344;0;2;227;229
8;Barcelona;40;Vallès Occidental;08187;Sabadell;3;14;B;;711;159;261;316;395;3;4;309;313
8;Barcelona;40;Vallès Occidental;08187;Sabadell;3;15;A;;507;98;180;242;265;0;2;240;242
8;Barcelona;40;Vallès Occidental;08187;Sabadell;3;15;B;;699;135;242;280;419;0;2;278;280
8;Barcelona;40;Vallès Occidental;08187;Sabadell;3;16;A;;450;88;143;175;275;1;0;174;174
8;Barcelona;40;Vallès Occidental;08187;Sabadell;3;16;B;;594;142;220;258;336;0;5;253;258
8;Barcelona;40;Vallès Occidental;08187;Sabadell;3;17;A;;346;85;115;140;206;0;0;140;140
8;Barcelona;40;Vallès Occidental;08187;Sabadell;3;17;B;;461;127;168;201;260;3;2;196;198
8;Barcelona;40;Vallès Occidental;08187;Sabadell;3;18;A;;724;139;260;342;382;5;0;337;337
8;Barcelona;40;Vallès Occidental;08187;Sabadell;3;18;B;;944;160;349;441;503;4;9;428;437
8;Barcelona;40;Vallès Occidental;08187;Sabadell;3;19;U;;791;153;293;376;415;0;7;369;376
8;Barcelona;40;Vallès Occidental;08187;Sabadell;3;2;A;;451;90;150;188;263;0;3;185;188
8;Barcelona;40;Vallès Occidental;08187;Sabadell;3;2;B;;589;94;172;224;365;1;3;220;223
8;Barcelona;40;Vallès Occidental;08187;Sabadell;3;20;A;;477;97;175;223;254;1;9;213;222
8;Barcelona;40;Vallès Occidental;08187;Sabadell;3;20;B;;562;102;190;251;311;0;7;244;251
8;Barcelona;40;Vallès Occidental;08187;Sabadell;3;21;A;;473;98;168;206;267;0;0;206;206
8;Barcelona;40;Vallès Occidental;08187;Sabadell;3;21;B;;577;111;214;268;309;0;3;265;268
8;Barcelona;40;Vallès Occidental;08187;Sabadell;3;22;U;;650;127;202;255;395;0;7;248;255
8;Barcelona;40;Vallès Occidental;08187;Sabadell;3;23;U;;583;102;199;240;343;3;4;233;237
8;Barcelona;40;Vallès Occidental;08187;Sabadell;3;24;A;;502;99;179;242;260;1;4;237;241
8;Barcelona;40;Vallès Occidental;08187;Sabadell;3;24;B;;596;125;210;275;321;0;5;270;275
8;Barcelona;40;Vallès Occidental;08187;Sabadell;3;25;A;;447;71;128;187;260;3;0;184;184
8;Barcelona;40;Vallès Occidental;08187;Sabadell;3;25;B;;557;90;159;249;308;6;11;232;243
8;Barcelona;40;Vallès Occidental;08187;Sabadell;3;26;A;;530;93;170;259;271;1;1;257;258
8;Barcelona;40;Vallès Occidental;08187;Sabadell;3;26;B;;620;108;203;297;323;2;2;293;295
8;Barcelona;40;Vallès Occidental;08187;Sabadell;3;27;U;;581;60;158;207;374;1;6;200;206
8;Barcelona;40;Vallès Occidental;08187;Sabadell;3;3;A;;551;102;188;244;307;0;5;239;244
8;Barcelona;40;Vallès Occidental;08187;Sabadell;3;3;B;;719;123;241;317;402;0;5;312;317
8;Barcelona;40;Vallès Occidental;08187;Sabadell;3;4;A;;558;111;222;280;278;2;2;276;278
8;Barcelona;40;Vallès Occidental;08187;Sabadell;3;4;B;;714;160;277;350;364;1;7;342;349
8;Barcelona;40;Vallès Occidental;08187;Sabadell;3;5;U;;764;182;319;376;388;2;5;369;374
8;Barcelona;40;Vallès Occidental;08187;Sabadell;3;6;A;;515;122;213;275;240;0;9;266;275
8;Barcelona;40;Vallès Occidental;08187;Sabadell;3;6;B;;653;143;261;338;315;4;1;333;334
8;Barcelona;40;Vallès Occidental;08187;Sabadell;3;7;U;;633;181;312;365;268;5;1;359;360
8;Barcelona;40;Vallès Occidental;08187;Sabadell;3;8;A;;468;85;143;188;280;1;5;182;187
8;Barcelona;40;Vallès Occidental;08187;Sabadell;3;8;B;;523;121;200;244;279;2;4;238;242
8;Barcelona;40;Vallès Occidental;08187;Sabadell;3;9;U;;692;125;223;273;419;0;1;272;273
8;Barcelona;40;Vallès Occidental;08187;Sabadell;4;1;A;;662;114;230;306;356;1;11;294;305
8;Barcelona;40;Vallès Occidental;08187;Sabadell;4;1;B;;808;147;296;397;411;2;6;389;395
8;Barcelona;40;Vallès Occidental;08187;Sabadell;4;10;A;;557;109;212;282;275;0;4;278;282
8;Barcelona;40;Vallès Occidental;08187;Sabadell;4;10;B;;629;144;271;341;288;1;10;330;340
8;Barcelona;40;Vallès Occidental;08187;Sabadell;4;11;U;;805;157;290;367;438;1;9;357;366
8;Barcelona;40;Vallès Occidental;08187;Sabadell;4;12;U;;851;157;286;366;485;0;11;355;366
8;Barcelona;40;Vallès Occidental;08187;Sabadell;4;13;A;;535;76;163;226;309;0;4;222;226
8;Barcelona;40;Vallès Occidental;08187;Sabadell;4;13;B;;629;144;241;278;351;0;1;277;278
8;Barcelona;40;Vallès Occidental;08187;Sabadell;4;14;A;;519;125;225;306;213;1;6;299;305
8;Barcelona;40;Vallès Occidental;08187;Sabadell;4;14;B;;566;117;241;318;248;3;4;311;315
8;Barcelona;40;Vallès Occidental;08187;Sabadell;4;15;U;;734;159;260;315;419;0;4;311;315
8;Barcelona;40;Vallès Occidental;08187;Sabadell;4;16;A;;621;126;235;317;304;0;9;308;317
8;Barcelona;40;Vallès Occidental;08187;Sabadell;4;16;B;;814;170;325;413;401;0;8;405;413
8;Barcelona;40;Vallès Occidental;08187;Sabadell;4;17;A;;645;142;250;313;332;0;5;308;313
8;Barcelona;40;Vallès Occidental;08187;Sabadell;4;17;B;;799;186;318;411;388;2;10;399;409
8;Barcelona;40;Vallès Occidental;08187;Sabadell;4;18;U;;537;130;215;248;289;0;2;246;248
8;Barcelona;40;Vallès Occidental;08187;Sabadell;4;19;A;;457;80;142;174;283;0;2;172;174
8;Barcelona;40;Vallès Occidental;08187;Sabadell;4;19;B;;536;123;177;219;317;3;2;214;216
8;Barcelona;40;Vallès Occidental;08187;Sabadell;4;2;A;;385;103;160;210;175;2;2;206;208
8;Barcelona;40;Vallès Occidental;08187;Sabadell;4;2;B;;519;127;209;263;256;0;2;261;263
8;Barcelona;40;Vallès Occidental;08187;Sabadell;4;20;A;;890;171;322;407;483;0;6;401;407
8;Barcelona;40;Vallès Occidental;08187;Sabadell;4;20;B;;744;187;354;466;278;0;16;450;466
8;Barcelona;40;Vallès Occidental;08187;Sabadell;4;20;C;;850;159;345;495;355;1;9;485;494
8;Barcelona;40;Vallès Occidental;08187;Sabadell;4;20;D;;998;198;392;522;476;2;8;512;520
8;Barcelona;40;Vallès Occidental;08187;Sabadell;4;20;E;;963;190;389;505;458;0;10;495;505
8;Barcelona;40;Vallès Occidental;08187;Sabadell;4;20;F;;698;146;284;390;308;0;13;377;390
8;Barcelona;40;Vallès Occidental;08187;Sabadell;4;21;U;;906;197;363;446;460;2;15;429;444
8;Barcelona;40;Vallès Occidental;08187;Sabadell;4;22;U;;755;124;256;368;387;4;10;354;364
8;Barcelona;40;Vallès Occidental;08187;Sabadell;4;3;U;;836;198;361;469;367;2;19;448;467
8;Barcelona;40;Vallès Occidental;08187;Sabadell;4;4;A;;618;139;251;321;297;1;8;312;320
8;Barcelona;40;Vallès Occidental;08187;Sabadell;4;4;B;;758;171;296;381;377;0;5;376;381
8;Barcelona;40;Vallès Occidental;08187;Sabadell;4;5;A;;553;156;269;325;228;0;5;320;325
8;Barcelona;40;Vallès Occidental;08187;Sabadell;4;5;B;;703;199;314;411;292;2;11;398;409
8;Barcelona;40;Vallès Occidental;08187;Sabadell;4;6;A;;611;171;280;387;224;0;6;381;387
8;Barcelona;40;Vallès Occidental;08187;Sabadell;4;6;B;;774;169;349;460;314;0;8;452;460
8;Barcelona;40;Vallès Occidental;08187;Sabadell;4;7;U;;922;144;391;512;410;3;13;496;509
8;Barcelona;40;Vallès Occidental;08187;Sabadell;4;8;A;;589;215;283;366;223;1;11;354;365
8;Barcelona;40;Vallès Occidental;08187;Sabadell;4;8;B;;675;169;322;423;252;1;13;409;422
8;Barcelona;40;Vallès Occidental;08187;Sabadell;4;9;A;;484;128;242;299;185;0;4;295;299
8;Barcelona;40;Vallès Occidental;08187;Sabadell;4;9;B;;473;92;204;291;182;0;4;287;291
8;Barcelona;40;Vallès Occidental;08187;Sabadell;5;1;A;;502;139;248;315;187;0;7;308;315
8;Barcelona;40;Vallès Occidental;08187;Sabadell;5;1;B;;590;165;279;314;276;0;2;312;314
8;Barcelona;40;Vallès Occidental;08187;Sabadell;5;10;U;;536;124;205;233;303;0;4;229;233
8;Barcelona;40;Vallès Occidental;08187;Sabadell;5;11;U;;898;240;348;365;533;2;13;350;363
8;Barcelona;40;Vallès Occidental;08187;Sabadell;5;12;U;;826;202;345;435;391;8;3;424;427
8;Barcelona;40;Vallès Occidental;08187;Sabadell;5;13;A;;570;116;210;294;276;0;4;290;294
8;Barcelona;40;Vallès Occidental;08187;Sabadell;5;13;B;;767;166;287;383;384;0;1;382;383
8;Barcelona;40;Vallès Occidental;08187;Sabadell;5;14;U;;804;207;355;475;329;0;9;466;475
8;Barcelona;40;Vallès Occidental;08187;Sabadell;5;15;U;;1035;267;540;702;333;8;26;668;694
8;Barcelona;40;Vallès Occidental;08187;Sabadell;5;2;A;;547;161;298;376;171;0;9;367;376
8;Barcelona;40;Vallès Occidental;08187;Sabadell;5;2;B;;651;176;331;432;219;2;16;414;430
8;Barcelona;40;Vallès Occidental;08187;Sabadell;5;3;U;;970;304;540;689;281;3;17;669;686
8;Barcelona;40;Vallès Occidental;08187;Sabadell;5;4;U;;623;163;326;381;242;3;6;372;378
8;Barcelona;40;Vallès Occidental;08187;Sabadell;5;5;A;;452;145;223;281;171;3;0;278;278
8;Barcelona;40;Vallès Occidental;08187;Sabadell;5;5;B;;531;154;247;308;223;1;3;304;307
8;Barcelona;40;Vallès Occidental;08187;Sabadell;5;6;U;;824;262;475;566;258;0;11;555;566
8;Barcelona;40;Vallès Occidental;08187;Sabadell;5;7;A;;370;92;156;212;158;0;4;208;212
8;Barcelona;40;Vallès Occidental;08187;Sabadell;5;7;B;;491;104;182;247;244;0;3;244;247
8;Barcelona;40;Vallès Occidental;08187;Sabadell;5;8;U;;498;147;212;255;243;4;1;250;251
8;Barcelona;40;Vallès Occidental;08187;Sabadell;5;9;A;;595;148;248;315;280;1;8;306;314
8;Barcelona;40;Vallès Occidental;08187;Sabadell;5;9;B;;644;151;275;355;289;0;5;350;355
8;Barcelona;40;Vallès Occidental;08187;Sabadell;6;1;U;;615;162;250;288;327;3;5;280;285
8;Barcelona;40;Vallès Occidental;08187;Sabadell;6;10;U;;659;162;281;317;342;3;4;310;314
8;Barcelona;40;Vallès Occidental;08187;Sabadell;6;11;U;;621;112;178;218;403;0;6;212;218
8;Barcelona;40;Vallès Occidental;08187;Sabadell;6;12;U;;818;183;307;364;454;0;8;356;364
8;Barcelona;40;Vallès Occidental;08187;Sabadell;6;13;U;;766;150;236;294;472;2;6;286;292
8;Barcelona;40;Vallès Occidental;08187;Sabadell;6;14;U;;453;122;206;250;203;0;6;244;250
8;Barcelona;40;Vallès Occidental;08187;Sabadell;6;15;A;;458;93;158;208;250;1;6;201;207
8;Barcelona;40;Vallès Occidental;08187;Sabadell;6;15;B;;665;141;251;303;362;1;4;298;302
8;Barcelona;40;Vallès Occidental;08187;Sabadell;6;16;A;;614;143;248;319;295;2;13;304;317
8;Barcelona;40;Vallès Occidental;08187;Sabadell;6;16;B;;689;186;286;381;308;1;8;372;380
8;Barcelona;40;Vallès Occidental;08187;Sabadell;6;17;A;;508;127;203;261;247;1;1;259;260
8;Barcelona;40;Vallès Occidental;08187;Sabadell;6;17;B;;710;174;300;377;333;0;0;377;377
8;Barcelona;40;Vallès Occidental;08187;Sabadell;6;18;U;;789;212;353;421;368;2;5;414;419
8;Barcelona;40;Vallès Occidental;08187;Sabadell;6;19;U;;559;134;223;264;295;0;3;261;264
8;Barcelona;40;Vallès Occidental;08187;Sabadell;6;2;U;;716;169;290;336;380;0;2;334;336
8;Barcelona;40;Vallès Occidental;08187;Sabadell;6;20;U;;991;232;351;475;516;7;3;465;468
8;Barcelona;40;Vallès Occidental;08187;Sabadell;6;21;U;;842;186;355;424;418;0;10;414;424
8;Barcelona;40;Vallès Occidental;08187;Sabadell;6;22;A;;597;125;202;259;338;0;4;255;259
8;Barcelona;40;Vallès Occidental;08187;Sabadell;6;22;B;;753;150;286;373;380;1;6;366;372
8;Barcelona;40;Vallès Occidental;08187;Sabadell;6;23;A;;617;138;247;336;281;0;8;328;336
8;Barcelona;40;Vallès Occidental;08187;Sabadell;6;23;B;;778;186;345;430;348;1;7;422;429
8;Barcelona;40;Vallès Occidental;08187;Sabadell;6;24;U;;845;201;346;421;424;1;8;412;420
8;Barcelona;40;Vallès Occidental;08187;Sabadell;6;3;U;;675;133;232;311;364;0;10;301;311
8;Barcelona;40;Vallès Occidental;08187;Sabadell;6;4;A;;486;114;187;230;256;8;0;222;222
8;Barcelona;40;Vallès Occidental;08187;Sabadell;6;4;B;;559;123;214;262;297;0;2;260;262
8;Barcelona;40;Vallès Occidental;08187;Sabadell;6;5;U;;835;139;271;333;502;0;2;331;333
8;Barcelona;40;Vallès Occidental;08187;Sabadell;6;6;U;;774;122;270;319;455;0;5;314;319
8;Barcelona;40;Vallès Occidental;08187;Sabadell;6;7;U;;694;165;262;312;382;2;2;308;310
8;Barcelona;40;Vallès Occidental;08187;Sabadell;6;8;A;;552;136;228;291;261;0;5;286;291
8;Barcelona;40;Vallès Occidental;08187;Sabadell;6;8;B;;555;129;228;297;258;1;7;289;296
8;Barcelona;40;Vallès Occidental;08187;Sabadell;6;9;A;;640;153;242;281;359;4;2;275;277
8;Barcelona;40;Vallès Occidental;08187;Sabadell;6;9;B;;726;162;263;319;407;3;4;312;316
8;Barcelona;40;Vallès Occidental;08187;Sabadell;7;1;U;;772;160;282;362;410;1;3;358;361
8;Barcelona;40;Vallès Occidental;08187;Sabadell;7;2;A;;456;89;156;198;258;0;4;194;198
8;Barcelona;40;Vallès Occidental;08187;Sabadell;7;2;B;;608;150;250;296;312;2;1;293;294
8;Barcelona;40;Vallès Occidental;08187;Sabadell;7;3;A;;825;131;237;294;531;0;5;289;294
8;Barcelona;40;Vallès Occidental;08187;Sabadell;7;3;B;;987;178;319;381;606;0;3;378;381
8;Barcelona;40;Vallès Occidental;08187;Sabadell;7;4;U;;592;148;232;295;297;0;5;290;295
8;Barcelona;40;Vallès Occidental;08187;Sabadell;7;5;U;;771;131;236;325;446;1;2;322;324
8;Barcelona;40;Vallès Occidental;08187;Sabadell;7;6;U;;572;129;241;287;285;3;3;281;284
8;Barcelona;14;Berguedà;08188;Sagàs;1;1;U;;112;29;61;83;29;1;3;79;82
25;Lleida;25;Pallars Jussà;25190;Salàs de Pallars;1;1;U;;286;83;162;195;91;2;3;190;193
8;Barcelona;14;Berguedà;08190;Saldes;1;1;U;;281;80;141;182;99;5;7;170;177
17;Girona;19;Garrotxa;17154;Sales de Llierca;1;1;U;;78;22;38;47;31;0;1;46;47
8;Barcelona;7;Bages;08191;Sallent;1;1;U;;522;132;250;317;205;0;10;307;317
8;Barcelona;7;Bages;08191;Sallent;1;2;U;;550;136;276;359;191;4;3;352;355
8;Barcelona;7;Bages;08191;Sallent;1;3;A;;523;138;241;316;207;0;9;307;316
8;Barcelona;7;Bages;08191;Sallent;1;3;B;;545;138;276;348;197;0;9;339;348
8;Barcelona;7;Bages;08191;Sallent;1;4;A;;529;122;216;289;240;2;9;278;287
8;Barcelona;7;Bages;08191;Sallent;1;4;B;;536;138;252;312;224;2;6;304;310
8;Barcelona;7;Bages;08191;Sallent;1;5;U;;1032;285;525;647;385;1;10;636;646
8;Barcelona;7;Bages;08191;Sallent;1;6;U;;683;173;350;416;267;0;12;404;416
8;Barcelona;7;Bages;08191;Sallent;1;7;U;;487;125;262;302;185;1;5;296;301
8;Barcelona;7;Bages;08191;Sallent;2;1;A;;191;66;95;112;79;0;1;111;112
8;Barcelona;7;Bages;08191;Sallent;2;1;B;;260;125;137;168;92;0;6;162;168
43;Tarragona;36;Tarragonès;43135;Salomó;1;1;U;;339;98;191;246;93;0;4;242;246
43;Tarragona;36;Tarragonès;43905;Salou;1;1;A;;602;108;185;248;354;2;3;243;246
43;Tarragona;36;Tarragonès;43905;Salou;1;1;B;;772;142;244;310;462;0;3;307;310
43;Tarragona;36;Tarragonès;43905;Salou;1;10;A;;851;145;269;370;481;1;5;364;369
43;Tarragona;36;Tarragonès;43905;Salou;1;10;B;;888;140;266;371;517;1;7;363;370
43;Tarragona;36;Tarragonès;43905;Salou;1;2;A;;544;82;161;207;337;2;2;203;205
43;Tarragona;36;Tarragonès;43905;Salou;1;2;B;;602;110;199;243;359;1;2;240;242
43;Tarragona;36;Tarragonès;43905;Salou;1;3;A;;403;70;135;185;218;2;4;179;183
43;Tarragona;36;Tarragonès;43905;Salou;1;3;B;;405;69;128;167;238;0;0;167;167
43;Tarragona;36;Tarragonès;43905;Salou;1;4;U;;890;175;332;394;496;2;9;383;392
43;Tarragona;36;Tarragonès;43905;Salou;1;5;U;;844;177;290;398;446;0;4;394;398
43;Tarragona;36;Tarragonès;43905;Salou;1;6;A;;736;141;220;280;456;2;5;273;278
43;Tarragona;36;Tarragonès;43905;Salou;1;6;B;;813;123;210;285;528;3;2;280;282
43;Tarragona;36;Tarragonès;43905;Salou;1;7;A;;762;160;304;380;382;3;4;373;377
43;Tarragona;36;Tarragonès;43905;Salou;1;7;B;;858;184;287;384;474;3;7;374;381
43;Tarragona;36;Tarragonès;43905;Salou;1;8;A;;514;88;174;241;273;0;2;239;241
43;Tarragona;36;Tarragonès;43905;Salou;1;8;B;;619;116;230;315;304;0;8;307;315
43;Tarragona;36;Tarragonès;43905;Salou;1;9;A;;454;87;168;231;223;1;0;230;230
43;Tarragona;36;Tarragonès;43905;Salou;1;9;B;;432;87;162;204;228;0;5;199;204
17;Girona;20;Gironès;17155;Salt;1;1;A;;534;173;310;360;174;6;12;342;354
17;Girona;20;Gironès;17155;Salt;1;1;B;;535;160;297;345;190;1;13;331;344
17;Girona;20;Gironès;17155;Salt;1;2;U;;835;264;432;500;335;4;9;487;496
17;Girona;20;Gironès;17155;Salt;1;3;A;;423;85;155;182;241;0;5;177;182
17;Girona;20;Gironès;17155;Salt;1;3;B;;447;104;182;215;232;2;3;210;213
17;Girona;20;Gironès;17155;Salt;1;4;A;;875;241;400;476;399;11;15;450;465
17;Girona;20;Gironès;17155;Salt;1;4;B;;883;242;397;464;419;1;8;455;463
17;Girona;20;Gironès;17155;Salt;1;5;A;;725;147;253;303;422;0;3;300;303
17;Girona;20;Gironès;17155;Salt;1;5;B;;744;164;285;330;414;0;9;321;330
17;Girona;20;Gironès;17155;Salt;1;6;A;;492;110;162;206;286;0;6;200;206
17;Girona;20;Gironès;17155;Salt;1;6;B;;497;126;190;211;286;0;3;208;211
17;Girona;20;Gironès;17155;Salt;1;7;U;;515;106;176;191;324;0;5;186;191
17;Girona;20;Gironès;17155;Salt;1;8;U;;772;219;383;416;356;2;9;405;414
17;Girona;20;Gironès;17155;Salt;1;9;U;;721;188;380;476;245;0;12;464;476
17;Girona;20;Gironès;17155;Salt;2;1;A;;513;145;229;277;236;1;9;267;276
17;Girona;20;Gironès;17155;Salt;2;1;B;;520;122;203;261;259;4;6;251;257
17;Girona;20;Gironès;17155;Salt;2;2;U;;918;216;350;420;498;4;11;405;416
17;Girona;20;Gironès;17155;Salt;2;3;A;;509;112;195;225;284;3;4;218;222
17;Girona;20;Gironès;17155;Salt;2;3;B;;518;118;188;222;296;0;2;220;222
17;Girona;20;Gironès;17155;Salt;2;4;A;;686;136;245;282;404;1;5;276;281
17;Girona;20;Gironès;17155;Salt;2;4;B;;682;141;242;300;382;1;8;291;299
17;Girona;20;Gironès;17155;Salt;2;5;U;;773;214;394;477;296;1;13;463;476
17;Girona;20;Gironès;17155;Salt;2;6;U;;735;185;286;331;404;0;7;324;331
17;Girona;20;Gironès;17155;Salt;2;7;U;;753;138;216;268;485;2;5;261;266
25;Lleida;32;Segarra;25191;Sanaüja;1;1;U;;363;97;222;261;102;2;12;247;259
43;Tarragona;22;Montsià;43138;Santa Bàrbara;1;1;A;;282;60;138;186;96;2;4;180;184
43;Tarragona;22;Montsià;43138;Santa Bàrbara;1;1;B;;245;50;185;149;96;1;2;146;148
43;Tarragona;22;Montsià;43138;Santa Bàrbara;1;1;C;;305;62;123;180;125;0;5;175;180
43;Tarragona;22;Montsià;43138;Santa Bàrbara;1;1;D;;313;64;148;202;111;2;6;194;200
43;Tarragona;22;Montsià;43138;Santa Bàrbara;1;1;E;;366;80;148;210;156;3;7;200;207
43;Tarragona;22;Montsià;43138;Santa Bàrbara;2;1;A;;421;75;186;252;169;2;6;244;250
43;Tarragona;22;Montsià;43138;Santa Bàrbara;2;1;B;;421;84;185;232;189;3;3;226;229
43;Tarragona;22;Montsià;43138;Santa Bàrbara;2;1;C;;378;72;146;196;182;1;7;188;195
8;Barcelona;24;Osona;08243;Santa Cecília de Voltregà;1;1;U;;161;55;105;116;45;0;7;109;116
8;Barcelona;11;Baix Llobregat;08244;Santa Coloma de Cervelló;1;1;A;;489;152;227;292;197;1;7;284;291
8;Barcelona;11;Baix Llobregat;08244;Santa Coloma de Cervelló;1;1;B;;522;133;246;324;198;1;7;316;323
8;Barcelona;11;Baix Llobregat;08244;Santa Coloma de Cervelló;1;1;C;;597;172;311;391;206;3;10;378;388
8;Barcelona;11;Baix Llobregat;08244;Santa Coloma de Cervelló;1;2;U;;612;199;352;438;174;0;7;431;438
8;Barcelona;11;Baix Llobregat;08244;Santa Coloma de Cervelló;1;3;A;;668;170;304;401;267;3;14;384;398
8;Barcelona;11;Baix Llobregat;08244;Santa Coloma de Cervelló;1;3;B;;840;211;381;503;337;2;21;480;501
8;Barcelona;11;Baix Llobregat;08244;Santa Coloma de Cervelló;1;3;C;;653;145;268;359;294;3;17;339;356
8;Barcelona;11;Baix Llobregat;08244;Santa Coloma de Cervelló;1;4;A;;543;108;207;292;251;0;4;288;292
8;Barcelona;11;Baix Llobregat;08244;Santa Coloma de Cervelló;1;4;B;;614;128;257;334;280;3;2;329;331
17;Girona;34;Selva;17180;Santa Coloma de Farners;1;1;A;;467;116;214;264;203;1;4;259;263
17;Girona;34;Selva;17180;Santa Coloma de Farners;1;1;B;;473;107;218;255;218;4;5;246;251
17;Girona;34;Selva;17180;Santa Coloma de Farners;1;1;C;;533;142;245;298;235;2;5;291;296
17;Girona;34;Selva;17180;Santa Coloma de Farners;1;2;A;;513;115;263;336;177;10;5;321;326
17;Girona;34;Selva;17180;Santa Coloma de Farners;1;2;B;;504;121;243;312;192;2;8;302;310
17;Girona;34;Selva;17180;Santa Coloma de Farners;1;3;A;;743;196;364;440;303;0;6;434;440
17;Girona;34;Selva;17180;Santa Coloma de Farners;1;3;B;;681;183;303;353;328;4;12;337;349
17;Girona;34;Selva;17180;Santa Coloma de Farners;1;4;A;;796;180;370;473;323;3;16;454;470
17;Girona;34;Selva;17180;Santa Coloma de Farners;1;4;B;;804;202;393;489;315;1;9;479;488
17;Girona;34;Selva;17180;Santa Coloma de Farners;1;5;A;;625;145;264;334;291;1;8;325;333
17;Girona;34;Selva;17180;Santa Coloma de Farners;1;5;B;;604;147;270;344;260;1;7;336;343
17;Girona;34;Selva;17180;Santa Coloma de Farners;1;6;U;;936;209;324;420;516;1;8;411;419
8;Barcelona;13;Barcelonès;08245;Santa Coloma de Gramenet;1;1;U;;826;210;434;541;285;4;17;520;537
8;Barcelona;13;Barcelonès;08245;Santa Coloma de Gramenet;1;10;A;;516;106;179;220;296;2;3;215;218
8;Barcelona;13;Barcelonès;08245;Santa Coloma de Gramenet;1;10;B;;524;131;225;272;252;4;3;265;268
8;Barcelona;13;Barcelonès;08245;Santa Coloma de Gramenet;1;11;A;;445;86;193;224;221;0;5;219;224
8;Barcelona;13;Barcelonès;08245;Santa Coloma de Gramenet;1;11;B;;466;125;196;246;220;0;5;241;246
8;Barcelona;13;Barcelonès;08245;Santa Coloma de Gramenet;1;12;U;;678;128;258;341;337;3;6;332;338
8;Barcelona;13;Barcelonès;08245;Santa Coloma de Gramenet;1;13;A;;503;98;193;264;239;0;11;253;264
8;Barcelona;13;Barcelonès;08245;Santa Coloma de Gramenet;1;13;B;;538;124;231;297;241;0;7;290;297
8;Barcelona;13;Barcelonès;08245;Santa Coloma de Gramenet;1;13;C;;527;131;235;322;205;1;7;314;321
8;Barcelona;13;Barcelonès;08245;Santa Coloma de Gramenet;1;14;U;;863;197;365;513;350;0;10;503;513
8;Barcelona;13;Barcelonès;08245;Santa Coloma de Gramenet;1;15;U;;597;123;234;323;274;2;2;319;321
8;Barcelona;13;Barcelonès;08245;Santa Coloma de Gramenet;1;16;U;;673;171;298;385;288;0;4;381;385
8;Barcelona;13;Barcelonès;08245;Santa Coloma de Gramenet;1;17;A;;587;130;217;288;299;0;5;283;288
8;Barcelona;13;Barcelonès;08245;Santa Coloma de Gramenet;1;17;B;;698;165;268;351;347;1;10;340;350
8;Barcelona;13;Barcelonès;08245;Santa Coloma de Gramenet;1;18;A;;509;118;194;264;245;1;8;255;263
8;Barcelona;13;Barcelonès;08245;Santa Coloma de Gramenet;1;18;B;;553;111;208;286;267;2;6;278;284
8;Barcelona;13;Barcelonès;08245;Santa Coloma de Gramenet;1;19;A;;557;99;172;247;310;0;4;243;247
8;Barcelona;13;Barcelonès;08245;Santa Coloma de Gramenet;1;19;B;;605;131;194;280;325;3;0;277;277
8;Barcelona;13;Barcelonès;08245;Santa Coloma de Gramenet;1;2;U;;685;167;287;377;308;0;7;370;377
8;Barcelona;13;Barcelonès;08245;Santa Coloma de Gramenet;1;3;A;;415;101;169;214;201;0;4;210;214
8;Barcelona;13;Barcelonès;08245;Santa Coloma de Gramenet;1;3;B;;519;11;210;262;257;0;7;255;262
8;Barcelona;13;Barcelonès;08245;Santa Coloma de Gramenet;1;4;U;;596;149;256;306;290;2;6;298;304
8;Barcelona;13;Barcelonès;08245;Santa Coloma de Gramenet;1;5;U;;670;164;262;328;342;0;6;322;328
8;Barcelona;13;Barcelonès;08245;Santa Coloma de Gramenet;1;6;U;;645;159;250;289;356;0;11;278;289
8;Barcelona;13;Barcelonès;08245;Santa Coloma de Gramenet;1;7;U;;459;108;169;199;260;0;4;195;199
8;Barcelona;13;Barcelonès;08245;Santa Coloma de Gramenet;1;8;U;;455;110;178;220;235;2;1;217;218
8;Barcelona;13;Barcelonès;08245;Santa Coloma de Gramenet;1;9;A;;416;81;146;180;236;1;7;172;179
8;Barcelona;13;Barcelonès;08245;Santa Coloma de Gramenet;1;9;B;;526;99;189;234;292;1;7;226;233
8;Barcelona;13;Barcelonès;08245;Santa Coloma de Gramenet;2;1;U;;760;164;292;383;377;2;11;370;381
8;Barcelona;13;Barcelonès;08245;Santa Coloma de Gramenet;2;10;U;;600;128;209;261;339;0;5;256;261
8;Barcelona;13;Barcelonès;08245;Santa Coloma de Gramenet;2;11;A;;471;83;137;184;287;1;3;180;183
8;Barcelona;13;Barcelonès;08245;Santa Coloma de Gramenet;2;11;B;;548;103;173;226;322;0;5;221;226
8;Barcelona;13;Barcelonès;08245;Santa Coloma de Gramenet;2;2;A;;374;101;160;198;176;0;4;194;198
8;Barcelona;13;Barcelonès;08245;Santa Coloma de Gramenet;2;2;B;;436;130;204;237;199;0;7;230;237
8;Barcelona;13;Barcelonès;08245;Santa Coloma de Gramenet;2;2;C;;412;102;174;224;188;0;8;216;224
8;Barcelona;13;Barcelonès;08245;Santa Coloma de Gramenet;2;3;A;;579;103;187;240;339;0;7;233;240
8;Barcelona;13;Barcelonès;08245;Santa Coloma de Gramenet;2;3;B;;711;110;187;237;474;0;7;230;237
8;Barcelona;13;Barcelonès;08245;Santa Coloma de Gramenet;2;4;A;;399;97;162;201;198;2;5;194;199
8;Barcelona;13;Barcelonès;08245;Santa Coloma de Gramenet;2;4;B;;477;106;189;248;229;1;3;244;247
8;Barcelona;13;Barcelonès;08245;Santa Coloma de Gramenet;2;5;A;;472;126;194;228;244;0;4;224;228
8;Barcelona;13;Barcelonès;08245;Santa Coloma de Gramenet;2;5;B;;460;109;172;214;246;1;7;206;213
8;Barcelona;13;Barcelonès;08245;Santa Coloma de Gramenet;2;6;A;;440;105;160;212;228;0;6;206;212
8;Barcelona;13;Barcelonès;08245;Santa Coloma de Gramenet;2;6;B;;537;125;212;267;270;0;2;265;267
8;Barcelona;13;Barcelonès;08245;Santa Coloma de Gramenet;2;7;A;;487;76;139;193;294;1;6;186;192
8;Barcelona;13;Barcelonès;08245;Santa Coloma de Gramenet;2;7;B;;542;87;164;218;324;0;5;213;218
8;Barcelona;13;Barcelonès;08245;Santa Coloma de Gramenet;2;7;C;;529;77;157;215;314;1;5;209;214
8;Barcelona;13;Barcelonès;08245;Santa Coloma de Gramenet;2;8;A;;520;81;178;217;303;0;1;216;217
8;Barcelona;13;Barcelonès;08245;Santa Coloma de Gramenet;2;8;B;;609;112;203;256;353;1;4;251;255
8;Barcelona;13;Barcelonès;08245;Santa Coloma de Gramenet;2;9;A;;446;83;151;179;267;8;0;171;171
8;Barcelona;13;Barcelonès;08245;Santa Coloma de Gramenet;2;9;B;;493;93;154;214;279;3;3;208;211
8;Barcelona;13;Barcelonès;08245;Santa Coloma de Gramenet;3;1;U;;667;116;219;287;380;1;8;278;286
8;Barcelona;13;Barcelonès;08245;Santa Coloma de Gramenet;3;10;U;;557;121;222;297;260;0;7;290;297
8;Barcelona;13;Barcelonès;08245;Santa Coloma de Gramenet;3;11;U;;783;157;297;365;418;0;7;358;365
8;Barcelona;13;Barcelonès;08245;Santa Coloma de Gramenet;3;12;A;;516;111;201;249;267;1;4;244;248
8;Barcelona;13;Barcelonès;08245;Santa Coloma de Gramenet;3;12;B;;672;114;233;302;370;0;6;296;302
8;Barcelona;13;Barcelonès;08245;Santa Coloma de Gramenet;3;13;A;;382;72;137;183;199;2;0;181;181
8;Barcelona;13;Barcelonès;08245;Santa Coloma de Gramenet;3;13;B;;491;94;180;237;254;1;5;231;236
8;Barcelona;13;Barcelonès;08245;Santa Coloma de Gramenet;3;13;C;;504;114;189;228;276;0;2;226;228
8;Barcelona;13;Barcelonès;08245;Santa Coloma de Gramenet;3;14;A;;450;88;154;196;254;1;4;191;195
8;Barcelona;13;Barcelonès;08245;Santa Coloma de Gramenet;3;14;B;;544;86;157;205;339;2;5;198;203
8;Barcelona;13;Barcelonès;08245;Santa Coloma de Gramenet;3;15;A;;447;107;180;245;202;5;11;229;240
8;Barcelona;13;Barcelonès;08245;Santa Coloma de Gramenet;3;15;B;;502;99;188;249;253;0;6;243;249
8;Barcelona;13;Barcelonès;08245;Santa Coloma de Gramenet;3;16;U;;791;169;292;369;422;2;2;365;367
8;Barcelona;13;Barcelonès;08245;Santa Coloma de Gramenet;3;17;U;;648;116;210;258;390;0;6;252;258
8;Barcelona;13;Barcelonès;08245;Santa Coloma de Gramenet;3;2;U;;533;116;200;249;284;0;5;244;249
8;Barcelona;13;Barcelonès;08245;Santa Coloma de Gramenet;3;3;U;;704;170;288;347;357;1;5;341;346
8;Barcelona;13;Barcelonès;08245;Santa Coloma de Gramenet;3;4;A;;401;87;134;168;233;0;2;166;168
8;Barcelona;13;Barcelonès;08245;Santa Coloma de Gramenet;3;4;B;;435;97;148;184;251;3;0;181;181
8;Barcelona;13;Barcelonès;08245;Santa Coloma de Gramenet;3;5;A;;381;61;110;128;253;1;4;123;127
8;Barcelona;13;Barcelonès;08245;Santa Coloma de Gramenet;3;5;B;;510;87;139;167;343;0;5;162;167
8;Barcelona;13;Barcelonès;08245;Santa Coloma de Gramenet;3;6;A;;372;83;129;171;201;1;4;166;170
8;Barcelona;13;Barcelonès;08245;Santa Coloma de Gramenet;3;6;B;;518;121;192;237;281;1;5;231;236
8;Barcelona;13;Barcelonès;08245;Santa Coloma de Gramenet;3;7;A;;451;101;159;209;242;0;3;206;209
8;Barcelona;13;Barcelonès;08245;Santa Coloma de Gramenet;3;7;B;;577;113;191;270;307;0;12;258;270
8;Barcelona;13;Barcelonès;08245;Santa Coloma de Gramenet;3;7;C;;507;93;144;217;290;11;0;206;206
8;Barcelona;13;Barcelonès;08245;Santa Coloma de Gramenet;3;8;U;;649;145;240;325;324;0;4;321;325
8;Barcelona;13;Barcelonès;08245;Santa Coloma de Gramenet;3;9;U;;984;198;349;457;527;1;13;443;456
8;Barcelona;13;Barcelonès;08245;Santa Coloma de Gramenet;4;1;U;;878;166;315;429;449;0;10;419;429
8;Barcelona;13;Barcelonès;08245;Santa Coloma de Gramenet;4;10;A;;444;85;166;210;234;0;6;204;210
8;Barcelona;13;Barcelonès;08245;Santa Coloma de Gramenet;4;10;B;;524;139;224;270;254;0;6;264;270
8;Barcelona;13;Barcelonès;08245;Santa Coloma de Gramenet;4;11;A;;383;94;163;205;178;0;5;200;205
8;Barcelona;13;Barcelonès;08245;Santa Coloma de Gramenet;4;11;B;;453;102;165;227;226;1;9;217;226
8;Barcelona;13;Barcelonès;08245;Santa Coloma de Gramenet;4;12;A;;351;77;140;174;177;2;4;168;172
8;Barcelona;13;Barcelonès;08245;Santa Coloma de Gramenet;4;12;B;;475;95;192;237;238;1;6;230;236
8;Barcelona;13;Barcelonès;08245;Santa Coloma de Gramenet;4;13;A;;551;114;211;260;291;0;4;256;260
8;Barcelona;13;Barcelonès;08245;Santa Coloma de Gramenet;4;13;B;;713;140;241;313;400;0;5;308;313
8;Barcelona;13;Barcelonès;08245;Santa Coloma de Gramenet;4;14;A;;445;96;160;213;232;0;0;213;213
8;Barcelona;13;Barcelonès;08245;Santa Coloma de Gramenet;4;14;B;;497;96;167;224;273;0;6;218;224
8;Barcelona;13;Barcelonès;08245;Santa Coloma de Gramenet;4;14;C;;503;102;202;255;248;0;4;251;255
8;Barcelona;13;Barcelonès;08245;Santa Coloma de Gramenet;4;15;A;;483;93;170;217;266;2;3;212;215
8;Barcelona;13;Barcelonès;08245;Santa Coloma de Gramenet;4;15;B;;611;126;223;287;324;0;6;281;287
8;Barcelona;13;Barcelonès;08245;Santa Coloma de Gramenet;4;16;A;;390;90;152;191;199;1;2;188;190
8;Barcelona;13;Barcelonès;08245;Santa Coloma de Gramenet;4;16;B;;474;96;169;220;254;2;4;214;218
8;Barcelona;13;Barcelonès;08245;Santa Coloma de Gramenet;4;2;A;;496;126;227;280;216;2;6;272;278
8;Barcelona;13;Barcelonès;08245;Santa Coloma de Gramenet;4;2;B;;502;122;227;296;206;1;6;289;295
8;Barcelona;13;Barcelonès;08245;Santa Coloma de Gramenet;4;3;A;;535;113;215;279;256;1;5;273;278
8;Barcelona;13;Barcelonès;08245;Santa Coloma de Gramenet;4;3;B;;643;140;270;341;302;1;6;334;340
8;Barcelona;13;Barcelonès;08245;Santa Coloma de Gramenet;4;4;A;;586;120;250;300;286;3;11;286;297
8;Barcelona;13;Barcelonès;08245;Santa Coloma de Gramenet;4;4;B;;725;150;300;368;357;0;6;362;368
8;Barcelona;13;Barcelonès;08245;Santa Coloma de Gramenet;4;5;U;;796;165;280;388;408;2;8;378;386
8;Barcelona;13;Barcelonès;08245;Santa Coloma de Gramenet;4;6;A;;447;165;183;253;194;1;6;246;252
8;Barcelona;13;Barcelonès;08245;Santa Coloma de Gramenet;4;6;B;;570;115;208;284;286;0;9;275;284
8;Barcelona;13;Barcelonès;08245;Santa Coloma de Gramenet;4;7;A;;555;129;229;275;280;0;6;269;275
8;Barcelona;13;Barcelonès;08245;Santa Coloma de Gramenet;4;7;B;;650;138;233;311;339;1;7;303;310
8;Barcelona;13;Barcelonès;08245;Santa Coloma de Gramenet;4;8;A;;369;92;154;197;172;0;2;195;197
8;Barcelona;13;Barcelonès;08245;Santa Coloma de Gramenet;4;8;B;;459;110;185;234;225;2;2;230;232
8;Barcelona;13;Barcelonès;08245;Santa Coloma de Gramenet;4;8;C;;510;107;182;241;269;1;3;237;240
8;Barcelona;13;Barcelonès;08245;Santa Coloma de Gramenet;4;9;A;;644;145;219;310;334;0;9;301;310
8;Barcelona;13;Barcelonès;08245;Santa Coloma de Gramenet;4;9;B;;632;166;260;339;293;0;8;331;339
8;Barcelona;13;Barcelonès;08245;Santa Coloma de Gramenet;5;1;U;;648;112;206;276;372;2;7;267;274
8;Barcelona;13;Barcelonès;08245;Santa Coloma de Gramenet;5;10;U;;495;94;173;210;285;1;4;205;209
8;Barcelona;13;Barcelonès;08245;Santa Coloma de Gramenet;5;11;A;;484;65;120;154;330;0;3;151;154
8;Barcelona;13;Barcelonès;08245;Santa Coloma de Gramenet;5;11;B;;515;65;123;168;347;1;1;166;167
8;Barcelona;13;Barcelonès;08245;Santa Coloma de Gramenet;5;12;U;;636;97;173;225;411;3;4;218;222
8;Barcelona;13;Barcelonès;08245;Santa Coloma de Gramenet;5;13;A;;426;72;119;162;264;0;2;160;162
8;Barcelona;13;Barcelonès;08245;Santa Coloma de Gramenet;5;13;B;;441;79;140;177;264;0;0;177;177
8;Barcelona;13;Barcelonès;08245;Santa Coloma de Gramenet;5;14;A;;465;69;129;175;290;0;0;175;175
8;Barcelona;13;Barcelonès;08245;Santa Coloma de Gramenet;5;14;B;;552;104;187;231;321;3;7;221;228
8;Barcelona;13;Barcelonès;08245;Santa Coloma de Gramenet;5;15;A;;388;73;115;144;244;0;2;142;144
8;Barcelona;13;Barcelonès;08245;Santa Coloma de Gramenet;5;15;B;;461;93;136;179;282;0;2;177;179
8;Barcelona;13;Barcelonès;08245;Santa Coloma de Gramenet;5;16;U;;760;128;237;297;463;2;1;294;295
8;Barcelona;13;Barcelonès;08245;Santa Coloma de Gramenet;5;17;U;;545;89;146;192;353;0;5;187;192
8;Barcelona;13;Barcelonès;08245;Santa Coloma de Gramenet;5;18;A;;331;34;64;78;253;0;1;77;78
8;Barcelona;13;Barcelonès;08245;Santa Coloma de Gramenet;5;18;B;;311;43;71;92;219;0;1;91;92
8;Barcelona;13;Barcelonès;08245;Santa Coloma de Gramenet;5;19;U;;928;201;343;427;501;5;2;420;422
8;Barcelona;13;Barcelonès;08245;Santa Coloma de Gramenet;5;2;A;;469;84;140;200;269;1;5;194;199
8;Barcelona;13;Barcelonès;08245;Santa Coloma de Gramenet;5;2;B;;560;120;211;260;300;2;6;252;258
8;Barcelona;13;Barcelonès;08245;Santa Coloma de Gramenet;5;3;U;;743;140;250;341;402;0;5;336;341
8;Barcelona;13;Barcelonès;08245;Santa Coloma de Gramenet;5;4;U;;619;116;216;290;329;0;0;290;290
8;Barcelona;13;Barcelonès;08245;Santa Coloma de Gramenet;5;5;A;;432;71;129;168;264;1;1;166;167
8;Barcelona;13;Barcelonès;08245;Santa Coloma de Gramenet;5;5;B;;437;76;115;142;295;0;3;139;142
8;Barcelona;13;Barcelonès;08245;Santa Coloma de Gramenet;5;6;U;;673;141;225;276;397;1;4;271;275
8;Barcelona;13;Barcelonès;08245;Santa Coloma de Gramenet;5;7;A;;345;71;123;159;186;0;3;156;159
8;Barcelona;13;Barcelonès;08245;Santa Coloma de Gramenet;5;7;B;;405;78;146;186;219;0;3;183;186
8;Barcelona;13;Barcelonès;08245;Santa Coloma de Gramenet;5;8;U;;644;82;175;228;416;0;7;221;228
8;Barcelona;13;Barcelonès;08245;Santa Coloma de Gramenet;5;9;U;;855;154;252;328;527;1;8;319;327
8;Barcelona;13;Barcelonès;08245;Santa Coloma de Gramenet;6;1;U;;466;109;185;228;238;1;2;225;227
8;Barcelona;13;Barcelonès;08245;Santa Coloma de Gramenet;6;10;U;;515;89;140;167;348;0;2;165;167
8;Barcelona;13;Barcelonès;08245;Santa Coloma de Gramenet;6;11;U;;528;86;149;184;344;0;1;183;184
8;Barcelona;13;Barcelonès;08245;Santa Coloma de Gramenet;6;12;U;;536;101;181;233;303;0;5;228;233
8;Barcelona;13;Barcelonès;08245;Santa Coloma de Gramenet;6;13;U;;421;101;158;206;215;2;3;201;204
8;Barcelona;13;Barcelonès;08245;Santa Coloma de Gramenet;6;14;A;;323;61;103;129;194;0;0;129;129
8;Barcelona;13;Barcelonès;08245;Santa Coloma de Gramenet;6;14;B;;424;98;134;164;260;1;2;161;163
8;Barcelona;13;Barcelonès;08245;Santa Coloma de Gramenet;6;15;U;;360;60;99;132;228;0;2;130;132
8;Barcelona;13;Barcelonès;08245;Santa Coloma de Gramenet;6;16;U;;380;61;100;124;256;1;1;122;123
8;Barcelona;13;Barcelonès;08245;Santa Coloma de Gramenet;6;17;U;;470;83;139;173;297;0;1;172;173
8;Barcelona;13;Barcelonès;08245;Santa Coloma de Gramenet;6;2;U;;681;171;280;336;345;1;6;329;335
8;Barcelona;13;Barcelonès;08245;Santa Coloma de Gramenet;6;3;A;;332;75;122;145;187;0;2;143;145
8;Barcelona;13;Barcelonès;08245;Santa Coloma de Gramenet;6;3;B;;410;87;125;148;262;0;1;147;148
8;Barcelona;13;Barcelonès;08245;Santa Coloma de Gramenet;6;4;A;;309;75;105;144;165;1;5;138;143
8;Barcelona;13;Barcelonès;08245;Santa Coloma de Gramenet;6;4;B;;398;93;151;198;200;0;0;198;198
8;Barcelona;13;Barcelonès;08245;Santa Coloma de Gramenet;6;5;U;;660;170;261;326;334;0;3;323;326
8;Barcelona;13;Barcelonès;08245;Santa Coloma de Gramenet;6;6;U;;525;95;179;225;300;3;4;218;222
8;Barcelona;13;Barcelonès;08245;Santa Coloma de Gramenet;6;7;U;;332;60;109;137;195;0;1;136;137
8;Barcelona;13;Barcelonès;08245;Santa Coloma de Gramenet;6;8;A;;392;77;131;167;225;0;3;164;167
8;Barcelona;13;Barcelonès;08245;Santa Coloma de Gramenet;6;8;B;;395;74;150;193;202;0;9;184;193
8;Barcelona;13;Barcelonès;08245;Santa Coloma de Gramenet;6;9;U;;412;76;125;167;245;0;8;159;167
43;Tarragona;16;Conca de Barberà;43139;Santa Coloma de Queralt;1;1;A;;656;140;360;374;282;3;6;365;371
43;Tarragona;16;Conca de Barberà;43139;Santa Coloma de Queralt;1;1;B;;799;182;377;488;311;7;7;474;481
43;Tarragona;16;Conca de Barberà;43139;Santa Coloma de Queralt;2;1;U;;735;171;337;465;270;1;13;451;464
17;Girona;10;Baix Empordà;17181;Santa Cristina d'Aro;1;1;A;;652;173;323;393;259;0;2;391;393
17;Girona;10;Baix Empordà;17181;Santa Cristina d'Aro;1;1;B;;678;165;309;388;290;0;7;381;388
17;Girona;10;Baix Empordà;17181;Santa Cristina d'Aro;1;2;A;;667;183;339;387;280;4;5;378;383
17;Girona;10;Baix Empordà;17181;Santa Cristina d'Aro;1;2;B;;756;186;338;403;353;2;9;392;401
8;Barcelona;13;Barcelonès;08194;Sant Adrià de Besòs;1;1;A;;534;147;238;291;243;0;5;286;291
8;Barcelona;13;Barcelonès;08194;Sant Adrià de Besòs;1;1;B;;659;167;280;347;312;1;9;337;346
8;Barcelona;13;Barcelonès;08194;Sant Adrià de Besòs;1;2;A;;502;139;226;292;210;0;6;286;292
8;Barcelona;13;Barcelonès;08194;Sant Adrià de Besòs;1;2;B;;606;129;248;336;270;0;8;328;336
8;Barcelona;13;Barcelonès;08194;Sant Adrià de Besòs;1;3;A;;650;142;259;361;289;0;26;335;361
8;Barcelona;13;Barcelonès;08194;Sant Adrià de Besòs;1;3;B;;752;161;295;411;341;0;30;381;411
8;Barcelona;13;Barcelonès;08194;Sant Adrià de Besòs;1;4;A;;642;148;259;333;309;0;8;325;333
8;Barcelona;13;Barcelonès;08194;Sant Adrià de Besòs;1;4;B;;727;160;295;381;346;0;9;372;381
8;Barcelona;13;Barcelonès;08194;Sant Adrià de Besòs;1;5;A;;749;166;296;387;362;1;12;374;386
8;Barcelona;13;Barcelonès;08194;Sant Adrià de Besòs;1;5;B;;773;184;334;419;354;2;9;408;417
8;Barcelona;13;Barcelonès;08194;Sant Adrià de Besòs;1;6;A;;485;101;181;247;238;0;6;241;247
8;Barcelona;13;Barcelonès;08194;Sant Adrià de Besòs;1;6;B;;580;136;241;320;260;0;11;309;320
8;Barcelona;13;Barcelonès;08194;Sant Adrià de Besòs;2;1;A;;532;123;204;250;282;0;5;245;250
8;Barcelona;13;Barcelonès;08194;Sant Adrià de Besòs;2;1;B;;593;123;227;288;305;2;7;279;286
8;Barcelona;13;Barcelonès;08194;Sant Adrià de Besòs;2;2;A;;545;118;183;233;312;0;3;230;233
8;Barcelona;13;Barcelonès;08194;Sant Adrià de Besòs;2;2;B;;651;146;230;290;361;1;5;284;289
8;Barcelona;13;Barcelonès;08194;Sant Adrià de Besòs;2;3;A;;544;112;194;241;303;0;3;238;241
8;Barcelona;13;Barcelonès;08194;Sant Adrià de Besòs;2;3;B;;720;158;250;318;402;3;1;314;315
8;Barcelona;13;Barcelonès;08194;Sant Adrià de Besòs;2;4;A;;511;134;228;284;227;1;2;281;283
8;Barcelona;13;Barcelonès;08194;Sant Adrià de Besòs;2;4;B;;462;106;165;236;226;0;5;231;236
8;Barcelona;13;Barcelonès;08194;Sant Adrià de Besòs;2;4;C;;638;130;194;285;353;1;5;279;284
8;Barcelona;13;Barcelonès;08194;Sant Adrià de Besòs;2;4;D;;514;122;213;239;275;0;4;235;239
8;Barcelona;13;Barcelonès;08194;Sant Adrià de Besòs;3;1;U;;399;98;159;181;218;0;7;174;181
8;Barcelona;13;Barcelonès;08194;Sant Adrià de Besòs;4;1;U;;258;65;104;119;139;0;4;115;119
8;Barcelona;13;Barcelonès;08194;Sant Adrià de Besòs;5;1;A;;591;152;254;305;286;0;7;298;305
8;Barcelona;13;Barcelonès;08194;Sant Adrià de Besòs;5;1;B;;646;146;244;303;343;0;5;298;303
8;Barcelona;13;Barcelonès;08194;Sant Adrià de Besòs;5;2;A;;561;132;205;262;299;1;4;257;261
8;Barcelona;13;Barcelonès;08194;Sant Adrià de Besòs;5;2;B;;611;152;216;273;338;0;6;267;273
8;Barcelona;13;Barcelonès;08194;Sant Adrià de Besòs;5;3;U;;715;190;314;395;320;0;8;387;395
8;Barcelona;13;Barcelonès;08194;Sant Adrià de Besòs;5;4;A;;461;123;208;247;214;0;4;243;247
8;Barcelona;13;Barcelonès;08194;Sant Adrià de Besòs;5;4;B;;497;134;219;266;231;3;3;260;263
8;Barcelona;13;Barcelonès;08194;Sant Adrià de Besòs;6;1;U;;359;55;78;91;268;0;1;90;91
8;Barcelona;13;Barcelonès;08194;Sant Adrià de Besòs;6;2;A;;555;77;113;138;417;0;2;136;138
8;Barcelona;13;Barcelonès;08194;Sant Adrià de Besòs;6;2;B;;483;72;118;144;339;0;6;138;144
8;Barcelona;13;Barcelonès;08194;Sant Adrià de Besòs;6;3;U;;429;59;89;108;321;0;0;108;108
8;Barcelona;13;Barcelonès;08194;Sant Adrià de Besòs;6;4;A;;913;41;82;117;796;0;1;116;117
8;Barcelona;13;Barcelonès;08194;Sant Adrià de Besòs;6;4;B;;498;50;85;113;385;0;1;112;113
8;Barcelona;13;Barcelonès;08194;Sant Adrià de Besòs;6;5;A;;473;118;160;181;292;0;4;177;181
8;Barcelona;13;Barcelonès;08194;Sant Adrià de Besòs;6;5;B;;520;118;189;222;298;2;4;216;220
8;Barcelona;13;Barcelonès;08194;Sant Adrià de Besòs;6;6;A;;619;50;98;116;503;0;0;116;116
8;Barcelona;13;Barcelonès;08194;Sant Adrià de Besòs;6;6;B;;525;62;105;129;396;2;1;126;127
8;Barcelona;13;Barcelonès;08194;Sant Adrià de Besòs;6;7;A;;365;58;93;112;253;0;0;112;112
8;Barcelona;13;Barcelonès;08194;Sant Adrià de Besòs;6;7;B;;389;80;118;144;245;0;4;140;144
8;Barcelona;24;Osona;08246;Santa Eugènia de Berga;1;1;A;;775;214;443;535;240;2;11;522;533
8;Barcelona;24;Osona;08246;Santa Eugènia de Berga;1;1;B;;867;303;524;621;246;5;16;600;616
8;Barcelona;24;Osona;08247;Santa Eulàlia de Riuprimer;1;1;U;;754;208;459;544;210;4;15;525;540
8;Barcelona;41;Vallès Oriental;08248;Santa Eulàlia de Ronçana;1;1;A;;807;182;388;483;324;2;15;466;481
8;Barcelona;41;Vallès Oriental;08248;Santa Eulàlia de Ronçana;1;1;B;;886;190;374;469;417;2;10;457;467
8;Barcelona;41;Vallès Oriental;08248;Santa Eulàlia de Ronçana;1;1;C;;736;189;351;437;299;2;10;425;435
8;Barcelona;41;Vallès Oriental;08248;Santa Eulàlia de Ronçana;1;2;A;;810;164;345;451;359;1;9;441;450
8;Barcelona;41;Vallès Oriental;08248;Santa Eulàlia de Ronçana;1;2;B;;864;207;364;483;381;1;9;473;482
8;Barcelona;41;Vallès Oriental;08248;Santa Eulàlia de Ronçana;1;2;C;;773;190;371;477;296;1;8;468;476
8;Barcelona;3;Alt Penedès;08249;Santa Fe del Penedès;1;1;U;;269;78;165;205;64;1;7;197;204
8;Barcelona;24;Osona;08195;Sant Agustí de Lluçanès;1;1;U;;85;16;45;56;29;0;2;54;56
17;Girona;2;Alt Empordà;17182;Santa Llogaia d'Àlguema;1;1;U;;242;66;104;115;127;0;0;115;115
8;Barcelona;6;Anoia;08250;Santa Margarida de Montbui;1;1;U;;724;200;387;476;248;6;6;464;470
8;Barcelona;6;Anoia;08250;Santa Margarida de Montbui;1;2;A;;820;180;313;410;410;2;9;399;408
8;Barcelona;6;Anoia;08250;Santa Margarida de Montbui;1;2;B;;812;174;285;366;446;2;10;354;364
8;Barcelona;6;Anoia;08250;Santa Margarida de Montbui;1;3;U;;887;151;307;392;495;1;9;382;391
8;Barcelona;6;Anoia;08250;Santa Margarida de Montbui;1;4;U;;727;172;326;392;335;1;4;387;391
8;Barcelona;6;Anoia;08250;Santa Margarida de Montbui;1;5;A;;633;115;211;281;352;1;5;275;280
8;Barcelona;6;Anoia;08250;Santa Margarida de Montbui;1;5;B;;678;123;234;303;375;3;2;298;300
8;Barcelona;6;Anoia;08250;Santa Margarida de Montbui;1;5;C;;640;111;200;276;364;4;2;270;272
8;Barcelona;6;Anoia;08250;Santa Margarida de Montbui;1;6;U;;728;155;261;313;415;2;7;304;311
8;Barcelona;6;Anoia;08250;Santa Margarida de Montbui;1;7;U;;626;143;231;284;342;1;1;282;283
8;Barcelona;3;Alt Penedès;08251;Santa Margarida i els Monjos;1;1;A;;672;162;321;384;288;0;8;376;384
8;Barcelona;3;Alt Penedès;08251;Santa Margarida i els Monjos;1;1;B;;631;149;274;341;290;0;5;336;341
8;Barcelona;3;Alt Penedès;08251;Santa Margarida i els Monjos;1;1;C;;744;183;334;417;327;2;5;410;415
8;Barcelona;3;Alt Penedès;08251;Santa Margarida i els Monjos;1;2;U;;969;225;457;567;402;12;12;543;555
8;Barcelona;3;Alt Penedès;08251;Santa Margarida i els Monjos;1;3;A;;619;132;265;315;304;0;2;313;315
8;Barcelona;3;Alt Penedès;08251;Santa Margarida i els Monjos;1;3;B;;801;188;368;458;343;7;3;448;451
8;Barcelona;;;08258;Santa Maria d'Oló;1;1;U;;909;250;511;623;286;1;11;611;622
8;Barcelona;24;Osona;08253;Santa Maria de Besora;1;1;U;;150;56;86;94;56;1;5;88;93
8;Barcelona;41;Vallès Oriental;08256;Santa Maria de Martorelles;1;1;U;;596;199;334;407;189;0;8;399;407
8;Barcelona;14;Berguedà;08255;Santa Maria de Merlès;1;1;U;;125;30;57;75;50;1;4;70;74
8;Barcelona;6;Anoia;08257;Santa Maria de Miralles;1;1;U;;104;15;34;54;50;0;0;54;54
8;Barcelona;41;Vallès Oriental;08259;Santa Maria de Palautordera;1;1;A;;583;190;311;376;207;4;5;367;372
8;Barcelona;41;Vallès Oriental;08259;Santa Maria de Palautordera;1;1;B;;631;198;313;384;247;0;10;374;384
8;Barcelona;41;Vallès Oriental;08259;Santa Maria de Palautordera;1;1;C;;643;180;332;398;245;0;14;384;398
8;Barcelona;41;Vallès Oriental;08259;Santa Maria de Palautordera;1;2;A;;674;200;374;468;206;1;11;456;467
8;Barcelona;41;Vallès Oriental;08259;Santa Maria de Palautordera;1;2;B;;679;190;336;443;236;2;11;430;441
8;Barcelona;41;Vallès Oriental;08259;Santa Maria de Palautordera;1;2;C;;769;221;391;503;266;0;13;490;503
8;Barcelona;41;Vallès Oriental;08259;Santa Maria de Palautordera;1;2;D;;370;71;137;177;193;1;1;175;176
8;Barcelona;41;Vallès Oriental;08259;Santa Maria de Palautordera;1;3;A;;350;84;162;196;154;1;4;191;195
8;Barcelona;41;Vallès Oriental;08259;Santa Maria de Palautordera;1;3;B;;784;200;397;513;271;5;5;503;508
8;Barcelona;41;Vallès Oriental;08259;Santa Maria de Palautordera;1;3;C;;444;111;207;290;154;4;11;275;286
8;Barcelona;11;Baix Llobregat;08196;Sant Andreu de la Barca;1;1;A;;760;168;274;371;389;2;14;355;369
8;Barcelona;11;Baix Llobregat;08196;Sant Andreu de la Barca;1;1;B;;710;139;230;318;392;0;8;310;318
8;Barcelona;11;Baix Llobregat;08196;Sant Andreu de la Barca;1;1;C;;938;186;330;446;492;0;11;435;446
8;Barcelona;11;Baix Llobregat;08196;Sant Andreu de la Barca;1;1;D;;764;155;255;336;428;0;5;331;336
8;Barcelona;11;Baix Llobregat;08196;Sant Andreu de la Barca;1;2;A;;739;178;258;339;400;0;7;332;339
8;Barcelona;11;Baix Llobregat;08196;Sant Andreu de la Barca;1;2;B;;605;115;191;260;345;0;4;256;260
8;Barcelona;11;Baix Llobregat;08196;Sant Andreu de la Barca;1;2;C;;936;199;318;390;546;2;9;379;388
8;Barcelona;11;Baix Llobregat;08196;Sant Andreu de la Barca;1;2;D;;666;119;190;264;402;0;5;259;264
8;Barcelona;11;Baix Llobregat;08196;Sant Andreu de la Barca;1;3;A;;764;166;261;341;423;0;8;333;341
8;Barcelona;11;Baix Llobregat;08196;Sant Andreu de la Barca;1;3;B;;961;2;369;453;508;1;11;441;452
8;Barcelona;11;Baix Llobregat;08196;Sant Andreu de la Barca;1;3;C;;875;194;330;409;466;2;2;405;407
8;Barcelona;11;Baix Llobregat;08196;Sant Andreu de la Barca;1;4;A;;540;113;191;244;296;1;3;240;243
8;Barcelona;11;Baix Llobregat;08196;Sant Andreu de la Barca;1;4;B;;662;143;241;301;361;0;3;298;301
8;Barcelona;11;Baix Llobregat;08196;Sant Andreu de la Barca;1;5;A;;644;135;241;321;323;1;6;314;320
8;Barcelona;11;Baix Llobregat;08196;Sant Andreu de la Barca;1;5;B;;617;108;234;312;305;0;12;300;312
8;Barcelona;11;Baix Llobregat;08196;Sant Andreu de la Barca;1;5;C;;866;183;341;439;427;2;3;434;437
8;Barcelona;11;Baix Llobregat;08196;Sant Andreu de la Barca;1;5;D;;657;150;246;342;315;0;6;336;342
8;Barcelona;11;Baix Llobregat;08196;Sant Andreu de la Barca;1;6;A;;628;127;236;296;332;2;8;286;294
8;Barcelona;11;Baix Llobregat;08196;Sant Andreu de la Barca;1;6;B;;892;198;334;433;459;5;5;423;428
8;Barcelona;11;Baix Llobregat;08196;Sant Andreu de la Barca;1;6;C;;766;156;284;367;399;0;6;361;367
8;Barcelona;11;Baix Llobregat;08196;Sant Andreu de la Barca;1;7;A;;696;165;263;355;341;2;3;350;353
8;Barcelona;11;Baix Llobregat;08196;Sant Andreu de la Barca;1;7;B;;728;171;315;395;333;2;3;390;393
8;Barcelona;11;Baix Llobregat;08196;Sant Andreu de la Barca;1;8;A;;699;120;235;336;363;0;9;327;336
8;Barcelona;11;Baix Llobregat;08196;Sant Andreu de la Barca;1;8;B;;823;167;277;391;432;0;3;388;391
8;Barcelona;11;Baix Llobregat;08196;Sant Andreu de la Barca;1;8;C;;687;143;261;346;341;4;7;335;342
8;Barcelona;21;Maresme;08197;Sant Andreu de Llavaneres;1;1;A;;709;170;335;420;289;0;9;411;420
8;Barcelona;21;Maresme;08197;Sant Andreu de Llavaneres;1;1;B;;592;148;261;354;238;0;10;344;354
8;Barcelona;21;Maresme;08197;Sant Andreu de Llavaneres;1;2;A;;715;205;356;460;255;2;2;456;458
8;Barcelona;21;Maresme;08197;Sant Andreu de Llavaneres;1;2;B;;675;167;315;415;260;0;8;407;415
8;Barcelona;21;Maresme;08197;Sant Andreu de Llavaneres;1;3;A;;650;168;310;383;267;1;6;376;382
8;Barcelona;21;Maresme;08197;Sant Andreu de Llavaneres;1;3;B;;597;158;285;354;243;1;7;346;353
8;Barcelona;21;Maresme;08197;Sant Andreu de Llavaneres;2;1;A;;532;162;281;337;195;0;4;333;337
8;Barcelona;21;Maresme;08197;Sant Andreu de Llavaneres;2;1;B;;577;161;286;341;236;2;3;336;339
8;Barcelona;21;Maresme;08197;Sant Andreu de Llavaneres;2;2;A;;476;122;236;285;191;0;8;277;285
8;Barcelona;21;Maresme;08197;Sant Andreu de Llavaneres;2;2;B;;560;158;276;346;214;1;10;335;345
8;Barcelona;21;Maresme;08197;Sant Andreu de Llavaneres;2;3;U;;734;217;377;479;255;0;7;472;479
17;Girona;20;Gironès;17157;Sant Andreu Salou;1;1;U;;120;52;85;94;26;0;0;94;94
17;Girona;19;Garrotxa;17183;Sant Aniol de Finestres;1;1;U;;226;66;130;162;64;0;2;160;162
8;Barcelona;41;Vallès Oriental;08198;Sant Antoni de Vilamajor;1;1;A;;695;178;354;470;225;2;8;460;468
8;Barcelona;41;Vallès Oriental;08198;Sant Antoni de Vilamajor;1;1;B;;700;169;330;434;266;1;10;423;433
8;Barcelona;41;Vallès Oriental;08198;Sant Antoni de Vilamajor;1;1;C;;717;173;334;443;274;0;11;432;443
8;Barcelona;41;Vallès Oriental;08198;Sant Antoni de Vilamajor;1;2;A;;798;191;327;438;360;1;9;428;437
8;Barcelona;41;Vallès Oriental;08198;Sant Antoni de Vilamajor;1;2;B;;774;194;345;447;327;2;6;439;445
43;Tarragona;12;Baix Penedès;43140;Santa Oliva;1;1;A;;765;183;334;436;329;4;12;420;432
43;Tarragona;12;Baix Penedès;43140;Santa Oliva;1;1;B;;1090;237;372;474;616;0;7;467;474
43;Tarragona;12;Baix Penedès;43140;Santa Oliva;1;1;C;;298;75;115;140;158;2;1;137;138
17;Girona;19;Garrotxa;17184;Santa Pau;1;1;A;;635;171;328;402;233;4;4;394;398
17;Girona;19;Garrotxa;17184;Santa Pau;1;1;B;;672;183;329;401;271;2;11;388;399
8;Barcelona;40;Vallès Occidental;08260;Santa Perpètua de Mogoda;1;1;A;;554;122;200;247;307;1;9;237;246
8;Barcelona;40;Vallès Occidental;08260;Santa Perpètua de Mogoda;1;1;B;;576;127;225;285;291;1;5;279;284
8;Barcelona;40;Vallès Occidental;08260;Santa Perpètua de Mogoda;1;10;U;;724;168;330;417;307;0;8;409;417
8;Barcelona;40;Vallès Occidental;08260;Santa Perpètua de Mogoda;1;11;U;;873;223;370;467;406;0;7;460;467
8;Barcelona;40;Vallès Occidental;08260;Santa Perpètua de Mogoda;1;12;A;;611;131;238;302;309;1;3;298;301
8;Barcelona;40;Vallès Occidental;08260;Santa Perpètua de Mogoda;1;12;B;;841;168;296;404;437;3;14;387;401
8;Barcelona;40;Vallès Occidental;08260;Santa Perpètua de Mogoda;1;12;C;;607;124;213;285;322;0;6;279;285
8;Barcelona;40;Vallès Occidental;08260;Santa Perpètua de Mogoda;1;13;A;;771;157;303;408;363;0;12;396;408
8;Barcelona;40;Vallès Occidental;08260;Santa Perpètua de Mogoda;1;13;B;;855;163;325;452;403;1;13;438;451
8;Barcelona;40;Vallès Occidental;08260;Santa Perpètua de Mogoda;1;2;A;;634;160;261;326;308;0;5;321;326
8;Barcelona;40;Vallès Occidental;08260;Santa Perpètua de Mogoda;1;2;B;;727;146;278;336;391;1;3;332;335
8;Barcelona;40;Vallès Occidental;08260;Santa Perpètua de Mogoda;1;2;C;;608;128;246;303;305;0;6;297;303
8;Barcelona;40;Vallès Occidental;08260;Santa Perpètua de Mogoda;1;3;A;;767;175;321;432;335;2;10;420;430
8;Barcelona;40;Vallès Occidental;08260;Santa Perpètua de Mogoda;1;3;B;;854;195;355;476;378;0;9;467;476
8;Barcelona;40;Vallès Occidental;08260;Santa Perpètua de Mogoda;1;4;A;;636;111;187;231;405;1;4;226;230
8;Barcelona;40;Vallès Occidental;08260;Santa Perpètua de Mogoda;1;4;B;;605;93;183;243;362;0;3;240;243
8;Barcelona;40;Vallès Occidental;08260;Santa Perpètua de Mogoda;1;5;A;;519;87;179;232;287;0;7;225;232
8;Barcelona;40;Vallès Occidental;08260;Santa Perpètua de Mogoda;1;5;B;;527;97;180;229;298;0;6;223;229
8;Barcelona;40;Vallès Occidental;08260;Santa Perpètua de Mogoda;1;6;U;;785;164;322;371;414;2;6;363;369
8;Barcelona;40;Vallès Occidental;08260;Santa Perpètua de Mogoda;1;7;U;;1001;209;398;478;523;3;8;467;475
8;Barcelona;40;Vallès Occidental;08260;Santa Perpètua de Mogoda;1;8;A;;593;104;203;260;333;1;2;257;259
8;Barcelona;40;Vallès Occidental;08260;Santa Perpètua de Mogoda;1;8;B;;721;121;244;325;396;2;10;313;323
8;Barcelona;40;Vallès Occidental;08260;Santa Perpètua de Mogoda;1;9;A;;600;133;235;328;272;0;7;321;328
8;Barcelona;40;Vallès Occidental;08260;Santa Perpètua de Mogoda;1;9;B;;718;135;275;365;353;0;6;359;365
8;Barcelona;40;Vallès Occidental;08260;Santa Perpètua de Mogoda;1;9;C;;569;115;205;298;271;0;5;293;298
8;Barcelona;21;Maresme;08261;Santa Susanna;1;1;A;;973;263;444;553;420;1;8;544;552
8;Barcelona;21;Maresme;08261;Santa Susanna;1;1;B;;1146;336;551;665;481;1;12;652;664
8;Barcelona;24;Osona;08199;Sant Bartomeu del Grau;1;1;U;;708;189;380;456;252;4;15;437;452
8;Barcelona;11;Baix Llobregat;08200;Sant Boi de Llobregat;1;1;A;;363;95;147;178;185;0;4;174;178
8;Barcelona;11;Baix Llobregat;08200;Sant Boi de Llobregat;1;1;B;;386;106;172;196;190;1;7;188;195
8;Barcelona;11;Baix Llobregat;08200;Sant Boi de Llobregat;1;2;A;;561;172;247;293;268;1;3;289;292
8;Barcelona;11;Baix Llobregat;08200;Sant Boi de Llobregat;1;2;B;;655;169;271;318;337;0;8;310;318
8;Barcelona;11;Baix Llobregat;08200;Sant Boi de Llobregat;1;3;A;;434;130;221;262;172;1;4;257;261
8;Barcelona;11;Baix Llobregat;08200;Sant Boi de Llobregat;1;3;B;;457;152;214;248;209;1;3;244;247
8;Barcelona;11;Baix Llobregat;08200;Sant Boi de Llobregat;1;4;A;;611;154;242;309;302;1;6;302;308
8;Barcelona;11;Baix Llobregat;08200;Sant Boi de Llobregat;1;4;B;;724;169;263;339;385;3;8;328;336
8;Barcelona;11;Baix Llobregat;08200;Sant Boi de Llobregat;1;5;A;;656;121;205;256;400;0;2;254;256
8;Barcelona;11;Baix Llobregat;08200;Sant Boi de Llobregat;1;5;B;;767;128;199;260;507;0;2;258;260
8;Barcelona;11;Baix Llobregat;08200;Sant Boi de Llobregat;1;6;A;;313;89;129;157;156;0;6;151;157
8;Barcelona;11;Baix Llobregat;08200;Sant Boi de Llobregat;1;6;B;;462;126;195;233;229;0;3;230;233
8;Barcelona;11;Baix Llobregat;08200;Sant Boi de Llobregat;1;7;A;;434;101;195;228;206;0;2;226;228
8;Barcelona;11;Baix Llobregat;08200;Sant Boi de Llobregat;1;7;B;;486;131;221;262;224;0;6;256;262
8;Barcelona;11;Baix Llobregat;08200;Sant Boi de Llobregat;2;1;A;;592;134;258;347;245;2;6;339;345
8;Barcelona;11;Baix Llobregat;08200;Sant Boi de Llobregat;2;1;B;;707;170;320;417;290;4;13;400;413
8;Barcelona;11;Baix Llobregat;08200;Sant Boi de Llobregat;2;1;C;;618;131;250;318;300;1;6;311;317
8;Barcelona;11;Baix Llobregat;08200;Sant Boi de Llobregat;2;10;A;;509;102;180;241;268;0;2;239;241
8;Barcelona;11;Baix Llobregat;08200;Sant Boi de Llobregat;2;10;B;;581;140;230;295;286;1;12;282;294
8;Barcelona;11;Baix Llobregat;08200;Sant Boi de Llobregat;2;10;C;;602;131;217;279;323;2;8;269;277
8;Barcelona;11;Baix Llobregat;08200;Sant Boi de Llobregat;2;11;A;;626;138;243;334;292;0;8;326;334
8;Barcelona;11;Baix Llobregat;08200;Sant Boi de Llobregat;2;11;B;;765;149;318;427;338;0;6;421;427
8;Barcelona;11;Baix Llobregat;08200;Sant Boi de Llobregat;2;12;A;;576;114;204;263;313;2;11;250;261
8;Barcelona;11;Baix Llobregat;08200;Sant Boi de Llobregat;2;12;B;;716;149;259;338;378;0;10;328;338
8;Barcelona;11;Baix Llobregat;08200;Sant Boi de Llobregat;2;12;C;;573;120;205;269;304;1;5;263;268
8;Barcelona;11;Baix Llobregat;08200;Sant Boi de Llobregat;2;13;A;;382;107;195;241;141;0;5;236;241
8;Barcelona;11;Baix Llobregat;08200;Sant Boi de Llobregat;2;13;B;;356;78;162;223;133;0;5;218;223
8;Barcelona;11;Baix Llobregat;08200;Sant Boi de Llobregat;2;13;C;;420;96;219;278;142;0;4;274;278
8;Barcelona;11;Baix Llobregat;08200;Sant Boi de Llobregat;2;14;A;;617;123;212;287;330;0;8;279;287
8;Barcelona;11;Baix Llobregat;08200;Sant Boi de Llobregat;2;14;B;;716;128;232;302;414;2;9;291;300
8;Barcelona;11;Baix Llobregat;08200;Sant Boi de Llobregat;2;15;A;;503;90;153;200;303;0;3;197;200
8;Barcelona;11;Baix Llobregat;08200;Sant Boi de Llobregat;2;15;B;;527;104;170;214;313;1;0;213;213
8;Barcelona;11;Baix Llobregat;08200;Sant Boi de Llobregat;2;15;C;;541;127;180;225;316;1;6;218;224
8;Barcelona;11;Baix Llobregat;08200;Sant Boi de Llobregat;2;16;A;;489;93;192;260;229;2;5;253;258
8;Barcelona;11;Baix Llobregat;08200;Sant Boi de Llobregat;2;16;B;;669;134;272;374;295;2;12;360;372
8;Barcelona;11;Baix Llobregat;08200;Sant Boi de Llobregat;2;17;A;;545;104;228;297;248;1;4;292;296
8;Barcelona;11;Baix Llobregat;08200;Sant Boi de Llobregat;2;17;B;;598;115;218;313;285;1;8;304;312
8;Barcelona;11;Baix Llobregat;08200;Sant Boi de Llobregat;2;18;A;;497;117;223;293;204;0;4;289;293
8;Barcelona;11;Baix Llobregat;08200;Sant Boi de Llobregat;2;18;B;;569;116;242;320;249;0;11;309;320
8;Barcelona;11;Baix Llobregat;08200;Sant Boi de Llobregat;2;19;U;;641;159;277;358;283;3;6;349;355
8;Barcelona;11;Baix Llobregat;08200;Sant Boi de Llobregat;2;2;A;;678;128;227;323;355;2;9;312;321
8;Barcelona;11;Baix Llobregat;08200;Sant Boi de Llobregat;2;2;B;;771;145;265;326;445;2;7;317;324
8;Barcelona;11;Baix Llobregat;08200;Sant Boi de Llobregat;2;3;A;;369;84;137;170;199;0;0;170;170
8;Barcelona;11;Baix Llobregat;08200;Sant Boi de Llobregat;2;3;B;;489;108;185;235;254;0;5;230;235
8;Barcelona;11;Baix Llobregat;08200;Sant Boi de Llobregat;2;3;C;;564;101;183;224;340;0;5;219;224
8;Barcelona;11;Baix Llobregat;08200;Sant Boi de Llobregat;2;4;A;;470;100;179;220;250;0;3;217;220
8;Barcelona;11;Baix Llobregat;08200;Sant Boi de Llobregat;2;4;B;;508;111;191;248;260;2;3;243;246
8;Barcelona;11;Baix Llobregat;08200;Sant Boi de Llobregat;2;5;A;;472;118;184;225;247;3;7;215;222
8;Barcelona;11;Baix Llobregat;08200;Sant Boi de Llobregat;2;5;B;;596;160;256;307;289;0;10;297;307
8;Barcelona;11;Baix Llobregat;08200;Sant Boi de Llobregat;2;6;A;;351;67;122;166;185;0;3;163;166
8;Barcelona;11;Baix Llobregat;08200;Sant Boi de Llobregat;2;6;B;;421;83;140;187;234;1;2;184;186
8;Barcelona;11;Baix Llobregat;08200;Sant Boi de Llobregat;2;6;C;;469;104;182;231;238;0;7;224;231
8;Barcelona;11;Baix Llobregat;08200;Sant Boi de Llobregat;2;7;A;;377;82;121;167;210;0;5;162;167
8;Barcelona;11;Baix Llobregat;08200;Sant Boi de Llobregat;2;7;B;;465;116;197;241;224;0;4;237;241
8;Barcelona;11;Baix Llobregat;08200;Sant Boi de Llobregat;2;8;A;;540;131;248;319;221;0;6;313;319
8;Barcelona;11;Baix Llobregat;08200;Sant Boi de Llobregat;2;8;B;;642;186;304;379;263;2;6;371;377
8;Barcelona;11;Baix Llobregat;08200;Sant Boi de Llobregat;2;9;A;;581;148;245;303;278;2;6;295;301
8;Barcelona;11;Baix Llobregat;08200;Sant Boi de Llobregat;2;9;B;;641;154;243;301;340;4;5;292;297
8;Barcelona;11;Baix Llobregat;08200;Sant Boi de Llobregat;3;1;A;;574;162;302;351;223;1;10;340;350
8;Barcelona;11;Baix Llobregat;08200;Sant Boi de Llobregat;3;1;B;;606;157;297;369;237;0;7;362;369
8;Barcelona;11;Baix Llobregat;08200;Sant Boi de Llobregat;3;2;A;;650;168;284;363;287;0;10;353;363
8;Barcelona;11;Baix Llobregat;08200;Sant Boi de Llobregat;3;2;B;;790;177;343;429;361;0;7;422;429
8;Barcelona;11;Baix Llobregat;08200;Sant Boi de Llobregat;3;3;A;;458;120;202;256;202;1;0;255;255
8;Barcelona;11;Baix Llobregat;08200;Sant Boi de Llobregat;3;3;B;;514;129;193;270;244;0;5;265;270
8;Barcelona;11;Baix Llobregat;08200;Sant Boi de Llobregat;3;3;C;;604;130;261;324;280;0;7;317;324
8;Barcelona;11;Baix Llobregat;08200;Sant Boi de Llobregat;3;4;U;;647;172;290;376;271;2;10;364;374
8;Barcelona;11;Baix Llobregat;08200;Sant Boi de Llobregat;3;5;A;;484;137;223;286;198;2;0;284;284
8;Barcelona;11;Baix Llobregat;08200;Sant Boi de Llobregat;3;5;B;;564;149;266;327;237;1;4;322;326
8;Barcelona;11;Baix Llobregat;08200;Sant Boi de Llobregat;3;5;C;;627;167;299;365;262;0;8;357;365
8;Barcelona;11;Baix Llobregat;08200;Sant Boi de Llobregat;3;6;A;;508;129;224;289;219;0;6;283;289
8;Barcelona;11;Baix Llobregat;08200;Sant Boi de Llobregat;3;6;B;;599;143;273;342;257;2;4;336;340
8;Barcelona;11;Baix Llobregat;08200;Sant Boi de Llobregat;3;7;A;;531;126;234;290;241;0;5;285;290
8;Barcelona;11;Baix Llobregat;08200;Sant Boi de Llobregat;3;7;B;;565;115;212;280;285;0;12;268;280
8;Barcelona;11;Baix Llobregat;08200;Sant Boi de Llobregat;3;7;C;;596;176;293;358;238;1;8;349;357
8;Barcelona;11;Baix Llobregat;08200;Sant Boi de Llobregat;3;8;U;;556;135;248;304;252;0;1;303;304
8;Barcelona;11;Baix Llobregat;08200;Sant Boi de Llobregat;3;9;A;;415;127;189;225;190;0;0;225;225
8;Barcelona;11;Baix Llobregat;08200;Sant Boi de Llobregat;3;9;B;;564;176;248;290;274;0;6;284;290
8;Barcelona;11;Baix Llobregat;08200;Sant Boi de Llobregat;4;1;A;;481;90;176;222;259;2;2;218;220
8;Barcelona;11;Baix Llobregat;08200;Sant Boi de Llobregat;4;1;B;;513;103;205;266;247;0;4;262;266
8;Barcelona;11;Baix Llobregat;08200;Sant Boi de Llobregat;4;1;C;;570;109;209;264;306;0;1;263;264
8;Barcelona;11;Baix Llobregat;08200;Sant Boi de Llobregat;4;2;A;;483;111;198;257;226;1;2;254;256
8;Barcelona;11;Baix Llobregat;08200;Sant Boi de Llobregat;4;2;B;;557;111;218;298;259;1;5;292;297
8;Barcelona;11;Baix Llobregat;08200;Sant Boi de Llobregat;4;2;C;;555;140;246;312;243;1;4;307;311
8;Barcelona;11;Baix Llobregat;08200;Sant Boi de Llobregat;4;3;A;;473;113;188;254;219;3;2;249;251
8;Barcelona;11;Baix Llobregat;08200;Sant Boi de Llobregat;4;3;B;;573;117;207;304;269;0;4;300;304
8;Barcelona;11;Baix Llobregat;08200;Sant Boi de Llobregat;4;4;A;;477;131;201;251;226;0;3;248;251
8;Barcelona;11;Baix Llobregat;08200;Sant Boi de Llobregat;4;4;B;;634;151;244;326;308;1;6;319;325
8;Barcelona;11;Baix Llobregat;08200;Sant Boi de Llobregat;4;5;A;;594;121;242;315;279;0;5;310;315
8;Barcelona;11;Baix Llobregat;08200;Sant Boi de Llobregat;4;5;B;;696;144;269;349;347;1;4;344;348
8;Barcelona;11;Baix Llobregat;08200;Sant Boi de Llobregat;4;6;A;;474;107;172;213;261;1;6;206;212
8;Barcelona;11;Baix Llobregat;08200;Sant Boi de Llobregat;4;6;B;;657;124;217;286;371;2;13;271;284
8;Barcelona;11;Baix Llobregat;08200;Sant Boi de Llobregat;4;6;C;;529;117;187;242;287;0;6;236;242
8;Barcelona;11;Baix Llobregat;08200;Sant Boi de Llobregat;4;7;A;;732;162;264;335;397;0;9;326;335
8;Barcelona;11;Baix Llobregat;08200;Sant Boi de Llobregat;4;7;B;;801;195;320;418;383;0;9;409;418
8;Barcelona;11;Baix Llobregat;08200;Sant Boi de Llobregat;4;8;A;;669;128;236;314;355;2;3;309;312
8;Barcelona;11;Baix Llobregat;08200;Sant Boi de Llobregat;4;8;B;;821;147;270;378;443;1;16;361;377
8;Barcelona;11;Baix Llobregat;08200;Sant Boi de Llobregat;4;9;A;;461;93;178;240;221;1;3;236;239
8;Barcelona;11;Baix Llobregat;08200;Sant Boi de Llobregat;4;9;B;;488;102;180;245;243;1;3;241;244
8;Barcelona;11;Baix Llobregat;08200;Sant Boi de Llobregat;5;1;A;;430;91;135;180;250;3;2;175;177
8;Barcelona;11;Baix Llobregat;08200;Sant Boi de Llobregat;5;1;B;;522;109;161;206;316;0;2;204;206
8;Barcelona;11;Baix Llobregat;08200;Sant Boi de Llobregat;5;1;C;;559;122;185;228;331;1;2;225;227
8;Barcelona;11;Baix Llobregat;08200;Sant Boi de Llobregat;5;2;A;;401;61;105;132;269;0;4;128;132
8;Barcelona;11;Baix Llobregat;08200;Sant Boi de Llobregat;5;2;B;;479;105;175;199;280;0;4;195;199
8;Barcelona;11;Baix Llobregat;08200;Sant Boi de Llobregat;5;3;U;;518;89;154;180;338;0;2;178;180
8;Barcelona;11;Baix Llobregat;08200;Sant Boi de Llobregat;5;4;A;;334;59;107;140;194;0;2;138;140
8;Barcelona;11;Baix Llobregat;08200;Sant Boi de Llobregat;5;4;B;;417;100;151;183;234;1;1;181;182
8;Barcelona;11;Baix Llobregat;08200;Sant Boi de Llobregat;6;1;A;;439;84;150;198;241;0;3;195;198
8;Barcelona;11;Baix Llobregat;08200;Sant Boi de Llobregat;6;1;B;;622;126;204;277;345;0;8;269;277
8;Barcelona;11;Baix Llobregat;08200;Sant Boi de Llobregat;6;1;C;;620;116;210;276;344;0;5;271;276
8;Barcelona;11;Baix Llobregat;08200;Sant Boi de Llobregat;6;2;A;;405;79;162;208;197;0;4;204;208
8;Barcelona;11;Baix Llobregat;08200;Sant Boi de Llobregat;6;2;B;;515;117;198;249;266;3;4;242;246
8;Barcelona;11;Baix Llobregat;08200;Sant Boi de Llobregat;6;2;C;;538;103;194;244;294;1;3;240;243
8;Barcelona;11;Baix Llobregat;08200;Sant Boi de Llobregat;6;3;A;;438;92;154;184;254;1;4;179;183
8;Barcelona;11;Baix Llobregat;08200;Sant Boi de Llobregat;6;3;B;;478;100;171;217;261;0;0;217;217
8;Barcelona;24;Osona;08201;Sant Boi de Lluçanès;1;1;U;;490;127;276;341;149;4;6;331;337
43;Tarragona;22;Montsià;43136;Sant Carles de la Ràpita;1;1;A;;713;145;265;362;351;3;4;355;359
43;Tarragona;22;Montsià;43136;Sant Carles de la Ràpita;1;1;B;;808;181;349;423;385;1;5;417;422
43;Tarragona;22;Montsià;43136;Sant Carles de la Ràpita;1;2;A;;469;104;180;234;235;2;5;227;232
43;Tarragona;22;Montsià;43136;Sant Carles de la Ràpita;1;2;B;;506;141;205;265;241;2;5;258;263
43;Tarragona;22;Montsià;43136;Sant Carles de la Ràpita;1;3;A;;481;106;207;258;223;1;4;253;257
43;Tarragona;22;Montsià;43136;Sant Carles de la Ràpita;1;3;B;;493;104;187;243;250;0;3;240;243
43;Tarragona;22;Montsià;43136;Sant Carles de la Ràpita;1;4;A;;720;161;292;364;356;0;7;357;364
43;Tarragona;22;Montsià;43136;Sant Carles de la Ràpita;1;4;B;;723;153;274;354;369;0;5;349;354
43;Tarragona;22;Montsià;43136;Sant Carles de la Ràpita;1;5;U;;812;179;309;379;433;1;4;374;378
43;Tarragona;22;Montsià;43136;Sant Carles de la Ràpita;2;1;U;;664;166;282;355;309;0;2;353;355
43;Tarragona;22;Montsià;43136;Sant Carles de la Ràpita;2;2;U;;622;176;302;350;272;0;1;349;350
43;Tarragona;22;Montsià;43136;Sant Carles de la Ràpita;2;3;U;;815;203;350;408;407;1;12;395;407
43;Tarragona;22;Montsià;43136;Sant Carles de la Ràpita;2;4;A;;721;165;295;382;339;0;2;380;382
43;Tarragona;22;Montsià;43136;Sant Carles de la Ràpita;2;4;B;;507;95;185;244;263;0;3;241;244
43;Tarragona;22;Montsià;43136;Sant Carles de la Ràpita;2;4;C;;677;145;250;351;326;1;8;342;350
8;Barcelona;21;Maresme;08203;Sant Cebrià de Vallalta;1;1;A;;705;182;340;406;299;1;7;398;405
8;Barcelona;21;Maresme;08203;Sant Cebrià de Vallalta;1;1;B;;698;190;318;386;312;2;11;373;384
8;Barcelona;21;Maresme;08203;Sant Cebrià de Vallalta;1;1;C;;840;195;348;443;397;0;9;434;443
8;Barcelona;41;Vallès Oriental;08202;Sant Celoni;1;1;A;;658;231;387;472;186;1;15;456;471
8;Barcelona;41;Vallès Oriental;08202;Sant Celoni;1;1;B;;666;201;345;435;231;0;3;432;435
8;Barcelona;41;Vallès Oriental;08202;Sant Celoni;1;1;C;;718;217;401;496;222;1;8;487;495
8;Barcelona;41;Vallès Oriental;08202;Sant Celoni;1;2;A;;652;216;377;455;197;1;4;450;454
8;Barcelona;41;Vallès Oriental;08202;Sant Celoni;1;2;B;;616;146;300;394;222;1;6;387;393
8;Barcelona;41;Vallès Oriental;08202;Sant Celoni;1;2;C;;655;216;382;467;188;0;11;456;467
8;Barcelona;41;Vallès Oriental;08202;Sant Celoni;1;3;A;;812;222;408;512;300;2;12;498;510
8;Barcelona;41;Vallès Oriental;08202;Sant Celoni;1;3;B;;1057;282;502;613;444;2;13;598;611
8;Barcelona;41;Vallès Oriental;08202;Sant Celoni;1;4;A;;246;64;117;141;105;1;2;138;140
8;Barcelona;41;Vallès Oriental;08202;Sant Celoni;1;4;B;;370;91;172;200;170;0;3;197;200
8;Barcelona;41;Vallès Oriental;08202;Sant Celoni;1;5;A;;776;206;384;476;300;0;10;466;476
8;Barcelona;41;Vallès Oriental;08202;Sant Celoni;1;5;B;;1014;240;474;603;411;4;17;582;599
8;Barcelona;41;Vallès Oriental;08202;Sant Celoni;1;6;A;;612;153;308;392;220;0;9;383;392
8;Barcelona;41;Vallès Oriental;08202;Sant Celoni;1;6;B;;773;221;388;459;314;3;6;450;456
8;Barcelona;41;Vallès Oriental;08202;Sant Celoni;1;7;A;;401;86;193;241;160;1;3;237;240
8;Barcelona;41;Vallès Oriental;08202;Sant Celoni;1;7;B;;493;114;232;279;214;0;1;278;279
8;Barcelona;41;Vallès Oriental;08202;Sant Celoni;2;1;A;;669;160;319;369;300;0;5;364;369
8;Barcelona;41;Vallès Oriental;08202;Sant Celoni;2;1;B;;526;125;238;289;237;1;6;282;288
8;Barcelona;11;Baix Llobregat;08204;Sant Climent de Llobregat;1;1;A;;635;121;278;386;249;2;11;373;384
8;Barcelona;11;Baix Llobregat;08204;Sant Climent de Llobregat;1;1;B;;799;165;391;546;253;0;9;537;546
8;Barcelona;11;Baix Llobregat;08204;Sant Climent de Llobregat;1;2;A;;599;107;231;326;273;5;6;315;321
8;Barcelona;11;Baix Llobregat;08204;Sant Climent de Llobregat;1;2;B;;813;180;345;464;349;1;10;453;463
17;Girona;2;Alt Empordà;17158;Sant Climent Sescebes;1;1;U;;369;125;212;239;130;0;3;236;239
8;Barcelona;40;Vallès Occidental;08205;Sant Cugat del Vallès;1;1;A;;707;207;349;449;258;2;7;440;447
8;Barcelona;40;Vallès Occidental;08205;Sant Cugat del Vallès;1;1;B;;675;190;313;402;273;0;7;395;402
8;Barcelona;40;Vallès Occidental;08205;Sant Cugat del Vallès;1;10;A;;471;116;215;283;188;5;11;267;278
8;Barcelona;40;Vallès Occidental;08205;Sant Cugat del Vallès;1;10;B;;556;139;230;303;253;1;8;294;302
8;Barcelona;40;Vallès Occidental;08205;Sant Cugat del Vallès;1;11;A;;899;248;499;634;265;1;9;624;633
8;Barcelona;40;Vallès Occidental;08205;Sant Cugat del Vallès;1;11;B;;938;271;477;614;324;0;13;601;614
8;Barcelona;40;Vallès Occidental;08205;Sant Cugat del Vallès;1;11;C;;974;281;519;686;288;2;18;666;684
8;Barcelona;40;Vallès Occidental;08205;Sant Cugat del Vallès;1;12;A;;776;251;428;547;229;1;19;527;546
8;Barcelona;40;Vallès Occidental;08205;Sant Cugat del Vallès;1;12;B;;793;264;453;547;246;1;11;535;546
8;Barcelona;40;Vallès Occidental;08205;Sant Cugat del Vallès;1;2;A;;536;186;289;357;179;1;11;345;356
8;Barcelona;40;Vallès Occidental;08205;Sant Cugat del Vallès;1;2;B;;502;168;275;337;165;1;9;327;336
8;Barcelona;40;Vallès Occidental;08205;Sant Cugat del Vallès;1;3;A;;832;258;453;549;283;1;7;541;548
8;Barcelona;40;Vallès Occidental;08205;Sant Cugat del Vallès;1;3;B;;865;232;446;572;293;2;8;562;570
8;Barcelona;40;Vallès Occidental;08205;Sant Cugat del Vallès;1;4;A;;668;192;370;471;197;1;10;460;470
8;Barcelona;40;Vallès Occidental;08205;Sant Cugat del Vallès;1;4;B;;711;221;384;485;226;3;18;464;482
8;Barcelona;40;Vallès Occidental;08205;Sant Cugat del Vallès;1;5;A;;1484;366;821;1034;450;2;22;1010;1032
8;Barcelona;40;Vallès Occidental;08205;Sant Cugat del Vallès;1;5;B;;1006;252;554;699;307;1;16;682;698
8;Barcelona;40;Vallès Occidental;08205;Sant Cugat del Vallès;1;5;C;;1101;271;579;740;361;2;8;730;738
8;Barcelona;40;Vallès Occidental;08205;Sant Cugat del Vallès;1;5;D;;974;265;514;679;295;2;12;665;677
8;Barcelona;40;Vallès Occidental;08205;Sant Cugat del Vallès;1;5;E;;858;232;484;617;241;1;13;603;616
8;Barcelona;40;Vallès Occidental;08205;Sant Cugat del Vallès;1;6;A;;567;155;268;336;231;0;10;326;336
8;Barcelona;40;Vallès Occidental;08205;Sant Cugat del Vallès;1;6;B;;756;161;346;435;321;1;9;425;434
8;Barcelona;40;Vallès Occidental;08205;Sant Cugat del Vallès;1;6;C;;563;149;270;337;226;2;3;332;335
8;Barcelona;40;Vallès Occidental;08205;Sant Cugat del Vallès;1;7;A;;705;192;344;419;286;1;13;405;418
8;Barcelona;40;Vallès Occidental;08205;Sant Cugat del Vallès;1;7;B;;839;223;373;475;364;4;6;465;471
8;Barcelona;40;Vallès Occidental;08205;Sant Cugat del Vallès;1;8;A;;660;171;301;393;267;0;8;385;393
8;Barcelona;40;Vallès Occidental;08205;Sant Cugat del Vallès;1;8;B;;817;225;390;504;313;6;11;487;498
8;Barcelona;40;Vallès Occidental;08205;Sant Cugat del Vallès;1;9;A;;601;193;371;456;145;0;12;444;456
8;Barcelona;40;Vallès Occidental;08205;Sant Cugat del Vallès;1;9;B;;619;205;374;487;132;3;11;473;484
8;Barcelona;40;Vallès Occidental;08205;Sant Cugat del Vallès;2;1;A;;666;204;400;500;166;1;13;486;499
8;Barcelona;40;Vallès Occidental;08205;Sant Cugat del Vallès;2;1;B;;557;164;319;424;133;0;14;410;424
8;Barcelona;40;Vallès Occidental;08205;Sant Cugat del Vallès;2;1;C;;626;185;376;475;151;1;9;465;474
8;Barcelona;40;Vallès Occidental;08205;Sant Cugat del Vallès;2;2;A;;660;211;351;441;219;1;10;430;440
8;Barcelona;40;Vallès Occidental;08205;Sant Cugat del Vallès;2;2;B;;694;243;412;492;202;2;8;482;490
8;Barcelona;40;Vallès Occidental;08205;Sant Cugat del Vallès;2;3;U;;894;258;433;558;336;5;12;541;553
8;Barcelona;40;Vallès Occidental;08205;Sant Cugat del Vallès;2;4;A;;449;130;212;283;166;0;11;272;283
8;Barcelona;40;Vallès Occidental;08205;Sant Cugat del Vallès;2;4;B;;496;148;255;347;149;0;10;337;347
8;Barcelona;40;Vallès Occidental;08205;Sant Cugat del Vallès;2;5;A;;474;129;218;269;205;2;7;260;267
8;Barcelona;40;Vallès Occidental;08205;Sant Cugat del Vallès;2;5;B;;493;134;215;282;211;1;6;275;281
8;Barcelona;40;Vallès Occidental;08205;Sant Cugat del Vallès;2;6;A;;570;177;336;430;140;2;11;417;428
8;Barcelona;40;Vallès Occidental;08205;Sant Cugat del Vallès;2;6;B;;593;165;339;447;146;0;19;428;447
8;Barcelona;40;Vallès Occidental;08205;Sant Cugat del Vallès;2;6;C;;812;240;466;575;237;2;6;567;573
8;Barcelona;40;Vallès Occidental;08205;Sant Cugat del Vallès;2;7;A;;529;170;280;357;172;1;12;344;356
8;Barcelona;40;Vallès Occidental;08205;Sant Cugat del Vallès;2;7;B;;608;191;328;407;201;0;11;396;407
8;Barcelona;40;Vallès Occidental;08205;Sant Cugat del Vallès;2;8;A;;1011;308;602;764;247;2;18;744;762
8;Barcelona;40;Vallès Occidental;08205;Sant Cugat del Vallès;2;8;B;;766;242;441;569;197;0;12;557;569
8;Barcelona;40;Vallès Occidental;08205;Sant Cugat del Vallès;2;8;C;;877;261;507;649;228;3;21;625;646
8;Barcelona;40;Vallès Occidental;08205;Sant Cugat del Vallès;2;8;D;;881;276;533;683;198;0;16;667;683
8;Barcelona;40;Vallès Occidental;08205;Sant Cugat del Vallès;3;1;A;;497;164;281;353;144;1;9;343;352
8;Barcelona;40;Vallès Occidental;08205;Sant Cugat del Vallès;3;1;B;;546;150;272;349;197;1;7;341;348
8;Barcelona;40;Vallès Occidental;08205;Sant Cugat del Vallès;3;2;A;;651;207;384;469;182;2;8;459;467
8;Barcelona;40;Vallès Occidental;08205;Sant Cugat del Vallès;3;2;B;;741;194;457;548;193;1;18;529;547
8;Barcelona;40;Vallès Occidental;08205;Sant Cugat del Vallès;3;3;A;;571;146;315;402;169;0;11;391;402
8;Barcelona;40;Vallès Occidental;08205;Sant Cugat del Vallès;3;3;B;;545;155;298;362;183;1;9;352;361
8;Barcelona;40;Vallès Occidental;08205;Sant Cugat del Vallès;3;4;A;;623;186;327;404;219;0;5;399;404
8;Barcelona;40;Vallès Occidental;08205;Sant Cugat del Vallès;3;4;B;;651;193;352;434;217;0;10;424;434
8;Barcelona;40;Vallès Occidental;08205;Sant Cugat del Vallès;4;1;U;;982;250;457;588;394;1;8;579;587
8;Barcelona;40;Vallès Occidental;08205;Sant Cugat del Vallès;4;2;U;;927;228;418;525;402;0;13;512;525
8;Barcelona;40;Vallès Occidental;08205;Sant Cugat del Vallès;4;3;A;;532;127;227;303;229;4;5;294;299
8;Barcelona;40;Vallès Occidental;08205;Sant Cugat del Vallès;4;3;B;;556;127;251;340;216;2;3;335;338
8;Barcelona;40;Vallès Occidental;08205;Sant Cugat del Vallès;5;1;A;;1073;295;614;788;285;1;21;766;787
8;Barcelona;40;Vallès Occidental;08205;Sant Cugat del Vallès;5;1;B;;998;247;540;719;279;1;12;706;718
8;Barcelona;40;Vallès Occidental;08205;Sant Cugat del Vallès;5;1;C;;963;290;592;758;205;1;22;735;757
8;Barcelona;40;Vallès Occidental;08205;Sant Cugat del Vallès;5;2;A;;1033;289;528;710;323;1;15;694;709
8;Barcelona;40;Vallès Occidental;08205;Sant Cugat del Vallès;5;2;B;;1142;273;561;731;411;2;21;708;729
8;Barcelona;40;Vallès Occidental;08205;Sant Cugat del Vallès;5;2;C;;1018;322;551;706;312;1;13;692;705
8;Barcelona;40;Vallès Occidental;08205;Sant Cugat del Vallès;6;1;U;;851;149;295;362;489;4;2;356;358
8;Barcelona;3;Alt Penedès;08206;Sant Cugat Sesgarrigues;1;1;U;;666;220;420;495;171;4;9;482;491
25;Lleida;25;Pallars Jussà;25196;Sant Esteve de la Sarga;1;1;U;;142;37;74;94;48;0;1;93;94
8;Barcelona;41;Vallès Oriental;08207;Sant Esteve de Palautordera;1;1;A;;678;223;390;490;188;0;15;475;490
8;Barcelona;41;Vallès Oriental;08207;Sant Esteve de Palautordera;1;1;B;;803;256;467;582;221;3;16;563;579
8;Barcelona;11;Baix Llobregat;08208;Sant Esteve Sesrovires;1;1;A;;542;139;260;315;227;0;6;309;315
8;Barcelona;11;Baix Llobregat;08208;Sant Esteve Sesrovires;1;1;B;;577;158;262;333;244;1;4;328;332
8;Barcelona;11;Baix Llobregat;08208;Sant Esteve Sesrovires;1;1;C;;497;149;256;318;179;1;5;312;317
8;Barcelona;11;Baix Llobregat;08208;Sant Esteve Sesrovires;1;2;A;;558;149;279;354;204;1;3;350;353
8;Barcelona;11;Baix Llobregat;08208;Sant Esteve Sesrovires;1;2;B;;699;218;366;449;250;1;5;443;448
8;Barcelona;11;Baix Llobregat;08208;Sant Esteve Sesrovires;1;2;C;;562;157;268;347;215;0;3;344;347
8;Barcelona;11;Baix Llobregat;08208;Sant Esteve Sesrovires;1;3;U;;744;194;365;458;286;0;7;451;458
8;Barcelona;11;Baix Llobregat;08208;Sant Esteve Sesrovires;1;4;U;;687;156;258;344;343;1;9;334;343
17;Girona;34;Selva;17159;Sant Feliu de Buixalleu;1;1;U;;618;178;315;410;208;0;9;401;410
8;Barcelona;41;Vallès Oriental;08210;Sant Feliu de Codines;1;1;A;;419;116;225;247;172;1;7;239;246
8;Barcelona;41;Vallès Oriental;08210;Sant Feliu de Codines;1;1;B;;496;140;246;299;197;10;3;286;289
8;Barcelona;41;Vallès Oriental;08210;Sant Feliu de Codines;1;2;A;;540;153;259;333;207;1;4;328;332
8;Barcelona;41;Vallès Oriental;08210;Sant Feliu de Codines;1;2;B;;654;1;312;369;285;1;10;358;368
8;Barcelona;41;Vallès Oriental;08210;Sant Feliu de Codines;2;1;A;;477;104;191;244;233;0;3;241;244
8;Barcelona;41;Vallès Oriental;08210;Sant Feliu de Codines;2;1;B;;523;145;239;300;223;1;8;291;299
8;Barcelona;41;Vallès Oriental;08210;Sant Feliu de Codines;2;2;A;;318;87;160;196;122;1;1;194;195
8;Barcelona;41;Vallès Oriental;08210;Sant Feliu de Codines;2;2;B;;393;102;192;242;151;2;7;233;240
17;Girona;10;Baix Empordà;17160;Sant Feliu de Guíxols;1;1;A;;557;148;286;322;235;4;3;315;318
17;Girona;10;Baix Empordà;17160;Sant Feliu de Guíxols;1;1;B;;502;135;243;307;195;0;5;302;307
17;Girona;10;Baix Empordà;17160;Sant Feliu de Guíxols;1;2;A;;616;203;203;400;216;5;5;390;395
17;Girona;10;Baix Empordà;17160;Sant Feliu de Guíxols;1;2;B;;683;215;348;435;248;3;6;426;432
17;Girona;10;Baix Empordà;17160;Sant Feliu de Guíxols;2;1;A;;534;171;256;297;237;3;4;290;294
17;Girona;10;Baix Empordà;17160;Sant Feliu de Guíxols;2;1;B;;530;171;267;309;221;0;9;300;309
17;Girona;10;Baix Empordà;17160;Sant Feliu de Guíxols;2;2;A;;813;210;343;395;418;3;8;384;392
17;Girona;10;Baix Empordà;17160;Sant Feliu de Guíxols;2;2;B;;865;210;374;432;433;4;8;420;428
17;Girona;10;Baix Empordà;17160;Sant Feliu de Guíxols;2;3;A;;839;202;339;418;421;3;6;409;415
17;Girona;10;Baix Empordà;17160;Sant Feliu de Guíxols;2;3;B;;884;203;339;411;473;3;6;402;408
17;Girona;10;Baix Empordà;17160;Sant Feliu de Guíxols;2;4;U;;840;170;332;405;435;2;8;395;403
17;Girona;10;Baix Empordà;17160;Sant Feliu de Guíxols;2;5;A;;625;115;198;242;383;0;4;238;242
17;Girona;10;Baix Empordà;17160;Sant Feliu de Guíxols;2;5;B;;698;140;240;279;419;0;3;276;279
17;Girona;10;Baix Empordà;17160;Sant Feliu de Guíxols;3;1;A;;914;250;441;507;407;4;6;497;503
17;Girona;10;Baix Empordà;17160;Sant Feliu de Guíxols;3;1;B;;875;238;413;494;381;3;6;485;491
17;Girona;10;Baix Empordà;17160;Sant Feliu de Guíxols;3;2;A;;526;145;259;294;232;0;7;287;294
17;Girona;10;Baix Empordà;17160;Sant Feliu de Guíxols;3;2;B;;573;139;243;276;297;1;1;274;275
17;Girona;10;Baix Empordà;17160;Sant Feliu de Guíxols;3;3;A;;491;133;229;263;228;5;4;254;258
17;Girona;10;Baix Empordà;17160;Sant Feliu de Guíxols;3;3;B;;528;134;228;261;267;4;1;256;257
17;Girona;10;Baix Empordà;17160;Sant Feliu de Guíxols;4;1;A;;676;188;323;371;305;0;4;367;371
17;Girona;10;Baix Empordà;17160;Sant Feliu de Guíxols;4;1;B;;650;179;304;356;294;1;6;349;355
17;Girona;10;Baix Empordà;17160;Sant Feliu de Guíxols;4;2;U;;732;193;359;445;287;1;9;435;444
8;Barcelona;11;Baix Llobregat;08211;Sant Feliu de Llobregat;1;1;A;;624;202;365;469;155;0;7;462;469
8;Barcelona;11;Baix Llobregat;08211;Sant Feliu de Llobregat;1;1;B;;643;197;378;472;171;2;17;453;470
8;Barcelona;11;Baix Llobregat;08211;Sant Feliu de Llobregat;1;2;A;;465;134;259;339;126;1;11;327;338
8;Barcelona;11;Baix Llobregat;08211;Sant Feliu de Llobregat;1;2;B;;516;158;265;364;152;1;8;355;363
8;Barcelona;11;Baix Llobregat;08211;Sant Feliu de Llobregat;1;3;A;;466;133;260;329;137;1;6;322;328
8;Barcelona;11;Baix Llobregat;08211;Sant Feliu de Llobregat;1;3;B;;558;170;307;389;169;1;8;380;388
8;Barcelona;11;Baix Llobregat;08211;Sant Feliu de Llobregat;1;4;A;;729;172;340;462;267;3;15;444;459
8;Barcelona;11;Baix Llobregat;08211;Sant Feliu de Llobregat;1;4;B;;859;214;400;537;322;0;13;524;537
8;Barcelona;11;Baix Llobregat;08211;Sant Feliu de Llobregat;2;1;A;;429;132;222;278;151;3;4;271;275
8;Barcelona;11;Baix Llobregat;08211;Sant Feliu de Llobregat;2;1;B;;487;139;236;305;182;1;4;300;304
8;Barcelona;11;Baix Llobregat;08211;Sant Feliu de Llobregat;2;2;U;;517;136;249;335;182;2;9;324;333
8;Barcelona;11;Baix Llobregat;08211;Sant Feliu de Llobregat;2;3;A;;487;112;197;236;251;0;2;234;236
8;Barcelona;11;Baix Llobregat;08211;Sant Feliu de Llobregat;2;3;B;;526;112;215;257;269;2;2;253;255
8;Barcelona;11;Baix Llobregat;08211;Sant Feliu de Llobregat;2;4;U;;585;150;252;333;252;3;10;320;330
8;Barcelona;11;Baix Llobregat;08211;Sant Feliu de Llobregat;2;5;U;;793;228;434;551;242;3;13;535;548
8;Barcelona;11;Baix Llobregat;08211;Sant Feliu de Llobregat;2;6;A;;587;132;237;320;267;0;17;303;320
8;Barcelona;11;Baix Llobregat;08211;Sant Feliu de Llobregat;2;6;B;;690;185;304;411;279;1;17;393;410
8;Barcelona;11;Baix Llobregat;08211;Sant Feliu de Llobregat;2;7;A;;625;141;279;344;281;2;5;337;342
8;Barcelona;11;Baix Llobregat;08211;Sant Feliu de Llobregat;2;7;B;;651;150;283;354;297;0;5;349;354
8;Barcelona;11;Baix Llobregat;08211;Sant Feliu de Llobregat;2;8;A;;660;164;265;346;314;0;0;346;346
8;Barcelona;11;Baix Llobregat;08211;Sant Feliu de Llobregat;2;8;B;;703;158;251;356;347;1;6;349;355
8;Barcelona;11;Baix Llobregat;08211;Sant Feliu de Llobregat;3;1;A;;397;118;198;257;140;1;7;249;256
8;Barcelona;11;Baix Llobregat;08211;Sant Feliu de Llobregat;3;1;B;;471;131;216;274;197;0;4;270;274
8;Barcelona;11;Baix Llobregat;08211;Sant Feliu de Llobregat;3;1;C;;487;136;229;275;212;0;5;270;275
8;Barcelona;11;Baix Llobregat;08211;Sant Feliu de Llobregat;3;2;A;;360;95;177;216;144;3;3;210;213
8;Barcelona;11;Baix Llobregat;08211;Sant Feliu de Llobregat;3;2;B;;458;123;218;261;197;0;3;258;261
8;Barcelona;11;Baix Llobregat;08211;Sant Feliu de Llobregat;3;3;A;;627;202;329;414;213;2;6;406;412
8;Barcelona;11;Baix Llobregat;08211;Sant Feliu de Llobregat;3;3;B;;690;188;362;463;227;2;12;449;461
8;Barcelona;11;Baix Llobregat;08211;Sant Feliu de Llobregat;3;4;A;;662;206;366;466;196;2;9;455;464
8;Barcelona;11;Baix Llobregat;08211;Sant Feliu de Llobregat;3;4;B;;737;217;413;525;212;2;11;512;523
8;Barcelona;11;Baix Llobregat;08211;Sant Feliu de Llobregat;3;5;A;;639;174;324;398;241;1;11;386;397
8;Barcelona;11;Baix Llobregat;08211;Sant Feliu de Llobregat;3;5;B;;724;214;351;445;279;2;8;435;443
8;Barcelona;11;Baix Llobregat;08211;Sant Feliu de Llobregat;4;1;U;;796;203;347;430;366;1;8;421;429
8;Barcelona;11;Baix Llobregat;08211;Sant Feliu de Llobregat;4;2;A;;374;101;161;189;185;0;6;183;189
8;Barcelona;11;Baix Llobregat;08211;Sant Feliu de Llobregat;4;2;B;;517;115;225;279;238;0;7;272;279
8;Barcelona;11;Baix Llobregat;08211;Sant Feliu de Llobregat;4;3;U;;863;204;326;416;447;3;12;401;413
8;Barcelona;11;Baix Llobregat;08211;Sant Feliu de Llobregat;4;4;A;;601;149;262;354;247;3;9;342;351
8;Barcelona;11;Baix Llobregat;08211;Sant Feliu de Llobregat;4;4;B;;673;156;290;385;288;3;7;375;382
8;Barcelona;11;Baix Llobregat;08211;Sant Feliu de Llobregat;4;5;U;;421;100;159;192;229;1;7;184;191
8;Barcelona;11;Baix Llobregat;08211;Sant Feliu de Llobregat;5;1;A;;418;96;152;189;229;0;3;186;189
8;Barcelona;11;Baix Llobregat;08211;Sant Feliu de Llobregat;5;1;B;;464;91;158;215;249;0;3;212;215
8;Barcelona;11;Baix Llobregat;08211;Sant Feliu de Llobregat;5;2;U;;771;126;231;308;463;4;7;297;304
8;Barcelona;11;Baix Llobregat;08211;Sant Feliu de Llobregat;6;1;A;;397;88;138;187;210;0;2;185;187
8;Barcelona;11;Baix Llobregat;08211;Sant Feliu de Llobregat;6;1;B;;551;131;218;254;297;0;4;250;254
8;Barcelona;11;Baix Llobregat;08211;Sant Feliu de Llobregat;6;1;C;;520;111;192;246;274;1;0;245;245
8;Barcelona;11;Baix Llobregat;08211;Sant Feliu de Llobregat;6;2;U;;673;186;305;376;297;1;9;366;375
8;Barcelona;11;Baix Llobregat;08211;Sant Feliu de Llobregat;6;3;U;;710;158;295;376;334;2;12;362;374
8;Barcelona;11;Baix Llobregat;08211;Sant Feliu de Llobregat;6;4;A;;449;93;189;257;192;1;8;248;256
8;Barcelona;11;Baix Llobregat;08211;Sant Feliu de Llobregat;6;4;B;;527;99;234;328;199;0;5;323;328
8;Barcelona;11;Baix Llobregat;08211;Sant Feliu de Llobregat;7;1;A;;630;192;328;434;196;0;17;417;434
8;Barcelona;11;Baix Llobregat;08211;Sant Feliu de Llobregat;7;1;B;;745;206;387;526;219;2;19;505;524
8;Barcelona;11;Baix Llobregat;08211;Sant Feliu de Llobregat;7;2;A;;700;212;404;474;226;3;16;455;471
8;Barcelona;11;Baix Llobregat;08211;Sant Feliu de Llobregat;7;2;B;;802;173;346;532;270;1;16;515;531
8;Barcelona;11;Baix Llobregat;08211;Sant Feliu de Llobregat;7;3;U;;780;204;354;483;297;0;9;474;483
17;Girona;19;Garrotxa;17161;Sant Feliu de Pallerols;1;1;A;;501;185;308;366;135;3;5;358;363
17;Girona;19;Garrotxa;17161;Sant Feliu de Pallerols;1;1;B;;498;173;311;365;133;7;6;352;358
8;Barcelona;7;Bages;08212;Sant Feliu Sasserra;1;1;U;;485;127;286;340;145;5;7;328;335
17;Girona;19;Garrotxa;17162;Sant Ferriol;1;1;U;;140;45;56;79;61;0;1;78;79
8;Barcelona;41;Vallès Oriental;08209;Sant Fost de Campsentelles;1;1;A;;673;156;285;355;318;0;6;349;355
8;Barcelona;41;Vallès Oriental;08209;Sant Fost de Campsentelles;1;1;B;;795;193;358;460;335;1;9;450;459
8;Barcelona;41;Vallès Oriental;08209;Sant Fost de Campsentelles;1;2;A;;458;119;237;283;175;1;1;281;282
8;Barcelona;41;Vallès Oriental;08209;Sant Fost de Campsentelles;1;2;B;;612;146;285;335;277;4;2;329;331
8;Barcelona;41;Vallès Oriental;08209;Sant Fost de Campsentelles;1;3;A;;618;133;272;363;255;1;2;360;362
8;Barcelona;41;Vallès Oriental;08209;Sant Fost de Campsentelles;1;3;B;;616;119;240;347;269;4;11;332;343
8;Barcelona;41;Vallès Oriental;08209;Sant Fost de Campsentelles;1;3;C;;662;149;296;388;274;2;6;380;386
8;Barcelona;41;Vallès Oriental;08209;Sant Fost de Campsentelles;1;4;A;;713;165;255;328;385;0;1;327;328
8;Barcelona;41;Vallès Oriental;08209;Sant Fost de Campsentelles;1;4;B;;835;154;267;362;473;0;1;361;362
8;Barcelona;7;Bages;08213;Sant Fruitós de Bages;1;1;A;;468;128;238;289;179;0;5;284;289
8;Barcelona;7;Bages;08213;Sant Fruitós de Bages;1;1;B;;374;83;151;209;165;1;3;205;208
8;Barcelona;7;Bages;08213;Sant Fruitós de Bages;1;1;C;;525;120;243;302;223;2;7;293;300
8;Barcelona;7;Bages;08213;Sant Fruitós de Bages;1;1;D;;464;131;235;281;183;1;5;275;280
8;Barcelona;7;Bages;08213;Sant Fruitós de Bages;1;2;A;;797;165;325;401;396;3;10;388;398
8;Barcelona;7;Bages;08213;Sant Fruitós de Bages;1;2;B;;887;214;361;451;436;2;10;439;449
8;Barcelona;7;Bages;08213;Sant Fruitós de Bages;1;2;C;;730;201;416;524;206;3;9;512;521
8;Barcelona;7;Bages;08213;Sant Fruitós de Bages;1;3;A;;635;142;294;364;271;2;11;351;362
8;Barcelona;7;Bages;08213;Sant Fruitós de Bages;1;3;B;;723;148;302;389;334;0;13;376;389
17;Girona;20;Gironès;17163;Sant Gregori;1;1;A;;655;228;381;454;201;2;11;441;452
17;Girona;20;Gironès;17163;Sant Gregori;1;1;B;;655;203;390;459;196;4;10;445;455
17;Girona;20;Gironès;17163;Sant Gregori;1;2;A;;684;171;317;391;293;2;1;388;389
17;Girona;20;Gironès;17163;Sant Gregori;1;2;B;;307;93;167;216;91;1;4;211;215
25;Lleida;32;Segarra;25192;Sant Guim de Freixenet;1;1;U;;792;213;422;527;265;7;20;500;520
25;Lleida;32;Segarra;25197;Sant Guim de la Plana;1;1;U;;149;27;91;105;44;0;3;102;105
17;Girona;34;Selva;17164;Sant Hilari Sacalm;1;1;A;;538;145;299;342;196;2;6;334;340
17;Girona;34;Selva;17164;Sant Hilari Sacalm;1;1;B;;672;171;366;432;240;3;4;425;429
17;Girona;34;Selva;17164;Sant Hilari Sacalm;1;2;A;;507;129;260;309;198;4;5;300;305
17;Girona;34;Selva;17164;Sant Hilari Sacalm;1;2;B;;600;162;297;358;242;6;7;345;352
17;Girona;34;Selva;17164;Sant Hilari Sacalm;1;3;A;;894;234;448;521;373;1;3;517;520
17;Girona;34;Selva;17164;Sant Hilari Sacalm;1;3;B;;860;198;433;525;335;1;4;520;524
8;Barcelona;24;Osona;08215;Sant Hipòlit de Voltregà;1;1;U;;796;275;419;506;290;0;22;484;506
8;Barcelona;24;Osona;08215;Sant Hipòlit de Voltregà;1;2;U;;835;290;506;607;228;5;12;590;602
8;Barcelona;24;Osona;08215;Sant Hipòlit de Voltregà;1;3;A;;384;111;205;244;140;2;10;232;242
8;Barcelona;24;Osona;08215;Sant Hipòlit de Voltregà;1;3;B;;538;177;304;369;169;3;8;358;366
8;Barcelona;21;Maresme;08193;Sant Iscle de Vallalta;1;1;U;;876;240;425;544;332;4;8;532;540
43;Tarragona;22;Montsià;43902;Sant Jaume d'Enveja;1;1;A;;803;174;328;428;375;0;2;426;428
43;Tarragona;22;Montsià;43902;Sant Jaume d'Enveja;1;1;B;;402;133;235;282;120;0;10;272;282
43;Tarragona;22;Montsià;43902;Sant Jaume d'Enveja;1;2;A;;794;195;343;429;365;0;8;421;429
43;Tarragona;22;Montsià;43902;Sant Jaume d'Enveja;1;2;B;;732;197;330;408;324;1;2;405;407
8;Barcelona;14;Berguedà;08216;Sant Jaume de Frontanyà;1;1;U;;29;8;13;21;8;0;0;21;21
17;Girona;19;Garrotxa;17165;Sant Jaume de Llierca;1;1;U;;642;212;376;428;214;5;10;413;423
43;Tarragona;12;Baix Penedès;43137;Sant Jaume dels Domenys;1;1;A;;734;190;360;431;303;4;7;420;427
43;Tarragona;12;Baix Penedès;43137;Sant Jaume dels Domenys;1;1;B;;857;233;439;534;323;3;6;525;531
17;Girona;31;Ripollès;17167;Sant Joan de les Abadesses;1;1;U;;576;192;322;383;193;3;6;374;380
17;Girona;31;Ripollès;17167;Sant Joan de les Abadesses;1;2;A;;554;179;286;349;205;0;5;344;349
17;Girona;31;Ripollès;17167;Sant Joan de les Abadesses;1;2;B;;478;162;250;302;176;7;3;292;295
17;Girona;31;Ripollès;17167;Sant Joan de les Abadesses;1;2;C;;560;198;312;368;192;1;8;359;367
17;Girona;31;Ripollès;17167;Sant Joan de les Abadesses;1;3;A;;381;112;210;249;132;2;3;244;247
17;Girona;31;Ripollès;17167;Sant Joan de les Abadesses;1;3;B;;376;126;212;257;119;1;2;254;256
17;Girona;20;Gironès;17168;Sant Joan de Mollet;1;1;U;;390;160;273;307;83;2;5;300;305
8;Barcelona;11;Baix Llobregat;08217;Sant Joan Despí;1;1;U;;833;183;386;513;320;2;8;503;511
8;Barcelona;11;Baix Llobregat;08217;Sant Joan Despí;1;10;U;;1179;273;587;790;389;6;24;760;784
8;Barcelona;11;Baix Llobregat;08217;Sant Joan Despí;1;2;A;;442;106;211;268;174;0;4;264;268
8;Barcelona;11;Baix Llobregat;08217;Sant Joan Despí;1;2;B;;488;110;221;287;201;3;8;276;284
8;Barcelona;11;Baix Llobregat;08217;Sant Joan Despí;1;3;A;;660;181;329;404;256;3;8;393;401
8;Barcelona;11;Baix Llobregat;08217;Sant Joan Despí;1;3;B;;811;193;370;475;336;0;8;467;475
8;Barcelona;11;Baix Llobregat;08217;Sant Joan Despí;1;4;A;;815;184;362;481;334;4;11;466;477
8;Barcelona;11;Baix Llobregat;08217;Sant Joan Despí;1;4;B;;942;231;452;571;371;5;13;553;566
8;Barcelona;11;Baix Llobregat;08217;Sant Joan Despí;1;5;A;;399;110;193;262;137;2;5;255;260
8;Barcelona;11;Baix Llobregat;08217;Sant Joan Despí;1;5;B;;452;120;209;289;163;1;0;288;288
8;Barcelona;11;Baix Llobregat;08217;Sant Joan Despí;1;5;C;;484;144;249;305;179;1;6;298;304
8;Barcelona;11;Baix Llobregat;08217;Sant Joan Despí;1;6;A;;391;62;167;205;186;0;1;204;205
8;Barcelona;11;Baix Llobregat;08217;Sant Joan Despí;1;6;B;;457;105;193;249;208;1;4;244;248
8;Barcelona;11;Baix Llobregat;08217;Sant Joan Despí;1;7;A;;537;119;225;305;232;0;6;299;305
8;Barcelona;11;Baix Llobregat;08217;Sant Joan Despí;1;7;B;;554;122;227;312;242;1;9;302;311
8;Barcelona;11;Baix Llobregat;08217;Sant Joan Despí;1;8;A;;576;143;270;343;233;0;20;323;343
8;Barcelona;11;Baix Llobregat;08217;Sant Joan Despí;1;8;B;;637;153;286;372;265;0;14;358;372
8;Barcelona;11;Baix Llobregat;08217;Sant Joan Despí;1;9;U;;969;235;460;619;350;0;13;606;619
8;Barcelona;11;Baix Llobregat;08217;Sant Joan Despí;2;2;A;;592;164;272;343;249;0;0;343;343
8;Barcelona;11;Baix Llobregat;08217;Sant Joan Despí;2;2;B;;548;150;234;297;251;2;11;284;295
8;Barcelona;11;Baix Llobregat;08217;Sant Joan Despí;2;3;U;;549;150;227;290;259;1;9;280;289
8;Barcelona;11;Baix Llobregat;08217;Sant Joan Despí;2;4;A;;392;141;183;212;180;0;1;211;212
8;Barcelona;11;Baix Llobregat;08217;Sant Joan Despí;2;4;B;;541;141;227;272;269;0;2;270;272
8;Barcelona;11;Baix Llobregat;08217;Sant Joan Despí;3;1;A;;326;98;162;200;126;4;3;193;196
8;Barcelona;11;Baix Llobregat;08217;Sant Joan Despí;3;1;B;;377;116;174;213;164;1;2;210;212
8;Barcelona;11;Baix Llobregat;08217;Sant Joan Despí;3;1;C;;332;91;148;191;141;2;8;181;189
8;Barcelona;11;Baix Llobregat;08217;Sant Joan Despí;3;2;A;;576;125;212;299;277;3;6;290;296
8;Barcelona;11;Baix Llobregat;08217;Sant Joan Despí;3;2;B;;600;142;247;330;270;3;11;316;327
8;Barcelona;11;Baix Llobregat;08217;Sant Joan Despí;3;3;A;;376;92;157;206;170;0;0;206;206
8;Barcelona;11;Baix Llobregat;08217;Sant Joan Despí;3;3;B;;345;94;162;195;150;0;1;194;195
8;Barcelona;11;Baix Llobregat;08217;Sant Joan Despí;3;4;A;;662;185;297;380;282;0;4;376;380
8;Barcelona;11;Baix Llobregat;08217;Sant Joan Despí;3;4;B;;703;206;328;398;305;0;11;387;398
8;Barcelona;11;Baix Llobregat;08217;Sant Joan Despí;3;5;A;;451;140;219;272;179;0;7;265;272
8;Barcelona;11;Baix Llobregat;08217;Sant Joan Despí;3;5;B;;503;117;233;284;219;0;4;280;284
8;Barcelona;11;Baix Llobregat;08217;Sant Joan Despí;4;1;A;;790;234;444;552;238;2;7;543;550
8;Barcelona;11;Baix Llobregat;08217;Sant Joan Despí;4;1;B;;900;260;490;614;286;0;13;601;614
8;Barcelona;11;Baix Llobregat;08217;Sant Joan Despí;5;1;A;;585;150;266;353;232;1;8;344;352
8;Barcelona;11;Baix Llobregat;08217;Sant Joan Despí;5;1;B;;681;167;305;399;282;1;7;391;398
8;Barcelona;11;Baix Llobregat;08217;Sant Joan Despí;5;1;C;;658;155;300;413;245;0;12;401;413
8;Barcelona;11;Baix Llobregat;08217;Sant Joan Despí;5;2;U;;882;204;462;604;278;2;16;586;602
8;Barcelona;7;Bages;08218;Sant Joan de Vilatorrada;1;1;A;;547;159;286;337;210;1;4;332;336
8;Barcelona;7;Bages;08218;Sant Joan de Vilatorrada;1;1;B;;583;144;265;316;267;1;5;310;315
8;Barcelona;7;Bages;08218;Sant Joan de Vilatorrada;1;1;C;;684;183;335;394;290;3;6;385;391
8;Barcelona;7;Bages;08218;Sant Joan de Vilatorrada;1;2;A;;728;156;302;385;343;0;15;370;385
8;Barcelona;7;Bages;08218;Sant Joan de Vilatorrada;1;2;B;;871;157;331;422;449;1;10;411;421
8;Barcelona;7;Bages;08218;Sant Joan de Vilatorrada;1;3;A;;583;172;277;329;254;0;12;317;329
8;Barcelona;7;Bages;08218;Sant Joan de Vilatorrada;1;3;B;;692;198;313;398;294;9;13;376;389
8;Barcelona;7;Bages;08218;Sant Joan de Vilatorrada;1;3;C;;191;60;101;130;61;2;0;128;128
8;Barcelona;7;Bages;08218;Sant Joan de Vilatorrada;1;5;A;;607;165;299;374;233;2;6;366;372
8;Barcelona;7;Bages;08218;Sant Joan de Vilatorrada;1;5;B;;729;166;335;430;299;3;7;420;427
8;Barcelona;7;Bages;08218;Sant Joan de Vilatorrada;1;6;A;;524;118;218;269;255;2;5;262;267
8;Barcelona;7;Bages;08218;Sant Joan de Vilatorrada;1;6;B;;685;146;284;344;341;0;2;342;344
8;Barcelona;7;Bages;08218;Sant Joan de Vilatorrada;1;6;C;;671;160;281;340;331;2;9;329;338
17;Girona;19;Garrotxa;17185;Sant Joan les Fonts;1;1;A;;474;163;261;327;147;7;8;312;320
17;Girona;19;Garrotxa;17185;Sant Joan les Fonts;1;1;B;;511;155;277;332;179;2;9;321;330
17;Girona;19;Garrotxa;17185;Sant Joan les Fonts;1;2;U;;471;116;236;299;172;4;8;287;295
17;Girona;19;Garrotxa;17185;Sant Joan les Fonts;1;3;A;;589;192;345;394;195;2;20;372;392
17;Girona;19;Garrotxa;17185;Sant Joan les Fonts;1;3;B;;199;38;87;125;74;0;5;120;125
17;Girona;20;Gironès;17166;Sant Jordi Desvalls;1;1;U;;472;176;299;332;140;8;4;320;324
8;Barcelona;14;Berguedà;08903;Sant Julià de Cerdanyola;1;1;U;;218;80;144;170;48;0;4;166;170
17;Girona;34;Selva;17903;Sant Julià del Llor i Bonmatí;1;1;U;;862;260;468;557;305;5;9;543;552
17;Girona;20;Gironès;17169;Sant Julià de Ramis;1;1;A;;700;175;333;409;291;2;4;403;407
17;Girona;20;Gironès;17169;Sant Julià de Ramis;1;1;B;;748;196;380;447;301;4;5;438;443
17;Girona;20;Gironès;17169;Sant Julià de Ramis;1;1;C;;648;190;341;416;232;4;4;408;412
8;Barcelona;24;Osona;08220;Sant Julià de Vilatorta;1;1;A;;809;276;448;594;215;2;18;574;592
8;Barcelona;24;Osona;08220;Sant Julià de Vilatorta;1;1;B;;711;233;407;494;217;4;16;474;490
8;Barcelona;24;Osona;08220;Sant Julià de Vilatorta;1;1;C;;660;233;428;513;147;2;17;494;511
8;Barcelona;11;Baix Llobregat;08221;Sant Just Desvern;1;1;A;;675;197;403;491;184;2;8;481;489
8;Barcelona;11;Baix Llobregat;08221;Sant Just Desvern;1;1;B;;782;244;446;555;227;4;7;544;551
8;Barcelona;11;Baix Llobregat;08221;Sant Just Desvern;1;2;U;;679;226;360;416;263;1;13;402;415
8;Barcelona;11;Baix Llobregat;08221;Sant Just Desvern;1;3;A;;751;265;446;530;221;0;13;517;530
8;Barcelona;11;Baix Llobregat;08221;Sant Just Desvern;1;3;B;;882;280;512;624;258;1;24;599;623
8;Barcelona;11;Baix Llobregat;08221;Sant Just Desvern;1;4;A;;590;168;300;392;198;2;10;380;390
8;Barcelona;11;Baix Llobregat;08221;Sant Just Desvern;1;4;B;;741;176;375;474;267;0;17;457;474
8;Barcelona;11;Baix Llobregat;08221;Sant Just Desvern;1;5;A;;650;178;364;455;195;6;5;444;449
8;Barcelona;11;Baix Llobregat;08221;Sant Just Desvern;1;5;B;;831;224;457;576;255;0;9;567;576
8;Barcelona;11;Baix Llobregat;08221;Sant Just Desvern;1;6;A;;750;247;480;564;186;5;13;546;559
8;Barcelona;11;Baix Llobregat;08221;Sant Just Desvern;1;6;B;;886;477;531;652;234;5;15;632;647
8;Barcelona;11;Baix Llobregat;08221;Sant Just Desvern;1;7;A;;537;160;313;394;143;1;7;386;393
8;Barcelona;11;Baix Llobregat;08221;Sant Just Desvern;1;7;B;;640;177;337;423;217;1;5;417;422
8;Barcelona;11;Baix Llobregat;08221;Sant Just Desvern;1;8;A;;429;101;222;298;131;2;8;288;296
8;Barcelona;11;Baix Llobregat;08221;Sant Just Desvern;1;8;B;;560;146;296;370;190;3;9;358;367
8;Barcelona;11;Baix Llobregat;08221;Sant Just Desvern;1;9;A;;378;121;231;269;109;0;3;266;269
8;Barcelona;11;Baix Llobregat;08221;Sant Just Desvern;1;9;B;;401;116;215;266;135;1;3;262;265
8;Barcelona;3;Alt Penedès;08222;Sant Llorenç d'Hortons;1;1;A;;800;212;421;553;247;4;14;535;549
8;Barcelona;3;Alt Penedès;08222;Sant Llorenç d'Hortons;1;1;B;;811;212;374;505;306;2;12;491;503
17;Girona;2;Alt Empordà;17171;Sant Llorenç de la Muga;1;1;U;;151;68;102;124;27;0;1;123;124
25;Lleida;35;Solsonès;25193;Sant Llorenç de Morunys;1;1;U;;764;231;412;505;259;6;15;484;499
8;Barcelona;40;Vallès Occidental;08223;Sant Llorenç Savall;1;1;A;;802;190;383;485;317;2;12;471;483
8;Barcelona;40;Vallès Occidental;08223;Sant Llorenç Savall;1;1;B;;1004;276;490;610;394;8;10;592;602
8;Barcelona;24;Osona;08225;Sant Martí d'Albars;1;1;U;;95;43;60;64;31;0;2;62;64
8;Barcelona;24;Osona;08224;Sant Martí de Centelles;1;1;U;;670;183;364;443;227;0;7;436;443
17;Girona;20;Gironès;17172;Sant Martí de Llémena;1;1;U;;389;114;219;259;130;1;7;251;258
25;Lleida;38;Urgell;25902;Sant Martí de Riucorb;1;1;U;;625;164;338;399;226;8;16;375;391
8;Barcelona;6;Anoia;08226;Sant Martí de Tous;1;1;U;;862;220;480;611;251;2;20;589;609
8;Barcelona;3;Alt Penedès;08227;Sant Martí Sarroca;1;1;A;;818;193;393;536;282;11;9;516;525
8;Barcelona;3;Alt Penedès;08227;Sant Martí Sarroca;1;1;B;;860;212;428;557;303;4;7;546;553
8;Barcelona;3;Alt Penedès;08227;Sant Martí Sarroca;1;2;U;;542;148;271;362;180;4;8;350;358
8;Barcelona;6;Anoia;08228;Sant Martí Sesgueioles;1;1;U;;298;92;173;214;84;6;3;205;208
17;Girona;20;Gironès;17173;Sant Martí Vell;1;1;U;;161;55;93;107;54;0;1;106;107
8;Barcelona;7;Bages;08229;Sant Mateu de Bages;1;1;A;;150;43;80;98;52;0;2;96;98
8;Barcelona;7;Bages;08229;Sant Mateu de Bages;1;1;B;;431;182;271;318;113;2;6;310;316
17;Girona;28;Pla de l'Estany;17174;Sant Miquel de Campmajor;1;1;U;;166;45;80;108;58;0;4;104;108
17;Girona;2;Alt Empordà;17175;Sant Miquel de Fluvià;1;1;U;;485;121;220;252;233;0;4;248;252
17;Girona;2;Alt Empordà;17176;Sant Mori;1;1;U;;126;40;76;91;35;1;3;87;90
17;Girona;31;Ripollès;17177;Sant Pau de Segúries;1;1;U;;560;175;320;390;170;2;12;376;388
8;Barcelona;7;Bages;08192;Santpedor;1;1;A;;525;131;236;319;206;0;6;313;319
8;Barcelona;7;Bages;08192;Santpedor;1;1;B;;603;157;258;362;241;4;2;356;358
8;Barcelona;7;Bages;08192;Santpedor;1;2;A;;666;186;345;430;236;2;7;421;428
8;Barcelona;7;Bages;08192;Santpedor;1;2;B;;597;142;275;355;242;2;9;344;353
8;Barcelona;7;Bages;08192;Santpedor;1;2;C;;726;209;375;469;257;0;13;456;469
8;Barcelona;7;Bages;08192;Santpedor;1;3;A;;659;165;320;443;216;20;4;419;423
8;Barcelona;7;Bages;08192;Santpedor;1;3;B;;619;143;279;381;238;1;11;369;380
8;Barcelona;7;Bages;08192;Santpedor;1;3;C;;703;182;359;451;252;0;8;443;451
8;Barcelona;17;Garraf;08231;Sant Pere de Ribes;1;1;A;;535;138;257;315;220;1;7;307;314
8;Barcelona;17;Garraf;08231;Sant Pere de Ribes;1;1;B;;569;150;272;336;233;3;6;327;333
8;Barcelona;17;Garraf;08231;Sant Pere de Ribes;1;10;A;;491;107;165;202;289;0;4;198;202
8;Barcelona;17;Garraf;08231;Sant Pere de Ribes;1;10;B;;610;119;179;229;381;1;3;225;228
8;Barcelona;17;Garraf;08231;Sant Pere de Ribes;1;11;A;;457;78;134;187;270;2;5;180;185
8;Barcelona;17;Garraf;08231;Sant Pere de Ribes;1;11;B;;429;91;150;190;239;0;2;188;190
8;Barcelona;17;Garraf;08231;Sant Pere de Ribes;1;12;A;;330;88;143;185;145;3;4;178;182
8;Barcelona;17;Garraf;08231;Sant Pere de Ribes;1;12;B;;352;71;122;163;189;1;3;159;162
8;Barcelona;17;Garraf;08231;Sant Pere de Ribes;1;13;A;;424;76;140;171;253;2;4;165;169
8;Barcelona;17;Garraf;08231;Sant Pere de Ribes;1;13;B;;510;115;183;234;276;1;1;232;233
8;Barcelona;17;Garraf;08231;Sant Pere de Ribes;1;14;U;;632;134;254;321;311;0;8;313;321
8;Barcelona;17;Garraf;08231;Sant Pere de Ribes;1;15;A;;490;127;208;275;215;1;3;271;274
8;Barcelona;17;Garraf;08231;Sant Pere de Ribes;1;15;B;;602;129;242;305;297;1;3;301;304
8;Barcelona;17;Garraf;08231;Sant Pere de Ribes;1;15;C;;252;87;137;160;92;0;1;159;160
8;Barcelona;17;Garraf;08231;Sant Pere de Ribes;1;16;A;;508;124;207;262;246;3;2;257;259
8;Barcelona;17;Garraf;08231;Sant Pere de Ribes;1;16;B;;575;130;237;304;271;1;7;296;303
8;Barcelona;17;Garraf;08231;Sant Pere de Ribes;1;17;A;;455;102;201;257;198;3;5;249;254
8;Barcelona;17;Garraf;08231;Sant Pere de Ribes;1;17;B;;574;117;255;334;240;1;5;328;333
8;Barcelona;17;Garraf;08231;Sant Pere de Ribes;1;2;A;;464;127;218;276;188;1;3;272;275
8;Barcelona;17;Garraf;08231;Sant Pere de Ribes;1;2;B;;498;137;244;282;216;0;7;275;282
8;Barcelona;17;Garraf;08231;Sant Pere de Ribes;1;3;A;;623;178;320;382;241;5;8;369;377
8;Barcelona;17;Garraf;08231;Sant Pere de Ribes;1;3;B;;726;191;361;427;299;3;7;417;424
8;Barcelona;17;Garraf;08231;Sant Pere de Ribes;1;4;A;;626;94;177;223;403;0;5;218;223
8;Barcelona;17;Garraf;08231;Sant Pere de Ribes;1;4;B;;805;170;257;327;478;1;10;316;326
8;Barcelona;17;Garraf;08231;Sant Pere de Ribes;1;5;A;;612;131;214;268;344;4;0;264;264
8;Barcelona;17;Garraf;08231;Sant Pere de Ribes;1;5;B;;800;165;255;332;468;3;6;323;329
8;Barcelona;17;Garraf;08231;Sant Pere de Ribes;1;6;A;;525;128;188;218;307;0;2;216;218
8;Barcelona;17;Garraf;08231;Sant Pere de Ribes;1;6;B;;689;173;249;289;400;2;7;280;287
8;Barcelona;17;Garraf;08231;Sant Pere de Ribes;1;7;A;;589;87;159;212;377;1;7;204;211
8;Barcelona;17;Garraf;08231;Sant Pere de Ribes;1;7;B;;770;158;271;314;456;0;3;311;314
8;Barcelona;17;Garraf;08231;Sant Pere de Ribes;1;8;A;;397;107;192;236;161;1;10;225;235
8;Barcelona;17;Garraf;08231;Sant Pere de Ribes;1;8;B;;540;142;247;333;207;3;11;319;330
8;Barcelona;17;Garraf;08231;Sant Pere de Ribes;1;9;A;;676;158;304;388;288;1;4;383;387
8;Barcelona;17;Garraf;08231;Sant Pere de Ribes;1;9;B;;639;152;278;355;284;2;10;343;353
8;Barcelona;3;Alt Penedès;08232;Sant Pere de Riudebitlles;1;1;A;;591;159;327;398;193;2;7;389;396
8;Barcelona;3;Alt Penedès;08232;Sant Pere de Riudebitlles;1;1;B;;588;178;322;385;203;3;5;377;382
8;Barcelona;3;Alt Penedès;08232;Sant Pere de Riudebitlles;1;1;C;;590;146;309;384;206;1;4;379;383
8;Barcelona;24;Osona;08233;Sant Pere de Torelló;1;1;U;;705;243;436;512;193;1;16;495;511
8;Barcelona;24;Osona;08233;Sant Pere de Torelló;1;2;U;;1079;331;594;709;370;0;14;695;709
8;Barcelona;41;Vallès Oriental;08234;Sant Pere de Vilamajor;1;1;A;;711;183;333;420;291;0;11;409;420
8;Barcelona;41;Vallès Oriental;08234;Sant Pere de Vilamajor;1;1;B;;559;142;247;309;250;1;4;304;308
8;Barcelona;41;Vallès Oriental;08234;Sant Pere de Vilamajor;1;1;C;;831;211;372;468;363;0;0;468;468
8;Barcelona;41;Vallès Oriental;08234;Sant Pere de Vilamajor;1;1;D;;631;181;294;358;273;0;6;352;358
17;Girona;2;Alt Empordà;17178;Sant Pere Pescador;1;1;U;;1053;372;617;704;349;3;7;694;701
8;Barcelona;6;Anoia;08189;Sant Pere Sallavinera;1;1;U;;146;60;101;122;24;1;3;118;121
8;Barcelona;21;Maresme;08235;Sant Pol de Mar;1;1;A;;591;206;349;424;167;1;6;417;423
8;Barcelona;21;Maresme;08235;Sant Pol de Mar;1;1;B;;621;185;318;393;228;2;16;375;391
8;Barcelona;21;Maresme;08235;Sant Pol de Mar;1;1;C;;771;244;445;537;234;6;9;522;531
8;Barcelona;21;Maresme;08235;Sant Pol de Mar;1;2;A;;640;193;340;425;215;0;5;420;425
8;Barcelona;21;Maresme;08235;Sant Pol de Mar;1;2;B;;851;287;501;603;248;0;0;603;603
8;Barcelona;3;Alt Penedès;08236;Sant Quintí de Mediona;1;1;A;;700;182;351;432;268;5;8;419;427
8;Barcelona;3;Alt Penedès;08236;Sant Quintí de Mediona;1;1;B;;824;256;438;540;284;4;14;522;536
8;Barcelona;24;Osona;08237;Sant Quirze de Besora;1;1;A;;469;165;275;306;163;3;5;298;303
8;Barcelona;24;Osona;08237;Sant Quirze de Besora;1;1;B;;536;20;320;361;175;3;5;353;358
8;Barcelona;24;Osona;08237;Sant Quirze de Besora;1;2;U;;693;253;431;505;188;2;12;491;503
8;Barcelona;40;Vallès Occidental;08238;Sant Quirze del Vallès;1;1;A;;540;162;284;361;179;1;10;350;360
8;Barcelona;40;Vallès Occidental;08238;Sant Quirze del Vallès;1;1;B;;658;207;355;440;218;3;7;430;437
8;Barcelona;40;Vallès Occidental;08238;Sant Quirze del Vallès;1;10;A;;431;130;226;285;146;0;8;277;285
8;Barcelona;40;Vallès Occidental;08238;Sant Quirze del Vallès;1;10;B;;482;153;231;302;180;2;6;294;300
8;Barcelona;40;Vallès Occidental;08238;Sant Quirze del Vallès;1;11;A;;451;119;211;280;171;0;5;275;280
8;Barcelona;40;Vallès Occidental;08238;Sant Quirze del Vallès;1;11;B;;575;149;248;322;253;1;9;312;321
8;Barcelona;40;Vallès Occidental;08238;Sant Quirze del Vallès;1;12;A;;389;100;188;260;129;3;7;250;257
8;Barcelona;40;Vallès Occidental;08238;Sant Quirze del Vallès;1;12;B;;416;103;201;267;149;0;4;263;267
8;Barcelona;40;Vallès Occidental;08238;Sant Quirze del Vallès;1;2;A;;550;158;331;416;134;1;10;405;415
8;Barcelona;40;Vallès Occidental;08238;Sant Quirze del Vallès;1;2;B;;540;157;311;401;139;3;19;379;398
8;Barcelona;40;Vallès Occidental;08238;Sant Quirze del Vallès;1;3;A;;573;113;113;276;297;2;6;268;274
8;Barcelona;40;Vallès Occidental;08238;Sant Quirze del Vallès;1;3;B;;755;140;266;353;402;0;7;346;353
8;Barcelona;40;Vallès Occidental;08238;Sant Quirze del Vallès;1;4;A;;433;118;242;310;123;2;5;303;308
8;Barcelona;40;Vallès Occidental;08238;Sant Quirze del Vallès;1;4;B;;414;114;201;271;143;0;6;265;271
8;Barcelona;40;Vallès Occidental;08238;Sant Quirze del Vallès;1;4;C;;424;99;205;299;125;1;6;292;298
8;Barcelona;40;Vallès Occidental;08238;Sant Quirze del Vallès;1;5;A;;460;120;198;263;197;1;6;256;262
8;Barcelona;40;Vallès Occidental;08238;Sant Quirze del Vallès;1;5;B;;512;114;224;307;205;2;1;304;305
8;Barcelona;40;Vallès Occidental;08238;Sant Quirze del Vallès;1;5;C;;470;130;224;298;172;0;7;291;298
8;Barcelona;40;Vallès Occidental;08238;Sant Quirze del Vallès;1;6;A;;330;87;166;226;104;1;3;222;225
8;Barcelona;40;Vallès Occidental;08238;Sant Quirze del Vallès;1;6;B;;433;86;184;265;168;0;10;255;265
8;Barcelona;40;Vallès Occidental;08238;Sant Quirze del Vallès;1;6;C;;361;98;189;246;115;0;5;241;246
8;Barcelona;40;Vallès Occidental;08238;Sant Quirze del Vallès;1;7;A;;418;92;185;276;142;0;9;267;276
8;Barcelona;40;Vallès Occidental;08238;Sant Quirze del Vallès;1;7;B;;405;82;187;273;132;1;14;258;272
8;Barcelona;40;Vallès Occidental;08238;Sant Quirze del Vallès;1;7;C;;434;113;217;287;147;0;16;271;287
8;Barcelona;40;Vallès Occidental;08238;Sant Quirze del Vallès;1;8;A;;505;140;256;347;158;2;6;339;345
8;Barcelona;40;Vallès Occidental;08238;Sant Quirze del Vallès;1;8;B;;634;163;311;424;210;0;22;402;424
8;Barcelona;40;Vallès Occidental;08238;Sant Quirze del Vallès;1;9;A;;227;40;73;96;131;0;0;96;96
8;Barcelona;40;Vallès Occidental;08238;Sant Quirze del Vallès;1;9;B;;277;49;102;125;152;0;1;124;125
8;Barcelona;;;08239;Sant Quirze Safaja;1;1;U;;425;116;224;279;146;1;5;273;278
25;Lleida;32;Segarra;25194;Sant Ramon;1;1;U;;476;128;252;301;175;2;17;282;299
8;Barcelona;3;Alt Penedès;08240;Sant Sadurní d'Anoia;1;1;A;;437;151;246;312;125;1;6;305;311
8;Barcelona;3;Alt Penedès;08240;Sant Sadurní d'Anoia;1;1;B;;502;182;301;357;145;0;4;353;357
8;Barcelona;3;Alt Penedès;08240;Sant Sadurní d'Anoia;1;2;A;;531;133;268;334;197;2;4;328;332
8;Barcelona;3;Alt Penedès;08240;Sant Sadurní d'Anoia;1;2;B;;440;123;223;272;168;2;2;268;270
8;Barcelona;3;Alt Penedès;08240;Sant Sadurní d'Anoia;1;2;C;;565;151;151;372;193;0;12;360;372
8;Barcelona;3;Alt Penedès;08240;Sant Sadurní d'Anoia;1;3;A;;450;107;202;258;192;0;6;252;258
8;Barcelona;3;Alt Penedès;08240;Sant Sadurní d'Anoia;1;3;B;;441;101;189;230;211;1;2;227;229
8;Barcelona;3;Alt Penedès;08240;Sant Sadurní d'Anoia;1;4;A;;687;179;368;462;225;2;8;452;460
8;Barcelona;3;Alt Penedès;08240;Sant Sadurní d'Anoia;1;4;B;;649;182;347;430;219;2;8;420;428
8;Barcelona;3;Alt Penedès;08240;Sant Sadurní d'Anoia;1;4;C;;737;168;367;475;262;2;6;467;473
8;Barcelona;3;Alt Penedès;08240;Sant Sadurní d'Anoia;2;1;A;;411;143;225;285;126;0;7;278;285
8;Barcelona;3;Alt Penedès;08240;Sant Sadurní d'Anoia;2;1;B;;473;138;257;324;149;2;3;319;322
8;Barcelona;3;Alt Penedès;08240;Sant Sadurní d'Anoia;2;2;A;;622;176;311;405;217;1;8;396;404
8;Barcelona;3;Alt Penedès;08240;Sant Sadurní d'Anoia;2;2;B;;699;182;328;419;280;3;4;412;416
8;Barcelona;3;Alt Penedès;08240;Sant Sadurní d'Anoia;2;3;A;;486;132;250;315;171;1;5;309;314
8;Barcelona;3;Alt Penedès;08240;Sant Sadurní d'Anoia;2;3;B;;651;182;325;415;236;0;14;401;415
8;Barcelona;24;Osona;08241;Sant Sadurní d'Osormort;1;1;U;;71;21;46;59;12;0;0;59;59
8;Barcelona;7;Bages;08098;Sant Salvador de Guardiola;1;1;A;;627;160;278;365;262;1;5;359;364
8;Barcelona;7;Bages;08098;Sant Salvador de Guardiola;1;1;B;;595;158;303;400;195;4;11;385;396
8;Barcelona;7;Bages;08098;Sant Salvador de Guardiola;1;2;A;;505;114;183;225;280;0;4;221;225
8;Barcelona;7;Bages;08098;Sant Salvador de Guardiola;1;2;B;;545;132;206;270;275;2;9;259;268
8;Barcelona;7;Bages;08262;Sant Vicenç de Castellet;1;1;A;;604;150;264;314;290;3;5;306;311
8;Barcelona;7;Bages;08262;Sant Vicenç de Castellet;1;1;B;;608;135;270;335;273;0;6;329;335
8;Barcelona;7;Bages;08262;Sant Vicenç de Castellet;1;1;C;;651;159;290;356;295;2;8;346;354
8;Barcelona;7;Bages;08262;Sant Vicenç de Castellet;1;1;D;;592;132;244;311;281;3;12;296;308
8;Barcelona;7;Bages;08262;Sant Vicenç de Castellet;1;2;A;;553;169;265;331;222;1;3;327;330
8;Barcelona;7;Bages;08262;Sant Vicenç de Castellet;1;2;B;;649;151;290;367;282;0;3;364;367
8;Barcelona;7;Bages;08262;Sant Vicenç de Castellet;2;1;A;;516;129;225;279;237;2;7;270;277
8;Barcelona;7;Bages;08262;Sant Vicenç de Castellet;2;1;B;;568;116;224;265;303;2;4;259;263
8;Barcelona;7;Bages;08262;Sant Vicenç de Castellet;2;1;C;;590;150;257;313;277;2;8;303;311
8;Barcelona;7;Bages;08262;Sant Vicenç de Castellet;2;2;A;;484;107;209;266;218;0;5;261;266
8;Barcelona;7;Bages;08262;Sant Vicenç de Castellet;2;2;B;;554;147;243;306;248;0;7;299;306
8;Barcelona;11;Baix Llobregat;08263;Sant Vicenç dels Horts;1;1;U;;650;157;313;406;244;0;11;395;406
8;Barcelona;11;Baix Llobregat;08263;Sant Vicenç dels Horts;1;10;A;;428;126;203;252;176;0;4;248;252
8;Barcelona;11;Baix Llobregat;08263;Sant Vicenç dels Horts;1;10;B;;524;121;221;291;233;0;5;286;291
8;Barcelona;11;Baix Llobregat;08263;Sant Vicenç dels Horts;1;11;A;;459;113;181;240;219;1;9;230;239
8;Barcelona;11;Baix Llobregat;08263;Sant Vicenç dels Horts;1;11;B;;556;117;205;267;289;0;5;262;267
8;Barcelona;11;Baix Llobregat;08263;Sant Vicenç dels Horts;1;12;U;;665;145;246;291;374;1;7;283;290
8;Barcelona;11;Baix Llobregat;08263;Sant Vicenç dels Horts;1;2;A;;639;170;295;390;249;2;5;383;388
8;Barcelona;11;Baix Llobregat;08263;Sant Vicenç dels Horts;1;2;B;;740;208;336;435;305;0;6;429;435
8;Barcelona;11;Baix Llobregat;08263;Sant Vicenç dels Horts;1;3;A;;437;126;214;264;173;2;2;260;262
8;Barcelona;11;Baix Llobregat;08263;Sant Vicenç dels Horts;1;3;B;;533;151;245;310;223;0;7;303;310
8;Barcelona;11;Baix Llobregat;08263;Sant Vicenç dels Horts;1;4;A;;657;157;294;357;300;3;17;337;354
8;Barcelona;11;Baix Llobregat;08263;Sant Vicenç dels Horts;1;4;B;;760;222;346;409;351;1;13;395;408
8;Barcelona;11;Baix Llobregat;08263;Sant Vicenç dels Horts;1;5;A;;561;135;221;294;267;0;6;288;294
8;Barcelona;11;Baix Llobregat;08263;Sant Vicenç dels Horts;1;5;B;;557;144;235;286;271;1;1;284;285
8;Barcelona;11;Baix Llobregat;08263;Sant Vicenç dels Horts;1;6;A;;308;64;117;145;163;0;3;142;145
8;Barcelona;11;Baix Llobregat;08263;Sant Vicenç dels Horts;1;6;B;;377;75;129;162;215;2;4;156;160
8;Barcelona;11;Baix Llobregat;08263;Sant Vicenç dels Horts;1;7;A;;590;149;230;292;298;0;3;289;292
8;Barcelona;11;Baix Llobregat;08263;Sant Vicenç dels Horts;1;7;B;;655;150;241;331;324;1;3;327;330
8;Barcelona;11;Baix Llobregat;08263;Sant Vicenç dels Horts;1;8;U;;870;180;317;399;471;0;13;386;399
8;Barcelona;11;Baix Llobregat;08263;Sant Vicenç dels Horts;1;9;U;;588;125;212;278;310;1;5;272;277
8;Barcelona;11;Baix Llobregat;08263;Sant Vicenç dels Horts;2;1;A;;541;83;139;165;376;1;4;160;164
8;Barcelona;11;Baix Llobregat;08263;Sant Vicenç dels Horts;2;1;B;;552;83;148;182;370;1;1;180;181
8;Barcelona;11;Baix Llobregat;08263;Sant Vicenç dels Horts;2;2;A;;463;97;152;195;268;0;3;192;195
8;Barcelona;11;Baix Llobregat;08263;Sant Vicenç dels Horts;2;2;B;;605;103;181;225;380;0;5;220;225
8;Barcelona;11;Baix Llobregat;08263;Sant Vicenç dels Horts;2;3;A;;441;78;131;160;281;2;2;156;158
8;Barcelona;11;Baix Llobregat;08263;Sant Vicenç dels Horts;2;3;B;;505;65;116;160;345;2;5;153;158
8;Barcelona;11;Baix Llobregat;08263;Sant Vicenç dels Horts;3;1;A;;688;127;227;287;401;0;5;282;287
8;Barcelona;11;Baix Llobregat;08263;Sant Vicenç dels Horts;3;1;B;;771;160;253;308;463;0;5;303;308
8;Barcelona;11;Baix Llobregat;08263;Sant Vicenç dels Horts;3;2;A;;587;107;193;253;334;0;3;250;253
8;Barcelona;11;Baix Llobregat;08263;Sant Vicenç dels Horts;3;2;B;;658;105;204;259;399;1;6;252;258
8;Barcelona;11;Baix Llobregat;08263;Sant Vicenç dels Horts;4;1;A;;504;80;177;245;259;1;4;240;244
8;Barcelona;11;Baix Llobregat;08263;Sant Vicenç dels Horts;4;1;B;;567;117;217;282;285;1;4;277;281
8;Barcelona;11;Baix Llobregat;08263;Sant Vicenç dels Horts;4;2;A;;364;77;132;181;183;1;4;176;180
8;Barcelona;11;Baix Llobregat;08263;Sant Vicenç dels Horts;4;2;B;;782;141;268;343;439;0;2;341;343
8;Barcelona;11;Baix Llobregat;08263;Sant Vicenç dels Horts;4;3;U;;793;172;311;414;379;0;5;409;414
8;Barcelona;21;Maresme;08264;Sant Vicenç de Montalt;1;1;A;;1020;262;530;690;330;1;18;671;689
8;Barcelona;21;Maresme;08264;Sant Vicenç de Montalt;1;1;B;;1022;281;538;656;366;0;18;638;656
8;Barcelona;21;Maresme;08264;Sant Vicenç de Montalt;1;2;A;;709;206;349;422;287;0;5;417;422
8;Barcelona;21;Maresme;08264;Sant Vicenç de Montalt;1;2;B;;912;262;465;540;372;1;7;532;539
8;Barcelona;24;Osona;08265;Sant Vicenç de Torelló;1;1;U;;1194;360;674;815;379;4;20;791;811
8;Barcelona;24;Osona;08265;Sant Vicenç de Torelló;1;2;U;;315;115;182;222;93;0;3;219;222
43;Tarragona;16;Conca de Barberà;43142;Sarral;1;1;A;;479;111;248;299;180;24;9;266;275
43;Tarragona;16;Conca de Barberà;43142;Sarral;1;1;B;;680;157;340;424;256;35;15;374;389
17;Girona;20;Gironès;17186;Sarrià de Ter;1;1;A;;898;288;463;530;368;6;9;515;524
17;Girona;20;Gironès;17186;Sarrià de Ter;1;1;B;;990;313;511;590;400;4;11;575;586
17;Girona;20;Gironès;17186;Sarrià de Ter;1;2;A;;655;207;331;381;274;4;7;370;377
17;Girona;20;Gironès;17186;Sarrià de Ter;1;2;B;;744;208;364;418;326;4;8;406;414
25;Lleida;25;Pallars Jussà;25201;Sarroca de Bellera;1;1;U;;125;32;52;73;52;0;0;73;73
25;Lleida;33;Segrià;25200;Sarroca de Lleida;1;1;U;;377;110;215;257;120;3;4;250;254
17;Girona;2;Alt Empordà;17187;Saus, Camallera i Llampaies;1;1;U;;571;172;344;391;180;0;7;384;391
43;Tarragona;16;Conca de Barberà;43143;Savallà del Comtat;1;1;U;;60;18;41;49;11;0;1;48;49
43;Tarragona;36;Tarragonès;43144;Secuita, la;1;1;A;;414;94;196;250;164;1;5;244;249
43;Tarragona;36;Tarragonès;43144;Secuita, la;1;1;B;;628;157;323;379;249;1;10;368;378
43;Tarragona;8;Baix Camp;43145;Selva del Camp, la;1;1;A;;799;170;379;485;314;2;11;472;483
43;Tarragona;8;Baix Camp;43145;Selva del Camp, la;1;1;B;;832;182;398;518;314;1;18;499;517
43;Tarragona;8;Baix Camp;43145;Selva del Camp, la;2;1;A;;677;147;318;438;239;4;5;429;434
43;Tarragona;8;Baix Camp;43145;Selva del Camp, la;2;1;B;;674;111;291;384;290;3;7;374;381
43;Tarragona;8;Baix Camp;43145;Selva del Camp, la;2;1;C;;685;138;314;448;237;1;11;436;447
17;Girona;2;Alt Empordà;17188;Selva de Mar, la;1;1;U;;172;57;112;130;42;0;2;128;130
43;Tarragona;16;Conca de Barberà;43146;Senan;1;1;U;;40;8;14;32;8;0;0;32;32
43;Tarragona;22;Montsià;43044;Sénia, la;1;1;A;;728;133;282;379;349;1;8;370;378
43;Tarragona;22;Montsià;43044;Sénia, la;1;1;B;;839;156;335;462;377;1;11;450;461
43;Tarragona;22;Montsià;43044;Sénia, la;2;1;A;;747;154;330;425;322;0;8;417;425
43;Tarragona;22;Montsià;43044;Sénia, la;2;1;B;;858;161;360;452;406;8;11;433;444
43;Tarragona;22;Montsià;43044;Sénia, la;2;2;U;;933;169;361;478;455;0;6;472;478
25;Lleida;25;Pallars Jussà;25202;Senterada;1;1;U;;115;36;57;74;41;0;1;73;74
25;Lleida;23;Noguera;25035;Sentiu de Sió, la;1;1;U;;441;124;243;280;161;5;11;264;275
8;Barcelona;40;Vallès Occidental;08267;Sentmenat;1;1;A;;468;81;148;232;236;5;0;227;227
8;Barcelona;40;Vallès Occidental;08267;Sentmenat;1;1;B;;456;82;154;228;228;2;9;217;226
8;Barcelona;40;Vallès Occidental;08267;Sentmenat;1;2;A;;566;129;240;316;250;1;3;312;315
8;Barcelona;40;Vallès Occidental;08267;Sentmenat;1;2;B;;657;162;279;377;280;1;4;372;376
8;Barcelona;40;Vallès Occidental;08267;Sentmenat;1;3;A;;500;111;202;288;212;1;12;275;287
8;Barcelona;40;Vallès Occidental;08267;Sentmenat;1;3;B;;671;168;291;387;284;1;7;379;386
8;Barcelona;40;Vallès Occidental;08267;Sentmenat;1;4;A;;588;156;287;357;231;2;6;349;355
8;Barcelona;40;Vallès Occidental;08267;Sentmenat;1;4;B;;739;212;406;500;239;3;16;481;497
8;Barcelona;40;Vallès Occidental;08267;Sentmenat;1;5;A;;382;81;149;204;178;0;3;201;204
8;Barcelona;40;Vallès Occidental;08267;Sentmenat;1;5;B;;521;99;181;254;267;0;2;252;254
17;Girona;28;Pla de l'Estany;17190;Serinyà;1;1;U;;796;260;496;559;237;1;13;545;558
25;Lleida;33;Segrià;25204;Seròs;1;1;U;;602;120;291;399;203;5;8;386;394
25;Lleida;33;Segrià;25204;Seròs;1;2;U;;811;218;392;508;303;7;11;490;501
17;Girona;10;Baix Empordà;17191;Serra de Daró;1;1;U;;145;65;101;119;26;0;3;116;119
17;Girona;31;Ripollès;17192;Setcases;1;1;U;;146;47;88;110;36;0;3;107;110
25;Lleida;4;Alt Urgell;25203;Seu d'Urgell, la;1;1;U;;671;168;278;347;324;3;5;339;344
25;Lleida;4;Alt Urgell;25203;Seu d'Urgell, la;1;2;A;;596;144;255;332;264;8;3;321;324
25;Lleida;4;Alt Urgell;25203;Seu d'Urgell, la;1;2;B;;586;139;253;333;253;2;8;323;331
25;Lleida;4;Alt Urgell;25203;Seu d'Urgell, la;1;3;A;;590;135;239;296;294;1;8;287;295
25;Lleida;4;Alt Urgell;25203;Seu d'Urgell, la;1;3;B;;621;111;253;321;300;3;8;310;318
25;Lleida;4;Alt Urgell;25203;Seu d'Urgell, la;1;4;A;;675;155;332;419;256;0;7;412;419
25;Lleida;4;Alt Urgell;25203;Seu d'Urgell, la;1;4;B;;589;132;275;338;251;1;11;326;337
25;Lleida;4;Alt Urgell;25203;Seu d'Urgell, la;1;4;C;;711;171;331;417;294;3;11;403;414
25;Lleida;4;Alt Urgell;25203;Seu d'Urgell, la;1;5;A;;617;181;291;361;256;0;11;350;361
25;Lleida;4;Alt Urgell;25203;Seu d'Urgell, la;1;5;B;;682;176;275;349;333;2;5;342;347
25;Lleida;4;Alt Urgell;25203;Seu d'Urgell, la;1;6;A;;377;102;194;239;138;0;9;230;239
25;Lleida;4;Alt Urgell;25203;Seu d'Urgell, la;1;6;B;;446;132;229;271;175;2;15;254;269
25;Lleida;4;Alt Urgell;25203;Seu d'Urgell, la;1;6;C;;361;83;185;214;147;0;7;207;214
25;Lleida;4;Alt Urgell;25203;Seu d'Urgell, la;1;7;A;;735;174;306;393;342;1;22;370;392
25;Lleida;4;Alt Urgell;25203;Seu d'Urgell, la;1;7;B;;787;202;325;405;382;0;11;394;405
8;Barcelona;24;Osona;08269;Seva;1;1;A;;647;198;352;439;208;7;9;423;432
8;Barcelona;24;Osona;08269;Seva;1;1;B;;831;246;466;563;268;6;11;546;557
8;Barcelona;24;Osona;08269;Seva;1;2;U;;983;305;592;676;307;5;9;662;671
25;Lleida;27;Pla d'Urgell;25205;Sidamon;1;1;U;;570;175;307;378;192;3;12;363;375
17;Girona;34;Selva;17193;Sils;1;1;A;;742;185;340;409;333;1;5;403;408
17;Girona;34;Selva;17193;Sils;1;1;B;;764;180;359;438;326;0;3;435;438
17;Girona;34;Selva;17193;Sils;1;2;U;;773;180;368;424;349;4;8;412;420
17;Girona;34;Selva;17193;Sils;1;3;U;;924;165;259;305;619;3;6;296;302
8;Barcelona;17;Garraf;08270;Sitges;1;1;A;;462;143;215;281;181;1;5;275;280
8;Barcelona;17;Garraf;08270;Sitges;1;1;B;;512;147;231;305;207;2;9;294;303
8;Barcelona;17;Garraf;08270;Sitges;1;2;A;;501;148;240;294;207;3;6;285;291
8;Barcelona;17;Garraf;08270;Sitges;1;2;B;;683;228;350;430;253;1;9;420;429
8;Barcelona;17;Garraf;08270;Sitges;1;3;A;;676;270;339;420;256;0;10;410;420
8;Barcelona;17;Garraf;08270;Sitges;1;3;B;;844;270;450;537;307;1;14;522;536
8;Barcelona;17;Garraf;08270;Sitges;1;4;A;;578;190;298;359;219;1;4;354;358
8;Barcelona;17;Garraf;08270;Sitges;1;4;B;;662;196;304;388;274;1;2;385;387
8;Barcelona;17;Garraf;08270;Sitges;2;1;A;;675;211;342;420;255;2;12;406;418
8;Barcelona;17;Garraf;08270;Sitges;2;1;B;;849;282;451;546;303;0;19;527;546
8;Barcelona;17;Garraf;08270;Sitges;2;10;U;;1064;312;519;643;421;1;14;628;642
8;Barcelona;17;Garraf;08270;Sitges;2;2;A;;641;198;319;406;235;3;5;398;403
8;Barcelona;17;Garraf;08270;Sitges;2;2;B;;683;208;329;416;267;2;9;405;414
8;Barcelona;17;Garraf;08270;Sitges;2;2;C;;645;218;330;412;233;1;13;398;411
8;Barcelona;17;Garraf;08270;Sitges;2;3;A;;615;180;294;354;261;1;6;347;353
8;Barcelona;17;Garraf;08270;Sitges;2;3;B;;794;224;394;490;304;1;9;480;489
8;Barcelona;17;Garraf;08270;Sitges;2;4;A;;555;150;245;312;243;3;6;303;309
8;Barcelona;17;Garraf;08270;Sitges;2;4;B;;731;211;307;396;335;2;9;385;394
8;Barcelona;17;Garraf;08270;Sitges;2;5;A;;403;117;207;250;153;0;5;245;250
8;Barcelona;17;Garraf;08270;Sitges;2;5;B;;556;159;275;341;215;1;3;337;340
8;Barcelona;17;Garraf;08270;Sitges;2;6;A;;543;175;301;359;184;1;14;344;358
8;Barcelona;17;Garraf;08270;Sitges;2;6;B;;602;188;311;378;224;3;6;369;375
8;Barcelona;17;Garraf;08270;Sitges;2;7;U;;593;154;250;318;275;0;9;309;318
8;Barcelona;17;Garraf;08270;Sitges;2;8;U;;551;167;270;336;215;1;8;327;335
8;Barcelona;17;Garraf;08270;Sitges;2;9;A;;223;64;121;153;70;3;3;147;150
8;Barcelona;17;Garraf;08270;Sitges;2;9;B;;1062;250;470;597;465;1;10;586;596
17;Girona;2;Alt Empordà;17052;Siurana;1;1;U;;147;43;66;86;61;0;4;82;86
8;Barcelona;24;Osona;08271;Sobremunt;1;1;U;;78;19;41;51;27;0;1;50;51
25;Lleida;18;Garrigues;25206;Soleràs, el;1;1;U;;318;60;180;236;82;0;5;231;236
43;Tarragona;16;Conca de Barberà;43147;Solivella;1;1;U;;531;160;298;358;173;4;13;341;354
25;Lleida;35;Solsonès;25207;Solsona;1;1;A;;693;186;381;453;240;7;9;437;446
25;Lleida;35;Solsonès;25207;Solsona;1;1;B;;791;183;393;497;294;6;11;480;491
25;Lleida;35;Solsonès;25207;Solsona;1;2;A;;639;161;297;363;276;3;14;346;360
25;Lleida;35;Solsonès;25207;Solsona;1;2;B;;732;157;326;405;327;2;6;397;403
25;Lleida;35;Solsonès;25207;Solsona;1;3;A;;471;114;228;289;182;0;10;279;289
25;Lleida;35;Solsonès;25207;Solsona;1;3;B;;548;142;273;336;212;1;3;332;335
25;Lleida;35;Solsonès;25207;Solsona;2;1;A;;510;146;267;340;170;1;7;332;339
25;Lleida;35;Solsonès;25207;Solsona;2;1;B;;709;187;337;435;274;3;17;415;432
25;Lleida;35;Solsonès;25207;Solsona;2;2;A;;464;116;240;292;172;3;6;283;289
25;Lleida;35;Solsonès;25207;Solsona;2;2;B;;626;173;320;395;231;5;10;380;390
8;Barcelona;24;Osona;08272;Sora;1;1;U;;143;34;69;95;48;0;2;93;95
25;Lleida;26;Pallars Sobirà;25208;Soriguera;1;1;U;;291;46;106;160;131;1;3;156;159
25;Lleida;26;Pallars Sobirà;25209;Sort;1;1;A;;722;221;376;494;228;5;5;484;489
25;Lleida;26;Pallars Sobirà;25209;Sort;1;1;B;;863;269;476;596;267;7;20;569;589
25;Lleida;33;Segrià;25210;Soses;1;1;U;;1200;270;612;777;423;5;6;766;772
8;Barcelona;3;Alt Penedès;08273;Subirats;1;1;U;;630;206;392;472;158;6;11;455;466
8;Barcelona;3;Alt Penedès;08273;Subirats;1;2;A;;486;132;292;356;130;3;8;345;353
8;Barcelona;3;Alt Penedès;08273;Subirats;1;2;B;;503;125;217;254;249;1;4;249;253
8;Barcelona;3;Alt Penedès;08273;Subirats;1;3;U;;639;186;380;453;186;2;9;442;451
25;Lleida;33;Segrià;25211;Sudanell;1;1;U;;668;102;251;333;335;3;8;322;330
25;Lleida;33;Segrià;25212;Sunyer;1;1;U;;239;85;158;189;50;1;4;184;188
8;Barcelona;7;Bages;08274;Súria;1;1;A;;763;238;429;505;258;3;11;491;502
8;Barcelona;7;Bages;08274;Súria;1;1;B;;785;219;428;527;258;2;8;517;525
8;Barcelona;7;Bages;08274;Súria;1;2;U;;588;184;288;347;241;1;5;341;346
8;Barcelona;7;Bages;08274;Súria;1;3;U;;331;74;141;177;154;2;5;170;175
8;Barcelona;7;Bages;08274;Súria;1;4;A;;730;197;368;450;280;1;7;442;449
8;Barcelona;7;Bages;08274;Súria;1;4;B;;774;219;392;465;309;5;3;457;460
8;Barcelona;7;Bages;08274;Súria;1;5;A;;532;156;293;349;183;0;10;339;349
8;Barcelona;7;Bages;08274;Súria;1;5;B;;540;165;294;352;188;3;7;342;349
17;Girona;34;Selva;17194;Susqueda;1;1;U;;92;22;41;66;26;1;2;63;65
8;Barcelona;41;Vallès Oriental;08276;Tagamanent;1;1;U;;232;80;108;148;84;1;4;143;147
8;Barcelona;7;Bages;08277;Talamanca;1;1;U;;116;37;62;83;33;0;0;83;83
25;Lleida;25;Pallars Jussà;25215;Talarn;1;1;U;;296;83;165;205;91;2;8;195;203
25;Lleida;32;Segarra;25216;Talavera;1;1;U;;253;64;149;184;69;0;8;176;184
17;Girona;10;Baix Empordà;17195;Tallada d'Empordà, la;1;1;U;;301;119;183;214;87;2;4;208;212
8;Barcelona;24;Osona;08278;Taradell;1;1;A;;720;223;413;512;208;0;20;492;512
8;Barcelona;24;Osona;08278;Taradell;1;1;B;;348;80;181;217;131;0;6;211;217
8;Barcelona;24;Osona;08278;Taradell;1;1;C;;560;147;313;377;183;0;8;369;377
8;Barcelona;24;Osona;08278;Taradell;1;1;D;;731;232;423;511;220;5;8;498;506
8;Barcelona;24;Osona;08278;Taradell;1;2;A;;900;258;491;566;334;0;0;566;566
8;Barcelona;24;Osona;08278;Taradell;1;2;B;;524;129;274;337;187;0;9;328;337
8;Barcelona;24;Osona;08278;Taradell;1;2;C;;611;163;336;399;212;0;9;390;399
43;Tarragona;36;Tarragonès;43148;Tarragona;1;1;A;;540;158;244;293;247;2;7;284;291
43;Tarragona;36;Tarragonès;43148;Tarragona;1;1;B;;608;175;283;340;268;3;9;328;337
43;Tarragona;36;Tarragonès;43148;Tarragona;2;1;A;;406;111;178;217;189;0;7;210;217
43;Tarragona;36;Tarragonès;43148;Tarragona;2;1;B;;449;120;197;243;206;1;8;234;242
43;Tarragona;36;Tarragonès;43148;Tarragona;3;1;A;;432;165;210;257;175;0;4;253;257
43;Tarragona;36;Tarragonès;43148;Tarragona;3;1;B;;440;153;227;273;167;0;2;271;273
43;Tarragona;36;Tarragonès;43148;Tarragona;3;2;A;;614;177;326;407;207;2;7;398;405
43;Tarragona;36;Tarragonès;43148;Tarragona;3;2;B;;597;155;292;396;201;0;9;387;396
43;Tarragona;36;Tarragonès;43148;Tarragona;3;3;A;;505;151;273;372;133;1;9;362;371
43;Tarragona;36;Tarragonès;43148;Tarragona;3;3;B;;493;130;302;343;150;0;6;337;343
43;Tarragona;36;Tarragonès;43148;Tarragona;3;3;C;;562;166;252;401;161;2;10;389;399
43;Tarragona;36;Tarragonès;43148;Tarragona;4;1;U;;610;215;362;415;195;3;10;402;412
43;Tarragona;36;Tarragonès;43148;Tarragona;4;10;A;;463;162;222;268;195;0;5;263;268
43;Tarragona;36;Tarragonès;43148;Tarragona;4;10;B;;531;184;261;317;214;1;3;313;316
43;Tarragona;36;Tarragonès;43148;Tarragona;4;11;U;;479;133;225;269;210;2;3;264;267
43;Tarragona;36;Tarragonès;43148;Tarragona;4;12;U;;609;203;324;385;224;0;5;380;385
43;Tarragona;36;Tarragonès;43148;Tarragona;4;13;A;;299;72;128;154;145;1;5;148;153
43;Tarragona;36;Tarragonès;43148;Tarragona;4;13;B;;351;81;141;197;154;1;4;192;196
43;Tarragona;36;Tarragonès;43148;Tarragona;4;14;A;;453;106;206;264;189;0;7;257;264
43;Tarragona;36;Tarragonès;43148;Tarragona;4;14;B;;456;126;198;262;194;1;7;254;261
43;Tarragona;36;Tarragonès;43148;Tarragona;4;14;C;;503;142;264;322;181;2;9;311;320
43;Tarragona;36;Tarragonès;43148;Tarragona;4;15;A;;331;89;168;211;120;1;3;207;210
43;Tarragona;36;Tarragonès;43148;Tarragona;4;15;B;;363;99;166;227;136;1;4;222;226
43;Tarragona;36;Tarragonès;43148;Tarragona;4;16;A;;543;174;288;387;156;2;4;381;385
43;Tarragona;36;Tarragonès;43148;Tarragona;4;16;B;;649;191;337;452;197;1;7;444;451
43;Tarragona;36;Tarragonès;43148;Tarragona;4;2;U;;606;175;305;380;226;2;12;366;378
43;Tarragona;36;Tarragonès;43148;Tarragona;4;3;U;;615;185;284;353;262;0;9;344;353
43;Tarragona;36;Tarragonès;43148;Tarragona;4;4;A;;400;129;203;252;148;1;2;249;251
43;Tarragona;36;Tarragonès;43148;Tarragona;4;4;B;;473;153;241;303;170;0;8;295;303
43;Tarragona;36;Tarragonès;43148;Tarragona;4;5;A;;415;134;226;276;139;0;5;271;276
43;Tarragona;36;Tarragonès;43148;Tarragona;4;5;B;;478;134;211;292;186;0;6;286;292
43;Tarragona;36;Tarragonès;43148;Tarragona;4;6;A;;520;162;276;342;178;0;2;340;342
43;Tarragona;36;Tarragonès;43148;Tarragona;4;6;B;;603;180;302;390;213;1;4;385;389
43;Tarragona;36;Tarragonès;43148;Tarragona;4;7;A;;321;136;192;231;90;1;9;221;230
43;Tarragona;36;Tarragonès;43148;Tarragona;4;7;B;;331;113;172;211;120;2;4;205;209
43;Tarragona;36;Tarragonès;43148;Tarragona;4;8;A;;454;136;238;291;163;1;5;285;290
43;Tarragona;36;Tarragonès;43148;Tarragona;4;8;B;;399;111;187;244;155;0;4;240;244
43;Tarragona;36;Tarragonès;43148;Tarragona;4;8;C;;457;142;237;295;162;0;11;284;295
43;Tarragona;36;Tarragonès;43148;Tarragona;4;9;A;;453;146;252;322;131;0;3;319;322
43;Tarragona;36;Tarragonès;43148;Tarragona;4;9;B;;558;150;283;365;193;2;4;359;363
43;Tarragona;36;Tarragonès;43148;Tarragona;5;1;A;;422;140;223;277;145;0;10;267;277
43;Tarragona;36;Tarragonès;43148;Tarragona;5;1;B;;461;163;244;294;167;0;6;288;294
43;Tarragona;36;Tarragonès;43148;Tarragona;5;2;A;;411;128;201;246;165;0;5;241;246
43;Tarragona;36;Tarragonès;43148;Tarragona;5;2;B;;405;126;203;256;149;1;2;253;255
43;Tarragona;36;Tarragonès;43148;Tarragona;5;3;A;;421;128;182;237;184;0;4;233;237
43;Tarragona;36;Tarragonès;43148;Tarragona;5;3;B;;466;134;219;276;190;2;3;271;274
43;Tarragona;36;Tarragonès;43148;Tarragona;5;4;A;;417;126;187;247;170;0;8;239;247
43;Tarragona;36;Tarragonès;43148;Tarragona;5;4;B;;501;130;207;274;227;2;4;268;272
43;Tarragona;36;Tarragonès;43148;Tarragona;5;5;A;;525;133;223;286;239;0;2;284;286
43;Tarragona;36;Tarragonès;43148;Tarragona;5;5;B;;585;150;265;332;253;0;1;331;332
43;Tarragona;36;Tarragonès;43148;Tarragona;5;6;A;;407;83;135;176;231;1;0;175;175
43;Tarragona;36;Tarragonès;43148;Tarragona;5;6;B;;412;88;135;182;230;1;4;177;181
43;Tarragona;36;Tarragonès;43148;Tarragona;5;7;A;;341;98;154;190;151;2;3;185;188
43;Tarragona;36;Tarragonès;43148;Tarragona;5;7;B;;391;110;188;225;166;1;3;221;224
43;Tarragona;36;Tarragonès;43148;Tarragona;5;8;A;;609;170;282;368;241;1;0;367;367
43;Tarragona;36;Tarragonès;43148;Tarragona;5;8;B;;694;196;323;408;286;0;4;404;408
43;Tarragona;36;Tarragonès;43148;Tarragona;5;9;U;;568;166;280;378;190;3;8;367;375
43;Tarragona;36;Tarragonès;43148;Tarragona;6;1;A;;444;131;222;294;150;1;7;286;293
43;Tarragona;36;Tarragonès;43148;Tarragona;6;1;B;;410;117;211;262;148;1;4;257;261
43;Tarragona;36;Tarragonès;43148;Tarragona;6;1;C;;462;162;247;317;145;0;7;310;317
43;Tarragona;36;Tarragonès;43148;Tarragona;6;10;A;;405;129;207;265;140;2;6;257;263
43;Tarragona;36;Tarragonès;43148;Tarragona;6;10;B;;370;119;173;217;153;0;4;213;217
43;Tarragona;36;Tarragonès;43148;Tarragona;6;10;C;;441;150;223;294;147;2;2;290;292
43;Tarragona;36;Tarragonès;43148;Tarragona;6;11;A;;424;146;210;264;160;3;6;255;261
43;Tarragona;36;Tarragonès;43148;Tarragona;6;11;B;;376;162;175;218;158;0;6;212;218
43;Tarragona;36;Tarragonès;43148;Tarragona;6;11;C;;469;160;239;296;173;2;4;290;294
43;Tarragona;36;Tarragonès;43148;Tarragona;6;12;A;;546;182;286;376;170;0;4;372;376
43;Tarragona;36;Tarragonès;43148;Tarragona;6;12;B;;598;192;300;413;185;2;5;406;411
43;Tarragona;36;Tarragonès;43148;Tarragona;6;13;A;;376;105;204;257;119;0;3;254;257
43;Tarragona;36;Tarragonès;43148;Tarragona;6;13;B;;388;109;172;224;164;2;1;221;222
43;Tarragona;36;Tarragonès;43148;Tarragona;6;14;U;;515;165;259;312;203;1;3;308;311
43;Tarragona;36;Tarragonès;43148;Tarragona;6;15;A;;338;69;144;152;186;0;1;151;152
43;Tarragona;36;Tarragonès;43148;Tarragona;6;15;B;;397;124;175;201;196;0;3;198;201
43;Tarragona;36;Tarragonès;43148;Tarragona;6;16;A;;545;173;282;338;207;1;8;329;337
43;Tarragona;36;Tarragonès;43148;Tarragona;6;16;B;;514;158;268;331;183;5;1;325;326
43;Tarragona;36;Tarragonès;43148;Tarragona;6;16;C;;621;188;314;388;233;3;3;382;385
43;Tarragona;36;Tarragonès;43148;Tarragona;6;2;A;;596;152;278;358;238;2;4;352;356
43;Tarragona;36;Tarragonès;43148;Tarragona;6;2;B;;561;157;272;350;211;0;7;343;350
43;Tarragona;36;Tarragonès;43148;Tarragona;6;2;C;;672;200;320;395;277;1;7;387;394
43;Tarragona;36;Tarragonès;43148;Tarragona;6;3;A;;472;111;197;249;223;3;3;243;246
43;Tarragona;36;Tarragonès;43148;Tarragona;6;3;B;;472;114;187;238;234;1;1;236;237
43;Tarragona;36;Tarragonès;43148;Tarragona;6;3;C;;416;104;172;207;209;1;3;203;206
43;Tarragona;36;Tarragonès;43148;Tarragona;6;4;A;;319;96;144;167;152;0;0;167;167
43;Tarragona;36;Tarragonès;43148;Tarragona;6;4;B;;365;93;160;196;169;1;2;193;195
43;Tarragona;36;Tarragonès;43148;Tarragona;6;5;A;;350;64;102;139;211;1;2;136;138
43;Tarragona;36;Tarragonès;43148;Tarragona;6;5;B;;472;85;148;214;258;2;4;208;212
43;Tarragona;36;Tarragonès;43148;Tarragona;6;6;A;;338;56;105;138;200;0;0;138;138
43;Tarragona;36;Tarragonès;43148;Tarragona;6;6;B;;296;67;109;140;156;0;1;139;140
43;Tarragona;36;Tarragonès;43148;Tarragona;6;7;U;;374;106;165;207;167;0;0;207;207
43;Tarragona;36;Tarragonès;43148;Tarragona;6;8;A;;399;126;201;262;137;0;5;257;262
43;Tarragona;36;Tarragonès;43148;Tarragona;6;8;B;;455;161;258;315;140;4;1;310;311
43;Tarragona;36;Tarragonès;43148;Tarragona;6;9;A;;545;185;278;352;193;0;6;346;352
43;Tarragona;36;Tarragonès;43148;Tarragona;6;9;B;;482;138;219;272;210;1;4;267;271
43;Tarragona;36;Tarragonès;43148;Tarragona;6;9;C;;577;169;261;338;239;1;5;332;337
43;Tarragona;36;Tarragonès;43148;Tarragona;7;1;U;;575;172;269;322;253;0;5;317;322
43;Tarragona;36;Tarragonès;43148;Tarragona;7;10;A;;484;107;162;207;277;0;3;204;207
43;Tarragona;36;Tarragonès;43148;Tarragona;7;10;B;;582;134;224;273;309;0;1;272;273
43;Tarragona;36;Tarragonès;43148;Tarragona;7;11;A;;547;96;208;228;319;2;6;220;226
43;Tarragona;36;Tarragonès;43148;Tarragona;7;11;B;;525;116;267;227;298;0;0;227;227
43;Tarragona;36;Tarragonès;43148;Tarragona;7;11;C;;502;162;194;247;255;0;2;245;247
43;Tarragona;36;Tarragonès;43148;Tarragona;7;12;A;;773;162;272;355;418;1;5;349;354
43;Tarragona;36;Tarragonès;43148;Tarragona;7;12;B;;792;161;289;361;431;0;6;355;361
43;Tarragona;36;Tarragonès;43148;Tarragona;7;12;C;;781;156;259;352;429;2;3;347;350
43;Tarragona;36;Tarragonès;43148;Tarragona;7;13;A;;612;133;275;385;227;2;9;374;383
43;Tarragona;36;Tarragonès;43148;Tarragona;7;13;B;;613;119;248;349;264;1;7;341;348
43;Tarragona;36;Tarragonès;43148;Tarragona;7;13;C;;688;163;326;434;254;5;15;414;429
43;Tarragona;36;Tarragonès;43148;Tarragona;7;14;A;;369;115;195;248;121;0;2;246;248
43;Tarragona;36;Tarragonès;43148;Tarragona;7;14;B;;414;132;226;302;112;0;4;298;302
43;Tarragona;36;Tarragonès;43148;Tarragona;7;15;A;;544;129;208;269;275;1;5;263;268
43;Tarragona;36;Tarragonès;43148;Tarragona;7;15;B;;633;162;267;336;297;2;4;330;334
43;Tarragona;36;Tarragonès;43148;Tarragona;7;16;A;;531;137;256;328;203;1;6;321;327
43;Tarragona;36;Tarragonès;43148;Tarragona;7;16;B;;537;287;287;353;184;0;14;339;353
43;Tarragona;36;Tarragonès;43148;Tarragona;7;16;C;;512;165;256;316;196;0;10;306;316
43;Tarragona;36;Tarragonès;43148;Tarragona;7;17;A;;635;186;321;409;226;1;7;401;408
43;Tarragona;36;Tarragonès;43148;Tarragona;7;17;B;;655;162;292;401;254;1;3;397;400
43;Tarragona;36;Tarragonès;43148;Tarragona;7;18;A;;577;108;220;284;293;0;3;281;284
43;Tarragona;36;Tarragonès;43148;Tarragona;7;18;B;;698;156;265;355;343;0;3;352;355
43;Tarragona;36;Tarragonès;43148;Tarragona;7;19;A;;495;132;207;266;229;2;3;261;264
43;Tarragona;36;Tarragonès;43148;Tarragona;7;19;B;;423;113;168;222;201;4;7;211;218
43;Tarragona;36;Tarragonès;43148;Tarragona;7;19;C;;611;141;229;322;289;3;6;313;319
43;Tarragona;36;Tarragonès;43148;Tarragona;7;19;D;;534;163;249;305;229;0;8;297;305
43;Tarragona;36;Tarragonès;43148;Tarragona;7;2;A;;517;156;238;291;226;1;4;286;290
43;Tarragona;36;Tarragonès;43148;Tarragona;7;2;B;;585;156;275;351;234;4;8;339;347
43;Tarragona;36;Tarragonès;43148;Tarragona;7;3;A;;431;90;151;183;248;0;3;180;183
43;Tarragona;36;Tarragonès;43148;Tarragona;7;3;B;;442;81;151;186;256;0;4;182;186
43;Tarragona;36;Tarragonès;43148;Tarragona;7;3;C;;494;115;186;233;261;0;2;231;233
43;Tarragona;36;Tarragonès;43148;Tarragona;7;4;A;;832;176;306;420;412;1;6;413;419
43;Tarragona;36;Tarragonès;43148;Tarragona;7;4;B;;903;188;346;459;444;4;15;440;455
43;Tarragona;36;Tarragonès;43148;Tarragona;7;5;A;;337;67;97;119;218;0;1;118;119
43;Tarragona;36;Tarragonès;43148;Tarragona;7;5;B;;414;62;88;113;301;0;5;108;113
43;Tarragona;36;Tarragonès;43148;Tarragona;7;6;A;;478;121;186;233;245;0;3;230;233
43;Tarragona;36;Tarragonès;43148;Tarragona;7;6;B;;492;109;187;247;245;1;2;244;246
43;Tarragona;36;Tarragonès;43148;Tarragona;7;7;A;;452;111;216;282;170;0;9;273;282
43;Tarragona;36;Tarragonès;43148;Tarragona;7;7;B;;508;123;234;299;209;0;9;290;299
43;Tarragona;36;Tarragonès;43148;Tarragona;7;7;C;;309;84;126;157;152;0;6;151;157
43;Tarragona;36;Tarragonès;43148;Tarragona;7;7;D;;545;170;268;343;202;1;8;334;342
43;Tarragona;36;Tarragonès;43148;Tarragona;7;7;E;;672;194;318;413;259;2;21;390;411
43;Tarragona;36;Tarragonès;43148;Tarragona;7;8;A;;539;151;266;355;184;3;6;346;352
43;Tarragona;36;Tarragonès;43148;Tarragona;7;8;B;;565;154;277;363;202;0;10;353;363
43;Tarragona;36;Tarragonès;43148;Tarragona;7;8;C;;638;177;330;431;207;1;11;419;430
43;Tarragona;36;Tarragonès;43148;Tarragona;7;9;U;;568;104;164;214;354;0;9;205;214
43;Tarragona;36;Tarragonès;43148;Tarragona;8;1;A;;419;104;156;193;226;3;3;187;190
43;Tarragona;36;Tarragonès;43148;Tarragona;8;1;B;;403;69;115;151;252;1;4;146;150
43;Tarragona;36;Tarragonès;43148;Tarragona;8;1;C;;430;85;134;177;253;1;1;175;176
43;Tarragona;36;Tarragonès;43148;Tarragona;8;10;A;;415;61;91;115;300;0;0;115;115
43;Tarragona;36;Tarragonès;43148;Tarragona;8;10;B;;434;53;103;127;307;0;1;126;127
43;Tarragona;36;Tarragonès;43148;Tarragona;8;11;A;;497;104;186;236;261;1;5;230;235
43;Tarragona;36;Tarragonès;43148;Tarragona;8;11;B;;524;112;179;246;278;1;0;245;245
43;Tarragona;36;Tarragonès;43148;Tarragona;8;12;U;;570;70;124;154;416;0;3;151;154
43;Tarragona;36;Tarragonès;43148;Tarragona;8;13;A;;353;65;124;156;197;2;1;153;154
43;Tarragona;36;Tarragonès;43148;Tarragona;8;13;B;;359;69;119;152;207;0;1;151;152
43;Tarragona;36;Tarragonès;43148;Tarragona;8;14;U;;565;122;186;222;343;1;1;220;221
43;Tarragona;36;Tarragonès;43148;Tarragona;8;2;A;;428;114;179;209;219;1;0;208;208
43;Tarragona;36;Tarragonès;43148;Tarragona;8;2;B;;480;107;178;218;262;1;4;213;217
43;Tarragona;36;Tarragonès;43148;Tarragona;8;3;A;;418;102;171;202;216;0;1;201;202
43;Tarragona;36;Tarragonès;43148;Tarragona;8;3;B;;461;99;167;207;254;3;4;200;204
43;Tarragona;36;Tarragonès;43148;Tarragona;8;3;C;;479;114;168;218;261;0;4;214;218
43;Tarragona;36;Tarragonès;43148;Tarragona;8;4;A;;466;124;192;237;229;0;1;236;237
43;Tarragona;36;Tarragonès;43148;Tarragona;8;4;B;;488;146;204;248;240;0;4;244;248
43;Tarragona;36;Tarragonès;43148;Tarragona;8;5;A;;422;80;115;160;262;0;3;157;160
43;Tarragona;36;Tarragonès;43148;Tarragona;8;5;B;;545;106;183;229;316;2;4;223;227
43;Tarragona;36;Tarragonès;43148;Tarragona;8;6;A;;442;92;163;205;237;0;3;202;205
43;Tarragona;36;Tarragonès;43148;Tarragona;8;6;B;;523;116;186;246;277;3;5;238;243
43;Tarragona;36;Tarragonès;43148;Tarragona;8;6;C;;476;111;171;223;253;0;3;220;223
43;Tarragona;36;Tarragonès;43148;Tarragona;8;7;A;;444;92;149;197;247;0;6;191;197
43;Tarragona;36;Tarragonès;43148;Tarragona;8;7;B;;488;90;172;204;284;0;8;196;204
43;Tarragona;36;Tarragonès;43148;Tarragona;8;7;C;;440;91;147;197;243;1;2;194;196
43;Tarragona;36;Tarragonès;43148;Tarragona;8;8;A;;420;71;117;148;272;1;0;147;147
43;Tarragona;36;Tarragonès;43148;Tarragona;8;8;B;;540;110;178;213;327;1;2;210;212
43;Tarragona;36;Tarragonès;43148;Tarragona;8;9;A;;559;98;192;254;305;0;4;250;254
43;Tarragona;36;Tarragonès;43148;Tarragona;8;9;B;;626;101;199;266;360;0;4;262;266
43;Tarragona;36;Tarragonès;43148;Tarragona;8;9;C;;649;115;229;298;351;1;5;292;297
43;Tarragona;36;Tarragonès;43148;Tarragona;9;1;A;;435;83;133;184;251;1;3;180;183
43;Tarragona;36;Tarragonès;43148;Tarragona;9;1;B;;484;86;137;177;307;0;4;173;177
43;Tarragona;36;Tarragonès;43148;Tarragona;9;10;A;;500;74;135;176;324;0;7;169;176
43;Tarragona;36;Tarragonès;43148;Tarragona;9;10;B;;540;98;146;194;346;0;5;189;194
43;Tarragona;36;Tarragonès;43148;Tarragona;9;2;A;;392;66;116;151;241;1;0;150;150
43;Tarragona;36;Tarragonès;43148;Tarragona;9;2;B;;414;80;134;161;253;1;2;158;160
43;Tarragona;36;Tarragonès;43148;Tarragona;9;3;A;;324;38;73;114;210;1;1;112;113
43;Tarragona;36;Tarragonès;43148;Tarragona;9;3;B;;392;79;120;163;229;2;2;159;161
43;Tarragona;36;Tarragonès;43148;Tarragona;9;4;A;;424;75;113;156;268;0;2;154;156
43;Tarragona;36;Tarragonès;43148;Tarragona;9;4;B;;540;104;167;207;333;1;4;202;206
43;Tarragona;36;Tarragonès;43148;Tarragona;9;5;A;;521;119;222;285;236;2;2;281;283
43;Tarragona;36;Tarragonès;43148;Tarragona;9;5;B;;620;137;250;310;310;6;2;302;304
43;Tarragona;36;Tarragonès;43148;Tarragona;9;6;A;;545;127;208;259;286;0;2;257;259
43;Tarragona;36;Tarragonès;43148;Tarragona;9;6;B;;622;138;234;291;331;0;0;291;291
43;Tarragona;36;Tarragonès;43148;Tarragona;9;6;C;;624;142;240;310;314;1;6;303;309
43;Tarragona;36;Tarragonès;43148;Tarragona;9;7;A;;399;91;185;234;165;0;6;228;234
43;Tarragona;36;Tarragonès;43148;Tarragona;9;7;B;;405;116;194;241;164;1;3;237;240
43;Tarragona;36;Tarragonès;43148;Tarragona;9;8;U;;709;122;193;272;437;1;1;270;271
43;Tarragona;36;Tarragonès;43148;Tarragona;9;9;U;;656;134;204;282;374;3;2;277;279
25;Lleida;38;Urgell;25217;Tàrrega;1;1;A;;735;159;337;414;321;0;12;402;414
25;Lleida;38;Urgell;25217;Tàrrega;1;1;B;;860;205;372;487;373;5;13;469;482
25;Lleida;38;Urgell;25217;Tàrrega;1;2;U;;596;158;290;356;240;1;6;349;355
25;Lleida;38;Urgell;25217;Tàrrega;2;1;A;;452;122;233;277;175;1;6;270;276
25;Lleida;38;Urgell;25217;Tàrrega;2;1;B;;512;146;273;332;180;3;8;321;329
25;Lleida;38;Urgell;25217;Tàrrega;2;2;A;;571;151;292;384;187;2;7;375;382
25;Lleida;38;Urgell;25217;Tàrrega;2;2;B;;709;198;365;476;233;5;16;455;471
25;Lleida;38;Urgell;25217;Tàrrega;2;3;A;;438;124;124;249;189;0;8;241;249
25;Lleida;38;Urgell;25217;Tàrrega;2;3;B;;506;121;233;318;188;0;19;299;318
25;Lleida;38;Urgell;25217;Tàrrega;3;1;A;;487;109;213;284;203;5;5;274;279
25;Lleida;38;Urgell;25217;Tàrrega;3;1;B;;659;158;309;392;267;1;17;374;391
25;Lleida;38;Urgell;25217;Tàrrega;3;2;U;;638;165;313;413;225;9;17;387;404
25;Lleida;38;Urgell;25217;Tàrrega;3;3;A;;470;131;225;286;184;0;13;273;286
25;Lleida;38;Urgell;25217;Tàrrega;3;3;B;;483;119;238;302;181;0;15;287;302
25;Lleida;38;Urgell;25217;Tàrrega;4;1;U;;591;157;266;356;235;6;15;335;350
25;Lleida;38;Urgell;25217;Tàrrega;4;2;A;;493;148;239;303;190;2;14;287;301
25;Lleida;38;Urgell;25217;Tàrrega;4;2;B;;597;150;315;373;224;7;15;351;366
25;Lleida;38;Urgell;25217;Tàrrega;5;1;A;;332;90;177;218;114;3;3;212;215
25;Lleida;38;Urgell;25217;Tàrrega;5;1;B;;208;54;112;139;69;2;11;126;137
25;Lleida;18;Garrigues;25218;Tarrés;1;1;U;;99;31;56;70;29;0;1;69;70
25;Lleida;32;Segarra;25219;Tarroja de Segarra;1;1;U;;150;30;76;103;47;2;7;94;101
8;Barcelona;24;Osona;08275;Tavèrnoles;1;1;U;;248;83;147;190;58;0;5;185;190
8;Barcelona;24;Osona;08280;Tavertet;1;1;U;;125;41;65;83;42;0;1;82;83
8;Barcelona;21;Maresme;08281;Teià;1;1;A;;770;217;436;533;237;0;19;514;533
8;Barcelona;21;Maresme;08281;Teià;1;1;B;;876;274;506;622;254;1;10;611;621
8;Barcelona;21;Maresme;08281;Teià;1;2;A;;699;208;375;453;246;2;15;436;451
8;Barcelona;21;Maresme;08281;Teià;1;2;B;;779;211;415;513;266;0;13;500;513
8;Barcelona;21;Maresme;08281;Teià;1;3;A;;684;179;355;453;231;3;12;438;450
8;Barcelona;21;Maresme;08281;Teià;1;3;B;;735;187;356;471;264;2;5;464;469
25;Lleida;23;Noguera;25220;Térmens;1;1;A;;487;111;234;289;198;0;7;282;289
25;Lleida;23;Noguera;25220;Térmens;1;1;B;;630;131;337;401;229;2;7;392;399
17;Girona;2;Alt Empordà;17196;Terrades;1;1;U;;183;56;114;128;55;1;3;124;127
8;Barcelona;40;Vallès Occidental;08279;Terrassa;1;1;A;;499;161;298;367;132;0;14;353;367
8;Barcelona;40;Vallès Occidental;08279;Terrassa;1;1;B;;542;172;318;400;142;1;9;390;399
8;Barcelona;40;Vallès Occidental;08279;Terrassa;1;10;U;;905;179;430;618;287;1;14;603;617
8;Barcelona;40;Vallès Occidental;08279;Terrassa;1;11;U;;909;114;228;526;383;0;16;510;526
8;Barcelona;40;Vallès Occidental;08279;Terrassa;1;12;A;;486;120;226;288;198;0;7;281;288
8;Barcelona;40;Vallès Occidental;08279;Terrassa;1;12;B;;587;161;245;278;309;0;6;272;278
8;Barcelona;40;Vallès Occidental;08279;Terrassa;1;13;U;;620;118;208;298;322;0;7;291;298
8;Barcelona;40;Vallès Occidental;08279;Terrassa;1;14;A;;432;113;187;240;192;3;5;232;237
8;Barcelona;40;Vallès Occidental;08279;Terrassa;1;14;B;;585;120;251;307;278;2;10;295;305
8;Barcelona;40;Vallès Occidental;08279;Terrassa;1;14;C;;604;142;237;291;313;1;3;287;290
8;Barcelona;40;Vallès Occidental;08279;Terrassa;1;15;U;;940;215;409;553;387;1;10;542;552
8;Barcelona;40;Vallès Occidental;08279;Terrassa;1;16;A;;833;169;374;514;319;1;9;504;513
8;Barcelona;40;Vallès Occidental;08279;Terrassa;1;16;B;;953;235;461;605;348;1;8;596;604
8;Barcelona;40;Vallès Occidental;08279;Terrassa;1;17;A;;756;244;425;526;230;0;19;507;526
8;Barcelona;40;Vallès Occidental;08279;Terrassa;1;17;B;;912;291;505;650;262;2;23;625;648
8;Barcelona;40;Vallès Occidental;08279;Terrassa;1;18;U;;393;107;182;245;148;3;7;235;242
8;Barcelona;40;Vallès Occidental;08279;Terrassa;1;19;U;;886;215;381;493;393;1;9;483;492
8;Barcelona;40;Vallès Occidental;08279;Terrassa;1;2;A;;480;141;264;342;138;0;9;333;342
8;Barcelona;40;Vallès Occidental;08279;Terrassa;1;2;B;;609;175;353;423;186;0;9;414;423
8;Barcelona;40;Vallès Occidental;08279;Terrassa;1;20;U;;837;241;445;585;252;3;24;558;582
8;Barcelona;40;Vallès Occidental;08279;Terrassa;1;21;U;;1049;230;454;617;432;0;15;602;617
8;Barcelona;40;Vallès Occidental;08279;Terrassa;1;22;A;;609;148;283;391;218;0;4;387;391
8;Barcelona;40;Vallès Occidental;08279;Terrassa;1;22;B;;670;154;303;408;262;0;6;402;408
8;Barcelona;40;Vallès Occidental;08279;Terrassa;1;23;U;;849;212;394;575;274;6;20;549;569
8;Barcelona;40;Vallès Occidental;08279;Terrassa;1;4;A;;580;152;295;419;161;0;10;409;419
8;Barcelona;40;Vallès Occidental;08279;Terrassa;1;4;B;;648;185;335;446;202;4;17;425;442
8;Barcelona;40;Vallès Occidental;08279;Terrassa;1;5;U;;863;255;484;639;224;1;13;625;638
8;Barcelona;40;Vallès Occidental;08279;Terrassa;1;6;A;;851;218;494;623;228;3;12;608;620
8;Barcelona;40;Vallès Occidental;08279;Terrassa;1;6;B;;994;254;518;687;307;1;12;674;686
8;Barcelona;40;Vallès Occidental;08279;Terrassa;1;7;A;;535;160;318;389;146;1;5;383;388
8;Barcelona;40;Vallès Occidental;08279;Terrassa;1;7;B;;659;161;339;443;216;1;6;436;442
8;Barcelona;40;Vallès Occidental;08279;Terrassa;1;8;U;;1295;316;685;901;394;4;22;875;897
8;Barcelona;40;Vallès Occidental;08279;Terrassa;1;9;U;;798;203;412;562;236;1;11;550;561
8;Barcelona;40;Vallès Occidental;08279;Terrassa;2;1;A;;478;127;196;241;237;0;7;234;241
8;Barcelona;40;Vallès Occidental;08279;Terrassa;2;1;B;;624;158;259;324;300;0;4;320;324
8;Barcelona;40;Vallès Occidental;08279;Terrassa;2;10;U;;469;82;138;211;258;0;5;206;211
8;Barcelona;40;Vallès Occidental;08279;Terrassa;2;11;U;;761;218;409;309;452;1;5;303;308
8;Barcelona;40;Vallès Occidental;08279;Terrassa;2;12;A;;319;70;108;139;180;0;2;137;139
8;Barcelona;40;Vallès Occidental;08279;Terrassa;2;12;B;;414;107;162;193;221;1;4;188;192
8;Barcelona;40;Vallès Occidental;08279;Terrassa;2;14;A;;703;92;218;304;399;0;7;297;304
8;Barcelona;40;Vallès Occidental;08279;Terrassa;2;14;B;;982;96;255;348;634;1;10;337;347
8;Barcelona;40;Vallès Occidental;08279;Terrassa;2;15;U;;645;78;112;161;484;2;2;157;159
8;Barcelona;40;Vallès Occidental;08279;Terrassa;2;16;U;;924;104;230;341;583;0;3;338;341
8;Barcelona;40;Vallès Occidental;08279;Terrassa;2;2;A;;265;59;81;101;164;0;4;97;101
8;Barcelona;40;Vallès Occidental;08279;Terrassa;2;2;B;;344;79;131;159;185;0;2;157;159
8;Barcelona;40;Vallès Occidental;08279;Terrassa;2;3;U;;566;122;206;251;315;1;2;248;250
8;Barcelona;40;Vallès Occidental;08279;Terrassa;2;4;A;;351;95;146;168;183;1;2;165;167
8;Barcelona;40;Vallès Occidental;08279;Terrassa;2;4;B;;463;100;179;214;249;1;9;204;213
8;Barcelona;40;Vallès Occidental;08279;Terrassa;2;5;A;;368;76;141;194;174;2;7;185;192
8;Barcelona;40;Vallès Occidental;08279;Terrassa;2;5;B;;476;90;158;232;244;2;7;223;230
8;Barcelona;40;Vallès Occidental;08279;Terrassa;2;6;U;;691;137;292;366;325;0;12;354;366
8;Barcelona;40;Vallès Occidental;08279;Terrassa;2;7;U;;356;71;123;154;202;0;2;152;154
8;Barcelona;40;Vallès Occidental;08279;Terrassa;2;8;U;;744;132;235;335;409;0;6;329;335
8;Barcelona;40;Vallès Occidental;08279;Terrassa;2;9;U;;634;116;220;310;324;0;8;302;310
8;Barcelona;40;Vallès Occidental;08279;Terrassa;3;1;A;;615;129;245;340;275;2;4;334;338
8;Barcelona;40;Vallès Occidental;08279;Terrassa;3;1;B;;687;155;266;367;320;1;4;362;366
8;Barcelona;40;Vallès Occidental;08279;Terrassa;3;10;A;;719;103;199;265;454;1;5;259;264
8;Barcelona;40;Vallès Occidental;08279;Terrassa;3;10;B;;922;127;235;314;608;0;4;310;314
8;Barcelona;40;Vallès Occidental;08279;Terrassa;3;11;A;;508;55;94;153;355;0;6;147;153
8;Barcelona;40;Vallès Occidental;08279;Terrassa;3;11;B;;701;53;119;173;528;0;2;171;173
8;Barcelona;40;Vallès Occidental;08279;Terrassa;3;12;A;;712;124;246;324;388;2;7;315;322
8;Barcelona;40;Vallès Occidental;08279;Terrassa;3;12;B;;911;140;294;415;496;4;2;409;411
8;Barcelona;40;Vallès Occidental;08279;Terrassa;3;13;U;;458;90;164;208;250;1;2;205;207
8;Barcelona;40;Vallès Occidental;08279;Terrassa;3;14;A;;543;111;196;253;290;2;4;247;251
8;Barcelona;40;Vallès Occidental;08279;Terrassa;3;14;B;;653;112;207;282;371;1;4;277;281
8;Barcelona;40;Vallès Occidental;08279;Terrassa;3;15;U;;833;193;365;460;373;0;12;448;460
8;Barcelona;40;Vallès Occidental;08279;Terrassa;3;16;U;;650;147;252;319;331;0;6;313;319
8;Barcelona;40;Vallès Occidental;08279;Terrassa;3;17;A;;415;83;154;195;220;0;2;193;195
8;Barcelona;40;Vallès Occidental;08279;Terrassa;3;17;B;;536;95;162;199;337;0;3;196;199
8;Barcelona;40;Vallès Occidental;08279;Terrassa;3;18;U;;828;118;195;281;547;0;11;270;281
8;Barcelona;40;Vallès Occidental;08279;Terrassa;3;19;A;;417;97;175;221;196;1;2;218;220
8;Barcelona;40;Vallès Occidental;08279;Terrassa;3;19;B;;581;116;207;268;313;1;3;264;267
8;Barcelona;40;Vallès Occidental;08279;Terrassa;3;2;U;;1030;230;420;584;446;0;11;573;584
8;Barcelona;40;Vallès Occidental;08279;Terrassa;3;20;U;;1118;223;435;565;553;1;13;551;564
8;Barcelona;40;Vallès Occidental;08279;Terrassa;3;3;A;;531;97;183;248;283;0;6;242;248
8;Barcelona;40;Vallès Occidental;08279;Terrassa;3;3;B;;635;101;222;299;336;0;3;296;299
8;Barcelona;40;Vallès Occidental;08279;Terrassa;3;4;U;;903;164;287;382;521;2;4;376;380
8;Barcelona;40;Vallès Occidental;08279;Terrassa;3;5;A;;565;142;255;333;232;0;3;330;333
8;Barcelona;40;Vallès Occidental;08279;Terrassa;3;5;B;;683;168;301;373;310;0;13;360;373
8;Barcelona;40;Vallès Occidental;08279;Terrassa;3;6;U;;1207;260;583;748;459;4;17;727;744
8;Barcelona;40;Vallès Occidental;08279;Terrassa;3;7;A;;592;138;259;368;224;1;8;359;367
8;Barcelona;40;Vallès Occidental;08279;Terrassa;3;7;B;;707;144;305;414;293;0;13;401;414
8;Barcelona;40;Vallès Occidental;08279;Terrassa;3;8;A;;534;99;191;241;293;2;2;237;239
8;Barcelona;40;Vallès Occidental;08279;Terrassa;3;8;B;;723;153;247;308;415;2;4;302;306
8;Barcelona;40;Vallès Occidental;08279;Terrassa;3;9;A;;685;137;278;374;311;2;7;365;372
8;Barcelona;40;Vallès Occidental;08279;Terrassa;3;9;B;;759;188;333;451;308;1;4;446;450
8;Barcelona;40;Vallès Occidental;08279;Terrassa;4;1;A;;484;118;257;340;144;1;12;327;339
8;Barcelona;40;Vallès Occidental;08279;Terrassa;4;1;B;;530;135;264;345;185;3;11;331;342
8;Barcelona;40;Vallès Occidental;08279;Terrassa;4;10;U;;544;123;235;236;308;0;3;233;236
8;Barcelona;40;Vallès Occidental;08279;Terrassa;4;11;U;;575;122;215;271;304;0;1;270;271
8;Barcelona;40;Vallès Occidental;08279;Terrassa;4;12;A;;456;110;179;257;199;5;8;244;252
8;Barcelona;40;Vallès Occidental;08279;Terrassa;4;12;B;;540;132;234;309;231;4;11;294;305
8;Barcelona;40;Vallès Occidental;08279;Terrassa;4;13;A;;580;168;295;363;217;0;8;355;363
8;Barcelona;40;Vallès Occidental;08279;Terrassa;4;13;B;;647;175;334;415;232;1;12;402;414
8;Barcelona;40;Vallès Occidental;08279;Terrassa;4;14;U;;955;280;499;670;285;4;12;654;666
8;Barcelona;40;Vallès Occidental;08279;Terrassa;4;15;U;;838;227;465;571;267;1;22;548;570
8;Barcelona;40;Vallès Occidental;08279;Terrassa;4;16;A;;442;134;239;312;130;1;9;302;311
8;Barcelona;40;Vallès Occidental;08279;Terrassa;4;16;B;;535;165;312;390;145;3;9;378;387
8;Barcelona;40;Vallès Occidental;08279;Terrassa;4;17;U;;945;266;491;655;290;1;20;634;654
8;Barcelona;40;Vallès Occidental;08279;Terrassa;4;18;A;;664;174;312;394;270;2;6;386;392
8;Barcelona;40;Vallès Occidental;08279;Terrassa;4;18;B;;820;200;379;491;329;0;11;480;491
8;Barcelona;40;Vallès Occidental;08279;Terrassa;4;19;A;;446;95;171;235;211;0;7;228;235
8;Barcelona;40;Vallès Occidental;08279;Terrassa;4;19;B;;499;130;211;266;233;1;6;259;265
8;Barcelona;40;Vallès Occidental;08279;Terrassa;4;2;A;;542;150;254;341;201;3;8;330;338
8;Barcelona;40;Vallès Occidental;08279;Terrassa;4;2;B;;601;154;285;383;218;2;2;379;381
8;Barcelona;40;Vallès Occidental;08279;Terrassa;4;20;U;;546;108;188;235;311;0;3;232;235
8;Barcelona;40;Vallès Occidental;08279;Terrassa;4;21;A;;364;64;124;150;214;0;6;144;150
8;Barcelona;40;Vallès Occidental;08279;Terrassa;4;21;B;;476;103;187;230;246;1;5;224;229
8;Barcelona;40;Vallès Occidental;08279;Terrassa;4;22;A;;711;79;200;297;414;0;6;291;297
8;Barcelona;40;Vallès Occidental;08279;Terrassa;4;22;B;;836;127;266;370;466;0;12;358;370
8;Barcelona;40;Vallès Occidental;08279;Terrassa;4;23;A;;629;100;186;275;354;0;3;272;275
8;Barcelona;40;Vallès Occidental;08279;Terrassa;4;23;B;;873;141;272;377;496;3;7;367;374
8;Barcelona;40;Vallès Occidental;08279;Terrassa;4;24;A;;527;61;110;153;374;1;6;146;152
8;Barcelona;40;Vallès Occidental;08279;Terrassa;4;24;B;;682;86;152;210;472;0;5;205;210
8;Barcelona;40;Vallès Occidental;08279;Terrassa;4;25;U;;964;209;386;506;458;0;12;494;506
8;Barcelona;40;Vallès Occidental;08279;Terrassa;4;26;A;;496;174;298;357;139;1;8;348;356
8;Barcelona;40;Vallès Occidental;08279;Terrassa;4;26;B;;525;165;283;371;154;1;7;363;370
8;Barcelona;40;Vallès Occidental;08279;Terrassa;4;3;A;;546;143;266;340;206;2;6;332;338
8;Barcelona;40;Vallès Occidental;08279;Terrassa;4;3;B;;685;202;335;411;274;1;9;401;410
8;Barcelona;40;Vallès Occidental;08279;Terrassa;4;4;A;;543;151;249;321;222;1;8;312;320
8;Barcelona;40;Vallès Occidental;08279;Terrassa;4;4;B;;537;140;246;310;227;1;4;305;309
8;Barcelona;40;Vallès Occidental;08279;Terrassa;4;5;A;;496;111;195;256;240;2;4;250;254
8;Barcelona;40;Vallès Occidental;08279;Terrassa;4;5;B;;574;122;238;308;266;1;7;300;307
8;Barcelona;40;Vallès Occidental;08279;Terrassa;4;6;A;;567;120;219;293;274;2;13;278;291
8;Barcelona;40;Vallès Occidental;08279;Terrassa;4;6;B;;788;177;320;429;359;2;7;420;427
8;Barcelona;40;Vallès Occidental;08279;Terrassa;4;7;A;;757;138;262;348;409;2;7;339;346
8;Barcelona;40;Vallès Occidental;08279;Terrassa;4;7;B;;921;180;309;395;526;0;9;386;395
8;Barcelona;40;Vallès Occidental;08279;Terrassa;4;8;U;;666;155;266;348;318;2;10;336;346
8;Barcelona;40;Vallès Occidental;08279;Terrassa;4;9;U;;757;123;206;298;459;0;8;290;298
8;Barcelona;40;Vallès Occidental;08279;Terrassa;5;1;A;;611;137;248;327;284;0;10;317;327
8;Barcelona;40;Vallès Occidental;08279;Terrassa;5;1;B;;788;150;287;395;393;1;13;381;394
8;Barcelona;40;Vallès Occidental;08279;Terrassa;5;10;A;;738;194;315;382;356;0;3;379;382
8;Barcelona;40;Vallès Occidental;08279;Terrassa;5;10;B;;837;207;344;427;410;4;6;417;423
8;Barcelona;40;Vallès Occidental;08279;Terrassa;5;11;A;;661;125;256;382;279;6;4;372;376
8;Barcelona;40;Vallès Occidental;08279;Terrassa;5;11;B;;776;164;314;437;339;1;5;431;436
8;Barcelona;40;Vallès Occidental;08279;Terrassa;5;12;U;;600;111;225;290;310;0;5;285;290
8;Barcelona;40;Vallès Occidental;08279;Terrassa;5;13;U;;1043;145;296;426;617;1;7;418;425
8;Barcelona;40;Vallès Occidental;08279;Terrassa;5;14;A;;402;89;158;189;213;1;4;184;188
8;Barcelona;40;Vallès Occidental;08279;Terrassa;5;14;B;;630;146;263;351;279;0;2;349;351
8;Barcelona;40;Vallès Occidental;08279;Terrassa;5;14;C;;565;128;223;285;280;2;8;275;283
8;Barcelona;40;Vallès Occidental;08279;Terrassa;5;15;A;;675;114;213;287;388;0;9;278;287
8;Barcelona;40;Vallès Occidental;08279;Terrassa;5;15;B;;831;152;269;343;488;2;10;331;341
8;Barcelona;40;Vallès Occidental;08279;Terrassa;5;16;A;;773;160;287;371;402;2;13;356;369
8;Barcelona;40;Vallès Occidental;08279;Terrassa;5;16;B;;973;201;375;463;510;1;10;452;462
8;Barcelona;40;Vallès Occidental;08279;Terrassa;5;17;A;;586;111;203;278;308;0;4;274;278
8;Barcelona;40;Vallès Occidental;08279;Terrassa;5;17;B;;718;126;241;349;369;1;1;347;348
8;Barcelona;40;Vallès Occidental;08279;Terrassa;5;18;A;;482;109;196;265;217;1;4;260;264
8;Barcelona;40;Vallès Occidental;08279;Terrassa;5;18;B;;604;112;237;302;302;3;5;294;299
8;Barcelona;40;Vallès Occidental;08279;Terrassa;5;19;A;;795;138;295;389;406;0;12;377;389
8;Barcelona;40;Vallès Occidental;08279;Terrassa;5;19;B;;949;171;348;457;492;2;12;443;455
8;Barcelona;40;Vallès Occidental;08279;Terrassa;5;2;A;;512;89;163;210;302;2;2;206;208
8;Barcelona;40;Vallès Occidental;08279;Terrassa;5;2;B;;707;131;234;296;411;0;2;294;296
8;Barcelona;40;Vallès Occidental;08279;Terrassa;5;20;A;;529;113;225;309;220;1;8;300;308
8;Barcelona;40;Vallès Occidental;08279;Terrassa;5;20;B;;603;130;250;337;266;8;3;326;329
8;Barcelona;40;Vallès Occidental;08279;Terrassa;5;21;A;;603;120;234;330;273;1;7;322;329
8;Barcelona;40;Vallès Occidental;08279;Terrassa;5;21;B;;808;166;327;448;360;9;0;439;439
8;Barcelona;40;Vallès Occidental;08279;Terrassa;5;22;U;;566;102;217;281;285;0;3;278;281
8;Barcelona;40;Vallès Occidental;08279;Terrassa;5;23;A;;588;159;300;389;199;0;9;380;389
8;Barcelona;40;Vallès Occidental;08279;Terrassa;5;23;B;;629;155;285;384;245;1;11;372;383
8;Barcelona;40;Vallès Occidental;08279;Terrassa;5;24;A;;520;112;205;261;259;0;5;256;261
8;Barcelona;40;Vallès Occidental;08279;Terrassa;5;24;B;;608;112;228;293;315;0;7;286;293
8;Barcelona;40;Vallès Occidental;08279;Terrassa;5;25;U;;887;182;333;452;435;2;12;438;450
8;Barcelona;40;Vallès Occidental;08279;Terrassa;5;26;A;;503;98;206;309;194;0;8;301;309
8;Barcelona;40;Vallès Occidental;08279;Terrassa;5;26;B;;559;133;250;359;200;1;8;350;358
8;Barcelona;40;Vallès Occidental;08279;Terrassa;5;3;A;;656;137;264;359;297;9;0;350;350
8;Barcelona;40;Vallès Occidental;08279;Terrassa;5;3;B;;798;160;345;460;338;0;7;453;460
8;Barcelona;40;Vallès Occidental;08279;Terrassa;5;4;A;;889;236;447;553;336;0;11;542;553
8;Barcelona;40;Vallès Occidental;08279;Terrassa;5;4;B;;1067;260;524;679;388;1;20;658;678
8;Barcelona;40;Vallès Occidental;08279;Terrassa;5;5;U;;728;201;351;442;286;1;5;436;441
8;Barcelona;40;Vallès Occidental;08279;Terrassa;5;6;A;;754;178;353;473;281;2;8;463;471
8;Barcelona;40;Vallès Occidental;08279;Terrassa;5;6;B;;835;208;386;512;323;1;14;497;511
8;Barcelona;40;Vallès Occidental;08279;Terrassa;5;7;U;;844;214;418;562;282;4;9;549;558
8;Barcelona;40;Vallès Occidental;08279;Terrassa;5;8;A;;677;160;305;415;262;0;8;407;415
8;Barcelona;40;Vallès Occidental;08279;Terrassa;5;8;B;;762;183;308;417;345;0;3;414;417
8;Barcelona;40;Vallès Occidental;08279;Terrassa;5;9;A;;637;145;285;373;264;0;2;371;373
8;Barcelona;40;Vallès Occidental;08279;Terrassa;5;9;B;;712;147;277;370;342;0;12;358;370
8;Barcelona;40;Vallès Occidental;08279;Terrassa;6;1;U;;910;196;359;473;437;2;10;461;471
8;Barcelona;40;Vallès Occidental;08279;Terrassa;6;10;A;;643;117;240;319;324;1;7;311;318
8;Barcelona;40;Vallès Occidental;08279;Terrassa;6;10;B;;870;180;340;469;401;1;8;460;468
8;Barcelona;40;Vallès Occidental;08279;Terrassa;6;11;A;;643;92;159;214;429;0;5;209;214
8;Barcelona;40;Vallès Occidental;08279;Terrassa;6;11;B;;764;108;183;278;486;0;2;276;278
8;Barcelona;40;Vallès Occidental;08279;Terrassa;6;12;A;;427;73;152;201;226;1;2;198;200
8;Barcelona;40;Vallès Occidental;08279;Terrassa;6;12;B;;606;122;220;285;321;0;5;280;285
8;Barcelona;40;Vallès Occidental;08279;Terrassa;6;13;U;;720;175;293;381;339;0;12;369;381
8;Barcelona;40;Vallès Occidental;08279;Terrassa;6;14;U;;748;119;210;283;465;1;4;278;282
8;Barcelona;40;Vallès Occidental;08279;Terrassa;6;16;A;;411;91;147;182;229;0;1;181;182
8;Barcelona;40;Vallès Occidental;08279;Terrassa;6;16;B;;577;113;184;225;352;0;5;220;225
8;Barcelona;40;Vallès Occidental;08279;Terrassa;6;18;U;;518;106;186;249;269;1;2;246;248
8;Barcelona;40;Vallès Occidental;08279;Terrassa;6;19;U;;505;108;192;235;270;0;9;226;235
8;Barcelona;40;Vallès Occidental;08279;Terrassa;6;2;A;;442;85;174;206;236;1;2;203;205
8;Barcelona;40;Vallès Occidental;08279;Terrassa;6;2;B;;661;125;225;299;362;0;7;292;299
8;Barcelona;40;Vallès Occidental;08279;Terrassa;6;20;U;;531;94;175;221;310;1;6;214;220
8;Barcelona;40;Vallès Occidental;08279;Terrassa;6;21;U;;815;163;280;326;489;0;3;323;326
8;Barcelona;40;Vallès Occidental;08279;Terrassa;6;23;U;;988;151;313;395;593;0;6;389;395
8;Barcelona;40;Vallès Occidental;08279;Terrassa;6;24;A;;786;113;250;330;456;1;6;323;329
8;Barcelona;40;Vallès Occidental;08279;Terrassa;6;24;B;;1054;134;296;403;651;0;13;390;403
8;Barcelona;40;Vallès Occidental;08279;Terrassa;6;25;A;;589;101;188;271;318;0;18;253;271
8;Barcelona;40;Vallès Occidental;08279;Terrassa;6;25;B;;826;150;267;374;452;0;26;348;374
8;Barcelona;40;Vallès Occidental;08279;Terrassa;6;26;A;;524;98;182;225;299;0;2;223;225
8;Barcelona;40;Vallès Occidental;08279;Terrassa;6;26;B;;665;125;234;293;372;0;4;289;293
8;Barcelona;40;Vallès Occidental;08279;Terrassa;6;27;A;;451;68;124;175;276;6;0;169;169
8;Barcelona;40;Vallès Occidental;08279;Terrassa;6;27;B;;554;89;151;196;358;0;4;192;196
8;Barcelona;40;Vallès Occidental;08279;Terrassa;6;28;A;;530;92;159;225;305;0;7;218;225
8;Barcelona;40;Vallès Occidental;08279;Terrassa;6;28;B;;709;124;209;273;436;1;3;269;272
8;Barcelona;40;Vallès Occidental;08279;Terrassa;6;29;U;;759;104;201;269;490;3;6;260;266
8;Barcelona;40;Vallès Occidental;08279;Terrassa;6;3;A;;641;122;224;298;343;0;3;295;298
8;Barcelona;40;Vallès Occidental;08279;Terrassa;6;3;B;;842;132;259;362;480;2;8;352;360
8;Barcelona;40;Vallès Occidental;08279;Terrassa;6;30;A;;732;109;196;336;396;2;6;328;334
8;Barcelona;40;Vallès Occidental;08279;Terrassa;6;30;B;;876;118;239;289;587;1;5;283;288
8;Barcelona;40;Vallès Occidental;08279;Terrassa;6;31;U;;777;125;213;286;491;1;9;276;285
8;Barcelona;40;Vallès Occidental;08279;Terrassa;6;4;A;;432;129;187;246;186;1;9;236;245
8;Barcelona;40;Vallès Occidental;08279;Terrassa;6;4;B;;512;131;203;247;265;0;9;238;247
8;Barcelona;40;Vallès Occidental;08279;Terrassa;6;5;U;;1031;160;323;424;607;3;13;408;421
8;Barcelona;40;Vallès Occidental;08279;Terrassa;6;6;A;;426;66;120;163;263;0;4;159;163
8;Barcelona;40;Vallès Occidental;08279;Terrassa;6;6;B;;608;78;151;222;386;0;11;211;222
8;Barcelona;40;Vallès Occidental;08279;Terrassa;6;8;A;;655;124;253;357;298;0;11;346;357
8;Barcelona;40;Vallès Occidental;08279;Terrassa;6;8;B;;904;185;345;465;439;3;8;454;462
8;Barcelona;40;Vallès Occidental;08279;Terrassa;6;9;A;;406;54;120;171;235;6;0;165;165
8;Barcelona;40;Vallès Occidental;08279;Terrassa;6;9;B;;498;94;156;222;276;0;5;217;222
8;Barcelona;21;Maresme;08282;Tiana;1;1;A;;621;177;299;408;213;0;12;396;408
8;Barcelona;21;Maresme;08282;Tiana;1;1;B;;696;214;366;473;223;0;11;462;473
8;Barcelona;21;Maresme;08282;Tiana;1;2;A;;344;86;201;246;98;0;9;237;246
8;Barcelona;21;Maresme;08282;Tiana;1;2;B;;291;87;157;202;89;0;2;200;202
8;Barcelona;21;Maresme;08282;Tiana;1;2;C;;438;139;245;307;131;3;10;294;304
8;Barcelona;21;Maresme;08282;Tiana;1;2;D;;396;120;218;289;107;1;4;284;288
8;Barcelona;21;Maresme;08282;Tiana;1;3;A;;447;127;234;290;157;1;7;282;289
8;Barcelona;21;Maresme;08282;Tiana;1;3;B;;525;126;268;341;184;0;2;339;341
8;Barcelona;21;Maresme;08282;Tiana;1;4;A;;586;138;302;386;200;1;13;372;385
8;Barcelona;21;Maresme;08282;Tiana;1;4;B;;669;176;356;456;213;2;11;443;454
8;Barcelona;21;Maresme;08282;Tiana;1;5;U;;589;182;345;409;180;1;7;401;408
25;Lleida;26;Pallars Sobirà;25221;Tírvia;1;1;U;;118;19;68;85;33;0;2;83;85
25;Lleida;23;Noguera;25222;Tiurana;1;1;U;;45;19;29;42;3;0;0;42;42
43;Tarragona;9;Baix Ebre;43149;Tivenys;1;1;U;;744;213;448;544;200;6;4;534;538
43;Tarragona;30;Ribera d'Ebre;43150;Tivissa;1;1;A;;556;149;298;400;156;1;3;396;399
43;Tarragona;30;Ribera d'Ebre;43150;Tivissa;1;1;B;;594;146;344;424;170;8;3;413;416
43;Tarragona;30;Ribera d'Ebre;43150;Tivissa;1;1;C;;233;91;161;179;54;1;4;174;178
8;Barcelona;24;Osona;08283;Tona;1;1;A;;678;181;342;435;243;0;9;426;435
8;Barcelona;24;Osona;08283;Tona;1;1;B;;843;176;377;499;344;1;8;490;498
8;Barcelona;24;Osona;08283;Tona;1;1;C;;535;126;259;327;208;0;7;320;327
8;Barcelona;24;Osona;08283;Tona;1;2;A;;639;174;365;444;195;7;10;427;437
8;Barcelona;24;Osona;08283;Tona;1;2;B;;623;150;353;397;226;6;10;381;391
8;Barcelona;24;Osona;08283;Tona;1;2;C;;499;107;276;332;167;0;6;326;332
8;Barcelona;24;Osona;08283;Tona;1;3;A;;632;174;330;398;234;2;6;390;396
8;Barcelona;24;Osona;08283;Tona;1;3;B;;677;150;325;401;276;2;8;391;399
8;Barcelona;24;Osona;08283;Tona;1;3;C;;428;124;256;289;139;1;5;283;288
25;Lleida;32;Segarra;25223;Torà;1;1;A;;409;132;231;283;126;14;7;262;269
25;Lleida;32;Segarra;25223;Torà;1;1;B;;553;172;293;362;191;17;15;330;345
8;Barcelona;21;Maresme;08284;Tordera;1;1;A;;617;167;315;364;253;1;1;362;363
8;Barcelona;21;Maresme;08284;Tordera;1;1;B;;812;236;403;487;325;1;4;482;486
8;Barcelona;21;Maresme;08284;Tordera;1;2;A;;490;114;207;263;227;1;1;261;262
8;Barcelona;21;Maresme;08284;Tordera;1;2;B;;593;113;242;306;287;0;6;300;306
8;Barcelona;21;Maresme;08284;Tordera;1;3;A;;510;108;238;292;218;2;5;285;290
8;Barcelona;21;Maresme;08284;Tordera;1;3;B;;627;176;309;365;262;4;6;355;361
8;Barcelona;21;Maresme;08284;Tordera;1;4;A;;574;149;257;310;264;5;7;298;305
8;Barcelona;21;Maresme;08284;Tordera;1;4;B;;761;193;339;419;342;5;9;405;414
8;Barcelona;21;Maresme;08284;Tordera;2;1;A;;851;188;345;420;431;3;5;412;417
8;Barcelona;21;Maresme;08284;Tordera;2;1;B;;947;234;412;495;452;0;8;487;495
8;Barcelona;21;Maresme;08284;Tordera;2;2;A;;514;96;177;222;292;3;2;217;219
8;Barcelona;21;Maresme;08284;Tordera;2;2;B;;689;111;217;268;421;1;4;263;267
8;Barcelona;21;Maresme;08284;Tordera;2;2;C;;684;115;224;268;416;5;2;261;263
8;Barcelona;21;Maresme;08284;Tordera;2;3;A;;514;100;162;202;312;0;4;198;202
8;Barcelona;21;Maresme;08284;Tordera;2;3;B;;613;123;194;238;375;1;1;236;237
8;Barcelona;21;Maresme;08284;Tordera;2;3;C;;564;107;180;233;331;0;3;230;233
8;Barcelona;24;Osona;08285;Torelló;1;1;A;;325;101;181;211;114;3;3;205;208
8;Barcelona;24;Osona;08285;Torelló;1;1;B;;365;106;191;222;143;0;4;218;222
8;Barcelona;24;Osona;08285;Torelló;1;2;A;;792;230;410;503;289;6;2;495;497
8;Barcelona;24;Osona;08285;Torelló;1;2;B;;766;245;414;511;255;4;13;494;507
8;Barcelona;24;Osona;08285;Torelló;1;4;A;;717;178;348;427;290;6;21;400;421
8;Barcelona;24;Osona;08285;Torelló;1;4;B;;768;212;369;461;307;0;20;441;461
8;Barcelona;24;Osona;08285;Torelló;2;1;A;;564;185;306;389;175;0;12;377;389
8;Barcelona;24;Osona;08285;Torelló;2;1;B;;568;178;303;369;199;1;6;362;368
8;Barcelona;24;Osona;08285;Torelló;2;2;A;;488;155;258;313;175;1;20;292;312
8;Barcelona;24;Osona;08285;Torelló;2;2;B;;534;167;297;354;180;4;13;337;350
8;Barcelona;24;Osona;08285;Torelló;3;1;A;;615;180;311;391;224;5;12;374;386
8;Barcelona;24;Osona;08285;Torelló;3;1;B;;761;193;356;471;290;4;14;453;467
8;Barcelona;24;Osona;08285;Torelló;3;2;A;;578;189;302;356;222;1;5;350;355
8;Barcelona;24;Osona;08285;Torelló;3;2;B;;692;229;353;409;283;1;11;397;408
8;Barcelona;24;Osona;08285;Torelló;3;3;A;;507;127;251;316;191;1;7;308;315
8;Barcelona;24;Osona;08285;Torelló;3;3;B;;569;170;300;369;200;3;9;357;366
8;Barcelona;24;Osona;08285;Torelló;3;3;C;;435;124;229;288;147;0;8;280;288
25;Lleida;18;Garrigues;25224;Torms, els;1;1;U;;161;59;94;119;42;1;1;117;118
25;Lleida;38;Urgell;25225;Tornabous;1;1;U;;626;156;325;421;205;3;19;399;418
25;Lleida;33;Segrià;25226;Torrebesses;1;1;U;;265;89;131;158;107;1;5;152;157
25;Lleida;25;Pallars Jussà;25227;Torre de Cabdella, la;1;1;U;;697;154;278;423;274;0;7;416;423
8;Barcelona;6;Anoia;08286;Torre de Claramunt, la;1;1;A;;769;193;349;442;327;2;13;427;440
8;Barcelona;6;Anoia;08286;Torre de Claramunt, la;1;1;B;;848;195;364;468;380;0;8;460;468
8;Barcelona;6;Anoia;08286;Torre de Claramunt, la;1;2;U;;1000;174;345;452;548;3;3;446;449
43;Tarragona;29;Priorat;43151;Torre de Fontaubella, la;1;1;U;;121;41;78;84;37;0;1;83;84
43;Tarragona;30;Ribera d'Ebre;43152;Torre de l'Espanyol, la;1;1;U;;503;183;334;392;111;3;2;387;389
43;Tarragona;36;Tarragonès;43153;Torredembarra;1;1;A;;584;162;254;321;263;4;5;312;317
43;Tarragona;36;Tarragonès;43153;Torredembarra;1;1;B;;762;208;358;424;338;2;7;415;422
43;Tarragona;36;Tarragonès;43153;Torredembarra;1;2;A;;565;120;206;286;279;1;5;280;285
43;Tarragona;36;Tarragonès;43153;Torredembarra;1;2;B;;642;157;256;330;312;2;4;324;328
43;Tarragona;36;Tarragonès;43153;Torredembarra;1;2;C;;737;177;304;404;333;3;2;399;401
43;Tarragona;36;Tarragonès;43153;Torredembarra;1;3;A;;570;141;231;287;283;2;4;281;285
43;Tarragona;36;Tarragonès;43153;Torredembarra;1;3;B;;618;137;235;294;324;1;5;288;293
43;Tarragona;36;Tarragonès;43153;Torredembarra;1;3;C;;739;156;285;368;371;3;6;359;365
43;Tarragona;36;Tarragonès;43153;Torredembarra;1;4;A;;695;186;302;371;324;2;3;366;369
43;Tarragona;36;Tarragonès;43153;Torredembarra;1;4;B;;853;220;386;493;360;3;16;474;490
43;Tarragona;36;Tarragonès;43153;Torredembarra;1;5;A;;521;122;227;270;251;1;6;263;269
43;Tarragona;36;Tarragonès;43153;Torredembarra;1;5;B;;627;179;274;340;287;3;8;329;337
43;Tarragona;36;Tarragonès;43153;Torredembarra;1;6;A;;544;147;231;283;261;1;9;273;282
43;Tarragona;36;Tarragonès;43153;Torredembarra;1;6;B;;640;115;205;254;386;1;7;246;253
43;Tarragona;36;Tarragonès;43153;Torredembarra;1;6;C;;670;164;260;312;358;1;5;306;311
25;Lleida;33;Segrià;25228;Torrefarrera;1;1;U;;1102;294;544;725;377;3;20;702;722
25;Lleida;33;Segrià;25228;Torrefarrera;1;2;A;;614;145;307;401;213;1;10;390;400
25;Lleida;33;Segrià;25228;Torrefarrera;1;2;B;;668;162;326;436;232;3;12;421;433
25;Lleida;32;Segarra;25907;Torrefeta i Florejacs;1;1;U;;535;153;282;339;196;1;6;332;338
25;Lleida;27;Pla d'Urgell;25230;Torregrossa;1;1;U;;525;181;341;400;125;3;9;388;397
25;Lleida;27;Pla d'Urgell;25230;Torregrossa;1;2;A;;587;126;317;391;196;7;6;378;384
25;Lleida;27;Pla d'Urgell;25230;Torregrossa;1;2;B;;634;180;371;448;186;2;9;437;446
25;Lleida;23;Noguera;25231;Torrelameu;1;1;U;;493;116;273;355;138;4;9;342;351
8;Barcelona;3;Alt Penedès;08287;Torrelavit;1;1;U;;990;293;554;708;282;4;8;696;704
8;Barcelona;3;Alt Penedès;08288;Torrelles de Foix;1;1;A;;757;180;342;417;340;3;4;410;414
8;Barcelona;3;Alt Penedès;08288;Torrelles de Foix;1;1;B;;934;247;430;507;427;5;2;500;502
8;Barcelona;11;Baix Llobregat;08289;Torrelles de Llobregat;1;1;A;;704;214;398;495;209;4;13;478;491
8;Barcelona;11;Baix Llobregat;08289;Torrelles de Llobregat;1;1;B;;971;260;505;655;316;5;19;631;650
8;Barcelona;11;Baix Llobregat;08289;Torrelles de Llobregat;1;2;A;;1009;210;383;517;492;1;16;500;516
8;Barcelona;11;Baix Llobregat;08289;Torrelles de Llobregat;1;2;B;;1003;221;403;535;468;2;9;524;533
17;Girona;10;Baix Empordà;17197;Torrent;1;1;U;;141;33;65;85;56;0;1;84;85
25;Lleida;33;Segrià;25232;Torres de Segre;1;1;A;;697;133;351;450;247;5;8;437;445
25;Lleida;33;Segrià;25232;Torres de Segre;1;1;B;;795;157;381;473;322;2;11;460;471
25;Lleida;33;Segrià;25233;Torre-serona;1;1;U;;277;63;155;194;83;1;1;192;193
17;Girona;2;Alt Empordà;17198;Torroella de Fluvià;1;1;U;;312;107;166;196;116;0;6;190;196
17;Girona;10;Baix Empordà;17199;Torroella de Montgrí;1;1;A;;658;196;339;417;241;2;10;405;415
17;Girona;10;Baix Empordà;17199;Torroella de Montgrí;1;1;B;;579;150;290;353;226;0;6;347;353
17;Girona;10;Baix Empordà;17199;Torroella de Montgrí;1;1;C;;592;176;313;379;213;2;13;364;377
17;Girona;10;Baix Empordà;17199;Torroella de Montgrí;1;2;A;;593;173;298;365;228;0;8;357;365
17;Girona;10;Baix Empordà;17199;Torroella de Montgrí;1;2;B;;552;143;246;316;236;1;1;314;315
17;Girona;10;Baix Empordà;17199;Torroella de Montgrí;1;3;A;;745;183;325;388;357;1;7;380;387
17;Girona;10;Baix Empordà;17199;Torroella de Montgrí;1;3;B;;703;152;268;360;343;1;5;354;359
17;Girona;10;Baix Empordà;17199;Torroella de Montgrí;1;4;A;;671;175;344;428;243;1;8;419;427
17;Girona;10;Baix Empordà;17199;Torroella de Montgrí;1;4;B;;727;206;370;440;287;1;13;426;439
17;Girona;10;Baix Empordà;17199;Torroella de Montgrí;1;5;U;;704;190;331;415;289;3;5;407;412
43;Tarragona;29;Priorat;43154;Torroja del Priorat;1;1;U;;140;26;80;105;35;2;0;103;103
17;Girona;19;Garrotxa;17200;Tortellà;1;1;U;;601;279;363;417;184;5;8;404;412
43;Tarragona;9;Baix Ebre;43155;Tortosa;1;1;U;;525;161;228;278;247;0;7;271;278
43;Tarragona;9;Baix Ebre;43155;Tortosa;1;2;U;;328;98;140;178;150;2;3;173;176
43;Tarragona;9;Baix Ebre;43155;Tortosa;1;3;A;;556;159;271;343;213;6;6;331;337
43;Tarragona;9;Baix Ebre;43155;Tortosa;1;3;B;;480;140;212;285;195;2;6;277;283
43;Tarragona;9;Baix Ebre;43155;Tortosa;1;4;A;;720;201;328;454;266;1;15;438;453
43;Tarragona;9;Baix Ebre;43155;Tortosa;1;4;B;;685;206;319;402;283;7;9;386;395
43;Tarragona;9;Baix Ebre;43155;Tortosa;1;5;U;;323;54;84;110;213;2;2;106;108
43;Tarragona;9;Baix Ebre;43155;Tortosa;1;6;A;;451;105;171;240;211;7;4;229;233
43;Tarragona;9;Baix Ebre;43155;Tortosa;1;6;B;;410;114;174;232;178;2;3;227;230
43;Tarragona;9;Baix Ebre;43155;Tortosa;1;7;A;;776;210;334;480;296;5;10;465;475
43;Tarragona;9;Baix Ebre;43155;Tortosa;1;7;B;;515;133;231;307;208;0;5;302;307
43;Tarragona;9;Baix Ebre;43155;Tortosa;1;7;C;;710;181;297;412;298;6;5;401;406
43;Tarragona;9;Baix Ebre;43155;Tortosa;2;1;U;;471;91;136;172;299;6;11;155;166
43;Tarragona;9;Baix Ebre;43155;Tortosa;2;2;A;;732;146;297;423;309;5;12;406;418
43;Tarragona;9;Baix Ebre;43155;Tortosa;2;2;B;;684;157;290;403;281;1;9;393;402
43;Tarragona;9;Baix Ebre;43155;Tortosa;2;3;A;;599;180;283;359;240;1;10;348;358
43;Tarragona;9;Baix Ebre;43155;Tortosa;2;3;B;;438;115;179;223;215;3;7;213;220
43;Tarragona;9;Baix Ebre;43155;Tortosa;2;3;C;;540;139;252;300;240;0;8;292;300
43;Tarragona;9;Baix Ebre;43155;Tortosa;2;4;U;;755;152;280;389;366;4;9;376;385
43;Tarragona;9;Baix Ebre;43155;Tortosa;2;5;A;;489;104;202;289;200;1;1;287;288
43;Tarragona;9;Baix Ebre;43155;Tortosa;2;5;B;;468;123;220;285;183;1;5;279;284
43;Tarragona;9;Baix Ebre;43155;Tortosa;3;1;A;;340;70;110;134;206;0;1;133;134
43;Tarragona;9;Baix Ebre;43155;Tortosa;3;1;B;;293;73;110;129;164;0;4;125;129
43;Tarragona;9;Baix Ebre;43155;Tortosa;3;2;A;;563;154;260;341;222;6;5;330;335
43;Tarragona;9;Baix Ebre;43155;Tortosa;3;2;B;;396;93;170;230;166;3;8;219;227
43;Tarragona;9;Baix Ebre;43155;Tortosa;3;3;A;;522;103;174;232;290;1;4;227;231
43;Tarragona;9;Baix Ebre;43155;Tortosa;3;3;B;;413;99;168;208;205;0;3;205;208
43;Tarragona;9;Baix Ebre;43155;Tortosa;3;4;A;;705;179;297;385;320;7;4;374;378
43;Tarragona;9;Baix Ebre;43155;Tortosa;3;4;B;;612;122;234;318;294;5;4;309;313
43;Tarragona;9;Baix Ebre;43155;Tortosa;4;1;A;;770;161;283;401;369;2;8;391;399
43;Tarragona;9;Baix Ebre;43155;Tortosa;4;1;B;;527;121;214;292;235;3;6;283;289
43;Tarragona;9;Baix Ebre;43155;Tortosa;4;1;C;;603;123;222;307;296;5;2;300;302
43;Tarragona;9;Baix Ebre;43155;Tortosa;4;2;A;;438;97;167;222;216;0;2;220;222
43;Tarragona;9;Baix Ebre;43155;Tortosa;4;2;B;;326;72;138;178;148;0;8;170;178
43;Tarragona;9;Baix Ebre;43155;Tortosa;4;2;C;;342;101;142;174;168;5;5;164;169
43;Tarragona;9;Baix Ebre;43155;Tortosa;4;3;A;;599;117;220;286;313;4;5;277;282
43;Tarragona;9;Baix Ebre;43155;Tortosa;4;3;B;;555;128;190;247;308;3;7;237;244
43;Tarragona;9;Baix Ebre;43155;Tortosa;4;4;A;;494;119;199;255;239;2;4;249;253
43;Tarragona;9;Baix Ebre;43155;Tortosa;4;4;B;;421;116;187;243;178;2;5;236;241
43;Tarragona;9;Baix Ebre;43155;Tortosa;4;5;A;;657;168;301;377;280;3;9;365;374
43;Tarragona;9;Baix Ebre;43155;Tortosa;4;5;B;;548;142;250;322;226;4;1;317;318
43;Tarragona;9;Baix Ebre;43155;Tortosa;4;6;U;;704;174;287;375;329;4;10;361;371
43;Tarragona;9;Baix Ebre;43155;Tortosa;4;7;A;;544;147;310;381;163;2;8;371;379
43;Tarragona;9;Baix Ebre;43155;Tortosa;4;7;B;;273;53;114;149;124;1;0;148;148
43;Tarragona;9;Baix Ebre;43155;Tortosa;4;8;U;;627;131;256;367;260;5;4;358;362
17;Girona;31;Ripollès;17201;Toses;1;1;U;;125;31;54;88;37;0;0;88;88
17;Girona;34;Selva;17202;Tossa de Mar;1;1;U;;918;216;417;507;411;4;10;493;503
17;Girona;34;Selva;17202;Tossa de Mar;1;2;A;;541;141;251;304;237;0;5;299;304
17;Girona;34;Selva;17202;Tossa de Mar;1;2;B;;553;146;256;321;232;2;10;309;319
17;Girona;34;Selva;17202;Tossa de Mar;1;3;A;;874;242;430;502;372;2;14;486;500
17;Girona;34;Selva;17202;Tossa de Mar;1;3;B;;829;214;400;479;350;2;9;468;477
25;Lleida;25;Pallars Jussà;25234;Tremp;1;1;U;;711;153;344;451;260;2;7;442;449
25;Lleida;25;Pallars Jussà;25234;Tremp;1;2;U;;866;200;413;542;324;1;10;531;541
25;Lleida;25;Pallars Jussà;25234;Tremp;2;1;A;;478;135;244;314;164;0;8;306;314
25;Lleida;25;Pallars Jussà;25234;Tremp;2;1;B;;520;115;273;324;196;1;4;319;323
25;Lleida;25;Pallars Jussà;25234;Tremp;2;2;A;;551;126;253;347;204;1;5;341;346
25;Lleida;25;Pallars Jussà;25234;Tremp;2;2;B;;538;111;236;322;216;1;5;316;321
25;Lleida;25;Pallars Jussà;25234;Tremp;3;1;U;;530;76;180;259;271;0;3;256;259
17;Girona;10;Baix Empordà;17204;Ullà;1;1;A;;336;115;193;218;118;0;10;208;218
17;Girona;10;Baix Empordà;17204;Ullà;1;1;B;;221;69;102;114;107;0;3;111;114
8;Barcelona;40;Vallès Occidental;08290;Ullastrell;1;1;A;;565;156;302;364;201;2;7;355;362
8;Barcelona;40;Vallès Occidental;08290;Ullastrell;1;1;B;;665;187;368;467;198;4;7;456;463
17;Girona;10;Baix Empordà;17205;Ullastret;1;1;U;;173;69;99;114;59;0;3;111;114
43;Tarragona;22;Montsià;43156;Ulldecona;1;1;A;;429;93;187;259;170;1;4;254;258
43;Tarragona;22;Montsià;43156;Ulldecona;1;1;B;;449;113;204;277;172;6;9;262;271
43;Tarragona;22;Montsià;43156;Ulldecona;1;2;A;;652;161;293;380;272;5;7;368;375
43;Tarragona;22;Montsià;43156;Ulldecona;1;2;B;;489;100;200;290;199;2;5;283;288
43;Tarragona;22;Montsià;43156;Ulldecona;1;2;C;;648;152;301;410;238;3;6;401;407
43;Tarragona;22;Montsià;43156;Ulldecona;2;1;U;;453;119;211;292;161;0;8;284;292
43;Tarragona;22;Montsià;43156;Ulldecona;2;2;U;;544;161;263;354;190;3;6;345;351
43;Tarragona;22;Montsià;43156;Ulldecona;3;1;U;;514;113;226;288;226;0;13;275;288
43;Tarragona;29;Priorat;43157;Ulldemolins;1;1;U;;435;134;257;324;111;4;10;310;320
17;Girona;10;Baix Empordà;17203;Ultramort;1;1;U;;178;44;87;107;71;0;3;104;107
17;Girona;15;Cerdanya;17206;Urús;1;1;U;;159;38;79;102;57;0;0;102;102
8;Barcelona;40;Vallès Occidental;08291;Vacarisses;1;1;A;;989;239;414;529;460;0;12;517;529
8;Barcelona;40;Vallès Occidental;08291;Vacarisses;1;1;B;;757;161;273;367;390;0;6;361;367
8;Barcelona;40;Vallès Occidental;08291;Vacarisses;1;1;C;;801;161;269;353;448;3;6;344;350
8;Barcelona;40;Vallès Occidental;08291;Vacarisses;1;1;D;;785;180;280;357;428;0;7;350;357
8;Barcelona;40;Vallès Occidental;08291;Vacarisses;1;1;E;;587;133;228;296;291;0;2;294;296
17;Girona;2;Alt Empordà;17014;Vajol, la;1;1;U;;74;23;36;48;26;0;2;46;48
8;Barcelona;6;Anoia;08292;Vallbona d'Anoia;1;1;U;;1020;292;558;657;363;4;7;646;653
25;Lleida;38;Urgell;25238;Vallbona de les Monges;1;1;U;;233;72;134;159;74;0;3;156;159
8;Barcelona;14;Berguedà;08293;Vallcebre;1;1;U;;241;90;134;162;79;0;3;159;162
43;Tarragona;16;Conca de Barberà;43158;Vallclara;1;1;U;;99;30;49;67;32;0;0;67;67
17;Girona;19;Garrotxa;17207;Vall d'en Bas, la;1;1;A;;892;328;549;643;249;1;16;626;642
17;Girona;19;Garrotxa;17207;Vall d'en Bas, la;1;1;B;;220;85;145;169;51;0;5;164;169
17;Girona;19;Garrotxa;17207;Vall d'en Bas, la;1;2;A;;913;279;510;602;311;1;14;587;601
17;Girona;19;Garrotxa;17207;Vall d'en Bas, la;1;2;B;;227;87;128;150;77;1;3;146;149
17;Girona;19;Garrotxa;17208;Vall de Bianya, la;1;1;A;;474;133;260;329;145;2;6;321;327
17;Girona;19;Garrotxa;17208;Vall de Bianya, la;1;1;B;;527;189;286;330;197;2;12;316;328
25;Lleida;5;Alta Ribagorça;25043;Vall de Boí, la;1;1;U;;844;165;313;445;399;0;15;430;445
25;Lleida;26;Pallars Sobirà;25901;Vall de Cardós;1;1;U;;296;51;133;182;114;1;8;173;181
25;Lleida;23;Noguera;25240;Vallfogona de Balaguer;1;1;A;;750;160;422;522;228;2;14;506;520
25;Lleida;23;Noguera;25240;Vallfogona de Balaguer;1;1;B;;557;117;266;339;218;1;7;331;338
17;Girona;31;Ripollès;17170;Vallfogona de Ripollès;1;1;U;;176;64;101;125;51;1;1;123;124
43;Tarragona;16;Conca de Barberà;43159;Vallfogona de Riucorb;1;1;U;;141;25;47;57;84;0;3;54;57
8;Barcelona;41;Vallès Oriental;08294;Vallgorguina;1;1;A;;939;254;484;599;340;0;16;583;599
8;Barcelona;41;Vallès Oriental;08294;Vallgorguina;1;1;B;;655;155;266;339;316;0;10;329;339
8;Barcelona;11;Baix Llobregat;08295;Vallirana;1;1;A;;486;125;220;265;221;3;11;251;262
8;Barcelona;11;Baix Llobregat;08295;Vallirana;1;1;B;;465;114;185;231;234;3;4;224;228
8;Barcelona;11;Baix Llobregat;08295;Vallirana;1;1;C;;537;123;241;292;245;1;3;288;291
8;Barcelona;11;Baix Llobregat;08295;Vallirana;1;2;A;;507;141;227;284;223;0;12;272;284
8;Barcelona;11;Baix Llobregat;08295;Vallirana;1;2;B;;527;113;194;257;270;2;4;251;255
8;Barcelona;11;Baix Llobregat;08295;Vallirana;1;2;C;;603;140;262;340;263;0;5;335;340
8;Barcelona;11;Baix Llobregat;08295;Vallirana;1;3;A;;675;158;296;383;292;0;8;375;383
8;Barcelona;11;Baix Llobregat;08295;Vallirana;1;3;B;;571;142;270;348;223;0;9;339;348
8;Barcelona;11;Baix Llobregat;08295;Vallirana;1;4;A;;413;92;188;232;181;2;4;226;230
8;Barcelona;11;Baix Llobregat;08295;Vallirana;1;4;B;;328;74;138;181;147;2;2;177;179
8;Barcelona;11;Baix Llobregat;08295;Vallirana;1;5;A;;570;136;225;274;296;3;1;270;271
8;Barcelona;11;Baix Llobregat;08295;Vallirana;1;5;B;;704;139;239;297;407;2;4;291;295
8;Barcelona;11;Baix Llobregat;08295;Vallirana;1;5;C;;587;106;191;252;335;1;3;248;251
8;Barcelona;11;Baix Llobregat;08295;Vallirana;1;6;A;;386;85;147;195;191;0;4;191;195
8;Barcelona;11;Baix Llobregat;08295;Vallirana;1;6;B;;518;106;190;267;251;0;9;258;267
8;Barcelona;11;Baix Llobregat;08295;Vallirana;1;6;C;;422;84;143;211;211;1;4;206;210
8;Barcelona;11;Baix Llobregat;08295;Vallirana;1;7;A;;436;80;150;204;232;0;6;198;204
8;Barcelona;11;Baix Llobregat;08295;Vallirana;1;7;B;;545;90;168;242;303;0;2;240;242
8;Barcelona;11;Baix Llobregat;08295;Vallirana;1;7;C;;482;89;174;220;262;0;6;214;220
17;Girona;10;Baix Empordà;17209;Vall-llobrega;1;1;U;;516;143;270;323;193;1;9;313;322
43;Tarragona;1;Alt Camp;43160;Vallmoll;1;1;A;;531;121;237;307;224;2;2;303;305
43;Tarragona;1;Alt Camp;43160;Vallmoll;1;1;B;;666;153;295;368;298;4;2;362;364
8;Barcelona;41;Vallès Oriental;08296;Vallromanes;1;1;A;;723;172;354;470;253;0;14;456;470
8;Barcelona;41;Vallès Oriental;08296;Vallromanes;1;1;B;;808;206;376;508;300;2;8;498;506
43;Tarragona;1;Alt Camp;43161;Valls;1;1;U;;576;160;279;342;234;13;3;326;329
43;Tarragona;1;Alt Camp;43161;Valls;2;1;U;;658;148;243;298;360;11;2;285;287
43;Tarragona;1;Alt Camp;43161;Valls;3;1;A;;643;192;324;420;223;11;10;399;409
43;Tarragona;1;Alt Camp;43161;Valls;3;1;B;;696;148;267;329;367;13;4;312;316
43;Tarragona;1;Alt Camp;43161;Valls;4;1;A;;403;128;226;267;136;8;4;255;259
43;Tarragona;1;Alt Camp;43161;Valls;4;1;B;;535;145;275;341;194;14;1;326;327
43;Tarragona;1;Alt Camp;43161;Valls;4;2;A;;414;72;135;186;228;14;7;165;172
43;Tarragona;1;Alt Camp;43161;Valls;4;2;B;;588;107;201;258;330;28;5;225;230
43;Tarragona;1;Alt Camp;43161;Valls;4;2;C;;361;109;197;247;114;1;5;241;246
43;Tarragona;1;Alt Camp;43161;Valls;4;3;A;;501;161;194;249;252;20;2;227;229
43;Tarragona;1;Alt Camp;43161;Valls;4;3;B;;577;88;183;256;321;18;4;234;238
43;Tarragona;1;Alt Camp;43161;Valls;5;1;A;;475;160;242;309;166;10;3;296;299
43;Tarragona;1;Alt Camp;43161;Valls;5;1;B;;448;129;208;257;191;10;3;244;247
43;Tarragona;1;Alt Camp;43161;Valls;5;1;C;;576;179;290;362;214;18;3;341;344
43;Tarragona;1;Alt Camp;43161;Valls;5;2;A;;533;160;276;348;185;20;7;321;328
43;Tarragona;1;Alt Camp;43161;Valls;5;2;B;;573;147;266;340;233;31;3;306;309
43;Tarragona;1;Alt Camp;43161;Valls;5;2;C;;675;177;317;418;257;22;4;392;396
43;Tarragona;1;Alt Camp;43161;Valls;5;3;A;;399;77;141;181;218;0;0;181;181
43;Tarragona;1;Alt Camp;43161;Valls;5;3;B;;507;109;187;243;264;4;4;235;239
43;Tarragona;1;Alt Camp;43161;Valls;6;1;A;;558;120;212;292;266;13;4;275;279
43;Tarragona;1;Alt Camp;43161;Valls;6;1;B;;530;119;202;270;260;9;4;257;261
43;Tarragona;1;Alt Camp;43161;Valls;6;1;C;;635;151;264;364;271;14;6;344;350
43;Tarragona;1;Alt Camp;43161;Valls;6;2;A;;723;171;351;455;268;11;5;439;444
43;Tarragona;1;Alt Camp;43161;Valls;6;2;B;;850;202;376;501;349;14;9;478;487
43;Tarragona;1;Alt Camp;43161;Valls;6;3;A;;436;137;233;306;130;9;0;297;297
43;Tarragona;1;Alt Camp;43161;Valls;6;3;B;;489;141;249;315;174;16;2;297;299
43;Tarragona;1;Alt Camp;43161;Valls;6;4;U;;837;230;389;477;360;20;4;453;457
43;Tarragona;1;Alt Camp;43161;Valls;6;5;A;;619;135;245;329;290;3;5;321;326
43;Tarragona;1;Alt Camp;43161;Valls;6;5;B;;702;159;303;397;305;6;6;385;391
43;Tarragona;1;Alt Camp;43161;Valls;6;6;U;;888;194;359;452;436;9;16;427;443
25;Lleida;4;Alt Urgell;25906;Valls d'Aguilar, les;1;1;U;;247;67;115;170;77;5;1;164;165
25;Lleida;4;Alt Urgell;25239;Valls de Valira, les;1;1;U;;541;113;199;276;265;1;6;269;275
43;Tarragona;8;Baix Camp;43162;Vandellòs i l'Hospitalet de l'Infant;1;1;A;;496;137;297;359;137;1;1;357;358
43;Tarragona;8;Baix Camp;43162;Vandellòs i l'Hospitalet de l'Infant;1;1;B;;401;108;226;276;125;0;3;273;276
43;Tarragona;8;Baix Camp;43162;Vandellòs i l'Hospitalet de l'Infant;1;2;A;;732;137;210;388;344;4;7;377;384
43;Tarragona;8;Baix Camp;43162;Vandellòs i l'Hospitalet de l'Infant;1;2;B;;651;134;234;338;313;3;6;329;335
43;Tarragona;8;Baix Camp;43162;Vandellòs i l'Hospitalet de l'Infant;1;3;A;;537;119;268;289;248;2;7;280;287
43;Tarragona;8;Baix Camp;43162;Vandellòs i l'Hospitalet de l'Infant;1;3;B;;530;111;224;305;225;0;2;303;305
43;Tarragona;8;Baix Camp;43162;Vandellòs i l'Hospitalet de l'Infant;1;4;U;;525;118;228;287;238;0;5;282;287
25;Lleida;4;Alt Urgell;25909;Vansa i Fórnols, la;1;1;U;;146;36;65;93;53;0;1;92;93
8;Barcelona;6;Anoia;08297;Veciana;1;1;U;;139;31;71;90;49;0;1;89;90
43;Tarragona;12;Baix Penedès;43163;Vendrell, el;1;1;A;;581;161;251;321;260;1;3;317;320
43;Tarragona;12;Baix Penedès;43163;Vendrell, el;1;1;B;;615;159;268;345;270;0;7;338;345
43;Tarragona;12;Baix Penedès;43163;Vendrell, el;1;1;C;;626;148;257;339;287;0;4;335;339
43;Tarragona;12;Baix Penedès;43163;Vendrell, el;1;2;U;;758;207;350;447;311;4;11;432;443
43;Tarragona;12;Baix Penedès;43163;Vendrell, el;2;1;U;;804;213;332;404;400;1;3;400;403
43;Tarragona;12;Baix Penedès;43163;Vendrell, el;2;2;A;;607;134;222;261;346;4;2;255;257
43;Tarragona;12;Baix Penedès;43163;Vendrell, el;2;2;B;;741;197;310;385;356;1;6;378;384
43;Tarragona;12;Baix Penedès;43163;Vendrell, el;2;3;A;;534;109;173;219;315;1;1;217;218
43;Tarragona;12;Baix Penedès;43163;Vendrell, el;2;3;B;;568;109;185;233;335;1;3;229;232
43;Tarragona;12;Baix Penedès;43163;Vendrell, el;2;3;C;;593;130;222;294;299;4;2;288;290
43;Tarragona;12;Baix Penedès;43163;Vendrell, el;2;4;A;;629;134;217;278;351;0;2;276;278
43;Tarragona;12;Baix Penedès;43163;Vendrell, el;2;4;B;;763;138;243;321;442;0;9;312;321
43;Tarragona;12;Baix Penedès;43163;Vendrell, el;2;5;A;;530;112;176;234;296;0;1;233;234
43;Tarragona;12;Baix Penedès;43163;Vendrell, el;2;5;B;;574;109;181;229;345;2;3;224;227
43;Tarragona;12;Baix Penedès;43163;Vendrell, el;2;5;C;;605;130;207;254;351;6;4;244;248
43;Tarragona;12;Baix Penedès;43163;Vendrell, el;3;1;A;;507;113;213;270;237;0;7;263;270
43;Tarragona;12;Baix Penedès;43163;Vendrell, el;3;1;B;;614;145;272;342;272;1;8;333;341
43;Tarragona;12;Baix Penedès;43163;Vendrell, el;3;2;A;;534;118;194;247;287;0;2;245;247
43;Tarragona;12;Baix Penedès;43163;Vendrell, el;3;2;B;;627;135;252;307;320;0;11;296;307
43;Tarragona;12;Baix Penedès;43163;Vendrell, el;3;3;A;;592;144;228;277;315;1;5;271;276
43;Tarragona;12;Baix Penedès;43163;Vendrell, el;3;3;B;;596;121;217;266;330;1;5;260;265
43;Tarragona;12;Baix Penedès;43163;Vendrell, el;3;3;C;;639;150;239;307;332;2;2;303;305
43;Tarragona;12;Baix Penedès;43163;Vendrell, el;3;4;A;;545;101;202;266;279;0;9;257;266
43;Tarragona;12;Baix Penedès;43163;Vendrell, el;3;4;B;;591;129;222;284;307;0;5;279;284
43;Tarragona;12;Baix Penedès;43163;Vendrell, el;3;4;C;;709;159;288;357;352;0;6;351;357
43;Tarragona;12;Baix Penedès;43163;Vendrell, el;3;5;A;;437;102;192;242;195;0;10;232;242
43;Tarragona;12;Baix Penedès;43163;Vendrell, el;3;5;B;;509;123;221;284;225;1;4;279;283
43;Tarragona;12;Baix Penedès;43163;Vendrell, el;3;6;A;;660;163;279;353;307;1;8;344;352
43;Tarragona;12;Baix Penedès;43163;Vendrell, el;3;6;B;;826;180;349;454;372;2;10;442;452
43;Tarragona;12;Baix Penedès;43163;Vendrell, el;3;7;A;;578;117;188;227;351;3;3;221;224
43;Tarragona;12;Baix Penedès;43163;Vendrell, el;3;7;B;;706;166;243;297;409;2;2;293;295
43;Tarragona;12;Baix Penedès;43163;Vendrell, el;3;7;C;;659;158;244;289;370;3;3;283;286
43;Tarragona;12;Baix Penedès;43163;Vendrell, el;3;8;A;;626;150;238;305;321;4;7;294;301
43;Tarragona;12;Baix Penedès;43163;Vendrell, el;3;8;B;;704;139;252;323;381;2;5;316;321
43;Tarragona;12;Baix Penedès;43163;Vendrell, el;3;8;C;;757;165;280;365;392;1;7;357;364
43;Tarragona;12;Baix Penedès;43163;Vendrell, el;3;9;A;;450;102;166;217;233;0;5;212;217
43;Tarragona;12;Baix Penedès;43163;Vendrell, el;3;9;B;;489;90;168;214;275;1;4;209;213
17;Girona;2;Alt Empordà;17210;Ventalló;1;1;U;;538;170;270;322;216;0;8;314;322
25;Lleida;38;Urgell;25242;Verdú;1;1;U;;816;266;426;510;306;11;10;489;499
17;Girona;10;Baix Empordà;17211;Verges;1;1;U;;887;321;541;621;266;13;14;594;608
43;Tarragona;36;Tarragonès;43164;Vespella de Gaià;1;1;U;;269;63;109;159;110;1;1;157;158
8;Barcelona;24;Osona;08298;Vic;1;1;U;;393;133;205;263;130;3;10;250;260
8;Barcelona;24;Osona;08298;Vic;1;2;U;;478;140;226;285;193;3;9;273;282
8;Barcelona;24;Osona;08298;Vic;1;3;U;;458;183;280;339;119;3;5;331;336
8;Barcelona;24;Osona;08298;Vic;2;1;U;;609;214;354;417;192;3;7;407;414
8;Barcelona;24;Osona;08298;Vic;2;2;A;;449;123;242;313;136;0;14;299;313
8;Barcelona;24;Osona;08298;Vic;2;2;B;;362;86;188;246;116;1;4;241;245
8;Barcelona;24;Osona;08298;Vic;2;2;C;;465;116;267;323;142;3;7;313;320
8;Barcelona;24;Osona;08298;Vic;2;3;A;;628;208;366;446;182;1;9;436;445
8;Barcelona;24;Osona;08298;Vic;2;3;B;;711;250;417;505;206;3;11;491;502
8;Barcelona;24;Osona;08298;Vic;2;4;A;;565;172;319;375;190;3;9;363;372
8;Barcelona;24;Osona;08298;Vic;2;4;B;;643;203;359;421;222;3;6;412;418
8;Barcelona;24;Osona;08298;Vic;2;5;A;;647;192;343;424;223;6;12;406;418
8;Barcelona;24;Osona;08298;Vic;2;5;B;;778;212;424;539;239;2;9;528;537
8;Barcelona;24;Osona;08298;Vic;2;6;A;;558;143;254;310;248;0;8;302;310
8;Barcelona;24;Osona;08298;Vic;2;6;B;;684;186;336;392;292;2;8;382;390
8;Barcelona;24;Osona;08298;Vic;3;1;A;;444;163;290;352;92;3;14;335;349
8;Barcelona;24;Osona;08298;Vic;3;1;B;;487;168;303;358;129;4;15;339;354
8;Barcelona;24;Osona;08298;Vic;3;10;U;;693;244;429;508;185;2;20;486;506
8;Barcelona;24;Osona;08298;Vic;3;11;A;;402;132;206;239;163;1;8;230;238
8;Barcelona;24;Osona;08298;Vic;3;11;B;;395;141;218;248;147;0;4;244;248
8;Barcelona;24;Osona;08298;Vic;3;12;A;;669;244;402;479;190;1;23;455;478
8;Barcelona;24;Osona;08298;Vic;3;12;B;;758;273;471;554;204;1;21;532;553
8;Barcelona;24;Osona;08298;Vic;3;2;U;;441;149;231;258;183;2;4;252;256
8;Barcelona;24;Osona;08298;Vic;3;3;A;;462;157;285;330;132;3;5;322;327
8;Barcelona;24;Osona;08298;Vic;3;3;B;;401;107;200;258;143;0;3;255;258
8;Barcelona;24;Osona;08298;Vic;3;3;C;;539;155;302;366;173;0;16;350;366
8;Barcelona;24;Osona;08298;Vic;3;4;U;;706;214;377;434;272;2;4;428;432
8;Barcelona;24;Osona;08298;Vic;3;5;A;;543;146;251;314;229;0;6;308;314
8;Barcelona;24;Osona;08298;Vic;3;5;B;;625;163;323;377;248;0;16;361;377
8;Barcelona;24;Osona;08298;Vic;3;6;A;;429;118;215;252;177;3;7;242;249
8;Barcelona;24;Osona;08298;Vic;3;6;B;;468;150;256;285;183;1;3;281;284
8;Barcelona;24;Osona;08298;Vic;3;7;A;;545;185;327;381;164;0;9;372;381
8;Barcelona;24;Osona;08298;Vic;3;7;B;;624;210;353;438;186;0;14;424;438
8;Barcelona;24;Osona;08298;Vic;3;8;A;;643;166;270;330;313;5;3;322;325
8;Barcelona;24;Osona;08298;Vic;3;8;B;;651;171;301;355;296;5;10;340;350
8;Barcelona;24;Osona;08298;Vic;3;9;U;;642;205;383;449;193;4;6;439;445
8;Barcelona;24;Osona;08298;Vic;4;1;A;;600;215;345;394;206;2;10;382;392
8;Barcelona;24;Osona;08298;Vic;4;1;B;;611;233;357;407;204;1;7;399;406
8;Barcelona;24;Osona;08298;Vic;4;2;A;;690;198;357;419;271;3;7;409;416
8;Barcelona;24;Osona;08298;Vic;4;2;B;;839;231;453;516;323;2;8;506;514
8;Barcelona;24;Osona;08298;Vic;4;3;A;;357;90;175;225;132;0;3;222;225
8;Barcelona;24;Osona;08298;Vic;4;3;B;;514;163;257;332;182;2;8;322;330
8;Barcelona;24;Osona;08298;Vic;4;4;A;;495;122;245;299;196;0;11;288;299
8;Barcelona;24;Osona;08298;Vic;4;4;B;;628;144;291;361;267;2;8;351;359
8;Barcelona;24;Osona;08298;Vic;5;1;U;;541;168;343;404;137;3;14;387;401
17;Girona;24;Osona;17212;Vidrà;1;1;U;;138;24;84;110;28;0;10;100;110
17;Girona;34;Selva;17213;Vidreres;1;1;A;;734;174;352;419;315;3;5;411;416
17;Girona;34;Selva;17213;Vidreres;1;1;B;;787;165;343;425;362;1;6;418;424
17;Girona;34;Selva;17213;Vidreres;1;2;U;;883;218;404;501;382;1;9;491;500
17;Girona;34;Selva;17213;Vidreres;1;3;A;;624;123;268;344;280;5;6;333;339
17;Girona;34;Selva;17213;Vidreres;1;3;B;;631;124;241;309;322;2;10;297;307
17;Girona;34;Selva;17213;Vidreres;1;4;A;;609;76;144;185;424;2;1;182;183
17;Girona;34;Selva;17213;Vidreres;1;4;B;;619;87;163;203;416;0;0;203;203
25;Lleida;39;Consell General d'Aran;25243;Vielha e Mijaran;1;1;A;;591;152;248;301;290;4;5;292;297
25;Lleida;39;Consell General d'Aran;25243;Vielha e Mijaran;1;1;B;;642;135;242;317;325;2;12;303;315
25;Lleida;39;Consell General d'Aran;25243;Vielha e Mijaran;1;2;A;;434;82;177;250;184;0;1;249;250
25;Lleida;39;Consell General d'Aran;25243;Vielha e Mijaran;1;2;B;;393;73;170;223;170;0;6;217;223
25;Lleida;39;Consell General d'Aran;25243;Vielha e Mijaran;1;2;C;;464;68;126;185;279;4;1;180;181
25;Lleida;39;Consell General d'Aran;25243;Vielha e Mijaran;1;3;U;;916;156;306;424;492;0;14;410;424
43;Tarragona;1;Alt Camp;43165;Vilabella;1;1;U;;629;186;367;464;165;0;7;457;464
17;Girona;2;Alt Empordà;17214;Vilabertran;1;1;U;;677;193;355;409;268;5;9;395;404
17;Girona;20;Gironès;17215;Vilablareix;1;1;A;;607;170;308;381;226;1;11;369;380
17;Girona;20;Gironès;17215;Vilablareix;1;1;B;;676;191;350;425;251;0;11;414;425
17;Girona;20;Gironès;17215;Vilablareix;1;1;C;;502;151;261;327;175;0;10;317;327
8;Barcelona;14;Berguedà;08299;Vilada;1;1;U;;454;142;259;291;163;2;6;283;289
17;Girona;2;Alt Empordà;17217;Viladamat;1;1;U;;346;128;230;259;87;4;9;246;255
17;Girona;20;Gironès;17216;Viladasens;1;1;U;;140;51;83;98;42;1;7;90;97
8;Barcelona;11;Baix Llobregat;08301;Viladecans;1;1;U;;938;232;389;457;481;0;8;449;457
8;Barcelona;11;Baix Llobregat;08301;Viladecans;1;10;A;;437;103;183;225;212;0;3;222;225
8;Barcelona;11;Baix Llobregat;08301;Viladecans;1;10;B;;553;134;220;267;286;2;2;263;265
8;Barcelona;11;Baix Llobregat;08301;Viladecans;1;11;A;;586;165;287;360;226;4;11;345;356
8;Barcelona;11;Baix Llobregat;08301;Viladecans;1;11;B;;664;186;327;412;252;2;9;401;410
8;Barcelona;11;Baix Llobregat;08301;Viladecans;1;12;U;;827;176;322;450;377;0;8;442;450
8;Barcelona;11;Baix Llobregat;08301;Viladecans;1;13;U;;936;187;350;467;469;2;16;449;465
8;Barcelona;11;Baix Llobregat;08301;Viladecans;1;14;U;;1274;262;450;578;696;1;14;563;577
8;Barcelona;11;Baix Llobregat;08301;Viladecans;1;15;U;;549;96;192;243;306;0;3;240;243
8;Barcelona;11;Baix Llobregat;08301;Viladecans;1;2;A;;558;116;215;270;288;0;3;267;270
8;Barcelona;11;Baix Llobregat;08301;Viladecans;1;2;B;;673;1;235;291;382;2;5;284;289
8;Barcelona;11;Baix Llobregat;08301;Viladecans;1;3;A;;866;191;343;451;415;4;9;438;447
8;Barcelona;11;Baix Llobregat;08301;Viladecans;1;3;B;;995;228;408;524;471;8;10;506;516
8;Barcelona;11;Baix Llobregat;08301;Viladecans;1;4;A;;946;181;376;509;437;2;7;500;507
8;Barcelona;11;Baix Llobregat;08301;Viladecans;1;4;B;;982;209;380;524;458;2;17;505;522
8;Barcelona;11;Baix Llobregat;08301;Viladecans;1;5;U;;627;152;275;333;294;0;9;324;333
8;Barcelona;11;Baix Llobregat;08301;Viladecans;1;6;A;;570;130;227;285;285;5;9;271;280
8;Barcelona;11;Baix Llobregat;08301;Viladecans;1;6;B;;710;161;277;355;355;1;6;348;354
8;Barcelona;11;Baix Llobregat;08301;Viladecans;1;7;A;;497;119;224;268;229;0;6;262;268
8;Barcelona;11;Baix Llobregat;08301;Viladecans;1;7;B;;496;117;212;249;247;0;14;235;249
8;Barcelona;11;Baix Llobregat;08301;Viladecans;1;8;U;;940;20;392;487;453;1;3;483;486
8;Barcelona;11;Baix Llobregat;08301;Viladecans;1;9;U;;847;201;330;415;432;0;5;410;415
8;Barcelona;11;Baix Llobregat;08301;Viladecans;2;1;A;;454;95;159;199;255;1;4;194;198
8;Barcelona;11;Baix Llobregat;08301;Viladecans;2;1;B;;618;152;234;284;334;1;4;279;283
8;Barcelona;11;Baix Llobregat;08301;Viladecans;2;10;A;;486;87;158;205;281;0;6;199;205
8;Barcelona;11;Baix Llobregat;08301;Viladecans;2;10;B;;659;132;213;275;384;1;3;271;274
8;Barcelona;11;Baix Llobregat;08301;Viladecans;2;11;U;;836;123;255;358;478;2;8;348;356
8;Barcelona;11;Baix Llobregat;08301;Viladecans;2;12;A;;543;108;169;210;333;0;6;204;210
8;Barcelona;11;Baix Llobregat;08301;Viladecans;2;12;B;;576;112;190;226;350;3;2;221;223
8;Barcelona;11;Baix Llobregat;08301;Viladecans;2;13;A;;520;107;184;240;280;0;5;235;240
8;Barcelona;11;Baix Llobregat;08301;Viladecans;2;13;B;;630;127;219;272;358;0;3;269;272
8;Barcelona;11;Baix Llobregat;08301;Viladecans;2;14;U;;815;116;217;307;508;0;2;305;307
8;Barcelona;11;Baix Llobregat;08301;Viladecans;2;15;A;;704;154;268;329;375;0;6;323;329
8;Barcelona;11;Baix Llobregat;08301;Viladecans;2;15;B;;749;169;277;346;403;3;4;339;343
8;Barcelona;11;Baix Llobregat;08301;Viladecans;2;16;A;;528;74;170;245;283;0;4;241;245
8;Barcelona;11;Baix Llobregat;08301;Viladecans;2;16;B;;713;111;252;336;377;1;4;331;335
8;Barcelona;11;Baix Llobregat;08301;Viladecans;2;17;A;;623;109;195;260;363;0;7;253;260
8;Barcelona;11;Baix Llobregat;08301;Viladecans;2;17;B;;714;126;222;297;417;1;2;294;296
8;Barcelona;11;Baix Llobregat;08301;Viladecans;2;18;U;;745;132;233;282;463;1;8;273;281
8;Barcelona;11;Baix Llobregat;08301;Viladecans;2;19;U;;597;114;219;294;303;1;2;291;293
8;Barcelona;11;Baix Llobregat;08301;Viladecans;2;2;A;;534;100;171;231;303;2;9;220;229
8;Barcelona;11;Baix Llobregat;08301;Viladecans;2;2;B;;565;99;181;245;320;0;7;238;245
8;Barcelona;11;Baix Llobregat;08301;Viladecans;2;20;A;;546;90;198;256;290;3;3;250;253
8;Barcelona;11;Baix Llobregat;08301;Viladecans;2;20;B;;683;139;240;333;350;2;6;325;331
8;Barcelona;11;Baix Llobregat;08301;Viladecans;2;21;U;;923;150;284;372;551;1;3;368;371
8;Barcelona;11;Baix Llobregat;08301;Viladecans;2;22;A;;581;140;209;275;306;1;2;272;274
8;Barcelona;11;Baix Llobregat;08301;Viladecans;2;22;B;;641;139;239;322;319;2;8;312;320
8;Barcelona;11;Baix Llobregat;08301;Viladecans;2;23;A;;421;94;174;232;189;0;5;227;232
8;Barcelona;11;Baix Llobregat;08301;Viladecans;2;23;B;;454;109;179;251;203;1;5;245;250
8;Barcelona;11;Baix Llobregat;08301;Viladecans;2;24;U;;742;127;238;317;425;2;5;310;315
8;Barcelona;11;Baix Llobregat;08301;Viladecans;2;25;A;;581;86;163;233;348;1;3;229;232
8;Barcelona;11;Baix Llobregat;08301;Viladecans;2;25;B;;682;114;201;285;397;1;6;278;284
8;Barcelona;11;Baix Llobregat;08301;Viladecans;2;26;A;;512;111;205;279;233;0;7;272;279
8;Barcelona;11;Baix Llobregat;08301;Viladecans;2;26;B;;618;140;234;324;294;3;8;313;321
8;Barcelona;11;Baix Llobregat;08301;Viladecans;2;27;U;;799;149;311;386;413;3;9;374;383
8;Barcelona;11;Baix Llobregat;08301;Viladecans;2;28;U;;810;170;305;411;399;1;7;403;410
8;Barcelona;11;Baix Llobregat;08301;Viladecans;2;29;A;;629;152;255;329;300;0;6;323;329
8;Barcelona;11;Baix Llobregat;08301;Viladecans;2;29;B;;755;186;345;435;320;2;9;424;433
8;Barcelona;11;Baix Llobregat;08301;Viladecans;2;3;A;;715;160;290;378;337;1;5;372;377
8;Barcelona;11;Baix Llobregat;08301;Viladecans;2;3;B;;811;173;340;438;373;0;8;430;438
8;Barcelona;11;Baix Llobregat;08301;Viladecans;2;4;U;;862;169;287;387;475;1;8;378;386
8;Barcelona;11;Baix Llobregat;08301;Viladecans;2;5;U;;812;211;377;441;371;1;7;433;440
8;Barcelona;11;Baix Llobregat;08301;Viladecans;2;6;A;;468;95;152;191;277;3;5;183;188
8;Barcelona;11;Baix Llobregat;08301;Viladecans;2;6;B;;604;114;193;248;356;2;7;239;246
8;Barcelona;11;Baix Llobregat;08301;Viladecans;2;7;A;;470;93;159;197;273;2;5;190;195
8;Barcelona;11;Baix Llobregat;08301;Viladecans;2;7;B;;537;125;184;247;290;3;9;235;244
8;Barcelona;11;Baix Llobregat;08301;Viladecans;2;8;A;;460;111;173;215;245;1;7;207;214
8;Barcelona;11;Baix Llobregat;08301;Viladecans;2;8;B;;612;104;225;284;328;0;4;280;284
8;Barcelona;11;Baix Llobregat;08301;Viladecans;2;9;A;;519;87;157;197;322;4;4;189;193
8;Barcelona;11;Baix Llobregat;08301;Viladecans;2;9;B;;559;76;167;220;339;0;2;218;220
8;Barcelona;40;Vallès Occidental;08300;Viladecavalls;1;1;A;;604;185;344;429;175;0;10;419;429
8;Barcelona;40;Vallès Occidental;08300;Viladecavalls;1;1;B;;600;171;308;399;201;4;7;388;395
8;Barcelona;40;Vallès Occidental;08300;Viladecavalls;1;1;C;;591;150;286;370;221;0;5;365;370
8;Barcelona;40;Vallès Occidental;08300;Viladecavalls;1;2;A;;435;77;157;204;231;0;5;199;204
8;Barcelona;40;Vallès Occidental;08300;Viladecavalls;1;2;B;;413;75;147;200;213;0;5;195;200
8;Barcelona;40;Vallès Occidental;08300;Viladecavalls;1;2;C;;693;112;234;349;344;3;26;320;346
8;Barcelona;40;Vallès Occidental;08300;Viladecavalls;1;2;D;;487;86;145;210;277;1;6;203;209
8;Barcelona;40;Vallès Occidental;08300;Viladecavalls;1;3;A;;409;70;143;179;230;0;4;175;179
8;Barcelona;40;Vallès Occidental;08300;Viladecavalls;1;3;B;;525;103;182;246;279;0;3;243;246
8;Barcelona;40;Vallès Occidental;08300;Viladecavalls;1;4;U;;560;145;258;345;215;2;2;341;343
17;Girona;28;Pla de l'Estany;17218;Vilademuls;1;1;A;;271;93;149;181;90;0;2;179;181
17;Girona;28;Pla de l'Estany;17218;Vilademuls;1;1;B;;331;117;196;240;91;1;8;231;239
17;Girona;24;Osona;17220;Viladrau;1;1;U;;747;231;365;498;249;2;15;481;496
17;Girona;2;Alt Empordà;17221;Vilafant;1;1;A;;915;224;441;509;406;9;1;499;500
17;Girona;2;Alt Empordà;17221;Vilafant;1;1;B;;1085;303;478;569;516;1;5;563;568
17;Girona;2;Alt Empordà;17221;Vilafant;1;2;A;;592;175;291;356;236;1;7;348;355
17;Girona;2;Alt Empordà;17221;Vilafant;1;2;B;;609;133;312;327;282;1;7;319;326
17;Girona;2;Alt Empordà;17221;Vilafant;1;2;C;;673;163;322;402;271;5;4;393;397
8;Barcelona;3;Alt Penedès;08305;Vilafranca del Penedès;1;1;A;;433;141;216;268;165;3;10;255;265
8;Barcelona;3;Alt Penedès;08305;Vilafranca del Penedès;1;1;B;;551;174;278;293;258;6;7;280;287
8;Barcelona;3;Alt Penedès;08305;Vilafranca del Penedès;1;1;C;;481;148;248;337;144;2;6;329;335
8;Barcelona;3;Alt Penedès;08305;Vilafranca del Penedès;1;2;A;;545;153;268;325;220;2;7;316;323
8;Barcelona;3;Alt Penedès;08305;Vilafranca del Penedès;1;2;B;;429;120;199;238;191;2;5;231;236
8;Barcelona;3;Alt Penedès;08305;Vilafranca del Penedès;1;2;C;;646;191;306;381;265;2;11;368;379
8;Barcelona;3;Alt Penedès;08305;Vilafranca del Penedès;1;2;D;;519;140;243;328;191;3;6;319;325
8;Barcelona;3;Alt Penedès;08305;Vilafranca del Penedès;2;1;A;;496;111;188;247;249;3;1;243;244
8;Barcelona;3;Alt Penedès;08305;Vilafranca del Penedès;2;1;B;;606;145;251;305;301;2;4;299;303
8;Barcelona;3;Alt Penedès;08305;Vilafranca del Penedès;2;1;C;;560;123;228;284;276;2;6;276;282
8;Barcelona;3;Alt Penedès;08305;Vilafranca del Penedès;2;2;A;;375;89;169;216;159;0;4;212;216
8;Barcelona;3;Alt Penedès;08305;Vilafranca del Penedès;2;2;B;;517;121;216;284;233;1;14;269;283
8;Barcelona;3;Alt Penedès;08305;Vilafranca del Penedès;2;3;A;;519;139;245;299;220;3;8;288;296
8;Barcelona;3;Alt Penedès;08305;Vilafranca del Penedès;2;3;B;;540;160;259;313;227;3;8;302;310
8;Barcelona;3;Alt Penedès;08305;Vilafranca del Penedès;2;4;A;;548;173;271;320;228;2;4;314;318
8;Barcelona;3;Alt Penedès;08305;Vilafranca del Penedès;2;4;B;;693;220;350;406;287;1;7;398;405
8;Barcelona;3;Alt Penedès;08305;Vilafranca del Penedès;2;5;A;;641;210;355;427;214;4;7;416;423
8;Barcelona;3;Alt Penedès;08305;Vilafranca del Penedès;2;5;B;;792;265;440;539;253;5;11;523;534
8;Barcelona;3;Alt Penedès;08305;Vilafranca del Penedès;2;6;A;;481;123;209;246;235;0;8;238;246
8;Barcelona;3;Alt Penedès;08305;Vilafranca del Penedès;2;6;B;;596;116;244;303;293;2;5;296;301
8;Barcelona;3;Alt Penedès;08305;Vilafranca del Penedès;2;6;C;;540;110;212;265;275;0;3;262;265
8;Barcelona;3;Alt Penedès;08305;Vilafranca del Penedès;3;1;A;;554;162;266;352;202;3;5;344;349
8;Barcelona;3;Alt Penedès;08305;Vilafranca del Penedès;3;1;B;;440;135;225;284;156;0;5;279;284
8;Barcelona;3;Alt Penedès;08305;Vilafranca del Penedès;3;1;C;;630;195;301;321;309;5;13;303;316
8;Barcelona;3;Alt Penedès;08305;Vilafranca del Penedès;3;1;D;;494;144;247;400;94;5;8;387;395
8;Barcelona;3;Alt Penedès;08305;Vilafranca del Penedès;3;2;A;;409;140;255;299;110;3;3;293;296
8;Barcelona;3;Alt Penedès;08305;Vilafranca del Penedès;3;2;B;;457;130;250;318;139;3;7;308;315
8;Barcelona;3;Alt Penedès;08305;Vilafranca del Penedès;3;3;A;;728;214;388;456;272;4;10;442;452
8;Barcelona;3;Alt Penedès;08305;Vilafranca del Penedès;3;3;B;;590;172;277;360;230;0;6;354;360
8;Barcelona;3;Alt Penedès;08305;Vilafranca del Penedès;3;3;C;;466;126;209;289;177;0;8;281;289
8;Barcelona;3;Alt Penedès;08305;Vilafranca del Penedès;4;1;A;;630;211;355;448;182;2;11;435;446
8;Barcelona;3;Alt Penedès;08305;Vilafranca del Penedès;4;1;B;;703;253;386;493;210;4;13;476;489
8;Barcelona;3;Alt Penedès;08305;Vilafranca del Penedès;4;2;A;;606;208;320;402;204;2;5;395;400
8;Barcelona;3;Alt Penedès;08305;Vilafranca del Penedès;4;2;B;;696;230;392;465;231;2;6;457;463
8;Barcelona;3;Alt Penedès;08305;Vilafranca del Penedès;4;3;A;;549;152;258;351;198;2;11;338;349
8;Barcelona;3;Alt Penedès;08305;Vilafranca del Penedès;4;3;B;;426;120;230;299;127;0;4;295;299
8;Barcelona;3;Alt Penedès;08305;Vilafranca del Penedès;4;3;C;;585;160;298;391;194;2;8;381;389
8;Barcelona;3;Alt Penedès;08305;Vilafranca del Penedès;4;3;D;;494;152;247;331;163;1;7;323;330
8;Barcelona;3;Alt Penedès;08305;Vilafranca del Penedès;4;4;A;;528;140;279;349;179;1;3;345;348
8;Barcelona;3;Alt Penedès;08305;Vilafranca del Penedès;4;4;B;;690;205;368;446;244;4;10;432;442
8;Barcelona;3;Alt Penedès;08305;Vilafranca del Penedès;4;5;A;;581;147;244;348;233;1;9;338;347
8;Barcelona;3;Alt Penedès;08305;Vilafranca del Penedès;4;5;B;;583;143;285;372;211;0;10;362;372
8;Barcelona;3;Alt Penedès;08305;Vilafranca del Penedès;4;5;C;;717;201;343;445;272;3;15;427;442
8;Barcelona;3;Alt Penedès;08305;Vilafranca del Penedès;4;5;D;;631;194;329;393;238;3;9;381;390
8;Barcelona;3;Alt Penedès;08305;Vilafranca del Penedès;4;6;A;;457;152;246;319;138;2;7;310;317
8;Barcelona;3;Alt Penedès;08305;Vilafranca del Penedès;4;6;B;;586;184;317;412;174;4;6;402;408
25;Lleida;38;Urgell;25244;Vilagrassa;1;1;U;;370;100;216;271;99;1;8;262;270
17;Girona;2;Alt Empordà;17223;Vilajuïga;1;1;U;;782;233;406;483;299;3;2;478;480
43;Tarragona;37;Terra Alta;43175;Vilalba dels Arcs;1;1;U;;625;177;330;461;164;2;5;454;459
8;Barcelona;41;Vallès Oriental;08306;Vilalba Sasserra;1;1;U;;455;104;217;274;181;2;6;266;272
25;Lleida;5;Alta Ribagorça;25245;Vilaller;1;1;U;;460;113;201;266;194;0;10;256;266
43;Tarragona;36;Tarragonès;43166;Vilallonga del Camp;1;1;A;;533;138;275;331;202;0;3;328;331
43;Tarragona;36;Tarragonès;43166;Vilallonga del Camp;1;1;B;;655;166;313;396;259;5;5;386;391
17;Girona;31;Ripollès;17224;Vilallonga de Ter;1;1;U;;374;121;219;258;116;1;4;253;257
17;Girona;2;Alt Empordà;17225;Vilamacolum;1;1;U;;216;71;132;151;65;4;3;144;147
17;Girona;2;Alt Empordà;17226;Vilamalla;1;1;A;;391;89;155;197;194;1;2;194;196
17;Girona;2;Alt Empordà;17226;Vilamalla;1;1;B;;392;77;164;204;188;1;4;199;203
17;Girona;2;Alt Empordà;17227;Vilamaniscle;1;1;U;;100;28;53;66;34;0;0;66;66
25;Lleida;39;Consell General d'Aran;25247;Vilamòs;1;1;U;;128;15;39;51;77;0;0;51;51
17;Girona;2;Alt Empordà;17228;Vilanant;1;1;U;;262;86;134;164;98;0;6;158;164
43;Tarragona;8;Baix Camp;43167;Vilanova d'Escornalbou;1;1;U;;361;116;212;259;102;0;10;249;259
25;Lleida;27;Pla d'Urgell;25248;Vilanova de Bellpuig;1;1;U;;939;232;530;683;256;2;17;664;681
25;Lleida;23;Noguera;25249;Vilanova de l'Aguda;1;1;U;;207;58;111;132;75;0;3;129;132
25;Lleida;33;Segrià;25254;Vilanova de la Barca;1;1;U;;762;195;431;540;222;7;13;520;533
8;Barcelona;6;Anoia;08302;Vilanova del Camí;1;1;A;;416;47;168;216;200;0;3;213;216
8;Barcelona;6;Anoia;08302;Vilanova del Camí;1;1;B;;503;111;191;235;268;1;2;232;234
8;Barcelona;6;Anoia;08302;Vilanova del Camí;1;1;C;;395;96;160;197;198;1;4;192;196
8;Barcelona;6;Anoia;08302;Vilanova del Camí;1;2;A;;593;119;213;251;342;2;5;244;249
8;Barcelona;6;Anoia;08302;Vilanova del Camí;1;2;B;;692;97;274;331;361;3;8;320;328
8;Barcelona;6;Anoia;08302;Vilanova del Camí;1;2;C;;586;141;189;250;336;1;4;245;249
8;Barcelona;6;Anoia;08302;Vilanova del Camí;1;3;A;;589;117;221;287;302;1;7;279;286
8;Barcelona;6;Anoia;08302;Vilanova del Camí;1;3;B;;686;122;234;303;383;1;9;293;302
8;Barcelona;6;Anoia;08302;Vilanova del Camí;1;3;C;;664;112;225;306;358;0;4;302;306
8;Barcelona;6;Anoia;08302;Vilanova del Camí;1;4;A;;633;169;262;323;310;1;2;320;322
8;Barcelona;6;Anoia;08302;Vilanova del Camí;1;4;B;;691;148;274;335;356;2;6;327;333
8;Barcelona;6;Anoia;08302;Vilanova del Camí;1;4;C;;611;136;236;307;304;0;6;301;307
8;Barcelona;6;Anoia;08302;Vilanova del Camí;1;5;A;;603;107;209;267;336;2;4;261;265
8;Barcelona;6;Anoia;08302;Vilanova del Camí;1;5;B;;761;164;283;354;407;5;10;339;349
8;Barcelona;6;Anoia;08302;Vilanova del Camí;1;5;C;;513;98;202;254;259;1;5;248;253
8;Barcelona;41;Vallès Oriental;08902;Vilanova del Vallès;1;1;A;;642;158;322;405;237;1;10;394;404
8;Barcelona;41;Vallès Oriental;08902;Vilanova del Vallès;1;1;B;;717;175;341;440;277;3;14;423;437
8;Barcelona;41;Vallès Oriental;08902;Vilanova del Vallès;1;2;A;;737;146;299;389;348;2;3;384;387
8;Barcelona;41;Vallès Oriental;08902;Vilanova del Vallès;1;2;B;;918;233;418;529;389;0;9;520;529
25;Lleida;23;Noguera;25250;Vilanova de Meià;1;1;U;;379;88;181;239;140;2;5;232;237
43;Tarragona;16;Conca de Barberà;43168;Vilanova de Prades;1;1;U;;122;42;62;86;36;0;0;86;86
8;Barcelona;24;Osona;08303;Vilanova de Sau;1;1;U;;277;89;165;206;71;0;3;203;206
25;Lleida;33;Segrià;25251;Vilanova de Segrià;1;1;U;;643;146;306;384;259;2;3;379;382
8;Barcelona;17;Garraf;08307;Vilanova i la Geltrú;1;1;A;;839;241;415;520;319;2;14;504;518
8;Barcelona;17;Garraf;08307;Vilanova i la Geltrú;1;1;B;;952;237;419;518;434;1;7;510;517
8;Barcelona;17;Garraf;08307;Vilanova i la Geltrú;1;10;A;;574;158;289;362;212;0;8;354;362
8;Barcelona;17;Garraf;08307;Vilanova i la Geltrú;1;10;B;;546;150;269;341;205;0;7;334;341
8;Barcelona;17;Garraf;08307;Vilanova i la Geltrú;1;11;A;;526;146;228;269;257;0;6;263;269
8;Barcelona;17;Garraf;08307;Vilanova i la Geltrú;1;11;B;;575;171;247;301;274;0;4;297;301
8;Barcelona;17;Garraf;08307;Vilanova i la Geltrú;1;2;A;;415;120;207;270;145;0;2;268;270
8;Barcelona;17;Garraf;08307;Vilanova i la Geltrú;1;2;B;;525;143;254;322;203;0;10;312;322
8;Barcelona;17;Garraf;08307;Vilanova i la Geltrú;1;3;A;;764;238;395;489;275;0;1;488;489
8;Barcelona;17;Garraf;08307;Vilanova i la Geltrú;1;3;B;;928;256;458;555;373;2;6;547;553
8;Barcelona;17;Garraf;08307;Vilanova i la Geltrú;1;4;U;;739;160;394;484;255;1;8;475;483
8;Barcelona;17;Garraf;08307;Vilanova i la Geltrú;1;5;U;;687;260;408;473;214;1;3;469;472
8;Barcelona;17;Garraf;08307;Vilanova i la Geltrú;1;6;A;;609;190;290;364;245;4;6;354;360
8;Barcelona;17;Garraf;08307;Vilanova i la Geltrú;1;6;B;;659;195;313;393;266;3;6;384;390
8;Barcelona;17;Garraf;08307;Vilanova i la Geltrú;1;7;A;;526;141;244;298;228;0;5;293;298
8;Barcelona;17;Garraf;08307;Vilanova i la Geltrú;1;7;B;;586;152;258;321;265;5;3;313;316
8;Barcelona;17;Garraf;08307;Vilanova i la Geltrú;1;8;A;;863;239;410;499;364;0;10;489;499
8;Barcelona;17;Garraf;08307;Vilanova i la Geltrú;1;8;B;;1068;281;466;597;471;0;6;591;597
8;Barcelona;17;Garraf;08307;Vilanova i la Geltrú;1;9;A;;559;145;249;330;229;1;2;327;329
8;Barcelona;17;Garraf;08307;Vilanova i la Geltrú;1;9;B;;668;198;331;446;222;2;9;435;444
8;Barcelona;17;Garraf;08307;Vilanova i la Geltrú;2;1;A;;813;208;422;530;283;1;8;521;529
8;Barcelona;17;Garraf;08307;Vilanova i la Geltrú;2;1;B;;958;243;464;595;363;0;12;583;595
8;Barcelona;17;Garraf;08307;Vilanova i la Geltrú;2;2;A;;787;227;364;466;321;1;9;456;465
8;Barcelona;17;Garraf;08307;Vilanova i la Geltrú;2;2;B;;873;269;396;510;363;0;8;502;510
8;Barcelona;17;Garraf;08307;Vilanova i la Geltrú;2;3;U;;897;294;452;561;336;3;8;550;558
8;Barcelona;17;Garraf;08307;Vilanova i la Geltrú;2;4;A;;721;217;352;425;296;6;11;408;419
8;Barcelona;17;Garraf;08307;Vilanova i la Geltrú;2;4;B;;781;240;382;460;321;3;10;447;457
8;Barcelona;17;Garraf;08307;Vilanova i la Geltrú;2;5;U;;505;97;169;217;288;0;2;215;217
8;Barcelona;17;Garraf;08307;Vilanova i la Geltrú;2;6;A;;624;176;281;357;267;0;5;352;357
8;Barcelona;17;Garraf;08307;Vilanova i la Geltrú;2;6;B;;680;166;290;353;327;0;3;350;353
8;Barcelona;17;Garraf;08307;Vilanova i la Geltrú;2;7;A;;769;227;348;416;353;4;4;408;412
8;Barcelona;17;Garraf;08307;Vilanova i la Geltrú;2;7;B;;819;268;382;420;399;4;5;411;416
8;Barcelona;17;Garraf;08307;Vilanova i la Geltrú;3;1;U;;509;160;255;305;204;2;5;298;303
8;Barcelona;17;Garraf;08307;Vilanova i la Geltrú;3;2;U;;757;219;346;447;310;7;7;433;440
8;Barcelona;17;Garraf;08307;Vilanova i la Geltrú;3;3;U;;870;252;414;528;342;3;19;506;525
8;Barcelona;17;Garraf;08307;Vilanova i la Geltrú;3;4;A;;829;205;335;406;423;1;7;398;405
8;Barcelona;17;Garraf;08307;Vilanova i la Geltrú;3;4;B;;975;201;365;439;536;1;8;430;438
8;Barcelona;17;Garraf;08307;Vilanova i la Geltrú;3;5;U;;988;254;385;484;504;3;4;477;481
8;Barcelona;17;Garraf;08307;Vilanova i la Geltrú;4;1;U;;836;272;451;556;280;6;10;540;550
8;Barcelona;17;Garraf;08307;Vilanova i la Geltrú;4;10;A;;700;158;301;395;305;7;14;374;388
8;Barcelona;17;Garraf;08307;Vilanova i la Geltrú;4;10;B;;856;192;349;441;415;2;8;431;439
8;Barcelona;17;Garraf;08307;Vilanova i la Geltrú;4;11;A;;601;144;223;270;331;1;4;265;269
8;Barcelona;17;Garraf;08307;Vilanova i la Geltrú;4;11;B;;804;206;331;404;400;0;7;397;404
8;Barcelona;17;Garraf;08307;Vilanova i la Geltrú;4;12;A;;517;130;237;316;201;1;2;313;315
8;Barcelona;17;Garraf;08307;Vilanova i la Geltrú;4;12;B;;645;131;271;364;281;3;8;353;361
8;Barcelona;17;Garraf;08307;Vilanova i la Geltrú;4;13;U;;968;246;436;564;404;1;6;557;563
8;Barcelona;17;Garraf;08307;Vilanova i la Geltrú;4;14;U;;1298;320;571;741;557;0;12;729;741
8;Barcelona;17;Garraf;08307;Vilanova i la Geltrú;4;15;U;;1325;371;658;836;489;1;15;820;835
8;Barcelona;17;Garraf;08307;Vilanova i la Geltrú;4;16;U;;726;100;167;214;512;1;1;212;213
8;Barcelona;17;Garraf;08307;Vilanova i la Geltrú;4;2;U;;561;200;311;376;185;1;5;370;375
8;Barcelona;17;Garraf;08307;Vilanova i la Geltrú;4;3;U;;539;159;252;287;252;2;3;282;285
8;Barcelona;17;Garraf;08307;Vilanova i la Geltrú;4;4;A;;565;162;257;323;242;1;7;315;322
8;Barcelona;17;Garraf;08307;Vilanova i la Geltrú;4;4;B;;751;216;340;414;337;2;6;406;412
8;Barcelona;17;Garraf;08307;Vilanova i la Geltrú;4;5;A;;650;162;287;374;276;0;7;367;374
8;Barcelona;17;Garraf;08307;Vilanova i la Geltrú;4;5;B;;743;193;342;440;303;0;10;430;440
8;Barcelona;17;Garraf;08307;Vilanova i la Geltrú;4;6;A;;610;170;288;364;246;3;4;357;361
8;Barcelona;17;Garraf;08307;Vilanova i la Geltrú;4;6;B;;766;231;360;447;319;0;8;439;447
8;Barcelona;17;Garraf;08307;Vilanova i la Geltrú;4;7;A;;1032;218;381;501;531;1;6;494;500
8;Barcelona;17;Garraf;08307;Vilanova i la Geltrú;4;7;B;;1125;213;389;497;628;1;2;494;496
8;Barcelona;17;Garraf;08307;Vilanova i la Geltrú;4;8;U;;726;165;276;363;363;1;8;354;362
8;Barcelona;17;Garraf;08307;Vilanova i la Geltrú;4;9;U;;898;235;427;528;370;4;6;518;524
43;Tarragona;8;Baix Camp;43169;Vilaplana;1;1;U;;460;142;310;378;82;3;9;366;375
43;Tarragona;1;Alt Camp;43170;Vila-rodona;1;1;U;;863;224;462;560;303;3;19;538;557
17;Girona;2;Alt Empordà;17230;Vila-sacra;1;1;U;;363;132;225;252;111;1;0;251;251
25;Lleida;27;Pla d'Urgell;25252;Vila-sana;1;1;U;;463;129;288;322;141;0;18;304;322
43;Tarragona;36;Tarragonès;43171;Vila-seca;1;1;A;;491;125;195;259;232;0;2;257;259
43;Tarragona;36;Tarragonès;43171;Vila-seca;1;1;B;;563;158;251;317;246;3;6;308;314
43;Tarragona;36;Tarragonès;43171;Vila-seca;1;1;C;;440;63;128;168;272;0;0;168;168
43;Tarragona;36;Tarragonès;43171;Vila-seca;1;10;A;;494;79;148;202;292;2;1;199;200
43;Tarragona;36;Tarragonès;43171;Vila-seca;1;10;B;;586;121;191;251;335;1;2;248;250
43;Tarragona;36;Tarragonès;43171;Vila-seca;1;2;A;;734;133;256;346;388;0;7;339;346
43;Tarragona;36;Tarragonès;43171;Vila-seca;1;2;B;;970;194;352;484;486;2;15;467;482
43;Tarragona;36;Tarragonès;43171;Vila-seca;1;3;A;;386;76;132;181;205;0;9;172;181
43;Tarragona;36;Tarragonès;43171;Vila-seca;1;3;B;;495;101;182;243;252;1;4;238;242
43;Tarragona;36;Tarragonès;43171;Vila-seca;1;4;A;;286;80;135;172;114;3;4;165;169
43;Tarragona;36;Tarragonès;43171;Vila-seca;1;4;B;;365;114;206;238;127;2;0;236;236
43;Tarragona;36;Tarragonès;43171;Vila-seca;1;5;A;;540;130;210;279;261;1;6;272;278
43;Tarragona;36;Tarragonès;43171;Vila-seca;1;5;B;;597;171;274;324;273;3;8;313;321
43;Tarragona;36;Tarragonès;43171;Vila-seca;1;6;A;;543;107;200;278;265;0;9;269;278
43;Tarragona;36;Tarragonès;43171;Vila-seca;1;6;B;;665;143;256;338;327;3;4;331;335
43;Tarragona;36;Tarragonès;43171;Vila-seca;1;7;A;;783;155;254;342;441;2;4;336;340
43;Tarragona;36;Tarragonès;43171;Vila-seca;1;7;B;;873;178;292;400;473;0;3;397;400
43;Tarragona;36;Tarragonès;43171;Vila-seca;1;8;A;;680;102;165;216;464;2;5;209;214
43;Tarragona;36;Tarragonès;43171;Vila-seca;1;8;B;;745;119;199;237;508;1;2;234;236
43;Tarragona;36;Tarragonès;43171;Vila-seca;1;9;A;;503;77;168;228;275;0;1;227;228
43;Tarragona;36;Tarragonès;43171;Vila-seca;1;9;B;;700;138;269;364;336;1;7;356;363
8;Barcelona;21;Maresme;08214;Vilassar de Dalt;1;1;A;;510;134;255;323;187;1;7;315;322
8;Barcelona;21;Maresme;08214;Vilassar de Dalt;1;1;B;;548;161;302;370;178;2;5;363;368
8;Barcelona;21;Maresme;08214;Vilassar de Dalt;1;2;U;;779;211;372;461;318;1;6;454;460
8;Barcelona;21;Maresme;08214;Vilassar de Dalt;1;3;A;;518;138;239;290;228;0;4;286;290
8;Barcelona;21;Maresme;08214;Vilassar de Dalt;1;3;B;;578;149;273;328;250;0;5;323;328
8;Barcelona;21;Maresme;08214;Vilassar de Dalt;1;4;A;;498;149;237;346;152;1;4;341;345
8;Barcelona;21;Maresme;08214;Vilassar de Dalt;1;4;B;;583;154;290;380;203;0;7;373;380
8;Barcelona;21;Maresme;08214;Vilassar de Dalt;2;1;A;;690;196;398;481;209;2;9;470;479
8;Barcelona;21;Maresme;08214;Vilassar de Dalt;2;1;B;;870;257;488;590;280;0;15;575;590
8;Barcelona;21;Maresme;08214;Vilassar de Dalt;2;2;A;;527;132;262;335;192;0;6;329;335
8;Barcelona;21;Maresme;08214;Vilassar de Dalt;2;2;B;;561;139;276;360;201;0;7;353;360
8;Barcelona;21;Maresme;08219;Vilassar de Mar;1;1;U;;733;243;417;514;219;3;11;500;511
8;Barcelona;21;Maresme;08219;Vilassar de Mar;1;2;A;;560;173;319;370;190;2;10;358;368
8;Barcelona;21;Maresme;08219;Vilassar de Mar;1;2;B;;765;211;420;540;225;6;16;518;534
8;Barcelona;21;Maresme;08219;Vilassar de Mar;1;3;A;;618;188;321;393;225;0;12;381;393
8;Barcelona;21;Maresme;08219;Vilassar de Mar;1;3;B;;789;210;372;462;327;2;15;445;460
8;Barcelona;21;Maresme;08219;Vilassar de Mar;1;4;U;;979;245;492;644;335;3;15;626;641
8;Barcelona;21;Maresme;08219;Vilassar de Mar;1;5;A;;487;145;250;323;164;1;11;311;322
8;Barcelona;21;Maresme;08219;Vilassar de Mar;1;5;B;;535;149;264;337;198;2;2;333;335
8;Barcelona;21;Maresme;08219;Vilassar de Mar;1;6;A;;459;154;242;298;161;0;4;294;298
8;Barcelona;21;Maresme;08219;Vilassar de Mar;1;6;B;;482;156;251;316;166;5;6;305;311
8;Barcelona;21;Maresme;08219;Vilassar de Mar;2;1;U;;851;248;451;575;276;13;6;556;562
8;Barcelona;21;Maresme;08219;Vilassar de Mar;2;2;U;;848;271;490;606;242;4;12;590;602
8;Barcelona;21;Maresme;08219;Vilassar de Mar;2;3;U;;853;251;501;564;289;2;20;542;562
8;Barcelona;21;Maresme;08219;Vilassar de Mar;2;4;U;;884;283;453;593;291;1;12;580;592
8;Barcelona;21;Maresme;08219;Vilassar de Mar;2;5;U;;919;261;492;635;284;1;20;614;634
8;Barcelona;21;Maresme;08219;Vilassar de Mar;3;1;A;;470;160;261;318;152;0;13;305;318
8;Barcelona;21;Maresme;08219;Vilassar de Mar;3;1;B;;570;170;292;357;213;0;5;352;357
8;Barcelona;21;Maresme;08219;Vilassar de Mar;3;2;U;;889;255;439;557;332;2;16;539;555
8;Barcelona;21;Maresme;08219;Vilassar de Mar;3;3;U;;740;195;340;421;319;2;9;410;419
8;Barcelona;21;Maresme;08219;Vilassar de Mar;3;4;U;;770;187;326;389;381;1;4;384;388
17;Girona;2;Alt Empordà;17222;Vilaür;1;1;U;;111;41;61;78;33;0;1;77;78
43;Tarragona;16;Conca de Barberà;43172;Vilaverd;1;1;U;;358;140;238;277;81;2;4;271;275
43;Tarragona;29;Priorat;43173;Vilella Alta, la;1;1;U;;102;17;52;71;31;1;0;70;70
43;Tarragona;29;Priorat;43174;Vilella Baixa, la;1;1;U;;141;40;75;100;41;0;0;100;100
17;Girona;34;Selva;17233;Vilobí d'Onyar;1;1;U;;642;168;323;407;235;2;12;393;405
17;Girona;34;Selva;17233;Vilobí d'Onyar;1;2;A;;739;221;374;457;282;6;15;436;451
17;Girona;34;Selva;17233;Vilobí d'Onyar;1;2;B;;686;208;364;445;241;6;9;430;439
8;Barcelona;3;Alt Penedès;08304;Vilobí del Penedès;1;1;U;;811;297;453;577;234;3;11;563;574
17;Girona;10;Baix Empordà;17232;Vilopriu;1;1;U;;146;44;76;101;45;0;2;99;101
25;Lleida;18;Garrigues;25253;Vilosell, el;1;1;U;;178;72;100;141;37;2;1;138;139
43;Tarragona;16;Conca de Barberà;43176;Vimbodí i Poblet;1;1;U;;897;250;441;569;328;4;12;553;565
25;Lleida;18;Garrigues;25255;Vinaixa;1;1;U;;499;132;300;347;152;5;2;340;342
43;Tarragona;30;Ribera d'Ebre;43177;Vinebre;1;1;U;;368;107;229;270;98;1;5;264;269
43;Tarragona;8;Baix Camp;43178;Vinyols i els Arcs;1;1;A;;775;166;392;491;284;1;4;486;490
43;Tarragona;8;Baix Camp;43178;Vinyols i els Arcs;1;1;B;;333;93;195;187;146;0;3;184;187
8;Barcelona;14;Berguedà;08308;Viver i Serrateix;1;1;U;;160;65;110;130;30;0;2;128;130
43;Tarragona;9;Baix Ebre;43052;Xerta;1;1;U;;996;311;561;711;285;10;8;693;701
8;Barcelona;98;Residents Absents;08998;Residents Absents;1;1;U;;82493; ; ;16801;65692;87;116;16598;16714
17;Girona;98;Residents Absents;17998;Residents Absents;1;1;U;;7721; ; ;1815;5906;4;10;1801;1811
25;Lleida;98;Residents Absents;25998;Residents Absents;1;1;U;;10239; ; ;2159;8080;7;8;2144;2152
43;Tarragona;98;Residents Absents;43998;Residents Absents;1;1;U;;8398; ; ;1883;6515;8;21;1854;1875
