﻿Codi Província;Nom Província;Codi Comarca;Nom Comarca;Codi Municipi;Nom Municipi;Districte;Secció;Mesa;Població;Cens;Participació 20:00;Abstenció;Vots nuls;Vots en blanc;Vots a candidatures;Vots vàlids
25;Lleida;25;Pallars Jussà;25001;Abella de la Conca;1;1;U;;144;78;66;0;1;77;78
8;Barcelona;11;Baix Llobregat;08001;Abrera;1;1;A;;380;235;145;0;6;229;235
8;Barcelona;11;Baix Llobregat;08001;Abrera;1;1;B;;397;252;145;1;1;250;251
8;Barcelona;11;Baix Llobregat;08001;Abrera;1;1;C;;430;289;141;2;2;285;287
8;Barcelona;11;Baix Llobregat;08001;Abrera;1;2;A;;503;325;178;0;2;323;325
8;Barcelona;11;Baix Llobregat;08001;Abrera;1;2;B;;489;310;179;1;4;305;309
8;Barcelona;11;Baix Llobregat;08001;Abrera;1;2;C;;627;395;232;2;5;388;393
8;Barcelona;11;Baix Llobregat;08001;Abrera;1;2;D;;495;282;213;0;1;281;282
8;Barcelona;11;Baix Llobregat;08001;Abrera;1;3;U;;456;291;165;1;5;285;290
8;Barcelona;11;Baix Llobregat;08001;Abrera;1;4;U;;708;419;289;1;8;410;418
8;Barcelona;11;Baix Llobregat;08001;Abrera;1;5;A;;701;384;317;0;1;383;384
8;Barcelona;11;Baix Llobregat;08001;Abrera;1;5;B;;741;432;309;1;1;430;431
8;Barcelona;11;Baix Llobregat;08001;Abrera;1;7;A;;745;353;392;2;3;348;351
8;Barcelona;11;Baix Llobregat;08001;Abrera;1;7;B;;468;242;226;0;4;238;242
25;Lleida;23;Noguera;25002;Àger;1;1;U;;467;335;132;2;6;327;333
25;Lleida;38;Urgell;25003;Agramunt;1;1;U;;731;500;231;2;0;498;498
25;Lleida;38;Urgell;25003;Agramunt;1;2;U;;827;591;236;4;3;584;587
25;Lleida;38;Urgell;25003;Agramunt;1;3;A;;564;390;174;0;7;383;390
25;Lleida;38;Urgell;25003;Agramunt;1;3;B;;667;451;216;2;4;445;449
25;Lleida;38;Urgell;25003;Agramunt;1;4;A;;516;324;192;0;1;323;324
25;Lleida;38;Urgell;25003;Agramunt;1;4;B;;580;381;199;0;3;378;381
8;Barcelona;7;Bages;08002;Aguilar de Segarra;1;1;U;;179;127;52;0;1;126;127
17;Girona;2;Alt Empordà;17001;Agullana;1;1;U;;577;453;124;2;0;451;451
8;Barcelona;41;Vallès Oriental;08014;Aiguafreda;1;1;A;;844;655;189;4;4;647;651
8;Barcelona;41;Vallès Oriental;08014;Aiguafreda;1;1;B;;991;747;244;3;8;736;744
43;Tarragona;1;Alt Camp;43001;Aiguamúrcia;1;1;A;;269;228;41;3;1;224;225
43;Tarragona;1;Alt Camp;43001;Aiguamúrcia;1;1;B;;308;213;95;0;5;208;213
17;Girona;20;Gironès;17002;Aiguaviva;1;1;U;;484;353;131;0;3;350;353
25;Lleida;33;Segrià;25038;Aitona;1;1;U;;826;612;214;4;3;605;608
25;Lleida;33;Segrià;25038;Aitona;1;2;U;;959;659;300;4;6;649;655
25;Lleida;33;Segrià;25004;Alamús, els;1;1;U;;589;467;122;2;1;464;465
25;Lleida;4;Alt Urgell;25005;Alàs i Cerc;1;1;U;;324;248;76;1;0;247;247
25;Lleida;18;Garrigues;25006;Albagés, l';1;1;U;;435;310;125;3;1;306;307
17;Girona;2;Alt Empordà;17003;Albanyà;1;1;U;;102;68;34;0;2;66;68
25;Lleida;33;Segrià;25007;Albatàrrec;1;1;A;;605;421;184;0;2;419;421
25;Lleida;33;Segrià;25007;Albatàrrec;1;1;B;;457;289;168;0;2;287;289
25;Lleida;23;Noguera;25008;Albesa;1;1;A;;659;484;175;0;7;477;484
25;Lleida;23;Noguera;25008;Albesa;1;1;B;;613;458;155;2;3;453;456
25;Lleida;18;Garrigues;25009;Albi, l';1;1;U;;685;522;163;5;5;512;517
43;Tarragona;12;Baix Penedès;43002;Albinyana;1;1;A;;411;348;63;5;3;340;343
43;Tarragona;12;Baix Penedès;43002;Albinyana;1;1;B;;1083;703;380;6;2;695;697
43;Tarragona;8;Baix Camp;43003;Albiol, l';1;1;U;;179;111;68;0;0;111;111
17;Girona;10;Baix Empordà;17004;Albons;1;1;U;;465;333;132;1;5;327;332
43;Tarragona;22;Montsià;43004;Alcanar;1;1;U;;870;550;320;5;6;539;545
43;Tarragona;22;Montsià;43004;Alcanar;1;2;A;;619;420;199;3;7;410;417
43;Tarragona;22;Montsià;43004;Alcanar;1;2;B;;662;454;208;1;1;452;453
43;Tarragona;22;Montsià;43004;Alcanar;1;3;A;;642;377;265;2;2;373;375
43;Tarragona;22;Montsià;43004;Alcanar;1;3;B;;547;312;235;1;4;307;311
43;Tarragona;22;Montsià;43004;Alcanar;1;4;U;;794;533;261;3;4;526;530
43;Tarragona;22;Montsià;43004;Alcanar;2;1;A;;560;327;233;0;2;325;327
43;Tarragona;22;Montsià;43004;Alcanar;2;1;B;;580;339;241;0;2;337;339
43;Tarragona;22;Montsià;43004;Alcanar;2;2;U;;657;409;248;0;3;406;409
43;Tarragona;22;Montsià;43004;Alcanar;2;3;U;;444;264;180;4;1;259;260
25;Lleida;33;Segrià;25010;Alcanó;1;1;U;;224;159;65;0;5;154;159
25;Lleida;33;Segrià;25011;Alcarràs;1;1;A;;908;580;328;1;1;578;579
25;Lleida;33;Segrià;25011;Alcarràs;1;1;B;;808;518;290;0;6;512;518
25;Lleida;33;Segrià;25011;Alcarràs;1;2;A;;828;503;325;0;2;501;503
25;Lleida;33;Segrià;25011;Alcarràs;1;2;B;;755;459;296;0;7;452;459
25;Lleida;33;Segrià;25011;Alcarràs;1;3;U;;707;419;288;0;0;419;419
25;Lleida;33;Segrià;25012;Alcoletge;1;1;A;;765;469;296;1;2;466;468
25;Lleida;33;Segrià;25012;Alcoletge;1;1;B;;762;486;276;0;7;479;486
43;Tarragona;1;Alt Camp;43005;Alcover;1;1;A;;851;533;318;2;3;528;531
43;Tarragona;1;Alt Camp;43005;Alcover;1;1;B;;937;571;366;3;5;563;568
43;Tarragona;1;Alt Camp;43005;Alcover;2;1;A;;714;424;290;0;11;413;424
43;Tarragona;1;Alt Camp;43005;Alcover;2;1;B;;716;416;300;0;1;415;416
43;Tarragona;9;Baix Ebre;43904;Aldea, l';1;1;A;;834;558;276;2;3;553;556
43;Tarragona;9;Baix Ebre;43904;Aldea, l';1;1;B;;762;472;290;1;7;464;471
43;Tarragona;9;Baix Ebre;43904;Aldea, l';1;2;A;;731;460;271;0;7;453;460
43;Tarragona;9;Baix Ebre;43904;Aldea, l';1;2;B;;528;350;178;4;3;343;346
43;Tarragona;9;Baix Ebre;43006;Aldover;1;1;U;;713;511;202;7;1;503;504
43;Tarragona;8;Baix Camp;43007;Aleixar, l';1;1;U;;602;408;194;3;6;399;405
8;Barcelona;21;Maresme;08003;Alella;1;1;A;;823;580;243;1;3;576;579
8;Barcelona;21;Maresme;08003;Alella;1;1;B;;891;618;273;4;5;609;614
8;Barcelona;21;Maresme;08003;Alella;1;2;A;;812;521;291;0;3;518;521
8;Barcelona;21;Maresme;08003;Alella;1;2;B;;990;639;351;1;8;630;638
8;Barcelona;21;Maresme;08003;Alella;1;3;A;;855;625;230;1;9;615;624
8;Barcelona;21;Maresme;08003;Alella;1;3;B;;913;683;230;2;6;675;681
8;Barcelona;21;Maresme;08003;Alella;1;4;A;;672;451;221;1;2;448;450
8;Barcelona;21;Maresme;08003;Alella;1;4;B;;776;510;266;0;5;505;510
43;Tarragona;9;Baix Ebre;43008;Alfara de Carles;1;1;U;;339;259;80;0;1;258;259
25;Lleida;33;Segrià;25013;Alfarràs;1;1;A;;652;433;219;0;2;431;433
25;Lleida;33;Segrià;25013;Alfarràs;1;1;B;;727;469;258;0;2;467;469
25;Lleida;33;Segrià;25013;Alfarràs;1;2;A;;475;291;184;0;2;289;291
25;Lleida;33;Segrià;25013;Alfarràs;1;2;B;;600;367;233;0;1;366;367
25;Lleida;33;Segrià;25014;Alfés;1;1;U;;281;197;84;2;4;191;195
43;Tarragona;8;Baix Camp;43009;Alforja;1;1;A;;509;368;141;3;6;359;365
43;Tarragona;8;Baix Camp;43009;Alforja;1;1;B;;648;451;197;5;4;442;446
25;Lleida;23;Noguera;25015;Algerri;1;1;U;;449;347;102;1;3;343;346
25;Lleida;33;Segrià;25016;Alguaire;1;1;A;;610;418;192;2;1;415;416
25;Lleida;33;Segrià;25016;Alguaire;1;1;B;;656;411;245;1;1;409;410
25;Lleida;33;Segrià;25016;Alguaire;1;2;A;;506;335;171;3;2;330;332
25;Lleida;33;Segrià;25016;Alguaire;1;2;B;;570;362;208;3;3;356;359
25;Lleida;26;Pallars Sobirà;25017;Alins;1;1;U;;242;180;62;1;3;176;179
43;Tarragona;1;Alt Camp;43010;Alió;1;1;U;;299;230;69;1;2;227;229
25;Lleida;33;Segrià;25019;Almacelles;1;1;U;;790;534;256;1;4;529;533
25;Lleida;33;Segrià;25019;Almacelles;1;2;A;;624;395;229;0;1;394;395
25;Lleida;33;Segrià;25019;Almacelles;1;2;B;;785;477;308;0;4;473;477
25;Lleida;33;Segrià;25019;Almacelles;2;1;A;;514;329;185;1;5;323;328
25;Lleida;33;Segrià;25019;Almacelles;2;1;B;;622;399;223;0;5;394;399
25;Lleida;33;Segrià;25019;Almacelles;2;2;A;;582;349;233;0;7;342;349
25;Lleida;33;Segrià;25019;Almacelles;2;2;B;;709;416;293;0;4;412;416
25;Lleida;33;Segrià;25020;Almatret;1;1;U;;420;321;99;0;1;320;321
25;Lleida;33;Segrià;25021;Almenar;1;1;U;;748;450;298;7;7;436;443
25;Lleida;33;Segrià;25021;Almenar;2;1;A;;501;343;158;1;1;341;342
25;Lleida;33;Segrià;25021;Almenar;2;1;B;;627;412;215;4;1;407;408
25;Lleida;33;Segrià;25021;Almenar;2;2;U;;954;638;316;1;10;627;637
43;Tarragona;8;Baix Camp;43011;Almoster;1;1;A;;364;257;107;0;4;253;257
43;Tarragona;8;Baix Camp;43011;Almoster;1;1;B;;409;307;102;2;4;301;305
25;Lleida;23;Noguera;25022;Alòs de Balaguer;1;1;U;;148;105;43;0;1;104;105
17;Girona;15;Cerdanya;17006;Alp;1;1;U;;1041;629;412;1;8;620;628
8;Barcelona;24;Osona;08004;Alpens;1;1;U;;226;188;38;1;3;184;187
25;Lleida;33;Segrià;25023;Alpicat;1;1;A;;607;401;206;0;4;397;401
25;Lleida;33;Segrià;25023;Alpicat;1;1;B;;563;353;210;0;3;350;353
25;Lleida;33;Segrià;25023;Alpicat;1;1;C;;640;426;214;3;4;419;423
25;Lleida;33;Segrià;25023;Alpicat;1;2;A;;605;402;203;2;5;395;400
25;Lleida;33;Segrià;25023;Alpicat;1;2;B;;609;412;197;2;4;406;410
25;Lleida;33;Segrià;25023;Alpicat;1;2;C;;646;427;219;1;11;415;426
43;Tarragona;36;Tarragonès;43012;Altafulla;1;1;A;;513;365;148;1;2;362;364
43;Tarragona;36;Tarragonès;43012;Altafulla;1;1;B;;401;269;132;0;2;267;269
43;Tarragona;36;Tarragonès;43012;Altafulla;1;1;C;;526;379;147;1;4;374;378
43;Tarragona;36;Tarragonès;43012;Altafulla;1;1;D;;476;343;133;2;4;337;341
43;Tarragona;36;Tarragonès;43012;Altafulla;1;2;A;;307;185;122;1;2;182;184
43;Tarragona;36;Tarragonès;43012;Altafulla;1;2;B;;446;267;179;3;2;262;264
25;Lleida;26;Pallars Sobirà;25024;Alt Àneu;1;1;U;;347;251;96;1;2;248;250
17;Girona;34;Selva;17007;Amer;1;1;A;;576;450;126;5;3;442;445
17;Girona;34;Selva;17007;Amer;1;1;B;;597;446;151;2;2;442;444
17;Girona;34;Selva;17007;Amer;1;1;C;;659;514;145;3;4;507;511
8;Barcelona;41;Vallès Oriental;08005;Ametlla del Vallès, l';1;1;A;;635;432;203;0;2;430;432
8;Barcelona;41;Vallès Oriental;08005;Ametlla del Vallès, l';1;1;B;;658;421;237;2;4;415;419
8;Barcelona;41;Vallès Oriental;08005;Ametlla del Vallès, l';1;1;C;;610;409;201;0;2;407;409
8;Barcelona;41;Vallès Oriental;08005;Ametlla del Vallès, l';1;2;A;;537;400;137;1;3;396;399
8;Barcelona;41;Vallès Oriental;08005;Ametlla del Vallès, l';1;2;B;;617;438;179;2;5;431;436
8;Barcelona;41;Vallès Oriental;08005;Ametlla del Vallès, l';1;3;A;;683;458;225;1;4;453;457
8;Barcelona;41;Vallès Oriental;08005;Ametlla del Vallès, l';1;3;B;;629;395;234;1;2;392;394
8;Barcelona;41;Vallès Oriental;08005;Ametlla del Vallès, l';1;3;C;;622;412;210;3;4;405;409
43;Tarragona;9;Baix Ebre;43013;Ametlla de Mar, l';1;1;A;;647;477;170;7;5;465;470
43;Tarragona;9;Baix Ebre;43013;Ametlla de Mar, l';1;1;B;;730;509;221;6;5;498;503
43;Tarragona;9;Baix Ebre;43013;Ametlla de Mar, l';1;2;A;;536;403;133;11;0;392;392
43;Tarragona;9;Baix Ebre;43013;Ametlla de Mar, l';1;2;B;;513;365;148;2;7;356;363
43;Tarragona;9;Baix Ebre;43013;Ametlla de Mar, l';1;3;A;;542;351;191;1;0;350;350
43;Tarragona;9;Baix Ebre;43013;Ametlla de Mar, l';1;3;B;;526;351;175;2;2;347;349
43;Tarragona;9;Baix Ebre;43013;Ametlla de Mar, l';1;3;C;;519;288;231;1;3;284;287
43;Tarragona;9;Baix Ebre;43906;Ampolla, l';1;1;A;;571;458;113;0;0;458;458
43;Tarragona;9;Baix Ebre;43906;Ampolla, l';1;1;B;;330;242;88;1;1;240;241
43;Tarragona;9;Baix Ebre;43906;Ampolla, l';1;1;C;;351;269;82;0;2;267;269
43;Tarragona;9;Baix Ebre;43906;Ampolla, l';1;1;D;;296;219;77;0;2;217;219
43;Tarragona;22;Montsià;43014;Amposta;1;1;A;;321;204;117;1;3;200;203
43;Tarragona;22;Montsià;43014;Amposta;1;1;B;;376;244;132;0;3;241;244
43;Tarragona;22;Montsià;43014;Amposta;1;2;A;;521;343;178;0;4;339;343
43;Tarragona;22;Montsià;43014;Amposta;1;2;B;;573;391;182;5;8;378;386
43;Tarragona;22;Montsià;43014;Amposta;2;1;U;;769;581;188;2;0;579;579
43;Tarragona;22;Montsià;43014;Amposta;2;2;A;;372;251;121;0;3;248;251
43;Tarragona;22;Montsià;43014;Amposta;2;2;B;;388;263;125;0;3;260;263
43;Tarragona;22;Montsià;43014;Amposta;3;1;A;;485;325;160;1;3;321;324
43;Tarragona;22;Montsià;43014;Amposta;3;1;B;;432;300;132;2;3;295;298
43;Tarragona;22;Montsià;43014;Amposta;3;2;A;;577;360;217;0;2;358;360
43;Tarragona;22;Montsià;43014;Amposta;3;2;B;;640;419;221;3;2;414;416
43;Tarragona;22;Montsià;43014;Amposta;4;1;A;;580;401;179;0;3;398;401
43;Tarragona;22;Montsià;43014;Amposta;4;1;B;;620;430;190;0;10;420;430
43;Tarragona;22;Montsià;43014;Amposta;4;2;A;;554;369;185;1;7;361;368
43;Tarragona;22;Montsià;43014;Amposta;4;2;B;;541;351;190;1;7;343;350
43;Tarragona;22;Montsià;43014;Amposta;4;3;A;;661;433;228;0;3;430;433
43;Tarragona;22;Montsià;43014;Amposta;4;3;B;;500;301;199;1;3;297;300
43;Tarragona;22;Montsià;43014;Amposta;4;3;C;;634;404;230;1;5;398;403
43;Tarragona;22;Montsià;43014;Amposta;4;4;A;;599;429;170;0;7;422;429
43;Tarragona;22;Montsià;43014;Amposta;4;4;B;;451;304;147;0;6;298;304
43;Tarragona;22;Montsià;43014;Amposta;4;4;C;;646;440;206;2;9;429;438
43;Tarragona;22;Montsià;43014;Amposta;4;5;A;;524;344;180;2;5;337;342
43;Tarragona;22;Montsià;43014;Amposta;4;5;B;;503;316;187;1;1;314;315
43;Tarragona;22;Montsià;43014;Amposta;4;5;C;;523;298;225;0;3;295;298
43;Tarragona;22;Montsià;43014;Amposta;4;6;A;;438;252;186;0;5;247;252
43;Tarragona;22;Montsià;43014;Amposta;4;6;B;;498;279;219;1;2;276;278
17;Girona;34;Selva;17008;Anglès;1;1;A;;530;357;173;1;3;353;356
17;Girona;34;Selva;17008;Anglès;1;1;B;;538;337;201;0;1;336;337
17;Girona;34;Selva;17008;Anglès;1;2;A;;777;520;257;4;6;510;516
17;Girona;34;Selva;17008;Anglès;1;2;B;;804;542;262;1;2;539;541
17;Girona;34;Selva;17008;Anglès;1;3;A;;616;404;212;0;1;403;404
17;Girona;34;Selva;17008;Anglès;1;3;B;;634;403;231;0;0;403;403
25;Lleida;38;Urgell;25027;Anglesola;1;1;A;;473;342;131;1;1;340;341
25;Lleida;38;Urgell;25027;Anglesola;1;1;B;;587;442;145;1;2;439;441
25;Lleida;18;Garrigues;25029;Arbeca;1;1;U;;885;653;232;7;5;641;646
25;Lleida;18;Garrigues;25029;Arbeca;1;2;U;;988;738;250;3;10;725;735
43;Tarragona;12;Baix Penedès;43016;Arboç, l';1;1;A;;576;409;167;2;2;405;407
43;Tarragona;12;Baix Penedès;43016;Arboç, l';1;1;B;;808;561;247;3;7;551;558
43;Tarragona;12;Baix Penedès;43016;Arboç, l';1;2;A;;779;528;251;1;3;524;527
43;Tarragona;12;Baix Penedès;43016;Arboç, l';1;2;B;;836;559;277;3;1;555;556
43;Tarragona;8;Baix Camp;43015;Arbolí;1;1;U;;111;72;39;0;1;71;72
17;Girona;34;Selva;17009;Arbúcies;1;1;A;;793;547;246;0;1;546;547
17;Girona;34;Selva;17009;Arbúcies;1;1;B;;833;571;262;4;2;565;567
17;Girona;34;Selva;17009;Arbúcies;1;2;A;;804;563;241;4;3;556;559
17;Girona;34;Selva;17009;Arbúcies;1;2;B;;758;556;202;4;3;549;552
17;Girona;34;Selva;17009;Arbúcies;2;1;U;;902;647;255;4;1;642;643
8;Barcelona;21;Maresme;08006;Arenys de Mar;1;1;A;;703;474;229;2;1;471;472
8;Barcelona;21;Maresme;08006;Arenys de Mar;1;1;B;;862;619;243;2;4;613;617
8;Barcelona;21;Maresme;08006;Arenys de Mar;1;2;A;;913;651;262;1;8;642;650
8;Barcelona;21;Maresme;08006;Arenys de Mar;1;2;B;;1036;725;311;2;9;714;723
8;Barcelona;21;Maresme;08006;Arenys de Mar;1;3;A;;470;312;158;2;1;309;310
8;Barcelona;21;Maresme;08006;Arenys de Mar;1;3;B;;555;405;150;3;2;400;402
8;Barcelona;21;Maresme;08006;Arenys de Mar;2;1;A;;567;378;189;1;1;376;377
8;Barcelona;21;Maresme;08006;Arenys de Mar;2;1;B;;657;423;234;4;4;415;419
8;Barcelona;21;Maresme;08006;Arenys de Mar;2;2;A;;681;487;194;4;2;481;483
8;Barcelona;21;Maresme;08006;Arenys de Mar;2;2;B;;745;510;235;3;4;503;507
8;Barcelona;21;Maresme;08006;Arenys de Mar;2;3;A;;519;336;183;0;3;333;336
8;Barcelona;21;Maresme;08006;Arenys de Mar;2;3;B;;691;460;231;1;1;458;459
8;Barcelona;21;Maresme;08006;Arenys de Mar;2;4;A;;967;609;358;4;10;595;605
8;Barcelona;21;Maresme;08006;Arenys de Mar;2;4;B;;1084;660;424;4;4;652;656
8;Barcelona;21;Maresme;08007;Arenys de Munt;1;1;U;;832;570;262;3;4;563;567
8;Barcelona;21;Maresme;08007;Arenys de Munt;1;2;A;;699;477;222;2;11;464;475
8;Barcelona;21;Maresme;08007;Arenys de Munt;1;2;B;;718;477;241;0;8;469;477
8;Barcelona;21;Maresme;08007;Arenys de Munt;1;2;C;;754;552;202;0;10;542;552
8;Barcelona;21;Maresme;08007;Arenys de Munt;2;1;A;;595;425;170;1;4;420;424
8;Barcelona;21;Maresme;08007;Arenys de Munt;2;1;B;;667;476;191;1;3;472;475
8;Barcelona;21;Maresme;08007;Arenys de Munt;2;2;A;;556;329;227;1;3;325;328
8;Barcelona;21;Maresme;08007;Arenys de Munt;2;2;B;;710;456;254;5;4;447;451
17;Girona;19;Garrotxa;17010;Argelaguer;1;1;U;;302;228;74;1;2;225;227
8;Barcelona;6;Anoia;08008;Argençola;1;1;U;;193;123;70;0;4;119;123
43;Tarragona;8;Baix Camp;43017;Argentera, l';1;1;U;;141;101;40;0;1;100;101
8;Barcelona;21;Maresme;08009;Argentona;1;1;A;;746;506;240;2;3;501;504
8;Barcelona;21;Maresme;08009;Argentona;1;1;B;;796;484;312;2;7;475;482
8;Barcelona;21;Maresme;08009;Argentona;1;1;C;;765;494;271;1;3;490;493
8;Barcelona;21;Maresme;08009;Argentona;1;2;A;;819;582;237;0;5;577;582
8;Barcelona;21;Maresme;08009;Argentona;1;2;B;;776;559;217;7;7;545;552
8;Barcelona;21;Maresme;08009;Argentona;1;2;C;;728;520;208;2;3;515;518
8;Barcelona;21;Maresme;08009;Argentona;1;3;A;;428;260;168;2;4;254;258
8;Barcelona;21;Maresme;08009;Argentona;1;3;B;;553;349;204;0;4;345;349
8;Barcelona;21;Maresme;08009;Argentona;2;1;A;;780;506;274;0;1;505;506
8;Barcelona;21;Maresme;08009;Argentona;2;1;B;;850;538;312;1;2;535;537
8;Barcelona;21;Maresme;08009;Argentona;2;2;A;;462;323;139;3;2;318;320
8;Barcelona;21;Maresme;08009;Argentona;2;2;B;;529;376;153;0;4;372;376
17;Girona;2;Alt Empordà;17011;Armentera, l';1;1;U;;621;481;140;0;9;472;481
43;Tarragona;37;Terra Alta;43018;Arnes;1;1;U;;454;390;64;0;4;386;390
25;Lleida;39;Consell General d'Aran;25031;Arres;1;1;U;;61;33;28;1;2;30;32
25;Lleida;4;Alt Urgell;25032;Arsèguel;1;1;U;;84;53;31;0;0;53;53
8;Barcelona;7;Bages;08010;Artés;1;1;A;;454;310;144;2;2;306;308
8;Barcelona;7;Bages;08010;Artés;1;1;B;;560;352;208;2;4;346;350
8;Barcelona;7;Bages;08010;Artés;2;1;A;;728;539;189;0;6;533;539
8;Barcelona;7;Bages;08010;Artés;2;1;B;;602;413;189;3;3;407;410
8;Barcelona;7;Bages;08010;Artés;2;1;C;;901;641;260;1;3;637;640
8;Barcelona;7;Bages;08010;Artés;2;2;U;;573;400;173;1;6;393;399
25;Lleida;33;Segrià;25033;Artesa de Lleida;1;1;A;;585;421;164;1;5;415;420
25;Lleida;33;Segrià;25033;Artesa de Lleida;1;1;B;;510;336;174;0;3;333;336
25;Lleida;23;Noguera;25034;Artesa de Segre;1;1;A;;627;474;153;8;3;463;466
25;Lleida;23;Noguera;25034;Artesa de Segre;1;1;B;;746;546;200;4;5;537;542
25;Lleida;23;Noguera;25034;Artesa de Segre;1;2;U;;776;554;222;2;9;543;552
25;Lleida;23;Noguera;25034;Artesa de Segre;2;1;U;;499;340;159;3;2;335;337
43;Tarragona;30;Ribera d'Ebre;43019;Ascó;1;1;A;;639;446;193;1;3;442;445
43;Tarragona;30;Ribera d'Ebre;43019;Ascó;1;1;B;;754;518;236;3;2;513;515
25;Lleida;33;Segrià;25036;Aspa;1;1;U;;242;179;63;3;7;169;176
25;Lleida;23;Noguera;25037;Avellanes i Santa Linya, les;1;1;U;;440;306;134;0;2;304;306
8;Barcelona;14;Berguedà;08011;Avià;1;1;A;;787;556;231;0;6;550;556
8;Barcelona;14;Berguedà;08011;Avià;1;1;B;;832;599;233;2;4;593;597
8;Barcelona;7;Bages;08012;Avinyó;1;1;A;;839;680;159;1;7;672;679
8;Barcelona;7;Bages;08012;Avinyó;1;1;B;;825;663;162;2;2;659;661
8;Barcelona;3;Alt Penedès;08013;Avinyonet del Penedès;1;1;A;;518;348;170;0;0;348;348
8;Barcelona;3;Alt Penedès;08013;Avinyonet del Penedès;1;1;B;;574;407;167;0;3;404;407
17;Girona;2;Alt Empordà;17012;Avinyonet de Puigventós;1;1;U;;788;461;327;2;5;454;459
8;Barcelona;13;Barcelonès;08015;Badalona;1;1;A;;515;375;140;0;3;372;375
8;Barcelona;13;Barcelonès;08015;Badalona;1;1;B;;576;425;151;1;6;418;424
8;Barcelona;13;Barcelonès;08015;Badalona;1;2;A;;455;302;153;0;4;298;302
8;Barcelona;13;Barcelonès;08015;Badalona;1;2;B;;557;398;159;3;0;395;395
8;Barcelona;13;Barcelonès;08015;Badalona;1;3;U;;800;585;215;3;8;574;582
8;Barcelona;13;Barcelonès;08015;Badalona;1;4;U;;684;504;180;1;3;500;503
8;Barcelona;13;Barcelonès;08015;Badalona;1;5;A;;592;458;134;0;7;451;458
8;Barcelona;13;Barcelonès;08015;Badalona;1;5;B;;649;491;158;2;3;486;489
8;Barcelona;13;Barcelonès;08015;Badalona;1;7;A;;493;358;135;1;1;356;357
8;Barcelona;13;Barcelonès;08015;Badalona;1;7;B;;565;428;137;0;6;422;428
8;Barcelona;13;Barcelonès;08015;Badalona;1;8;U;;556;417;139;1;4;412;416
8;Barcelona;13;Barcelonès;08015;Badalona;2;1;A;;514;312;202;1;1;310;311
8;Barcelona;13;Barcelonès;08015;Badalona;2;1;B;;600;381;219;1;2;378;380
8;Barcelona;13;Barcelonès;08015;Badalona;2;10;A;;569;329;240;1;3;325;328
8;Barcelona;13;Barcelonès;08015;Badalona;2;10;B;;671;344;327;0;3;341;344
8;Barcelona;13;Barcelonès;08015;Badalona;2;11;A;;633;333;300;0;3;330;333
8;Barcelona;13;Barcelonès;08015;Badalona;2;11;B;;778;435;343;0;0;435;435
8;Barcelona;13;Barcelonès;08015;Badalona;2;12;U;;910;462;448;0;3;459;462
8;Barcelona;13;Barcelonès;08015;Badalona;2;13;A;;438;204;234;0;0;204;204
8;Barcelona;13;Barcelonès;08015;Badalona;2;13;B;;586;280;306;0;0;280;280
8;Barcelona;13;Barcelonès;08015;Badalona;2;14;U;;459;275;184;0;1;274;275
8;Barcelona;13;Barcelonès;08015;Badalona;2;15;A;;437;230;207;0;2;228;230
8;Barcelona;13;Barcelonès;08015;Badalona;2;15;B;;527;257;270;0;5;252;257
8;Barcelona;13;Barcelonès;08015;Badalona;2;2;A;;685;511;174;1;6;504;510
8;Barcelona;13;Barcelonès;08015;Badalona;2;2;B;;721;534;187;3;4;527;531
8;Barcelona;13;Barcelonès;08015;Badalona;2;3;U;;693;517;176;0;5;512;517
8;Barcelona;13;Barcelonès;08015;Badalona;2;4;A;;763;569;194;1;1;567;568
8;Barcelona;13;Barcelonès;08015;Badalona;2;4;B;;809;607;202;0;3;604;607
8;Barcelona;13;Barcelonès;08015;Badalona;2;5;U;;479;274;205;1;5;268;273
8;Barcelona;13;Barcelonès;08015;Badalona;2;6;U;;544;285;259;0;1;284;285
8;Barcelona;13;Barcelonès;08015;Badalona;2;7;U;;608;277;331;0;4;273;277
8;Barcelona;13;Barcelonès;08015;Badalona;2;8;A;;612;442;170;0;5;437;442
8;Barcelona;13;Barcelonès;08015;Badalona;2;8;B;;543;373;170;0;5;368;373
8;Barcelona;13;Barcelonès;08015;Badalona;2;8;C;;624;436;188;0;7;429;436
8;Barcelona;13;Barcelonès;08015;Badalona;2;9;A;;424;216;208;1;3;212;215
8;Barcelona;13;Barcelonès;08015;Badalona;2;9;B;;507;242;265;0;3;239;242
8;Barcelona;13;Barcelonès;08015;Badalona;3;1;U;;690;337;353;0;0;337;337
8;Barcelona;13;Barcelonès;08015;Badalona;3;10;A;;437;280;157;0;1;279;280
8;Barcelona;13;Barcelonès;08015;Badalona;3;10;B;;481;310;171;0;0;310;310
8;Barcelona;13;Barcelonès;08015;Badalona;3;11;U;;955;586;369;0;8;578;586
8;Barcelona;13;Barcelonès;08015;Badalona;3;12;A;;485;333;152;0;4;329;333
8;Barcelona;13;Barcelonès;08015;Badalona;3;12;B;;534;373;161;0;1;372;373
8;Barcelona;13;Barcelonès;08015;Badalona;3;2;A;;587;388;199;0;5;383;388
8;Barcelona;13;Barcelonès;08015;Badalona;3;2;B;;686;438;248;2;4;432;436
8;Barcelona;13;Barcelonès;08015;Badalona;3;3;A;;582;362;220;1;3;358;361
8;Barcelona;13;Barcelonès;08015;Badalona;3;3;B;;706;422;284;1;6;415;421
8;Barcelona;13;Barcelonès;08015;Badalona;3;4;A;;456;319;137;0;3;316;319
8;Barcelona;13;Barcelonès;08015;Badalona;3;4;B;;583;412;171;2;5;405;410
8;Barcelona;13;Barcelonès;08015;Badalona;3;5;A;;537;291;246;0;2;289;291
8;Barcelona;13;Barcelonès;08015;Badalona;3;5;B;;599;345;254;1;2;342;344
8;Barcelona;13;Barcelonès;08015;Badalona;3;6;U;;853;632;221;0;6;626;632
8;Barcelona;13;Barcelonès;08015;Badalona;3;7;U;;868;623;245;0;5;618;623
8;Barcelona;13;Barcelonès;08015;Badalona;3;8;U;;577;380;197;0;1;379;380
8;Barcelona;13;Barcelonès;08015;Badalona;3;9;U;;454;312;142;0;1;311;312
8;Barcelona;13;Barcelonès;08015;Badalona;4;1;A;;682;355;327;1;0;354;354
8;Barcelona;13;Barcelonès;08015;Badalona;4;1;B;;839;439;400;0;3;436;439
8;Barcelona;13;Barcelonès;08015;Badalona;4;1;C;;849;423;426;1;4;418;422
8;Barcelona;13;Barcelonès;08015;Badalona;4;10;A;;460;233;227;0;3;230;233
8;Barcelona;13;Barcelonès;08015;Badalona;4;10;B;;505;254;251;1;3;250;253
8;Barcelona;13;Barcelonès;08015;Badalona;4;11;A;;510;270;240;0;4;266;270
8;Barcelona;13;Barcelonès;08015;Badalona;4;11;B;;623;325;298;2;5;318;323
8;Barcelona;13;Barcelonès;08015;Badalona;4;12;A;;420;244;176;1;0;243;243
8;Barcelona;13;Barcelonès;08015;Badalona;4;12;B;;491;256;235;0;2;254;256
8;Barcelona;13;Barcelonès;08015;Badalona;4;13;U;;936;569;367;1;8;560;568
8;Barcelona;13;Barcelonès;08015;Badalona;4;14;A;;679;433;246;4;4;425;429
8;Barcelona;13;Barcelonès;08015;Badalona;4;14;B;;679;425;254;0;6;419;425
8;Barcelona;13;Barcelonès;08015;Badalona;4;14;C;;932;581;351;1;8;572;580
8;Barcelona;13;Barcelonès;08015;Badalona;4;14;D;;747;464;283;1;3;460;463
8;Barcelona;13;Barcelonès;08015;Badalona;4;2;A;;550;337;213;2;2;333;335
8;Barcelona;13;Barcelonès;08015;Badalona;4;2;B;;710;450;260;0;5;445;450
8;Barcelona;13;Barcelonès;08015;Badalona;4;3;A;;521;328;193;0;3;325;328
8;Barcelona;13;Barcelonès;08015;Badalona;4;3;B;;523;321;202;0;0;321;321
8;Barcelona;13;Barcelonès;08015;Badalona;4;4;A;;537;335;202;0;4;331;335
8;Barcelona;13;Barcelonès;08015;Badalona;4;4;B;;635;399;236;0;5;394;399
8;Barcelona;13;Barcelonès;08015;Badalona;4;4;C;;594;347;247;0;2;345;347
8;Barcelona;13;Barcelonès;08015;Badalona;4;5;U;;994;597;397;0;2;595;597
8;Barcelona;13;Barcelonès;08015;Badalona;4;6;A;;685;327;358;0;2;325;327
8;Barcelona;13;Barcelonès;08015;Badalona;4;6;B;;849;442;407;0;2;440;442
8;Barcelona;13;Barcelonès;08015;Badalona;4;7;A;;691;432;259;3;4;425;429
8;Barcelona;13;Barcelonès;08015;Badalona;4;7;B;;799;512;287;0;2;510;512
8;Barcelona;13;Barcelonès;08015;Badalona;4;8;A;;564;315;249;0;4;311;315
8;Barcelona;13;Barcelonès;08015;Badalona;4;8;B;;694;387;307;0;5;382;387
8;Barcelona;13;Barcelonès;08015;Badalona;4;9;U;;738;456;282;1;8;447;455
8;Barcelona;13;Barcelonès;08015;Badalona;5;1;A;;710;527;183;1;2;524;526
8;Barcelona;13;Barcelonès;08015;Badalona;5;1;B;;862;625;237;0;5;620;625
8;Barcelona;13;Barcelonès;08015;Badalona;5;2;U;;798;600;198;0;7;593;600
8;Barcelona;13;Barcelonès;08015;Badalona;5;3;A;;793;523;270;0;6;517;523
8;Barcelona;13;Barcelonès;08015;Badalona;5;3;B;;824;556;268;1;4;551;555
8;Barcelona;13;Barcelonès;08015;Badalona;5;4;A;;834;511;323;1;8;502;510
8;Barcelona;13;Barcelonès;08015;Badalona;5;4;B;;887;558;329;2;2;554;556
8;Barcelona;13;Barcelonès;08015;Badalona;5;5;A;;513;330;183;0;1;329;330
8;Barcelona;13;Barcelonès;08015;Badalona;5;5;B;;589;348;241;1;3;344;347
8;Barcelona;13;Barcelonès;08015;Badalona;5;5;C;;542;356;186;0;3;353;356
8;Barcelona;13;Barcelonès;08015;Badalona;5;6;U;;975;740;235;1;9;730;739
8;Barcelona;13;Barcelonès;08015;Badalona;6;1;A;;496;274;222;3;2;269;271
8;Barcelona;13;Barcelonès;08015;Badalona;6;1;B;;506;271;235;1;1;269;270
8;Barcelona;13;Barcelonès;08015;Badalona;6;2;A;;408;263;145;0;6;257;263
8;Barcelona;13;Barcelonès;08015;Badalona;6;2;B;;605;354;251;0;2;352;354
8;Barcelona;13;Barcelonès;08015;Badalona;6;2;C;;352;189;163;0;0;189;189
8;Barcelona;13;Barcelonès;08015;Badalona;6;3;A;;493;225;268;1;3;221;224
8;Barcelona;13;Barcelonès;08015;Badalona;6;3;B;;562;295;267;0;1;294;295
8;Barcelona;13;Barcelonès;08015;Badalona;6;4;A;;509;218;291;2;1;215;216
8;Barcelona;13;Barcelonès;08015;Badalona;6;4;B;;650;324;326;0;5;319;324
8;Barcelona;13;Barcelonès;08015;Badalona;6;5;A;;557;277;280;1;3;273;276
8;Barcelona;13;Barcelonès;08015;Badalona;6;5;B;;725;352;373;0;2;350;352
8;Barcelona;13;Barcelonès;08015;Badalona;6;6;A;;439;180;259;0;1;179;180
8;Barcelona;13;Barcelonès;08015;Badalona;6;6;B;;554;259;295;0;1;258;259
8;Barcelona;13;Barcelonès;08015;Badalona;7;1;A;;586;288;298;1;4;283;287
8;Barcelona;13;Barcelonès;08015;Badalona;7;1;B;;748;396;352;2;2;392;394
8;Barcelona;13;Barcelonès;08015;Badalona;7;10;U;;670;360;310;0;1;359;360
8;Barcelona;13;Barcelonès;08015;Badalona;7;11;A;;561;284;277;0;0;284;284
8;Barcelona;13;Barcelonès;08015;Badalona;7;11;B;;638;332;306;1;10;321;331
8;Barcelona;13;Barcelonès;08015;Badalona;7;12;A;;539;270;269;0;7;263;270
8;Barcelona;13;Barcelonès;08015;Badalona;7;12;B;;666;340;326;1;1;338;339
8;Barcelona;13;Barcelonès;08015;Badalona;7;13;U;;917;342;575;0;4;338;342
8;Barcelona;13;Barcelonès;08015;Badalona;7;14;A;;644;276;368;3;1;272;273
8;Barcelona;13;Barcelonès;08015;Badalona;7;14;B;;789;356;433;3;4;349;353
8;Barcelona;13;Barcelonès;08015;Badalona;7;15;U;;777;298;479;1;6;291;297
8;Barcelona;13;Barcelonès;08015;Badalona;7;17;U;;582;279;303;2;1;276;277
8;Barcelona;13;Barcelonès;08015;Badalona;7;18;A;;598;351;247;1;4;346;350
8;Barcelona;13;Barcelonès;08015;Badalona;7;18;B;;670;377;293;0;3;374;377
8;Barcelona;13;Barcelonès;08015;Badalona;7;19;U;;466;233;233;0;0;233;233
8;Barcelona;13;Barcelonès;08015;Badalona;7;2;A;;612;344;268;0;3;341;344
8;Barcelona;13;Barcelonès;08015;Badalona;7;2;B;;637;352;285;1;2;349;351
8;Barcelona;13;Barcelonès;08015;Badalona;7;2;C;;591;333;258;2;5;326;331
8;Barcelona;13;Barcelonès;08015;Badalona;7;20;A;;462;265;197;1;3;261;264
8;Barcelona;13;Barcelonès;08015;Badalona;7;20;B;;544;297;247;0;0;297;297
8;Barcelona;13;Barcelonès;08015;Badalona;7;21;U;;846;389;457;0;0;389;389
8;Barcelona;13;Barcelonès;08015;Badalona;7;22;U;;652;423;229;2;10;411;421
8;Barcelona;13;Barcelonès;08015;Badalona;7;23;A;;717;477;240;0;2;475;477
8;Barcelona;13;Barcelonès;08015;Badalona;7;23;B;;893;603;290;1;4;598;602
8;Barcelona;13;Barcelonès;08015;Badalona;7;24;A;;560;340;220;0;6;334;340
8;Barcelona;13;Barcelonès;08015;Badalona;7;24;B;;743;436;307;1;2;433;435
8;Barcelona;13;Barcelonès;08015;Badalona;7;25;U;;579;201;378;0;5;196;201
8;Barcelona;13;Barcelonès;08015;Badalona;7;26;U;;563;269;294;0;1;268;269
8;Barcelona;13;Barcelonès;08015;Badalona;7;27;A;;564;250;314;0;1;249;250
8;Barcelona;13;Barcelonès;08015;Badalona;7;27;B;;597;264;333;1;5;258;263
8;Barcelona;13;Barcelonès;08015;Badalona;7;28;A;;710;302;408;0;2;300;302
8;Barcelona;13;Barcelonès;08015;Badalona;7;28;B;;884;453;431;1;8;444;452
8;Barcelona;13;Barcelonès;08015;Badalona;7;29;A;;493;287;206;0;1;286;287
8;Barcelona;13;Barcelonès;08015;Badalona;7;29;B;;674;426;248;0;2;424;426
8;Barcelona;13;Barcelonès;08015;Badalona;7;29;C;;640;366;274;0;4;362;366
8;Barcelona;13;Barcelonès;08015;Badalona;7;3;A;;553;307;246;2;3;302;305
8;Barcelona;13;Barcelonès;08015;Badalona;7;3;B;;672;353;319;0;11;342;353
8;Barcelona;13;Barcelonès;08015;Badalona;7;30;A;;714;401;313;1;9;391;400
8;Barcelona;13;Barcelonès;08015;Badalona;7;30;B;;859;513;346;3;5;505;510
8;Barcelona;13;Barcelonès;08015;Badalona;7;31;A;;506;259;247;0;8;251;259
8;Barcelona;13;Barcelonès;08015;Badalona;7;31;B;;686;344;342;1;5;338;343
8;Barcelona;13;Barcelonès;08015;Badalona;7;4;U;;855;519;336;0;6;513;519
8;Barcelona;13;Barcelonès;08015;Badalona;7;5;U;;692;340;352;0;1;339;340
8;Barcelona;13;Barcelonès;08015;Badalona;7;6;U;;821;477;344;2;8;467;475
8;Barcelona;13;Barcelonès;08015;Badalona;7;7;U;;771;295;476;0;3;292;295
8;Barcelona;13;Barcelonès;08015;Badalona;7;8;A;;493;218;275;1;0;217;217
8;Barcelona;13;Barcelonès;08015;Badalona;7;8;B;;584;273;311;1;3;269;272
8;Barcelona;13;Barcelonès;08015;Badalona;7;9;U;;529;268;261;1;2;265;267
8;Barcelona;13;Barcelonès;08015;Badalona;8;1;U;;640;236;404;0;0;236;236
8;Barcelona;13;Barcelonès;08015;Badalona;8;10;A;;626;270;356;0;9;261;270
8;Barcelona;13;Barcelonès;08015;Badalona;8;10;B;;679;324;355;1;1;322;323
8;Barcelona;13;Barcelonès;08015;Badalona;8;11;U;;747;358;389;0;6;352;358
8;Barcelona;13;Barcelonès;08015;Badalona;8;12;A;;562;366;196;1;3;362;365
8;Barcelona;13;Barcelonès;08015;Badalona;8;12;B;;657;367;290;0;4;363;367
8;Barcelona;13;Barcelonès;08015;Badalona;8;12;C;;636;383;253;2;8;373;381
8;Barcelona;13;Barcelonès;08015;Badalona;8;13;U;;695;354;341;0;5;349;354
8;Barcelona;13;Barcelonès;08015;Badalona;8;2;A;;516;278;238;0;4;274;278
8;Barcelona;13;Barcelonès;08015;Badalona;8;2;B;;724;379;345;0;4;375;379
8;Barcelona;13;Barcelonès;08015;Badalona;8;2;C;;626;343;283;0;0;343;343
8;Barcelona;13;Barcelonès;08015;Badalona;8;3;A;;505;269;236;2;3;264;267
8;Barcelona;13;Barcelonès;08015;Badalona;8;3;B;;601;318;283;1;1;316;317
8;Barcelona;13;Barcelonès;08015;Badalona;8;3;C;;600;266;334;0;0;266;266
8;Barcelona;13;Barcelonès;08015;Badalona;8;4;U;;695;311;384;1;3;307;310
8;Barcelona;13;Barcelonès;08015;Badalona;8;5;U;;824;401;423;1;4;396;400
8;Barcelona;13;Barcelonès;08015;Badalona;8;6;A;;686;382;304;0;2;380;382
8;Barcelona;13;Barcelonès;08015;Badalona;8;6;B;;830;465;365;0;3;462;465
8;Barcelona;13;Barcelonès;08015;Badalona;8;7;A;;460;228;232;0;1;227;228
8;Barcelona;13;Barcelonès;08015;Badalona;8;7;B;;504;236;268;0;0;236;236
8;Barcelona;13;Barcelonès;08015;Badalona;8;8;A;;500;247;253;0;2;245;247
8;Barcelona;13;Barcelonès;08015;Badalona;8;8;B;;652;283;369;1;1;281;282
8;Barcelona;13;Barcelonès;08015;Badalona;8;8;C;;597;277;320;0;3;274;277
8;Barcelona;13;Barcelonès;08015;Badalona;8;9;A;;523;248;275;0;3;245;248
8;Barcelona;13;Barcelonès;08015;Badalona;8;9;B;;618;298;320;1;2;295;297
8;Barcelona;13;Barcelonès;08015;Badalona;9;1;U;;478;273;205;0;1;272;273
8;Barcelona;13;Barcelonès;08015;Badalona;9;10;A;;572;291;281;4;1;286;287
8;Barcelona;13;Barcelonès;08015;Badalona;9;10;B;;733;382;351;0;3;379;382
8;Barcelona;13;Barcelonès;08015;Badalona;9;11;U;;814;481;333;1;3;477;480
8;Barcelona;13;Barcelonès;08015;Badalona;9;12;U;;577;350;227;0;5;345;350
8;Barcelona;13;Barcelonès;08015;Badalona;9;13;U;;671;368;303;0;2;366;368
8;Barcelona;13;Barcelonès;08015;Badalona;9;14;A;;633;359;274;2;5;352;357
8;Barcelona;13;Barcelonès;08015;Badalona;9;14;B;;754;426;328;0;7;419;426
8;Barcelona;13;Barcelonès;08015;Badalona;9;15;U;;670;315;355;0;0;315;315
8;Barcelona;13;Barcelonès;08015;Badalona;9;16;A;;709;329;380;0;6;323;329
8;Barcelona;13;Barcelonès;08015;Badalona;9;16;B;;726;380;346;2;6;372;378
8;Barcelona;13;Barcelonès;08015;Badalona;9;17;U;;539;185;354;3;0;182;182
8;Barcelona;13;Barcelonès;08015;Badalona;9;18;U;;520;239;281;0;2;237;239
8;Barcelona;13;Barcelonès;08015;Badalona;9;19;A;;432;205;227;1;2;202;204
8;Barcelona;13;Barcelonès;08015;Badalona;9;19;B;;495;249;246;0;7;242;249
8;Barcelona;13;Barcelonès;08015;Badalona;9;2;A;;660;240;420;0;3;237;240
8;Barcelona;13;Barcelonès;08015;Badalona;9;2;B;;603;240;363;0;1;239;240
8;Barcelona;13;Barcelonès;08015;Badalona;9;20;U;;634;342;292;0;2;340;342
8;Barcelona;13;Barcelonès;08015;Badalona;9;21;A;;561;297;264;5;0;292;292
8;Barcelona;13;Barcelonès;08015;Badalona;9;21;B;;617;326;291;0;5;321;326
8;Barcelona;13;Barcelonès;08015;Badalona;9;22;A;;497;314;183;0;4;310;314
8;Barcelona;13;Barcelonès;08015;Badalona;9;22;B;;627;347;280;0;1;346;347
8;Barcelona;13;Barcelonès;08015;Badalona;9;23;U;;589;329;260;0;4;325;329
8;Barcelona;13;Barcelonès;08015;Badalona;9;24;A;;545;295;250;0;0;295;295
8;Barcelona;13;Barcelonès;08015;Badalona;9;24;B;;593;332;261;0;2;330;332
8;Barcelona;13;Barcelonès;08015;Badalona;9;24;C;;605;348;257;0;5;343;348
8;Barcelona;13;Barcelonès;08015;Badalona;9;25;A;;433;238;195;0;7;231;238
8;Barcelona;13;Barcelonès;08015;Badalona;9;25;B;;492;245;247;0;5;240;245
8;Barcelona;13;Barcelonès;08015;Badalona;9;26;A;;506;274;232;0;0;274;274
8;Barcelona;13;Barcelonès;08015;Badalona;9;26;B;;601;331;270;1;2;328;330
8;Barcelona;13;Barcelonès;08015;Badalona;9;27;U;;692;366;326;0;6;360;366
8;Barcelona;13;Barcelonès;08015;Badalona;9;28;A;;519;173;346;0;6;167;173
8;Barcelona;13;Barcelonès;08015;Badalona;9;28;B;;575;203;372;0;2;201;203
8;Barcelona;13;Barcelonès;08015;Badalona;9;28;C;;550;196;354;1;1;194;195
8;Barcelona;13;Barcelonès;08015;Badalona;9;29;U;;812;409;403;1;6;402;408
8;Barcelona;13;Barcelonès;08015;Badalona;9;3;U;;682;337;345;2;1;334;335
8;Barcelona;13;Barcelonès;08015;Badalona;9;30;U;;884;376;508;1;2;373;375
8;Barcelona;13;Barcelonès;08015;Badalona;9;31;A;;453;244;209;1;5;238;243
8;Barcelona;13;Barcelonès;08015;Badalona;9;31;B;;522;295;227;0;3;292;295
8;Barcelona;13;Barcelonès;08015;Badalona;9;32;U;;778;361;417;2;1;358;359
8;Barcelona;13;Barcelonès;08015;Badalona;9;33;A;;609;335;274;2;3;330;333
8;Barcelona;13;Barcelonès;08015;Badalona;9;33;B;;810;443;367;0;4;439;443
8;Barcelona;13;Barcelonès;08015;Badalona;9;34;A;;790;442;348;0;3;439;442
8;Barcelona;13;Barcelonès;08015;Badalona;9;34;B;;836;515;321;1;9;505;514
8;Barcelona;13;Barcelonès;08015;Badalona;9;35;A;;550;298;252;1;2;295;297
8;Barcelona;13;Barcelonès;08015;Badalona;9;35;B;;666;352;314;1;6;345;351
8;Barcelona;13;Barcelonès;08015;Badalona;9;36;A;;539;246;293;0;1;245;246
8;Barcelona;13;Barcelonès;08015;Badalona;9;36;B;;573;281;292;0;0;281;281
8;Barcelona;13;Barcelonès;08015;Badalona;9;37;U;;853;300;553;0;8;292;300
8;Barcelona;13;Barcelonès;08015;Badalona;9;38;A;;474;216;258;1;4;211;215
8;Barcelona;13;Barcelonès;08015;Badalona;9;38;B;;501;267;234;2;3;262;265
8;Barcelona;13;Barcelonès;08015;Badalona;9;4;A;;668;242;426;1;0;241;241
8;Barcelona;13;Barcelonès;08015;Badalona;9;4;B;;616;232;384;1;3;228;231
8;Barcelona;13;Barcelonès;08015;Badalona;9;42;A;;430;160;270;2;0;158;158
8;Barcelona;13;Barcelonès;08015;Badalona;9;42;B;;451;181;270;0;1;180;181
8;Barcelona;13;Barcelonès;08015;Badalona;9;43;A;;684;375;309;0;4;371;375
8;Barcelona;13;Barcelonès;08015;Badalona;9;43;B;;828;422;406;1;5;416;421
8;Barcelona;13;Barcelonès;08015;Badalona;9;44;U;;780;362;418;0;6;356;362
8;Barcelona;13;Barcelonès;08015;Badalona;9;45;A;;634;322;312;1;2;319;321
8;Barcelona;13;Barcelonès;08015;Badalona;9;45;B;;808;399;409;1;4;394;398
8;Barcelona;13;Barcelonès;08015;Badalona;9;46;U;;670;309;361;0;2;307;309
8;Barcelona;13;Barcelonès;08015;Badalona;9;47;U;;860;389;471;0;2;387;389
8;Barcelona;13;Barcelonès;08015;Badalona;9;48;U;;920;442;478;0;4;438;442
8;Barcelona;13;Barcelonès;08015;Badalona;9;49;A;;584;319;265;0;0;319;319
8;Barcelona;13;Barcelonès;08015;Badalona;9;49;B;;613;341;272;0;3;338;341
8;Barcelona;13;Barcelonès;08015;Badalona;9;5;A;;423;181;242;0;1;180;181
8;Barcelona;13;Barcelonès;08015;Badalona;9;5;B;;557;253;304;0;4;249;253
8;Barcelona;13;Barcelonès;08015;Badalona;9;50;U;;727;366;361;1;2;363;365
8;Barcelona;13;Barcelonès;08015;Badalona;9;52;U;;777;431;346;1;3;427;430
8;Barcelona;13;Barcelonès;08015;Badalona;9;53;U;;909;450;459;2;4;444;448
8;Barcelona;13;Barcelonès;08015;Badalona;9;54;A;;473;226;247;0;2;224;226
8;Barcelona;13;Barcelonès;08015;Badalona;9;54;B;;611;321;290;0;3;318;321
8;Barcelona;13;Barcelonès;08015;Badalona;9;55;U;;772;445;327;0;3;442;445
8;Barcelona;13;Barcelonès;08015;Badalona;9;56;U;;537;218;319;0;3;215;218
8;Barcelona;13;Barcelonès;08015;Badalona;9;57;U;;970;498;472;2;4;492;496
8;Barcelona;13;Barcelonès;08015;Badalona;9;58;A;;567;295;272;0;0;295;295
8;Barcelona;13;Barcelonès;08015;Badalona;9;58;B;;691;383;308;1;5;377;382
8;Barcelona;13;Barcelonès;08015;Badalona;9;59;A;;470;267;203;1;1;265;266
8;Barcelona;13;Barcelonès;08015;Badalona;9;59;B;;504;304;200;0;2;302;304
8;Barcelona;13;Barcelonès;08015;Badalona;9;6;A;;602;257;345;0;0;257;257
8;Barcelona;13;Barcelonès;08015;Badalona;9;6;B;;599;284;315;0;3;281;284
8;Barcelona;13;Barcelonès;08015;Badalona;9;8;A;;641;272;369;0;0;272;272
8;Barcelona;13;Barcelonès;08015;Badalona;9;8;B;;729;309;420;0;1;308;309
8;Barcelona;13;Barcelonès;08015;Badalona;9;9;A;;432;273;159;0;1;272;273
8;Barcelona;13;Barcelonès;08015;Badalona;9;9;B;;557;358;199;1;6;351;357
8;Barcelona;40;Vallès Occidental;08904;Badia del Vallès;1;1;A;;437;219;218;2;4;213;217
8;Barcelona;40;Vallès Occidental;08904;Badia del Vallès;1;1;B;;525;289;236;0;0;289;289
8;Barcelona;40;Vallès Occidental;08904;Badia del Vallès;1;10;A;;480;248;232;0;0;248;248
8;Barcelona;40;Vallès Occidental;08904;Badia del Vallès;1;10;B;;430;230;200;0;1;229;230
8;Barcelona;40;Vallès Occidental;08904;Badia del Vallès;1;11;A;;474;289;185;0;1;288;289
8;Barcelona;40;Vallès Occidental;08904;Badia del Vallès;1;11;B;;545;281;264;1;3;277;280
8;Barcelona;40;Vallès Occidental;08904;Badia del Vallès;1;12;A;;491;269;222;4;4;261;265
8;Barcelona;40;Vallès Occidental;08904;Badia del Vallès;1;12;B;;481;253;228;2;5;246;251
8;Barcelona;40;Vallès Occidental;08904;Badia del Vallès;1;2;U;;810;376;434;0;5;371;376
8;Barcelona;40;Vallès Occidental;08904;Badia del Vallès;1;3;A;;536;253;283;0;1;252;253
8;Barcelona;40;Vallès Occidental;08904;Badia del Vallès;1;3;B;;554;267;287;0;8;259;267
8;Barcelona;40;Vallès Occidental;08904;Badia del Vallès;1;4;A;;446;185;261;3;0;182;182
8;Barcelona;40;Vallès Occidental;08904;Badia del Vallès;1;4;B;;567;247;320;0;3;244;247
8;Barcelona;40;Vallès Occidental;08904;Badia del Vallès;1;5;A;;503;192;311;0;1;191;192
8;Barcelona;40;Vallès Occidental;08904;Badia del Vallès;1;5;B;;519;228;291;0;5;223;228
8;Barcelona;40;Vallès Occidental;08904;Badia del Vallès;1;6;A;;628;294;334;0;3;291;294
8;Barcelona;40;Vallès Occidental;08904;Badia del Vallès;1;6;B;;643;306;337;1;3;302;305
8;Barcelona;40;Vallès Occidental;08904;Badia del Vallès;1;7;A;;518;261;257;0;3;258;261
8;Barcelona;40;Vallès Occidental;08904;Badia del Vallès;1;7;B;;432;207;225;0;2;205;207
8;Barcelona;40;Vallès Occidental;08904;Badia del Vallès;1;8;A;;533;244;289;0;6;238;244
8;Barcelona;40;Vallès Occidental;08904;Badia del Vallès;1;8;B;;429;190;239;0;1;189;190
8;Barcelona;40;Vallès Occidental;08904;Badia del Vallès;1;9;A;;543;231;312;0;2;229;231
8;Barcelona;40;Vallès Occidental;08904;Badia del Vallès;1;9;B;;452;217;235;4;3;210;213
8;Barcelona;14;Berguedà;08016;Bagà;1;1;A;;829;584;245;0;2;582;584
8;Barcelona;14;Berguedà;08016;Bagà;1;1;B;;949;694;255;0;3;691;694
25;Lleida;26;Pallars Sobirà;25039;Baix Pallars;1;1;U;;320;224;96;0;1;223;224
25;Lleida;23;Noguera;25040;Balaguer;1;1;A;;408;274;134;1;1;272;273
25;Lleida;23;Noguera;25040;Balaguer;1;1;B;;440;308;132;3;0;305;305
25;Lleida;23;Noguera;25040;Balaguer;1;2;U;;882;611;271;0;2;609;611
25;Lleida;23;Noguera;25040;Balaguer;2;1;A;;385;177;208;0;1;176;177
25;Lleida;23;Noguera;25040;Balaguer;2;1;B;;300;179;121;0;0;179;179
25;Lleida;23;Noguera;25040;Balaguer;2;1;C;;348;162;186;4;3;155;158
25;Lleida;23;Noguera;25040;Balaguer;3;1;A;;888;592;296;2;6;584;590
25;Lleida;23;Noguera;25040;Balaguer;3;1;B;;919;616;303;2;4;610;614
25;Lleida;23;Noguera;25040;Balaguer;3;2;U;;812;537;275;2;3;532;535
25;Lleida;23;Noguera;25040;Balaguer;4;1;A;;684;514;170;1;3;510;513
25;Lleida;23;Noguera;25040;Balaguer;4;1;B;;748;560;188;2;4;554;558
25;Lleida;23;Noguera;25040;Balaguer;4;2;A;;706;455;251;0;3;452;455
25;Lleida;23;Noguera;25040;Balaguer;4;2;B;;863;575;288;4;6;565;571
25;Lleida;23;Noguera;25040;Balaguer;4;3;A;;473;349;124;1;3;345;348
25;Lleida;23;Noguera;25040;Balaguer;4;3;B;;597;425;172;2;9;414;423
25;Lleida;23;Noguera;25040;Balaguer;4;4;A;;577;412;165;1;2;409;411
25;Lleida;23;Noguera;25040;Balaguer;4;4;B;;725;549;176;4;5;540;545
8;Barcelona;24;Osona;08017;Balenyà;1;1;A;;637;448;189;3;5;440;445
8;Barcelona;24;Osona;08017;Balenyà;1;1;B;;532;372;160;1;8;363;371
8;Barcelona;24;Osona;08017;Balenyà;1;1;C;;699;493;206;3;4;486;490
8;Barcelona;24;Osona;08017;Balenyà;1;2;U;;711;494;217;3;2;489;491
8;Barcelona;7;Bages;08018;Balsareny;1;1;A;;706;469;237;1;6;462;468
8;Barcelona;7;Bages;08018;Balsareny;1;1;B;;650;452;198;0;1;451;452
8;Barcelona;7;Bages;08018;Balsareny;1;2;A;;493;313;180;3;0;310;310
8;Barcelona;7;Bages;08018;Balsareny;1;2;B;;510;336;174;0;0;336;336
8;Barcelona;7;Bages;08018;Balsareny;1;3;U;;368;267;101;0;4;263;267
43;Tarragona;12;Baix Penedès;43020;Banyeres del Penedès;1;1;A;;722;489;233;3;3;483;486
43;Tarragona;12;Baix Penedès;43020;Banyeres del Penedès;1;1;B;;803;553;250;4;5;544;549
17;Girona;28;Pla de l'Estany;17015;Banyoles;1;1;A;;610;408;202;3;4;401;405
17;Girona;28;Pla de l'Estany;17015;Banyoles;1;1;B;;644;468;176;2;6;460;466
17;Girona;28;Pla de l'Estany;17015;Banyoles;1;2;U;;661;491;170;3;1;487;488
17;Girona;28;Pla de l'Estany;17015;Banyoles;1;3;A;;871;596;275;3;4;589;593
17;Girona;28;Pla de l'Estany;17015;Banyoles;1;3;B;;904;595;309;3;0;592;592
17;Girona;28;Pla de l'Estany;17015;Banyoles;1;4;A;;580;412;168;6;2;404;406
17;Girona;28;Pla de l'Estany;17015;Banyoles;1;4;B;;698;487;211;6;2;479;481
17;Girona;28;Pla de l'Estany;17015;Banyoles;2;1;A;;620;439;181;5;7;427;434
17;Girona;28;Pla de l'Estany;17015;Banyoles;2;1;B;;699;505;194;2;7;496;503
17;Girona;28;Pla de l'Estany;17015;Banyoles;2;2;U;;800;600;200;5;2;593;595
17;Girona;28;Pla de l'Estany;17015;Banyoles;2;3;A;;616;438;178;2;6;430;436
17;Girona;28;Pla de l'Estany;17015;Banyoles;2;3;B;;664;489;175;5;8;476;484
17;Girona;28;Pla de l'Estany;17015;Banyoles;2;4;U;;531;373;158;1;6;366;372
17;Girona;28;Pla de l'Estany;17015;Banyoles;2;5;U;;749;524;225;4;5;515;520
17;Girona;28;Pla de l'Estany;17015;Banyoles;3;1;A;;587;430;157;3;2;425;427
17;Girona;28;Pla de l'Estany;17015;Banyoles;3;1;B;;625;458;167;4;4;450;454
17;Girona;28;Pla de l'Estany;17015;Banyoles;3;2;U;;752;450;302;2;5;443;448
25;Lleida;27;Pla d'Urgell;25041;Barbens;1;1;U;;671;477;194;8;17;452;469
43;Tarragona;16;Conca de Barberà;43021;Barberà de la Conca;1;1;U;;363;237;126;0;5;232;237
8;Barcelona;40;Vallès Occidental;08252;Barberà del Vallès;1;1;A;;861;517;344;3;10;504;514
8;Barcelona;40;Vallès Occidental;08252;Barberà del Vallès;1;1;B;;822;483;339;0;4;479;483
8;Barcelona;40;Vallès Occidental;08252;Barberà del Vallès;1;10;A;;592;332;260;0;1;331;332
8;Barcelona;40;Vallès Occidental;08252;Barberà del Vallès;1;10;B;;673;389;284;0;7;382;389
8;Barcelona;40;Vallès Occidental;08252;Barberà del Vallès;1;11;A;;732;404;328;2;2;400;402
8;Barcelona;40;Vallès Occidental;08252;Barberà del Vallès;1;11;B;;634;342;292;0;5;337;342
8;Barcelona;40;Vallès Occidental;08252;Barberà del Vallès;1;18;U;;880;419;461;1;5;413;418
8;Barcelona;40;Vallès Occidental;08252;Barberà del Vallès;1;19;A;;617;308;309;0;0;308;308
8;Barcelona;40;Vallès Occidental;08252;Barberà del Vallès;1;19;B;;516;265;251;0;3;262;265
8;Barcelona;40;Vallès Occidental;08252;Barberà del Vallès;1;2;U;;831;445;386;0;5;440;445
8;Barcelona;40;Vallès Occidental;08252;Barberà del Vallès;1;20;U;;876;457;419;2;2;453;455
8;Barcelona;40;Vallès Occidental;08252;Barberà del Vallès;1;21;A;;542;301;241;0;5;296;301
8;Barcelona;40;Vallès Occidental;08252;Barberà del Vallès;1;21;B;;520;281;239;1;1;279;280
8;Barcelona;40;Vallès Occidental;08252;Barberà del Vallès;1;22;A;;909;560;349;0;4;556;560
8;Barcelona;40;Vallès Occidental;08252;Barberà del Vallès;1;22;B;;841;523;318;0;7;516;523
8;Barcelona;40;Vallès Occidental;08252;Barberà del Vallès;1;23;U;;658;430;228;0;9;421;430
8;Barcelona;40;Vallès Occidental;08252;Barberà del Vallès;1;24;U;;793;438;355;0;9;429;438
8;Barcelona;40;Vallès Occidental;08252;Barberà del Vallès;1;25;U;;872;498;374;0;9;489;498
8;Barcelona;40;Vallès Occidental;08252;Barberà del Vallès;1;26;A;;770;448;322;0;1;447;448
8;Barcelona;40;Vallès Occidental;08252;Barberà del Vallès;1;26;B;;674;410;264;0;2;408;410
8;Barcelona;40;Vallès Occidental;08252;Barberà del Vallès;1;3;A;;678;345;333;0;1;344;345
8;Barcelona;40;Vallès Occidental;08252;Barberà del Vallès;1;3;B;;560;307;253;0;4;303;307
8;Barcelona;40;Vallès Occidental;08252;Barberà del Vallès;1;4;A;;591;316;275;0;5;311;316
8;Barcelona;40;Vallès Occidental;08252;Barberà del Vallès;1;4;B;;583;335;248;1;1;333;334
8;Barcelona;40;Vallès Occidental;08252;Barberà del Vallès;1;5;A;;605;310;295;0;2;308;310
8;Barcelona;40;Vallès Occidental;08252;Barberà del Vallès;1;5;B;;550;296;254;1;1;294;295
8;Barcelona;40;Vallès Occidental;08252;Barberà del Vallès;1;6;U;;915;514;401;3;5;506;511
8;Barcelona;40;Vallès Occidental;08252;Barberà del Vallès;1;7;U;;777;487;290;1;6;480;486
8;Barcelona;40;Vallès Occidental;08252;Barberà del Vallès;1;8;A;;576;292;284;1;4;287;291
8;Barcelona;40;Vallès Occidental;08252;Barberà del Vallès;1;8;B;;526;290;236;0;5;285;290
8;Barcelona;40;Vallès Occidental;08252;Barberà del Vallès;1;9;U;;720;396;324;1;2;393;395
8;Barcelona;13;Barcelonès;08019;Barcelona;1;1;U;;435;236;199;2;3;231;234
8;Barcelona;13;Barcelonès;08019;Barcelona;1;100;U;;946;483;463;3;0;480;480
8;Barcelona;13;Barcelonès;08019;Barcelona;1;103;U;;740;418;322;2;1;415;416
8;Barcelona;13;Barcelonès;08019;Barcelona;1;104;U;;634;285;349;0;3;282;285
8;Barcelona;13;Barcelonès;08019;Barcelona;1;105;U;;749;278;471;3;3;272;275
8;Barcelona;13;Barcelonès;08019;Barcelona;1;109;U;;1051;499;552;0;3;496;499
8;Barcelona;13;Barcelonès;08019;Barcelona;1;11;U;;1227;695;532;2;4;689;693
8;Barcelona;13;Barcelonès;08019;Barcelona;1;112;U;;816;445;371;2;5;438;443
8;Barcelona;13;Barcelonès;08019;Barcelona;1;114;U;;508;237;271;3;3;231;234
8;Barcelona;13;Barcelonès;08019;Barcelona;1;115;U;;1052;497;555;2;4;491;495
8;Barcelona;13;Barcelonès;08019;Barcelona;1;116;U;;670;312;358;4;1;307;308
8;Barcelona;13;Barcelonès;08019;Barcelona;1;118;U;;664;324;340;0;1;323;324
8;Barcelona;13;Barcelonès;08019;Barcelona;1;120;U;;819;407;412;1;1;405;406
8;Barcelona;13;Barcelonès;08019;Barcelona;1;122;U;;520;234;286;1;2;231;233
8;Barcelona;13;Barcelonès;08019;Barcelona;1;123;U;;635;413;222;2;2;409;411
8;Barcelona;13;Barcelonès;08019;Barcelona;1;124;U;;699;331;368;0;6;325;331
8;Barcelona;13;Barcelonès;08019;Barcelona;1;126;U;;635;388;247;1;5;382;387
8;Barcelona;13;Barcelonès;08019;Barcelona;1;127;U;;640;364;276;2;2;360;362
8;Barcelona;13;Barcelonès;08019;Barcelona;1;129;U;;501;316;185;0;6;310;316
8;Barcelona;13;Barcelonès;08019;Barcelona;1;13;U;;832;486;346;1;4;481;485
8;Barcelona;13;Barcelonès;08019;Barcelona;1;130;U;;705;356;349;1;3;352;355
8;Barcelona;13;Barcelonès;08019;Barcelona;1;132;U;;552;345;207;0;0;345;345
8;Barcelona;13;Barcelonès;08019;Barcelona;1;134;U;;646;342;304;0;2;340;342
8;Barcelona;13;Barcelonès;08019;Barcelona;1;137;U;;435;209;226;1;5;203;208
8;Barcelona;13;Barcelonès;08019;Barcelona;1;138;U;;440;211;229;1;2;208;210
8;Barcelona;13;Barcelonès;08019;Barcelona;1;139;U;;534;289;245;0;4;285;289
8;Barcelona;13;Barcelonès;08019;Barcelona;1;14;U;;1095;589;506;3;2;584;586
8;Barcelona;13;Barcelonès;08019;Barcelona;1;140;U;;487;240;247;1;4;235;239
8;Barcelona;13;Barcelonès;08019;Barcelona;1;141;U;;514;277;237;1;0;276;276
8;Barcelona;13;Barcelonès;08019;Barcelona;1;142;U;;586;308;278;0;1;307;308
8;Barcelona;13;Barcelonès;08019;Barcelona;1;144;U;;615;354;261;1;1;352;353
8;Barcelona;13;Barcelonès;08019;Barcelona;1;146;U;;714;428;286;2;4;422;426
8;Barcelona;13;Barcelonès;08019;Barcelona;1;148;U;;683;444;239;2;2;440;442
8;Barcelona;13;Barcelonès;08019;Barcelona;1;150;U;;512;322;190;1;1;320;321
8;Barcelona;13;Barcelonès;08019;Barcelona;1;151;U;;580;340;240;0;5;335;340
8;Barcelona;13;Barcelonès;08019;Barcelona;1;18;U;;557;281;276;1;1;279;280
8;Barcelona;13;Barcelonès;08019;Barcelona;1;19;U;;670;371;299;0;1;370;371
8;Barcelona;13;Barcelonès;08019;Barcelona;1;2;U;;468;254;214;5;0;249;249
8;Barcelona;13;Barcelonès;08019;Barcelona;1;20;U;;679;349;330;0;1;348;349
8;Barcelona;13;Barcelonès;08019;Barcelona;1;22;U;;451;222;229;0;0;222;222
8;Barcelona;13;Barcelonès;08019;Barcelona;1;23;A;;716;383;333;0;4;379;383
8;Barcelona;13;Barcelonès;08019;Barcelona;1;23;B;;687;387;300;0;1;386;387
8;Barcelona;13;Barcelonès;08019;Barcelona;1;25;U;;643;397;246;1;4;392;396
8;Barcelona;13;Barcelonès;08019;Barcelona;1;27;U;;771;484;287;6;4;474;478
8;Barcelona;13;Barcelonès;08019;Barcelona;1;29;U;;898;540;358;3;8;529;537
8;Barcelona;13;Barcelonès;08019;Barcelona;1;3;U;;607;319;288;0;5;314;319
8;Barcelona;13;Barcelonès;08019;Barcelona;1;31;U;;560;307;253;4;9;294;303
8;Barcelona;13;Barcelonès;08019;Barcelona;1;32;U;;416;240;176;0;1;239;240
8;Barcelona;13;Barcelonès;08019;Barcelona;1;33;U;;536;297;239;0;4;293;297
8;Barcelona;13;Barcelonès;08019;Barcelona;1;34;U;;703;429;274;0;2;427;429
8;Barcelona;13;Barcelonès;08019;Barcelona;1;36;U;;677;433;244;0;1;432;433
8;Barcelona;13;Barcelonès;08019;Barcelona;1;38;U;;524;300;224;0;3;297;300
8;Barcelona;13;Barcelonès;08019;Barcelona;1;39;U;;707;479;228;0;2;477;479
8;Barcelona;13;Barcelonès;08019;Barcelona;1;40;U;;901;470;431;3;2;465;467
8;Barcelona;13;Barcelonès;08019;Barcelona;1;43;U;;501;229;272;2;2;225;227
8;Barcelona;13;Barcelonès;08019;Barcelona;1;45;U;;1121;643;478;0;4;639;643
8;Barcelona;13;Barcelonès;08019;Barcelona;1;46;U;;850;445;405;1;3;441;444
8;Barcelona;13;Barcelonès;08019;Barcelona;1;48;U;;496;264;232;0;1;263;264
8;Barcelona;13;Barcelonès;08019;Barcelona;1;5;U;;451;214;237;1;0;213;213
8;Barcelona;13;Barcelonès;08019;Barcelona;1;50;U;;812;478;334;0;2;476;478
8;Barcelona;13;Barcelonès;08019;Barcelona;1;52;U;;545;347;198;0;3;344;347
8;Barcelona;13;Barcelonès;08019;Barcelona;1;53;U;;620;341;279;0;2;339;341
8;Barcelona;13;Barcelonès;08019;Barcelona;1;54;U;;452;231;221;3;2;226;228
8;Barcelona;13;Barcelonès;08019;Barcelona;1;55;U;;407;238;169;0;0;238;238
8;Barcelona;13;Barcelonès;08019;Barcelona;1;56;U;;848;551;297;0;4;547;551
8;Barcelona;13;Barcelonès;08019;Barcelona;1;58;U;;600;389;211;0;0;389;389
8;Barcelona;13;Barcelonès;08019;Barcelona;1;59;U;;548;323;225;0;2;321;323
8;Barcelona;13;Barcelonès;08019;Barcelona;1;6;U;;588;275;313;1;3;271;274
8;Barcelona;13;Barcelonès;08019;Barcelona;1;61;U;;705;430;275;2;3;425;428
8;Barcelona;13;Barcelonès;08019;Barcelona;1;63;U;;913;617;296;0;2;615;617
8;Barcelona;13;Barcelonès;08019;Barcelona;1;66;U;;688;421;267;1;1;419;420
8;Barcelona;13;Barcelonès;08019;Barcelona;1;68;A;;682;192;490;0;2;190;192
8;Barcelona;13;Barcelonès;08019;Barcelona;1;68;B;;643;193;450;0;1;192;193
8;Barcelona;13;Barcelonès;08019;Barcelona;1;69;U;;600;366;234;4;5;357;362
8;Barcelona;13;Barcelonès;08019;Barcelona;1;7;U;;560;320;240;1;0;319;319
8;Barcelona;13;Barcelonès;08019;Barcelona;1;71;U;;620;339;281;0;3;336;339
8;Barcelona;13;Barcelonès;08019;Barcelona;1;73;A;;686;375;311;0;2;373;375
8;Barcelona;13;Barcelonès;08019;Barcelona;1;73;B;;650;362;288;0;2;360;362
8;Barcelona;13;Barcelonès;08019;Barcelona;1;77;U;;738;464;274;0;7;457;464
8;Barcelona;13;Barcelonès;08019;Barcelona;1;79;U;;568;302;266;0;3;299;302
8;Barcelona;13;Barcelonès;08019;Barcelona;1;8;U;;598;329;269;2;2;325;327
8;Barcelona;13;Barcelonès;08019;Barcelona;1;82;U;;698;405;293;0;5;400;405
8;Barcelona;13;Barcelonès;08019;Barcelona;1;83;U;;804;443;361;5;1;437;438
8;Barcelona;13;Barcelonès;08019;Barcelona;1;86;U;;476;236;240;3;1;232;233
8;Barcelona;13;Barcelonès;08019;Barcelona;1;87;U;;750;353;397;0;3;350;353
8;Barcelona;13;Barcelonès;08019;Barcelona;1;88;U;;538;331;207;0;0;331;331
8;Barcelona;13;Barcelonès;08019;Barcelona;1;89;U;;835;440;395;1;3;436;439
8;Barcelona;13;Barcelonès;08019;Barcelona;1;9;U;;846;480;366;4;3;473;476
8;Barcelona;13;Barcelonès;08019;Barcelona;1;91;U;;713;337;376;0;2;335;337
8;Barcelona;13;Barcelonès;08019;Barcelona;1;94;U;;830;476;354;0;3;473;476
8;Barcelona;13;Barcelonès;08019;Barcelona;1;95;U;;888;450;438;1;3;446;449
8;Barcelona;13;Barcelonès;08019;Barcelona;1;97;U;;541;243;298;1;5;237;242
8;Barcelona;13;Barcelonès;08019;Barcelona;1;99;U;;541;255;286;1;3;251;254
8;Barcelona;13;Barcelonès;08019;Barcelona;10;1;U;;1092;733;359;0;10;723;733
8;Barcelona;13;Barcelonès;08019;Barcelona;10;10;A;;703;505;198;12;6;487;493
8;Barcelona;13;Barcelonès;08019;Barcelona;10;10;B;;583;431;152;0;3;428;431
8;Barcelona;13;Barcelonès;08019;Barcelona;10;100;U;;509;322;187;0;4;318;322
8;Barcelona;13;Barcelonès;08019;Barcelona;10;101;A;;850;535;315;5;3;527;530
8;Barcelona;13;Barcelonès;08019;Barcelona;10;101;B;;939;589;350;3;5;581;586
8;Barcelona;13;Barcelonès;08019;Barcelona;10;101;C;;870;540;330;0;8;532;540
8;Barcelona;13;Barcelonès;08019;Barcelona;10;102;A;;748;535;213;2;6;527;533
8;Barcelona;13;Barcelonès;08019;Barcelona;10;102;B;;586;413;173;0;8;405;413
8;Barcelona;13;Barcelonès;08019;Barcelona;10;103;A;;808;534;274;0;10;524;534
8;Barcelona;13;Barcelonès;08019;Barcelona;10;103;B;;724;483;241;6;1;476;477
8;Barcelona;13;Barcelonès;08019;Barcelona;10;104;U;;778;517;261;1;7;509;516
8;Barcelona;13;Barcelonès;08019;Barcelona;10;105;U;;1073;780;293;0;0;780;780
8;Barcelona;13;Barcelonès;08019;Barcelona;10;106;U;;1158;779;379;1;12;766;778
8;Barcelona;13;Barcelonès;08019;Barcelona;10;107;U;;620;394;226;3;0;391;391
8;Barcelona;13;Barcelonès;08019;Barcelona;10;108;U;;630;433;197;0;7;426;433
8;Barcelona;13;Barcelonès;08019;Barcelona;10;109;U;;757;507;250;3;2;502;504
8;Barcelona;13;Barcelonès;08019;Barcelona;10;11;U;;1164;839;325;1;7;831;838
8;Barcelona;13;Barcelonès;08019;Barcelona;10;110;U;;589;396;193;0;2;394;396
8;Barcelona;13;Barcelonès;08019;Barcelona;10;111;U;;872;576;296;0;6;570;576
8;Barcelona;13;Barcelonès;08019;Barcelona;10;113;A;;701;466;235;0;2;464;466
8;Barcelona;13;Barcelonès;08019;Barcelona;10;113;B;;618;412;206;1;4;407;411
8;Barcelona;13;Barcelonès;08019;Barcelona;10;115;U;;818;551;267;0;7;544;551
8;Barcelona;13;Barcelonès;08019;Barcelona;10;116;U;;1009;714;295;1;8;705;713
8;Barcelona;13;Barcelonès;08019;Barcelona;10;117;U;;567;388;179;1;7;380;387
8;Barcelona;13;Barcelonès;08019;Barcelona;10;118;U;;933;635;298;1;4;630;634
8;Barcelona;13;Barcelonès;08019;Barcelona;10;120;U;;616;408;208;2;1;405;406
8;Barcelona;13;Barcelonès;08019;Barcelona;10;121;U;;904;673;231;2;7;664;671
8;Barcelona;13;Barcelonès;08019;Barcelona;10;122;U;;1047;748;299;2;4;742;746
8;Barcelona;13;Barcelonès;08019;Barcelona;10;123;U;;1018;698;320;0;7;691;698
8;Barcelona;13;Barcelonès;08019;Barcelona;10;125;U;;541;395;146;0;2;393;395
8;Barcelona;13;Barcelonès;08019;Barcelona;10;126;U;;478;318;160;0;3;315;318
8;Barcelona;13;Barcelonès;08019;Barcelona;10;127;U;;1046;706;340;0;1;705;706
8;Barcelona;13;Barcelonès;08019;Barcelona;10;129;U;;512;350;162;0;2;348;350
8;Barcelona;13;Barcelonès;08019;Barcelona;10;130;U;;898;652;246;0;7;645;652
8;Barcelona;13;Barcelonès;08019;Barcelona;10;132;U;;474;338;136;0;3;335;338
8;Barcelona;13;Barcelonès;08019;Barcelona;10;133;U;;1221;936;285;0;7;929;936
8;Barcelona;13;Barcelonès;08019;Barcelona;10;134;U;;722;491;231;2;9;480;489
8;Barcelona;13;Barcelonès;08019;Barcelona;10;135;U;;934;622;312;2;10;610;620
8;Barcelona;13;Barcelonès;08019;Barcelona;10;137;U;;525;364;161;3;8;353;361
8;Barcelona;13;Barcelonès;08019;Barcelona;10;138;U;;909;661;248;1;3;657;660
8;Barcelona;13;Barcelonès;08019;Barcelona;10;139;U;;772;549;223;3;6;540;546
8;Barcelona;13;Barcelonès;08019;Barcelona;10;14;U;;823;544;279;1;10;533;543
8;Barcelona;13;Barcelonès;08019;Barcelona;10;140;U;;1137;793;344;0;8;785;793
8;Barcelona;13;Barcelonès;08019;Barcelona;10;142;U;;785;533;252;0;4;529;533
8;Barcelona;13;Barcelonès;08019;Barcelona;10;143;U;;438;268;170;0;2;266;268
8;Barcelona;13;Barcelonès;08019;Barcelona;10;144;U;;731;491;240;1;7;483;490
8;Barcelona;13;Barcelonès;08019;Barcelona;10;145;U;;825;510;315;0;0;510;510
8;Barcelona;13;Barcelonès;08019;Barcelona;10;146;U;;679;467;212;1;6;460;466
8;Barcelona;13;Barcelonès;08019;Barcelona;10;147;U;;678;501;177;1;1;499;500
8;Barcelona;13;Barcelonès;08019;Barcelona;10;149;U;;729;498;231;0;3;495;498
8;Barcelona;13;Barcelonès;08019;Barcelona;10;150;U;;990;693;297;0;3;690;693
8;Barcelona;13;Barcelonès;08019;Barcelona;10;151;U;;663;461;202;0;4;457;461
8;Barcelona;13;Barcelonès;08019;Barcelona;10;152;U;;1191;809;382;1;9;799;808
8;Barcelona;13;Barcelonès;08019;Barcelona;10;154;U;;1013;748;265;0;4;744;748
8;Barcelona;13;Barcelonès;08019;Barcelona;10;155;A;;679;460;219;1;6;453;459
8;Barcelona;13;Barcelonès;08019;Barcelona;10;155;B;;602;407;195;0;8;399;407
8;Barcelona;13;Barcelonès;08019;Barcelona;10;156;A;;711;474;237;2;9;463;472
8;Barcelona;13;Barcelonès;08019;Barcelona;10;156;B;;636;456;180;1;3;452;455
8;Barcelona;13;Barcelonès;08019;Barcelona;10;158;U;;555;363;192;1;2;360;362
8;Barcelona;13;Barcelonès;08019;Barcelona;10;160;U;;1048;724;324;0;6;718;724
8;Barcelona;13;Barcelonès;08019;Barcelona;10;161;U;;1180;718;462;1;6;711;717
8;Barcelona;13;Barcelonès;08019;Barcelona;10;163;A;;852;555;297;0;5;550;555
8;Barcelona;13;Barcelonès;08019;Barcelona;10;163;B;;776;514;262;0;5;509;514
8;Barcelona;13;Barcelonès;08019;Barcelona;10;164;A;;701;467;234;1;2;464;466
8;Barcelona;13;Barcelonès;08019;Barcelona;10;164;B;;616;412;204;0;3;409;412
8;Barcelona;13;Barcelonès;08019;Barcelona;10;165;U;;891;581;310;2;5;574;579
8;Barcelona;13;Barcelonès;08019;Barcelona;10;166;U;;855;564;291;2;4;558;562
8;Barcelona;13;Barcelonès;08019;Barcelona;10;168;U;;711;418;293;3;3;412;415
8;Barcelona;13;Barcelonès;08019;Barcelona;10;170;U;;816;521;295;2;2;517;519
8;Barcelona;13;Barcelonès;08019;Barcelona;10;172;U;;713;496;217;2;0;494;494
8;Barcelona;13;Barcelonès;08019;Barcelona;10;173;A;;752;543;209;0;5;538;543
8;Barcelona;13;Barcelonès;08019;Barcelona;10;173;B;;698;515;183;0;2;513;515
8;Barcelona;13;Barcelonès;08019;Barcelona;10;174;A;;669;441;228;7;1;433;434
8;Barcelona;13;Barcelonès;08019;Barcelona;10;174;B;;618;407;211;2;6;399;405
8;Barcelona;13;Barcelonès;08019;Barcelona;10;175;U;;926;664;262;6;5;653;658
8;Barcelona;13;Barcelonès;08019;Barcelona;10;176;A;;705;398;307;0;7;391;398
8;Barcelona;13;Barcelonès;08019;Barcelona;10;176;B;;657;358;299;0;4;354;358
8;Barcelona;13;Barcelonès;08019;Barcelona;10;177;U;;537;388;149;1;2;385;387
8;Barcelona;13;Barcelonès;08019;Barcelona;10;178;U;;813;543;270;1;6;536;542
8;Barcelona;13;Barcelonès;08019;Barcelona;10;18;U;;829;435;394;2;1;432;433
8;Barcelona;13;Barcelonès;08019;Barcelona;10;180;U;;992;671;321;7;12;652;664
8;Barcelona;13;Barcelonès;08019;Barcelona;10;182;U;;459;311;148;5;1;305;306
8;Barcelona;13;Barcelonès;08019;Barcelona;10;183;A;;906;599;307;1;5;593;598
8;Barcelona;13;Barcelonès;08019;Barcelona;10;183;B;;865;556;309;0;9;547;556
8;Barcelona;13;Barcelonès;08019;Barcelona;10;184;U;;1126;770;356;0;9;761;770
8;Barcelona;13;Barcelonès;08019;Barcelona;10;185;U;;919;655;264;1;12;642;654
8;Barcelona;13;Barcelonès;08019;Barcelona;10;186;U;;452;344;108;0;0;344;344
8;Barcelona;13;Barcelonès;08019;Barcelona;10;187;U;;732;507;225;0;7;500;507
8;Barcelona;13;Barcelonès;08019;Barcelona;10;189;U;;587;392;195;0;3;389;392
8;Barcelona;13;Barcelonès;08019;Barcelona;10;190;U;;670;458;212;0;5;453;458
8;Barcelona;13;Barcelonès;08019;Barcelona;10;191;U;;963;676;287;6;0;670;670
8;Barcelona;13;Barcelonès;08019;Barcelona;10;192;A;;732;472;260;1;2;469;471
8;Barcelona;13;Barcelonès;08019;Barcelona;10;192;B;;715;467;248;2;2;463;465
8;Barcelona;13;Barcelonès;08019;Barcelona;10;194;A;;687;395;292;1;4;390;394
8;Barcelona;13;Barcelonès;08019;Barcelona;10;194;B;;596;329;267;0;0;329;329
8;Barcelona;13;Barcelonès;08019;Barcelona;10;195;A;;740;478;262;0;2;476;478
8;Barcelona;13;Barcelonès;08019;Barcelona;10;195;B;;760;479;281;5;0;474;474
8;Barcelona;13;Barcelonès;08019;Barcelona;10;197;U;;905;651;254;0;8;643;651
8;Barcelona;13;Barcelonès;08019;Barcelona;10;198;U;;741;511;230;0;6;505;511
8;Barcelona;13;Barcelonès;08019;Barcelona;10;199;U;;1082;688;394;0;2;686;688
8;Barcelona;13;Barcelonès;08019;Barcelona;10;2;U;;1134;762;372;6;5;751;756
8;Barcelona;13;Barcelonès;08019;Barcelona;10;20;U;;616;326;290;0;5;321;326
8;Barcelona;13;Barcelonès;08019;Barcelona;10;200;U;;853;549;304;0;2;547;549
8;Barcelona;13;Barcelonès;08019;Barcelona;10;201;U;;429;288;141;0;3;285;288
8;Barcelona;13;Barcelonès;08019;Barcelona;10;202;A;;888;582;306;0;4;578;582
8;Barcelona;13;Barcelonès;08019;Barcelona;10;202;B;;736;469;267;1;8;460;468
8;Barcelona;13;Barcelonès;08019;Barcelona;10;203;U;;574;378;196;0;7;371;378
8;Barcelona;13;Barcelonès;08019;Barcelona;10;204;U;;627;395;232;0;5;390;395
8;Barcelona;13;Barcelonès;08019;Barcelona;10;205;U;;464;308;156;1;1;306;307
8;Barcelona;13;Barcelonès;08019;Barcelona;10;206;U;;1057;705;352;5;11;689;700
8;Barcelona;13;Barcelonès;08019;Barcelona;10;207;A;;604;427;177;0;2;425;427
8;Barcelona;13;Barcelonès;08019;Barcelona;10;207;B;;641;426;215;1;4;421;425
8;Barcelona;13;Barcelonès;08019;Barcelona;10;208;U;;741;475;266;0;4;471;475
8;Barcelona;13;Barcelonès;08019;Barcelona;10;209;U;;787;540;247;1;4;535;539
8;Barcelona;13;Barcelonès;08019;Barcelona;10;21;A;;790;529;261;0;7;522;529
8;Barcelona;13;Barcelonès;08019;Barcelona;10;21;B;;684;448;236;2;6;440;446
8;Barcelona;13;Barcelonès;08019;Barcelona;10;210;U;;718;475;243;0;10;465;475
8;Barcelona;13;Barcelonès;08019;Barcelona;10;211;U;;1196;790;406;0;7;783;790
8;Barcelona;13;Barcelonès;08019;Barcelona;10;212;U;;919;573;346;1;4;568;572
8;Barcelona;13;Barcelonès;08019;Barcelona;10;213;U;;730;439;291;1;3;435;438
8;Barcelona;13;Barcelonès;08019;Barcelona;10;214;U;;979;555;424;2;4;549;553
8;Barcelona;13;Barcelonès;08019;Barcelona;10;215;U;;762;436;326;1;1;434;435
8;Barcelona;13;Barcelonès;08019;Barcelona;10;217;U;;652;381;271;7;4;370;374
8;Barcelona;13;Barcelonès;08019;Barcelona;10;218;U;;647;370;277;9;2;359;361
8;Barcelona;13;Barcelonès;08019;Barcelona;10;22;A;;829;600;229;2;9;589;598
8;Barcelona;13;Barcelonès;08019;Barcelona;10;22;B;;780;548;232;0;3;545;548
8;Barcelona;13;Barcelonès;08019;Barcelona;10;220;U;;816;507;309;1;8;498;506
8;Barcelona;13;Barcelonès;08019;Barcelona;10;221;U;;652;366;286;2;1;363;364
8;Barcelona;13;Barcelonès;08019;Barcelona;10;222;U;;720;428;292;6;0;422;422
8;Barcelona;13;Barcelonès;08019;Barcelona;10;223;A;;771;408;363;0;6;402;408
8;Barcelona;13;Barcelonès;08019;Barcelona;10;223;B;;637;366;271;3;2;361;363
8;Barcelona;13;Barcelonès;08019;Barcelona;10;224;A;;737;483;254;0;5;478;483
8;Barcelona;13;Barcelonès;08019;Barcelona;10;224;B;;573;385;188;1;4;380;384
8;Barcelona;13;Barcelonès;08019;Barcelona;10;225;U;;1030;685;345;1;3;681;684
8;Barcelona;13;Barcelonès;08019;Barcelona;10;226;U;;855;469;386;5;2;462;464
8;Barcelona;13;Barcelonès;08019;Barcelona;10;227;U;;723;301;422;1;1;299;300
8;Barcelona;13;Barcelonès;08019;Barcelona;10;229;U;;552;377;175;0;2;375;377
8;Barcelona;13;Barcelonès;08019;Barcelona;10;23;U;;884;573;311;3;3;567;570
8;Barcelona;13;Barcelonès;08019;Barcelona;10;230;A;;876;585;291;2;2;581;583
8;Barcelona;13;Barcelonès;08019;Barcelona;10;230;B;;677;453;224;0;3;450;453
8;Barcelona;13;Barcelonès;08019;Barcelona;10;231;U;;929;588;341;1;6;581;587
8;Barcelona;13;Barcelonès;08019;Barcelona;10;232;A;;934;752;182;1;6;745;751
8;Barcelona;13;Barcelonès;08019;Barcelona;10;232;B;;795;633;162;0;9;624;633
8;Barcelona;13;Barcelonès;08019;Barcelona;10;233;U;;904;729;175;0;7;722;729
8;Barcelona;13;Barcelonès;08019;Barcelona;10;25;U;;653;436;217;0;0;436;436
8;Barcelona;13;Barcelonès;08019;Barcelona;10;26;U;;1191;765;426;1;6;758;764
8;Barcelona;13;Barcelonès;08019;Barcelona;10;28;U;;1105;713;392;0;9;704;713
8;Barcelona;13;Barcelonès;08019;Barcelona;10;3;U;;499;304;195;0;4;300;304
8;Barcelona;13;Barcelonès;08019;Barcelona;10;30;U;;492;318;174;0;1;317;318
8;Barcelona;13;Barcelonès;08019;Barcelona;10;31;U;;683;490;193;0;3;487;490
8;Barcelona;13;Barcelonès;08019;Barcelona;10;34;U;;591;444;147;2;1;441;442
8;Barcelona;13;Barcelonès;08019;Barcelona;10;35;U;;666;492;174;0;0;492;492
8;Barcelona;13;Barcelonès;08019;Barcelona;10;36;U;;674;443;231;0;3;440;443
8;Barcelona;13;Barcelonès;08019;Barcelona;10;37;U;;559;352;207;0;4;348;352
8;Barcelona;13;Barcelonès;08019;Barcelona;10;38;U;;587;307;280;2;3;302;305
8;Barcelona;13;Barcelonès;08019;Barcelona;10;39;U;;461;253;208;0;2;251;253
8;Barcelona;13;Barcelonès;08019;Barcelona;10;4;U;;891;577;314;2;12;563;575
8;Barcelona;13;Barcelonès;08019;Barcelona;10;40;A;;1126;753;373;0;7;746;753
8;Barcelona;13;Barcelonès;08019;Barcelona;10;40;B;;1085;721;364;0;8;713;721
8;Barcelona;13;Barcelonès;08019;Barcelona;10;41;A;;702;489;213;0;0;489;489
8;Barcelona;13;Barcelonès;08019;Barcelona;10;41;B;;650;453;197;0;5;448;453
8;Barcelona;13;Barcelonès;08019;Barcelona;10;43;A;;652;454;198;1;6;447;453
8;Barcelona;13;Barcelonès;08019;Barcelona;10;43;B;;659;407;252;2;4;401;405
8;Barcelona;13;Barcelonès;08019;Barcelona;10;45;U;;824;537;287;10;1;526;527
8;Barcelona;13;Barcelonès;08019;Barcelona;10;46;U;;1095;727;368;6;4;717;721
8;Barcelona;13;Barcelonès;08019;Barcelona;10;47;U;;698;493;205;1;6;486;492
8;Barcelona;13;Barcelonès;08019;Barcelona;10;48;U;;695;473;222;2;6;465;471
8;Barcelona;13;Barcelonès;08019;Barcelona;10;49;U;;1071;743;328;1;7;735;742
8;Barcelona;13;Barcelonès;08019;Barcelona;10;5;U;;1097;747;350;1;9;737;746
8;Barcelona;13;Barcelonès;08019;Barcelona;10;50;U;;674;443;231;2;1;440;441
8;Barcelona;13;Barcelonès;08019;Barcelona;10;51;U;;1139;709;430;1;9;699;708
8;Barcelona;13;Barcelonès;08019;Barcelona;10;54;U;;480;285;195;0;2;283;285
8;Barcelona;13;Barcelonès;08019;Barcelona;10;56;A;;690;489;201;1;4;484;488
8;Barcelona;13;Barcelonès;08019;Barcelona;10;56;B;;645;438;207;0;5;433;438
8;Barcelona;13;Barcelonès;08019;Barcelona;10;57;A;;814;469;345;0;6;463;469
8;Barcelona;13;Barcelonès;08019;Barcelona;10;57;B;;789;485;304;5;1;479;480
8;Barcelona;13;Barcelonès;08019;Barcelona;10;58;U;;821;550;271;0;5;545;550
8;Barcelona;13;Barcelonès;08019;Barcelona;10;59;U;;690;424;266;0;3;421;424
8;Barcelona;13;Barcelonès;08019;Barcelona;10;6;U;;1078;725;353;0;5;720;725
8;Barcelona;13;Barcelonès;08019;Barcelona;10;60;A;;1115;749;366;1;12;736;748
8;Barcelona;13;Barcelonès;08019;Barcelona;10;60;B;;915;636;279;4;6;626;632
8;Barcelona;13;Barcelonès;08019;Barcelona;10;62;A;;692;353;339;1;0;352;352
8;Barcelona;13;Barcelonès;08019;Barcelona;10;62;B;;588;293;295;1;3;289;292
8;Barcelona;13;Barcelonès;08019;Barcelona;10;65;A;;1220;812;408;1;7;804;811
8;Barcelona;13;Barcelonès;08019;Barcelona;10;65;B;;1141;759;382;0;2;757;759
8;Barcelona;13;Barcelonès;08019;Barcelona;10;66;A;;932;620;312;0;4;616;620
8;Barcelona;13;Barcelonès;08019;Barcelona;10;66;B;;944;618;326;2;10;606;616
8;Barcelona;13;Barcelonès;08019;Barcelona;10;66;C;;993;664;329;0;8;656;664
8;Barcelona;13;Barcelonès;08019;Barcelona;10;68;U;;1008;664;344;0;4;660;664
8;Barcelona;13;Barcelonès;08019;Barcelona;10;69;U;;552;330;222;0;3;327;330
8;Barcelona;13;Barcelonès;08019;Barcelona;10;70;U;;536;288;248;1;4;283;287
8;Barcelona;13;Barcelonès;08019;Barcelona;10;71;U;;948;578;370;0;5;573;578
8;Barcelona;13;Barcelonès;08019;Barcelona;10;72;U;;685;457;228;0;0;457;457
8;Barcelona;13;Barcelonès;08019;Barcelona;10;73;A;;794;514;280;0;7;507;514
8;Barcelona;13;Barcelonès;08019;Barcelona;10;73;B;;661;396;265;0;6;390;396
8;Barcelona;13;Barcelonès;08019;Barcelona;10;75;U;;531;231;300;0;1;230;231
8;Barcelona;13;Barcelonès;08019;Barcelona;10;76;U;;415;259;156;0;3;256;259
8;Barcelona;13;Barcelonès;08019;Barcelona;10;77;U;;807;386;421;0;0;386;386
8;Barcelona;13;Barcelonès;08019;Barcelona;10;78;U;;476;231;245;0;0;231;231
8;Barcelona;13;Barcelonès;08019;Barcelona;10;79;U;;997;547;450;7;0;540;540
8;Barcelona;13;Barcelonès;08019;Barcelona;10;8;U;;681;434;247;0;4;430;434
8;Barcelona;13;Barcelonès;08019;Barcelona;10;82;U;;887;492;395;9;2;481;483
8;Barcelona;13;Barcelonès;08019;Barcelona;10;83;U;;639;308;331;0;1;307;308
8;Barcelona;13;Barcelonès;08019;Barcelona;10;85;U;;742;390;352;1;3;386;389
8;Barcelona;13;Barcelonès;08019;Barcelona;10;86;U;;839;468;371;4;3;461;464
8;Barcelona;13;Barcelonès;08019;Barcelona;10;88;U;;644;382;262;0;3;379;382
8;Barcelona;13;Barcelonès;08019;Barcelona;10;89;U;;608;355;253;0;2;353;355
8;Barcelona;13;Barcelonès;08019;Barcelona;10;9;U;;748;532;216;0;3;529;532
8;Barcelona;13;Barcelonès;08019;Barcelona;10;90;U;;787;416;371;0;4;412;416
8;Barcelona;13;Barcelonès;08019;Barcelona;10;92;U;;607;377;230;1;0;376;376
8;Barcelona;13;Barcelonès;08019;Barcelona;10;93;A;;741;433;308;1;7;425;432
8;Barcelona;13;Barcelonès;08019;Barcelona;10;93;B;;642;383;259;1;6;376;382
8;Barcelona;13;Barcelonès;08019;Barcelona;10;94;U;;669;422;247;2;4;416;420
8;Barcelona;13;Barcelonès;08019;Barcelona;10;96;U;;1072;590;482;1;3;586;589
8;Barcelona;13;Barcelonès;08019;Barcelona;10;98;A;;1194;721;473;0;12;709;721
8;Barcelona;13;Barcelonès;08019;Barcelona;10;98;B;;1048;649;399;1;10;638;648
8;Barcelona;13;Barcelonès;08019;Barcelona;10;99;A;;1029;669;360;0;10;659;669
8;Barcelona;13;Barcelonès;08019;Barcelona;10;99;B;;866;603;263;1;4;598;602
8;Barcelona;13;Barcelonès;08019;Barcelona;2;1;U;;525;335;190;0;3;332;335
8;Barcelona;13;Barcelonès;08019;Barcelona;2;10;U;;506;320;186;0;4;316;320
8;Barcelona;13;Barcelonès;08019;Barcelona;2;100;U;;458;277;181;1;0;276;276
8;Barcelona;13;Barcelonès;08019;Barcelona;2;101;U;;778;521;257;1;2;518;520
8;Barcelona;13;Barcelonès;08019;Barcelona;2;102;U;;715;476;239;0;2;474;476
8;Barcelona;13;Barcelonès;08019;Barcelona;2;103;U;;633;397;236;0;10;387;397
8;Barcelona;13;Barcelonès;08019;Barcelona;2;104;U;;557;364;193;0;3;361;364
8;Barcelona;13;Barcelonès;08019;Barcelona;2;105;U;;549;343;206;0;3;340;343
8;Barcelona;13;Barcelonès;08019;Barcelona;2;106;U;;521;348;173;0;5;343;348
8;Barcelona;13;Barcelonès;08019;Barcelona;2;107;U;;934;673;261;4;6;663;669
8;Barcelona;13;Barcelonès;08019;Barcelona;2;109;U;;472;323;149;1;8;314;322
8;Barcelona;13;Barcelonès;08019;Barcelona;2;11;U;;705;465;240;0;3;462;465
8;Barcelona;13;Barcelonès;08019;Barcelona;2;110;U;;662;455;207;1;6;448;454
8;Barcelona;13;Barcelonès;08019;Barcelona;2;112;U;;692;515;177;2;6;507;513
8;Barcelona;13;Barcelonès;08019;Barcelona;2;114;U;;690;489;201;1;5;483;488
8;Barcelona;13;Barcelonès;08019;Barcelona;2;115;U;;741;529;212;1;4;524;528
8;Barcelona;13;Barcelonès;08019;Barcelona;2;117;U;;793;553;240;1;8;544;552
8;Barcelona;13;Barcelonès;08019;Barcelona;2;118;U;;988;695;293;0;7;688;695
8;Barcelona;13;Barcelonès;08019;Barcelona;2;12;U;;711;498;213;1;2;495;497
8;Barcelona;13;Barcelonès;08019;Barcelona;2;121;U;;936;674;262;0;8;666;674
8;Barcelona;13;Barcelonès;08019;Barcelona;2;124;U;;598;407;191;1;6;400;406
8;Barcelona;13;Barcelonès;08019;Barcelona;2;125;U;;694;525;169;1;2;522;524
8;Barcelona;13;Barcelonès;08019;Barcelona;2;126;U;;408;325;83;0;2;323;325
8;Barcelona;13;Barcelonès;08019;Barcelona;2;127;U;;568;398;170;0;5;393;398
8;Barcelona;13;Barcelonès;08019;Barcelona;2;128;U;;951;676;275;1;2;673;675
8;Barcelona;13;Barcelonès;08019;Barcelona;2;129;U;;874;660;214;2;8;650;658
8;Barcelona;13;Barcelonès;08019;Barcelona;2;13;U;;1123;804;319;0;4;800;804
8;Barcelona;13;Barcelonès;08019;Barcelona;2;130;U;;609;423;186;0;4;419;423
8;Barcelona;13;Barcelonès;08019;Barcelona;2;131;U;;654;447;207;5;2;440;442
8;Barcelona;13;Barcelonès;08019;Barcelona;2;132;U;;1028;775;253;0;4;771;775
8;Barcelona;13;Barcelonès;08019;Barcelona;2;133;U;;1231;952;279;1;10;941;951
8;Barcelona;13;Barcelonès;08019;Barcelona;2;134;U;;1087;747;340;0;6;741;747
8;Barcelona;13;Barcelonès;08019;Barcelona;2;135;U;;876;647;229;3;5;639;644
8;Barcelona;13;Barcelonès;08019;Barcelona;2;137;U;;1109;838;271;0;7;831;838
8;Barcelona;13;Barcelonès;08019;Barcelona;2;138;A;;703;509;194;0;8;501;509
8;Barcelona;13;Barcelonès;08019;Barcelona;2;138;B;;675;462;213;0;1;461;462
8;Barcelona;13;Barcelonès;08019;Barcelona;2;14;U;;669;464;205;0;4;460;464
8;Barcelona;13;Barcelonès;08019;Barcelona;2;140;U;;951;605;346;0;8;597;605
8;Barcelona;13;Barcelonès;08019;Barcelona;2;141;U;;684;439;245;0;6;433;439
8;Barcelona;13;Barcelonès;08019;Barcelona;2;142;U;;679;474;205;0;10;464;474
8;Barcelona;13;Barcelonès;08019;Barcelona;2;143;U;;798;532;266;1;3;528;531
8;Barcelona;13;Barcelonès;08019;Barcelona;2;144;U;;911;683;228;2;6;675;681
8;Barcelona;13;Barcelonès;08019;Barcelona;2;145;U;;1203;863;340;0;9;854;863
8;Barcelona;13;Barcelonès;08019;Barcelona;2;146;A;;724;528;196;1;6;521;527
8;Barcelona;13;Barcelonès;08019;Barcelona;2;146;B;;606;439;167;0;4;435;439
8;Barcelona;13;Barcelonès;08019;Barcelona;2;148;U;;1169;891;278;1;11;879;890
8;Barcelona;13;Barcelonès;08019;Barcelona;2;149;U;;740;487;253;1;5;481;486
8;Barcelona;13;Barcelonès;08019;Barcelona;2;15;U;;989;707;282;1;5;701;706
8;Barcelona;13;Barcelonès;08019;Barcelona;2;151;U;;622;421;201;0;4;417;421
8;Barcelona;13;Barcelonès;08019;Barcelona;2;152;U;;749;510;239;1;1;508;509
8;Barcelona;13;Barcelonès;08019;Barcelona;2;153;U;;569;392;177;0;4;388;392
8;Barcelona;13;Barcelonès;08019;Barcelona;2;154;U;;823;617;206;4;3;610;613
8;Barcelona;13;Barcelonès;08019;Barcelona;2;155;U;;839;610;229;2;11;597;608
8;Barcelona;13;Barcelonès;08019;Barcelona;2;156;U;;562;387;175;0;4;383;387
8;Barcelona;13;Barcelonès;08019;Barcelona;2;157;U;;752;567;185;2;6;559;565
8;Barcelona;13;Barcelonès;08019;Barcelona;2;158;U;;789;621;168;0;4;617;621
8;Barcelona;13;Barcelonès;08019;Barcelona;2;159;U;;983;717;266;2;9;706;715
8;Barcelona;13;Barcelonès;08019;Barcelona;2;161;U;;705;510;195;0;4;506;510
8;Barcelona;13;Barcelonès;08019;Barcelona;2;162;U;;641;474;167;0;4;470;474
8;Barcelona;13;Barcelonès;08019;Barcelona;2;163;U;;931;656;275;1;7;648;655
8;Barcelona;13;Barcelonès;08019;Barcelona;2;167;U;;770;540;230;1;11;528;539
8;Barcelona;13;Barcelonès;08019;Barcelona;2;168;U;;726;554;172;2;3;549;552
8;Barcelona;13;Barcelonès;08019;Barcelona;2;169;U;;497;348;149;1;4;343;347
8;Barcelona;13;Barcelonès;08019;Barcelona;2;17;U;;570;370;200;1;5;364;369
8;Barcelona;13;Barcelonès;08019;Barcelona;2;170;U;;750;559;191;0;10;549;559
8;Barcelona;13;Barcelonès;08019;Barcelona;2;171;U;;570;421;149;1;4;416;420
8;Barcelona;13;Barcelonès;08019;Barcelona;2;172;U;;561;453;108;4;5;444;449
8;Barcelona;13;Barcelonès;08019;Barcelona;2;173;U;;521;401;120;3;6;392;398
8;Barcelona;13;Barcelonès;08019;Barcelona;2;174;U;;502;363;139;0;9;354;363
8;Barcelona;13;Barcelonès;08019;Barcelona;2;175;U;;610;443;167;0;5;438;443
8;Barcelona;13;Barcelonès;08019;Barcelona;2;176;U;;869;608;261;2;5;601;606
8;Barcelona;13;Barcelonès;08019;Barcelona;2;177;U;;486;332;154;0;1;331;332
8;Barcelona;13;Barcelonès;08019;Barcelona;2;178;U;;573;418;155;0;7;411;418
8;Barcelona;13;Barcelonès;08019;Barcelona;2;179;U;;590;400;190;0;13;387;400
8;Barcelona;13;Barcelonès;08019;Barcelona;2;18;U;;1122;823;299;0;7;816;823
8;Barcelona;13;Barcelonès;08019;Barcelona;2;180;U;;793;577;216;0;9;568;577
8;Barcelona;13;Barcelonès;08019;Barcelona;2;182;U;;1150;827;323;1;7;819;826
8;Barcelona;13;Barcelonès;08019;Barcelona;2;184;U;;691;474;217;1;2;471;473
8;Barcelona;13;Barcelonès;08019;Barcelona;2;185;U;;912;685;227;0;6;679;685
8;Barcelona;13;Barcelonès;08019;Barcelona;2;187;U;;537;387;150;0;7;380;387
8;Barcelona;13;Barcelonès;08019;Barcelona;2;189;U;;645;515;130;1;4;510;514
8;Barcelona;13;Barcelonès;08019;Barcelona;2;19;U;;876;611;265;2;1;608;609
8;Barcelona;13;Barcelonès;08019;Barcelona;2;190;U;;541;418;123;1;1;416;417
8;Barcelona;13;Barcelonès;08019;Barcelona;2;191;U;;571;386;185;0;5;381;386
8;Barcelona;13;Barcelonès;08019;Barcelona;2;192;U;;694;456;238;0;2;454;456
8;Barcelona;13;Barcelonès;08019;Barcelona;2;193;U;;657;504;153;1;7;496;503
8;Barcelona;13;Barcelonès;08019;Barcelona;2;195;U;;852;640;212;3;7;630;637
8;Barcelona;13;Barcelonès;08019;Barcelona;2;197;U;;755;521;234;0;7;514;521
8;Barcelona;13;Barcelonès;08019;Barcelona;2;199;U;;583;409;174;0;6;403;409
8;Barcelona;13;Barcelonès;08019;Barcelona;2;2;U;;720;502;218;0;2;500;502
8;Barcelona;13;Barcelonès;08019;Barcelona;2;20;U;;1175;765;410;6;1;758;759
8;Barcelona;13;Barcelonès;08019;Barcelona;2;201;U;;948;725;223;1;11;713;724
8;Barcelona;13;Barcelonès;08019;Barcelona;2;203;U;;652;490;162;1;8;481;489
8;Barcelona;13;Barcelonès;08019;Barcelona;2;206;U;;834;615;219;2;9;604;613
8;Barcelona;13;Barcelonès;08019;Barcelona;2;207;U;;676;479;197;2;3;474;477
8;Barcelona;13;Barcelonès;08019;Barcelona;2;209;U;;489;336;153;0;4;332;336
8;Barcelona;13;Barcelonès;08019;Barcelona;2;21;U;;1109;722;387;4;5;713;718
8;Barcelona;13;Barcelonès;08019;Barcelona;2;210;U;;997;705;292;4;6;695;701
8;Barcelona;13;Barcelonès;08019;Barcelona;2;212;U;;881;641;240;0;11;630;641
8;Barcelona;13;Barcelonès;08019;Barcelona;2;213;U;;713;504;209;1;12;491;503
8;Barcelona;13;Barcelonès;08019;Barcelona;2;214;U;;739;499;240;0;3;496;499
8;Barcelona;13;Barcelonès;08019;Barcelona;2;215;U;;915;673;242;1;5;667;672
8;Barcelona;13;Barcelonès;08019;Barcelona;2;216;U;;805;577;228;2;5;570;575
8;Barcelona;13;Barcelonès;08019;Barcelona;2;219;U;;737;519;218;1;2;516;518
8;Barcelona;13;Barcelonès;08019;Barcelona;2;220;A;;689;492;197;0;7;485;492
8;Barcelona;13;Barcelonès;08019;Barcelona;2;220;B;;599;445;154;2;3;440;443
8;Barcelona;13;Barcelonès;08019;Barcelona;2;221;U;;984;678;306;4;5;669;674
8;Barcelona;13;Barcelonès;08019;Barcelona;2;224;U;;578;433;145;0;3;430;433
8;Barcelona;13;Barcelonès;08019;Barcelona;2;226;U;;547;407;140;0;2;405;407
8;Barcelona;13;Barcelonès;08019;Barcelona;2;229;U;;624;461;163;0;5;456;461
8;Barcelona;13;Barcelonès;08019;Barcelona;2;230;U;;936;582;354;3;3;576;579
8;Barcelona;13;Barcelonès;08019;Barcelona;2;231;U;;642;499;143;1;1;497;498
8;Barcelona;13;Barcelonès;08019;Barcelona;2;232;U;;452;297;155;0;5;292;297
8;Barcelona;13;Barcelonès;08019;Barcelona;2;233;U;;753;612;141;0;6;606;612
8;Barcelona;13;Barcelonès;08019;Barcelona;2;234;U;;609;459;150;0;7;452;459
8;Barcelona;13;Barcelonès;08019;Barcelona;2;236;U;;900;679;221;0;4;675;679
8;Barcelona;13;Barcelonès;08019;Barcelona;2;237;U;;712;509;203;0;7;502;509
8;Barcelona;13;Barcelonès;08019;Barcelona;2;238;U;;876;664;212;0;3;661;664
8;Barcelona;13;Barcelonès;08019;Barcelona;2;239;U;;770;571;199;3;5;563;568
8;Barcelona;13;Barcelonès;08019;Barcelona;2;24;U;;720;468;252;0;4;464;468
8;Barcelona;13;Barcelonès;08019;Barcelona;2;240;U;;1040;739;301;2;4;733;737
8;Barcelona;13;Barcelonès;08019;Barcelona;2;241;U;;1170;908;262;3;6;899;905
8;Barcelona;13;Barcelonès;08019;Barcelona;2;243;U;;837;559;278;0;5;554;559
8;Barcelona;13;Barcelonès;08019;Barcelona;2;244;U;;798;612;186;0;10;602;612
8;Barcelona;13;Barcelonès;08019;Barcelona;2;246;U;;1089;736;353;0;7;729;736
8;Barcelona;13;Barcelonès;08019;Barcelona;2;247;U;;984;681;303;0;5;676;681
8;Barcelona;13;Barcelonès;08019;Barcelona;2;248;U;;963;709;254;1;5;703;708
8;Barcelona;13;Barcelonès;08019;Barcelona;2;249;U;;852;561;291;1;5;555;560
8;Barcelona;13;Barcelonès;08019;Barcelona;2;25;U;;1104;801;303;3;6;792;798
8;Barcelona;13;Barcelonès;08019;Barcelona;2;251;U;;919;589;330;2;6;581;587
8;Barcelona;13;Barcelonès;08019;Barcelona;2;252;U;;739;494;245;2;3;489;492
8;Barcelona;13;Barcelonès;08019;Barcelona;2;253;U;;917;582;335;2;2;578;580
8;Barcelona;13;Barcelonès;08019;Barcelona;2;255;U;;708;491;217;0;3;488;491
8;Barcelona;13;Barcelonès;08019;Barcelona;2;256;U;;585;391;194;2;4;385;389
8;Barcelona;13;Barcelonès;08019;Barcelona;2;257;U;;918;610;308;0;8;602;610
8;Barcelona;13;Barcelonès;08019;Barcelona;2;258;U;;1007;737;270;6;2;729;731
8;Barcelona;13;Barcelonès;08019;Barcelona;2;259;U;;797;562;235;0;3;559;562
8;Barcelona;13;Barcelonès;08019;Barcelona;2;26;U;;844;624;220;0;9;615;624
8;Barcelona;13;Barcelonès;08019;Barcelona;2;260;U;;713;493;220;2;6;485;491
8;Barcelona;13;Barcelonès;08019;Barcelona;2;261;U;;729;538;191;0;8;530;538
8;Barcelona;13;Barcelonès;08019;Barcelona;2;262;U;;1121;812;309;1;5;806;811
8;Barcelona;13;Barcelonès;08019;Barcelona;2;264;U;;782;513;269;0;2;511;513
8;Barcelona;13;Barcelonès;08019;Barcelona;2;265;U;;713;478;235;0;3;475;478
8;Barcelona;13;Barcelonès;08019;Barcelona;2;266;U;;634;383;251;2;3;378;381
8;Barcelona;13;Barcelonès;08019;Barcelona;2;267;U;;678;436;242;3;2;431;433
8;Barcelona;13;Barcelonès;08019;Barcelona;2;268;U;;805;575;230;3;9;563;572
8;Barcelona;13;Barcelonès;08019;Barcelona;2;269;U;;936;597;339;1;7;589;596
8;Barcelona;13;Barcelonès;08019;Barcelona;2;27;U;;605;425;180;2;6;417;423
8;Barcelona;13;Barcelonès;08019;Barcelona;2;271;U;;816;499;317;2;5;492;497
8;Barcelona;13;Barcelonès;08019;Barcelona;2;272;U;;672;419;253;0;3;416;419
8;Barcelona;13;Barcelonès;08019;Barcelona;2;273;U;;951;648;303;1;6;641;647
8;Barcelona;13;Barcelonès;08019;Barcelona;2;274;U;;907;635;272;0;0;635;635
8;Barcelona;13;Barcelonès;08019;Barcelona;2;275;U;;940;636;304;0;3;633;636
8;Barcelona;13;Barcelonès;08019;Barcelona;2;276;U;;972;658;314;1;4;653;657
8;Barcelona;13;Barcelonès;08019;Barcelona;2;277;U;;908;689;219;2;7;680;687
8;Barcelona;13;Barcelonès;08019;Barcelona;2;278;U;;727;513;214;0;7;506;513
8;Barcelona;13;Barcelonès;08019;Barcelona;2;279;U;;814;571;243;0;6;565;571
8;Barcelona;13;Barcelonès;08019;Barcelona;2;28;U;;749;540;209;1;5;534;539
8;Barcelona;13;Barcelonès;08019;Barcelona;2;280;U;;1193;871;322;3;11;857;868
8;Barcelona;13;Barcelonès;08019;Barcelona;2;281;U;;700;529;171;0;4;525;529
8;Barcelona;13;Barcelonès;08019;Barcelona;2;282;U;;914;720;194;0;10;710;720
8;Barcelona;13;Barcelonès;08019;Barcelona;2;283;U;;882;596;286;2;4;590;594
8;Barcelona;13;Barcelonès;08019;Barcelona;2;284;U;;904;572;332;2;3;567;570
8;Barcelona;13;Barcelonès;08019;Barcelona;2;285;U;;1105;782;323;0;10;772;782
8;Barcelona;13;Barcelonès;08019;Barcelona;2;286;U;;640;459;181;1;2;456;458
8;Barcelona;13;Barcelonès;08019;Barcelona;2;287;U;;779;570;209;0;9;561;570
8;Barcelona;13;Barcelonès;08019;Barcelona;2;288;U;;671;452;219;1;6;445;451
8;Barcelona;13;Barcelonès;08019;Barcelona;2;289;U;;818;548;270;0;2;546;548
8;Barcelona;13;Barcelonès;08019;Barcelona;2;29;U;;804;567;237;0;11;556;567
8;Barcelona;13;Barcelonès;08019;Barcelona;2;290;U;;719;491;228;3;4;484;488
8;Barcelona;13;Barcelonès;08019;Barcelona;2;292;U;;714;504;210;2;3;499;502
8;Barcelona;13;Barcelonès;08019;Barcelona;2;294;U;;487;354;133;4;12;338;350
8;Barcelona;13;Barcelonès;08019;Barcelona;2;295;U;;715;509;206;0;8;501;509
8;Barcelona;13;Barcelonès;08019;Barcelona;2;296;U;;727;509;218;1;4;504;508
8;Barcelona;13;Barcelonès;08019;Barcelona;2;297;U;;846;605;241;0;9;596;605
8;Barcelona;13;Barcelonès;08019;Barcelona;2;298;U;;706;452;254;0;6;446;452
8;Barcelona;13;Barcelonès;08019;Barcelona;2;3;U;;600;400;200;0;2;398;400
8;Barcelona;13;Barcelonès;08019;Barcelona;2;30;U;;1040;692;348;1;7;684;691
8;Barcelona;13;Barcelonès;08019;Barcelona;2;300;U;;782;575;207;0;8;567;575
8;Barcelona;13;Barcelonès;08019;Barcelona;2;301;U;;1164;866;298;2;11;853;864
8;Barcelona;13;Barcelonès;08019;Barcelona;2;302;U;;997;720;277;1;10;709;719
8;Barcelona;13;Barcelonès;08019;Barcelona;2;303;U;;999;752;247;1;7;744;751
8;Barcelona;13;Barcelonès;08019;Barcelona;2;304;U;;909;630;279;0;7;623;630
8;Barcelona;13;Barcelonès;08019;Barcelona;2;305;U;;935;640;295;1;6;633;639
8;Barcelona;13;Barcelonès;08019;Barcelona;2;306;U;;1076;813;263;1;5;807;812
8;Barcelona;13;Barcelonès;08019;Barcelona;2;307;A;;754;567;187;0;6;561;567
8;Barcelona;13;Barcelonès;08019;Barcelona;2;307;B;;686;513;173;0;5;508;513
8;Barcelona;13;Barcelonès;08019;Barcelona;2;308;U;;1003;695;308;1;8;686;694
8;Barcelona;13;Barcelonès;08019;Barcelona;2;309;U;;740;446;294;0;1;445;446
8;Barcelona;13;Barcelonès;08019;Barcelona;2;31;U;;831;592;239;1;1;590;591
8;Barcelona;13;Barcelonès;08019;Barcelona;2;311;U;;876;594;282;1;5;588;593
8;Barcelona;13;Barcelonès;08019;Barcelona;2;312;U;;795;574;221;0;12;562;574
8;Barcelona;13;Barcelonès;08019;Barcelona;2;314;U;;637;480;157;2;4;474;478
8;Barcelona;13;Barcelonès;08019;Barcelona;2;315;U;;966;659;307;2;5;652;657
8;Barcelona;13;Barcelonès;08019;Barcelona;2;317;U;;1186;790;396;6;4;780;784
8;Barcelona;13;Barcelonès;08019;Barcelona;2;32;U;;837;629;208;1;1;627;628
8;Barcelona;13;Barcelonès;08019;Barcelona;2;33;U;;754;549;205;1;4;544;548
8;Barcelona;13;Barcelonès;08019;Barcelona;2;34;U;;913;610;303;0;6;604;610
8;Barcelona;13;Barcelonès;08019;Barcelona;2;35;U;;613;415;198;1;2;412;414
8;Barcelona;13;Barcelonès;08019;Barcelona;2;36;U;;760;522;238;1;3;518;521
8;Barcelona;13;Barcelonès;08019;Barcelona;2;37;U;;730;515;215;5;5;505;510
8;Barcelona;13;Barcelonès;08019;Barcelona;2;39;U;;612;401;211;0;6;395;401
8;Barcelona;13;Barcelonès;08019;Barcelona;2;4;U;;624;421;203;0;3;418;421
8;Barcelona;13;Barcelonès;08019;Barcelona;2;40;U;;646;455;191;1;1;453;454
8;Barcelona;13;Barcelonès;08019;Barcelona;2;41;U;;764;529;235;0;0;529;529
8;Barcelona;13;Barcelonès;08019;Barcelona;2;42;U;;647;421;226;1;1;419;420
8;Barcelona;13;Barcelonès;08019;Barcelona;2;43;U;;684;451;233;0;9;442;451
8;Barcelona;13;Barcelonès;08019;Barcelona;2;45;U;;526;366;160;1;5;360;365
8;Barcelona;13;Barcelonès;08019;Barcelona;2;47;U;;1105;742;363;1;8;733;741
8;Barcelona;13;Barcelonès;08019;Barcelona;2;49;U;;867;593;274;0;8;585;593
8;Barcelona;13;Barcelonès;08019;Barcelona;2;5;U;;630;423;207;0;1;422;423
8;Barcelona;13;Barcelonès;08019;Barcelona;2;51;U;;513;371;142;1;7;363;370
8;Barcelona;13;Barcelonès;08019;Barcelona;2;52;U;;615;419;196;1;2;416;418
8;Barcelona;13;Barcelonès;08019;Barcelona;2;53;U;;575;407;168;0;7;400;407
8;Barcelona;13;Barcelonès;08019;Barcelona;2;54;U;;695;461;234;0;7;454;461
8;Barcelona;13;Barcelonès;08019;Barcelona;2;55;U;;924;659;265;4;5;650;655
8;Barcelona;13;Barcelonès;08019;Barcelona;2;56;U;;596;422;174;1;3;418;421
8;Barcelona;13;Barcelonès;08019;Barcelona;2;57;U;;591;431;160;0;7;424;431
8;Barcelona;13;Barcelonès;08019;Barcelona;2;59;U;;594;391;203;3;3;385;388
8;Barcelona;13;Barcelonès;08019;Barcelona;2;6;U;;537;338;199;0;4;334;338
8;Barcelona;13;Barcelonès;08019;Barcelona;2;60;U;;750;511;239;0;6;505;511
8;Barcelona;13;Barcelonès;08019;Barcelona;2;61;U;;766;526;240;3;4;519;523
8;Barcelona;13;Barcelonès;08019;Barcelona;2;62;U;;588;425;163;0;2;423;425
8;Barcelona;13;Barcelonès;08019;Barcelona;2;63;U;;795;590;205;3;9;578;587
8;Barcelona;13;Barcelonès;08019;Barcelona;2;65;U;;789;592;197;0;4;588;592
8;Barcelona;13;Barcelonès;08019;Barcelona;2;66;U;;759;565;194;1;4;560;564
8;Barcelona;13;Barcelonès;08019;Barcelona;2;67;U;;800;548;252;4;8;536;544
8;Barcelona;13;Barcelonès;08019;Barcelona;2;68;U;;894;574;320;0;7;567;574
8;Barcelona;13;Barcelonès;08019;Barcelona;2;7;U;;601;344;257;2;6;336;342
8;Barcelona;13;Barcelonès;08019;Barcelona;2;70;U;;595;393;202;1;3;389;392
8;Barcelona;13;Barcelonès;08019;Barcelona;2;71;U;;903;633;270;1;6;626;632
8;Barcelona;13;Barcelonès;08019;Barcelona;2;72;U;;689;419;270;2;9;408;417
8;Barcelona;13;Barcelonès;08019;Barcelona;2;73;U;;884;666;218;0;6;660;666
8;Barcelona;13;Barcelonès;08019;Barcelona;2;74;U;;923;620;303;1;5;614;619
8;Barcelona;13;Barcelonès;08019;Barcelona;2;75;U;;1096;778;318;0;11;767;778
8;Barcelona;13;Barcelonès;08019;Barcelona;2;77;U;;853;623;230;1;5;617;622
8;Barcelona;13;Barcelonès;08019;Barcelona;2;78;U;;621;419;202;0;6;413;419
8;Barcelona;13;Barcelonès;08019;Barcelona;2;79;U;;938;656;282;4;3;649;652
8;Barcelona;13;Barcelonès;08019;Barcelona;2;8;U;;659;419;240;0;6;413;419
8;Barcelona;13;Barcelonès;08019;Barcelona;2;80;U;;977;714;263;0;10;704;714
8;Barcelona;13;Barcelonès;08019;Barcelona;2;81;U;;870;564;306;2;2;560;562
8;Barcelona;13;Barcelonès;08019;Barcelona;2;82;U;;913;609;304;0;8;601;609
8;Barcelona;13;Barcelonès;08019;Barcelona;2;83;U;;661;474;187;1;4;469;473
8;Barcelona;13;Barcelonès;08019;Barcelona;2;84;U;;1195;794;401;0;9;785;794
8;Barcelona;13;Barcelonès;08019;Barcelona;2;85;U;;787;558;229;1;7;550;557
8;Barcelona;13;Barcelonès;08019;Barcelona;2;86;U;;995;634;361;2;4;628;632
8;Barcelona;13;Barcelonès;08019;Barcelona;2;87;U;;1048;755;293;1;7;747;754
8;Barcelona;13;Barcelonès;08019;Barcelona;2;89;U;;965;717;248;0;8;709;717
8;Barcelona;13;Barcelonès;08019;Barcelona;2;9;U;;740;499;241;0;2;497;499
8;Barcelona;13;Barcelonès;08019;Barcelona;2;90;U;;1013;754;259;0;5;749;754
8;Barcelona;13;Barcelonès;08019;Barcelona;2;91;U;;550;403;147;1;8;394;402
8;Barcelona;13;Barcelonès;08019;Barcelona;2;92;U;;990;706;284;5;5;696;701
8;Barcelona;13;Barcelonès;08019;Barcelona;2;93;U;;907;642;265;0;12;630;642
8;Barcelona;13;Barcelonès;08019;Barcelona;2;94;U;;980;708;272;3;9;696;705
8;Barcelona;13;Barcelonès;08019;Barcelona;2;95;U;;1120;846;274;0;13;833;846
8;Barcelona;13;Barcelonès;08019;Barcelona;2;96;U;;581;434;147;0;3;431;434
8;Barcelona;13;Barcelonès;08019;Barcelona;2;97;U;;851;598;253;2;14;582;596
8;Barcelona;13;Barcelonès;08019;Barcelona;2;98;U;;716;524;192;0;0;524;524
8;Barcelona;13;Barcelonès;08019;Barcelona;2;99;U;;598;437;161;1;2;434;436
8;Barcelona;13;Barcelonès;08019;Barcelona;3;1;U;;1160;761;399;0;7;754;761
8;Barcelona;13;Barcelonès;08019;Barcelona;3;10;U;;976;579;397;0;1;578;579
8;Barcelona;13;Barcelonès;08019;Barcelona;3;100;U;;1106;777;329;0;5;772;777
8;Barcelona;13;Barcelonès;08019;Barcelona;3;101;U;;1133;773;360;1;16;756;772
8;Barcelona;13;Barcelonès;08019;Barcelona;3;102;U;;749;518;231;0;3;515;518
8;Barcelona;13;Barcelonès;08019;Barcelona;3;103;U;;641;418;223;1;3;414;417
8;Barcelona;13;Barcelonès;08019;Barcelona;3;104;U;;852;554;298;0;0;554;554
8;Barcelona;13;Barcelonès;08019;Barcelona;3;106;U;;455;315;140;0;1;314;315
8;Barcelona;13;Barcelonès;08019;Barcelona;3;107;U;;1105;704;401;1;7;696;703
8;Barcelona;13;Barcelonès;08019;Barcelona;3;109;A;;841;551;290;0;3;548;551
8;Barcelona;13;Barcelonès;08019;Barcelona;3;109;B;;817;538;279;0;4;534;538
8;Barcelona;13;Barcelonès;08019;Barcelona;3;110;A;;775;509;266;0;1;508;509
8;Barcelona;13;Barcelonès;08019;Barcelona;3;110;B;;707;447;260;0;5;442;447
8;Barcelona;13;Barcelonès;08019;Barcelona;3;111;A;;916;584;332;0;9;575;584
8;Barcelona;13;Barcelonès;08019;Barcelona;3;111;B;;848;529;319;0;4;525;529
8;Barcelona;13;Barcelonès;08019;Barcelona;3;112;U;;684;448;236;0;3;445;448
8;Barcelona;13;Barcelonès;08019;Barcelona;3;113;U;;722;458;264;1;3;454;457
8;Barcelona;13;Barcelonès;08019;Barcelona;3;114;U;;604;429;175;1;6;422;428
8;Barcelona;13;Barcelonès;08019;Barcelona;3;115;U;;974;656;318;0;7;649;656
8;Barcelona;13;Barcelonès;08019;Barcelona;3;117;U;;622;518;104;1;3;514;517
8;Barcelona;13;Barcelonès;08019;Barcelona;3;118;U;;665;470;195;0;1;469;470
8;Barcelona;13;Barcelonès;08019;Barcelona;3;119;U;;455;285;170;1;0;284;284
8;Barcelona;13;Barcelonès;08019;Barcelona;3;12;U;;822;407;415;0;3;404;407
8;Barcelona;13;Barcelonès;08019;Barcelona;3;120;U;;643;425;218;4;4;417;421
8;Barcelona;13;Barcelonès;08019;Barcelona;3;121;U;;510;328;182;1;4;323;327
8;Barcelona;13;Barcelonès;08019;Barcelona;3;122;U;;817;557;260;0;1;556;557
8;Barcelona;13;Barcelonès;08019;Barcelona;3;124;U;;648;442;206;1;3;438;441
8;Barcelona;13;Barcelonès;08019;Barcelona;3;125;U;;728;507;221;7;4;496;500
8;Barcelona;13;Barcelonès;08019;Barcelona;3;127;U;;555;388;167;1;0;387;387
8;Barcelona;13;Barcelonès;08019;Barcelona;3;128;U;;475;319;156;2;4;313;317
8;Barcelona;13;Barcelonès;08019;Barcelona;3;129;U;;614;449;165;4;8;437;445
8;Barcelona;13;Barcelonès;08019;Barcelona;3;130;U;;1023;713;310;2;6;705;711
8;Barcelona;13;Barcelonès;08019;Barcelona;3;132;U;;799;577;222;0;4;573;577
8;Barcelona;13;Barcelonès;08019;Barcelona;3;133;U;;529;355;174;2;3;350;353
8;Barcelona;13;Barcelonès;08019;Barcelona;3;134;A;;1026;691;335;1;6;684;690
8;Barcelona;13;Barcelonès;08019;Barcelona;3;134;B;;921;613;308;2;6;605;611
8;Barcelona;13;Barcelonès;08019;Barcelona;3;135;U;;802;470;332;2;3;465;468
8;Barcelona;13;Barcelonès;08019;Barcelona;3;137;U;;903;573;330;0;9;564;573
8;Barcelona;13;Barcelonès;08019;Barcelona;3;138;U;;803;560;243;1;8;551;559
8;Barcelona;13;Barcelonès;08019;Barcelona;3;139;U;;516;349;167;0;3;346;349
8;Barcelona;13;Barcelonès;08019;Barcelona;3;14;U;;736;378;358;0;2;376;378
8;Barcelona;13;Barcelonès;08019;Barcelona;3;140;U;;474;322;152;0;0;322;322
8;Barcelona;13;Barcelonès;08019;Barcelona;3;141;U;;577;344;233;0;2;342;344
8;Barcelona;13;Barcelonès;08019;Barcelona;3;142;U;;742;528;214;1;4;523;527
8;Barcelona;13;Barcelonès;08019;Barcelona;3;143;U;;513;326;187;0;4;322;326
8;Barcelona;13;Barcelonès;08019;Barcelona;3;144;U;;854;618;236;0;3;615;618
8;Barcelona;13;Barcelonès;08019;Barcelona;3;146;U;;626;462;164;0;3;459;462
8;Barcelona;13;Barcelonès;08019;Barcelona;3;147;A;;665;486;179;0;2;484;486
8;Barcelona;13;Barcelonès;08019;Barcelona;3;147;B;;607;458;149;1;8;449;457
8;Barcelona;13;Barcelonès;08019;Barcelona;3;148;U;;1141;832;309;1;10;821;831
8;Barcelona;13;Barcelonès;08019;Barcelona;3;149;U;;891;640;251;3;8;629;637
8;Barcelona;13;Barcelonès;08019;Barcelona;3;15;U;;529;308;221;0;3;305;308
8;Barcelona;13;Barcelonès;08019;Barcelona;3;150;U;;728;511;217;2;4;505;509
8;Barcelona;13;Barcelonès;08019;Barcelona;3;151;U;;822;575;247;6;6;563;569
8;Barcelona;13;Barcelonès;08019;Barcelona;3;152;U;;511;349;162;0;4;345;349
8;Barcelona;13;Barcelonès;08019;Barcelona;3;153;U;;1240;840;400;0;5;835;840
8;Barcelona;13;Barcelonès;08019;Barcelona;3;154;U;;750;496;254;0;3;493;496
8;Barcelona;13;Barcelonès;08019;Barcelona;3;157;U;;713;452;261;0;2;450;452
8;Barcelona;13;Barcelonès;08019;Barcelona;3;159;U;;633;445;188;1;3;441;444
8;Barcelona;13;Barcelonès;08019;Barcelona;3;16;U;;586;331;255;1;5;325;330
8;Barcelona;13;Barcelonès;08019;Barcelona;3;160;U;;1147;821;326;1;5;815;820
8;Barcelona;13;Barcelonès;08019;Barcelona;3;162;U;;935;665;270;0;5;660;665
8;Barcelona;13;Barcelonès;08019;Barcelona;3;163;U;;560;410;150;1;6;403;409
8;Barcelona;13;Barcelonès;08019;Barcelona;3;164;U;;545;404;141;4;0;400;400
8;Barcelona;13;Barcelonès;08019;Barcelona;3;165;U;;426;293;133;0;2;291;293
8;Barcelona;13;Barcelonès;08019;Barcelona;3;167;U;;693;519;174;4;12;503;515
8;Barcelona;13;Barcelonès;08019;Barcelona;3;168;A;;679;505;174;1;3;501;504
8;Barcelona;13;Barcelonès;08019;Barcelona;3;168;B;;598;436;162;0;5;431;436
8;Barcelona;13;Barcelonès;08019;Barcelona;3;169;U;;1195;889;306;3;9;877;886
8;Barcelona;13;Barcelonès;08019;Barcelona;3;17;U;;618;363;255;0;4;359;363
8;Barcelona;13;Barcelonès;08019;Barcelona;3;170;U;;1191;830;361;0;3;827;830
8;Barcelona;13;Barcelonès;08019;Barcelona;3;172;U;;809;547;262;0;1;546;547
8;Barcelona;13;Barcelonès;08019;Barcelona;3;173;U;;817;550;267;0;6;544;550
8;Barcelona;13;Barcelonès;08019;Barcelona;3;176;U;;610;419;191;2;9;408;417
8;Barcelona;13;Barcelonès;08019;Barcelona;3;177;U;;493;309;184;1;2;306;308
8;Barcelona;13;Barcelonès;08019;Barcelona;3;178;U;;678;455;223;2;4;449;453
8;Barcelona;13;Barcelonès;08019;Barcelona;3;179;U;;878;542;336;3;13;526;539
8;Barcelona;13;Barcelonès;08019;Barcelona;3;18;U;;565;342;223;0;2;340;342
8;Barcelona;13;Barcelonès;08019;Barcelona;3;180;U;;666;408;258;2;7;399;406
8;Barcelona;13;Barcelonès;08019;Barcelona;3;182;U;;477;306;171;0;3;303;306
8;Barcelona;13;Barcelonès;08019;Barcelona;3;183;U;;732;445;287;2;1;442;443
8;Barcelona;13;Barcelonès;08019;Barcelona;3;184;U;;635;435;200;2;9;424;433
8;Barcelona;13;Barcelonès;08019;Barcelona;3;185;U;;741;470;271;0;2;468;470
8;Barcelona;13;Barcelonès;08019;Barcelona;3;186;U;;566;394;172;0;8;386;394
8;Barcelona;13;Barcelonès;08019;Barcelona;3;188;U;;546;382;164;0;2;380;382
8;Barcelona;13;Barcelonès;08019;Barcelona;3;189;U;;755;479;276;0;3;476;479
8;Barcelona;13;Barcelonès;08019;Barcelona;3;19;U;;525;350;175;1;2;347;349
8;Barcelona;13;Barcelonès;08019;Barcelona;3;191;U;;943;653;290;2;6;645;651
8;Barcelona;13;Barcelonès;08019;Barcelona;3;192;U;;564;376;188;0;2;374;376
8;Barcelona;13;Barcelonès;08019;Barcelona;3;193;A;;767;515;252;1;7;507;514
8;Barcelona;13;Barcelonès;08019;Barcelona;3;193;B;;663;427;236;0;6;421;427
8;Barcelona;13;Barcelonès;08019;Barcelona;3;195;U;;483;315;168;0;1;314;315
8;Barcelona;13;Barcelonès;08019;Barcelona;3;196;U;;688;453;235;0;5;448;453
8;Barcelona;13;Barcelonès;08019;Barcelona;3;197;U;;500;304;196;0;3;301;304
8;Barcelona;13;Barcelonès;08019;Barcelona;3;198;U;;1112;727;385;4;3;720;723
8;Barcelona;13;Barcelonès;08019;Barcelona;3;199;U;;526;322;204;0;7;315;322
8;Barcelona;13;Barcelonès;08019;Barcelona;3;20;U;;588;396;192;0;4;392;396
8;Barcelona;13;Barcelonès;08019;Barcelona;3;200;U;;784;462;322;1;5;456;461
8;Barcelona;13;Barcelonès;08019;Barcelona;3;201;A;;632;426;206;1;9;416;425
8;Barcelona;13;Barcelonès;08019;Barcelona;3;201;B;;596;384;212;1;0;383;383
8;Barcelona;13;Barcelonès;08019;Barcelona;3;202;U;;1149;775;374;2;9;764;773
8;Barcelona;13;Barcelonès;08019;Barcelona;3;204;U;;828;525;303;0;8;517;525
8;Barcelona;13;Barcelonès;08019;Barcelona;3;205;U;;852;586;266;1;3;582;585
8;Barcelona;13;Barcelonès;08019;Barcelona;3;207;U;;816;534;282;1;5;528;533
8;Barcelona;13;Barcelonès;08019;Barcelona;3;208;U;;678;480;198;0;5;475;480
8;Barcelona;13;Barcelonès;08019;Barcelona;3;209;U;;873;615;258;0;3;612;615
8;Barcelona;13;Barcelonès;08019;Barcelona;3;210;U;;977;632;345;0;3;629;632
8;Barcelona;13;Barcelonès;08019;Barcelona;3;22;U;;714;442;272;0;0;442;442
8;Barcelona;13;Barcelonès;08019;Barcelona;3;23;U;;1135;685;450;2;2;681;683
8;Barcelona;13;Barcelonès;08019;Barcelona;3;24;U;;515;337;178;0;2;335;337
8;Barcelona;13;Barcelonès;08019;Barcelona;3;25;U;;765;446;319;0;8;438;446
8;Barcelona;13;Barcelonès;08019;Barcelona;3;26;U;;451;294;157;0;1;293;294
8;Barcelona;13;Barcelonès;08019;Barcelona;3;29;U;;561;333;228;1;7;325;332
8;Barcelona;13;Barcelonès;08019;Barcelona;3;3;U;;767;486;281;3;3;480;483
8;Barcelona;13;Barcelonès;08019;Barcelona;3;30;U;;815;495;320;2;2;491;493
8;Barcelona;13;Barcelonès;08019;Barcelona;3;32;U;;811;484;327;3;0;481;481
8;Barcelona;13;Barcelonès;08019;Barcelona;3;33;U;;606;352;254;1;0;351;351
8;Barcelona;13;Barcelonès;08019;Barcelona;3;37;U;;665;403;262;1;1;401;402
8;Barcelona;13;Barcelonès;08019;Barcelona;3;38;U;;928;564;364;0;7;557;564
8;Barcelona;13;Barcelonès;08019;Barcelona;3;39;U;;844;538;306;0;6;532;538
8;Barcelona;13;Barcelonès;08019;Barcelona;3;4;U;;949;545;404;3;7;535;542
8;Barcelona;13;Barcelonès;08019;Barcelona;3;41;U;;549;327;222;0;3;324;327
8;Barcelona;13;Barcelonès;08019;Barcelona;3;42;U;;583;355;228;0;4;351;355
8;Barcelona;13;Barcelonès;08019;Barcelona;3;43;U;;823;554;269;0;3;551;554
8;Barcelona;13;Barcelonès;08019;Barcelona;3;45;U;;737;410;327;0;3;407;410
8;Barcelona;13;Barcelonès;08019;Barcelona;3;47;U;;662;391;271;0;7;384;391
8;Barcelona;13;Barcelonès;08019;Barcelona;3;48;U;;800;488;312;0;4;484;488
8;Barcelona;13;Barcelonès;08019;Barcelona;3;49;U;;613;355;258;3;0;352;352
8;Barcelona;13;Barcelonès;08019;Barcelona;3;50;U;;938;606;332;0;3;603;606
8;Barcelona;13;Barcelonès;08019;Barcelona;3;53;U;;479;320;159;1;2;317;319
8;Barcelona;13;Barcelonès;08019;Barcelona;3;55;U;;680;415;265;1;6;408;414
8;Barcelona;13;Barcelonès;08019;Barcelona;3;56;U;;513;315;198;0;5;310;315
8;Barcelona;13;Barcelonès;08019;Barcelona;3;57;A;;200;85;115;1;1;83;84
8;Barcelona;13;Barcelonès;08019;Barcelona;3;57;B;;187;91;96;0;0;91;91
8;Barcelona;13;Barcelonès;08019;Barcelona;3;6;U;;664;394;270;1;7;386;393
8;Barcelona;13;Barcelonès;08019;Barcelona;3;61;U;;1099;393;706;0;2;391;393
8;Barcelona;13;Barcelonès;08019;Barcelona;3;65;U;;670;418;252;0;3;415;418
8;Barcelona;13;Barcelonès;08019;Barcelona;3;66;U;;745;464;281;0;5;459;464
8;Barcelona;13;Barcelonès;08019;Barcelona;3;67;U;;527;359;168;9;2;348;350
8;Barcelona;13;Barcelonès;08019;Barcelona;3;68;A;;707;469;238;3;3;463;466
8;Barcelona;13;Barcelonès;08019;Barcelona;3;68;B;;674;437;237;0;7;430;437
8;Barcelona;13;Barcelonès;08019;Barcelona;3;69;A;;1037;650;387;1;10;639;649
8;Barcelona;13;Barcelonès;08019;Barcelona;3;69;B;;908;568;340;0;7;561;568
8;Barcelona;13;Barcelonès;08019;Barcelona;3;7;U;;457;255;202;3;3;249;252
8;Barcelona;13;Barcelonès;08019;Barcelona;3;71;A;;904;592;312;1;7;584;591
8;Barcelona;13;Barcelonès;08019;Barcelona;3;71;B;;801;526;275;2;4;520;524
8;Barcelona;13;Barcelonès;08019;Barcelona;3;72;A;;749;469;280;1;8;460;468
8;Barcelona;13;Barcelonès;08019;Barcelona;3;72;B;;1032;642;390;0;3;639;642
8;Barcelona;13;Barcelonès;08019;Barcelona;3;72;C;;1161;724;437;1;10;713;723
8;Barcelona;13;Barcelonès;08019;Barcelona;3;72;D;;851;521;330;2;1;518;519
8;Barcelona;13;Barcelonès;08019;Barcelona;3;72;E;;897;537;360;0;8;529;537
8;Barcelona;13;Barcelonès;08019;Barcelona;3;72;F;;793;486;307;2;3;481;484
8;Barcelona;13;Barcelonès;08019;Barcelona;3;73;A;;1176;695;481;0;13;682;695
8;Barcelona;13;Barcelonès;08019;Barcelona;3;73;B;;1056;628;428;1;10;617;627
8;Barcelona;13;Barcelonès;08019;Barcelona;3;74;A;;765;410;355;0;3;407;410
8;Barcelona;13;Barcelonès;08019;Barcelona;3;74;B;;875;499;376;5;0;494;494
8;Barcelona;13;Barcelonès;08019;Barcelona;3;74;C;;815;450;365;0;2;448;450
8;Barcelona;13;Barcelonès;08019;Barcelona;3;75;A;;823;446;377;2;0;444;444
8;Barcelona;13;Barcelonès;08019;Barcelona;3;75;B;;713;359;354;0;3;356;359
8;Barcelona;13;Barcelonès;08019;Barcelona;3;76;U;;790;471;319;0;12;459;471
8;Barcelona;13;Barcelonès;08019;Barcelona;3;77;U;;944;461;483;1;4;456;460
8;Barcelona;13;Barcelonès;08019;Barcelona;3;78;U;;747;312;435;0;1;311;312
8;Barcelona;13;Barcelonès;08019;Barcelona;3;8;U;;888;525;363;3;2;520;522
8;Barcelona;13;Barcelonès;08019;Barcelona;3;80;U;;692;376;316;3;1;372;373
8;Barcelona;13;Barcelonès;08019;Barcelona;3;82;A;;838;510;328;2;7;501;508
8;Barcelona;13;Barcelonès;08019;Barcelona;3;82;B;;687;443;244;1;7;435;442
8;Barcelona;13;Barcelonès;08019;Barcelona;3;83;U;;897;546;351;2;10;534;544
8;Barcelona;13;Barcelonès;08019;Barcelona;3;84;U;;555;361;194;1;1;359;360
8;Barcelona;13;Barcelonès;08019;Barcelona;3;85;U;;776;522;254;0;5;517;522
8;Barcelona;13;Barcelonès;08019;Barcelona;3;86;U;;775;482;293;1;5;476;481
8;Barcelona;13;Barcelonès;08019;Barcelona;3;87;U;;556;339;217;2;6;331;337
8;Barcelona;13;Barcelonès;08019;Barcelona;3;88;U;;751;514;237;5;1;508;509
8;Barcelona;13;Barcelonès;08019;Barcelona;3;89;U;;434;295;139;0;3;292;295
8;Barcelona;13;Barcelonès;08019;Barcelona;3;90;U;;592;380;212;0;4;376;380
8;Barcelona;13;Barcelonès;08019;Barcelona;3;91;U;;1130;802;328;0;9;793;802
8;Barcelona;13;Barcelonès;08019;Barcelona;3;92;U;;531;356;175;2;7;347;354
8;Barcelona;13;Barcelonès;08019;Barcelona;3;93;U;;552;360;192;0;0;360;360
8;Barcelona;13;Barcelonès;08019;Barcelona;3;94;U;;568;344;224;0;2;342;344
8;Barcelona;13;Barcelonès;08019;Barcelona;3;95;U;;636;388;248;1;8;379;387
8;Barcelona;13;Barcelonès;08019;Barcelona;3;97;U;;585;391;194;3;3;385;388
8;Barcelona;13;Barcelonès;08019;Barcelona;3;98;U;;1002;593;409;1;4;588;592
8;Barcelona;13;Barcelonès;08019;Barcelona;4;1;U;;709;525;184;1;6;518;524
8;Barcelona;13;Barcelonès;08019;Barcelona;4;10;A;;804;623;181;2;10;611;621
8;Barcelona;13;Barcelonès;08019;Barcelona;4;10;B;;776;582;194;0;4;578;582
8;Barcelona;13;Barcelonès;08019;Barcelona;4;10;C;;855;637;218;2;14;621;635
8;Barcelona;13;Barcelonès;08019;Barcelona;4;11;A;;772;564;208;2;4;558;562
8;Barcelona;13;Barcelonès;08019;Barcelona;4;11;B;;718;523;195;0;10;513;523
8;Barcelona;13;Barcelonès;08019;Barcelona;4;12;U;;512;348;164;0;2;346;348
8;Barcelona;13;Barcelonès;08019;Barcelona;4;13;U;;896;565;331;1;6;558;564
8;Barcelona;13;Barcelonès;08019;Barcelona;4;14;U;;635;421;214;0;7;414;421
8;Barcelona;13;Barcelonès;08019;Barcelona;4;15;U;;557;337;220;0;0;337;337
8;Barcelona;13;Barcelonès;08019;Barcelona;4;16;A;;761;485;276;0;0;485;485
8;Barcelona;13;Barcelonès;08019;Barcelona;4;16;B;;744;461;283;0;6;455;461
8;Barcelona;13;Barcelonès;08019;Barcelona;4;17;U;;446;255;191;0;0;255;255
8;Barcelona;13;Barcelonès;08019;Barcelona;4;18;U;;1113;789;324;0;8;781;789
8;Barcelona;13;Barcelonès;08019;Barcelona;4;19;A;;978;750;228;1;5;744;749
8;Barcelona;13;Barcelonès;08019;Barcelona;4;19;B;;857;638;219;3;6;629;635
8;Barcelona;13;Barcelonès;08019;Barcelona;4;2;U;;653;469;184;0;6;463;469
8;Barcelona;13;Barcelonès;08019;Barcelona;4;20;A;;808;626;182;1;4;621;625
8;Barcelona;13;Barcelonès;08019;Barcelona;4;20;B;;738;562;176;0;5;557;562
8;Barcelona;13;Barcelonès;08019;Barcelona;4;21;U;;1085;863;222;0;10;853;863
8;Barcelona;13;Barcelonès;08019;Barcelona;4;22;U;;785;588;197;3;8;577;585
8;Barcelona;13;Barcelonès;08019;Barcelona;4;23;U;;566;418;148;1;7;410;417
8;Barcelona;13;Barcelonès;08019;Barcelona;4;24;U;;824;620;204;0;2;618;620
8;Barcelona;13;Barcelonès;08019;Barcelona;4;25;U;;563;413;150;1;10;402;412
8;Barcelona;13;Barcelonès;08019;Barcelona;4;26;U;;754;547;207;1;11;535;546
8;Barcelona;13;Barcelonès;08019;Barcelona;4;27;U;;681;460;221;1;6;453;459
8;Barcelona;13;Barcelonès;08019;Barcelona;4;28;U;;717;491;226;1;7;483;490
8;Barcelona;13;Barcelonès;08019;Barcelona;4;29;U;;976;685;291;2;6;677;683
8;Barcelona;13;Barcelonès;08019;Barcelona;4;3;U;;495;343;152;3;1;339;340
8;Barcelona;13;Barcelonès;08019;Barcelona;4;30;U;;765;533;232;0;1;532;533
8;Barcelona;13;Barcelonès;08019;Barcelona;4;32;U;;771;514;257;0;7;507;514
8;Barcelona;13;Barcelonès;08019;Barcelona;4;33;U;;773;538;235;0;6;532;538
8;Barcelona;13;Barcelonès;08019;Barcelona;4;34;U;;880;651;229;2;8;641;649
8;Barcelona;13;Barcelonès;08019;Barcelona;4;35;U;;920;631;289;0;5;626;631
8;Barcelona;13;Barcelonès;08019;Barcelona;4;36;U;;650;464;186;1;3;460;463
8;Barcelona;13;Barcelonès;08019;Barcelona;4;37;U;;1073;803;270;0;7;796;803
8;Barcelona;13;Barcelonès;08019;Barcelona;4;38;U;;656;464;192;0;1;463;464
8;Barcelona;13;Barcelonès;08019;Barcelona;4;39;U;;705;517;188;2;3;512;515
8;Barcelona;13;Barcelonès;08019;Barcelona;4;4;U;;707;517;190;0;6;511;517
8;Barcelona;13;Barcelonès;08019;Barcelona;4;40;A;;726;555;171;1;9;545;554
8;Barcelona;13;Barcelonès;08019;Barcelona;4;40;B;;756;553;203;1;5;547;552
8;Barcelona;13;Barcelonès;08019;Barcelona;4;41;A;;651;485;166;1;5;479;484
8;Barcelona;13;Barcelonès;08019;Barcelona;4;41;B;;599;426;173;1;7;418;425
8;Barcelona;13;Barcelonès;08019;Barcelona;4;42;A;;776;578;198;0;5;573;578
8;Barcelona;13;Barcelonès;08019;Barcelona;4;42;B;;688;541;147;1;3;537;540
8;Barcelona;13;Barcelonès;08019;Barcelona;4;43;U;;640;462;178;0;4;458;462
8;Barcelona;13;Barcelonès;08019;Barcelona;4;44;U;;927;687;240;1;2;684;686
8;Barcelona;13;Barcelonès;08019;Barcelona;4;45;U;;1082;704;378;0;1;703;704
8;Barcelona;13;Barcelonès;08019;Barcelona;4;48;U;;1042;771;271;1;8;762;770
8;Barcelona;13;Barcelonès;08019;Barcelona;4;5;U;;702;477;225;1;3;473;476
8;Barcelona;13;Barcelonès;08019;Barcelona;4;50;U;;696;520;176;1;4;515;519
8;Barcelona;13;Barcelonès;08019;Barcelona;4;51;U;;459;339;120;0;2;337;339
8;Barcelona;13;Barcelonès;08019;Barcelona;4;52;U;;734;520;214;0;3;517;520
8;Barcelona;13;Barcelonès;08019;Barcelona;4;53;U;;1035;789;246;2;8;779;787
8;Barcelona;13;Barcelonès;08019;Barcelona;4;54;U;;857;652;205;0;8;644;652
8;Barcelona;13;Barcelonès;08019;Barcelona;4;55;U;;577;429;148;0;4;425;429
8;Barcelona;13;Barcelonès;08019;Barcelona;4;57;U;;975;664;311;0;9;655;664
8;Barcelona;13;Barcelonès;08019;Barcelona;4;58;U;;615;440;175;0;3;437;440
8;Barcelona;13;Barcelonès;08019;Barcelona;4;6;U;;602;406;196;1;6;399;405
8;Barcelona;13;Barcelonès;08019;Barcelona;4;60;U;;599;432;167;0;4;428;432
8;Barcelona;13;Barcelonès;08019;Barcelona;4;61;U;;545;405;140;2;0;403;403
8;Barcelona;13;Barcelonès;08019;Barcelona;4;62;U;;539;406;133;0;6;400;406
8;Barcelona;13;Barcelonès;08019;Barcelona;4;63;U;;803;601;202;0;4;597;601
8;Barcelona;13;Barcelonès;08019;Barcelona;4;65;U;;1033;780;253;0;8;772;780
8;Barcelona;13;Barcelonès;08019;Barcelona;4;66;U;;1105;857;248;0;10;847;857
8;Barcelona;13;Barcelonès;08019;Barcelona;4;68;U;;599;440;159;2;4;434;438
8;Barcelona;13;Barcelonès;08019;Barcelona;4;69;U;;996;743;253;3;10;730;740
8;Barcelona;13;Barcelonès;08019;Barcelona;4;7;A;;833;619;214;0;4;615;619
8;Barcelona;13;Barcelonès;08019;Barcelona;4;7;B;;704;506;198;3;4;499;503
8;Barcelona;13;Barcelonès;08019;Barcelona;4;71;A;;890;687;203;3;5;679;684
8;Barcelona;13;Barcelonès;08019;Barcelona;4;71;B;;717;562;155;1;2;559;561
8;Barcelona;13;Barcelonès;08019;Barcelona;4;73;U;;1129;858;271;0;9;849;858
8;Barcelona;13;Barcelonès;08019;Barcelona;4;74;A;;666;510;156;0;4;506;510
8;Barcelona;13;Barcelonès;08019;Barcelona;4;74;B;;582;438;144;2;4;432;436
8;Barcelona;13;Barcelonès;08019;Barcelona;4;75;U;;465;340;125;0;3;337;340
8;Barcelona;13;Barcelonès;08019;Barcelona;4;76;U;;1144;884;260;0;11;873;884
8;Barcelona;13;Barcelonès;08019;Barcelona;4;77;A;;796;612;184;0;6;606;612
8;Barcelona;13;Barcelonès;08019;Barcelona;4;77;B;;652;490;162;0;5;485;490
8;Barcelona;13;Barcelonès;08019;Barcelona;4;78;U;;850;576;274;1;2;573;575
8;Barcelona;13;Barcelonès;08019;Barcelona;4;79;U;;888;700;188;1;6;693;699
8;Barcelona;13;Barcelonès;08019;Barcelona;4;8;U;;915;640;275;0;6;634;640
8;Barcelona;13;Barcelonès;08019;Barcelona;4;81;U;;936;663;273;0;14;649;663
8;Barcelona;13;Barcelonès;08019;Barcelona;4;82;U;;699;516;183;0;4;512;516
8;Barcelona;13;Barcelonès;08019;Barcelona;4;83;A;;1149;843;306;0;8;835;843
8;Barcelona;13;Barcelonès;08019;Barcelona;4;83;B;;1034;805;229;1;7;797;804
8;Barcelona;13;Barcelonès;08019;Barcelona;5;1;U;;743;564;179;1;8;555;563
8;Barcelona;13;Barcelonès;08019;Barcelona;5;10;U;;658;461;197;1;4;456;460
8;Barcelona;13;Barcelonès;08019;Barcelona;5;100;U;;626;467;159;0;4;463;467
8;Barcelona;13;Barcelonès;08019;Barcelona;5;101;U;;540;344;196;0;1;343;344
8;Barcelona;13;Barcelonès;08019;Barcelona;5;102;U;;821;628;193;3;3;622;625
8;Barcelona;13;Barcelonès;08019;Barcelona;5;103;U;;489;374;115;0;5;369;374
8;Barcelona;13;Barcelonès;08019;Barcelona;5;104;U;;713;521;192;0;10;511;521
8;Barcelona;13;Barcelonès;08019;Barcelona;5;105;U;;1216;934;282;0;17;917;934
8;Barcelona;13;Barcelonès;08019;Barcelona;5;106;U;;746;575;171;2;5;568;573
8;Barcelona;13;Barcelonès;08019;Barcelona;5;107;U;;804;596;208;0;17;579;596
8;Barcelona;13;Barcelonès;08019;Barcelona;5;109;U;;635;496;139;2;6;488;494
8;Barcelona;13;Barcelonès;08019;Barcelona;5;11;U;;986;716;270;1;11;704;715
8;Barcelona;13;Barcelonès;08019;Barcelona;5;110;U;;1067;792;275;3;12;777;789
8;Barcelona;13;Barcelonès;08019;Barcelona;5;112;A;;688;501;187;1;6;494;500
8;Barcelona;13;Barcelonès;08019;Barcelona;5;112;B;;634;462;172;1;5;456;461
8;Barcelona;13;Barcelonès;08019;Barcelona;5;115;U;;923;654;269;0;9;645;654
8;Barcelona;13;Barcelonès;08019;Barcelona;5;117;U;;1017;778;239;1;6;771;777
8;Barcelona;13;Barcelonès;08019;Barcelona;5;118;U;;899;683;216;0;8;675;683
8;Barcelona;13;Barcelonès;08019;Barcelona;5;120;U;;769;536;233;0;5;531;536
8;Barcelona;13;Barcelonès;08019;Barcelona;5;121;U;;658;482;176;0;8;474;482
8;Barcelona;13;Barcelonès;08019;Barcelona;5;122;U;;929;684;245;0;12;672;684
8;Barcelona;13;Barcelonès;08019;Barcelona;5;124;U;;499;388;111;0;4;384;388
8;Barcelona;13;Barcelonès;08019;Barcelona;5;125;U;;479;317;162;0;4;313;317
8;Barcelona;13;Barcelonès;08019;Barcelona;5;126;U;;541;409;132;1;6;402;408
8;Barcelona;13;Barcelonès;08019;Barcelona;5;127;U;;496;371;125;0;3;368;371
8;Barcelona;13;Barcelonès;08019;Barcelona;5;129;U;;512;393;119;0;5;388;393
8;Barcelona;13;Barcelonès;08019;Barcelona;5;13;U;;803;525;278;1;3;521;524
8;Barcelona;13;Barcelonès;08019;Barcelona;5;131;U;;838;650;188;2;5;643;648
8;Barcelona;13;Barcelonès;08019;Barcelona;5;133;U;;890;688;202;1;7;680;687
8;Barcelona;13;Barcelonès;08019;Barcelona;5;134;U;;562;447;115;0;3;444;447
8;Barcelona;13;Barcelonès;08019;Barcelona;5;135;U;;1001;784;217;1;8;775;783
8;Barcelona;13;Barcelonès;08019;Barcelona;5;136;U;;755;610;145;0;7;603;610
8;Barcelona;13;Barcelonès;08019;Barcelona;5;137;U;;562;456;106;1;4;451;455
8;Barcelona;13;Barcelonès;08019;Barcelona;5;138;U;;630;495;135;0;11;484;495
8;Barcelona;13;Barcelonès;08019;Barcelona;5;139;U;;823;642;181;0;13;629;642
8;Barcelona;13;Barcelonès;08019;Barcelona;5;14;U;;548;392;156;0;5;387;392
8;Barcelona;13;Barcelonès;08019;Barcelona;5;140;U;;949;727;222;0;13;714;727
8;Barcelona;13;Barcelonès;08019;Barcelona;5;141;U;;817;583;234;1;10;572;582
8;Barcelona;13;Barcelonès;08019;Barcelona;5;144;U;;672;515;157;0;3;512;515
8;Barcelona;13;Barcelonès;08019;Barcelona;5;145;U;;766;609;157;0;7;602;609
8;Barcelona;13;Barcelonès;08019;Barcelona;5;146;U;;687;498;189;0;6;492;498
8;Barcelona;13;Barcelonès;08019;Barcelona;5;147;U;;673;502;171;1;10;491;501
8;Barcelona;13;Barcelonès;08019;Barcelona;5;148;A;;618;501;117;0;6;495;501
8;Barcelona;13;Barcelonès;08019;Barcelona;5;148;B;;594;482;112;0;8;474;482
8;Barcelona;13;Barcelonès;08019;Barcelona;5;149;A;;660;480;180;0;5;475;480
8;Barcelona;13;Barcelonès;08019;Barcelona;5;149;B;;616;435;181;1;2;432;434
8;Barcelona;13;Barcelonès;08019;Barcelona;5;15;U;;886;665;221;0;8;657;665
8;Barcelona;13;Barcelonès;08019;Barcelona;5;152;U;;474;322;152;1;9;312;321
8;Barcelona;13;Barcelonès;08019;Barcelona;5;153;U;;557;419;138;2;5;412;417
8;Barcelona;13;Barcelonès;08019;Barcelona;5;154;U;;605;459;146;1;4;454;458
8;Barcelona;13;Barcelonès;08019;Barcelona;5;155;U;;527;418;109;0;3;415;418
8;Barcelona;13;Barcelonès;08019;Barcelona;5;156;U;;826;671;155;2;7;662;669
8;Barcelona;13;Barcelonès;08019;Barcelona;5;157;U;;663;510;153;0;9;501;510
8;Barcelona;13;Barcelonès;08019;Barcelona;5;158;U;;772;603;169;1;6;596;602
8;Barcelona;13;Barcelonès;08019;Barcelona;5;16;U;;830;631;199;1;8;622;630
8;Barcelona;13;Barcelonès;08019;Barcelona;5;160;U;;1027;756;271;1;12;743;755
8;Barcelona;13;Barcelonès;08019;Barcelona;5;161;U;;737;554;183;1;5;548;553
8;Barcelona;13;Barcelonès;08019;Barcelona;5;162;U;;950;685;265;0;9;676;685
8;Barcelona;13;Barcelonès;08019;Barcelona;5;164;U;;520;371;149;2;7;362;369
8;Barcelona;13;Barcelonès;08019;Barcelona;5;165;U;;610;494;116;0;6;488;494
8;Barcelona;13;Barcelonès;08019;Barcelona;5;166;U;;684;510;174;0;6;504;510
8;Barcelona;13;Barcelonès;08019;Barcelona;5;168;U;;572;451;121;1;7;443;450
8;Barcelona;13;Barcelonès;08019;Barcelona;5;169;U;;873;672;201;1;5;666;671
8;Barcelona;13;Barcelonès;08019;Barcelona;5;170;U;;653;483;170;1;4;478;482
8;Barcelona;13;Barcelonès;08019;Barcelona;5;171;U;;1162;935;227;0;7;928;935
8;Barcelona;13;Barcelonès;08019;Barcelona;5;174;U;;512;336;176;0;1;335;336
8;Barcelona;13;Barcelonès;08019;Barcelona;5;175;U;;1061;773;288;1;6;766;772
8;Barcelona;13;Barcelonès;08019;Barcelona;5;177;U;;517;408;109;0;3;405;408
8;Barcelona;13;Barcelonès;08019;Barcelona;5;178;U;;862;623;239;0;6;617;623
8;Barcelona;13;Barcelonès;08019;Barcelona;5;18;U;;626;469;157;1;7;461;468
8;Barcelona;13;Barcelonès;08019;Barcelona;5;180;U;;624;495;129;1;10;484;494
8;Barcelona;13;Barcelonès;08019;Barcelona;5;182;U;;1073;776;297;4;4;768;772
8;Barcelona;13;Barcelonès;08019;Barcelona;5;183;U;;754;476;278;0;5;471;476
8;Barcelona;13;Barcelonès;08019;Barcelona;5;19;U;;501;383;118;4;2;377;379
8;Barcelona;13;Barcelonès;08019;Barcelona;5;2;U;;523;389;134;0;2;387;389
8;Barcelona;13;Barcelonès;08019;Barcelona;5;20;U;;514;372;142;0;3;369;372
8;Barcelona;13;Barcelonès;08019;Barcelona;5;21;U;;470;369;101;1;7;361;368
8;Barcelona;13;Barcelonès;08019;Barcelona;5;23;U;;547;392;155;0;3;389;392
8;Barcelona;13;Barcelonès;08019;Barcelona;5;24;U;;519;419;100;0;3;416;419
8;Barcelona;13;Barcelonès;08019;Barcelona;5;25;U;;567;408;159;0;3;405;408
8;Barcelona;13;Barcelonès;08019;Barcelona;5;27;U;;592;425;167;1;5;419;424
8;Barcelona;13;Barcelonès;08019;Barcelona;5;28;U;;540;395;145;2;4;389;393
8;Barcelona;13;Barcelonès;08019;Barcelona;5;29;U;;981;768;213;0;8;760;768
8;Barcelona;13;Barcelonès;08019;Barcelona;5;3;A;;848;657;191;1;6;650;656
8;Barcelona;13;Barcelonès;08019;Barcelona;5;3;B;;775;595;180;0;13;582;595
8;Barcelona;13;Barcelonès;08019;Barcelona;5;31;U;;716;540;176;0;4;536;540
8;Barcelona;13;Barcelonès;08019;Barcelona;5;32;U;;489;379;110;1;5;373;378
8;Barcelona;13;Barcelonès;08019;Barcelona;5;33;U;;438;336;102;0;5;331;336
8;Barcelona;13;Barcelonès;08019;Barcelona;5;34;U;;641;486;155;1;6;479;485
8;Barcelona;13;Barcelonès;08019;Barcelona;5;35;U;;1005;693;312;0;7;686;693
8;Barcelona;13;Barcelonès;08019;Barcelona;5;37;U;;692;499;193;0;4;495;499
8;Barcelona;13;Barcelonès;08019;Barcelona;5;38;U;;471;352;119;0;4;348;352
8;Barcelona;13;Barcelonès;08019;Barcelona;5;39;U;;956;706;250;0;8;698;706
8;Barcelona;13;Barcelonès;08019;Barcelona;5;4;U;;852;647;205;0;6;641;647
8;Barcelona;13;Barcelonès;08019;Barcelona;5;40;U;;504;406;98;1;8;397;405
8;Barcelona;13;Barcelonès;08019;Barcelona;5;41;U;;870;646;224;0;9;637;646
8;Barcelona;13;Barcelonès;08019;Barcelona;5;42;U;;706;545;161;2;2;541;543
8;Barcelona;13;Barcelonès;08019;Barcelona;5;43;U;;1055;851;204;0;16;835;851
8;Barcelona;13;Barcelonès;08019;Barcelona;5;45;U;;500;373;127;0;0;373;373
8;Barcelona;13;Barcelonès;08019;Barcelona;5;46;U;;605;448;157;0;7;441;448
8;Barcelona;13;Barcelonès;08019;Barcelona;5;47;U;;659;494;165;0;7;487;494
8;Barcelona;13;Barcelonès;08019;Barcelona;5;48;U;;1038;776;262;2;18;756;774
8;Barcelona;13;Barcelonès;08019;Barcelona;5;49;U;;554;411;143;0;4;407;411
8;Barcelona;13;Barcelonès;08019;Barcelona;5;5;U;;869;673;196;0;11;662;673
8;Barcelona;13;Barcelonès;08019;Barcelona;5;50;U;;564;408;156;0;6;402;408
8;Barcelona;13;Barcelonès;08019;Barcelona;5;52;U;;667;524;143;0;8;516;524
8;Barcelona;13;Barcelonès;08019;Barcelona;5;53;U;;495;384;111;0;6;378;384
8;Barcelona;13;Barcelonès;08019;Barcelona;5;54;U;;667;484;183;0;7;477;484
8;Barcelona;13;Barcelonès;08019;Barcelona;5;55;U;;838;632;206;1;17;614;631
8;Barcelona;13;Barcelonès;08019;Barcelona;5;56;U;;535;406;129;0;5;401;406
8;Barcelona;13;Barcelonès;08019;Barcelona;5;57;U;;559;436;123;1;3;432;435
8;Barcelona;13;Barcelonès;08019;Barcelona;5;58;U;;795;593;202;0;13;580;593
8;Barcelona;13;Barcelonès;08019;Barcelona;5;59;U;;463;372;91;0;5;367;372
8;Barcelona;13;Barcelonès;08019;Barcelona;5;6;U;;961;723;238;0;0;723;723
8;Barcelona;13;Barcelonès;08019;Barcelona;5;60;U;;677;507;170;1;3;503;506
8;Barcelona;13;Barcelonès;08019;Barcelona;5;61;U;;712;547;165;0;7;540;547
8;Barcelona;13;Barcelonès;08019;Barcelona;5;62;U;;654;509;145;1;5;503;508
8;Barcelona;13;Barcelonès;08019;Barcelona;5;64;U;;594;424;170;0;3;421;424
8;Barcelona;13;Barcelonès;08019;Barcelona;5;65;U;;870;624;246;1;12;611;623
8;Barcelona;13;Barcelonès;08019;Barcelona;5;67;U;;834;616;218;0;6;610;616
8;Barcelona;13;Barcelonès;08019;Barcelona;5;68;U;;468;314;154;0;6;308;314
8;Barcelona;13;Barcelonès;08019;Barcelona;5;69;U;;1107;789;318;2;2;785;787
8;Barcelona;13;Barcelonès;08019;Barcelona;5;70;U;;611;459;152;1;3;455;458
8;Barcelona;13;Barcelonès;08019;Barcelona;5;72;U;;666;500;166;1;2;497;499
8;Barcelona;13;Barcelonès;08019;Barcelona;5;73;U;;1008;770;238;1;12;757;769
8;Barcelona;13;Barcelonès;08019;Barcelona;5;75;U;;656;487;169;0;4;483;487
8;Barcelona;13;Barcelonès;08019;Barcelona;5;76;U;;575;447;128;1;5;441;446
8;Barcelona;13;Barcelonès;08019;Barcelona;5;77;U;;992;766;226;0;6;760;766
8;Barcelona;13;Barcelonès;08019;Barcelona;5;79;U;;661;501;160;1;2;498;500
8;Barcelona;13;Barcelonès;08019;Barcelona;5;8;U;;501;355;146;1;6;348;354
8;Barcelona;13;Barcelonès;08019;Barcelona;5;80;U;;949;682;267;0;4;678;682
8;Barcelona;13;Barcelonès;08019;Barcelona;5;81;U;;507;340;167;0;1;339;340
8;Barcelona;13;Barcelonès;08019;Barcelona;5;82;U;;806;594;212;1;7;586;593
8;Barcelona;13;Barcelonès;08019;Barcelona;5;84;A;;699;529;170;0;9;520;529
8;Barcelona;13;Barcelonès;08019;Barcelona;5;84;B;;640;488;152;0;3;485;488
8;Barcelona;13;Barcelonès;08019;Barcelona;5;86;U;;789;583;206;2;8;573;581
8;Barcelona;13;Barcelonès;08019;Barcelona;5;87;U;;517;398;119;1;3;394;397
8;Barcelona;13;Barcelonès;08019;Barcelona;5;88;U;;548;401;147;0;3;398;401
8;Barcelona;13;Barcelonès;08019;Barcelona;5;89;U;;795;594;201;1;6;587;593
8;Barcelona;13;Barcelonès;08019;Barcelona;5;90;U;;703;537;166;0;5;532;537
8;Barcelona;13;Barcelonès;08019;Barcelona;5;91;A;;959;724;235;2;10;712;722
8;Barcelona;13;Barcelonès;08019;Barcelona;5;91;B;;992;732;260;2;7;723;730
8;Barcelona;13;Barcelonès;08019;Barcelona;5;93;U;;495;389;106;0;5;384;389
8;Barcelona;13;Barcelonès;08019;Barcelona;5;94;U;;476;345;131;1;3;341;344
8;Barcelona;13;Barcelonès;08019;Barcelona;5;95;U;;849;626;223;0;2;624;626
8;Barcelona;13;Barcelonès;08019;Barcelona;5;96;U;;651;490;161;1;9;480;489
8;Barcelona;13;Barcelonès;08019;Barcelona;5;97;A;;676;485;191;0;3;482;485
8;Barcelona;13;Barcelonès;08019;Barcelona;5;97;B;;611;463;148;0;5;458;463
8;Barcelona;13;Barcelonès;08019;Barcelona;5;98;U;;554;379;175;0;2;377;379
8;Barcelona;13;Barcelonès;08019;Barcelona;5;99;U;;530;406;124;0;8;398;406
8;Barcelona;13;Barcelonès;08019;Barcelona;6;1;A;;644;476;168;0;6;470;476
8;Barcelona;13;Barcelonès;08019;Barcelona;6;1;B;;525;375;150;0;1;374;375
8;Barcelona;13;Barcelonès;08019;Barcelona;6;10;U;;665;543;122;1;2;540;542
8;Barcelona;13;Barcelonès;08019;Barcelona;6;100;U;;724;508;216;1;6;501;507
8;Barcelona;13;Barcelonès;08019;Barcelona;6;102;U;;614;459;155;0;7;452;459
8;Barcelona;13;Barcelonès;08019;Barcelona;6;103;U;;806;590;216;2;4;584;588
8;Barcelona;13;Barcelonès;08019;Barcelona;6;104;U;;623;456;167;4;4;448;452
8;Barcelona;13;Barcelonès;08019;Barcelona;6;105;U;;673;472;201;1;1;470;471
8;Barcelona;13;Barcelonès;08019;Barcelona;6;106;U;;764;509;255;2;8;499;507
8;Barcelona;13;Barcelonès;08019;Barcelona;6;107;U;;959;707;252;1;4;702;706
8;Barcelona;13;Barcelonès;08019;Barcelona;6;109;U;;687;475;212;0;4;471;475
8;Barcelona;13;Barcelonès;08019;Barcelona;6;11;U;;898;580;318;0;4;576;580
8;Barcelona;13;Barcelonès;08019;Barcelona;6;110;U;;900;625;275;2;9;614;623
8;Barcelona;13;Barcelonès;08019;Barcelona;6;112;U;;850;617;233;0;7;610;617
8;Barcelona;13;Barcelonès;08019;Barcelona;6;113;U;;783;601;182;0;6;595;601
8;Barcelona;13;Barcelonès;08019;Barcelona;6;114;A;;854;622;232;0;3;619;622
8;Barcelona;13;Barcelonès;08019;Barcelona;6;114;B;;838;642;196;0;10;632;642
8;Barcelona;13;Barcelonès;08019;Barcelona;6;115;U;;1198;939;259;1;9;929;938
8;Barcelona;13;Barcelonès;08019;Barcelona;6;116;U;;556;420;136;2;3;415;418
8;Barcelona;13;Barcelonès;08019;Barcelona;6;117;U;;724;537;187;0;11;526;537
8;Barcelona;13;Barcelonès;08019;Barcelona;6;118;U;;786;565;221;2;1;562;563
8;Barcelona;13;Barcelonès;08019;Barcelona;6;119;U;;706;525;181;0;3;522;525
8;Barcelona;13;Barcelonès;08019;Barcelona;6;12;U;;484;312;172;0;0;312;312
8;Barcelona;13;Barcelonès;08019;Barcelona;6;120;U;;664;516;148;0;5;511;516
8;Barcelona;13;Barcelonès;08019;Barcelona;6;121;U;;669;467;202;2;3;462;465
8;Barcelona;13;Barcelonès;08019;Barcelona;6;122;U;;1100;829;271;0;5;824;829
8;Barcelona;13;Barcelonès;08019;Barcelona;6;124;U;;655;406;249;1;3;402;405
8;Barcelona;13;Barcelonès;08019;Barcelona;6;125;U;;548;387;161;0;2;385;387
8;Barcelona;13;Barcelonès;08019;Barcelona;6;127;U;;872;593;279;3;9;581;590
8;Barcelona;13;Barcelonès;08019;Barcelona;6;128;U;;876;648;228;3;7;638;645
8;Barcelona;13;Barcelonès;08019;Barcelona;6;129;U;;455;314;141;1;2;311;313
8;Barcelona;13;Barcelonès;08019;Barcelona;6;13;U;;564;367;197;0;3;364;367
8;Barcelona;13;Barcelonès;08019;Barcelona;6;130;U;;538;378;160;0;2;376;378
8;Barcelona;13;Barcelonès;08019;Barcelona;6;131;U;;737;446;291;2;2;442;444
8;Barcelona;13;Barcelonès;08019;Barcelona;6;132;U;;690;457;233;1;6;450;456
8;Barcelona;13;Barcelonès;08019;Barcelona;6;133;U;;671;466;205;1;3;462;465
8;Barcelona;13;Barcelonès;08019;Barcelona;6;134;A;;659;474;185;0;3;471;474
8;Barcelona;13;Barcelonès;08019;Barcelona;6;134;B;;673;511;162;0;3;508;511
8;Barcelona;13;Barcelonès;08019;Barcelona;6;136;U;;1109;761;348;4;4;753;757
8;Barcelona;13;Barcelonès;08019;Barcelona;6;137;U;;576;407;169;0;4;403;407
8;Barcelona;13;Barcelonès;08019;Barcelona;6;138;U;;796;531;265;1;4;526;530
8;Barcelona;13;Barcelonès;08019;Barcelona;6;139;U;;617;416;201;0;6;410;416
8;Barcelona;13;Barcelonès;08019;Barcelona;6;14;U;;792;514;278;2;6;506;512
8;Barcelona;13;Barcelonès;08019;Barcelona;6;140;U;;669;462;207;0;3;459;462
8;Barcelona;13;Barcelonès;08019;Barcelona;6;141;U;;569;406;163;0;3;403;406
8;Barcelona;13;Barcelonès;08019;Barcelona;6;142;U;;1101;724;377;4;11;709;720
8;Barcelona;13;Barcelonès;08019;Barcelona;6;144;U;;713;443;270;3;3;437;440
8;Barcelona;13;Barcelonès;08019;Barcelona;6;145;U;;999;600;399;3;5;592;597
8;Barcelona;13;Barcelonès;08019;Barcelona;6;146;U;;829;535;294;2;9;524;533
8;Barcelona;13;Barcelonès;08019;Barcelona;6;148;U;;600;373;227;0;3;370;373
8;Barcelona;13;Barcelonès;08019;Barcelona;6;149;U;;652;422;230;0;6;416;422
8;Barcelona;13;Barcelonès;08019;Barcelona;6;150;U;;1107;825;282;1;3;821;824
8;Barcelona;13;Barcelonès;08019;Barcelona;6;152;U;;578;395;183;1;5;389;394
8;Barcelona;13;Barcelonès;08019;Barcelona;6;153;U;;743;549;194;0;10;539;549
8;Barcelona;13;Barcelonès;08019;Barcelona;6;154;A;;987;686;301;2;8;676;684
8;Barcelona;13;Barcelonès;08019;Barcelona;6;154;B;;924;674;250;0;5;669;674
8;Barcelona;13;Barcelonès;08019;Barcelona;6;157;A;;766;542;224;1;5;536;541
8;Barcelona;13;Barcelonès;08019;Barcelona;6;157;B;;683;473;210;0;3;470;473
8;Barcelona;13;Barcelonès;08019;Barcelona;6;158;U;;1179;835;344;3;6;826;832
8;Barcelona;13;Barcelonès;08019;Barcelona;6;16;U;;615;384;231;5;3;376;379
8;Barcelona;13;Barcelonès;08019;Barcelona;6;17;U;;535;356;179;1;3;352;355
8;Barcelona;13;Barcelonès;08019;Barcelona;6;18;U;;659;445;214;0;3;442;445
8;Barcelona;13;Barcelonès;08019;Barcelona;6;19;U;;603;433;170;0;2;431;433
8;Barcelona;13;Barcelonès;08019;Barcelona;6;20;U;;795;544;251;2;2;540;542
8;Barcelona;13;Barcelonès;08019;Barcelona;6;21;U;;603;457;146;0;2;455;457
8;Barcelona;13;Barcelonès;08019;Barcelona;6;22;U;;993;659;334;7;1;651;652
8;Barcelona;13;Barcelonès;08019;Barcelona;6;23;U;;897;664;233;1;5;658;663
8;Barcelona;13;Barcelonès;08019;Barcelona;6;26;U;;1009;777;232;1;4;772;776
8;Barcelona;13;Barcelonès;08019;Barcelona;6;28;U;;618;420;198;1;3;416;419
8;Barcelona;13;Barcelonès;08019;Barcelona;6;29;U;;856;623;233;2;0;621;621
8;Barcelona;13;Barcelonès;08019;Barcelona;6;30;U;;640;456;184;0;4;452;456
8;Barcelona;13;Barcelonès;08019;Barcelona;6;31;U;;761;523;238;2;6;515;521
8;Barcelona;13;Barcelonès;08019;Barcelona;6;32;U;;747;525;222;0;4;521;525
8;Barcelona;13;Barcelonès;08019;Barcelona;6;33;U;;623;427;196;0;2;425;427
8;Barcelona;13;Barcelonès;08019;Barcelona;6;34;U;;910;652;258;0;0;652;652
8;Barcelona;13;Barcelonès;08019;Barcelona;6;35;U;;902;607;295;4;0;603;603
8;Barcelona;13;Barcelonès;08019;Barcelona;6;36;U;;515;431;84;0;1;430;431
8;Barcelona;13;Barcelonès;08019;Barcelona;6;37;U;;642;492;150;2;6;484;490
8;Barcelona;13;Barcelonès;08019;Barcelona;6;38;U;;828;615;213;0;12;603;615
8;Barcelona;13;Barcelonès;08019;Barcelona;6;39;U;;586;450;136;0;5;445;450
8;Barcelona;13;Barcelonès;08019;Barcelona;6;4;U;;943;661;282;2;5;654;659
8;Barcelona;13;Barcelonès;08019;Barcelona;6;40;U;;767;540;227;0;5;535;540
8;Barcelona;13;Barcelonès;08019;Barcelona;6;41;U;;1140;846;294;0;12;834;846
8;Barcelona;13;Barcelonès;08019;Barcelona;6;42;U;;871;627;244;1;1;625;626
8;Barcelona;13;Barcelonès;08019;Barcelona;6;43;U;;874;666;208;1;12;653;665
8;Barcelona;13;Barcelonès;08019;Barcelona;6;44;U;;904;660;244;0;11;649;660
8;Barcelona;13;Barcelonès;08019;Barcelona;6;45;U;;620;429;191;1;5;423;428
8;Barcelona;13;Barcelonès;08019;Barcelona;6;47;U;;467;314;153;0;1;313;314
8;Barcelona;13;Barcelonès;08019;Barcelona;6;48;U;;557;395;162;2;5;388;393
8;Barcelona;13;Barcelonès;08019;Barcelona;6;49;U;;509;366;143;1;4;361;365
8;Barcelona;13;Barcelonès;08019;Barcelona;6;50;U;;853;589;264;1;6;582;588
8;Barcelona;13;Barcelonès;08019;Barcelona;6;52;U;;880;592;288;3;2;587;589
8;Barcelona;13;Barcelonès;08019;Barcelona;6;54;U;;553;416;137;0;3;413;416
8;Barcelona;13;Barcelonès;08019;Barcelona;6;55;U;;798;601;197;1;4;596;600
8;Barcelona;13;Barcelonès;08019;Barcelona;6;56;U;;700;509;191;6;3;500;503
8;Barcelona;13;Barcelonès;08019;Barcelona;6;57;U;;1025;753;272;2;8;743;751
8;Barcelona;13;Barcelonès;08019;Barcelona;6;58;U;;458;339;119;0;1;338;339
8;Barcelona;13;Barcelonès;08019;Barcelona;6;59;U;;981;746;235;0;4;742;746
8;Barcelona;13;Barcelonès;08019;Barcelona;6;6;U;;919;658;261;3;6;649;655
8;Barcelona;13;Barcelonès;08019;Barcelona;6;60;U;;542;366;176;0;1;365;366
8;Barcelona;13;Barcelonès;08019;Barcelona;6;61;U;;552;398;154;1;4;393;397
8;Barcelona;13;Barcelonès;08019;Barcelona;6;63;U;;428;287;141;0;0;287;287
8;Barcelona;13;Barcelonès;08019;Barcelona;6;64;U;;661;416;245;0;7;409;416
8;Barcelona;13;Barcelonès;08019;Barcelona;6;66;U;;1099;762;337;1;4;757;761
8;Barcelona;13;Barcelonès;08019;Barcelona;6;68;U;;685;441;244;0;5;436;441
8;Barcelona;13;Barcelonès;08019;Barcelona;6;69;U;;896;614;282;0;3;611;614
8;Barcelona;13;Barcelonès;08019;Barcelona;6;72;U;;900;648;252;0;3;645;648
8;Barcelona;13;Barcelonès;08019;Barcelona;6;74;U;;884;630;254;4;6;620;626
8;Barcelona;13;Barcelonès;08019;Barcelona;6;76;U;;544;392;152;0;1;391;392
8;Barcelona;13;Barcelonès;08019;Barcelona;6;77;U;;507;348;159;1;1;346;347
8;Barcelona;13;Barcelonès;08019;Barcelona;6;78;U;;768;527;241;0;6;521;527
8;Barcelona;13;Barcelonès;08019;Barcelona;6;8;U;;876;558;318;0;3;555;558
8;Barcelona;13;Barcelonès;08019;Barcelona;6;80;U;;933;589;344;0;1;588;589
8;Barcelona;13;Barcelonès;08019;Barcelona;6;82;U;;848;593;255;1;6;586;592
8;Barcelona;13;Barcelonès;08019;Barcelona;6;84;U;;571;390;181;0;2;388;390
8;Barcelona;13;Barcelonès;08019;Barcelona;6;85;U;;623;459;164;0;4;455;459
8;Barcelona;13;Barcelonès;08019;Barcelona;6;86;U;;852;605;247;0;7;598;605
8;Barcelona;13;Barcelonès;08019;Barcelona;6;88;U;;963;667;296;5;5;657;662
8;Barcelona;13;Barcelonès;08019;Barcelona;6;89;U;;817;612;205;3;7;602;609
8;Barcelona;13;Barcelonès;08019;Barcelona;6;91;U;;424;317;107;0;3;314;317
8;Barcelona;13;Barcelonès;08019;Barcelona;6;92;U;;488;359;129;0;1;358;359
8;Barcelona;13;Barcelonès;08019;Barcelona;6;93;U;;582;376;206;0;3;373;376
8;Barcelona;13;Barcelonès;08019;Barcelona;6;94;U;;616;392;224;2;0;390;390
8;Barcelona;13;Barcelonès;08019;Barcelona;6;95;U;;577;398;179;1;7;390;397
8;Barcelona;13;Barcelonès;08019;Barcelona;6;96;U;;503;361;142;1;4;356;360
8;Barcelona;13;Barcelonès;08019;Barcelona;6;97;U;;899;635;264;1;7;627;634
8;Barcelona;13;Barcelonès;08019;Barcelona;6;98;U;;734;530;204;0;5;525;530
8;Barcelona;13;Barcelonès;08019;Barcelona;7;1;A;;788;557;231;0;5;552;557
8;Barcelona;13;Barcelonès;08019;Barcelona;7;1;B;;659;456;203;1;6;449;455
8;Barcelona;13;Barcelonès;08019;Barcelona;7;10;U;;856;602;254;1;8;593;601
8;Barcelona;13;Barcelonès;08019;Barcelona;7;100;U;;818;496;322;4;11;481;492
8;Barcelona;13;Barcelonès;08019;Barcelona;7;101;U;;586;420;166;0;4;416;420
8;Barcelona;13;Barcelonès;08019;Barcelona;7;102;U;;469;312;157;0;4;308;312
8;Barcelona;13;Barcelonès;08019;Barcelona;7;103;U;;622;421;201;0;2;419;421
8;Barcelona;13;Barcelonès;08019;Barcelona;7;104;U;;1026;713;313;1;8;704;712
8;Barcelona;13;Barcelonès;08019;Barcelona;7;105;U;;595;409;186;0;3;406;409
8;Barcelona;13;Barcelonès;08019;Barcelona;7;106;U;;620;462;158;0;10;452;462
8;Barcelona;13;Barcelonès;08019;Barcelona;7;107;U;;533;403;130;1;4;398;402
8;Barcelona;13;Barcelonès;08019;Barcelona;7;108;U;;624;414;210;0;3;411;414
8;Barcelona;13;Barcelonès;08019;Barcelona;7;109;U;;716;503;213;0;6;497;503
8;Barcelona;13;Barcelonès;08019;Barcelona;7;11;U;;717;491;226;0;7;484;491
8;Barcelona;13;Barcelonès;08019;Barcelona;7;110;U;;1138;655;483;1;2;652;654
8;Barcelona;13;Barcelonès;08019;Barcelona;7;112;U;;497;282;215;0;3;279;282
8;Barcelona;13;Barcelonès;08019;Barcelona;7;113;U;;615;331;284;0;2;329;331
8;Barcelona;13;Barcelonès;08019;Barcelona;7;114;U;;664;364;300;0;7;357;364
8;Barcelona;13;Barcelonès;08019;Barcelona;7;116;U;;801;433;368;1;3;429;432
8;Barcelona;13;Barcelonès;08019;Barcelona;7;117;U;;775;442;333;1;4;437;441
8;Barcelona;13;Barcelonès;08019;Barcelona;7;118;U;;911;455;456;0;2;453;455
8;Barcelona;13;Barcelonès;08019;Barcelona;7;119;U;;863;439;424;1;4;434;438
8;Barcelona;13;Barcelonès;08019;Barcelona;7;12;U;;615;412;203;0;6;406;412
8;Barcelona;13;Barcelonès;08019;Barcelona;7;120;U;;705;431;274;0;4;427;431
8;Barcelona;13;Barcelonès;08019;Barcelona;7;121;U;;528;279;249;1;0;278;278
8;Barcelona;13;Barcelonès;08019;Barcelona;7;122;U;;864;450;414;0;4;446;450
8;Barcelona;13;Barcelonès;08019;Barcelona;7;123;A;;735;423;312;2;6;415;421
8;Barcelona;13;Barcelonès;08019;Barcelona;7;123;B;;703;429;274;1;3;425;428
8;Barcelona;13;Barcelonès;08019;Barcelona;7;124;U;;696;420;276;1;1;418;419
8;Barcelona;13;Barcelonès;08019;Barcelona;7;125;U;;1071;636;435;0;5;631;636
8;Barcelona;13;Barcelonès;08019;Barcelona;7;127;U;;678;397;281;2;9;386;395
8;Barcelona;13;Barcelonès;08019;Barcelona;7;128;U;;720;404;316;1;7;396;403
8;Barcelona;13;Barcelonès;08019;Barcelona;7;129;U;;606;338;268;1;6;331;337
8;Barcelona;13;Barcelonès;08019;Barcelona;7;13;U;;885;641;244;0;5;636;641
8;Barcelona;13;Barcelonès;08019;Barcelona;7;130;U;;451;240;211;1;3;236;239
8;Barcelona;13;Barcelonès;08019;Barcelona;7;131;U;;747;401;346;1;4;396;400
8;Barcelona;13;Barcelonès;08019;Barcelona;7;132;U;;509;293;216;1;3;289;292
8;Barcelona;13;Barcelonès;08019;Barcelona;7;133;U;;852;517;335;1;5;511;516
8;Barcelona;13;Barcelonès;08019;Barcelona;7;134;A;;691;414;277;3;2;409;411
8;Barcelona;13;Barcelonès;08019;Barcelona;7;134;B;;608;359;249;0;2;357;359
8;Barcelona;13;Barcelonès;08019;Barcelona;7;136;U;;453;276;177;0;2;274;276
8;Barcelona;13;Barcelonès;08019;Barcelona;7;137;U;;843;509;334;0;3;506;509
8;Barcelona;13;Barcelonès;08019;Barcelona;7;138;U;;618;374;244;1;4;369;373
8;Barcelona;13;Barcelonès;08019;Barcelona;7;139;U;;928;553;375;4;6;543;549
8;Barcelona;13;Barcelonès;08019;Barcelona;7;14;U;;898;587;311;1;1;585;586
8;Barcelona;13;Barcelonès;08019;Barcelona;7;140;U;;491;296;195;3;3;290;293
8;Barcelona;13;Barcelonès;08019;Barcelona;7;141;U;;645;413;232;1;3;409;412
8;Barcelona;13;Barcelonès;08019;Barcelona;7;142;U;;1042;624;418;1;13;610;623
8;Barcelona;13;Barcelonès;08019;Barcelona;7;144;U;;1155;740;415;0;9;731;740
8;Barcelona;13;Barcelonès;08019;Barcelona;7;147;U;;1193;828;365;8;2;818;820
8;Barcelona;13;Barcelonès;08019;Barcelona;7;148;U;;956;557;399;1;10;546;556
8;Barcelona;13;Barcelonès;08019;Barcelona;7;15;U;;520;356;164;0;6;350;356
8;Barcelona;13;Barcelonès;08019;Barcelona;7;150;U;;884;571;313;5;7;559;566
8;Barcelona;13;Barcelonès;08019;Barcelona;7;151;U;;557;342;215;0;3;339;342
8;Barcelona;13;Barcelonès;08019;Barcelona;7;152;U;;537;350;187;0;5;345;350
8;Barcelona;13;Barcelonès;08019;Barcelona;7;155;U;;928;622;306;0;7;615;622
8;Barcelona;13;Barcelonès;08019;Barcelona;7;157;U;;725;517;208;0;2;515;517
8;Barcelona;13;Barcelonès;08019;Barcelona;7;158;A;;398;287;111;0;6;281;287
8;Barcelona;13;Barcelonès;08019;Barcelona;7;158;B;;365;241;124;0;2;239;241
8;Barcelona;13;Barcelonès;08019;Barcelona;7;159;U;;776;507;269;0;5;502;507
8;Barcelona;13;Barcelonès;08019;Barcelona;7;16;U;;924;598;326;2;10;586;596
8;Barcelona;13;Barcelonès;08019;Barcelona;7;160;U;;502;355;147;0;3;352;355
8;Barcelona;13;Barcelonès;08019;Barcelona;7;161;U;;443;331;112;0;0;331;331
8;Barcelona;13;Barcelonès;08019;Barcelona;7;162;U;;699;463;236;1;8;454;462
8;Barcelona;13;Barcelonès;08019;Barcelona;7;163;U;;1041;712;329;3;4;705;709
8;Barcelona;13;Barcelonès;08019;Barcelona;7;165;U;;611;417;194;1;1;415;416
8;Barcelona;13;Barcelonès;08019;Barcelona;7;166;U;;1207;850;357;3;10;837;847
8;Barcelona;13;Barcelonès;08019;Barcelona;7;167;U;;843;590;253;0;6;584;590
8;Barcelona;13;Barcelonès;08019;Barcelona;7;169;U;;688;432;256;0;3;429;432
8;Barcelona;13;Barcelonès;08019;Barcelona;7;170;U;;1022;677;345;1;4;672;676
8;Barcelona;13;Barcelonès;08019;Barcelona;7;172;U;;584;411;173;1;1;409;410
8;Barcelona;13;Barcelonès;08019;Barcelona;7;173;U;;975;642;333;3;3;636;639
8;Barcelona;13;Barcelonès;08019;Barcelona;7;174;U;;722;500;222;0;8;492;500
8;Barcelona;13;Barcelonès;08019;Barcelona;7;176;U;;533;393;140;1;4;388;392
8;Barcelona;13;Barcelonès;08019;Barcelona;7;177;U;;1015;661;354;1;6;654;660
8;Barcelona;13;Barcelonès;08019;Barcelona;7;179;U;;644;447;197;0;3;444;447
8;Barcelona;13;Barcelonès;08019;Barcelona;7;18;U;;521;347;174;0;2;345;347
8;Barcelona;13;Barcelonès;08019;Barcelona;7;180;U;;520;349;171;0;5;344;349
8;Barcelona;13;Barcelonès;08019;Barcelona;7;181;U;;877;548;329;0;8;540;548
8;Barcelona;13;Barcelonès;08019;Barcelona;7;183;U;;628;401;227;4;2;395;397
8;Barcelona;13;Barcelonès;08019;Barcelona;7;184;U;;889;581;308;0;9;572;581
8;Barcelona;13;Barcelonès;08019;Barcelona;7;185;U;;739;513;226;1;5;507;512
8;Barcelona;13;Barcelonès;08019;Barcelona;7;187;U;;423;223;200;0;1;222;223
8;Barcelona;13;Barcelonès;08019;Barcelona;7;188;U;;919;508;411;1;4;503;507
8;Barcelona;13;Barcelonès;08019;Barcelona;7;189;U;;729;398;331;5;8;385;393
8;Barcelona;13;Barcelonès;08019;Barcelona;7;19;U;;840;590;250;0;7;583;590
8;Barcelona;13;Barcelonès;08019;Barcelona;7;190;U;;891;589;302;2;2;585;587
8;Barcelona;13;Barcelonès;08019;Barcelona;7;191;U;;711;496;215;2;4;490;494
8;Barcelona;13;Barcelonès;08019;Barcelona;7;192;U;;710;462;248;0;1;461;462
8;Barcelona;13;Barcelonès;08019;Barcelona;7;193;U;;550;354;196;1;3;350;353
8;Barcelona;13;Barcelonès;08019;Barcelona;7;194;U;;503;392;111;0;4;388;392
8;Barcelona;13;Barcelonès;08019;Barcelona;7;195;U;;853;552;301;1;5;546;551
8;Barcelona;13;Barcelonès;08019;Barcelona;7;196;U;;915;601;314;0;12;589;601
8;Barcelona;13;Barcelonès;08019;Barcelona;7;197;U;;682;483;199;1;5;477;482
8;Barcelona;13;Barcelonès;08019;Barcelona;7;198;U;;678;475;203;1;5;469;474
8;Barcelona;13;Barcelonès;08019;Barcelona;7;2;U;;599;441;158;1;7;433;440
8;Barcelona;13;Barcelonès;08019;Barcelona;7;20;U;;545;319;226;0;5;314;319
8;Barcelona;13;Barcelonès;08019;Barcelona;7;200;U;;811;459;352;5;4;450;454
8;Barcelona;13;Barcelonès;08019;Barcelona;7;201;U;;625;434;191;0;3;431;434
8;Barcelona;13;Barcelonès;08019;Barcelona;7;202;U;;599;399;200;1;4;394;398
8;Barcelona;13;Barcelonès;08019;Barcelona;7;204;A;;950;692;258;0;6;686;692
8;Barcelona;13;Barcelonès;08019;Barcelona;7;204;B;;824;596;228;1;8;587;595
8;Barcelona;13;Barcelonès;08019;Barcelona;7;205;A;;760;547;213;0;7;540;547
8;Barcelona;13;Barcelonès;08019;Barcelona;7;205;B;;656;466;190;2;7;457;464
8;Barcelona;13;Barcelonès;08019;Barcelona;7;207;A;;722;478;244;1;7;470;477
8;Barcelona;13;Barcelonès;08019;Barcelona;7;207;B;;614;416;198;3;4;409;413
8;Barcelona;13;Barcelonès;08019;Barcelona;7;209;U;;1008;600;408;2;3;595;598
8;Barcelona;13;Barcelonès;08019;Barcelona;7;210;A;;690;429;261;1;2;426;428
8;Barcelona;13;Barcelonès;08019;Barcelona;7;210;B;;580;371;209;0;2;369;371
8;Barcelona;13;Barcelonès;08019;Barcelona;7;211;A;;706;394;312;0;6;388;394
8;Barcelona;13;Barcelonès;08019;Barcelona;7;211;B;;679;375;304;0;5;370;375
8;Barcelona;13;Barcelonès;08019;Barcelona;7;213;U;;774;417;357;0;5;412;417
8;Barcelona;13;Barcelonès;08019;Barcelona;7;214;U;;556;309;247;0;4;305;309
8;Barcelona;13;Barcelonès;08019;Barcelona;7;215;U;;948;506;442;1;0;505;505
8;Barcelona;13;Barcelonès;08019;Barcelona;7;217;U;;452;270;182;0;1;269;270
8;Barcelona;13;Barcelonès;08019;Barcelona;7;218;U;;666;382;284;1;5;376;381
8;Barcelona;13;Barcelonès;08019;Barcelona;7;219;U;;660;410;250;6;4;400;404
8;Barcelona;13;Barcelonès;08019;Barcelona;7;220;U;;767;477;290;0;7;470;477
8;Barcelona;13;Barcelonès;08019;Barcelona;7;221;U;;674;423;251;1;3;419;422
8;Barcelona;13;Barcelonès;08019;Barcelona;7;23;U;;647;462;185;0;2;460;462
8;Barcelona;13;Barcelonès;08019;Barcelona;7;24;U;;708;447;261;0;2;445;447
8;Barcelona;13;Barcelonès;08019;Barcelona;7;26;U;;560;385;175;1;2;382;384
8;Barcelona;13;Barcelonès;08019;Barcelona;7;27;U;;485;321;164;1;1;319;320
8;Barcelona;13;Barcelonès;08019;Barcelona;7;28;U;;444;293;151;0;3;290;293
8;Barcelona;13;Barcelonès;08019;Barcelona;7;29;U;;705;470;235;0;3;467;470
8;Barcelona;13;Barcelonès;08019;Barcelona;7;3;U;;592;379;213;0;1;378;379
8;Barcelona;13;Barcelonès;08019;Barcelona;7;31;U;;805;561;244;2;10;549;559
8;Barcelona;13;Barcelonès;08019;Barcelona;7;32;U;;485;361;124;0;3;358;361
8;Barcelona;13;Barcelonès;08019;Barcelona;7;33;U;;728;544;184;4;7;533;540
8;Barcelona;13;Barcelonès;08019;Barcelona;7;34;U;;888;544;344;1;6;537;543
8;Barcelona;13;Barcelonès;08019;Barcelona;7;36;U;;471;324;147;0;4;320;324
8;Barcelona;13;Barcelonès;08019;Barcelona;7;37;U;;531;358;173;0;1;357;358
8;Barcelona;13;Barcelonès;08019;Barcelona;7;38;U;;665;453;212;1;7;445;452
8;Barcelona;13;Barcelonès;08019;Barcelona;7;39;U;;536;391;145;1;4;386;390
8;Barcelona;13;Barcelonès;08019;Barcelona;7;4;U;;795;536;259;0;6;530;536
8;Barcelona;13;Barcelonès;08019;Barcelona;7;40;U;;575;435;140;0;1;434;435
8;Barcelona;13;Barcelonès;08019;Barcelona;7;41;U;;446;284;162;0;1;283;284
8;Barcelona;13;Barcelonès;08019;Barcelona;7;42;U;;470;307;163;2;0;305;305
8;Barcelona;13;Barcelonès;08019;Barcelona;7;43;U;;777;549;228;0;1;548;549
8;Barcelona;13;Barcelonès;08019;Barcelona;7;44;U;;658;501;157;1;6;494;500
8;Barcelona;13;Barcelonès;08019;Barcelona;7;45;U;;839;587;252;2;9;576;585
8;Barcelona;13;Barcelonès;08019;Barcelona;7;47;U;;684;461;223;0;3;458;461
8;Barcelona;13;Barcelonès;08019;Barcelona;7;48;U;;1033;722;311;1;7;714;721
8;Barcelona;13;Barcelonès;08019;Barcelona;7;50;U;;574;382;192;0;6;376;382
8;Barcelona;13;Barcelonès;08019;Barcelona;7;51;U;;848;616;232;0;6;610;616
8;Barcelona;13;Barcelonès;08019;Barcelona;7;52;U;;504;343;161;2;2;339;341
8;Barcelona;13;Barcelonès;08019;Barcelona;7;53;U;;531;379;152;0;3;376;379
8;Barcelona;13;Barcelonès;08019;Barcelona;7;54;U;;549;378;171;0;5;373;378
8;Barcelona;13;Barcelonès;08019;Barcelona;7;55;U;;863;556;307;0;10;546;556
8;Barcelona;13;Barcelonès;08019;Barcelona;7;56;U;;983;658;325;1;6;651;657
8;Barcelona;13;Barcelonès;08019;Barcelona;7;57;U;;932;664;268;1;6;657;663
8;Barcelona;13;Barcelonès;08019;Barcelona;7;58;U;;709;470;239;2;9;459;468
8;Barcelona;13;Barcelonès;08019;Barcelona;7;60;U;;726;472;254;0;3;469;472
8;Barcelona;13;Barcelonès;08019;Barcelona;7;62;U;;813;504;309;3;3;498;501
8;Barcelona;13;Barcelonès;08019;Barcelona;7;64;U;;514;372;142;1;1;370;371
8;Barcelona;13;Barcelonès;08019;Barcelona;7;65;U;;874;553;321;0;8;545;553
8;Barcelona;13;Barcelonès;08019;Barcelona;7;66;U;;458;252;206;0;1;251;252
8;Barcelona;13;Barcelonès;08019;Barcelona;7;67;U;;1102;734;368;3;7;724;731
8;Barcelona;13;Barcelonès;08019;Barcelona;7;68;U;;572;387;185;1;8;378;386
8;Barcelona;13;Barcelonès;08019;Barcelona;7;7;U;;582;426;156;0;6;420;426
8;Barcelona;13;Barcelonès;08019;Barcelona;7;70;U;;596;372;224;0;2;370;372
8;Barcelona;13;Barcelonès;08019;Barcelona;7;71;U;;523;330;193;0;3;327;330
8;Barcelona;13;Barcelonès;08019;Barcelona;7;72;A;;774;546;228;0;5;541;546
8;Barcelona;13;Barcelonès;08019;Barcelona;7;72;B;;745;531;214;0;8;523;531
8;Barcelona;13;Barcelonès;08019;Barcelona;7;73;U;;811;572;239;1;5;566;571
8;Barcelona;13;Barcelonès;08019;Barcelona;7;74;U;;596;391;205;1;3;387;390
8;Barcelona;13;Barcelonès;08019;Barcelona;7;75;U;;749;475;274;0;8;467;475
8;Barcelona;13;Barcelonès;08019;Barcelona;7;76;U;;775;530;245;0;4;526;530
8;Barcelona;13;Barcelonès;08019;Barcelona;7;78;A;;651;461;190;0;7;454;461
8;Barcelona;13;Barcelonès;08019;Barcelona;7;78;B;;604;410;194;0;6;404;410
8;Barcelona;13;Barcelonès;08019;Barcelona;7;79;U;;1033;683;350;2;8;673;681
8;Barcelona;13;Barcelonès;08019;Barcelona;7;8;A;;670;471;199;0;6;465;471
8;Barcelona;13;Barcelonès;08019;Barcelona;7;8;B;;601;448;153;0;3;445;448
8;Barcelona;13;Barcelonès;08019;Barcelona;7;80;U;;644;431;213;0;8;423;431
8;Barcelona;13;Barcelonès;08019;Barcelona;7;81;U;;863;648;215;1;10;637;647
8;Barcelona;13;Barcelonès;08019;Barcelona;7;83;U;;564;348;216;1;6;341;347
8;Barcelona;13;Barcelonès;08019;Barcelona;7;84;U;;851;566;285;0;3;563;566
8;Barcelona;13;Barcelonès;08019;Barcelona;7;85;U;;821;579;242;0;4;575;579
8;Barcelona;13;Barcelonès;08019;Barcelona;7;86;U;;801;575;226;0;5;570;575
8;Barcelona;13;Barcelonès;08019;Barcelona;7;88;U;;971;652;319;0;8;644;652
8;Barcelona;13;Barcelonès;08019;Barcelona;7;89;U;;885;506;379;2;2;502;504
8;Barcelona;13;Barcelonès;08019;Barcelona;7;9;U;;891;620;271;1;4;615;619
8;Barcelona;13;Barcelonès;08019;Barcelona;7;91;U;;761;459;302;2;6;451;457
8;Barcelona;13;Barcelonès;08019;Barcelona;7;92;U;;654;359;295;0;5;354;359
8;Barcelona;13;Barcelonès;08019;Barcelona;7;93;A;;1096;655;441;0;5;650;655
8;Barcelona;13;Barcelonès;08019;Barcelona;7;93;B;;997;629;368;0;5;624;629
8;Barcelona;13;Barcelonès;08019;Barcelona;7;94;U;;680;373;307;1;4;368;372
8;Barcelona;13;Barcelonès;08019;Barcelona;7;95;U;;1115;584;531;0;5;579;584
8;Barcelona;13;Barcelonès;08019;Barcelona;7;97;U;;717;392;325;0;3;389;392
8;Barcelona;13;Barcelonès;08019;Barcelona;7;98;U;;931;584;347;0;6;578;584
8;Barcelona;13;Barcelonès;08019;Barcelona;8;1;U;;1060;750;310;0;8;742;750
8;Barcelona;13;Barcelonès;08019;Barcelona;8;10;U;;887;568;319;1;1;566;567
8;Barcelona;13;Barcelonès;08019;Barcelona;8;100;U;;712;414;298;0;4;410;414
8;Barcelona;13;Barcelonès;08019;Barcelona;8;101;U;;784;498;286;2;2;494;496
8;Barcelona;13;Barcelonès;08019;Barcelona;8;102;U;;518;277;241;2;6;269;275
8;Barcelona;13;Barcelonès;08019;Barcelona;8;103;U;;788;494;294;4;1;489;490
8;Barcelona;13;Barcelonès;08019;Barcelona;8;104;U;;690;332;358;0;0;332;332
8;Barcelona;13;Barcelonès;08019;Barcelona;8;107;U;;805;462;343;0;3;459;462
8;Barcelona;13;Barcelonès;08019;Barcelona;8;108;U;;728;435;293;1;3;431;434
8;Barcelona;13;Barcelonès;08019;Barcelona;8;109;U;;591;349;242;0;4;345;349
8;Barcelona;13;Barcelonès;08019;Barcelona;8;11;U;;767;506;261;1;4;501;505
8;Barcelona;13;Barcelonès;08019;Barcelona;8;111;U;;554;328;226;5;0;323;323
8;Barcelona;13;Barcelonès;08019;Barcelona;8;112;U;;538;333;205;4;1;328;329
8;Barcelona;13;Barcelonès;08019;Barcelona;8;113;U;;732;443;289;1;8;434;442
8;Barcelona;13;Barcelonès;08019;Barcelona;8;114;U;;778;491;287;0;2;489;491
8;Barcelona;13;Barcelonès;08019;Barcelona;8;115;U;;805;486;319;1;10;475;485
8;Barcelona;13;Barcelonès;08019;Barcelona;8;116;U;;1001;627;374;2;8;617;625
8;Barcelona;13;Barcelonès;08019;Barcelona;8;117;U;;559;319;240;1;1;317;318
8;Barcelona;13;Barcelonès;08019;Barcelona;8;119;U;;809;480;329;1;6;473;479
8;Barcelona;13;Barcelonès;08019;Barcelona;8;12;U;;557;385;172;0;2;383;385
8;Barcelona;13;Barcelonès;08019;Barcelona;8;121;U;;570;350;220;1;4;345;349
8;Barcelona;13;Barcelonès;08019;Barcelona;8;122;U;;838;528;310;1;2;525;527
8;Barcelona;13;Barcelonès;08019;Barcelona;8;123;U;;475;282;193;0;3;279;282
8;Barcelona;13;Barcelonès;08019;Barcelona;8;124;U;;764;317;447;0;0;317;317
8;Barcelona;13;Barcelonès;08019;Barcelona;8;126;U;;1049;570;479;2;6;562;568
8;Barcelona;13;Barcelonès;08019;Barcelona;8;127;U;;732;443;289;1;4;438;442
8;Barcelona;13;Barcelonès;08019;Barcelona;8;129;U;;896;501;395;0;6;495;501
8;Barcelona;13;Barcelonès;08019;Barcelona;8;13;U;;838;537;301;1;3;533;536
8;Barcelona;13;Barcelonès;08019;Barcelona;8;131;U;;954;565;389;0;2;563;565
8;Barcelona;13;Barcelonès;08019;Barcelona;8;133;U;;597;378;219;2;2;374;376
8;Barcelona;13;Barcelonès;08019;Barcelona;8;134;U;;474;305;169;0;2;303;305
8;Barcelona;13;Barcelonès;08019;Barcelona;8;135;U;;1046;671;375;0;8;663;671
8;Barcelona;13;Barcelonès;08019;Barcelona;8;136;U;;568;351;217;0;4;347;351
8;Barcelona;13;Barcelonès;08019;Barcelona;8;138;U;;700;421;279;1;7;413;420
8;Barcelona;13;Barcelonès;08019;Barcelona;8;14;U;;744;528;216;0;12;516;528
8;Barcelona;13;Barcelonès;08019;Barcelona;8;140;U;;1134;718;416;1;10;707;717
8;Barcelona;13;Barcelonès;08019;Barcelona;8;141;U;;799;509;290;6;2;501;503
8;Barcelona;13;Barcelonès;08019;Barcelona;8;142;A;;766;480;286;0;1;479;480
8;Barcelona;13;Barcelonès;08019;Barcelona;8;142;B;;673;423;250;2;0;421;421
8;Barcelona;13;Barcelonès;08019;Barcelona;8;143;U;;1028;699;329;1;10;688;698
8;Barcelona;13;Barcelonès;08019;Barcelona;8;144;U;;1157;678;479;2;8;668;676
8;Barcelona;13;Barcelonès;08019;Barcelona;8;145;U;;605;380;225;1;4;375;379
8;Barcelona;13;Barcelonès;08019;Barcelona;8;146;U;;866;521;345;2;7;512;519
8;Barcelona;13;Barcelonès;08019;Barcelona;8;147;U;;582;353;229;0;4;349;353
8;Barcelona;13;Barcelonès;08019;Barcelona;8;149;U;;612;400;212;1;4;395;399
8;Barcelona;13;Barcelonès;08019;Barcelona;8;15;U;;838;560;278;1;7;552;559
8;Barcelona;13;Barcelonès;08019;Barcelona;8;150;U;;683;431;252;1;1;429;430
8;Barcelona;13;Barcelonès;08019;Barcelona;8;151;U;;608;328;280;0;2;326;328
8;Barcelona;13;Barcelonès;08019;Barcelona;8;152;U;;924;548;376;0;3;545;548
8;Barcelona;13;Barcelonès;08019;Barcelona;8;153;U;;487;296;191;1;6;289;295
8;Barcelona;13;Barcelonès;08019;Barcelona;8;154;U;;547;333;214;0;5;328;333
8;Barcelona;13;Barcelonès;08019;Barcelona;8;155;U;;682;410;272;1;3;406;409
8;Barcelona;13;Barcelonès;08019;Barcelona;8;156;U;;966;478;488;5;0;473;473
8;Barcelona;13;Barcelonès;08019;Barcelona;8;158;U;;803;429;374;5;6;418;424
8;Barcelona;13;Barcelonès;08019;Barcelona;8;160;U;;733;428;305;2;2;424;426
8;Barcelona;13;Barcelonès;08019;Barcelona;8;161;U;;700;366;334;0;2;364;366
8;Barcelona;13;Barcelonès;08019;Barcelona;8;162;U;;710;310;400;0;1;309;310
8;Barcelona;13;Barcelonès;08019;Barcelona;8;163;U;;1088;469;619;1;4;464;468
8;Barcelona;13;Barcelonès;08019;Barcelona;8;164;U;;508;294;214;1;6;287;293
8;Barcelona;13;Barcelonès;08019;Barcelona;8;166;U;;704;381;323;0;2;379;381
8;Barcelona;13;Barcelonès;08019;Barcelona;8;167;U;;689;348;341;0;3;345;348
8;Barcelona;13;Barcelonès;08019;Barcelona;8;168;U;;860;505;355;0;0;505;505
8;Barcelona;13;Barcelonès;08019;Barcelona;8;17;U;;580;393;187;2;1;390;391
8;Barcelona;13;Barcelonès;08019;Barcelona;8;170;U;;536;318;218;0;0;318;318
8;Barcelona;13;Barcelonès;08019;Barcelona;8;171;U;;831;445;386;3;1;441;442
8;Barcelona;13;Barcelonès;08019;Barcelona;8;172;U;;620;328;292;0;5;323;328
8;Barcelona;13;Barcelonès;08019;Barcelona;8;173;U;;829;521;308;0;6;515;521
8;Barcelona;13;Barcelonès;08019;Barcelona;8;174;U;;853;496;357;0;2;494;496
8;Barcelona;13;Barcelonès;08019;Barcelona;8;176;U;;622;330;292;0;2;328;330
8;Barcelona;13;Barcelonès;08019;Barcelona;8;178;U;;712;430;282;3;5;422;427
8;Barcelona;13;Barcelonès;08019;Barcelona;8;18;A;;669;469;200;0;7;462;469
8;Barcelona;13;Barcelonès;08019;Barcelona;8;18;B;;596;413;183;1;5;407;412
8;Barcelona;13;Barcelonès;08019;Barcelona;8;180;U;;642;353;289;0;1;352;353
8;Barcelona;13;Barcelonès;08019;Barcelona;8;181;U;;571;316;255;3;6;307;313
8;Barcelona;13;Barcelonès;08019;Barcelona;8;182;U;;502;264;238;0;1;263;264
8;Barcelona;13;Barcelonès;08019;Barcelona;8;183;U;;691;412;279;1;3;408;411
8;Barcelona;13;Barcelonès;08019;Barcelona;8;184;U;;629;369;260;0;7;362;369
8;Barcelona;13;Barcelonès;08019;Barcelona;8;185;U;;701;365;336;0;4;361;365
8;Barcelona;13;Barcelonès;08019;Barcelona;8;186;U;;792;357;435;3;2;352;354
8;Barcelona;13;Barcelonès;08019;Barcelona;8;187;U;;482;220;262;0;1;219;220
8;Barcelona;13;Barcelonès;08019;Barcelona;8;188;U;;514;298;216;0;2;296;298
8;Barcelona;13;Barcelonès;08019;Barcelona;8;189;U;;984;594;390;2;6;586;592
8;Barcelona;13;Barcelonès;08019;Barcelona;8;19;U;;1002;714;288;3;4;707;711
8;Barcelona;13;Barcelonès;08019;Barcelona;8;190;U;;1168;716;452;0;2;714;716
8;Barcelona;13;Barcelonès;08019;Barcelona;8;191;A;;645;361;284;3;4;354;358
8;Barcelona;13;Barcelonès;08019;Barcelona;8;191;B;;587;344;243;0;4;340;344
8;Barcelona;13;Barcelonès;08019;Barcelona;8;192;U;;527;261;266;1;3;257;260
8;Barcelona;13;Barcelonès;08019;Barcelona;8;193;A;;818;437;381;0;6;431;437
8;Barcelona;13;Barcelonès;08019;Barcelona;8;193;B;;742;361;381;1;2;358;360
8;Barcelona;13;Barcelonès;08019;Barcelona;8;194;A;;630;290;340;0;4;286;290
8;Barcelona;13;Barcelonès;08019;Barcelona;8;194;B;;623;308;315;0;2;306;308
8;Barcelona;13;Barcelonès;08019;Barcelona;8;195;U;;656;259;397;1;0;258;258
8;Barcelona;13;Barcelonès;08019;Barcelona;8;196;U;;551;225;326;0;1;224;225
8;Barcelona;13;Barcelonès;08019;Barcelona;8;198;U;;866;381;485;0;7;374;381
8;Barcelona;13;Barcelonès;08019;Barcelona;8;2;U;;644;406;238;0;2;404;406
8;Barcelona;13;Barcelonès;08019;Barcelona;8;20;U;;920;599;321;1;9;589;598
8;Barcelona;13;Barcelonès;08019;Barcelona;8;200;U;;675;334;341;0;1;333;334
8;Barcelona;13;Barcelonès;08019;Barcelona;8;202;U;;882;430;452;0;4;426;430
8;Barcelona;13;Barcelonès;08019;Barcelona;8;203;U;;899;498;401;0;8;490;498
8;Barcelona;13;Barcelonès;08019;Barcelona;8;205;U;;893;457;436;1;6;450;456
8;Barcelona;13;Barcelonès;08019;Barcelona;8;207;U;;420;246;174;2;4;240;244
8;Barcelona;13;Barcelonès;08019;Barcelona;8;208;U;;761;465;296;2;4;459;463
8;Barcelona;13;Barcelonès;08019;Barcelona;8;209;U;;1173;644;529;4;8;632;640
8;Barcelona;13;Barcelonès;08019;Barcelona;8;21;U;;684;468;216;1;6;461;467
8;Barcelona;13;Barcelonès;08019;Barcelona;8;211;U;;722;335;387;1;3;331;334
8;Barcelona;13;Barcelonès;08019;Barcelona;8;213;A;;782;525;257;3;0;522;522
8;Barcelona;13;Barcelonès;08019;Barcelona;8;213;B;;700;451;249;0;2;449;451
8;Barcelona;13;Barcelonès;08019;Barcelona;8;214;U;;1176;773;403;0;15;758;773
8;Barcelona;13;Barcelonès;08019;Barcelona;8;22;U;;519;362;157;0;8;354;362
8;Barcelona;13;Barcelonès;08019;Barcelona;8;24;U;;725;509;216;5;7;497;504
8;Barcelona;13;Barcelonès;08019;Barcelona;8;27;U;;820;561;259;4;9;548;557
8;Barcelona;13;Barcelonès;08019;Barcelona;8;28;U;;1258;824;434;1;6;817;823
8;Barcelona;13;Barcelonès;08019;Barcelona;8;29;U;;804;504;300;1;8;495;503
8;Barcelona;13;Barcelonès;08019;Barcelona;8;3;U;;1130;749;381;0;5;744;749
8;Barcelona;13;Barcelonès;08019;Barcelona;8;30;U;;1019;673;346;0;8;665;673
8;Barcelona;13;Barcelonès;08019;Barcelona;8;33;U;;722;466;256;1;4;461;465
8;Barcelona;13;Barcelonès;08019;Barcelona;8;34;U;;805;553;252;1;7;545;552
8;Barcelona;13;Barcelonès;08019;Barcelona;8;36;U;;850;531;319;0;7;524;531
8;Barcelona;13;Barcelonès;08019;Barcelona;8;39;U;;482;330;152;0;2;328;330
8;Barcelona;13;Barcelonès;08019;Barcelona;8;40;U;;507;343;164;0;3;340;343
8;Barcelona;13;Barcelonès;08019;Barcelona;8;41;U;;632;414;218;0;3;411;414
8;Barcelona;13;Barcelonès;08019;Barcelona;8;42;U;;581;391;190;1;1;389;390
8;Barcelona;13;Barcelonès;08019;Barcelona;8;43;U;;494;338;156;0;3;335;338
8;Barcelona;13;Barcelonès;08019;Barcelona;8;44;U;;1048;692;356;1;10;681;691
8;Barcelona;13;Barcelonès;08019;Barcelona;8;45;U;;420;257;163;1;5;251;256
8;Barcelona;13;Barcelonès;08019;Barcelona;8;46;U;;689;354;335;0;4;350;354
8;Barcelona;13;Barcelonès;08019;Barcelona;8;47;U;;679;448;231;1;4;443;447
8;Barcelona;13;Barcelonès;08019;Barcelona;8;48;U;;621;402;219;0;3;399;402
8;Barcelona;13;Barcelonès;08019;Barcelona;8;49;U;;797;474;323;1;0;473;473
8;Barcelona;13;Barcelonès;08019;Barcelona;8;5;U;;828;562;266;1;6;555;561
8;Barcelona;13;Barcelonès;08019;Barcelona;8;50;U;;601;338;263;1;0;337;337
8;Barcelona;13;Barcelonès;08019;Barcelona;8;51;U;;764;529;235;0;2;527;529
8;Barcelona;13;Barcelonès;08019;Barcelona;8;52;U;;721;451;270;0;10;441;451
8;Barcelona;13;Barcelonès;08019;Barcelona;8;53;U;;966;604;362;0;7;597;604
8;Barcelona;13;Barcelonès;08019;Barcelona;8;54;U;;555;348;207;0;5;343;348
8;Barcelona;13;Barcelonès;08019;Barcelona;8;55;U;;447;269;178;1;1;267;268
8;Barcelona;13;Barcelonès;08019;Barcelona;8;56;U;;1011;645;366;5;4;636;640
8;Barcelona;13;Barcelonès;08019;Barcelona;8;57;U;;841;550;291;1;4;545;549
8;Barcelona;13;Barcelonès;08019;Barcelona;8;58;U;;807;494;313;1;3;490;493
8;Barcelona;13;Barcelonès;08019;Barcelona;8;6;U;;810;548;262;0;7;541;548
8;Barcelona;13;Barcelonès;08019;Barcelona;8;60;U;;893;540;353;0;2;538;540
8;Barcelona;13;Barcelonès;08019;Barcelona;8;62;U;;1042;668;374;0;15;653;668
8;Barcelona;13;Barcelonès;08019;Barcelona;8;64;U;;430;291;139;0;5;286;291
8;Barcelona;13;Barcelonès;08019;Barcelona;8;65;U;;790;523;267;0;3;520;523
8;Barcelona;13;Barcelonès;08019;Barcelona;8;66;U;;503;266;237;0;1;265;266
8;Barcelona;13;Barcelonès;08019;Barcelona;8;67;U;;599;291;308;2;3;286;289
8;Barcelona;13;Barcelonès;08019;Barcelona;8;68;U;;584;319;265;3;3;313;316
8;Barcelona;13;Barcelonès;08019;Barcelona;8;7;U;;684;478;206;0;6;472;478
8;Barcelona;13;Barcelonès;08019;Barcelona;8;70;U;;402;225;177;0;2;223;225
8;Barcelona;13;Barcelonès;08019;Barcelona;8;71;U;;688;460;228;0;9;451;460
8;Barcelona;13;Barcelonès;08019;Barcelona;8;72;U;;502;353;149;1;4;348;352
8;Barcelona;13;Barcelonès;08019;Barcelona;8;73;U;;663;440;223;2;6;432;438
8;Barcelona;13;Barcelonès;08019;Barcelona;8;74;U;;726;506;220;2;4;500;504
8;Barcelona;13;Barcelonès;08019;Barcelona;8;76;U;;1226;732;494;3;8;721;729
8;Barcelona;13;Barcelonès;08019;Barcelona;8;77;A;;678;397;281;0;4;393;397
8;Barcelona;13;Barcelonès;08019;Barcelona;8;77;B;;599;371;228;1;9;361;370
8;Barcelona;13;Barcelonès;08019;Barcelona;8;8;A;;687;465;222;0;6;459;465
8;Barcelona;13;Barcelonès;08019;Barcelona;8;8;B;;604;407;197;1;8;398;406
8;Barcelona;13;Barcelonès;08019;Barcelona;8;80;A;;634;387;247;2;1;384;385
8;Barcelona;13;Barcelonès;08019;Barcelona;8;80;B;;602;382;220;0;4;378;382
8;Barcelona;13;Barcelonès;08019;Barcelona;8;82;U;;481;297;184;0;3;294;297
8;Barcelona;13;Barcelonès;08019;Barcelona;8;83;U;;489;298;191;2;3;293;296
8;Barcelona;13;Barcelonès;08019;Barcelona;8;84;U;;1057;652;405;0;4;648;652
8;Barcelona;13;Barcelonès;08019;Barcelona;8;85;U;;803;391;412;3;3;385;388
8;Barcelona;13;Barcelonès;08019;Barcelona;8;86;U;;859;457;402;0;4;453;457
8;Barcelona;13;Barcelonès;08019;Barcelona;8;88;U;;927;620;307;0;5;615;620
8;Barcelona;13;Barcelonès;08019;Barcelona;8;89;U;;857;565;292;1;5;559;564
8;Barcelona;13;Barcelonès;08019;Barcelona;8;90;U;;935;650;285;3;9;638;647
8;Barcelona;13;Barcelonès;08019;Barcelona;8;91;A;;782;521;261;2;1;518;519
8;Barcelona;13;Barcelonès;08019;Barcelona;8;91;B;;874;557;317;1;5;551;556
8;Barcelona;13;Barcelonès;08019;Barcelona;8;91;C;;810;506;304;1;4;501;505
8;Barcelona;13;Barcelonès;08019;Barcelona;8;92;A;;814;539;275;3;5;531;536
8;Barcelona;13;Barcelonès;08019;Barcelona;8;92;B;;747;501;246;2;3;496;499
8;Barcelona;13;Barcelonès;08019;Barcelona;8;93;A;;918;633;285;2;6;625;631
8;Barcelona;13;Barcelonès;08019;Barcelona;8;93;B;;879;619;260;1;13;605;618
8;Barcelona;13;Barcelonès;08019;Barcelona;8;94;U;;414;312;102;0;0;312;312
8;Barcelona;13;Barcelonès;08019;Barcelona;8;95;U;;560;410;150;0;1;409;410
8;Barcelona;13;Barcelonès;08019;Barcelona;8;96;U;;773;496;277;1;3;492;495
8;Barcelona;13;Barcelonès;08019;Barcelona;8;97;U;;796;513;283;2;2;509;511
8;Barcelona;13;Barcelonès;08019;Barcelona;8;98;U;;970;599;371;0;0;599;599
8;Barcelona;13;Barcelonès;08019;Barcelona;9;10;U;;494;337;157;1;3;333;336
8;Barcelona;13;Barcelonès;08019;Barcelona;9;100;A;;742;505;237;2;4;499;503
8;Barcelona;13;Barcelonès;08019;Barcelona;9;100;B;;690;460;230;1;9;450;459
8;Barcelona;13;Barcelonès;08019;Barcelona;9;102;A;;718;430;288;3;2;425;427
8;Barcelona;13;Barcelonès;08019;Barcelona;9;102;B;;601;383;218;1;1;381;382
8;Barcelona;13;Barcelonès;08019;Barcelona;9;103;A;;1185;694;491;1;10;683;693
8;Barcelona;13;Barcelonès;08019;Barcelona;9;103;B;;1067;621;446;0;5;616;621
8;Barcelona;13;Barcelonès;08019;Barcelona;9;104;U;;695;440;255;0;9;431;440
8;Barcelona;13;Barcelonès;08019;Barcelona;9;105;U;;417;242;175;1;2;239;241
8;Barcelona;13;Barcelonès;08019;Barcelona;9;106;U;;816;542;274;0;4;538;542
8;Barcelona;13;Barcelonès;08019;Barcelona;9;107;U;;828;574;254;0;2;572;574
8;Barcelona;13;Barcelonès;08019;Barcelona;9;108;U;;1095;778;317;1;9;768;777
8;Barcelona;13;Barcelonès;08019;Barcelona;9;109;U;;959;651;308;0;7;644;651
8;Barcelona;13;Barcelonès;08019;Barcelona;9;11;U;;920;618;302;2;4;612;616
8;Barcelona;13;Barcelonès;08019;Barcelona;9;110;U;;1224;811;413;0;7;804;811
8;Barcelona;13;Barcelonès;08019;Barcelona;9;111;U;;770;529;241;0;5;524;529
8;Barcelona;13;Barcelonès;08019;Barcelona;9;112;A;;868;602;266;11;1;590;591
8;Barcelona;13;Barcelonès;08019;Barcelona;9;112;B;;829;598;231;0;9;589;598
8;Barcelona;13;Barcelonès;08019;Barcelona;9;113;U;;1165;787;378;1;13;773;786
8;Barcelona;13;Barcelonès;08019;Barcelona;9;114;U;;960;658;302;1;8;649;657
8;Barcelona;13;Barcelonès;08019;Barcelona;9;115;U;;994;680;314;8;1;671;672
8;Barcelona;13;Barcelonès;08019;Barcelona;9;116;A;;634;467;167;1;3;463;466
8;Barcelona;13;Barcelonès;08019;Barcelona;9;116;B;;638;466;172;1;2;463;465
8;Barcelona;13;Barcelonès;08019;Barcelona;9;118;U;;1150;781;369;2;5;774;779
8;Barcelona;13;Barcelonès;08019;Barcelona;9;119;U;;847;588;259;0;9;579;588
8;Barcelona;13;Barcelonès;08019;Barcelona;9;120;U;;899;578;321;3;12;563;575
8;Barcelona;13;Barcelonès;08019;Barcelona;9;121;U;;811;498;313;0;0;498;498
8;Barcelona;13;Barcelonès;08019;Barcelona;9;123;U;;631;458;173;0;6;452;458
8;Barcelona;13;Barcelonès;08019;Barcelona;9;124;U;;557;395;162;2;1;392;393
8;Barcelona;13;Barcelonès;08019;Barcelona;9;125;U;;757;592;165;0;4;588;592
8;Barcelona;13;Barcelonès;08019;Barcelona;9;126;U;;1064;764;300;0;8;756;764
8;Barcelona;13;Barcelonès;08019;Barcelona;9;128;U;;763;476;287;0;7;469;476
8;Barcelona;13;Barcelonès;08019;Barcelona;9;129;U;;524;287;237;0;2;285;287
8;Barcelona;13;Barcelonès;08019;Barcelona;9;13;U;;1063;792;271;0;3;789;792
8;Barcelona;13;Barcelonès;08019;Barcelona;9;130;U;;879;507;372;2;2;503;505
8;Barcelona;13;Barcelonès;08019;Barcelona;9;132;U;;1008;576;432;1;8;567;575
8;Barcelona;13;Barcelonès;08019;Barcelona;9;133;U;;652;380;272;0;5;375;380
8;Barcelona;13;Barcelonès;08019;Barcelona;9;134;U;;772;438;334;0;8;430;438
8;Barcelona;13;Barcelonès;08019;Barcelona;9;136;U;;1004;625;379;2;8;615;623
8;Barcelona;13;Barcelonès;08019;Barcelona;9;137;U;;859;468;391;3;5;460;465
8;Barcelona;13;Barcelonès;08019;Barcelona;9;139;U;;629;315;314;1;0;314;314
8;Barcelona;13;Barcelonès;08019;Barcelona;9;14;U;;796;542;254;1;4;537;541
8;Barcelona;13;Barcelonès;08019;Barcelona;9;140;A;;871;526;345;2;6;518;524
8;Barcelona;13;Barcelonès;08019;Barcelona;9;140;B;;745;471;274;3;9;459;468
8;Barcelona;13;Barcelonès;08019;Barcelona;9;142;U;;717;340;377;0;2;338;340
8;Barcelona;13;Barcelonès;08019;Barcelona;9;144;U;;1158;541;617;0;2;539;541
8;Barcelona;13;Barcelonès;08019;Barcelona;9;145;U;;1027;585;442;0;2;583;585
8;Barcelona;13;Barcelonès;08019;Barcelona;9;146;U;;757;440;317;0;0;440;440
8;Barcelona;13;Barcelonès;08019;Barcelona;9;147;U;;1067;598;469;1;2;595;597
8;Barcelona;13;Barcelonès;08019;Barcelona;9;148;U;;571;290;281;0;1;289;290
8;Barcelona;13;Barcelonès;08019;Barcelona;9;149;U;;650;369;281;0;3;366;369
8;Barcelona;13;Barcelonès;08019;Barcelona;9;15;U;;931;667;264;1;2;664;666
8;Barcelona;13;Barcelonès;08019;Barcelona;9;150;U;;910;465;445;0;1;464;465
8;Barcelona;13;Barcelonès;08019;Barcelona;9;151;U;;927;470;457;1;5;464;469
8;Barcelona;13;Barcelonès;08019;Barcelona;9;154;U;;629;316;313;0;2;314;316
8;Barcelona;13;Barcelonès;08019;Barcelona;9;17;U;;1017;758;259;1;14;743;757
8;Barcelona;13;Barcelonès;08019;Barcelona;9;18;U;;689;502;187;1;7;494;501
8;Barcelona;13;Barcelonès;08019;Barcelona;9;19;U;;923;614;309;0;5;609;614
8;Barcelona;13;Barcelonès;08019;Barcelona;9;2;A;;783;543;240;1;4;538;542
8;Barcelona;13;Barcelonès;08019;Barcelona;9;2;B;;745;505;240;0;5;500;505
8;Barcelona;13;Barcelonès;08019;Barcelona;9;20;U;;684;449;235;1;8;440;448
8;Barcelona;13;Barcelonès;08019;Barcelona;9;21;U;;777;554;223;1;4;549;553
8;Barcelona;13;Barcelonès;08019;Barcelona;9;22;U;;504;376;128;0;3;373;376
8;Barcelona;13;Barcelonès;08019;Barcelona;9;23;U;;1108;716;392;3;12;701;713
8;Barcelona;13;Barcelonès;08019;Barcelona;9;25;U;;948;673;275;1;8;664;672
8;Barcelona;13;Barcelonès;08019;Barcelona;9;26;A;;913;656;257;1;6;649;655
8;Barcelona;13;Barcelonès;08019;Barcelona;9;26;B;;806;556;250;4;5;547;552
8;Barcelona;13;Barcelonès;08019;Barcelona;9;27;U;;1027;732;295;1;3;728;731
8;Barcelona;13;Barcelonès;08019;Barcelona;9;28;U;;678;469;209;1;1;467;468
8;Barcelona;13;Barcelonès;08019;Barcelona;9;3;A;;991;703;288;1;8;694;702
8;Barcelona;13;Barcelonès;08019;Barcelona;9;3;B;;797;552;245;1;7;544;551
8;Barcelona;13;Barcelonès;08019;Barcelona;9;30;A;;856;552;304;1;6;545;551
8;Barcelona;13;Barcelonès;08019;Barcelona;9;30;B;;887;551;336;1;10;540;550
8;Barcelona;13;Barcelonès;08019;Barcelona;9;31;U;;819;553;266;1;4;548;552
8;Barcelona;13;Barcelonès;08019;Barcelona;9;32;U;;1124;780;344;1;14;765;779
8;Barcelona;13;Barcelonès;08019;Barcelona;9;33;U;;780;531;249;0;10;521;531
8;Barcelona;13;Barcelonès;08019;Barcelona;9;35;U;;622;427;195;0;10;417;427
8;Barcelona;13;Barcelonès;08019;Barcelona;9;36;U;;440;294;146;1;2;291;293
8;Barcelona;13;Barcelonès;08019;Barcelona;9;37;U;;1124;739;385;3;9;727;736
8;Barcelona;13;Barcelonès;08019;Barcelona;9;39;A;;908;607;301;1;2;604;606
8;Barcelona;13;Barcelonès;08019;Barcelona;9;39;B;;929;597;332;2;4;591;595
8;Barcelona;13;Barcelonès;08019;Barcelona;9;39;C;;956;617;339;1;3;613;616
8;Barcelona;13;Barcelonès;08019;Barcelona;9;4;U;;1118;797;321;0;7;790;797
8;Barcelona;13;Barcelonès;08019;Barcelona;9;40;U;;1111;755;356;4;0;751;751
8;Barcelona;13;Barcelonès;08019;Barcelona;9;41;U;;733;513;220;0;6;507;513
8;Barcelona;13;Barcelonès;08019;Barcelona;9;42;U;;738;496;242;1;4;491;495
8;Barcelona;13;Barcelonès;08019;Barcelona;9;43;U;;832;571;261;1;6;564;570
8;Barcelona;13;Barcelonès;08019;Barcelona;9;44;A;;714;485;229;0;7;478;485
8;Barcelona;13;Barcelonès;08019;Barcelona;9;44;B;;657;428;229;5;3;420;423
8;Barcelona;13;Barcelonès;08019;Barcelona;9;45;A;;846;582;264;0;8;574;582
8;Barcelona;13;Barcelonès;08019;Barcelona;9;45;B;;731;498;233;0;2;496;498
8;Barcelona;13;Barcelonès;08019;Barcelona;9;46;U;;1138;701;437;0;4;697;701
8;Barcelona;13;Barcelonès;08019;Barcelona;9;47;A;;660;442;218;0;6;436;442
8;Barcelona;13;Barcelonès;08019;Barcelona;9;47;B;;666;445;221;2;7;436;443
8;Barcelona;13;Barcelonès;08019;Barcelona;9;48;U;;1166;773;393;2;6;765;771
8;Barcelona;13;Barcelonès;08019;Barcelona;9;49;U;;677;467;210;0;2;465;467
8;Barcelona;13;Barcelonès;08019;Barcelona;9;5;U;;1153;822;331;1;8;813;821
8;Barcelona;13;Barcelonès;08019;Barcelona;9;51;U;;883;544;339;3;7;534;541
8;Barcelona;13;Barcelonès;08019;Barcelona;9;52;U;;742;468;274;1;4;463;467
8;Barcelona;13;Barcelonès;08019;Barcelona;9;54;U;;465;315;150;1;1;313;314
8;Barcelona;13;Barcelonès;08019;Barcelona;9;55;U;;941;608;333;0;9;599;608
8;Barcelona;13;Barcelonès;08019;Barcelona;9;57;U;;542;382;160;1;1;380;381
8;Barcelona;13;Barcelonès;08019;Barcelona;9;59;U;;827;545;282;3;11;531;542
8;Barcelona;13;Barcelonès;08019;Barcelona;9;6;A;;662;460;202;1;2;457;459
8;Barcelona;13;Barcelonès;08019;Barcelona;9;6;B;;574;425;149;0;2;423;425
8;Barcelona;13;Barcelonès;08019;Barcelona;9;60;U;;1178;824;354;2;9;813;822
8;Barcelona;13;Barcelonès;08019;Barcelona;9;62;U;;546;396;150;1;8;387;395
8;Barcelona;13;Barcelonès;08019;Barcelona;9;63;U;;563;407;156;0;3;404;407
8;Barcelona;13;Barcelonès;08019;Barcelona;9;64;U;;907;626;281;0;0;626;626
8;Barcelona;13;Barcelonès;08019;Barcelona;9;66;U;;747;535;212;3;6;526;532
8;Barcelona;13;Barcelonès;08019;Barcelona;9;67;U;;1063;746;317;1;3;742;745
8;Barcelona;13;Barcelonès;08019;Barcelona;9;69;U;;1141;843;298;0;7;836;843
8;Barcelona;13;Barcelonès;08019;Barcelona;9;7;U;;1209;881;328;1;8;872;880
8;Barcelona;13;Barcelonès;08019;Barcelona;9;71;U;;431;305;126;0;0;305;305
8;Barcelona;13;Barcelonès;08019;Barcelona;9;72;U;;1023;716;307;0;10;706;716
8;Barcelona;13;Barcelonès;08019;Barcelona;9;73;U;;722;514;208;0;5;509;514
8;Barcelona;13;Barcelonès;08019;Barcelona;9;74;U;;507;367;140;2;4;361;365
8;Barcelona;13;Barcelonès;08019;Barcelona;9;75;U;;1015;670;345;3;8;659;667
8;Barcelona;13;Barcelonès;08019;Barcelona;9;77;U;;829;605;224;2;6;597;603
8;Barcelona;13;Barcelonès;08019;Barcelona;9;79;U;;812;552;260;2;6;544;550
8;Barcelona;13;Barcelonès;08019;Barcelona;9;80;A;;676;464;212;1;5;458;463
8;Barcelona;13;Barcelonès;08019;Barcelona;9;80;B;;628;441;187;0;3;438;441
8;Barcelona;13;Barcelonès;08019;Barcelona;9;82;U;;913;658;255;0;7;651;658
8;Barcelona;13;Barcelonès;08019;Barcelona;9;84;U;;961;691;270;0;0;691;691
8;Barcelona;13;Barcelonès;08019;Barcelona;9;86;A;;805;575;230;1;9;565;574
8;Barcelona;13;Barcelonès;08019;Barcelona;9;86;B;;729;548;181;1;1;546;547
8;Barcelona;13;Barcelonès;08019;Barcelona;9;87;U;;664;455;209;0;3;452;455
8;Barcelona;13;Barcelonès;08019;Barcelona;9;88;U;;511;337;174;0;5;332;337
8;Barcelona;13;Barcelonès;08019;Barcelona;9;89;U;;1132;797;335;0;7;790;797
8;Barcelona;13;Barcelonès;08019;Barcelona;9;9;U;;523;331;192;0;1;330;331
8;Barcelona;13;Barcelonès;08019;Barcelona;9;90;U;;554;373;181;0;5;368;373
8;Barcelona;13;Barcelonès;08019;Barcelona;9;91;U;;931;662;269;0;7;655;662
8;Barcelona;13;Barcelonès;08019;Barcelona;9;92;U;;739;471;268;0;3;468;471
8;Barcelona;13;Barcelonès;08019;Barcelona;9;94;U;;614;429;185;0;4;425;429
8;Barcelona;13;Barcelonès;08019;Barcelona;9;95;U;;557;399;158;1;3;395;398
8;Barcelona;13;Barcelonès;08019;Barcelona;9;96;U;;493;313;180;0;3;310;313
8;Barcelona;13;Barcelonès;08019;Barcelona;9;97;U;;690;460;230;0;11;449;460
8;Barcelona;13;Barcelonès;08019;Barcelona;9;98;U;;1218;733;485;4;7;722;729
25;Lleida;23;Noguera;25042;Baronia de Rialb, la;1;1;U;;231;169;62;0;1;168;169
17;Girona;2;Alt Empordà;17016;Bàscara;1;1;U;;717;531;186;0;5;526;531
25;Lleida;4;Alt Urgell;25044;Bassella;1;1;U;;225;166;59;1;0;165;165
43;Tarragona;37;Terra Alta;43022;Batea;1;1;U;;868;700;168;4;11;685;696
43;Tarragona;37;Terra Alta;43022;Batea;1;2;U;;806;642;164;2;5;635;640
25;Lleida;39;Consell General d'Aran;25045;Bausen;1;1;U;;44;30;14;0;0;30;30
8;Barcelona;11;Baix Llobregat;08020;Begues;1;1;A;;648;450;198;1;3;446;449
8;Barcelona;11;Baix Llobregat;08020;Begues;1;1;B;;631;428;203;0;5;423;428
8;Barcelona;11;Baix Llobregat;08020;Begues;1;1;C;;658;474;184;2;3;469;472
8;Barcelona;11;Baix Llobregat;08020;Begues;1;1;D;;692;479;213;0;5;474;479
8;Barcelona;11;Baix Llobregat;08020;Begues;1;2;A;;537;386;151;0;0;386;386
8;Barcelona;11;Baix Llobregat;08020;Begues;1;2;B;;580;425;155;0;4;421;425
17;Girona;10;Baix Empordà;17013;Begur;1;1;A;;529;336;193;0;0;336;336
17;Girona;10;Baix Empordà;17013;Begur;1;1;B;;524;319;205;0;3;316;319
17;Girona;10;Baix Empordà;17013;Begur;1;2;U;;597;442;155;0;5;437;442
17;Girona;10;Baix Empordà;17013;Begur;1;3;A;;533;410;123;1;3;406;409
17;Girona;10;Baix Empordà;17013;Begur;1;3;B;;448;337;111;2;5;330;335
25;Lleida;38;Urgell;25046;Belianes;1;1;U;;482;380;102;1;4;375;379
25;Lleida;18;Garrigues;25170;Bellaguarda;1;1;U;;307;227;80;0;1;226;227
17;Girona;10;Baix Empordà;17018;Bellcaire d'Empordà;1;1;U;;460;346;114;4;0;342;342
25;Lleida;23;Noguera;25047;Bellcaire d'Urgell;1;1;A;;520;398;122;5;4;389;393
25;Lleida;23;Noguera;25047;Bellcaire d'Urgell;1;1;B;;558;437;121;0;0;437;437
25;Lleida;27;Pla d'Urgell;25048;Bell-lloc d'Urgell;1;1;U;;736;534;202;4;10;520;530
25;Lleida;27;Pla d'Urgell;25048;Bell-lloc d'Urgell;1;2;U;;974;733;241;10;2;721;723
25;Lleida;23;Noguera;25049;Bellmunt d'Urgell;1;1;U;;187;143;44;0;1;142;143
43;Tarragona;29;Priorat;43023;Bellmunt del Priorat;1;1;U;;273;215;58;1;0;214;214
8;Barcelona;6;Anoia;08021;Bellprat;1;1;U;;83;52;31;1;0;51;51
25;Lleida;38;Urgell;25050;Bellpuig;1;1;A;;649;487;162;2;7;478;485
25;Lleida;38;Urgell;25050;Bellpuig;1;1;B;;639;437;202;3;2;432;434
25;Lleida;38;Urgell;25050;Bellpuig;1;2;A;;463;350;113;0;5;345;350
25;Lleida;38;Urgell;25050;Bellpuig;1;2;B;;570;419;151;1;3;415;418
25;Lleida;38;Urgell;25050;Bellpuig;1;3;U;;931;666;265;5;16;645;661
43;Tarragona;12;Baix Penedès;43024;Bellvei;1;1;A;;465;302;163;0;0;302;302
43;Tarragona;12;Baix Penedès;43024;Bellvei;1;1;B;;691;479;212;0;5;474;479
25;Lleida;15;Cerdanya;25051;Bellver de Cerdanya;1;1;A;;633;432;201;2;3;427;430
25;Lleida;15;Cerdanya;25051;Bellver de Cerdanya;1;1;B;;836;544;292;3;5;536;541
25;Lleida;27;Pla d'Urgell;25052;Bellvís;1;1;A;;911;647;264;0;8;639;647
25;Lleida;27;Pla d'Urgell;25052;Bellvís;1;1;B;;838;622;216;4;4;614;618
25;Lleida;33;Segrià;25053;Benavent de Segrià;1;1;U;;902;623;279;2;8;613;621
43;Tarragona;9;Baix Ebre;43025;Benifallet;1;1;U;;737;527;210;3;3;521;524
43;Tarragona;30;Ribera d'Ebre;43026;Benissanet;1;1;U;;864;682;182;3;11;668;679
8;Barcelona;14;Berguedà;08022;Berga;1;1;A;;570;394;176;0;6;388;394
8;Barcelona;14;Berguedà;08022;Berga;1;1;B;;591;387;204;3;4;380;384
8;Barcelona;14;Berguedà;08022;Berga;1;2;A;;521;351;170;1;2;348;350
8;Barcelona;14;Berguedà;08022;Berga;1;2;B;;582;409;173;1;2;406;408
8;Barcelona;14;Berguedà;08022;Berga;1;3;U;;780;599;181;3;8;588;596
8;Barcelona;14;Berguedà;08022;Berga;1;4;A;;909;622;287;1;3;618;621
8;Barcelona;14;Berguedà;08022;Berga;1;4;B;;1072;717;355;3;11;703;714
8;Barcelona;14;Berguedà;08022;Berga;1;5;A;;644;473;171;0;5;468;473
8;Barcelona;14;Berguedà;08022;Berga;1;5;B;;726;513;213;0;7;506;513
8;Barcelona;14;Berguedà;08022;Berga;2;1;A;;369;213;156;0;6;207;213
8;Barcelona;14;Berguedà;08022;Berga;2;1;B;;382;215;167;0;0;215;215
8;Barcelona;14;Berguedà;08022;Berga;2;2;U;;769;466;303;4;5;457;462
8;Barcelona;14;Berguedà;08022;Berga;2;3;A;;890;534;356;1;3;530;533
8;Barcelona;14;Berguedà;08022;Berga;2;3;B;;1098;662;436;3;3;656;659
8;Barcelona;14;Berguedà;08022;Berga;2;4;A;;659;456;203;3;0;453;453
8;Barcelona;14;Berguedà;08022;Berga;2;4;B;;715;487;228;2;7;478;485
8;Barcelona;14;Berguedà;08022;Berga;3;1;A;;247;151;96;1;3;147;150
8;Barcelona;14;Berguedà;08022;Berga;3;1;B;;347;264;83;3;3;258;261
8;Barcelona;14;Berguedà;08022;Berga;4;1;U;;565;398;167;1;5;392;397
17;Girona;19;Garrotxa;17019;Besalú;1;1;A;;525;410;115;6;4;400;404
17;Girona;19;Garrotxa;17019;Besalú;1;1;B;;655;499;156;1;5;493;498
17;Girona;19;Garrotxa;17019;Besalú;1;1;C;;590;469;121;3;2;464;466
17;Girona;20;Gironès;17020;Bescanó;1;1;A;;460;340;120;1;4;335;339
17;Girona;20;Gironès;17020;Bescanó;1;1;B;;505;374;131;1;5;368;373
17;Girona;20;Gironès;17020;Bescanó;1;2;A;;330;221;109;0;3;218;221
17;Girona;20;Gironès;17020;Bescanó;1;2;B;;317;222;95;0;0;222;222
17;Girona;20;Gironès;17020;Bescanó;1;3;A;;409;326;83;0;1;325;326
17;Girona;20;Gironès;17020;Bescanó;1;3;B;;413;313;100;0;1;312;313
17;Girona;20;Gironès;17020;Bescanó;1;3;C;;429;328;101;0;3;325;328
17;Girona;19;Garrotxa;17021;Beuda;1;1;U;;115;89;26;0;0;89;89
8;Barcelona;41;Vallès Oriental;08023;Bigues i Riells;1;1;A;;1235;717;518;0;6;711;717
8;Barcelona;41;Vallès Oriental;08023;Bigues i Riells;1;1;B;;831;490;341;2;5;483;488
8;Barcelona;41;Vallès Oriental;08023;Bigues i Riells;1;1;C;;932;519;413;0;1;518;519
8;Barcelona;41;Vallès Oriental;08023;Bigues i Riells;1;1;D;;877;472;405;2;3;467;470
8;Barcelona;41;Vallès Oriental;08023;Bigues i Riells;1;1;E;;777;477;300;1;3;473;476
8;Barcelona;41;Vallès Oriental;08023;Bigues i Riells;1;1;F;;499;349;150;0;0;349;349
25;Lleida;32;Segarra;25055;Biosca;1;1;U;;207;163;44;2;2;159;161
17;Girona;10;Baix Empordà;17022;Bisbal d'Empordà, la;1;2;A;;530;353;177;1;1;351;352
17;Girona;10;Baix Empordà;17022;Bisbal d'Empordà, la;1;2;B;;485;329;156;2;5;322;327
17;Girona;10;Baix Empordà;17022;Bisbal d'Empordà, la;1;3;U;;1022;663;359;3;7;653;660
17;Girona;10;Baix Empordà;17022;Bisbal d'Empordà, la;1;4;A;;748;489;259;3;1;485;486
17;Girona;10;Baix Empordà;17022;Bisbal d'Empordà, la;1;4;B;;725;512;213;2;4;506;510
17;Girona;10;Baix Empordà;17022;Bisbal d'Empordà, la;2;1;U;;948;644;304;7;8;629;637
17;Girona;10;Baix Empordà;17022;Bisbal d'Empordà, la;2;2;A;;539;360;179;1;5;354;359
17;Girona;10;Baix Empordà;17022;Bisbal d'Empordà, la;2;2;B;;575;403;172;3;2;398;400
17;Girona;10;Baix Empordà;17022;Bisbal d'Empordà, la;2;3;U;;884;570;314;1;2;567;569
43;Tarragona;29;Priorat;43027;Bisbal de Falset, la;1;1;U;;206;142;64;0;2;140;142
43;Tarragona;12;Baix Penedès;43028;Bisbal del Penedès, la;1;1;A;;854;519;335;5;2;512;514
43;Tarragona;12;Baix Penedès;43028;Bisbal del Penedès, la;1;1;B;;1036;637;399;5;6;626;632
17;Girona;2;Alt Empordà;17234;Biure;1;1;U;;184;134;50;0;0;134;134
43;Tarragona;16;Conca de Barberà;43029;Blancafort;1;1;U;;323;230;93;2;2;226;228
17;Girona;34;Selva;17023;Blanes;1;1;U;;917;631;286;3;5;623;628
17;Girona;34;Selva;17023;Blanes;1;2;A;;928;645;283;1;9;635;644
17;Girona;34;Selva;17023;Blanes;1;2;B;;943;656;287;2;4;650;654
17;Girona;34;Selva;17023;Blanes;1;4;A;;786;506;280;3;3;500;503
17;Girona;34;Selva;17023;Blanes;1;4;B;;706;426;280;2;6;418;424
17;Girona;34;Selva;17023;Blanes;1;6;A;;632;332;300;0;2;330;332
17;Girona;34;Selva;17023;Blanes;1;6;B;;579;301;278;2;3;296;299
17;Girona;34;Selva;17023;Blanes;2;1;A;;856;565;291;1;5;559;564
17;Girona;34;Selva;17023;Blanes;2;1;B;;784;510;274;0;4;506;510
17;Girona;34;Selva;17023;Blanes;2;10;A;;781;361;420;2;4;355;359
17;Girona;34;Selva;17023;Blanes;2;10;B;;732;325;407;1;3;321;324
17;Girona;34;Selva;17023;Blanes;2;11;A;;604;349;255;4;5;340;345
17;Girona;34;Selva;17023;Blanes;2;11;B;;566;326;240;0;5;321;326
17;Girona;34;Selva;17023;Blanes;2;2;U;;843;508;335;4;1;503;504
17;Girona;34;Selva;17023;Blanes;2;3;A;;581;303;278;1;9;293;302
17;Girona;34;Selva;17023;Blanes;2;3;B;;588;333;255;1;3;329;332
17;Girona;34;Selva;17023;Blanes;2;4;A;;750;457;293;4;0;453;453
17;Girona;34;Selva;17023;Blanes;2;4;B;;736;428;308;1;4;423;427
17;Girona;34;Selva;17023;Blanes;2;5;A;;819;427;392;0;5;422;427
17;Girona;34;Selva;17023;Blanes;2;5;B;;766;399;367;0;3;396;399
17;Girona;34;Selva;17023;Blanes;2;6;A;;934;601;333;0;3;598;601
17;Girona;34;Selva;17023;Blanes;2;6;B;;869;577;292;0;0;577;577
17;Girona;34;Selva;17023;Blanes;2;7;A;;921;553;368;1;7;545;552
17;Girona;34;Selva;17023;Blanes;2;7;B;;909;554;355;2;6;546;552
17;Girona;34;Selva;17023;Blanes;2;8;A;;803;497;306;4;5;488;493
17;Girona;34;Selva;17023;Blanes;2;8;B;;792;515;277;1;8;506;514
17;Girona;34;Selva;17023;Blanes;2;9;U;;710;464;246;2;0;462;462
17;Girona;34;Selva;17023;Blanes;3;1;A;;573;331;242;2;5;324;329
17;Girona;34;Selva;17023;Blanes;3;1;B;;492;269;223;1;0;268;268
17;Girona;34;Selva;17023;Blanes;3;2;A;;481;284;197;3;2;279;281
17;Girona;34;Selva;17023;Blanes;3;2;B;;496;319;177;1;2;316;318
17;Girona;34;Selva;17023;Blanes;3;3;A;;906;512;394;5;6;501;507
17;Girona;34;Selva;17023;Blanes;3;3;B;;285;212;73;3;6;203;209
17;Girona;34;Selva;17023;Blanes;3;4;A;;400;230;170;0;3;227;230
17;Girona;34;Selva;17023;Blanes;3;4;B;;914;513;401;0;10;503;513
17;Girona;2;Alt Empordà;17029;Boadella i les Escaules;1;1;U;;207;139;68;1;2;136;138
17;Girona;15;Cerdanya;17024;Bolvir;1;1;U;;249;157;92;0;0;157;157
43;Tarragona;12;Baix Penedès;43030;Bonastre;1;1;U;;307;228;79;2;4;222;226
25;Lleida;39;Consell General d'Aran;25057;Bòrdes, es;1;1;U;;190;127;63;1;1;125;126
17;Girona;20;Gironès;17025;Bordils;1;1;U;;1068;810;258;4;7;799;806
25;Lleida;18;Garrigues;25058;Borges Blanques, les;1;1;U;;761;533;228;1;2;530;532
25;Lleida;18;Garrigues;25058;Borges Blanques, les;1;2;A;;487;334;153;2;1;331;332
25;Lleida;18;Garrigues;25058;Borges Blanques, les;1;2;B;;598;425;173;0;1;424;425
25;Lleida;18;Garrigues;25058;Borges Blanques, les;2;1;A;;676;467;209;1;1;465;466
25;Lleida;18;Garrigues;25058;Borges Blanques, les;2;1;B;;694;477;217;3;8;466;474
25;Lleida;18;Garrigues;25058;Borges Blanques, les;2;2;A;;558;380;178;0;3;377;380
25;Lleida;18;Garrigues;25058;Borges Blanques, les;2;2;B;;613;416;197;0;3;413;416
43;Tarragona;8;Baix Camp;43031;Borges del Camp, les;1;1;A;;673;507;166;0;2;505;507
43;Tarragona;8;Baix Camp;43031;Borges del Camp, les;1;1;B;;713;518;195;4;6;508;514
17;Girona;2;Alt Empordà;17026;Borrassà;1;1;U;;456;350;106;3;0;347;347
8;Barcelona;14;Berguedà;08024;Borredà;1;1;U;;394;293;101;1;1;291;292
25;Lleida;39;Consell General d'Aran;25059;Bossòst;1;1;U;;764;555;209;4;3;548;551
43;Tarragona;37;Terra Alta;43032;Bot;1;1;U;;699;541;158;7;2;532;534
43;Tarragona;8;Baix Camp;43033;Botarell;1;1;U;;613;423;190;0;3;420;423
25;Lleida;18;Garrigues;25056;Bovera;1;1;U;;350;252;98;0;4;248;252
43;Tarragona;1;Alt Camp;43034;Bràfim;1;1;U;;482;372;110;4;7;361;368
17;Girona;34;Selva;17027;Breda;1;1;A;;522;364;158;2;2;360;362
17;Girona;34;Selva;17027;Breda;1;1;B;;562;373;189;3;4;366;370
17;Girona;34;Selva;17027;Breda;1;1;C;;477;325;152;5;2;318;320
17;Girona;34;Selva;17027;Breda;1;2;A;;567;442;125;1;6;435;441
17;Girona;34;Selva;17027;Breda;1;2;B;;688;503;185;0;5;498;503
8;Barcelona;6;Anoia;08025;Bruc, el;1;1;U;;1091;703;388;3;2;698;700
8;Barcelona;24;Osona;08026;Brull, el;1;1;U;;169;143;26;0;0;143;143
17;Girona;34;Selva;17028;Brunyola i Sant Martí Sapresa;1;1;U;;304;210;94;0;0;210;210
43;Tarragona;29;Priorat;43035;Cabacés;1;1;U;;307;226;81;0;5;221;226
25;Lleida;23;Noguera;25060;Cabanabona;1;1;U;;94;71;23;1;1;69;70
17;Girona;2;Alt Empordà;17031;Cabanelles;1;1;U;;188;128;60;0;2;126;128
17;Girona;2;Alt Empordà;17030;Cabanes;1;1;U;;651;457;194;4;2;451;453
8;Barcelona;3;Alt Penedès;08027;Cabanyes, les;1;1;U;;479;364;115;1;1;362;363
25;Lleida;4;Alt Urgell;25061;Cabó;1;1;U;;103;63;40;0;0;63;63
43;Tarragona;1;Alt Camp;43036;Cabra del Camp;1;1;U;;603;377;226;1;3;373;376
8;Barcelona;6;Anoia;08028;Cabrera d'Anoia;1;1;U;;608;394;214;1;1;392;393
8;Barcelona;21;Maresme;08029;Cabrera de Mar;1;1;A;;896;659;237;0;5;654;659
8;Barcelona;21;Maresme;08029;Cabrera de Mar;1;1;B;;868;628;240;4;4;620;624
8;Barcelona;21;Maresme;08029;Cabrera de Mar;1;2;A;;628;424;204;1;8;415;423
8;Barcelona;21;Maresme;08029;Cabrera de Mar;1;2;B;;672;470;202;1;8;461;469
8;Barcelona;21;Maresme;08030;Cabrils;1;1;A;;1012;677;335;1;4;672;676
8;Barcelona;21;Maresme;08030;Cabrils;1;1;B;;1079;736;343;1;5;730;735
8;Barcelona;21;Maresme;08030;Cabrils;1;2;A;;981;698;283;8;1;689;690
8;Barcelona;21;Maresme;08030;Cabrils;1;2;B;;990;697;293;0;6;691;697
17;Girona;2;Alt Empordà;17032;Cadaqués;1;1;A;;792;517;275;2;2;513;515
17;Girona;2;Alt Empordà;17032;Cadaqués;1;1;B;;774;501;273;1;4;496;500
8;Barcelona;6;Anoia;08031;Calaf;1;1;U;;614;436;178;2;6;428;434
8;Barcelona;6;Anoia;08031;Calaf;1;2;A;;619;475;144;1;3;471;474
8;Barcelona;6;Anoia;08031;Calaf;1;2;B;;533;386;147;1;4;381;385
8;Barcelona;6;Anoia;08031;Calaf;1;2;C;;660;510;150;2;3;505;508
43;Tarragona;12;Baix Penedès;43037;Calafell;1;1;A;;714;368;346;3;2;363;365
43;Tarragona;12;Baix Penedès;43037;Calafell;1;1;B;;825;420;405;2;3;415;418
43;Tarragona;12;Baix Penedès;43037;Calafell;1;1;C;;824;413;411;4;5;404;409
43;Tarragona;12;Baix Penedès;43037;Calafell;1;2;U;;1128;637;491;5;7;625;632
43;Tarragona;12;Baix Penedès;43037;Calafell;1;3;A;;585;367;218;2;1;364;365
43;Tarragona;12;Baix Penedès;43037;Calafell;1;3;B;;869;566;303;1;4;561;565
43;Tarragona;12;Baix Penedès;43037;Calafell;2;1;A;;545;331;214;2;2;327;329
43;Tarragona;12;Baix Penedès;43037;Calafell;2;1;B;;565;341;224;4;5;332;337
43;Tarragona;12;Baix Penedès;43037;Calafell;2;1;C;;834;533;301;4;5;524;529
43;Tarragona;12;Baix Penedès;43037;Calafell;2;2;A;;509;261;248;0;4;257;261
43;Tarragona;12;Baix Penedès;43037;Calafell;2;2;B;;638;304;334;1;4;299;303
43;Tarragona;12;Baix Penedès;43037;Calafell;2;2;C;;635;311;324;0;3;308;311
43;Tarragona;12;Baix Penedès;43037;Calafell;2;3;A;;651;294;357;1;1;292;293
43;Tarragona;12;Baix Penedès;43037;Calafell;2;3;B;;787;346;441;4;1;341;342
43;Tarragona;12;Baix Penedès;43037;Calafell;2;3;C;;764;366;398;1;6;359;365
43;Tarragona;12;Baix Penedès;43037;Calafell;3;1;A;;598;323;275;1;1;321;322
43;Tarragona;12;Baix Penedès;43037;Calafell;3;1;B;;822;422;400;3;2;417;419
8;Barcelona;;;08034;Calders;1;1;U;;630;483;147;1;0;482;482
8;Barcelona;21;Maresme;08032;Caldes d'Estrac;1;1;A;;808;560;248;2;7;551;558
8;Barcelona;21;Maresme;08032;Caldes d'Estrac;1;1;B;;942;633;309;0;2;631;633
17;Girona;34;Selva;17033;Caldes de Malavella;1;1;A;;734;463;271;5;3;455;458
17;Girona;34;Selva;17033;Caldes de Malavella;1;1;B;;617;375;242;2;7;366;373
17;Girona;34;Selva;17033;Caldes de Malavella;1;2;A;;826;448;378;2;4;442;446
17;Girona;34;Selva;17033;Caldes de Malavella;1;2;B;;801;441;360;1;3;437;440
17;Girona;34;Selva;17033;Caldes de Malavella;1;3;U;;865;604;261;2;5;597;602
8;Barcelona;41;Vallès Oriental;08033;Caldes de Montbui;1;1;A;;498;355;143;0;5;350;355
8;Barcelona;41;Vallès Oriental;08033;Caldes de Montbui;1;1;B;;652;457;195;0;6;451;457
8;Barcelona;41;Vallès Oriental;08033;Caldes de Montbui;1;2;A;;807;490;317;1;6;483;489
8;Barcelona;41;Vallès Oriental;08033;Caldes de Montbui;1;2;B;;873;525;348;1;6;518;524
8;Barcelona;41;Vallès Oriental;08033;Caldes de Montbui;1;3;U;;735;509;226;0;5;504;509
8;Barcelona;41;Vallès Oriental;08033;Caldes de Montbui;2;1;A;;576;395;181;0;7;388;395
8;Barcelona;41;Vallès Oriental;08033;Caldes de Montbui;2;1;B;;587;375;212;1;3;371;374
8;Barcelona;41;Vallès Oriental;08033;Caldes de Montbui;2;1;C;;596;414;182;0;3;411;414
8;Barcelona;41;Vallès Oriental;08033;Caldes de Montbui;3;1;A;;606;391;215;0;4;387;391
8;Barcelona;41;Vallès Oriental;08033;Caldes de Montbui;3;1;B;;703;459;244;1;6;452;458
8;Barcelona;41;Vallès Oriental;08033;Caldes de Montbui;3;2;U;;689;449;240;0;0;449;449
8;Barcelona;41;Vallès Oriental;08033;Caldes de Montbui;3;3;A;;876;457;419;2;7;448;455
8;Barcelona;41;Vallès Oriental;08033;Caldes de Montbui;3;3;B;;785;400;385;0;5;395;400
8;Barcelona;41;Vallès Oriental;08033;Caldes de Montbui;3;3;C;;624;343;281;3;3;337;340
8;Barcelona;41;Vallès Oriental;08033;Caldes de Montbui;3;4;A;;786;533;253;1;8;524;532
8;Barcelona;41;Vallès Oriental;08033;Caldes de Montbui;3;4;B;;957;632;325;4;8;620;628
8;Barcelona;21;Maresme;08035;Calella;1;1;A;;490;318;172;0;0;318;318
8;Barcelona;21;Maresme;08035;Calella;1;1;B;;629;396;233;1;1;394;395
8;Barcelona;21;Maresme;08035;Calella;1;2;U;;777;530;247;0;5;525;530
8;Barcelona;21;Maresme;08035;Calella;1;3;A;;497;258;239;0;2;256;258
8;Barcelona;21;Maresme;08035;Calella;1;3;B;;738;388;350;6;1;381;382
8;Barcelona;21;Maresme;08035;Calella;2;1;U;;709;472;237;0;3;469;472
8;Barcelona;21;Maresme;08035;Calella;2;2;A;;461;289;172;0;0;289;289
8;Barcelona;21;Maresme;08035;Calella;2;2;B;;489;310;179;2;1;307;308
8;Barcelona;21;Maresme;08035;Calella;2;2;C;;560;392;168;0;1;391;392
8;Barcelona;21;Maresme;08035;Calella;3;1;A;;550;368;182;0;0;368;368
8;Barcelona;21;Maresme;08035;Calella;3;1;B;;594;379;215;0;0;379;379
8;Barcelona;21;Maresme;08035;Calella;3;1;C;;592;404;188;2;3;399;402
8;Barcelona;21;Maresme;08035;Calella;3;2;A;;528;332;196;1;4;327;331
8;Barcelona;21;Maresme;08035;Calella;3;2;B;;599;332;267;2;6;324;330
8;Barcelona;21;Maresme;08035;Calella;3;2;C;;635;399;236;2;1;396;397
8;Barcelona;21;Maresme;08035;Calella;3;3;A;;682;436;246;2;2;432;434
8;Barcelona;21;Maresme;08035;Calella;3;3;B;;753;439;314;1;6;432;438
8;Barcelona;21;Maresme;08035;Calella;3;3;C;;677;433;244;0;3;430;433
8;Barcelona;24;Osona;08037;Calldetenes;1;1;A;;785;606;179;3;3;600;603
8;Barcelona;24;Osona;08037;Calldetenes;1;1;B;;811;612;199;2;4;606;610
8;Barcelona;7;Bages;08038;Callús;1;1;A;;498;356;142;0;3;353;356
8;Barcelona;7;Bages;08038;Callús;1;1;B;;637;443;194;0;3;440;443
17;Girona;10;Baix Empordà;17034;Calonge i Sant Antoni;1;1;A;;508;321;187;0;2;319;321
17;Girona;10;Baix Empordà;17034;Calonge i Sant Antoni;1;1;B;;777;452;325;1;1;450;451
17;Girona;10;Baix Empordà;17034;Calonge i Sant Antoni;1;1;C;;480;292;188;1;3;288;291
17;Girona;10;Baix Empordà;17034;Calonge i Sant Antoni;1;2;A;;565;343;222;1;4;338;342
17;Girona;10;Baix Empordà;17034;Calonge i Sant Antoni;1;2;B;;506;303;203;0;2;301;303
17;Girona;10;Baix Empordà;17034;Calonge i Sant Antoni;1;3;A;;616;370;246;2;2;366;368
17;Girona;10;Baix Empordà;17034;Calonge i Sant Antoni;1;3;B;;489;291;198;0;4;287;291
17;Girona;10;Baix Empordà;17034;Calonge i Sant Antoni;1;4;A;;551;311;240;2;1;308;309
17;Girona;10;Baix Empordà;17034;Calonge i Sant Antoni;1;4;B;;736;418;318;4;4;410;414
17;Girona;10;Baix Empordà;17034;Calonge i Sant Antoni;1;4;C;;507;295;212;2;4;289;293
8;Barcelona;6;Anoia;08036;Calonge de Segarra;1;1;U;;166;123;43;0;0;123;123
25;Lleida;23;Noguera;25062;Camarasa;1;1;U;;805;598;207;0;7;591;598
43;Tarragona;9;Baix Ebre;43903;Camarles;1;1;A;;866;610;256;6;10;594;604
43;Tarragona;9;Baix Ebre;43903;Camarles;1;1;B;;734;511;223;2;3;506;509
43;Tarragona;9;Baix Ebre;43903;Camarles;1;2;U;;752;433;319;1;3;429;432
43;Tarragona;8;Baix Camp;43038;Cambrils;1;1;A;;589;305;284;0;4;301;305
43;Tarragona;8;Baix Camp;43038;Cambrils;1;1;B;;684;366;318;0;5;361;366
43;Tarragona;8;Baix Camp;43038;Cambrils;1;2;A;;818;421;397;0;2;419;421
43;Tarragona;8;Baix Camp;43038;Cambrils;1;2;B;;934;537;397;3;5;529;534
43;Tarragona;8;Baix Camp;43038;Cambrils;1;3;A;;809;448;361;2;6;440;446
43;Tarragona;8;Baix Camp;43038;Cambrils;1;3;B;;942;541;401;0;5;536;541
43;Tarragona;8;Baix Camp;43038;Cambrils;1;4;A;;720;321;399;1;4;316;320
43;Tarragona;8;Baix Camp;43038;Cambrils;1;4;B;;926;462;464;0;6;456;462
43;Tarragona;8;Baix Camp;43038;Cambrils;1;5;A;;413;266;147;1;2;263;265
43;Tarragona;8;Baix Camp;43038;Cambrils;1;5;B;;455;276;179;0;4;272;276
43;Tarragona;8;Baix Camp;43038;Cambrils;2;1;A;;714;449;265;3;6;440;446
43;Tarragona;8;Baix Camp;43038;Cambrils;2;1;B;;676;423;253;1;1;421;422
43;Tarragona;8;Baix Camp;43038;Cambrils;2;2;A;;591;335;256;2;3;330;333
43;Tarragona;8;Baix Camp;43038;Cambrils;2;2;B;;608;329;279;1;1;327;328
43;Tarragona;8;Baix Camp;43038;Cambrils;2;3;A;;556;322;234;1;4;317;321
43;Tarragona;8;Baix Camp;43038;Cambrils;2;3;B;;731;442;289;0;4;438;442
43;Tarragona;8;Baix Camp;43038;Cambrils;2;4;A;;443;219;224;0;3;216;219
43;Tarragona;8;Baix Camp;43038;Cambrils;2;4;B;;535;286;249;2;3;281;284
43;Tarragona;8;Baix Camp;43038;Cambrils;2;5;A;;703;364;339;1;3;360;363
43;Tarragona;8;Baix Camp;43038;Cambrils;2;5;B;;797;439;358;1;3;435;438
43;Tarragona;8;Baix Camp;43038;Cambrils;2;6;A;;518;274;244;1;2;271;273
43;Tarragona;8;Baix Camp;43038;Cambrils;2;6;B;;560;283;277;0;2;281;283
43;Tarragona;8;Baix Camp;43038;Cambrils;2;7;A;;715;437;278;0;6;431;437
43;Tarragona;8;Baix Camp;43038;Cambrils;2;7;B;;759;362;397;0;4;358;362
43;Tarragona;8;Baix Camp;43038;Cambrils;2;8;A;;472;247;225;2;0;245;245
43;Tarragona;8;Baix Camp;43038;Cambrils;2;8;B;;516;237;279;1;3;233;236
17;Girona;28;Pla de l'Estany;17035;Camós;1;1;U;;550;442;108;3;4;435;439
17;Girona;31;Ripollès;17036;Campdevànol;1;1;A;;541;418;123;0;8;410;418
17;Girona;31;Ripollès;17036;Campdevànol;1;1;B;;599;464;135;2;9;453;462
17;Girona;31;Ripollès;17036;Campdevànol;1;2;A;;439;315;124;1;4;310;314
17;Girona;31;Ripollès;17036;Campdevànol;1;2;B;;450;332;118;2;1;329;330
17;Girona;31;Ripollès;17036;Campdevànol;1;3;A;;426;297;129;1;2;294;296
17;Girona;31;Ripollès;17036;Campdevànol;1;3;B;;425;296;129;0;2;294;296
17;Girona;31;Ripollès;17037;Campelles;1;1;U;;111;83;28;0;2;81;83
8;Barcelona;41;Vallès Oriental;08039;Campins;1;1;U;;247;178;69;0;3;175;178
17;Girona;20;Gironès;17038;Campllong;1;1;U;;267;210;57;2;1;207;208
17;Girona;31;Ripollès;17039;Camprodon;1;1;A;;598;476;122;3;3;470;473
17;Girona;31;Ripollès;17039;Camprodon;1;1;B;;700;535;165;1;7;527;534
17;Girona;31;Ripollès;17039;Camprodon;1;2;U;;732;541;191;4;3;534;537
25;Lleida;39;Consell General d'Aran;25063;Canejan;1;1;U;;95;64;31;0;0;64;64
17;Girona;20;Gironès;17040;Canet d'Adri;1;1;U;;471;327;144;2;5;320;325
8;Barcelona;21;Maresme;08040;Canet de Mar;1;1;A;;735;510;225;0;5;505;510
8;Barcelona;21;Maresme;08040;Canet de Mar;1;1;B;;725;472;253;3;18;451;469
8;Barcelona;21;Maresme;08040;Canet de Mar;1;1;C;;845;572;273;1;4;567;571
8;Barcelona;21;Maresme;08040;Canet de Mar;1;2;A;;666;434;232;2;4;428;432
8;Barcelona;21;Maresme;08040;Canet de Mar;1;2;B;;714;405;309;4;5;396;401
8;Barcelona;21;Maresme;08040;Canet de Mar;1;2;C;;692;414;278;0;2;412;414
8;Barcelona;21;Maresme;08040;Canet de Mar;1;3;A;;706;444;262;1;2;441;443
8;Barcelona;21;Maresme;08040;Canet de Mar;1;3;B;;787;471;316;0;8;463;471
8;Barcelona;21;Maresme;08040;Canet de Mar;1;3;C;;658;444;214;1;6;437;443
8;Barcelona;21;Maresme;08040;Canet de Mar;1;4;A;;701;463;238;1;5;457;462
8;Barcelona;21;Maresme;08040;Canet de Mar;1;4;B;;530;341;189;0;5;336;341
8;Barcelona;21;Maresme;08040;Canet de Mar;1;4;C;;788;538;250;0;2;536;538
8;Barcelona;21;Maresme;08040;Canet de Mar;1;4;D;;711;454;257;1;7;446;453
8;Barcelona;41;Vallès Oriental;08041;Canovelles;1;1;U;;1006;550;456;0;7;543;550
8;Barcelona;41;Vallès Oriental;08041;Canovelles;1;2;A;;610;348;262;0;1;347;348
8;Barcelona;41;Vallès Oriental;08041;Canovelles;1;2;B;;754;421;333;0;4;417;421
8;Barcelona;41;Vallès Oriental;08041;Canovelles;1;3;A;;592;317;275;2;2;313;315
8;Barcelona;41;Vallès Oriental;08041;Canovelles;1;3;B;;722;367;355;1;7;359;366
8;Barcelona;41;Vallès Oriental;08041;Canovelles;1;4;U;;885;434;451;1;4;429;433
8;Barcelona;41;Vallès Oriental;08041;Canovelles;1;5;A;;454;243;211;2;2;239;241
8;Barcelona;41;Vallès Oriental;08041;Canovelles;1;5;B;;658;343;315;2;2;339;341
8;Barcelona;41;Vallès Oriental;08041;Canovelles;1;6;A;;638;400;238;1;1;398;399
8;Barcelona;41;Vallès Oriental;08041;Canovelles;1;6;B;;906;533;373;0;3;530;533
8;Barcelona;41;Vallès Oriental;08041;Canovelles;1;7;A;;691;462;229;1;1;460;461
8;Barcelona;41;Vallès Oriental;08041;Canovelles;1;7;B;;900;571;329;3;5;563;568
8;Barcelona;41;Vallès Oriental;08041;Canovelles;1;8;A;;581;376;205;1;5;370;375
8;Barcelona;41;Vallès Oriental;08041;Canovelles;1;8;B;;804;523;281;0;6;517;523
8;Barcelona;41;Vallès Oriental;08042;Cànoves i Samalús;1;1;A;;839;540;299;0;4;536;540
8;Barcelona;41;Vallès Oriental;08042;Cànoves i Samalús;1;1;B;;919;578;341;1;3;574;577
17;Girona;2;Alt Empordà;17041;Cantallops;1;1;U;;219;163;56;0;1;162;163
8;Barcelona;17;Garraf;08043;Canyelles;1;1;A;;911;575;336;2;7;566;573
8;Barcelona;17;Garraf;08043;Canyelles;1;1;B;;1092;675;417;1;3;671;674
43;Tarragona;8;Baix Camp;43039;Capafonts;1;1;U;;109;81;28;0;1;80;81
43;Tarragona;29;Priorat;43040;Capçanes;1;1;U;;351;257;94;2;3;252;255
8;Barcelona;6;Anoia;08044;Capellades;1;1;A;;559;374;185;2;1;371;372
8;Barcelona;6;Anoia;08044;Capellades;1;1;B;;670;422;248;0;5;417;422
8;Barcelona;6;Anoia;08044;Capellades;1;1;C;;603;385;218;1;1;383;384
8;Barcelona;6;Anoia;08044;Capellades;2;1;A;;519;357;162;0;0;357;357
8;Barcelona;6;Anoia;08044;Capellades;2;1;B;;623;441;182;3;1;437;438
8;Barcelona;6;Anoia;08044;Capellades;2;2;A;;465;333;132;0;3;330;333
8;Barcelona;6;Anoia;08044;Capellades;2;2;B;;635;470;165;1;1;468;469
17;Girona;2;Alt Empordà;17042;Capmany;1;1;U;;378;297;81;0;3;294;297
8;Barcelona;14;Berguedà;08045;Capolat;1;1;U;;74;43;31;0;1;42;43
8;Barcelona;41;Vallès Oriental;08046;Cardedeu;1;1;A;;490;375;115;0;6;369;375
8;Barcelona;41;Vallès Oriental;08046;Cardedeu;1;1;B;;473;327;146;2;4;321;325
8;Barcelona;41;Vallès Oriental;08046;Cardedeu;1;2;A;;625;467;158;2;2;463;465
8;Barcelona;41;Vallès Oriental;08046;Cardedeu;1;2;B;;677;497;180;2;3;492;495
8;Barcelona;41;Vallès Oriental;08046;Cardedeu;1;3;A;;471;330;141;0;2;328;330
8;Barcelona;41;Vallès Oriental;08046;Cardedeu;1;3;B;;575;392;183;0;5;387;392
8;Barcelona;41;Vallès Oriental;08046;Cardedeu;2;1;A;;515;350;165;2;4;344;348
8;Barcelona;41;Vallès Oriental;08046;Cardedeu;2;1;B;;554;348;206;0;4;344;348
8;Barcelona;41;Vallès Oriental;08046;Cardedeu;2;1;C;;577;386;191;1;1;384;385
8;Barcelona;41;Vallès Oriental;08046;Cardedeu;2;2;A;;561;386;175;1;7;378;385
8;Barcelona;41;Vallès Oriental;08046;Cardedeu;2;2;B;;528;355;173;1;8;346;354
8;Barcelona;41;Vallès Oriental;08046;Cardedeu;2;3;A;;657;454;203;4;10;440;450
8;Barcelona;41;Vallès Oriental;08046;Cardedeu;2;3;B;;616;436;180;2;2;432;434
8;Barcelona;41;Vallès Oriental;08046;Cardedeu;2;4;A;;541;362;179;1;2;359;361
8;Barcelona;41;Vallès Oriental;08046;Cardedeu;2;4;B;;589;361;228;2;2;357;359
8;Barcelona;41;Vallès Oriental;08046;Cardedeu;2;4;C;;572;378;194;3;4;371;375
8;Barcelona;41;Vallès Oriental;08046;Cardedeu;3;1;A;;545;360;185;3;1;356;357
8;Barcelona;41;Vallès Oriental;08046;Cardedeu;3;1;B;;619;356;263;2;2;352;354
8;Barcelona;41;Vallès Oriental;08046;Cardedeu;3;1;C;;616;387;229;3;2;382;384
8;Barcelona;7;Bages;08047;Cardona;1;1;A;;385;275;110;0;4;271;275
8;Barcelona;7;Bages;08047;Cardona;1;1;B;;312;200;112;2;1;197;198
8;Barcelona;7;Bages;08047;Cardona;1;1;C;;385;260;125;1;6;253;259
8;Barcelona;7;Bages;08047;Cardona;1;2;A;;410;274;136;0;0;274;274
8;Barcelona;7;Bages;08047;Cardona;1;2;B;;443;291;152;2;3;286;289
8;Barcelona;7;Bages;08047;Cardona;1;3;A;;688;435;253;0;5;430;435
8;Barcelona;7;Bages;08047;Cardona;1;3;B;;681;454;227;1;2;451;453
8;Barcelona;7;Bages;08047;Cardona;2;1;U;;751;472;279;8;4;460;464
8;Barcelona;7;Bages;08047;Cardona;2;3;U;;483;351;132;3;1;347;348
8;Barcelona;6;Anoia;08048;Carme;1;1;U;;598;471;127;1;5;465;470
43;Tarragona;37;Terra Alta;43041;Caseres;1;1;U;;272;222;50;3;3;216;219
17;Girona;20;Gironès;17044;Cassà de la Selva;1;1;A;;678;498;180;1;4;493;497
17;Girona;20;Gironès;17044;Cassà de la Selva;1;1;B;;646;488;158;0;3;485;488
17;Girona;20;Gironès;17044;Cassà de la Selva;1;2;A;;548;375;173;1;0;374;374
17;Girona;20;Gironès;17044;Cassà de la Selva;1;2;B;;612;417;195;3;3;411;414
17;Girona;20;Gironès;17044;Cassà de la Selva;2;1;A;;804;548;256;1;8;539;547
17;Girona;20;Gironès;17044;Cassà de la Selva;2;1;B;;817;563;254;4;6;553;559
17;Girona;20;Gironès;17044;Cassà de la Selva;2;2;A;;792;547;245;1;6;540;546
17;Girona;20;Gironès;17044;Cassà de la Selva;2;2;B;;758;523;235;2;4;517;521
17;Girona;20;Gironès;17044;Cassà de la Selva;2;3;U;;595;442;153;2;6;434;440
8;Barcelona;14;Berguedà;08049;Casserres;1;1;A;;1115;869;246;6;6;857;863
8;Barcelona;14;Berguedà;08049;Casserres;1;1;B;;239;161;78;0;0;161;161
25;Lleida;35;Solsonès;25064;Castellar de la Ribera;1;1;U;;136;110;26;0;0;110;110
8;Barcelona;14;Berguedà;08050;Castellar del Riu;1;1;U;;112;83;29;0;0;83;83
8;Barcelona;40;Vallès Occidental;08051;Castellar del Vallès;1;1;U;;887;603;284;4;5;594;599
8;Barcelona;40;Vallès Occidental;08051;Castellar del Vallès;1;10;U;;1008;653;355;0;2;651;653
8;Barcelona;40;Vallès Occidental;08051;Castellar del Vallès;1;11;U;;587;404;183;0;0;404;404
8;Barcelona;40;Vallès Occidental;08051;Castellar del Vallès;1;12;U;;536;305;231;1;0;304;304
8;Barcelona;40;Vallès Occidental;08051;Castellar del Vallès;1;2;A;;741;513;228;1;2;510;512
8;Barcelona;40;Vallès Occidental;08051;Castellar del Vallès;1;2;B;;938;662;276;2;5;655;660
8;Barcelona;40;Vallès Occidental;08051;Castellar del Vallès;1;3;U;;1199;776;423;3;5;768;773
8;Barcelona;40;Vallès Occidental;08051;Castellar del Vallès;1;4;A;;754;503;251;0;7;496;503
8;Barcelona;40;Vallès Occidental;08051;Castellar del Vallès;1;4;B;;875;579;296;0;5;574;579
8;Barcelona;40;Vallès Occidental;08051;Castellar del Vallès;1;5;A;;615;441;174;2;6;433;439
8;Barcelona;40;Vallès Occidental;08051;Castellar del Vallès;1;5;B;;774;539;235;0;7;532;539
8;Barcelona;40;Vallès Occidental;08051;Castellar del Vallès;1;6;U;;991;527;464;1;4;522;526
8;Barcelona;40;Vallès Occidental;08051;Castellar del Vallès;1;7;A;;985;610;375;1;4;605;609
8;Barcelona;40;Vallès Occidental;08051;Castellar del Vallès;1;7;B;;1147;667;480;0;7;660;667
8;Barcelona;40;Vallès Occidental;08051;Castellar del Vallès;1;8;A;;715;464;251;3;5;456;461
8;Barcelona;40;Vallès Occidental;08051;Castellar del Vallès;1;8;B;;839;519;320;0;4;515;519
8;Barcelona;40;Vallès Occidental;08051;Castellar del Vallès;1;9;A;;660;443;217;0;4;439;443
8;Barcelona;40;Vallès Occidental;08051;Castellar del Vallès;1;9;B;;748;480;268;0;4;476;480
8;Barcelona;14;Berguedà;08052;Castellar de n'Hug;1;1;U;;166;133;33;0;0;133;133
8;Barcelona;7;Bages;08053;Castellbell i el Vilar;1;1;A;;629;448;181;0;5;443;448
8;Barcelona;7;Bages;08053;Castellbell i el Vilar;1;1;B;;828;573;255;1;1;571;572
8;Barcelona;7;Bages;08053;Castellbell i el Vilar;1;2;U;;1170;626;544;2;5;619;624
8;Barcelona;40;Vallès Occidental;08054;Castellbisbal;1;1;A;;935;572;363;1;1;570;571
8;Barcelona;40;Vallès Occidental;08054;Castellbisbal;1;1;B;;970;574;396;0;4;570;574
8;Barcelona;40;Vallès Occidental;08054;Castellbisbal;1;2;A;;958;478;480;0;4;474;478
8;Barcelona;40;Vallès Occidental;08054;Castellbisbal;1;2;B;;924;492;432;0;2;490;492
8;Barcelona;40;Vallès Occidental;08054;Castellbisbal;1;3;A;;1351;819;532;7;9;803;812
8;Barcelona;40;Vallès Occidental;08054;Castellbisbal;1;3;B;;1297;800;497;1;5;794;799
8;Barcelona;40;Vallès Occidental;08054;Castellbisbal;1;4;U;;1170;785;385;1;5;779;784
8;Barcelona;;;08055;Castellcir;1;1;U;;385;275;110;1;2;272;274
25;Lleida;18;Garrigues;25067;Castelldans;1;1;U;;797;567;230;1;8;558;566
8;Barcelona;11;Baix Llobregat;08056;Castelldefels;1;1;U;;713;367;346;2;0;365;365
8;Barcelona;11;Baix Llobregat;08056;Castelldefels;1;2;A;;543;290;253;0;1;289;290
8;Barcelona;11;Baix Llobregat;08056;Castelldefels;1;2;B;;606;332;274;1;5;326;331
8;Barcelona;11;Baix Llobregat;08056;Castelldefels;1;3;A;;706;428;278;3;10;415;425
8;Barcelona;11;Baix Llobregat;08056;Castelldefels;1;3;B;;764;443;321;0;4;439;443
8;Barcelona;11;Baix Llobregat;08056;Castelldefels;1;4;A;;753;403;350;1;5;397;402
8;Barcelona;11;Baix Llobregat;08056;Castelldefels;1;4;B;;748;390;358;5;4;381;385
8;Barcelona;11;Baix Llobregat;08056;Castelldefels;1;5;A;;700;354;346;2;2;350;352
8;Barcelona;11;Baix Llobregat;08056;Castelldefels;1;5;B;;774;408;366;2;0;406;406
8;Barcelona;11;Baix Llobregat;08056;Castelldefels;1;6;A;;911;488;423;4;4;480;484
8;Barcelona;11;Baix Llobregat;08056;Castelldefels;1;6;B;;1131;674;457;0;8;666;674
8;Barcelona;11;Baix Llobregat;08056;Castelldefels;1;7;U;;1224;740;484;0;18;722;740
8;Barcelona;11;Baix Llobregat;08056;Castelldefels;2;1;A;;627;394;233;1;4;389;393
8;Barcelona;11;Baix Llobregat;08056;Castelldefels;2;1;B;;663;356;307;4;3;349;352
8;Barcelona;11;Baix Llobregat;08056;Castelldefels;2;2;A;;568;346;222;1;8;337;345
8;Barcelona;11;Baix Llobregat;08056;Castelldefels;2;2;B;;636;387;249;1;3;383;386
8;Barcelona;11;Baix Llobregat;08056;Castelldefels;2;3;A;;617;372;245;3;4;365;369
8;Barcelona;11;Baix Llobregat;08056;Castelldefels;2;3;B;;584;336;248;2;4;330;334
8;Barcelona;11;Baix Llobregat;08056;Castelldefels;2;4;A;;845;492;353;1;4;487;491
8;Barcelona;11;Baix Llobregat;08056;Castelldefels;2;4;B;;943;525;418;2;12;511;523
8;Barcelona;11;Baix Llobregat;08056;Castelldefels;2;5;U;;1138;673;465;1;4;668;672
8;Barcelona;11;Baix Llobregat;08056;Castelldefels;2;6;A;;501;260;241;0;3;257;260
8;Barcelona;11;Baix Llobregat;08056;Castelldefels;2;6;B;;631;364;267;0;5;359;364
8;Barcelona;11;Baix Llobregat;08056;Castelldefels;3;1;U;;898;493;405;2;1;490;491
8;Barcelona;11;Baix Llobregat;08056;Castelldefels;3;2;A;;645;392;253;2;2;388;390
8;Barcelona;11;Baix Llobregat;08056;Castelldefels;3;2;B;;624;384;240;1;2;381;383
8;Barcelona;11;Baix Llobregat;08056;Castelldefels;3;3;A;;937;486;451;0;6;480;486
8;Barcelona;11;Baix Llobregat;08056;Castelldefels;3;3;B;;1141;605;536;3;10;592;602
8;Barcelona;11;Baix Llobregat;08056;Castelldefels;3;4;A;;672;455;217;0;6;449;455
8;Barcelona;11;Baix Llobregat;08056;Castelldefels;3;4;B;;782;521;261;1;9;511;520
8;Barcelona;11;Baix Llobregat;08056;Castelldefels;3;5;U;;773;541;232;2;10;529;539
8;Barcelona;11;Baix Llobregat;08056;Castelldefels;4;1;A;;997;648;349;2;8;638;646
8;Barcelona;11;Baix Llobregat;08056;Castelldefels;4;1;B;;1122;754;368;0;10;744;754
8;Barcelona;11;Baix Llobregat;08056;Castelldefels;4;2;U;;1273;691;582;0;9;682;691
8;Barcelona;11;Baix Llobregat;08056;Castelldefels;4;3;A;;696;382;314;0;6;376;382
8;Barcelona;11;Baix Llobregat;08056;Castelldefels;4;3;B;;758;445;313;0;3;442;445
8;Barcelona;11;Baix Llobregat;08056;Castelldefels;4;4;A;;762;368;394;1;4;363;367
8;Barcelona;11;Baix Llobregat;08056;Castelldefels;4;4;B;;732;375;357;0;4;371;375
8;Barcelona;11;Baix Llobregat;08056;Castelldefels;5;1;A;;870;550;320;0;7;543;550
8;Barcelona;11;Baix Llobregat;08056;Castelldefels;5;1;B;;940;607;333;2;8;597;605
8;Barcelona;11;Baix Llobregat;08056;Castelldefels;5;2;A;;794;416;378;1;4;411;415
8;Barcelona;11;Baix Llobregat;08056;Castelldefels;5;2;B;;803;463;340;0;6;457;463
8;Barcelona;11;Baix Llobregat;08056;Castelldefels;5;3;A;;652;310;342;0;4;306;310
8;Barcelona;11;Baix Llobregat;08056;Castelldefels;5;3;B;;732;352;380;1;2;349;351
8;Barcelona;11;Baix Llobregat;08056;Castelldefels;5;4;A;;847;549;298;0;6;543;549
8;Barcelona;11;Baix Llobregat;08056;Castelldefels;5;4;B;;931;610;321;0;5;605;610
8;Barcelona;14;Berguedà;08057;Castell de l'Areny;1;1;U;;58;47;11;1;1;45;46
25;Lleida;25;Pallars Jussà;25904;Castell de Mur;1;1;U;;145;108;37;0;1;107;108
8;Barcelona;3;Alt Penedès;08058;Castellet i la Gornal;1;1;U;;455;297;158;0;1;296;297
8;Barcelona;3;Alt Penedès;08058;Castellet i la Gornal;1;2;U;;870;504;366;2;3;499;502
17;Girona;19;Garrotxa;17046;Castellfollit de la Roca;1;1;A;;377;288;89;0;0;288;288
17;Girona;19;Garrotxa;17046;Castellfollit de la Roca;1;1;B;;408;311;97;2;6;303;309
8;Barcelona;7;Bages;08059;Castellfollit del Boix;1;1;U;;311;191;120;1;4;186;190
8;Barcelona;6;Anoia;08060;Castellfollit de Riubregós;1;1;U;;180;150;30;1;1;148;149
8;Barcelona;7;Bages;08061;Castellgalí;1;1;U;;915;605;310;3;5;597;602
8;Barcelona;7;Bages;08062;Castellnou de Bages;1;1;U;;580;377;203;1;6;370;376
25;Lleida;27;Pla d'Urgell;25068;Castellnou de Seana;1;1;U;;598;439;159;1;7;431;438
17;Girona;2;Alt Empordà;17047;Castelló d'Empúries;1;1;A;;643;393;250;2;1;390;391
17;Girona;2;Alt Empordà;17047;Castelló d'Empúries;1;1;B;;650;374;276;2;1;371;372
17;Girona;2;Alt Empordà;17047;Castelló d'Empúries;1;2;A;;576;406;170;0;5;401;406
17;Girona;2;Alt Empordà;17047;Castelló d'Empúries;1;2;B;;550;388;162;2;1;385;386
17;Girona;2;Alt Empordà;17047;Castelló d'Empúries;1;3;A;;756;364;392;3;7;354;361
17;Girona;2;Alt Empordà;17047;Castelló d'Empúries;1;3;B;;768;350;418;3;3;344;347
25;Lleida;23;Noguera;25069;Castelló de Farfanya;1;1;U;;505;358;147;0;3;355;358
8;Barcelona;6;Anoia;08063;Castellolí;1;1;U;;366;319;47;0;1;318;319
17;Girona;10;Baix Empordà;17048;Castell-Platja d'Aro;1;1;U;;1016;678;338;6;6;666;672
17;Girona;10;Baix Empordà;17048;Castell-Platja d'Aro;1;2;A;;735;405;330;0;3;402;405
17;Girona;10;Baix Empordà;17048;Castell-Platja d'Aro;1;2;B;;683;394;289;2;2;390;392
17;Girona;10;Baix Empordà;17048;Castell-Platja d'Aro;1;3;A;;787;485;302;1;2;482;484
17;Girona;10;Baix Empordà;17048;Castell-Platja d'Aro;1;3;B;;782;466;316;6;4;456;460
17;Girona;10;Baix Empordà;17048;Castell-Platja d'Aro;1;4;U;;708;384;324;0;4;380;384
17;Girona;10;Baix Empordà;17048;Castell-Platja d'Aro;1;5;U;;841;446;395;2;4;440;444
25;Lleida;38;Urgell;25070;Castellserà;1;1;U;;948;713;235;1;4;708;712
8;Barcelona;;;08064;Castellterçol;1;1;A;;869;687;182;4;8;675;683
8;Barcelona;;;08064;Castellterçol;1;1;B;;847;665;182;4;4;657;661
43;Tarragona;8;Baix Camp;43042;Castellvell del Camp;1;1;A;;748;486;262;0;4;482;486
43;Tarragona;8;Baix Camp;43042;Castellvell del Camp;1;1;B;;838;577;261;0;7;570;577
8;Barcelona;3;Alt Penedès;08065;Castellví de la Marca;1;1;U;;1200;822;378;0;6;816;822
8;Barcelona;11;Baix Llobregat;08066;Castellví de Rosanes;1;1;A;;367;275;92;0;0;275;275
8;Barcelona;11;Baix Llobregat;08066;Castellví de Rosanes;1;1;B;;356;248;108;0;5;243;248
8;Barcelona;11;Baix Llobregat;08066;Castellví de Rosanes;1;1;C;;255;170;85;0;0;170;170
43;Tarragona;36;Tarragonès;43043;Catllar, el;1;1;A;;542;279;263;0;5;274;279
43;Tarragona;36;Tarragonès;43043;Catllar, el;1;1;B;;723;403;320;2;0;401;401
43;Tarragona;36;Tarragonès;43043;Catllar, el;1;2;A;;465;305;160;2;0;303;303
43;Tarragona;36;Tarragonès;43043;Catllar, el;1;2;B;;524;310;214;1;3;306;309
25;Lleida;4;Alt Urgell;25071;Cava;1;1;U;;45;24;21;0;0;24;24
17;Girona;34;Selva;17189;Cellera de Ter, la;1;1;U;;861;658;203;0;7;651;658
17;Girona;34;Selva;17189;Cellera de Ter, la;1;2;U;;760;569;191;1;3;565;568
17;Girona;20;Gironès;17049;Celrà;1;1;U;;1067;780;287;2;2;776;778
17;Girona;20;Gironès;17049;Celrà;1;2;A;;613;393;220;2;1;390;391
17;Girona;20;Gironès;17049;Celrà;1;2;B;;595;395;200;2;3;390;393
8;Barcelona;24;Osona;08067;Centelles;1;1;A;;621;436;185;1;2;433;435
8;Barcelona;24;Osona;08067;Centelles;1;1;B;;627;442;185;0;4;438;442
8;Barcelona;24;Osona;08067;Centelles;1;2;A;;469;323;146;0;2;321;323
8;Barcelona;24;Osona;08067;Centelles;1;2;B;;462;349;113;1;1;347;348
8;Barcelona;24;Osona;08067;Centelles;1;3;A;;495;335;160;0;4;331;335
8;Barcelona;24;Osona;08067;Centelles;1;3;B;;649;478;171;0;4;474;478
8;Barcelona;24;Osona;08067;Centelles;1;4;A;;742;516;226;1;2;513;515
8;Barcelona;24;Osona;08067;Centelles;1;4;B;;1004;698;306;0;3;695;698
8;Barcelona;14;Berguedà;08268;Cercs;1;1;A;;312;231;81;1;1;229;230
8;Barcelona;14;Berguedà;08268;Cercs;1;1;B;;260;175;85;0;0;175;175
8;Barcelona;14;Berguedà;08268;Cercs;1;2;U;;584;464;120;2;2;460;462
8;Barcelona;40;Vallès Occidental;08266;Cerdanyola del Vallès;1;1;A;;812;457;355;0;5;452;457
8;Barcelona;40;Vallès Occidental;08266;Cerdanyola del Vallès;1;1;B;;995;549;446;0;12;537;549
8;Barcelona;40;Vallès Occidental;08266;Cerdanyola del Vallès;1;10;A;;1109;699;410;0;8;691;699
8;Barcelona;40;Vallès Occidental;08266;Cerdanyola del Vallès;1;10;B;;1263;818;445;0;7;811;818
8;Barcelona;40;Vallès Occidental;08266;Cerdanyola del Vallès;1;11;A;;497;242;255;0;1;241;242
8;Barcelona;40;Vallès Occidental;08266;Cerdanyola del Vallès;1;11;B;;575;269;306;0;1;268;269
8;Barcelona;40;Vallès Occidental;08266;Cerdanyola del Vallès;1;12;A;;526;315;211;0;2;313;315
8;Barcelona;40;Vallès Occidental;08266;Cerdanyola del Vallès;1;12;B;;708;404;304;0;8;396;404
8;Barcelona;40;Vallès Occidental;08266;Cerdanyola del Vallès;1;12;C;;593;347;246;1;6;340;346
8;Barcelona;40;Vallès Occidental;08266;Cerdanyola del Vallès;1;13;U;;837;514;323;2;10;502;512
8;Barcelona;40;Vallès Occidental;08266;Cerdanyola del Vallès;1;14;A;;754;471;283;0;2;469;471
8;Barcelona;40;Vallès Occidental;08266;Cerdanyola del Vallès;1;14;B;;805;507;298;0;3;504;507
8;Barcelona;40;Vallès Occidental;08266;Cerdanyola del Vallès;1;15;A;;516;307;209;0;3;304;307
8;Barcelona;40;Vallès Occidental;08266;Cerdanyola del Vallès;1;15;B;;682;406;276;0;7;399;406
8;Barcelona;40;Vallès Occidental;08266;Cerdanyola del Vallès;1;15;C;;623;358;265;0;1;357;358
8;Barcelona;40;Vallès Occidental;08266;Cerdanyola del Vallès;1;16;A;;735;457;278;0;4;453;457
8;Barcelona;40;Vallès Occidental;08266;Cerdanyola del Vallès;1;16;B;;751;481;270;0;5;476;481
8;Barcelona;40;Vallès Occidental;08266;Cerdanyola del Vallès;1;17;A;;584;306;278;2;2;302;304
8;Barcelona;40;Vallès Occidental;08266;Cerdanyola del Vallès;1;17;B;;662;342;320;0;6;336;342
8;Barcelona;40;Vallès Occidental;08266;Cerdanyola del Vallès;1;17;C;;608;315;293;1;2;312;314
8;Barcelona;40;Vallès Occidental;08266;Cerdanyola del Vallès;1;18;A;;934;603;331;6;9;588;597
8;Barcelona;40;Vallès Occidental;08266;Cerdanyola del Vallès;1;18;B;;1026;629;397;0;14;615;629
8;Barcelona;40;Vallès Occidental;08266;Cerdanyola del Vallès;1;19;A;;574;368;206;1;9;358;367
8;Barcelona;40;Vallès Occidental;08266;Cerdanyola del Vallès;1;19;B;;697;414;283;1;7;406;413
8;Barcelona;40;Vallès Occidental;08266;Cerdanyola del Vallès;1;19;C;;640;390;250;0;3;387;390
8;Barcelona;40;Vallès Occidental;08266;Cerdanyola del Vallès;1;2;A;;644;396;248;0;2;394;396
8;Barcelona;40;Vallès Occidental;08266;Cerdanyola del Vallès;1;2;B;;864;516;348;0;3;513;516
8;Barcelona;40;Vallès Occidental;08266;Cerdanyola del Vallès;1;20;A;;719;565;154;1;8;556;564
8;Barcelona;40;Vallès Occidental;08266;Cerdanyola del Vallès;1;20;B;;569;426;143;0;6;420;426
8;Barcelona;40;Vallès Occidental;08266;Cerdanyola del Vallès;1;20;C;;795;612;183;2;7;603;610
8;Barcelona;40;Vallès Occidental;08266;Cerdanyola del Vallès;1;27;A;;683;368;315;0;2;366;368
8;Barcelona;40;Vallès Occidental;08266;Cerdanyola del Vallès;1;27;B;;763;407;356;5;6;396;402
8;Barcelona;40;Vallès Occidental;08266;Cerdanyola del Vallès;1;28;A;;563;401;162;1;0;400;400
8;Barcelona;40;Vallès Occidental;08266;Cerdanyola del Vallès;1;28;B;;728;500;228;1;11;488;499
8;Barcelona;40;Vallès Occidental;08266;Cerdanyola del Vallès;1;29;A;;956;642;314;1;7;634;641
8;Barcelona;40;Vallès Occidental;08266;Cerdanyola del Vallès;1;29;B;;1008;659;349;0;4;655;659
8;Barcelona;40;Vallès Occidental;08266;Cerdanyola del Vallès;1;3;A;;672;417;255;0;3;414;417
8;Barcelona;40;Vallès Occidental;08266;Cerdanyola del Vallès;1;3;B;;766;460;306;0;4;456;460
8;Barcelona;40;Vallès Occidental;08266;Cerdanyola del Vallès;1;30;A;;458;290;168;0;7;283;290
8;Barcelona;40;Vallès Occidental;08266;Cerdanyola del Vallès;1;30;B;;665;407;258;0;2;405;407
8;Barcelona;40;Vallès Occidental;08266;Cerdanyola del Vallès;1;31;A;;483;289;194;0;4;285;289
8;Barcelona;40;Vallès Occidental;08266;Cerdanyola del Vallès;1;31;B;;584;348;236;0;5;343;348
8;Barcelona;40;Vallès Occidental;08266;Cerdanyola del Vallès;1;32;U;;668;449;219;0;2;447;449
8;Barcelona;40;Vallès Occidental;08266;Cerdanyola del Vallès;1;33;A;;600;339;261;0;7;332;339
8;Barcelona;40;Vallès Occidental;08266;Cerdanyola del Vallès;1;33;B;;756;414;342;1;3;410;413
8;Barcelona;40;Vallès Occidental;08266;Cerdanyola del Vallès;1;34;A;;630;388;242;1;2;385;387
8;Barcelona;40;Vallès Occidental;08266;Cerdanyola del Vallès;1;34;B;;753;452;301;0;9;443;452
8;Barcelona;40;Vallès Occidental;08266;Cerdanyola del Vallès;1;35;A;;1170;757;413;0;9;748;757
8;Barcelona;40;Vallès Occidental;08266;Cerdanyola del Vallès;1;35;B;;1354;805;549;1;11;793;804
8;Barcelona;40;Vallès Occidental;08266;Cerdanyola del Vallès;1;4;A;;695;414;281;0;6;408;414
8;Barcelona;40;Vallès Occidental;08266;Cerdanyola del Vallès;1;4;B;;750;453;297;0;5;448;453
8;Barcelona;40;Vallès Occidental;08266;Cerdanyola del Vallès;1;5;A;;484;301;183;0;4;297;301
8;Barcelona;40;Vallès Occidental;08266;Cerdanyola del Vallès;1;5;B;;472;283;189;0;5;278;283
8;Barcelona;40;Vallès Occidental;08266;Cerdanyola del Vallès;1;6;A;;749;474;275;0;3;471;474
8;Barcelona;40;Vallès Occidental;08266;Cerdanyola del Vallès;1;6;B;;819;543;276;0;5;538;543
8;Barcelona;40;Vallès Occidental;08266;Cerdanyola del Vallès;1;7;U;;730;507;223;0;3;504;507
8;Barcelona;40;Vallès Occidental;08266;Cerdanyola del Vallès;1;8;A;;629;372;257;1;2;369;371
8;Barcelona;40;Vallès Occidental;08266;Cerdanyola del Vallès;1;8;B;;807;494;313;1;3;490;493
8;Barcelona;40;Vallès Occidental;08266;Cerdanyola del Vallès;1;9;A;;635;390;245;0;1;389;390
8;Barcelona;40;Vallès Occidental;08266;Cerdanyola del Vallès;1;9;B;;780;479;301;0;7;472;479
8;Barcelona;11;Baix Llobregat;08068;Cervelló;1;1;A;;546;361;185;0;4;357;361
8;Barcelona;11;Baix Llobregat;08068;Cervelló;1;1;B;;505;332;173;1;4;327;331
8;Barcelona;11;Baix Llobregat;08068;Cervelló;1;1;C;;592;365;227;1;4;360;364
8;Barcelona;11;Baix Llobregat;08068;Cervelló;1;2;A;;591;383;208;0;1;382;383
8;Barcelona;11;Baix Llobregat;08068;Cervelló;1;2;B;;645;393;252;0;4;389;393
8;Barcelona;11;Baix Llobregat;08068;Cervelló;1;3;U;;535;334;201;0;3;331;334
8;Barcelona;11;Baix Llobregat;08068;Cervelló;1;4;A;;629;365;264;1;1;363;364
8;Barcelona;11;Baix Llobregat;08068;Cervelló;1;4;B;;700;391;309;1;6;384;390
8;Barcelona;11;Baix Llobregat;08068;Cervelló;1;4;C;;596;355;241;1;5;349;354
25;Lleida;32;Segarra;25072;Cervera;1;1;A;;483;318;165;4;3;311;314
25;Lleida;32;Segarra;25072;Cervera;1;1;B;;619;411;208;0;1;410;411
25;Lleida;32;Segarra;25072;Cervera;2;1;A;;605;452;153;1;3;448;451
25;Lleida;32;Segarra;25072;Cervera;2;1;B;;653;468;185;4;6;458;464
25;Lleida;32;Segarra;25072;Cervera;2;2;A;;672;437;235;1;3;433;436
25;Lleida;32;Segarra;25072;Cervera;2;2;B;;727;468;259;3;4;461;465
25;Lleida;32;Segarra;25072;Cervera;2;3;A;;437;312;125;1;4;307;311
25;Lleida;32;Segarra;25072;Cervera;2;3;B;;536;380;156;1;11;368;379
25;Lleida;32;Segarra;25072;Cervera;3;1;A;;533;334;199;3;4;327;331
25;Lleida;32;Segarra;25072;Cervera;3;1;B;;669;422;247;1;4;417;421
25;Lleida;18;Garrigues;25073;Cervià de les Garrigues;1;1;U;;739;491;248;1;2;488;490
17;Girona;20;Gironès;17050;Cervià de Ter;1;1;U;;556;445;111;2;4;439;443
17;Girona;2;Alt Empordà;17051;Cistella;1;1;U;;204;147;57;1;0;146;146
25;Lleida;38;Urgell;25074;Ciutadilla;1;1;U;;206;159;47;0;2;157;159
25;Lleida;35;Solsonès;25075;Clariana de Cardener;1;1;U;;116;95;21;0;1;94;95
25;Lleida;18;Garrigues;25076;Cogul, el;1;1;U;;197;135;62;0;0;135;135
17;Girona;2;Alt Empordà;17054;Colera;1;1;U;;585;360;225;2;5;353;358
8;Barcelona;11;Baix Llobregat;08069;Collbató;1;1;A;;538;362;176;0;2;360;362
8;Barcelona;11;Baix Llobregat;08069;Collbató;1;1;B;;500;330;170;0;3;327;330
8;Barcelona;11;Baix Llobregat;08069;Collbató;1;1;C;;614;378;236;0;3;375;378
8;Barcelona;11;Baix Llobregat;08069;Collbató;1;1;D;;513;347;166;1;1;345;346
43;Tarragona;8;Baix Camp;43045;Colldejou;1;1;U;;169;122;47;0;0;122;122
25;Lleida;4;Alt Urgell;25077;Coll de Nargó;1;1;U;;487;347;140;1;1;345;346
8;Barcelona;;;08070;Collsuspina;1;1;U;;235;195;40;0;2;193;195
17;Girona;10;Baix Empordà;17055;Colomers;1;1;U;;179;150;29;1;0;149;149
25;Lleida;35;Solsonès;25163;Coma i la Pedra, la;1;1;U;;217;141;76;0;1;140;141
25;Lleida;25;Pallars Jussà;25161;Conca de Dalt;1;1;U;;378;266;112;0;3;263;266
43;Tarragona;16;Conca de Barberà;43046;Conesa;1;1;U;;111;86;25;0;1;85;86
43;Tarragona;36;Tarragonès;43047;Constantí;1;1;A;;610;360;250;1;4;355;359
43;Tarragona;36;Tarragonès;43047;Constantí;1;1;B;;661;399;262;2;3;394;397
43;Tarragona;36;Tarragonès;43047;Constantí;1;2;A;;537;189;348;1;1;187;188
43;Tarragona;36;Tarragonès;43047;Constantí;1;2;B;;610;234;376;0;0;234;234
43;Tarragona;36;Tarragonès;43047;Constantí;2;1;A;;682;406;276;2;5;399;404
43;Tarragona;36;Tarragonès;43047;Constantí;2;1;B;;965;564;401;1;2;561;563
8;Barcelona;6;Anoia;08071;Copons;1;1;U;;255;189;66;1;4;184;188
43;Tarragona;37;Terra Alta;43048;Corbera d'Ebre;1;1;U;;877;646;231;5;3;638;641
8;Barcelona;11;Baix Llobregat;08072;Corbera de Llobregat;1;1;A;;664;366;298;2;2;362;364
8;Barcelona;11;Baix Llobregat;08072;Corbera de Llobregat;1;1;B;;767;396;371;2;4;390;394
8;Barcelona;11;Baix Llobregat;08072;Corbera de Llobregat;1;1;C;;706;390;316;0;5;385;390
8;Barcelona;11;Baix Llobregat;08072;Corbera de Llobregat;1;2;A;;470;338;132;0;5;333;338
8;Barcelona;11;Baix Llobregat;08072;Corbera de Llobregat;1;2;B;;548;337;211;1;2;334;336
8;Barcelona;11;Baix Llobregat;08072;Corbera de Llobregat;1;2;C;;468;299;169;0;5;294;299
8;Barcelona;11;Baix Llobregat;08072;Corbera de Llobregat;1;3;A;;495;319;176;2;6;311;317
8;Barcelona;11;Baix Llobregat;08072;Corbera de Llobregat;1;3;B;;532;311;221;2;4;305;309
8;Barcelona;11;Baix Llobregat;08072;Corbera de Llobregat;1;4;A;;764;479;285;0;6;473;479
8;Barcelona;11;Baix Llobregat;08072;Corbera de Llobregat;1;4;B;;804;516;288;0;7;509;516
8;Barcelona;11;Baix Llobregat;08072;Corbera de Llobregat;1;5;A;;551;330;221;1;4;325;329
8;Barcelona;11;Baix Llobregat;08072;Corbera de Llobregat;1;5;B;;583;332;251;2;7;323;330
8;Barcelona;11;Baix Llobregat;08072;Corbera de Llobregat;1;6;U;;815;392;423;0;2;390;392
25;Lleida;33;Segrià;25078;Corbins;1;1;U;;918;717;201;1;4;712;716
17;Girona;10;Baix Empordà;17057;Corçà;1;1;U;;991;706;285;4;4;698;702
8;Barcelona;11;Baix Llobregat;08073;Cornellà de Llobregat;1;1;A;;675;486;189;0;4;482;486
8;Barcelona;11;Baix Llobregat;08073;Cornellà de Llobregat;1;1;B;;816;557;259;0;3;554;557
8;Barcelona;11;Baix Llobregat;08073;Cornellà de Llobregat;1;10;A;;522;336;186;3;5;328;333
8;Barcelona;11;Baix Llobregat;08073;Cornellà de Llobregat;1;10;B;;643;430;213;8;4;418;422
8;Barcelona;11;Baix Llobregat;08073;Cornellà de Llobregat;1;11;A;;425;266;159;0;1;265;266
8;Barcelona;11;Baix Llobregat;08073;Cornellà de Llobregat;1;11;B;;476;278;198;0;9;269;278
8;Barcelona;11;Baix Llobregat;08073;Cornellà de Llobregat;1;12;U;;714;394;320;0;5;389;394
8;Barcelona;11;Baix Llobregat;08073;Cornellà de Llobregat;1;13;A;;572;344;228;1;4;339;343
8;Barcelona;11;Baix Llobregat;08073;Cornellà de Llobregat;1;13;B;;564;345;219;1;3;341;344
8;Barcelona;11;Baix Llobregat;08073;Cornellà de Llobregat;1;14;U;;965;652;313;0;10;642;652
8;Barcelona;11;Baix Llobregat;08073;Cornellà de Llobregat;1;2;A;;693;469;224;1;3;465;468
8;Barcelona;11;Baix Llobregat;08073;Cornellà de Llobregat;1;2;B;;801;508;293;1;3;504;507
8;Barcelona;11;Baix Llobregat;08073;Cornellà de Llobregat;1;3;A;;552;321;231;0;1;320;321
8;Barcelona;11;Baix Llobregat;08073;Cornellà de Llobregat;1;3;B;;595;373;222;0;3;370;373
8;Barcelona;11;Baix Llobregat;08073;Cornellà de Llobregat;1;4;A;;702;415;287;2;2;411;413
8;Barcelona;11;Baix Llobregat;08073;Cornellà de Llobregat;1;4;B;;716;447;269;2;8;437;445
8;Barcelona;11;Baix Llobregat;08073;Cornellà de Llobregat;1;5;U;;924;535;389;2;6;527;533
8;Barcelona;11;Baix Llobregat;08073;Cornellà de Llobregat;1;6;U;;542;355;187;5;0;350;350
8;Barcelona;11;Baix Llobregat;08073;Cornellà de Llobregat;1;7;A;;609;413;196;0;4;409;413
8;Barcelona;11;Baix Llobregat;08073;Cornellà de Llobregat;1;7;B;;723;507;216;0;6;501;507
8;Barcelona;11;Baix Llobregat;08073;Cornellà de Llobregat;1;8;A;;593;352;241;0;4;348;352
8;Barcelona;11;Baix Llobregat;08073;Cornellà de Llobregat;1;8;B;;650;408;242;3;9;396;405
8;Barcelona;11;Baix Llobregat;08073;Cornellà de Llobregat;1;9;A;;409;278;131;1;4;273;277
8;Barcelona;11;Baix Llobregat;08073;Cornellà de Llobregat;1;9;B;;409;272;137;1;3;268;271
8;Barcelona;11;Baix Llobregat;08073;Cornellà de Llobregat;2;1;A;;667;399;268;0;5;394;399
8;Barcelona;11;Baix Llobregat;08073;Cornellà de Llobregat;2;1;B;;659;411;248;0;4;407;411
8;Barcelona;11;Baix Llobregat;08073;Cornellà de Llobregat;2;1;C;;653;406;247;0;7;399;406
8;Barcelona;11;Baix Llobregat;08073;Cornellà de Llobregat;2;2;A;;566;368;198;0;1;367;368
8;Barcelona;11;Baix Llobregat;08073;Cornellà de Llobregat;2;2;B;;600;365;235;2;7;356;363
8;Barcelona;11;Baix Llobregat;08073;Cornellà de Llobregat;2;2;C;;599;358;241;2;2;354;356
8;Barcelona;11;Baix Llobregat;08073;Cornellà de Llobregat;3;1;A;;449;266;183;0;1;265;266
8;Barcelona;11;Baix Llobregat;08073;Cornellà de Llobregat;3;1;B;;501;301;200;0;2;299;301
8;Barcelona;11;Baix Llobregat;08073;Cornellà de Llobregat;3;2;A;;393;205;188;0;0;205;205
8;Barcelona;11;Baix Llobregat;08073;Cornellà de Llobregat;3;2;B;;401;220;181;2;1;217;218
8;Barcelona;11;Baix Llobregat;08073;Cornellà de Llobregat;3;3;U;;711;412;299;4;2;406;408
8;Barcelona;11;Baix Llobregat;08073;Cornellà de Llobregat;3;4;A;;612;385;227;1;7;377;384
8;Barcelona;11;Baix Llobregat;08073;Cornellà de Llobregat;3;4;B;;721;460;261;0;9;451;460
8;Barcelona;11;Baix Llobregat;08073;Cornellà de Llobregat;3;4;C;;640;385;255;0;1;384;385
8;Barcelona;11;Baix Llobregat;08073;Cornellà de Llobregat;3;5;U;;837;505;332;0;3;502;505
8;Barcelona;11;Baix Llobregat;08073;Cornellà de Llobregat;3;6;U;;646;398;248;0;4;394;398
8;Barcelona;11;Baix Llobregat;08073;Cornellà de Llobregat;3;7;A;;369;230;139;0;0;230;230
8;Barcelona;11;Baix Llobregat;08073;Cornellà de Llobregat;3;7;B;;439;288;151;0;4;284;288
8;Barcelona;11;Baix Llobregat;08073;Cornellà de Llobregat;3;8;U;;762;425;337;0;4;421;425
8;Barcelona;11;Baix Llobregat;08073;Cornellà de Llobregat;3;9;A;;397;193;204;0;0;193;193
8;Barcelona;11;Baix Llobregat;08073;Cornellà de Llobregat;3;9;B;;457;213;244;0;3;210;213
8;Barcelona;11;Baix Llobregat;08073;Cornellà de Llobregat;4;1;A;;560;368;192;1;3;364;367
8;Barcelona;11;Baix Llobregat;08073;Cornellà de Llobregat;4;1;B;;632;395;237;1;8;386;394
8;Barcelona;11;Baix Llobregat;08073;Cornellà de Llobregat;4;10;A;;421;251;170;1;3;247;250
8;Barcelona;11;Baix Llobregat;08073;Cornellà de Llobregat;4;10;B;;482;279;203;0;2;277;279
8;Barcelona;11;Baix Llobregat;08073;Cornellà de Llobregat;4;11;A;;408;256;152;0;3;253;256
8;Barcelona;11;Baix Llobregat;08073;Cornellà de Llobregat;4;11;B;;429;276;153;1;3;272;275
8;Barcelona;11;Baix Llobregat;08073;Cornellà de Llobregat;4;12;A;;517;325;192;0;0;325;325
8;Barcelona;11;Baix Llobregat;08073;Cornellà de Llobregat;4;12;B;;597;367;230;2;1;364;365
8;Barcelona;11;Baix Llobregat;08073;Cornellà de Llobregat;4;13;A;;620;397;223;0;7;390;397
8;Barcelona;11;Baix Llobregat;08073;Cornellà de Llobregat;4;13;B;;684;440;244;4;12;424;436
8;Barcelona;11;Baix Llobregat;08073;Cornellà de Llobregat;4;14;A;;482;283;199;4;1;278;279
8;Barcelona;11;Baix Llobregat;08073;Cornellà de Llobregat;4;14;B;;534;310;224;0;2;308;310
8;Barcelona;11;Baix Llobregat;08073;Cornellà de Llobregat;4;15;A;;389;228;161;1;1;226;227
8;Barcelona;11;Baix Llobregat;08073;Cornellà de Llobregat;4;15;B;;463;291;172;0;4;287;291
8;Barcelona;11;Baix Llobregat;08073;Cornellà de Llobregat;4;16;A;;480;270;210;1;2;267;269
8;Barcelona;11;Baix Llobregat;08073;Cornellà de Llobregat;4;16;B;;556;350;206;1;6;343;349
8;Barcelona;11;Baix Llobregat;08073;Cornellà de Llobregat;4;17;A;;516;342;174;2;5;335;340
8;Barcelona;11;Baix Llobregat;08073;Cornellà de Llobregat;4;17;B;;570;341;229;1;3;337;340
8;Barcelona;11;Baix Llobregat;08073;Cornellà de Llobregat;4;18;U;;734;431;303;0;5;426;431
8;Barcelona;11;Baix Llobregat;08073;Cornellà de Llobregat;4;19;U;;717;418;299;0;7;411;418
8;Barcelona;11;Baix Llobregat;08073;Cornellà de Llobregat;4;2;U;;596;356;240;0;0;356;356
8;Barcelona;11;Baix Llobregat;08073;Cornellà de Llobregat;4;3;A;;598;339;259;0;2;337;339
8;Barcelona;11;Baix Llobregat;08073;Cornellà de Llobregat;4;3;B;;726;414;312;0;2;412;414
8;Barcelona;11;Baix Llobregat;08073;Cornellà de Llobregat;4;4;A;;408;272;136;0;6;266;272
8;Barcelona;11;Baix Llobregat;08073;Cornellà de Llobregat;4;4;B;;423;273;150;0;1;272;273
8;Barcelona;11;Baix Llobregat;08073;Cornellà de Llobregat;4;5;A;;363;240;123;0;4;236;240
8;Barcelona;11;Baix Llobregat;08073;Cornellà de Llobregat;4;5;B;;441;302;139;2;2;298;300
8;Barcelona;11;Baix Llobregat;08073;Cornellà de Llobregat;4;6;A;;557;326;231;0;9;317;326
8;Barcelona;11;Baix Llobregat;08073;Cornellà de Llobregat;4;6;B;;636;382;254;0;6;376;382
8;Barcelona;11;Baix Llobregat;08073;Cornellà de Llobregat;4;7;A;;412;251;161;0;4;247;251
8;Barcelona;11;Baix Llobregat;08073;Cornellà de Llobregat;4;7;B;;496;308;188;0;0;308;308
8;Barcelona;11;Baix Llobregat;08073;Cornellà de Llobregat;4;8;A;;585;348;237;0;1;347;348
8;Barcelona;11;Baix Llobregat;08073;Cornellà de Llobregat;4;8;B;;638;386;252;0;5;381;386
8;Barcelona;11;Baix Llobregat;08073;Cornellà de Llobregat;4;9;U;;745;449;296;0;8;441;449
8;Barcelona;11;Baix Llobregat;08073;Cornellà de Llobregat;5;1;U;;635;349;286;1;0;348;348
8;Barcelona;11;Baix Llobregat;08073;Cornellà de Llobregat;5;10;A;;467;261;206;0;3;258;261
8;Barcelona;11;Baix Llobregat;08073;Cornellà de Llobregat;5;10;B;;489;294;195;0;2;292;294
8;Barcelona;11;Baix Llobregat;08073;Cornellà de Llobregat;5;2;U;;625;286;339;0;1;285;286
8;Barcelona;11;Baix Llobregat;08073;Cornellà de Llobregat;5;3;A;;419;214;205;1;3;210;213
8;Barcelona;11;Baix Llobregat;08073;Cornellà de Llobregat;5;3;B;;415;227;188;0;3;224;227
8;Barcelona;11;Baix Llobregat;08073;Cornellà de Llobregat;5;4;U;;571;302;269;1;0;301;301
8;Barcelona;11;Baix Llobregat;08073;Cornellà de Llobregat;5;5;U;;689;364;325;0;6;358;364
8;Barcelona;11;Baix Llobregat;08073;Cornellà de Llobregat;5;6;A;;419;243;176;0;2;241;243
8;Barcelona;11;Baix Llobregat;08073;Cornellà de Llobregat;5;6;B;;443;270;173;1;1;268;269
8;Barcelona;11;Baix Llobregat;08073;Cornellà de Llobregat;5;7;A;;391;221;170;0;1;220;221
8;Barcelona;11;Baix Llobregat;08073;Cornellà de Llobregat;5;7;B;;470;274;196;1;5;268;273
8;Barcelona;11;Baix Llobregat;08073;Cornellà de Llobregat;5;8;A;;379;212;167;1;0;211;211
8;Barcelona;11;Baix Llobregat;08073;Cornellà de Llobregat;5;8;B;;375;228;147;2;6;220;226
8;Barcelona;11;Baix Llobregat;08073;Cornellà de Llobregat;5;9;U;;710;495;215;1;5;489;494
8;Barcelona;11;Baix Llobregat;08073;Cornellà de Llobregat;6;1;U;;463;233;230;0;2;231;233
8;Barcelona;11;Baix Llobregat;08073;Cornellà de Llobregat;6;10;U;;690;404;286;0;4;400;404
8;Barcelona;11;Baix Llobregat;08073;Cornellà de Llobregat;6;11;U;;404;226;178;1;3;222;225
8;Barcelona;11;Baix Llobregat;08073;Cornellà de Llobregat;6;12;U;;696;376;320;0;9;367;376
8;Barcelona;11;Baix Llobregat;08073;Cornellà de Llobregat;6;13;U;;568;344;224;0;4;340;344
8;Barcelona;11;Baix Llobregat;08073;Cornellà de Llobregat;6;14;U;;722;398;324;0;5;393;398
8;Barcelona;11;Baix Llobregat;08073;Cornellà de Llobregat;6;15;U;;816;520;296;3;3;514;517
8;Barcelona;11;Baix Llobregat;08073;Cornellà de Llobregat;6;16;U;;530;279;251;0;2;277;279
8;Barcelona;11;Baix Llobregat;08073;Cornellà de Llobregat;6;2;A;;409;249;160;0;2;247;249
8;Barcelona;11;Baix Llobregat;08073;Cornellà de Llobregat;6;2;B;;444;268;176;1;2;265;267
8;Barcelona;11;Baix Llobregat;08073;Cornellà de Llobregat;6;3;U;;456;235;221;0;0;235;235
8;Barcelona;11;Baix Llobregat;08073;Cornellà de Llobregat;6;4;U;;508;264;244;3;6;255;261
8;Barcelona;11;Baix Llobregat;08073;Cornellà de Llobregat;6;5;U;;599;332;267;2;7;323;330
8;Barcelona;11;Baix Llobregat;08073;Cornellà de Llobregat;6;6;U;;481;292;189;1;2;289;291
8;Barcelona;11;Baix Llobregat;08073;Cornellà de Llobregat;6;7;A;;375;238;137;1;1;236;237
8;Barcelona;11;Baix Llobregat;08073;Cornellà de Llobregat;6;7;B;;412;251;161;0;0;251;251
8;Barcelona;11;Baix Llobregat;08073;Cornellà de Llobregat;6;8;U;;521;303;218;0;2;301;303
8;Barcelona;11;Baix Llobregat;08073;Cornellà de Llobregat;6;9;A;;521;338;183;1;2;335;337
8;Barcelona;11;Baix Llobregat;08073;Cornellà de Llobregat;6;9;B;;660;406;254;0;7;399;406
8;Barcelona;11;Baix Llobregat;08073;Cornellà de Llobregat;6;9;C;;629;395;234;1;4;390;394
17;Girona;28;Pla de l'Estany;17056;Cornellà del Terri;1;1;A;;807;586;221;4;1;581;582
17;Girona;28;Pla de l'Estany;17056;Cornellà del Terri;1;1;B;;827;612;215;2;3;607;610
43;Tarragona;29;Priorat;43049;Cornudella de Montsant;1;1;U;;741;554;187;6;2;546;548
43;Tarragona;36;Tarragonès;43050;Creixell;1;1;A;;827;525;302;8;2;515;517
43;Tarragona;36;Tarragonès;43050;Creixell;1;1;B;;900;556;344;5;2;549;551
17;Girona;28;Pla de l'Estany;17058;Crespià;1;1;U;;192;116;76;0;0;116;116
17;Girona;10;Baix Empordà;17901;Cruïlles, Monells i Sant Sadurní;1;1;A;;472;332;140;2;3;327;330
17;Girona;10;Baix Empordà;17901;Cruïlles, Monells i Sant Sadurní;1;1;B;;210;150;60;3;0;147;147
17;Girona;10;Baix Empordà;17901;Cruïlles, Monells i Sant Sadurní;1;1;C;;234;167;67;1;0;166;166
8;Barcelona;17;Garraf;08074;Cubelles;1;1;U;;763;434;329;1;5;428;433
8;Barcelona;17;Garraf;08074;Cubelles;1;2;A;;741;445;296;1;5;439;444
8;Barcelona;17;Garraf;08074;Cubelles;1;2;B;;834;463;371;3;3;457;460
8;Barcelona;17;Garraf;08074;Cubelles;1;3;A;;606;332;274;0;2;330;332
8;Barcelona;17;Garraf;08074;Cubelles;1;3;B;;694;391;303;1;6;384;390
8;Barcelona;17;Garraf;08074;Cubelles;1;4;U;;1090;614;476;1;7;606;613
8;Barcelona;17;Garraf;08074;Cubelles;1;5;A;;730;381;349;0;3;378;381
8;Barcelona;17;Garraf;08074;Cubelles;1;5;B;;776;405;371;0;1;404;405
8;Barcelona;17;Garraf;08074;Cubelles;1;5;C;;783;395;388;3;1;391;392
25;Lleida;23;Noguera;25079;Cubells;1;1;U;;320;262;58;0;2;260;262
43;Tarragona;12;Baix Penedès;43051;Cunit;1;1;A;;577;296;281;1;2;293;295
43;Tarragona;12;Baix Penedès;43051;Cunit;1;1;B;;603;323;280;5;3;315;318
43;Tarragona;12;Baix Penedès;43051;Cunit;1;2;A;;740;398;342;0;3;395;398
43;Tarragona;12;Baix Penedès;43051;Cunit;1;2;B;;729;390;339;2;2;386;388
43;Tarragona;12;Baix Penedès;43051;Cunit;1;2;C;;760;423;337;3;7;413;420
43;Tarragona;12;Baix Penedès;43051;Cunit;1;3;A;;713;406;307;3;0;403;403
43;Tarragona;12;Baix Penedès;43051;Cunit;1;3;B;;829;436;393;3;1;432;433
43;Tarragona;12;Baix Penedès;43051;Cunit;1;4;U;;887;423;464;9;2;412;414
17;Girona;2;Alt Empordà;17060;Darnius;1;1;U;;405;324;81;0;1;323;324
17;Girona;15;Cerdanya;17061;Das;1;1;U;;134;106;28;1;0;105;105
43;Tarragona;9;Baix Ebre;43901;Deltebre;1;1;A;;843;528;315;5;6;517;523
43;Tarragona;9;Baix Ebre;43901;Deltebre;1;1;B;;683;427;256;4;4;419;423
43;Tarragona;9;Baix Ebre;43901;Deltebre;1;2;A;;901;561;340;2;8;551;559
43;Tarragona;9;Baix Ebre;43901;Deltebre;1;2;B;;308;173;135;0;3;170;173
43;Tarragona;9;Baix Ebre;43901;Deltebre;1;2;C;;670;417;253;2;7;408;415
43;Tarragona;9;Baix Ebre;43901;Deltebre;1;3;A;;583;377;206;0;4;373;377
43;Tarragona;9;Baix Ebre;43901;Deltebre;1;3;B;;471;318;153;0;5;313;318
43;Tarragona;9;Baix Ebre;43901;Deltebre;1;4;A;;826;535;291;8;5;522;527
43;Tarragona;9;Baix Ebre;43901;Deltebre;1;4;B;;563;349;214;1;3;345;348
43;Tarragona;9;Baix Ebre;43901;Deltebre;1;5;A;;653;430;223;2;6;422;428
43;Tarragona;9;Baix Ebre;43901;Deltebre;1;5;B;;577;357;220;0;2;355;357
43;Tarragona;9;Baix Ebre;43901;Deltebre;1;6;A;;883;558;325;1;6;551;557
43;Tarragona;9;Baix Ebre;43901;Deltebre;1;6;B;;708;420;288;3;1;416;417
8;Barcelona;21;Maresme;08075;Dosrius;1;1;A;;775;490;285;2;2;486;488
8;Barcelona;21;Maresme;08075;Dosrius;1;1;B;;792;462;330;1;2;459;461
8;Barcelona;21;Maresme;08075;Dosrius;1;2;A;;666;335;331;1;3;331;334
8;Barcelona;21;Maresme;08075;Dosrius;1;2;B;;737;394;343;0;5;389;394
43;Tarragona;8;Baix Camp;43053;Duesaigües;1;1;U;;180;143;37;1;1;141;142
17;Girona;2;Alt Empordà;17062;Escala, l';1;1;U;;927;559;368;1;5;553;558
17;Girona;2;Alt Empordà;17062;Escala, l';1;2;A;;703;395;308;0;0;395;395
17;Girona;2;Alt Empordà;17062;Escala, l';1;2;B;;660;389;271;0;3;386;389
17;Girona;2;Alt Empordà;17062;Escala, l';1;3;A;;606;368;238;2;7;359;366
17;Girona;2;Alt Empordà;17062;Escala, l';1;3;B;;597;379;218;3;5;371;376
17;Girona;2;Alt Empordà;17062;Escala, l';1;4;U;;966;624;342;1;6;617;623
17;Girona;2;Alt Empordà;17062;Escala, l';1;5;U;;793;402;391;0;3;399;402
8;Barcelona;11;Baix Llobregat;08076;Esparreguera;1;1;A;;595;356;239;0;2;354;356
8;Barcelona;11;Baix Llobregat;08076;Esparreguera;1;1;B;;673;360;313;2;4;354;358
8;Barcelona;11;Baix Llobregat;08076;Esparreguera;1;1;C;;542;326;216;0;0;326;326
8;Barcelona;11;Baix Llobregat;08076;Esparreguera;1;2;A;;712;407;305;1;2;404;406
8;Barcelona;11;Baix Llobregat;08076;Esparreguera;1;2;B;;907;561;346;2;4;555;559
8;Barcelona;11;Baix Llobregat;08076;Esparreguera;1;3;A;;574;402;172;1;2;399;401
8;Barcelona;11;Baix Llobregat;08076;Esparreguera;1;3;B;;825;559;266;2;4;553;557
8;Barcelona;11;Baix Llobregat;08076;Esparreguera;1;4;A;;691;455;236;3;1;451;452
8;Barcelona;11;Baix Llobregat;08076;Esparreguera;1;4;B;;814;520;294;5;7;508;515
8;Barcelona;11;Baix Llobregat;08076;Esparreguera;1;5;U;;676;384;292;2;2;380;382
8;Barcelona;11;Baix Llobregat;08076;Esparreguera;1;6;A;;601;380;221;0;4;376;380
8;Barcelona;11;Baix Llobregat;08076;Esparreguera;1;6;B;;627;387;240;0;7;380;387
8;Barcelona;11;Baix Llobregat;08076;Esparreguera;2;1;A;;830;462;368;0;3;459;462
8;Barcelona;11;Baix Llobregat;08076;Esparreguera;2;1;B;;947;505;442;3;6;496;502
8;Barcelona;11;Baix Llobregat;08076;Esparreguera;2;2;A;;720;374;346;0;1;373;374
8;Barcelona;11;Baix Llobregat;08076;Esparreguera;2;2;B;;807;370;437;0;4;366;370
8;Barcelona;11;Baix Llobregat;08076;Esparreguera;2;2;C;;651;332;319;1;5;326;331
8;Barcelona;11;Baix Llobregat;08076;Esparreguera;2;3;A;;789;517;272;4;6;507;513
8;Barcelona;11;Baix Llobregat;08076;Esparreguera;2;3;B;;895;590;305;2;6;582;588
8;Barcelona;11;Baix Llobregat;08076;Esparreguera;2;4;A;;621;363;258;2;5;356;361
8;Barcelona;11;Baix Llobregat;08076;Esparreguera;2;4;B;;686;388;298;1;2;385;387
17;Girona;24;Osona;17063;Espinelves;1;1;U;;167;126;41;1;1;124;125
25;Lleida;18;Garrigues;25081;Espluga Calba, l';1;1;U;;358;281;77;1;2;278;280
43;Tarragona;16;Conca de Barberà;43054;Espluga de Francolí, l';1;1;A;;652;474;178;2;3;469;472
43;Tarragona;16;Conca de Barberà;43054;Espluga de Francolí, l';1;1;B;;410;290;120;1;3;286;289
43;Tarragona;16;Conca de Barberà;43054;Espluga de Francolí, l';1;1;C;;748;513;235;3;5;505;510
43;Tarragona;16;Conca de Barberà;43054;Espluga de Francolí, l';2;1;A;;498;340;158;0;9;331;340
43;Tarragona;16;Conca de Barberà;43054;Espluga de Francolí, l';2;1;B;;654;439;215;1;3;435;438
8;Barcelona;11;Baix Llobregat;08077;Esplugues de Llobregat;1;1;A;;578;431;147;1;8;422;430
8;Barcelona;11;Baix Llobregat;08077;Esplugues de Llobregat;1;1;B;;645;477;168;0;3;474;477
8;Barcelona;11;Baix Llobregat;08077;Esplugues de Llobregat;1;2;A;;497;350;147;1;4;345;349
8;Barcelona;11;Baix Llobregat;08077;Esplugues de Llobregat;1;2;B;;554;415;139;0;3;412;415
8;Barcelona;11;Baix Llobregat;08077;Esplugues de Llobregat;1;3;A;;674;457;217;2;2;453;455
8;Barcelona;11;Baix Llobregat;08077;Esplugues de Llobregat;1;3;B;;703;488;215;0;9;479;488
8;Barcelona;11;Baix Llobregat;08077;Esplugues de Llobregat;1;4;A;;532;348;184;0;8;340;348
8;Barcelona;11;Baix Llobregat;08077;Esplugues de Llobregat;1;4;B;;583;370;213;1;5;364;369
8;Barcelona;11;Baix Llobregat;08077;Esplugues de Llobregat;1;5;A;;648;402;246;0;2;400;402
8;Barcelona;11;Baix Llobregat;08077;Esplugues de Llobregat;1;5;B;;697;455;242;0;8;447;455
8;Barcelona;11;Baix Llobregat;08077;Esplugues de Llobregat;10;1;A;;526;346;180;0;2;344;346
8;Barcelona;11;Baix Llobregat;08077;Esplugues de Llobregat;10;1;B;;711;471;240;0;5;466;471
8;Barcelona;11;Baix Llobregat;08077;Esplugues de Llobregat;10;1;C;;708;455;253;1;2;452;454
8;Barcelona;11;Baix Llobregat;08077;Esplugues de Llobregat;10;2;A;;603;351;252;0;5;346;351
8;Barcelona;11;Baix Llobregat;08077;Esplugues de Llobregat;10;2;B;;779;475;304;0;7;468;475
8;Barcelona;11;Baix Llobregat;08077;Esplugues de Llobregat;10;3;A;;630;369;261;1;9;359;368
8;Barcelona;11;Baix Llobregat;08077;Esplugues de Llobregat;10;3;B;;654;383;271;1;3;379;382
8;Barcelona;11;Baix Llobregat;08077;Esplugues de Llobregat;10;3;C;;635;391;244;1;7;383;390
8;Barcelona;11;Baix Llobregat;08077;Esplugues de Llobregat;10;4;A;;435;223;212;0;2;221;223
8;Barcelona;11;Baix Llobregat;08077;Esplugues de Llobregat;10;4;B;;586;310;276;0;1;309;310
8;Barcelona;11;Baix Llobregat;08077;Esplugues de Llobregat;10;5;A;;444;239;205;0;1;238;239
8;Barcelona;11;Baix Llobregat;08077;Esplugues de Llobregat;10;5;B;;492;278;214;0;2;276;278
8;Barcelona;11;Baix Llobregat;08077;Esplugues de Llobregat;10;6;A;;660;403;257;0;7;396;403
8;Barcelona;11;Baix Llobregat;08077;Esplugues de Llobregat;10;6;B;;755;457;298;0;3;454;457
8;Barcelona;11;Baix Llobregat;08077;Esplugues de Llobregat;10;7;A;;668;435;233;3;7;425;432
8;Barcelona;11;Baix Llobregat;08077;Esplugues de Llobregat;10;7;B;;760;493;267;0;7;486;493
8;Barcelona;11;Baix Llobregat;08077;Esplugues de Llobregat;10;8;A;;714;399;315;3;2;394;396
8;Barcelona;11;Baix Llobregat;08077;Esplugues de Llobregat;10;8;B;;849;492;357;1;4;487;491
8;Barcelona;11;Baix Llobregat;08077;Esplugues de Llobregat;2;1;A;;577;378;199;1;0;377;377
8;Barcelona;11;Baix Llobregat;08077;Esplugues de Llobregat;2;1;B;;607;408;199;2;4;402;406
8;Barcelona;11;Baix Llobregat;08077;Esplugues de Llobregat;2;2;A;;478;264;214;0;4;260;264
8;Barcelona;11;Baix Llobregat;08077;Esplugues de Llobregat;2;2;B;;568;348;220;0;4;344;348
8;Barcelona;11;Baix Llobregat;08077;Esplugues de Llobregat;2;3;A;;695;452;243;2;11;439;450
8;Barcelona;11;Baix Llobregat;08077;Esplugues de Llobregat;2;3;B;;838;529;309;0;9;520;529
8;Barcelona;11;Baix Llobregat;08077;Esplugues de Llobregat;2;4;A;;557;386;171;1;7;378;385
8;Barcelona;11;Baix Llobregat;08077;Esplugues de Llobregat;2;4;B;;681;399;282;0;11;388;399
8;Barcelona;11;Baix Llobregat;08077;Esplugues de Llobregat;2;5;A;;627;404;223;2;4;398;402
8;Barcelona;11;Baix Llobregat;08077;Esplugues de Llobregat;2;5;B;;739;464;275;2;8;454;462
8;Barcelona;11;Baix Llobregat;08077;Esplugues de Llobregat;2;6;A;;536;369;167;1;7;361;368
8;Barcelona;11;Baix Llobregat;08077;Esplugues de Llobregat;2;6;B;;629;415;214;2;8;405;413
8;Barcelona;11;Baix Llobregat;08077;Esplugues de Llobregat;3;1;A;;531;351;180;1;5;345;350
8;Barcelona;11;Baix Llobregat;08077;Esplugues de Llobregat;3;1;B;;632;438;194;1;6;431;437
8;Barcelona;11;Baix Llobregat;08077;Esplugues de Llobregat;3;2;A;;616;394;222;1;2;391;393
8;Barcelona;11;Baix Llobregat;08077;Esplugues de Llobregat;3;2;B;;649;418;231;2;3;413;416
8;Barcelona;11;Baix Llobregat;08077;Esplugues de Llobregat;3;2;C;;603;364;239;3;5;356;361
8;Barcelona;11;Baix Llobregat;08077;Esplugues de Llobregat;4;1;U;;627;435;192;1;6;428;434
8;Barcelona;11;Baix Llobregat;08077;Esplugues de Llobregat;5;1;U;;475;334;141;1;2;331;333
8;Barcelona;11;Baix Llobregat;08077;Esplugues de Llobregat;6;1;U;;552;367;185;0;6;361;367
8;Barcelona;11;Baix Llobregat;08077;Esplugues de Llobregat;7;1;U;;917;639;278;1;15;623;638
8;Barcelona;11;Baix Llobregat;08077;Esplugues de Llobregat;8;1;A;;662;425;237;1;2;422;424
8;Barcelona;11;Baix Llobregat;08077;Esplugues de Llobregat;8;1;B;;842;557;285;5;9;543;552
8;Barcelona;11;Baix Llobregat;08077;Esplugues de Llobregat;8;2;A;;800;513;287;4;8;501;509
8;Barcelona;11;Baix Llobregat;08077;Esplugues de Llobregat;8;2;B;;919;628;291;3;6;619;625
8;Barcelona;11;Baix Llobregat;08077;Esplugues de Llobregat;9;1;A;;628;390;238;0;2;388;390
8;Barcelona;11;Baix Llobregat;08077;Esplugues de Llobregat;9;1;B;;649;397;252;0;5;392;397
8;Barcelona;11;Baix Llobregat;08077;Esplugues de Llobregat;9;2;A;;688;452;236;0;7;445;452
8;Barcelona;11;Baix Llobregat;08077;Esplugues de Llobregat;9;2;B;;753;494;259;0;5;489;494
17;Girona;2;Alt Empordà;17064;Espolla;1;1;U;;319;256;63;0;2;254;256
17;Girona;28;Pla de l'Estany;17065;Esponellà;1;1;U;;341;260;81;1;5;254;259
25;Lleida;26;Pallars Sobirà;25082;Espot;1;1;U;;292;193;99;0;0;193;193
8;Barcelona;14;Berguedà;08078;Espunyola, l';1;1;U;;232;172;60;2;2;168;170
8;Barcelona;24;Osona;08254;Esquirol, l';1;1;A;;651;516;135;1;5;510;515
8;Barcelona;24;Osona;08254;Esquirol, l';1;1;B;;688;539;149;1;5;533;538
8;Barcelona;24;Osona;08254;Esquirol, l';1;1;C;;175;135;40;0;4;131;135
8;Barcelona;24;Osona;08254;Esquirol, l';1;1;D;;284;207;77;0;0;207;207
25;Lleida;4;Alt Urgell;25088;Estamariu;1;1;U;;110;88;22;0;0;88;88
8;Barcelona;;;08079;Estany, l';1;1;U;;353;281;72;0;5;276;281
25;Lleida;32;Segarra;25085;Estaràs;1;1;U;;162;122;40;0;2;120;122
25;Lleida;26;Pallars Sobirà;25086;Esterri d'Àneu;1;1;U;;584;431;153;3;3;425;428
25;Lleida;26;Pallars Sobirà;25087;Esterri de Cardós;1;1;U;;61;42;19;0;0;42;42
43;Tarragona;29;Priorat;43055;Falset;1;1;A;;423;326;97;1;4;321;325
43;Tarragona;29;Priorat;43055;Falset;1;1;B;;557;412;145;1;2;409;411
43;Tarragona;29;Priorat;43055;Falset;2;1;A;;473;366;107;0;4;362;366
43;Tarragona;29;Priorat;43055;Falset;2;1;B;;567;437;130;0;2;435;437
17;Girona;2;Alt Empordà;17005;Far d'Empordà, el;1;1;U;;341;218;123;0;1;217;218
25;Lleida;26;Pallars Sobirà;25089;Farrera;1;1;U;;92;71;21;0;0;71;71
43;Tarragona;37;Terra Alta;43056;Fatarella, la;1;1;U;;503;352;151;1;3;348;351
43;Tarragona;37;Terra Alta;43056;Fatarella, la;1;2;U;;534;389;145;0;2;387;389
43;Tarragona;8;Baix Camp;43057;Febró, la;1;1;U;;54;33;21;0;2;31;33
8;Barcelona;41;Vallès Oriental;08134;Figaró-Montmany;1;1;U;;725;477;248;1;1;475;476
8;Barcelona;14;Berguedà;08080;Fígols;1;1;U;;41;32;9;0;1;31;32
25;Lleida;4;Alt Urgell;25908;Fígols i Alinyà;1;1;U;;256;191;65;0;3;188;191
43;Tarragona;29;Priorat;43058;Figuera, la;1;1;U;;206;152;54;0;1;151;152
17;Girona;2;Alt Empordà;17066;Figueres;1;1;U;;602;341;261;0;4;337;341
17;Girona;2;Alt Empordà;17066;Figueres;1;2;U;;939;614;325;1;5;608;613
17;Girona;2;Alt Empordà;17066;Figueres;1;3;A;;815;477;338;1;2;474;476
17;Girona;2;Alt Empordà;17066;Figueres;1;3;B;;713;433;280;1;1;431;432
17;Girona;2;Alt Empordà;17066;Figueres;1;4;U;;915;559;356;2;5;552;557
17;Girona;2;Alt Empordà;17066;Figueres;1;5;U;;1009;480;529;3;1;476;477
17;Girona;2;Alt Empordà;17066;Figueres;1;6;A;;789;384;405;1;3;380;383
17;Girona;2;Alt Empordà;17066;Figueres;1;6;B;;770;402;368;0;3;399;402
17;Girona;2;Alt Empordà;17066;Figueres;1;7;U;;1021;532;489;4;8;520;528
17;Girona;2;Alt Empordà;17066;Figueres;1;8;U;;783;423;360;2;2;419;421
17;Girona;2;Alt Empordà;17066;Figueres;2;1;U;;596;367;229;0;4;363;367
17;Girona;2;Alt Empordà;17066;Figueres;2;2;U;;919;494;425;2;3;489;492
17;Girona;2;Alt Empordà;17066;Figueres;2;3;U;;664;450;214;0;6;444;450
17;Girona;2;Alt Empordà;17066;Figueres;2;4;A;;771;450;321;1;3;446;449
17;Girona;2;Alt Empordà;17066;Figueres;2;4;B;;764;444;320;0;3;441;444
17;Girona;2;Alt Empordà;17066;Figueres;2;5;U;;538;314;224;3;4;307;311
17;Girona;2;Alt Empordà;17066;Figueres;3;1;U;;566;367;199;4;3;360;363
17;Girona;2;Alt Empordà;17066;Figueres;3;2;A;;714;452;262;2;4;446;450
17;Girona;2;Alt Empordà;17066;Figueres;3;2;B;;286;191;95;0;1;190;191
17;Girona;2;Alt Empordà;17066;Figueres;3;3;A;;632;359;273;2;2;355;357
17;Girona;2;Alt Empordà;17066;Figueres;3;3;B;;558;303;255;0;3;300;303
17;Girona;2;Alt Empordà;17066;Figueres;3;4;A;;591;286;305;2;2;282;284
17;Girona;2;Alt Empordà;17066;Figueres;3;4;B;;527;267;260;0;0;267;267
17;Girona;2;Alt Empordà;17066;Figueres;3;5;A;;835;551;284;16;4;531;535
17;Girona;2;Alt Empordà;17066;Figueres;3;5;B;;724;453;271;4;9;440;449
17;Girona;2;Alt Empordà;17066;Figueres;4;1;A;;594;379;215;1;5;373;378
17;Girona;2;Alt Empordà;17066;Figueres;4;1;B;;491;302;189;3;3;296;299
17;Girona;2;Alt Empordà;17066;Figueres;4;2;A;;699;458;241;5;2;451;453
17;Girona;2;Alt Empordà;17066;Figueres;4;2;B;;665;432;233;3;5;424;429
17;Girona;2;Alt Empordà;17066;Figueres;4;3;A;;616;387;229;1;4;382;386
17;Girona;2;Alt Empordà;17066;Figueres;4;3;B;;610;386;224;1;3;382;385
17;Girona;2;Alt Empordà;17066;Figueres;4;4;A;;917;553;364;1;1;551;552
17;Girona;2;Alt Empordà;17066;Figueres;4;4;B;;796;507;289;3;6;498;504
17;Girona;2;Alt Empordà;17066;Figueres;4;5;A;;901;563;338;1;2;560;562
17;Girona;2;Alt Empordà;17066;Figueres;4;5;B;;823;473;350;0;3;470;473
17;Girona;2;Alt Empordà;17066;Figueres;4;7;U;;753;449;304;0;6;443;449
17;Girona;2;Alt Empordà;17066;Figueres;4;8;U;;745;429;316;1;9;419;428
43;Tarragona;1;Alt Camp;43059;Figuerola del Camp;1;1;U;;242;186;56;1;4;181;185
17;Girona;20;Gironès;17067;Flaçà;1;1;U;;720;551;169;3;4;544;548
43;Tarragona;30;Ribera d'Ebre;43060;Flix;1;1;A;;483;358;125;1;2;355;357
43;Tarragona;30;Ribera d'Ebre;43060;Flix;1;1;B;;564;408;156;2;4;402;406
43;Tarragona;30;Ribera d'Ebre;43060;Flix;1;2;A;;624;471;153;0;0;471;471
43;Tarragona;30;Ribera d'Ebre;43060;Flix;1;2;B;;652;474;178;0;4;470;474
43;Tarragona;30;Ribera d'Ebre;43060;Flix;2;1;A;;507;365;142;2;4;359;363
43;Tarragona;30;Ribera d'Ebre;43060;Flix;2;1;B;;539;379;160;2;4;373;377
25;Lleida;18;Garrigues;25092;Floresta, la;1;1;U;;157;121;36;0;0;121;121
8;Barcelona;34;Selva;08082;Fogars de la Selva;1;1;U;;789;465;324;0;6;459;465
8;Barcelona;41;Vallès Oriental;08081;Fogars de Montclús;1;1;U;;325;260;65;3;4;253;257
17;Girona;10;Baix Empordà;17068;Foixà;1;1;U;;245;184;61;0;1;183;184
8;Barcelona;24;Osona;08083;Folgueroles;1;1;A;;663;536;127;5;4;527;531
8;Barcelona;24;Osona;08083;Folgueroles;1;1;B;;767;618;149;2;9;607;616
25;Lleida;27;Pla d'Urgell;25093;Fondarella;1;1;U;;580;426;154;0;4;422;426
8;Barcelona;7;Bages;08084;Fonollosa;1;1;A;;307;256;51;1;3;252;255
8;Barcelona;7;Bages;08084;Fonollosa;1;1;B;;232;182;50;1;2;179;181
8;Barcelona;7;Bages;08084;Fonollosa;1;1;C;;377;215;162;0;1;214;215
17;Girona;15;Cerdanya;17069;Fontanals de Cerdanya;1;1;U;;361;263;98;4;3;256;259
17;Girona;10;Baix Empordà;17070;Fontanilles;1;1;U;;132;109;23;0;3;106;109
17;Girona;28;Pla de l'Estany;17071;Fontcoberta;1;1;A;;438;320;118;2;4;314;318
17;Girona;28;Pla de l'Estany;17071;Fontcoberta;1;1;B;;493;357;136;2;5;350;355
8;Barcelona;3;Alt Penedès;08085;Font-rubí;1;1;U;;996;737;259;4;3;730;733
25;Lleida;23;Noguera;25094;Foradada;1;1;U;;200;145;55;0;3;142;145
17;Girona;10;Baix Empordà;17902;Forallac;1;1;U;;789;603;186;2;4;597;601
17;Girona;10;Baix Empordà;17902;Forallac;1;2;A;;349;270;79;0;3;267;270
17;Girona;10;Baix Empordà;17902;Forallac;1;2;B;;245;192;53;1;0;191;191
43;Tarragona;16;Conca de Barberà;43061;Forès;1;1;U;;60;42;18;0;0;42;42
17;Girona;20;Gironès;17073;Fornells de la Selva;1;1;A;;631;491;140;0;3;488;491
17;Girona;20;Gironès;17073;Fornells de la Selva;1;1;B;;692;541;151;2;11;528;539
17;Girona;2;Alt Empordà;17074;Fortià;1;1;U;;445;311;134;1;8;302;310
8;Barcelona;41;Vallès Oriental;08086;Franqueses del Vallès, les;1;1;A;;783;507;276;0;5;502;507
8;Barcelona;41;Vallès Oriental;08086;Franqueses del Vallès, les;1;1;B;;748;484;264;2;5;477;482
8;Barcelona;41;Vallès Oriental;08086;Franqueses del Vallès, les;1;1;C;;834;552;282;3;1;548;549
8;Barcelona;41;Vallès Oriental;08086;Franqueses del Vallès, les;1;1;D;;109;76;33;0;0;76;76
8;Barcelona;41;Vallès Oriental;08086;Franqueses del Vallès, les;1;2;A;;498;263;235;1;0;262;262
8;Barcelona;41;Vallès Oriental;08086;Franqueses del Vallès, les;1;2;B;;642;308;334;0;2;306;308
8;Barcelona;41;Vallès Oriental;08086;Franqueses del Vallès, les;1;2;C;;601;308;293;0;1;307;308
8;Barcelona;41;Vallès Oriental;08086;Franqueses del Vallès, les;1;3;A;;544;282;262;0;1;281;282
8;Barcelona;41;Vallès Oriental;08086;Franqueses del Vallès, les;1;3;B;;485;235;250;0;3;232;235
8;Barcelona;41;Vallès Oriental;08086;Franqueses del Vallès, les;1;3;C;;572;283;289;3;5;275;280
8;Barcelona;41;Vallès Oriental;08086;Franqueses del Vallès, les;1;4;A;;475;246;229;1;3;242;245
8;Barcelona;41;Vallès Oriental;08086;Franqueses del Vallès, les;1;4;B;;575;384;191;2;3;379;382
8;Barcelona;41;Vallès Oriental;08086;Franqueses del Vallès, les;1;4;C;;634;396;238;1;6;389;395
8;Barcelona;41;Vallès Oriental;08086;Franqueses del Vallès, les;1;4;D;;667;417;250;1;5;411;416
8;Barcelona;41;Vallès Oriental;08086;Franqueses del Vallès, les;1;5;A;;866;439;427;0;8;431;439
8;Barcelona;41;Vallès Oriental;08086;Franqueses del Vallès, les;1;5;B;;1033;518;515;2;4;512;516
8;Barcelona;41;Vallès Oriental;08086;Franqueses del Vallès, les;2;1;A;;689;518;171;2;1;515;516
8;Barcelona;41;Vallès Oriental;08086;Franqueses del Vallès, les;2;1;B;;445;322;123;0;2;320;322
43;Tarragona;22;Montsià;43062;Freginals;1;1;U;;298;245;53;2;4;239;243
25;Lleida;38;Urgell;25096;Fuliola, la;1;1;A;;446;344;102;0;0;344;344
25;Lleida;38;Urgell;25096;Fuliola, la;1;1;B;;574;433;141;1;3;429;432
25;Lleida;18;Garrigues;25097;Fulleda;1;1;U;;97;77;20;0;1;76;77
8;Barcelona;7;Bages;08090;Gaià;1;1;U;;128;95;33;0;0;95;95
43;Tarragona;22;Montsià;43063;Galera, la;1;1;U;;598;432;166;1;8;423;431
8;Barcelona;40;Vallès Occidental;08087;Gallifa;1;1;U;;156;124;32;0;0;124;124
43;Tarragona;37;Terra Alta;43064;Gandesa;1;1;A;;641;483;158;4;7;472;479
43;Tarragona;37;Terra Alta;43064;Gandesa;1;1;B;;666;506;160;1;9;496;505
43;Tarragona;37;Terra Alta;43064;Gandesa;2;1;U;;838;625;213;4;6;615;621
43;Tarragona;30;Ribera d'Ebre;43065;Garcia;1;1;U;;440;323;117;1;2;320;322
43;Tarragona;1;Alt Camp;43066;Garidells, els;1;1;U;;132;89;43;3;3;83;86
8;Barcelona;41;Vallès Oriental;08088;Garriga, la;1;1;A;;743;541;202;3;2;536;538
8;Barcelona;41;Vallès Oriental;08088;Garriga, la;1;1;B;;797;547;250;2;7;538;545
8;Barcelona;41;Vallès Oriental;08088;Garriga, la;1;2;A;;621;400;221;1;3;396;399
8;Barcelona;41;Vallès Oriental;08088;Garriga, la;1;2;B;;539;361;178;1;5;355;360
8;Barcelona;41;Vallès Oriental;08088;Garriga, la;1;3;A;;749;490;259;1;3;486;489
8;Barcelona;41;Vallès Oriental;08088;Garriga, la;1;3;B;;737;463;274;3;6;454;460
8;Barcelona;41;Vallès Oriental;08088;Garriga, la;2;1;A;;810;596;214;1;2;593;595
8;Barcelona;41;Vallès Oriental;08088;Garriga, la;2;1;B;;918;676;242;2;0;674;674
8;Barcelona;41;Vallès Oriental;08088;Garriga, la;2;2;A;;713;493;220;1;5;487;492
8;Barcelona;41;Vallès Oriental;08088;Garriga, la;2;2;B;;766;506;260;2;2;502;504
8;Barcelona;41;Vallès Oriental;08088;Garriga, la;2;3;A;;1071;725;346;1;6;718;724
8;Barcelona;41;Vallès Oriental;08088;Garriga, la;2;3;B;;1181;773;408;4;6;763;769
17;Girona;2;Alt Empordà;17075;Garrigàs;1;1;U;;262;196;66;2;0;194;194
17;Girona;10;Baix Empordà;17076;Garrigoles;1;1;U;;122;105;17;1;3;101;104
17;Girona;2;Alt Empordà;17077;Garriguella;1;1;U;;545;345;200;0;0;345;345
8;Barcelona;11;Baix Llobregat;08089;Gavà;1;1;A;;588;355;233;0;4;351;355
8;Barcelona;11;Baix Llobregat;08089;Gavà;1;1;B;;674;411;263;1;3;407;410
8;Barcelona;11;Baix Llobregat;08089;Gavà;1;2;A;;598;379;219;3;4;372;376
8;Barcelona;11;Baix Llobregat;08089;Gavà;1;2;B;;712;461;251;2;3;456;459
8;Barcelona;11;Baix Llobregat;08089;Gavà;1;3;A;;518;320;198;0;4;316;320
8;Barcelona;11;Baix Llobregat;08089;Gavà;1;3;B;;521;322;199;2;4;316;320
8;Barcelona;11;Baix Llobregat;08089;Gavà;1;3;C;;542;361;181;1;4;356;360
8;Barcelona;11;Baix Llobregat;08089;Gavà;1;4;A;;772;475;297;1;3;471;474
8;Barcelona;11;Baix Llobregat;08089;Gavà;1;4;B;;862;546;316;0;11;535;546
8;Barcelona;11;Baix Llobregat;08089;Gavà;1;5;U;;994;552;442;3;7;542;549
8;Barcelona;11;Baix Llobregat;08089;Gavà;1;6;U;;595;254;341;0;2;252;254
8;Barcelona;11;Baix Llobregat;08089;Gavà;1;7;A;;868;572;296;0;7;565;572
8;Barcelona;11;Baix Llobregat;08089;Gavà;1;7;B;;861;519;342;0;5;514;519
8;Barcelona;11;Baix Llobregat;08089;Gavà;1;7;C;;986;619;367;0;4;615;619
8;Barcelona;11;Baix Llobregat;08089;Gavà;2;1;A;;798;504;294;1;0;503;503
8;Barcelona;11;Baix Llobregat;08089;Gavà;2;1;B;;897;557;340;1;6;550;556
8;Barcelona;11;Baix Llobregat;08089;Gavà;2;10;U;;410;185;225;0;0;185;185
8;Barcelona;11;Baix Llobregat;08089;Gavà;2;2;U;;878;543;335;1;3;539;542
8;Barcelona;11;Baix Llobregat;08089;Gavà;2;3;A;;387;230;157;2;4;224;228
8;Barcelona;11;Baix Llobregat;08089;Gavà;2;3;B;;392;249;143;0;3;246;249
8;Barcelona;11;Baix Llobregat;08089;Gavà;2;4;A;;661;301;360;0;2;299;301
8;Barcelona;11;Baix Llobregat;08089;Gavà;2;4;B;;838;413;425;3;4;406;410
8;Barcelona;11;Baix Llobregat;08089;Gavà;2;5;U;;518;241;277;0;2;239;241
8;Barcelona;11;Baix Llobregat;08089;Gavà;2;6;A;;757;371;386;2;1;368;369
8;Barcelona;11;Baix Llobregat;08089;Gavà;2;6;B;;832;392;440;1;1;390;391
8;Barcelona;11;Baix Llobregat;08089;Gavà;2;7;U;;783;442;341;0;8;434;442
8;Barcelona;11;Baix Llobregat;08089;Gavà;2;8;A;;727;388;339;1;5;382;387
8;Barcelona;11;Baix Llobregat;08089;Gavà;2;8;B;;776;408;368;0;4;404;408
8;Barcelona;11;Baix Llobregat;08089;Gavà;2;9;A;;622;343;279;0;3;340;343
8;Barcelona;11;Baix Llobregat;08089;Gavà;2;9;B;;756;415;341;0;2;413;415
8;Barcelona;11;Baix Llobregat;08089;Gavà;3;1;A;;473;264;209;0;1;263;264
8;Barcelona;11;Baix Llobregat;08089;Gavà;3;1;B;;540;270;270;0;0;270;270
8;Barcelona;11;Baix Llobregat;08089;Gavà;3;2;U;;917;546;371;0;12;534;546
8;Barcelona;11;Baix Llobregat;08089;Gavà;3;3;A;;785;408;377;0;4;404;408
8;Barcelona;11;Baix Llobregat;08089;Gavà;3;3;B;;823;439;384;0;6;433;439
8;Barcelona;11;Baix Llobregat;08089;Gavà;3;4;A;;548;290;258;0;2;288;290
8;Barcelona;11;Baix Llobregat;08089;Gavà;3;4;B;;600;292;308;0;2;290;292
8;Barcelona;11;Baix Llobregat;08089;Gavà;3;5;A;;759;280;479;0;4;276;280
8;Barcelona;11;Baix Llobregat;08089;Gavà;3;5;B;;720;309;411;0;4;305;309
8;Barcelona;11;Baix Llobregat;08089;Gavà;3;6;U;;934;556;378;0;3;553;556
8;Barcelona;11;Baix Llobregat;08089;Gavà;3;7;U;;807;493;314;0;5;488;493
8;Barcelona;11;Baix Llobregat;08089;Gavà;3;8;A;;751;469;282;1;7;461;468
8;Barcelona;11;Baix Llobregat;08089;Gavà;3;8;B;;805;488;317;0;7;481;488
8;Barcelona;11;Baix Llobregat;08089;Gavà;4;1;A;;780;475;305;1;3;471;474
8;Barcelona;11;Baix Llobregat;08089;Gavà;4;1;B;;977;598;379;1;2;595;597
8;Barcelona;11;Baix Llobregat;08089;Gavà;4;2;A;;647;349;298;5;4;340;344
8;Barcelona;11;Baix Llobregat;08089;Gavà;4;2;B;;724;401;323;0;4;397;401
25;Lleida;25;Pallars Jussà;25098;Gavet de la Conca;1;1;U;;265;187;78;2;0;185;185
8;Barcelona;3;Alt Penedès;08091;Gelida;1;1;A;;579;406;173;0;6;400;406
8;Barcelona;3;Alt Penedès;08091;Gelida;1;1;B;;696;447;249;1;1;445;446
8;Barcelona;3;Alt Penedès;08091;Gelida;1;2;A;;626;419;207;2;4;413;417
8;Barcelona;3;Alt Penedès;08091;Gelida;1;2;B;;698;458;240;3;3;452;455
8;Barcelona;3;Alt Penedès;08091;Gelida;2;1;A;;687;471;216;0;2;469;471
8;Barcelona;3;Alt Penedès;08091;Gelida;2;1;B;;785;512;273;2;3;507;510
17;Girona;15;Cerdanya;17078;Ger;1;1;U;;324;239;85;3;0;236;236
25;Lleida;33;Segrià;25912;Gimenells i el Pla de la Font;1;1;A;;622;428;194;2;0;426;426
25;Lleida;33;Segrià;25912;Gimenells i el Pla de la Font;1;1;B;;295;192;103;1;4;187;191
43;Tarragona;30;Ribera d'Ebre;43067;Ginestar;1;1;U;;749;607;142;2;2;603;605
17;Girona;20;Gironès;17079;Girona;1;1;U;;480;326;154;1;3;322;325
17;Girona;20;Gironès;17079;Girona;1;2;U;;657;455;202;1;9;445;454
17;Girona;20;Gironès;17079;Girona;1;3;A;;426;314;112;1;3;310;313
17;Girona;20;Gironès;17079;Girona;1;3;B;;403;293;110;4;1;288;289
17;Girona;20;Gironès;17079;Girona;1;4;A;;417;258;159;1;2;255;257
17;Girona;20;Gironès;17079;Girona;1;4;B;;404;246;158;4;1;241;242
17;Girona;20;Gironès;17079;Girona;1;5;A;;824;248;576;1;0;247;247
17;Girona;20;Gironès;17079;Girona;1;5;B;;384;133;251;2;3;128;131
17;Girona;20;Gironès;17079;Girona;1;6;A;;502;318;184;0;4;314;318
17;Girona;20;Gironès;17079;Girona;1;6;B;;540;350;190;0;0;350;350
17;Girona;20;Gironès;17079;Girona;2;1;U;;642;485;157;1;3;481;484
17;Girona;20;Gironès;17079;Girona;2;10;A;;707;509;198;0;7;502;509
17;Girona;20;Gironès;17079;Girona;2;10;B;;695;507;188;3;4;500;504
17;Girona;20;Gironès;17079;Girona;2;11;A;;637;414;223;3;5;406;411
17;Girona;20;Gironès;17079;Girona;2;11;B;;587;377;210;2;1;374;375
17;Girona;20;Gironès;17079;Girona;2;12;A;;559;426;133;0;5;421;426
17;Girona;20;Gironès;17079;Girona;2;12;B;;587;428;159;1;2;425;427
17;Girona;20;Gironès;17079;Girona;2;13;A;;480;352;128;0;1;351;352
17;Girona;20;Gironès;17079;Girona;2;13;B;;468;348;120;0;2;346;348
17;Girona;20;Gironès;17079;Girona;2;14;U;;596;342;254;4;3;335;338
17;Girona;20;Gironès;17079;Girona;2;15;A;;625;452;173;1;2;449;451
17;Girona;20;Gironès;17079;Girona;2;15;B;;682;510;172;0;0;510;510
17;Girona;20;Gironès;17079;Girona;2;16;U;;826;645;181;1;0;644;644
17;Girona;20;Gironès;17079;Girona;2;17;U;;813;586;227;1;6;579;585
17;Girona;20;Gironès;17079;Girona;2;18;U;;795;583;212;0;7;576;583
17;Girona;20;Gironès;17079;Girona;2;19;U;;947;679;268;0;10;669;679
17;Girona;20;Gironès;17079;Girona;2;2;U;;608;441;167;1;3;437;440
17;Girona;20;Gironès;17079;Girona;2;20;U;;914;686;228;3;7;676;683
17;Girona;20;Gironès;17079;Girona;2;3;A;;515;359;156;1;2;356;358
17;Girona;20;Gironès;17079;Girona;2;3;B;;517;367;150;1;1;365;366
17;Girona;20;Gironès;17079;Girona;2;4;A;;667;511;156;4;1;506;507
17;Girona;20;Gironès;17079;Girona;2;4;B;;621;473;148;0;3;470;473
17;Girona;20;Gironès;17079;Girona;2;5;U;;683;506;177;0;10;496;506
17;Girona;20;Gironès;17079;Girona;2;6;A;;534;382;152;1;2;379;381
17;Girona;20;Gironès;17079;Girona;2;6;B;;434;313;121;2;2;309;311
17;Girona;20;Gironès;17079;Girona;2;6;C;;539;387;152;0;6;381;387
17;Girona;20;Gironès;17079;Girona;2;7;A;;997;718;279;0;11;707;718
17;Girona;20;Gironès;17079;Girona;2;7;B;;876;610;266;4;8;598;606
17;Girona;20;Gironès;17079;Girona;2;8;A;;736;518;218;1;0;517;517
17;Girona;20;Gironès;17079;Girona;2;8;B;;812;615;197;1;7;607;614
17;Girona;20;Gironès;17079;Girona;2;9;A;;477;313;164;0;4;309;313
17;Girona;20;Gironès;17079;Girona;2;9;B;;508;332;176;0;6;326;332
17;Girona;20;Gironès;17079;Girona;3;1;A;;388;275;113;0;3;272;275
17;Girona;20;Gironès;17079;Girona;3;1;B;;390;296;94;0;3;293;296
17;Girona;20;Gironès;17079;Girona;3;10;A;;557;346;211;1;2;343;345
17;Girona;20;Gironès;17079;Girona;3;10;B;;567;373;194;1;3;369;372
17;Girona;20;Gironès;17079;Girona;3;11;A;;596;374;222;2;3;369;372
17;Girona;20;Gironès;17079;Girona;3;11;B;;544;317;227;2;5;310;315
17;Girona;20;Gironès;17079;Girona;3;11;C;;581;368;213;0;1;367;368
17;Girona;20;Gironès;17079;Girona;3;12;A;;838;501;337;4;5;492;497
17;Girona;20;Gironès;17079;Girona;3;12;B;;800;482;318;0;3;479;482
17;Girona;20;Gironès;17079;Girona;3;13;A;;642;401;241;1;2;398;400
17;Girona;20;Gironès;17079;Girona;3;13;B;;619;386;233;1;2;383;385
17;Girona;20;Gironès;17079;Girona;3;14;A;;743;411;332;2;3;406;409
17;Girona;20;Gironès;17079;Girona;3;14;B;;653;377;276;0;3;374;377
17;Girona;20;Gironès;17079;Girona;3;15;A;;666;421;245;3;4;414;418
17;Girona;20;Gironès;17079;Girona;3;15;B;;687;454;233;2;1;451;452
17;Girona;20;Gironès;17079;Girona;3;16;A;;572;391;181;0;4;387;391
17;Girona;20;Gironès;17079;Girona;3;16;B;;587;427;160;0;1;426;427
17;Girona;20;Gironès;17079;Girona;3;17;A;;964;605;359;2;5;598;603
17;Girona;20;Gironès;17079;Girona;3;17;B;;897;565;332;2;9;554;563
17;Girona;20;Gironès;17079;Girona;3;2;A;;407;277;130;0;1;276;277
17;Girona;20;Gironès;17079;Girona;3;2;B;;376;282;94;1;4;277;281
17;Girona;20;Gironès;17079;Girona;3;3;A;;693;502;191;3;6;493;499
17;Girona;20;Gironès;17079;Girona;3;3;B;;664;483;181;0;7;476;483
17;Girona;20;Gironès;17079;Girona;3;4;A;;766;597;169;2;9;586;595
17;Girona;20;Gironès;17079;Girona;3;4;B;;796;631;165;1;8;622;630
17;Girona;20;Gironès;17079;Girona;3;5;A;;803;605;198;0;3;602;605
17;Girona;20;Gironès;17079;Girona;3;5;B;;819;587;232;3;6;578;584
17;Girona;20;Gironès;17079;Girona;3;6;U;;745;534;211;1;3;530;533
17;Girona;20;Gironès;17079;Girona;3;7;A;;715;463;252;1;2;460;462
17;Girona;20;Gironès;17079;Girona;3;7;B;;739;456;283;1;0;455;455
17;Girona;20;Gironès;17079;Girona;3;8;A;;755;508;247;2;5;501;506
17;Girona;20;Gironès;17079;Girona;3;8;B;;746;496;250;2;7;487;494
17;Girona;20;Gironès;17079;Girona;3;9;A;;475;281;194;0;2;279;281
17;Girona;20;Gironès;17079;Girona;3;9;B;;442;287;155;0;3;284;287
17;Girona;20;Gironès;17079;Girona;4;1;U;;518;360;158;1;2;357;359
17;Girona;20;Gironès;17079;Girona;4;2;U;;640;440;200;2;4;434;438
17;Girona;20;Gironès;17079;Girona;4;3;U;;753;410;343;1;2;407;409
17;Girona;20;Gironès;17079;Girona;5;1;A;;903;704;199;6;1;697;698
17;Girona;20;Gironès;17079;Girona;5;1;B;;876;705;171;0;3;702;705
17;Girona;20;Gironès;17079;Girona;5;2;U;;495;300;195;2;4;294;298
17;Girona;20;Gironès;17079;Girona;5;3;A;;604;345;259;1;3;341;344
17;Girona;20;Gironès;17079;Girona;5;3;B;;526;327;199;0;1;326;327
17;Girona;20;Gironès;17079;Girona;5;4;U;;522;368;154;3;1;364;365
17;Girona;20;Gironès;17079;Girona;5;5;A;;429;258;171;0;0;258;258
17;Girona;20;Gironès;17079;Girona;5;5;B;;439;266;173;0;2;264;266
17;Girona;20;Gironès;17079;Girona;6;1;A;;675;395;280;1;4;390;394
17;Girona;20;Gironès;17079;Girona;6;1;B;;690;439;251;2;3;434;437
17;Girona;20;Gironès;17079;Girona;6;1;C;;671;434;237;2;3;429;432
17;Girona;20;Gironès;17079;Girona;6;2;A;;722;463;259;3;1;459;460
17;Girona;20;Gironès;17079;Girona;6;2;B;;654;429;225;0;2;427;429
17;Girona;20;Gironès;17079;Girona;6;3;A;;766;489;277;0;4;485;489
17;Girona;20;Gironès;17079;Girona;6;3;B;;670;405;265;0;2;403;405
17;Girona;20;Gironès;17079;Girona;6;4;A;;602;385;217;1;5;379;384
17;Girona;20;Gironès;17079;Girona;6;4;B;;546;348;198;0;10;338;348
8;Barcelona;14;Berguedà;08092;Gironella;1;1;A;;606;462;144;1;4;457;461
8;Barcelona;14;Berguedà;08092;Gironella;1;1;B;;699;521;178;4;2;515;517
8;Barcelona;14;Berguedà;08092;Gironella;2;1;U;;456;313;143;1;0;312;312
8;Barcelona;14;Berguedà;08092;Gironella;2;2;A;;546;401;145;3;2;396;398
8;Barcelona;14;Berguedà;08092;Gironella;2;2;B;;637;449;188;5;3;441;444
8;Barcelona;14;Berguedà;08092;Gironella;2;3;A;;550;387;163;1;2;384;386
8;Barcelona;14;Berguedà;08092;Gironella;2;3;B;;619;458;161;5;1;452;453
8;Barcelona;14;Berguedà;08093;Gisclareny;1;1;U;;32;26;6;0;0;26;26
43;Tarragona;22;Montsià;43068;Godall;1;1;U;;603;434;169;5;1;428;429
25;Lleida;27;Pla d'Urgell;25099;Golmés;1;1;U;;1120;766;354;1;10;755;765
17;Girona;31;Ripollès;17080;Gombrèn;1;1;U;;207;174;33;0;1;173;174
25;Lleida;14;Berguedà;25100;Gósol;1;1;U;;198;145;53;0;0;145;145
8;Barcelona;3;Alt Penedès;08094;Granada, la;1;1;A;;573;442;131;0;2;440;442
8;Barcelona;3;Alt Penedès;08094;Granada, la;1;1;B;;620;469;151;1;3;465;468
25;Lleida;18;Garrigues;25101;Granadella, la;1;1;U;;685;520;165;1;2;517;519
8;Barcelona;;;08095;Granera;1;1;U;;67;49;18;0;1;48;49
25;Lleida;33;Segrià;25102;Granja d'Escarp, la;1;1;U;;863;544;319;2;16;526;542
8;Barcelona;41;Vallès Oriental;08096;Granollers;1;1;U;;513;391;122;0;7;384;391
8;Barcelona;41;Vallès Oriental;08096;Granollers;1;10;A;;562;336;226;0;2;334;336
8;Barcelona;41;Vallès Oriental;08096;Granollers;1;10;B;;693;415;278;0;1;414;415
8;Barcelona;41;Vallès Oriental;08096;Granollers;1;11;A;;421;231;190;0;2;229;231
8;Barcelona;41;Vallès Oriental;08096;Granollers;1;11;B;;500;292;208;2;0;290;290
8;Barcelona;41;Vallès Oriental;08096;Granollers;1;11;C;;419;238;181;3;4;231;235
8;Barcelona;41;Vallès Oriental;08096;Granollers;1;2;A;;445;321;124;0;2;319;321
8;Barcelona;41;Vallès Oriental;08096;Granollers;1;2;B;;565;415;150;1;2;412;414
8;Barcelona;41;Vallès Oriental;08096;Granollers;1;3;A;;420;303;117;1;2;300;302
8;Barcelona;41;Vallès Oriental;08096;Granollers;1;3;B;;528;346;182;0;0;346;346
8;Barcelona;41;Vallès Oriental;08096;Granollers;1;3;C;;507;353;154;1;9;343;352
8;Barcelona;41;Vallès Oriental;08096;Granollers;1;4;U;;423;262;161;1;0;261;261
8;Barcelona;41;Vallès Oriental;08096;Granollers;1;5;A;;449;322;127;1;5;316;321
8;Barcelona;41;Vallès Oriental;08096;Granollers;1;5;B;;542;383;159;2;4;377;381
8;Barcelona;41;Vallès Oriental;08096;Granollers;1;5;C;;505;368;137;1;0;367;367
8;Barcelona;41;Vallès Oriental;08096;Granollers;1;6;A;;393;236;157;1;2;233;235
8;Barcelona;41;Vallès Oriental;08096;Granollers;1;6;B;;579;383;196;0;2;381;383
8;Barcelona;41;Vallès Oriental;08096;Granollers;1;7;A;;512;352;160;1;2;349;351
8;Barcelona;41;Vallès Oriental;08096;Granollers;1;7;B;;695;454;241;0;4;450;454
8;Barcelona;41;Vallès Oriental;08096;Granollers;1;8;U;;557;293;264;3;2;288;290
8;Barcelona;41;Vallès Oriental;08096;Granollers;1;9;A;;470;251;219;0;2;249;251
8;Barcelona;41;Vallès Oriental;08096;Granollers;1;9;B;;565;288;277;0;3;285;288
8;Barcelona;41;Vallès Oriental;08096;Granollers;2;1;A;;631;430;201;0;2;428;430
8;Barcelona;41;Vallès Oriental;08096;Granollers;2;1;B;;640;442;198;0;3;439;442
8;Barcelona;41;Vallès Oriental;08096;Granollers;2;2;U;;436;330;106;0;1;329;330
8;Barcelona;41;Vallès Oriental;08096;Granollers;2;3;U;;479;368;111;1;7;360;367
8;Barcelona;41;Vallès Oriental;08096;Granollers;2;4;A;;542;317;225;2;4;311;315
8;Barcelona;41;Vallès Oriental;08096;Granollers;2;4;B;;668;420;248;2;3;415;418
8;Barcelona;41;Vallès Oriental;08096;Granollers;2;4;C;;602;371;231;0;2;369;371
8;Barcelona;41;Vallès Oriental;08096;Granollers;2;5;U;;918;562;356;0;4;558;562
8;Barcelona;41;Vallès Oriental;08096;Granollers;2;6;A;;467;299;168;0;2;297;299
8;Barcelona;41;Vallès Oriental;08096;Granollers;2;6;B;;627;418;209;1;5;412;417
8;Barcelona;41;Vallès Oriental;08096;Granollers;2;7;A;;450;279;171;0;2;277;279
8;Barcelona;41;Vallès Oriental;08096;Granollers;2;7;B;;507;326;181;2;2;322;324
8;Barcelona;41;Vallès Oriental;08096;Granollers;3;1;A;;507;352;155;1;2;349;351
8;Barcelona;41;Vallès Oriental;08096;Granollers;3;1;B;;476;345;131;1;2;342;344
8;Barcelona;41;Vallès Oriental;08096;Granollers;3;1;C;;571;425;146;0;7;418;425
8;Barcelona;41;Vallès Oriental;08096;Granollers;3;2;A;;676;392;284;0;8;384;392
8;Barcelona;41;Vallès Oriental;08096;Granollers;3;2;B;;804;466;338;1;9;456;465
8;Barcelona;41;Vallès Oriental;08096;Granollers;3;3;A;;461;293;168;0;3;290;293
8;Barcelona;41;Vallès Oriental;08096;Granollers;3;3;B;;541;331;210;2;1;328;329
8;Barcelona;41;Vallès Oriental;08096;Granollers;3;4;A;;654;486;168;0;8;478;486
8;Barcelona;41;Vallès Oriental;08096;Granollers;3;4;B;;836;585;251;0;4;581;585
8;Barcelona;41;Vallès Oriental;08096;Granollers;3;5;A;;660;390;270;2;3;385;388
8;Barcelona;41;Vallès Oriental;08096;Granollers;3;5;B;;725;459;266;1;3;455;458
8;Barcelona;41;Vallès Oriental;08096;Granollers;3;6;A;;553;337;216;1;2;334;336
8;Barcelona;41;Vallès Oriental;08096;Granollers;3;6;B;;639;374;265;0;3;371;374
8;Barcelona;41;Vallès Oriental;08096;Granollers;3;6;C;;630;384;246;2;1;381;382
8;Barcelona;41;Vallès Oriental;08096;Granollers;3;7;U;;662;408;254;0;3;405;408
8;Barcelona;41;Vallès Oriental;08096;Granollers;3;8;A;;433;197;236;0;4;193;197
8;Barcelona;41;Vallès Oriental;08096;Granollers;3;8;B;;545;239;306;0;1;238;239
8;Barcelona;41;Vallès Oriental;08096;Granollers;3;9;U;;713;504;209;0;4;500;504
8;Barcelona;41;Vallès Oriental;08096;Granollers;4;1;A;;568;401;167;0;3;398;401
8;Barcelona;41;Vallès Oriental;08096;Granollers;4;1;B;;551;374;177;1;3;370;373
8;Barcelona;41;Vallès Oriental;08096;Granollers;4;1;C;;556;379;177;1;6;372;378
8;Barcelona;41;Vallès Oriental;08096;Granollers;4;10;A;;491;319;172;1;1;317;318
8;Barcelona;41;Vallès Oriental;08096;Granollers;4;10;B;;670;459;211;0;3;456;459
8;Barcelona;41;Vallès Oriental;08096;Granollers;4;10;C;;604;410;194;2;3;405;408
8;Barcelona;41;Vallès Oriental;08096;Granollers;4;10;D;;308;230;78;0;2;228;230
8;Barcelona;41;Vallès Oriental;08096;Granollers;4;11;A;;582;395;187;2;7;386;393
8;Barcelona;41;Vallès Oriental;08096;Granollers;4;11;B;;670;462;208;2;3;457;460
8;Barcelona;41;Vallès Oriental;08096;Granollers;4;2;A;;525;328;197;0;2;326;328
8;Barcelona;41;Vallès Oriental;08096;Granollers;4;2;B;;658;435;223;1;3;431;434
8;Barcelona;41;Vallès Oriental;08096;Granollers;4;2;C;;498;315;183;1;3;311;314
8;Barcelona;41;Vallès Oriental;08096;Granollers;4;3;U;;634;403;231;0;0;403;403
8;Barcelona;41;Vallès Oriental;08096;Granollers;4;4;U;;751;447;304;2;4;441;445
8;Barcelona;41;Vallès Oriental;08096;Granollers;4;5;U;;489;308;181;2;4;302;306
8;Barcelona;41;Vallès Oriental;08096;Granollers;4;6;U;;767;479;288;0;3;476;479
8;Barcelona;41;Vallès Oriental;08096;Granollers;4;7;A;;484;281;203;1;1;279;280
8;Barcelona;41;Vallès Oriental;08096;Granollers;4;7;B;;614;364;250;2;7;355;362
8;Barcelona;41;Vallès Oriental;08096;Granollers;4;7;C;;478;309;169;2;6;301;307
8;Barcelona;41;Vallès Oriental;08096;Granollers;4;7;D;;181;128;53;0;1;127;128
8;Barcelona;41;Vallès Oriental;08096;Granollers;4;8;U;;534;311;223;0;2;309;311
8;Barcelona;41;Vallès Oriental;08096;Granollers;4;9;A;;467;303;164;1;3;299;302
8;Barcelona;41;Vallès Oriental;08096;Granollers;4;9;B;;521;331;190;1;2;328;330
25;Lleida;32;Segarra;25103;Granyanella;1;1;U;;139;100;39;0;0;100;100
25;Lleida;18;Garrigues;25105;Granyena de les Garrigues;1;1;U;;151;118;33;1;1;116;117
25;Lleida;32;Segarra;25104;Granyena de Segarra;1;1;U;;137;106;31;1;1;104;105
43;Tarragona;29;Priorat;43069;Gratallops;1;1;U;;188;142;46;0;6;136;142
8;Barcelona;41;Vallès Oriental;08097;Gualba;1;1;U;;723;534;189;0;6;528;534
17;Girona;10;Baix Empordà;17081;Gualta;1;1;U;;236;182;54;0;2;180;182
8;Barcelona;14;Berguedà;08099;Guardiola de Berguedà;1;1;U;;768;550;218;1;2;547;549
43;Tarragona;29;Priorat;43070;Guiamets, els;1;1;U;;275;226;49;1;1;224;225
17;Girona;15;Cerdanya;17082;Guils de Cerdanya;1;1;U;;306;217;89;1;0;216;216
25;Lleida;38;Urgell;25109;Guimerà;1;1;U;;310;232;78;0;1;231;232
25;Lleida;26;Pallars Sobirà;25903;Guingueta d'Àneu, la;1;1;U;;277;198;79;1;2;195;197
25;Lleida;32;Segarra;25110;Guissona;1;1;A;;443;316;127;1;6;309;315
25;Lleida;32;Segarra;25110;Guissona;1;1;B;;508;374;134;1;4;369;373
25;Lleida;32;Segarra;25110;Guissona;1;2;A;;718;471;247;0;6;465;471
25;Lleida;32;Segarra;25110;Guissona;1;2;B;;939;633;306;2;5;626;631
25;Lleida;35;Solsonès;25111;Guixers;1;1;U;;149;106;43;1;2;103;105
8;Barcelona;24;Osona;08100;Gurb;1;1;A;;723;578;145;0;6;572;578
8;Barcelona;24;Osona;08100;Gurb;1;1;B;;896;684;212;2;2;680;682
43;Tarragona;37;Terra Alta;43071;Horta de Sant Joan;1;1;U;;1026;795;231;3;8;784;792
8;Barcelona;13;Barcelonès;08101;Hospitalet de Llobregat, l';1;1;U;;1187;719;468;0;5;714;719
8;Barcelona;13;Barcelonès;08101;Hospitalet de Llobregat, l';1;10;U;;1036;627;409;1;4;622;626
8;Barcelona;13;Barcelonès;08101;Hospitalet de Llobregat, l';1;11;U;;736;465;271;0;8;457;465
8;Barcelona;13;Barcelonès;08101;Hospitalet de Llobregat, l';1;12;U;;1236;831;405;1;20;810;830
8;Barcelona;13;Barcelonès;08101;Hospitalet de Llobregat, l';1;13;U;;1100;692;408;1;2;689;691
8;Barcelona;13;Barcelonès;08101;Hospitalet de Llobregat, l';1;14;A;;634;341;293;0;4;337;341
8;Barcelona;13;Barcelonès;08101;Hospitalet de Llobregat, l';1;14;B;;703;386;317;0;2;384;386
8;Barcelona;13;Barcelonès;08101;Hospitalet de Llobregat, l';1;15;U;;1026;628;398;0;14;614;628
8;Barcelona;13;Barcelonès;08101;Hospitalet de Llobregat, l';1;16;A;;579;331;248;3;1;327;328
8;Barcelona;13;Barcelonès;08101;Hospitalet de Llobregat, l';1;16;B;;695;429;266;0;1;428;429
8;Barcelona;13;Barcelonès;08101;Hospitalet de Llobregat, l';1;17;A;;766;441;325;0;0;441;441
8;Barcelona;13;Barcelonès;08101;Hospitalet de Llobregat, l';1;17;B;;886;544;342;0;16;528;544
8;Barcelona;13;Barcelonès;08101;Hospitalet de Llobregat, l';1;18;A;;700;409;291;0;4;405;409
8;Barcelona;13;Barcelonès;08101;Hospitalet de Llobregat, l';1;18;B;;694;411;283;1;7;403;410
8;Barcelona;13;Barcelonès;08101;Hospitalet de Llobregat, l';1;19;U;;1178;718;460;0;9;709;718
8;Barcelona;13;Barcelonès;08101;Hospitalet de Llobregat, l';1;2;A;;611;382;229;2;3;377;380
8;Barcelona;13;Barcelonès;08101;Hospitalet de Llobregat, l';1;2;B;;692;438;254;1;4;433;437
8;Barcelona;13;Barcelonès;08101;Hospitalet de Llobregat, l';1;20;U;;1266;799;467;0;5;794;799
8;Barcelona;13;Barcelonès;08101;Hospitalet de Llobregat, l';1;21;U;;632;338;294;0;2;336;338
8;Barcelona;13;Barcelonès;08101;Hospitalet de Llobregat, l';1;22;U;;688;411;277;0;2;409;411
8;Barcelona;13;Barcelonès;08101;Hospitalet de Llobregat, l';1;23;U;;1019;682;337;1;0;681;681
8;Barcelona;13;Barcelonès;08101;Hospitalet de Llobregat, l';1;24;U;;657;444;213;1;5;438;443
8;Barcelona;13;Barcelonès;08101;Hospitalet de Llobregat, l';1;25;U;;1152;678;474;2;7;669;676
8;Barcelona;13;Barcelonès;08101;Hospitalet de Llobregat, l';1;26;U;;910;586;324;1;6;579;585
8;Barcelona;13;Barcelonès;08101;Hospitalet de Llobregat, l';1;27;U;;636;381;255;0;2;379;381
8;Barcelona;13;Barcelonès;08101;Hospitalet de Llobregat, l';1;28;U;;789;416;373;1;5;410;415
8;Barcelona;13;Barcelonès;08101;Hospitalet de Llobregat, l';1;29;U;;865;469;396;3;1;465;466
8;Barcelona;13;Barcelonès;08101;Hospitalet de Llobregat, l';1;3;U;;603;398;205;0;3;395;398
8;Barcelona;13;Barcelonès;08101;Hospitalet de Llobregat, l';1;30;U;;825;557;268;0;0;557;557
8;Barcelona;13;Barcelonès;08101;Hospitalet de Llobregat, l';1;31;U;;1183;648;535;0;8;640;648
8;Barcelona;13;Barcelonès;08101;Hospitalet de Llobregat, l';1;32;A;;750;432;318;3;0;429;429
8;Barcelona;13;Barcelonès;08101;Hospitalet de Llobregat, l';1;32;B;;911;486;425;1;3;482;485
8;Barcelona;13;Barcelonès;08101;Hospitalet de Llobregat, l';1;33;U;;732;500;232;0;4;496;500
8;Barcelona;13;Barcelonès;08101;Hospitalet de Llobregat, l';1;34;U;;973;582;391;1;10;571;581
8;Barcelona;13;Barcelonès;08101;Hospitalet de Llobregat, l';1;35;U;;1228;741;487;0;16;725;741
8;Barcelona;13;Barcelonès;08101;Hospitalet de Llobregat, l';1;36;U;;933;630;303;0;8;622;630
8;Barcelona;13;Barcelonès;08101;Hospitalet de Llobregat, l';1;37;U;;1110;691;419;2;13;676;689
8;Barcelona;13;Barcelonès;08101;Hospitalet de Llobregat, l';1;38;U;;657;412;245;1;7;404;411
8;Barcelona;13;Barcelonès;08101;Hospitalet de Llobregat, l';1;39;U;;673;393;280;0;6;387;393
8;Barcelona;13;Barcelonès;08101;Hospitalet de Llobregat, l';1;4;U;;708;484;224;0;5;479;484
8;Barcelona;13;Barcelonès;08101;Hospitalet de Llobregat, l';1;40;U;;761;435;326;0;4;431;435
8;Barcelona;13;Barcelonès;08101;Hospitalet de Llobregat, l';1;5;U;;954;582;372;1;4;577;581
8;Barcelona;13;Barcelonès;08101;Hospitalet de Llobregat, l';1;6;A;;704;426;278;1;3;422;425
8;Barcelona;13;Barcelonès;08101;Hospitalet de Llobregat, l';1;6;B;;860;484;376;1;6;477;483
8;Barcelona;13;Barcelonès;08101;Hospitalet de Llobregat, l';1;7;A;;656;384;272;0;4;380;384
8;Barcelona;13;Barcelonès;08101;Hospitalet de Llobregat, l';1;7;B;;750;423;327;1;6;416;422
8;Barcelona;13;Barcelonès;08101;Hospitalet de Llobregat, l';1;8;U;;1044;709;335;0;5;704;709
8;Barcelona;13;Barcelonès;08101;Hospitalet de Llobregat, l';1;9;U;;869;594;275;5;6;583;589
8;Barcelona;13;Barcelonès;08101;Hospitalet de Llobregat, l';2;1;U;;496;314;182;1;1;312;313
8;Barcelona;13;Barcelonès;08101;Hospitalet de Llobregat, l';2;10;U;;756;500;256;0;6;494;500
8;Barcelona;13;Barcelonès;08101;Hospitalet de Llobregat, l';2;11;U;;816;458;358;0;4;454;458
8;Barcelona;13;Barcelonès;08101;Hospitalet de Llobregat, l';2;12;U;;968;490;478;0;6;484;490
8;Barcelona;13;Barcelonès;08101;Hospitalet de Llobregat, l';2;13;U;;676;403;273;0;3;400;403
8;Barcelona;13;Barcelonès;08101;Hospitalet de Llobregat, l';2;14;U;;456;265;191;0;7;258;265
8;Barcelona;13;Barcelonès;08101;Hospitalet de Llobregat, l';2;15;U;;655;391;264;1;1;389;390
8;Barcelona;13;Barcelonès;08101;Hospitalet de Llobregat, l';2;16;U;;954;551;403;2;6;543;549
8;Barcelona;13;Barcelonès;08101;Hospitalet de Llobregat, l';2;17;U;;430;213;217;0;0;213;213
8;Barcelona;13;Barcelonès;08101;Hospitalet de Llobregat, l';2;18;U;;521;283;238;0;1;282;283
8;Barcelona;13;Barcelonès;08101;Hospitalet de Llobregat, l';2;19;U;;832;513;319;3;4;506;510
8;Barcelona;13;Barcelonès;08101;Hospitalet de Llobregat, l';2;2;U;;551;330;221;1;1;328;329
8;Barcelona;13;Barcelonès;08101;Hospitalet de Llobregat, l';2;20;U;;583;348;235;0;1;347;348
8;Barcelona;13;Barcelonès;08101;Hospitalet de Llobregat, l';2;21;U;;796;420;376;2;1;417;418
8;Barcelona;13;Barcelonès;08101;Hospitalet de Llobregat, l';2;22;U;;580;303;277;4;2;297;299
8;Barcelona;13;Barcelonès;08101;Hospitalet de Llobregat, l';2;23;U;;798;469;329;2;3;464;467
8;Barcelona;13;Barcelonès;08101;Hospitalet de Llobregat, l';2;24;U;;425;242;183;0;3;239;242
8;Barcelona;13;Barcelonès;08101;Hospitalet de Llobregat, l';2;25;U;;381;220;161;3;5;212;217
8;Barcelona;13;Barcelonès;08101;Hospitalet de Llobregat, l';2;26;U;;812;484;328;6;1;477;478
8;Barcelona;13;Barcelonès;08101;Hospitalet de Llobregat, l';2;27;U;;478;329;149;1;0;328;328
8;Barcelona;13;Barcelonès;08101;Hospitalet de Llobregat, l';2;28;U;;473;247;226;0;3;244;247
8;Barcelona;13;Barcelonès;08101;Hospitalet de Llobregat, l';2;29;U;;481;281;200;6;0;275;275
8;Barcelona;13;Barcelonès;08101;Hospitalet de Llobregat, l';2;3;U;;543;308;235;1;3;304;307
8;Barcelona;13;Barcelonès;08101;Hospitalet de Llobregat, l';2;30;U;;541;267;274;6;1;260;261
8;Barcelona;13;Barcelonès;08101;Hospitalet de Llobregat, l';2;31;U;;739;427;312;0;1;426;427
8;Barcelona;13;Barcelonès;08101;Hospitalet de Llobregat, l';2;32;U;;744;482;262;1;2;479;481
8;Barcelona;13;Barcelonès;08101;Hospitalet de Llobregat, l';2;33;U;;559;329;230;0;2;327;329
8;Barcelona;13;Barcelonès;08101;Hospitalet de Llobregat, l';2;34;U;;643;368;275;2;1;365;366
8;Barcelona;13;Barcelonès;08101;Hospitalet de Llobregat, l';2;35;A;;413;208;205;0;0;208;208
8;Barcelona;13;Barcelonès;08101;Hospitalet de Llobregat, l';2;35;B;;475;275;200;2;0;273;273
8;Barcelona;13;Barcelonès;08101;Hospitalet de Llobregat, l';2;36;U;;757;464;293;0;7;457;464
8;Barcelona;13;Barcelonès;08101;Hospitalet de Llobregat, l';2;37;U;;912;511;401;5;0;506;506
8;Barcelona;13;Barcelonès;08101;Hospitalet de Llobregat, l';2;38;U;;608;381;227;1;7;373;380
8;Barcelona;13;Barcelonès;08101;Hospitalet de Llobregat, l';2;39;U;;849;537;312;1;6;530;536
8;Barcelona;13;Barcelonès;08101;Hospitalet de Llobregat, l';2;4;U;;367;222;145;0;1;221;222
8;Barcelona;13;Barcelonès;08101;Hospitalet de Llobregat, l';2;40;U;;510;324;186;0;2;322;324
8;Barcelona;13;Barcelonès;08101;Hospitalet de Llobregat, l';2;41;U;;535;336;199;0;4;332;336
8;Barcelona;13;Barcelonès;08101;Hospitalet de Llobregat, l';2;42;U;;791;481;310;0;4;477;481
8;Barcelona;13;Barcelonès;08101;Hospitalet de Llobregat, l';2;43;A;;497;311;186;0;6;305;311
8;Barcelona;13;Barcelonès;08101;Hospitalet de Llobregat, l';2;43;B;;584;336;248;0;6;330;336
8;Barcelona;13;Barcelonès;08101;Hospitalet de Llobregat, l';2;44;U;;489;307;182;0;3;304;307
8;Barcelona;13;Barcelonès;08101;Hospitalet de Llobregat, l';2;45;U;;722;425;297;1;5;419;424
8;Barcelona;13;Barcelonès;08101;Hospitalet de Llobregat, l';2;46;U;;722;428;294;3;3;422;425
8;Barcelona;13;Barcelonès;08101;Hospitalet de Llobregat, l';2;47;U;;845;475;370;0;11;464;475
8;Barcelona;13;Barcelonès;08101;Hospitalet de Llobregat, l';2;48;U;;824;475;349;0;4;471;475
8;Barcelona;13;Barcelonès;08101;Hospitalet de Llobregat, l';2;49;U;;734;422;312;0;4;418;422
8;Barcelona;13;Barcelonès;08101;Hospitalet de Llobregat, l';2;5;U;;675;450;225;0;2;448;450
8;Barcelona;13;Barcelonès;08101;Hospitalet de Llobregat, l';2;6;U;;631;385;246;1;2;382;384
8;Barcelona;13;Barcelonès;08101;Hospitalet de Llobregat, l';2;7;U;;518;332;186;0;8;324;332
8;Barcelona;13;Barcelonès;08101;Hospitalet de Llobregat, l';2;8;A;;697;441;256;2;2;437;439
8;Barcelona;13;Barcelonès;08101;Hospitalet de Llobregat, l';2;8;B;;765;501;264;0;3;498;501
8;Barcelona;13;Barcelonès;08101;Hospitalet de Llobregat, l';2;9;U;;730;467;263;1;1;465;466
8;Barcelona;13;Barcelonès;08101;Hospitalet de Llobregat, l';3;1;A;;714;403;311;0;8;395;403
8;Barcelona;13;Barcelonès;08101;Hospitalet de Llobregat, l';3;1;B;;860;501;359;0;8;493;501
8;Barcelona;13;Barcelonès;08101;Hospitalet de Llobregat, l';3;10;U;;719;406;313;0;4;402;406
8;Barcelona;13;Barcelonès;08101;Hospitalet de Llobregat, l';3;11;U;;1024;598;426;0;9;589;598
8;Barcelona;13;Barcelonès;08101;Hospitalet de Llobregat, l';3;12;A;;550;342;208;1;2;339;341
8;Barcelona;13;Barcelonès;08101;Hospitalet de Llobregat, l';3;12;B;;560;347;213;1;3;343;346
8;Barcelona;13;Barcelonès;08101;Hospitalet de Llobregat, l';3;13;A;;704;427;277;0;10;417;427
8;Barcelona;13;Barcelonès;08101;Hospitalet de Llobregat, l';3;13;B;;781;456;325;1;2;453;455
8;Barcelona;13;Barcelonès;08101;Hospitalet de Llobregat, l';3;14;A;;795;501;294;0;6;495;501
8;Barcelona;13;Barcelonès;08101;Hospitalet de Llobregat, l';3;14;B;;1003;594;409;1;6;587;593
8;Barcelona;13;Barcelonès;08101;Hospitalet de Llobregat, l';3;15;U;;1152;640;512;0;6;634;640
8;Barcelona;13;Barcelonès;08101;Hospitalet de Llobregat, l';3;16;A;;873;604;269;1;11;592;603
8;Barcelona;13;Barcelonès;08101;Hospitalet de Llobregat, l';3;16;B;;1014;684;330;1;3;680;683
8;Barcelona;13;Barcelonès;08101;Hospitalet de Llobregat, l';3;17;U;;624;313;311;1;5;307;312
8;Barcelona;13;Barcelonès;08101;Hospitalet de Llobregat, l';3;18;U;;668;448;220;0;3;445;448
8;Barcelona;13;Barcelonès;08101;Hospitalet de Llobregat, l';3;19;U;;944;579;365;3;4;572;576
8;Barcelona;13;Barcelonès;08101;Hospitalet de Llobregat, l';3;2;U;;1178;655;523;1;6;648;654
8;Barcelona;13;Barcelonès;08101;Hospitalet de Llobregat, l';3;20;U;;734;443;291;1;4;438;442
8;Barcelona;13;Barcelonès;08101;Hospitalet de Llobregat, l';3;21;A;;932;634;298;1;5;628;633
8;Barcelona;13;Barcelonès;08101;Hospitalet de Llobregat, l';3;21;B;;994;702;292;1;4;697;701
8;Barcelona;13;Barcelonès;08101;Hospitalet de Llobregat, l';3;22;U;;895;524;371;0;8;516;524
8;Barcelona;13;Barcelonès;08101;Hospitalet de Llobregat, l';3;23;A;;1105;619;486;1;7;611;618
8;Barcelona;13;Barcelonès;08101;Hospitalet de Llobregat, l';3;23;B;;1317;748;569;1;4;743;747
8;Barcelona;13;Barcelonès;08101;Hospitalet de Llobregat, l';3;24;U;;609;338;271;3;0;335;335
8;Barcelona;13;Barcelonès;08101;Hospitalet de Llobregat, l';3;25;A;;737;506;231;0;0;506;506
8;Barcelona;13;Barcelonès;08101;Hospitalet de Llobregat, l';3;25;B;;832;597;235;0;1;596;597
8;Barcelona;13;Barcelonès;08101;Hospitalet de Llobregat, l';3;3;A;;629;382;247;0;6;376;382
8;Barcelona;13;Barcelonès;08101;Hospitalet de Llobregat, l';3;3;B;;695;420;275;0;6;414;420
8;Barcelona;13;Barcelonès;08101;Hospitalet de Llobregat, l';3;4;U;;986;583;403;0;6;577;583
8;Barcelona;13;Barcelonès;08101;Hospitalet de Llobregat, l';3;5;U;;1184;818;366;0;5;813;818
8;Barcelona;13;Barcelonès;08101;Hospitalet de Llobregat, l';3;6;U;;1173;785;388;0;12;773;785
8;Barcelona;13;Barcelonès;08101;Hospitalet de Llobregat, l';3;7;A;;601;412;189;0;5;407;412
8;Barcelona;13;Barcelonès;08101;Hospitalet de Llobregat, l';3;7;B;;649;453;196;0;5;448;453
8;Barcelona;13;Barcelonès;08101;Hospitalet de Llobregat, l';3;8;U;;1534;1029;505;1;14;1014;1028
8;Barcelona;13;Barcelonès;08101;Hospitalet de Llobregat, l';3;9;U;;542;322;220;0;0;322;322
8;Barcelona;13;Barcelonès;08101;Hospitalet de Llobregat, l';4;1;U;;880;578;302;0;4;574;578
8;Barcelona;13;Barcelonès;08101;Hospitalet de Llobregat, l';4;10;A;;624;370;254;0;2;368;370
8;Barcelona;13;Barcelonès;08101;Hospitalet de Llobregat, l';4;10;B;;738;412;326;2;1;409;410
8;Barcelona;13;Barcelonès;08101;Hospitalet de Llobregat, l';4;11;U;;856;494;362;1;4;489;493
8;Barcelona;13;Barcelonès;08101;Hospitalet de Llobregat, l';4;12;A;;582;364;218;1;4;359;363
8;Barcelona;13;Barcelonès;08101;Hospitalet de Llobregat, l';4;12;B;;723;411;312;1;3;407;410
8;Barcelona;13;Barcelonès;08101;Hospitalet de Llobregat, l';4;13;U;;397;226;171;6;0;220;220
8;Barcelona;13;Barcelonès;08101;Hospitalet de Llobregat, l';4;14;U;;670;412;258;0;4;408;412
8;Barcelona;13;Barcelonès;08101;Hospitalet de Llobregat, l';4;15;U;;490;241;249;2;1;238;239
8;Barcelona;13;Barcelonès;08101;Hospitalet de Llobregat, l';4;16;U;;512;319;193;0;3;316;319
8;Barcelona;13;Barcelonès;08101;Hospitalet de Llobregat, l';4;17;U;;444;237;207;0;1;236;237
8;Barcelona;13;Barcelonès;08101;Hospitalet de Llobregat, l';4;18;U;;847;482;365;1;6;475;481
8;Barcelona;13;Barcelonès;08101;Hospitalet de Llobregat, l';4;19;U;;577;281;296;6;1;274;275
8;Barcelona;13;Barcelonès;08101;Hospitalet de Llobregat, l';4;2;U;;614;327;287;0;2;325;327
8;Barcelona;13;Barcelonès;08101;Hospitalet de Llobregat, l';4;20;U;;885;475;410;1;4;470;474
8;Barcelona;13;Barcelonès;08101;Hospitalet de Llobregat, l';4;21;U;;853;471;382;0;3;468;471
8;Barcelona;13;Barcelonès;08101;Hospitalet de Llobregat, l';4;22;U;;753;354;399;0;1;353;354
8;Barcelona;13;Barcelonès;08101;Hospitalet de Llobregat, l';4;23;U;;726;447;279;0;9;438;447
8;Barcelona;13;Barcelonès;08101;Hospitalet de Llobregat, l';4;24;U;;420;231;189;0;0;231;231
8;Barcelona;13;Barcelonès;08101;Hospitalet de Llobregat, l';4;25;U;;696;405;291;0;8;397;405
8;Barcelona;13;Barcelonès;08101;Hospitalet de Llobregat, l';4;26;U;;662;359;303;1;4;354;358
8;Barcelona;13;Barcelonès;08101;Hospitalet de Llobregat, l';4;27;U;;597;320;277;0;3;317;320
8;Barcelona;13;Barcelonès;08101;Hospitalet de Llobregat, l';4;28;U;;368;185;183;0;2;183;185
8;Barcelona;13;Barcelonès;08101;Hospitalet de Llobregat, l';4;29;U;;479;258;221;1;2;255;257
8;Barcelona;13;Barcelonès;08101;Hospitalet de Llobregat, l';4;3;U;;912;578;334;3;5;570;575
8;Barcelona;13;Barcelonès;08101;Hospitalet de Llobregat, l';4;30;U;;652;334;318;2;3;329;332
8;Barcelona;13;Barcelonès;08101;Hospitalet de Llobregat, l';4;31;A;;459;255;204;1;5;249;254
8;Barcelona;13;Barcelonès;08101;Hospitalet de Llobregat, l';4;31;B;;528;303;225;0;0;303;303
8;Barcelona;13;Barcelonès;08101;Hospitalet de Llobregat, l';4;32;U;;966;599;367;5;0;594;594
8;Barcelona;13;Barcelonès;08101;Hospitalet de Llobregat, l';4;33;U;;673;326;347;1;4;321;325
8;Barcelona;13;Barcelonès;08101;Hospitalet de Llobregat, l';4;34;U;;442;233;209;3;1;229;230
8;Barcelona;13;Barcelonès;08101;Hospitalet de Llobregat, l';4;35;U;;719;357;362;0;1;356;357
8;Barcelona;13;Barcelonès;08101;Hospitalet de Llobregat, l';4;36;U;;499;269;230;0;3;266;269
8;Barcelona;13;Barcelonès;08101;Hospitalet de Llobregat, l';4;37;U;;595;330;265;0;3;327;330
8;Barcelona;13;Barcelonès;08101;Hospitalet de Llobregat, l';4;38;U;;615;333;282;0;4;329;333
8;Barcelona;13;Barcelonès;08101;Hospitalet de Llobregat, l';4;39;U;;641;338;303;2;7;329;336
8;Barcelona;13;Barcelonès;08101;Hospitalet de Llobregat, l';4;4;U;;934;528;406;1;3;524;527
8;Barcelona;13;Barcelonès;08101;Hospitalet de Llobregat, l';4;40;U;;859;488;371;5;1;482;483
8;Barcelona;13;Barcelonès;08101;Hospitalet de Llobregat, l';4;41;A;;742;445;297;2;2;441;443
8;Barcelona;13;Barcelonès;08101;Hospitalet de Llobregat, l';4;41;B;;841;513;328;1;8;504;512
8;Barcelona;13;Barcelonès;08101;Hospitalet de Llobregat, l';4;42;U;;432;243;189;0;5;238;243
8;Barcelona;13;Barcelonès;08101;Hospitalet de Llobregat, l';4;5;U;;656;378;278;3;2;373;375
8;Barcelona;13;Barcelonès;08101;Hospitalet de Llobregat, l';4;6;U;;982;560;422;2;2;556;558
8;Barcelona;13;Barcelonès;08101;Hospitalet de Llobregat, l';4;7;U;;735;421;314;3;2;416;418
8;Barcelona;13;Barcelonès;08101;Hospitalet de Llobregat, l';4;8;U;;621;338;283;0;1;337;338
8;Barcelona;13;Barcelonès;08101;Hospitalet de Llobregat, l';4;9;U;;529;311;218;0;2;309;311
8;Barcelona;13;Barcelonès;08101;Hospitalet de Llobregat, l';5;1;U;;987;568;419;0;6;562;568
8;Barcelona;13;Barcelonès;08101;Hospitalet de Llobregat, l';5;10;U;;751;428;323;1;5;422;427
8;Barcelona;13;Barcelonès;08101;Hospitalet de Llobregat, l';5;11;U;;496;244;252;0;2;242;244
8;Barcelona;13;Barcelonès;08101;Hospitalet de Llobregat, l';5;12;U;;613;348;265;3;8;337;345
8;Barcelona;13;Barcelonès;08101;Hospitalet de Llobregat, l';5;13;U;;538;287;251;0;1;286;287
8;Barcelona;13;Barcelonès;08101;Hospitalet de Llobregat, l';5;14;U;;502;295;207;1;2;292;294
8;Barcelona;13;Barcelonès;08101;Hospitalet de Llobregat, l';5;15;U;;359;204;155;0;2;202;204
8;Barcelona;13;Barcelonès;08101;Hospitalet de Llobregat, l';5;16;U;;447;222;225;0;1;221;222
8;Barcelona;13;Barcelonès;08101;Hospitalet de Llobregat, l';5;17;U;;825;433;392;1;1;431;432
8;Barcelona;13;Barcelonès;08101;Hospitalet de Llobregat, l';5;18;U;;808;480;328;0;7;473;480
8;Barcelona;13;Barcelonès;08101;Hospitalet de Llobregat, l';5;19;U;;414;205;209;0;0;205;205
8;Barcelona;13;Barcelonès;08101;Hospitalet de Llobregat, l';5;2;A;;541;314;227;0;2;312;314
8;Barcelona;13;Barcelonès;08101;Hospitalet de Llobregat, l';5;2;B;;617;368;249;0;2;366;368
8;Barcelona;13;Barcelonès;08101;Hospitalet de Llobregat, l';5;20;U;;697;399;298;0;5;394;399
8;Barcelona;13;Barcelonès;08101;Hospitalet de Llobregat, l';5;21;U;;983;614;369;1;6;607;613
8;Barcelona;13;Barcelonès;08101;Hospitalet de Llobregat, l';5;22;U;;505;247;258;0;0;247;247
8;Barcelona;13;Barcelonès;08101;Hospitalet de Llobregat, l';5;23;U;;1040;600;440;3;1;596;597
8;Barcelona;13;Barcelonès;08101;Hospitalet de Llobregat, l';5;24;U;;848;430;418;3;4;423;427
8;Barcelona;13;Barcelonès;08101;Hospitalet de Llobregat, l';5;25;U;;631;360;271;0;2;358;360
8;Barcelona;13;Barcelonès;08101;Hospitalet de Llobregat, l';5;26;U;;470;260;210;1;0;259;259
8;Barcelona;13;Barcelonès;08101;Hospitalet de Llobregat, l';5;27;U;;684;333;351;1;0;332;332
8;Barcelona;13;Barcelonès;08101;Hospitalet de Llobregat, l';5;28;U;;821;495;326;4;3;488;491
8;Barcelona;13;Barcelonès;08101;Hospitalet de Llobregat, l';5;29;U;;839;488;351;1;3;484;487
8;Barcelona;13;Barcelonès;08101;Hospitalet de Llobregat, l';5;3;U;;721;443;278;1;2;440;442
8;Barcelona;13;Barcelonès;08101;Hospitalet de Llobregat, l';5;30;U;;992;578;414;0;8;570;578
8;Barcelona;13;Barcelonès;08101;Hospitalet de Llobregat, l';5;31;U;;651;346;305;0;4;342;346
8;Barcelona;13;Barcelonès;08101;Hospitalet de Llobregat, l';5;32;U;;1004;586;418;1;9;576;585
8;Barcelona;13;Barcelonès;08101;Hospitalet de Llobregat, l';5;33;U;;623;352;271;0;2;350;352
8;Barcelona;13;Barcelonès;08101;Hospitalet de Llobregat, l';5;34;U;;712;410;302;1;6;403;409
8;Barcelona;13;Barcelonès;08101;Hospitalet de Llobregat, l';5;35;U;;922;545;377;4;6;535;541
8;Barcelona;13;Barcelonès;08101;Hospitalet de Llobregat, l';5;36;U;;688;464;224;2;2;460;462
8;Barcelona;13;Barcelonès;08101;Hospitalet de Llobregat, l';5;37;U;;920;545;375;1;2;542;544
8;Barcelona;13;Barcelonès;08101;Hospitalet de Llobregat, l';5;38;U;;906;519;387;2;0;517;517
8;Barcelona;13;Barcelonès;08101;Hospitalet de Llobregat, l';5;4;U;;974;549;425;4;3;542;545
8;Barcelona;13;Barcelonès;08101;Hospitalet de Llobregat, l';5;5;A;;517;314;203;1;3;310;313
8;Barcelona;13;Barcelonès;08101;Hospitalet de Llobregat, l';5;5;B;;634;405;229;0;6;399;405
8;Barcelona;13;Barcelonès;08101;Hospitalet de Llobregat, l';5;6;A;;791;488;303;0;3;485;488
8;Barcelona;13;Barcelonès;08101;Hospitalet de Llobregat, l';5;6;B;;799;449;350;0;8;441;449
8;Barcelona;13;Barcelonès;08101;Hospitalet de Llobregat, l';5;7;U;;675;428;247;2;4;422;426
8;Barcelona;13;Barcelonès;08101;Hospitalet de Llobregat, l';5;8;U;;450;261;189;0;1;260;261
8;Barcelona;13;Barcelonès;08101;Hospitalet de Llobregat, l';5;9;U;;536;288;248;2;0;286;286
8;Barcelona;13;Barcelonès;08101;Hospitalet de Llobregat, l';6;1;U;;1143;674;469;1;5;668;673
8;Barcelona;13;Barcelonès;08101;Hospitalet de Llobregat, l';6;10;A;;512;308;204;1;3;304;307
8;Barcelona;13;Barcelonès;08101;Hospitalet de Llobregat, l';6;10;B;;532;351;181;2;2;347;349
8;Barcelona;13;Barcelonès;08101;Hospitalet de Llobregat, l';6;11;A;;641;361;280;0;0;361;361
8;Barcelona;13;Barcelonès;08101;Hospitalet de Llobregat, l';6;11;B;;669;364;305;2;3;359;362
8;Barcelona;13;Barcelonès;08101;Hospitalet de Llobregat, l';6;12;U;;893;521;372;1;7;513;520
8;Barcelona;13;Barcelonès;08101;Hospitalet de Llobregat, l';6;13;A;;484;288;196;0;3;285;288
8;Barcelona;13;Barcelonès;08101;Hospitalet de Llobregat, l';6;13;B;;546;342;204;0;2;340;342
8;Barcelona;13;Barcelonès;08101;Hospitalet de Llobregat, l';6;14;U;;784;471;313;2;9;460;469
8;Barcelona;13;Barcelonès;08101;Hospitalet de Llobregat, l';6;15;U;;749;494;255;2;1;491;492
8;Barcelona;13;Barcelonès;08101;Hospitalet de Llobregat, l';6;16;A;;935;432;503;0;4;428;432
8;Barcelona;13;Barcelonès;08101;Hospitalet de Llobregat, l';6;16;B;;1028;449;579;0;2;447;449
8;Barcelona;13;Barcelonès;08101;Hospitalet de Llobregat, l';6;17;U;;850;477;373;0;5;472;477
8;Barcelona;13;Barcelonès;08101;Hospitalet de Llobregat, l';6;18;U;;477;322;155;0;3;319;322
8;Barcelona;13;Barcelonès;08101;Hospitalet de Llobregat, l';6;19;U;;1157;716;441;0;9;707;716
8;Barcelona;13;Barcelonès;08101;Hospitalet de Llobregat, l';6;2;U;;479;280;199;1;3;276;279
8;Barcelona;13;Barcelonès;08101;Hospitalet de Llobregat, l';6;20;U;;500;345;155;2;4;339;343
8;Barcelona;13;Barcelonès;08101;Hospitalet de Llobregat, l';6;21;A;;645;391;254;2;5;384;389
8;Barcelona;13;Barcelonès;08101;Hospitalet de Llobregat, l';6;21;B;;687;429;258;2;5;422;427
8;Barcelona;13;Barcelonès;08101;Hospitalet de Llobregat, l';6;22;U;;725;362;363;0;6;356;362
8;Barcelona;13;Barcelonès;08101;Hospitalet de Llobregat, l';6;23;A;;605;379;226;0;8;371;379
8;Barcelona;13;Barcelonès;08101;Hospitalet de Llobregat, l';6;23;B;;689;442;247;0;6;436;442
8;Barcelona;13;Barcelonès;08101;Hospitalet de Llobregat, l';6;24;U;;966;549;417;1;9;539;548
8;Barcelona;13;Barcelonès;08101;Hospitalet de Llobregat, l';6;25;U;;1119;720;399;1;5;714;719
8;Barcelona;13;Barcelonès;08101;Hospitalet de Llobregat, l';6;26;U;;827;470;357;0;7;463;470
8;Barcelona;13;Barcelonès;08101;Hospitalet de Llobregat, l';6;27;U;;934;571;363;0;8;563;571
8;Barcelona;13;Barcelonès;08101;Hospitalet de Llobregat, l';6;28;U;;869;499;370;3;0;496;496
8;Barcelona;13;Barcelonès;08101;Hospitalet de Llobregat, l';6;29;U;;493;269;224;0;1;268;269
8;Barcelona;13;Barcelonès;08101;Hospitalet de Llobregat, l';6;3;U;;498;275;223;0;3;272;275
8;Barcelona;13;Barcelonès;08101;Hospitalet de Llobregat, l';6;30;U;;781;490;291;3;13;474;487
8;Barcelona;13;Barcelonès;08101;Hospitalet de Llobregat, l';6;31;U;;931;559;372;1;8;550;558
8;Barcelona;13;Barcelonès;08101;Hospitalet de Llobregat, l';6;32;U;;809;359;450;0;1;358;359
8;Barcelona;13;Barcelonès;08101;Hospitalet de Llobregat, l';6;4;U;;577;338;239;5;4;329;333
8;Barcelona;13;Barcelonès;08101;Hospitalet de Llobregat, l';6;5;U;;588;366;222;1;5;360;365
8;Barcelona;13;Barcelonès;08101;Hospitalet de Llobregat, l';6;6;U;;799;441;358;2;6;433;439
8;Barcelona;13;Barcelonès;08101;Hospitalet de Llobregat, l';6;7;U;;847;484;363;2;4;478;482
8;Barcelona;13;Barcelonès;08101;Hospitalet de Llobregat, l';6;8;U;;757;385;372;0;2;383;385
8;Barcelona;13;Barcelonès;08101;Hospitalet de Llobregat, l';6;9;U;;726;429;297;2;6;421;427
8;Barcelona;6;Anoia;08162;Hostalets de Pierola, els;1;1;A;;452;334;118;1;3;330;333
8;Barcelona;6;Anoia;08162;Hostalets de Pierola, els;1;1;B;;516;368;148;0;3;365;368
8;Barcelona;6;Anoia;08162;Hostalets de Pierola, els;1;1;C;;323;183;140;0;0;183;183
17;Girona;34;Selva;17083;Hostalric;1;1;A;;388;263;125;0;0;263;263
17;Girona;34;Selva;17083;Hostalric;1;1;B;;443;307;136;1;4;302;306
17;Girona;34;Selva;17083;Hostalric;1;2;A;;487;331;156;3;3;325;328
17;Girona;34;Selva;17083;Hostalric;1;2;B;;582;327;255;3;4;320;324
17;Girona;34;Selva;17083;Hostalric;1;2;C;;588;367;221;4;0;363;363
8;Barcelona;6;Anoia;08102;Igualada;1;1;A;;555;346;209;1;2;343;345
8;Barcelona;6;Anoia;08102;Igualada;1;1;B;;765;456;309;0;3;453;456
8;Barcelona;6;Anoia;08102;Igualada;2;1;U;;496;341;155;1;2;338;340
8;Barcelona;6;Anoia;08102;Igualada;2;2;U;;886;589;297;7;4;578;582
8;Barcelona;6;Anoia;08102;Igualada;2;3;A;;650;444;206;1;6;437;443
8;Barcelona;6;Anoia;08102;Igualada;2;3;B;;750;527;223;1;5;521;526
8;Barcelona;6;Anoia;08102;Igualada;3;1;U;;938;598;340;5;6;587;593
8;Barcelona;6;Anoia;08102;Igualada;3;2;U;;1081;675;406;2;5;668;673
8;Barcelona;6;Anoia;08102;Igualada;3;3;A;;538;384;154;0;0;384;384
8;Barcelona;6;Anoia;08102;Igualada;3;3;B;;609;426;183;3;4;419;423
8;Barcelona;6;Anoia;08102;Igualada;3;4;A;;698;455;243;1;4;450;454
8;Barcelona;6;Anoia;08102;Igualada;3;4;B;;878;603;275;5;6;592;598
8;Barcelona;6;Anoia;08102;Igualada;3;5;A;;414;261;153;0;3;258;261
8;Barcelona;6;Anoia;08102;Igualada;3;5;B;;497;332;165;0;0;332;332
8;Barcelona;6;Anoia;08102;Igualada;3;6;A;;1052;750;302;2;9;739;748
8;Barcelona;6;Anoia;08102;Igualada;3;6;B;;1136;825;311;2;13;810;823
8;Barcelona;6;Anoia;08102;Igualada;3;7;A;;644;477;167;1;5;471;476
8;Barcelona;6;Anoia;08102;Igualada;3;7;B;;757;553;204;1;3;549;552
8;Barcelona;6;Anoia;08102;Igualada;3;8;A;;764;498;266;0;4;494;498
8;Barcelona;6;Anoia;08102;Igualada;3;8;B;;826;560;266;0;4;556;560
8;Barcelona;6;Anoia;08102;Igualada;4;1;U;;703;434;269;1;2;431;433
8;Barcelona;6;Anoia;08102;Igualada;4;2;U;;621;425;196;0;2;423;425
8;Barcelona;6;Anoia;08102;Igualada;4;3;U;;774;520;254;0;6;514;520
8;Barcelona;6;Anoia;08102;Igualada;4;4;A;;434;295;139;6;2;287;289
8;Barcelona;6;Anoia;08102;Igualada;4;4;B;;490;342;148;2;0;340;340
8;Barcelona;6;Anoia;08102;Igualada;4;5;A;;584;404;180;0;4;400;404
8;Barcelona;6;Anoia;08102;Igualada;4;5;B;;780;519;261;1;2;516;518
8;Barcelona;6;Anoia;08102;Igualada;5;1;A;;477;307;170;0;3;304;307
8;Barcelona;6;Anoia;08102;Igualada;5;1;B;;543;372;171;2;5;365;370
8;Barcelona;6;Anoia;08102;Igualada;5;2;A;;528;347;181;0;0;347;347
8;Barcelona;6;Anoia;08102;Igualada;5;2;B;;726;484;242;0;5;479;484
8;Barcelona;6;Anoia;08102;Igualada;5;3;A;;730;506;224;1;0;505;505
8;Barcelona;6;Anoia;08102;Igualada;5;3;B;;970;680;290;2;6;672;678
8;Barcelona;6;Anoia;08102;Igualada;5;4;A;;556;398;158;1;9;388;397
8;Barcelona;6;Anoia;08102;Igualada;5;4;B;;705;484;221;1;8;475;483
8;Barcelona;6;Anoia;08102;Igualada;5;5;U;;594;336;258;2;2;332;334
8;Barcelona;6;Anoia;08102;Igualada;5;6;A;;417;258;159;1;2;255;257
8;Barcelona;6;Anoia;08102;Igualada;5;6;B;;428;261;167;1;1;259;260
8;Barcelona;6;Anoia;08102;Igualada;5;7;A;;695;500;195;2;2;496;498
8;Barcelona;6;Anoia;08102;Igualada;5;7;B;;824;563;261;1;9;553;562
25;Lleida;25;Pallars Jussà;25115;Isona i Conca Dellà;1;1;A;;661;460;201;0;1;459;460
25;Lleida;25;Pallars Jussà;25115;Isona i Conca Dellà;1;1;B;;342;201;141;0;1;200;201
17;Girona;15;Cerdanya;17084;Isòvol;1;1;U;;187;136;51;1;2;133;135
25;Lleida;27;Pla d'Urgell;25113;Ivars d'Urgell;1;1;U;;656;507;149;6;7;494;501
25;Lleida;27;Pla d'Urgell;25113;Ivars d'Urgell;1;2;A;;499;384;115;3;0;381;381
25;Lleida;27;Pla d'Urgell;25113;Ivars d'Urgell;1;2;B;;232;199;33;0;1;198;199
25;Lleida;23;Noguera;25112;Ivars de Noguera;1;1;U;;313;257;56;0;5;252;257
25;Lleida;32;Segarra;25114;Ivorra;1;1;U;;130;109;21;0;2;107;109
17;Girona;10;Baix Empordà;17085;Jafre;1;1;U;;291;231;60;1;2;228;230
17;Girona;2;Alt Empordà;17086;Jonquera, la;1;1;A;;320;219;101;0;3;216;219
17;Girona;2;Alt Empordà;17086;Jonquera, la;1;1;B;;344;208;136;1;1;206;207
17;Girona;2;Alt Empordà;17086;Jonquera, la;1;1;C;;293;175;118;1;1;173;174
17;Girona;2;Alt Empordà;17086;Jonquera, la;1;1;D;;317;184;133;0;2;182;184
17;Girona;2;Alt Empordà;17086;Jonquera, la;1;2;A;;313;204;109;1;1;202;203
17;Girona;2;Alt Empordà;17086;Jonquera, la;1;2;B;;315;199;116;0;3;196;199
8;Barcelona;6;Anoia;08103;Jorba;1;1;U;;474;347;127;0;7;340;347
25;Lleida;4;Alt Urgell;25910;Josa i Tuixén;1;1;U;;166;117;49;0;1;116;117
17;Girona;20;Gironès;17087;Juià;1;1;U;;229;193;36;0;0;193;193
25;Lleida;18;Garrigues;25118;Juncosa;1;1;U;;448;323;125;2;2;319;321
25;Lleida;18;Garrigues;25119;Juneda;1;1;A;;734;550;184;3;5;542;547
25;Lleida;18;Garrigues;25119;Juneda;1;1;B;;716;527;189;7;6;514;520
25;Lleida;18;Garrigues;25119;Juneda;1;2;A;;455;371;84;1;2;368;370
25;Lleida;18;Garrigues;25119;Juneda;1;2;B;;473;383;90;2;2;379;381
25;Lleida;39;Consell General d'Aran;25121;Les;1;1;U;;572;398;174;0;6;392;398
25;Lleida;27;Pla d'Urgell;25122;Linyola;1;1;A;;431;341;90;1;4;336;340
25;Lleida;27;Pla d'Urgell;25122;Linyola;1;1;B;;529;393;136;4;4;385;389
25;Lleida;27;Pla d'Urgell;25122;Linyola;1;2;A;;404;307;97;3;5;299;304
25;Lleida;27;Pla d'Urgell;25122;Linyola;1;2;B;;605;483;122;1;5;477;482
8;Barcelona;6;Anoia;08104;Llacuna, la;1;1;U;;715;514;201;1;2;511;513
17;Girona;2;Alt Empordà;17088;Lladó;1;1;U;;458;326;132;3;7;316;323
25;Lleida;26;Pallars Sobirà;25123;Lladorre;1;1;U;;210;149;61;1;1;147;148
25;Lleida;35;Solsonès;25124;Lladurs;1;1;U;;189;128;61;1;0;127;127
8;Barcelona;41;Vallès Oriental;08105;Llagosta, la;1;1;A;;504;270;234;1;4;265;269
8;Barcelona;41;Vallès Oriental;08105;Llagosta, la;1;1;B;;675;371;304;1;2;368;370
8;Barcelona;41;Vallès Oriental;08105;Llagosta, la;1;2;A;;721;424;297;1;3;420;423
8;Barcelona;41;Vallès Oriental;08105;Llagosta, la;1;2;B;;910;519;391;2;7;510;517
8;Barcelona;41;Vallès Oriental;08105;Llagosta, la;1;3;A;;823;478;345;0;1;477;478
8;Barcelona;41;Vallès Oriental;08105;Llagosta, la;1;3;B;;1084;591;493;0;2;589;591
8;Barcelona;41;Vallès Oriental;08105;Llagosta, la;1;4;A;;546;342;204;2;0;340;340
8;Barcelona;41;Vallès Oriental;08105;Llagosta, la;1;4;B;;646;402;244;1;0;401;401
8;Barcelona;41;Vallès Oriental;08105;Llagosta, la;1;5;A;;796;430;366;4;8;418;426
8;Barcelona;41;Vallès Oriental;08105;Llagosta, la;1;5;B;;866;440;426;2;7;431;438
8;Barcelona;41;Vallès Oriental;08105;Llagosta, la;1;6;A;;493;245;248;2;4;239;243
8;Barcelona;41;Vallès Oriental;08105;Llagosta, la;1;6;B;;611;297;314;1;3;293;296
8;Barcelona;41;Vallès Oriental;08105;Llagosta, la;1;7;A;;588;341;247;2;5;334;339
8;Barcelona;41;Vallès Oriental;08105;Llagosta, la;1;7;B;;714;366;348;1;3;362;365
17;Girona;20;Gironès;17089;Llagostera;1;1;A;;597;374;223;0;0;374;374
17;Girona;20;Gironès;17089;Llagostera;1;1;B;;674;421;253;0;0;421;421
17;Girona;20;Gironès;17089;Llagostera;1;2;A;;524;371;153;0;1;370;371
17;Girona;20;Gironès;17089;Llagostera;1;2;B;;640;426;214;5;3;418;421
17;Girona;20;Gironès;17089;Llagostera;1;3;A;;602;382;220;5;0;377;377
17;Girona;20;Gironès;17089;Llagostera;1;3;B;;683;410;273;3;4;403;407
17;Girona;20;Gironès;17089;Llagostera;1;4;U;;960;628;332;0;2;626;628
17;Girona;20;Gironès;17090;Llambilles;1;1;U;;423;321;102;0;0;321;321
17;Girona;31;Ripollès;17091;Llanars;1;1;U;;432;319;113;10;3;306;309
17;Girona;2;Alt Empordà;17092;Llançà;1;1;A;;458;327;131;3;3;321;324
17;Girona;2;Alt Empordà;17092;Llançà;1;1;B;;407;271;136;3;2;266;268
17;Girona;2;Alt Empordà;17092;Llançà;1;2;A;;507;383;124;1;3;379;382
17;Girona;2;Alt Empordà;17092;Llançà;1;2;B;;544;361;183;0;4;357;361
17;Girona;2;Alt Empordà;17092;Llançà;1;2;C;;505;340;165;0;3;337;340
17;Girona;2;Alt Empordà;17092;Llançà;1;3;A;;377;266;111;1;3;262;265
17;Girona;2;Alt Empordà;17092;Llançà;1;3;B;;386;289;97;1;2;286;288
25;Lleida;33;Segrià;25125;Llardecans;1;1;U;;511;375;136;1;6;368;374
25;Lleida;26;Pallars Sobirà;25126;Llavorsí;1;1;U;;280;208;72;0;0;208;208
25;Lleida;33;Segrià;25120;Lleida;1;1;A;;693;487;206;0;13;474;487
25;Lleida;33;Segrià;25120;Lleida;1;1;B;;773;500;273;1;3;496;499
25;Lleida;33;Segrià;25120;Lleida;1;10;A;;572;320;252;1;5;314;319
25;Lleida;33;Segrià;25120;Lleida;1;10;B;;715;378;337;0;1;377;378
25;Lleida;33;Segrià;25120;Lleida;1;11;A;;533;292;241;0;2;290;292
25;Lleida;33;Segrià;25120;Lleida;1;11;B;;613;324;289;1;3;320;323
25;Lleida;33;Segrià;25120;Lleida;1;12;U;;827;504;323;0;7;497;504
25;Lleida;33;Segrià;25120;Lleida;1;13;A;;727;442;285;1;1;440;441
25;Lleida;33;Segrià;25120;Lleida;1;13;B;;745;461;284;3;5;453;458
25;Lleida;33;Segrià;25120;Lleida;1;14;A;;480;261;219;0;4;257;261
25;Lleida;33;Segrià;25120;Lleida;1;14;B;;528;284;244;0;2;282;284
25;Lleida;33;Segrià;25120;Lleida;1;3;A;;574;365;209;0;2;363;365
25;Lleida;33;Segrià;25120;Lleida;1;3;B;;628;398;230;2;3;393;396
25;Lleida;33;Segrià;25120;Lleida;1;4;A;;716;458;258;0;5;453;458
25;Lleida;33;Segrià;25120;Lleida;1;4;B;;819;552;267;4;5;543;548
25;Lleida;33;Segrià;25120;Lleida;1;5;A;;597;298;299;0;2;296;298
25;Lleida;33;Segrià;25120;Lleida;1;5;B;;899;475;424;2;4;469;473
25;Lleida;33;Segrià;25120;Lleida;1;6;A;;483;281;202;3;3;275;278
25;Lleida;33;Segrià;25120;Lleida;1;6;B;;575;338;237;2;5;331;336
25;Lleida;33;Segrià;25120;Lleida;1;7;A;;809;434;375;2;6;426;432
25;Lleida;33;Segrià;25120;Lleida;1;7;B;;899;426;473;4;6;416;422
25;Lleida;33;Segrià;25120;Lleida;1;8;A;;741;441;300;1;3;437;440
25;Lleida;33;Segrià;25120;Lleida;1;8;B;;873;529;344;1;8;520;528
25;Lleida;33;Segrià;25120;Lleida;1;9;A;;462;279;183;1;4;274;278
25;Lleida;33;Segrià;25120;Lleida;1;9;B;;445;285;160;0;2;283;285
25;Lleida;33;Segrià;25120;Lleida;2;1;U;;620;334;286;0;5;329;334
25;Lleida;33;Segrià;25120;Lleida;2;2;A;;558;344;214;0;1;343;344
25;Lleida;33;Segrià;25120;Lleida;2;2;B;;669;433;236;3;1;429;430
25;Lleida;33;Segrià;25120;Lleida;2;3;U;;715;426;289;2;4;420;424
25;Lleida;33;Segrià;25120;Lleida;2;4;A;;553;311;242;1;2;308;310
25;Lleida;33;Segrià;25120;Lleida;2;4;B;;542;333;209;0;3;330;333
25;Lleida;33;Segrià;25120;Lleida;2;5;U;;734;450;284;2;4;444;448
25;Lleida;33;Segrià;25120;Lleida;2;6;A;;425;264;161;0;4;260;264
25;Lleida;33;Segrià;25120;Lleida;2;6;B;;565;355;210;0;5;350;355
25;Lleida;33;Segrià;25120;Lleida;2;7;A;;851;505;346;3;2;500;502
25;Lleida;33;Segrià;25120;Lleida;2;7;B;;833;486;347;0;8;478;486
25;Lleida;33;Segrià;25120;Lleida;2;8;A;;527;355;172;0;4;351;355
25;Lleida;33;Segrià;25120;Lleida;2;8;B;;665;419;246;0;6;413;419
25;Lleida;33;Segrià;25120;Lleida;2;9;U;;909;627;282;0;9;618;627
25;Lleida;33;Segrià;25120;Lleida;3;1;A;;478;180;298;0;2;178;180
25;Lleida;33;Segrià;25120;Lleida;3;1;B;;454;186;268;1;1;184;185
25;Lleida;33;Segrià;25120;Lleida;3;3;U;;611;427;184;1;6;420;426
25;Lleida;33;Segrià;25120;Lleida;3;4;A;;464;353;111;1;9;343;352
25;Lleida;33;Segrià;25120;Lleida;3;4;B;;530;400;130;0;9;391;400
25;Lleida;33;Segrià;25120;Lleida;3;5;U;;620;389;231;2;2;385;387
25;Lleida;33;Segrià;25120;Lleida;3;6;A;;514;360;154;1;3;356;359
25;Lleida;33;Segrià;25120;Lleida;3;6;B;;589;380;209;3;7;370;377
25;Lleida;33;Segrià;25120;Lleida;3;7;U;;521;305;216;0;5;300;305
25;Lleida;33;Segrià;25120;Lleida;3;8;U;;823;506;317;1;8;497;505
25;Lleida;33;Segrià;25120;Lleida;4;1;U;;530;218;312;0;3;215;218
25;Lleida;33;Segrià;25120;Lleida;4;10;A;;881;328;553;0;1;327;328
25;Lleida;33;Segrià;25120;Lleida;4;10;B;;724;290;434;0;7;283;290
25;Lleida;33;Segrià;25120;Lleida;4;11;A;;502;222;280;2;4;216;220
25;Lleida;33;Segrià;25120;Lleida;4;11;B;;496;219;277;2;3;214;217
25;Lleida;33;Segrià;25120;Lleida;4;12;U;;689;306;383;2;3;301;304
25;Lleida;33;Segrià;25120;Lleida;4;13;A;;546;277;269;0;1;276;277
25;Lleida;33;Segrià;25120;Lleida;4;13;B;;618;307;311;0;0;307;307
25;Lleida;33;Segrià;25120;Lleida;4;14;U;;813;417;396;3;5;409;414
25;Lleida;33;Segrià;25120;Lleida;4;15;A;;545;326;219;2;7;317;324
25;Lleida;33;Segrià;25120;Lleida;4;15;B;;600;369;231;0;11;358;369
25;Lleida;33;Segrià;25120;Lleida;4;16;A;;578;356;222;1;2;353;355
25;Lleida;33;Segrià;25120;Lleida;4;16;B;;690;449;241;1;11;437;448
25;Lleida;33;Segrià;25120;Lleida;4;17;A;;771;466;305;3;6;457;463
25;Lleida;33;Segrià;25120;Lleida;4;17;B;;785;460;325;0;8;452;460
25;Lleida;33;Segrià;25120;Lleida;4;2;U;;588;349;239;1;5;343;348
25;Lleida;33;Segrià;25120;Lleida;4;3;A;;763;550;213;1;10;539;549
25;Lleida;33;Segrià;25120;Lleida;4;3;B;;829;593;236;2;7;584;591
25;Lleida;33;Segrià;25120;Lleida;4;4;U;;686;443;243;2;4;437;441
25;Lleida;33;Segrià;25120;Lleida;4;5;U;;722;480;242;1;10;469;479
25;Lleida;33;Segrià;25120;Lleida;4;6;A;;614;414;200;0;3;411;414
25;Lleida;33;Segrià;25120;Lleida;4;6;B;;655;416;239;2;3;411;414
25;Lleida;33;Segrià;25120;Lleida;4;7;A;;491;292;199;0;0;292;292
25;Lleida;33;Segrià;25120;Lleida;4;7;B;;549;336;213;1;7;328;335
25;Lleida;33;Segrià;25120;Lleida;4;8;A;;474;254;220;1;2;251;253
25;Lleida;33;Segrià;25120;Lleida;4;8;B;;455;273;182;0;7;266;273
25;Lleida;33;Segrià;25120;Lleida;5;10;U;;906;645;261;0;1;644;645
25;Lleida;33;Segrià;25120;Lleida;5;11;A;;567;457;110;0;7;450;457
25;Lleida;33;Segrià;25120;Lleida;5;11;B;;577;414;163;1;6;407;413
25;Lleida;33;Segrià;25120;Lleida;5;12;U;;785;561;224;1;13;547;560
25;Lleida;33;Segrià;25120;Lleida;5;2;U;;837;567;270;1;5;561;566
25;Lleida;33;Segrià;25120;Lleida;5;3;A;;490;328;162;1;3;324;327
25;Lleida;33;Segrià;25120;Lleida;5;3;B;;523;359;164;0;2;357;359
25;Lleida;33;Segrià;25120;Lleida;5;4;A;;393;258;135;0;4;254;258
25;Lleida;33;Segrià;25120;Lleida;5;4;B;;521;370;151;0;3;367;370
25;Lleida;33;Segrià;25120;Lleida;5;5;A;;436;309;127;0;5;304;309
25;Lleida;33;Segrià;25120;Lleida;5;5;B;;558;395;163;1;2;392;394
25;Lleida;33;Segrià;25120;Lleida;5;6;A;;563;380;183;2;4;374;378
25;Lleida;33;Segrià;25120;Lleida;5;6;B;;707;482;225;1;5;476;481
25;Lleida;33;Segrià;25120;Lleida;5;7;U;;669;410;259;2;4;404;408
25;Lleida;33;Segrià;25120;Lleida;5;8;U;;958;656;302;4;9;643;652
25;Lleida;33;Segrià;25120;Lleida;5;9;U;;828;581;247;0;9;572;581
25;Lleida;33;Segrià;25120;Lleida;6;1;A;;395;183;212;0;4;179;183
25;Lleida;33;Segrià;25120;Lleida;6;1;B;;871;575;296;6;8;561;569
25;Lleida;33;Segrià;25120;Lleida;6;10;A;;584;377;207;1;3;373;376
25;Lleida;33;Segrià;25120;Lleida;6;10;B;;657;387;270;0;3;384;387
25;Lleida;33;Segrià;25120;Lleida;6;11;A;;636;406;230;1;9;396;405
25;Lleida;33;Segrià;25120;Lleida;6;11;B;;590;404;186;0;2;402;404
25;Lleida;33;Segrià;25120;Lleida;6;12;A;;593;427;166;5;8;414;422
25;Lleida;33;Segrià;25120;Lleida;6;12;B;;651;433;218;1;11;421;432
25;Lleida;33;Segrià;25120;Lleida;6;13;A;;524;358;166;0;0;358;358
25;Lleida;33;Segrià;25120;Lleida;6;13;B;;620;444;176;1;9;434;443
25;Lleida;33;Segrià;25120;Lleida;6;14;A;;623;390;233;0;8;382;390
25;Lleida;33;Segrià;25120;Lleida;6;14;B;;736;457;279;2;9;446;455
25;Lleida;33;Segrià;25120;Lleida;6;15;U;;572;379;193;1;3;375;378
25;Lleida;33;Segrià;25120;Lleida;6;16;U;;704;522;182;4;3;515;518
25;Lleida;33;Segrià;25120;Lleida;6;2;A;;644;412;232;0;4;408;412
25;Lleida;33;Segrià;25120;Lleida;6;2;B;;696;447;249;2;5;440;445
25;Lleida;33;Segrià;25120;Lleida;6;3;A;;777;496;281;0;6;490;496
25;Lleida;33;Segrià;25120;Lleida;6;3;B;;863;564;299;3;8;553;561
25;Lleida;33;Segrià;25120;Lleida;6;4;A;;575;376;199;1;2;373;375
25;Lleida;33;Segrià;25120;Lleida;6;4;B;;603;422;181;1;2;419;421
25;Lleida;33;Segrià;25120;Lleida;6;5;U;;752;527;225;2;5;520;525
25;Lleida;33;Segrià;25120;Lleida;6;6;A;;879;500;379;1;4;495;499
25;Lleida;33;Segrià;25120;Lleida;6;6;B;;1015;577;438;4;15;558;573
25;Lleida;33;Segrià;25120;Lleida;6;7;A;;823;446;377;0;5;441;446
25;Lleida;33;Segrià;25120;Lleida;6;7;B;;1019;576;443;0;7;569;576
25;Lleida;33;Segrià;25120;Lleida;6;9;A;;378;219;159;2;1;216;217
25;Lleida;33;Segrià;25120;Lleida;6;9;B;;476;284;192;1;1;282;283
25;Lleida;33;Segrià;25120;Lleida;7;1;A;;644;359;285;2;4;353;357
25;Lleida;33;Segrià;25120;Lleida;7;1;B;;763;420;343;1;3;416;419
25;Lleida;33;Segrià;25120;Lleida;7;2;U;;597;299;298;0;0;299;299
25;Lleida;33;Segrià;25120;Lleida;7;3;A;;552;320;232;1;1;318;319
25;Lleida;33;Segrià;25120;Lleida;7;3;B;;671;393;278;4;3;386;389
25;Lleida;33;Segrià;25120;Lleida;7;4;A;;894;483;411;0;6;477;483
25;Lleida;33;Segrià;25120;Lleida;7;4;B;;1022;551;471;0;12;539;551
25;Lleida;33;Segrià;25120;Lleida;7;5;A;;829;439;390;1;8;430;438
25;Lleida;33;Segrià;25120;Lleida;7;5;B;;896;466;430;1;9;456;465
25;Lleida;33;Segrià;25120;Lleida;7;6;A;;835;465;370;1;4;460;464
25;Lleida;33;Segrià;25120;Lleida;7;6;B;;959;519;440;2;3;514;517
25;Lleida;33;Segrià;25120;Lleida;7;7;A;;721;371;350;0;2;369;371
25;Lleida;33;Segrià;25120;Lleida;7;7;B;;854;429;425;3;3;423;426
25;Lleida;33;Segrià;25120;Lleida;8;1;A;;551;385;166;0;8;377;385
25;Lleida;33;Segrià;25120;Lleida;8;1;B;;857;479;378;0;7;472;479
25;Lleida;33;Segrià;25120;Lleida;8;2;A;;1026;736;290;2;8;726;734
25;Lleida;33;Segrià;25120;Lleida;8;2;B;;381;227;154;2;2;223;225
25;Lleida;33;Segrià;25120;Lleida;8;2;C;;246;197;49;0;4;193;197
25;Lleida;33;Segrià;25120;Lleida;8;3;A;;353;248;105;1;3;244;247
25;Lleida;33;Segrià;25120;Lleida;8;3;B;;527;355;172;1;1;353;354
25;Lleida;33;Segrià;25120;Lleida;9;1;A;;605;415;190;0;3;412;415
25;Lleida;33;Segrià;25120;Lleida;9;1;B;;841;519;322;3;5;511;516
25;Lleida;33;Segrià;25120;Lleida;9;2;A;;825;537;288;1;2;534;536
25;Lleida;33;Segrià;25120;Lleida;9;2;B;;357;223;134;0;0;223;223
17;Girona;2;Alt Empordà;17093;Llers;1;1;A;;463;319;144;1;3;315;318
17;Girona;2;Alt Empordà;17093;Llers;1;1;B;;407;260;147;4;0;256;256
25;Lleida;15;Cerdanya;25127;Lles de Cerdanya;1;1;U;;237;166;71;0;5;161;166
8;Barcelona;41;Vallès Oriental;08107;Lliçà d'Amunt;1;1;A;;554;362;192;1;0;361;361
8;Barcelona;41;Vallès Oriental;08107;Lliçà d'Amunt;1;1;B;;762;501;261;2;4;495;499
8;Barcelona;41;Vallès Oriental;08107;Lliçà d'Amunt;1;2;A;;611;378;233;3;1;374;375
8;Barcelona;41;Vallès Oriental;08107;Lliçà d'Amunt;1;2;B;;711;442;269;0;3;439;442
8;Barcelona;41;Vallès Oriental;08107;Lliçà d'Amunt;1;2;C;;683;418;265;1;4;413;417
8;Barcelona;41;Vallès Oriental;08107;Lliçà d'Amunt;1;3;A;;629;345;284;1;2;342;344
8;Barcelona;41;Vallès Oriental;08107;Lliçà d'Amunt;1;3;B;;807;475;332;1;4;470;474
8;Barcelona;41;Vallès Oriental;08107;Lliçà d'Amunt;1;4;A;;583;286;297;1;1;284;285
8;Barcelona;41;Vallès Oriental;08107;Lliçà d'Amunt;1;4;B;;706;340;366;0;6;334;340
8;Barcelona;41;Vallès Oriental;08107;Lliçà d'Amunt;1;5;A;;887;467;420;0;2;465;467
8;Barcelona;41;Vallès Oriental;08107;Lliçà d'Amunt;1;5;B;;1012;529;483;1;6;522;528
8;Barcelona;41;Vallès Oriental;08107;Lliçà d'Amunt;1;6;A;;611;310;301;0;2;308;310
8;Barcelona;41;Vallès Oriental;08107;Lliçà d'Amunt;1;6;B;;689;343;346;1;3;339;342
8;Barcelona;41;Vallès Oriental;08108;Lliçà de Vall;1;1;A;;554;348;206;2;3;343;346
8;Barcelona;41;Vallès Oriental;08108;Lliçà de Vall;1;1;B;;657;383;274;2;3;378;381
8;Barcelona;41;Vallès Oriental;08108;Lliçà de Vall;1;2;A;;627;414;213;0;1;413;414
8;Barcelona;41;Vallès Oriental;08108;Lliçà de Vall;1;2;B;;805;535;270;0;0;535;535
8;Barcelona;41;Vallès Oriental;08108;Lliçà de Vall;1;2;C;;645;432;213;2;2;428;430
8;Barcelona;41;Vallès Oriental;08108;Lliçà de Vall;1;3;A;;575;341;234;0;2;339;341
8;Barcelona;41;Vallès Oriental;08108;Lliçà de Vall;1;3;B;;617;386;231;2;1;383;384
25;Lleida;25;Pallars Jussà;25128;Llimiana;1;1;U;;166;110;56;1;0;109;109
8;Barcelona;41;Vallès Oriental;08106;Llinars del Vallès;1;1;A;;473;300;173;4;3;293;296
8;Barcelona;41;Vallès Oriental;08106;Llinars del Vallès;1;1;B;;441;275;166;0;2;273;275
8;Barcelona;41;Vallès Oriental;08106;Llinars del Vallès;1;2;A;;606;365;241;3;4;358;362
8;Barcelona;41;Vallès Oriental;08106;Llinars del Vallès;1;2;B;;692;398;294;5;2;391;393
8;Barcelona;41;Vallès Oriental;08106;Llinars del Vallès;2;1;A;;898;575;323;1;7;567;574
8;Barcelona;41;Vallès Oriental;08106;Llinars del Vallès;2;1;B;;980;643;337;1;6;636;642
8;Barcelona;41;Vallès Oriental;08106;Llinars del Vallès;2;2;A;;873;519;354;0;5;514;519
8;Barcelona;41;Vallès Oriental;08106;Llinars del Vallès;2;2;B;;941;565;376;1;4;560;564
17;Girona;15;Cerdanya;17094;Llívia;1;1;U;;899;610;289;5;5;600;605
43;Tarragona;29;Priorat;43072;Lloar, el;1;1;U;;108;88;20;1;0;87;87
25;Lleida;35;Solsonès;25129;Llobera;1;1;U;;199;140;59;0;2;138;140
43;Tarragona;16;Conca de Barberà;43073;Llorac;1;1;U;;113;84;29;1;0;83;83
43;Tarragona;12;Baix Penedès;43074;Llorenç del Penedès;1;1;A;;424;329;95;1;0;328;328
43;Tarragona;12;Baix Penedès;43074;Llorenç del Penedès;1;1;B;;424;321;103;0;1;320;321
43;Tarragona;12;Baix Penedès;43074;Llorenç del Penedès;1;1;C;;571;434;137;0;0;434;434
17;Girona;34;Selva;17095;Lloret de Mar;1;1;A;;746;372;374;1;5;366;371
17;Girona;34;Selva;17095;Lloret de Mar;1;1;B;;788;375;413;1;2;372;374
17;Girona;34;Selva;17095;Lloret de Mar;1;1;C;;724;369;355;3;4;362;366
17;Girona;34;Selva;17095;Lloret de Mar;1;2;A;;616;372;244;0;5;367;372
17;Girona;34;Selva;17095;Lloret de Mar;1;2;B;;522;308;214;0;2;306;308
17;Girona;34;Selva;17095;Lloret de Mar;2;1;A;;722;439;283;0;5;434;439
17;Girona;34;Selva;17095;Lloret de Mar;2;1;B;;676;434;242;2;3;429;432
17;Girona;34;Selva;17095;Lloret de Mar;2;2;A;;718;408;310;2;3;403;406
17;Girona;34;Selva;17095;Lloret de Mar;2;2;B;;654;375;279;0;2;373;375
17;Girona;34;Selva;17095;Lloret de Mar;2;3;A;;718;407;311;3;6;398;404
17;Girona;34;Selva;17095;Lloret de Mar;2;3;B;;670;400;270;8;5;387;392
17;Girona;34;Selva;17095;Lloret de Mar;3;1;A;;565;282;283;0;2;280;282
17;Girona;34;Selva;17095;Lloret de Mar;3;1;B;;621;316;305;0;1;315;316
17;Girona;34;Selva;17095;Lloret de Mar;3;1;C;;625;325;300;0;4;321;325
17;Girona;34;Selva;17095;Lloret de Mar;3;2;A;;784;433;351;1;6;426;432
17;Girona;34;Selva;17095;Lloret de Mar;3;2;B;;702;407;295;1;3;403;406
17;Girona;34;Selva;17095;Lloret de Mar;3;3;A;;579;298;281;0;4;294;298
17;Girona;34;Selva;17095;Lloret de Mar;3;3;B;;647;291;356;0;8;283;291
17;Girona;34;Selva;17095;Lloret de Mar;3;3;C;;550;273;277;0;1;272;273
17;Girona;34;Selva;17095;Lloret de Mar;4;1;A;;771;421;350;2;3;416;419
17;Girona;34;Selva;17095;Lloret de Mar;4;1;B;;711;357;354;1;2;354;356
17;Girona;34;Selva;17095;Lloret de Mar;4;2;A;;458;237;221;1;2;234;236
17;Girona;34;Selva;17095;Lloret de Mar;4;2;B;;623;295;328;0;4;291;295
17;Girona;34;Selva;17095;Lloret de Mar;4;2;C;;578;272;306;0;4;268;272
17;Girona;31;Ripollès;17096;Llosses, les;1;1;U;;219;141;78;2;1;138;139
8;Barcelona;24;Osona;08109;Lluçà;1;1;U;;214;171;43;0;0;171;171
17;Girona;2;Alt Empordà;17102;Maçanet de Cabrenys;1;1;U;;589;438;151;2;11;425;436
17;Girona;34;Selva;17103;Maçanet de la Selva;1;1;A;;965;612;353;1;5;606;611
17;Girona;34;Selva;17103;Maçanet de la Selva;1;1;B;;1038;636;402;3;1;632;633
17;Girona;34;Selva;17103;Maçanet de la Selva;1;2;A;;891;388;503;0;2;386;388
17;Girona;34;Selva;17103;Maçanet de la Selva;1;2;B;;844;370;474;0;2;368;370
17;Girona;20;Gironès;17097;Madremanya;1;1;U;;165;137;28;2;1;134;135
17;Girona;19;Garrotxa;17098;Maià de Montcal;1;1;U;;291;230;61;0;2;228;230
25;Lleida;33;Segrià;25133;Maials;1;1;U;;836;621;215;1;8;612;620
25;Lleida;38;Urgell;25130;Maldà;1;1;U;;236;173;63;1;0;172;172
8;Barcelona;21;Maresme;08110;Malgrat de Mar;1;1;A;;599;360;239;0;1;359;360
8;Barcelona;21;Maresme;08110;Malgrat de Mar;1;1;B;;572;309;263;0;0;309;309
8;Barcelona;21;Maresme;08110;Malgrat de Mar;1;1;C;;666;391;275;0;3;388;391
8;Barcelona;21;Maresme;08110;Malgrat de Mar;1;1;D;;589;363;226;0;1;362;363
8;Barcelona;21;Maresme;08110;Malgrat de Mar;1;2;A;;464;287;177;1;1;285;286
8;Barcelona;21;Maresme;08110;Malgrat de Mar;1;2;B;;604;391;213;0;0;391;391
8;Barcelona;21;Maresme;08110;Malgrat de Mar;1;2;C;;655;426;229;4;2;420;422
8;Barcelona;21;Maresme;08110;Malgrat de Mar;1;3;A;;681;381;300;2;3;376;379
8;Barcelona;21;Maresme;08110;Malgrat de Mar;1;3;B;;797;442;355;1;6;435;441
8;Barcelona;21;Maresme;08110;Malgrat de Mar;1;4;A;;421;244;177;0;3;241;244
8;Barcelona;21;Maresme;08110;Malgrat de Mar;1;4;B;;503;282;221;0;0;282;282
8;Barcelona;21;Maresme;08110;Malgrat de Mar;1;4;C;;530;320;210;0;3;317;320
8;Barcelona;21;Maresme;08110;Malgrat de Mar;1;5;A;;415;244;171;1;1;242;243
8;Barcelona;21;Maresme;08110;Malgrat de Mar;1;5;B;;501;288;213;2;1;285;286
8;Barcelona;21;Maresme;08110;Malgrat de Mar;1;5;C;;468;274;194;1;2;271;273
8;Barcelona;21;Maresme;08110;Malgrat de Mar;2;1;A;;627;390;237;1;5;384;389
8;Barcelona;21;Maresme;08110;Malgrat de Mar;2;1;B;;620;367;253;1;2;364;366
8;Barcelona;21;Maresme;08110;Malgrat de Mar;2;1;C;;797;505;292;1;4;500;504
8;Barcelona;21;Maresme;08110;Malgrat de Mar;2;2;A;;494;341;153;1;5;335;340
8;Barcelona;21;Maresme;08110;Malgrat de Mar;2;2;B;;486;298;188;1;0;297;297
8;Barcelona;21;Maresme;08110;Malgrat de Mar;2;2;C;;587;377;210;1;1;375;376
8;Barcelona;24;Osona;08111;Malla;1;1;U;;212;190;22;0;3;187;190
8;Barcelona;24;Osona;08112;Manlleu;1;1;A;;612;440;172;2;2;436;438
8;Barcelona;24;Osona;08112;Manlleu;1;1;B;;721;533;188;2;5;526;531
8;Barcelona;24;Osona;08112;Manlleu;1;2;U;;602;486;116;1;4;481;485
8;Barcelona;24;Osona;08112;Manlleu;2;1;A;;612;440;172;1;2;437;439
8;Barcelona;24;Osona;08112;Manlleu;2;1;B;;724;531;193;1;5;525;530
8;Barcelona;24;Osona;08112;Manlleu;2;2;A;;616;428;188;0;2;426;428
8;Barcelona;24;Osona;08112;Manlleu;2;2;B;;762;534;228;0;5;529;534
8;Barcelona;24;Osona;08112;Manlleu;2;3;A;;444;343;101;0;3;340;343
8;Barcelona;24;Osona;08112;Manlleu;2;3;B;;475;348;127;1;2;345;347
8;Barcelona;24;Osona;08112;Manlleu;2;4;A;;528;369;159;1;2;366;368
8;Barcelona;24;Osona;08112;Manlleu;2;4;B;;589;414;175;0;5;409;414
8;Barcelona;24;Osona;08112;Manlleu;3;1;A;;688;457;231;0;1;456;457
8;Barcelona;24;Osona;08112;Manlleu;3;1;B;;603;367;236;0;3;364;367
8;Barcelona;24;Osona;08112;Manlleu;3;1;C;;602;380;222;0;4;376;380
8;Barcelona;24;Osona;08112;Manlleu;3;2;A;;740;513;227;0;5;508;513
8;Barcelona;24;Osona;08112;Manlleu;3;2;B;;820;548;272;2;6;540;546
8;Barcelona;24;Osona;08112;Manlleu;3;3;A;;627;377;250;0;3;374;377
8;Barcelona;24;Osona;08112;Manlleu;3;3;B;;696;429;267;1;2;426;428
8;Barcelona;24;Osona;08112;Manlleu;4;1;U;;567;411;156;2;3;406;409
8;Barcelona;24;Osona;08112;Manlleu;4;2;A;;550;401;149;1;3;397;400
8;Barcelona;24;Osona;08112;Manlleu;4;2;B;;675;476;199;0;1;475;476
8;Barcelona;7;Bages;08113;Manresa;1;1;U;;673;387;286;2;8;377;385
8;Barcelona;7;Bages;08113;Manresa;1;2;U;;581;349;232;0;0;349;349
8;Barcelona;7;Bages;08113;Manresa;2;1;U;;740;557;183;1;6;550;556
8;Barcelona;7;Bages;08113;Manresa;2;10;A;;659;455;204;0;5;450;455
8;Barcelona;7;Bages;08113;Manresa;2;10;B;;795;570;225;0;6;564;570
8;Barcelona;7;Bages;08113;Manresa;2;11;A;;566;391;175;1;3;387;390
8;Barcelona;7;Bages;08113;Manresa;2;11;B;;710;487;223;0;4;483;487
8;Barcelona;7;Bages;08113;Manresa;2;12;U;;1079;743;336;0;10;733;743
8;Barcelona;7;Bages;08113;Manresa;2;13;A;;486;330;156;0;8;322;330
8;Barcelona;7;Bages;08113;Manresa;2;13;B;;604;400;204;0;6;394;400
8;Barcelona;7;Bages;08113;Manresa;2;14;U;;514;315;199;1;2;312;314
8;Barcelona;7;Bages;08113;Manresa;2;2;A;;688;497;191;2;9;486;495
8;Barcelona;7;Bages;08113;Manresa;2;2;B;;836;611;225;1;3;607;610
8;Barcelona;7;Bages;08113;Manresa;2;3;A;;639;424;215;0;4;420;424
8;Barcelona;7;Bages;08113;Manresa;2;3;B;;912;640;272;1;10;629;639
8;Barcelona;7;Bages;08113;Manresa;2;4;A;;716;519;197;4;1;514;515
8;Barcelona;7;Bages;08113;Manresa;2;4;B;;963;686;277;0;7;679;686
8;Barcelona;7;Bages;08113;Manresa;2;5;A;;750;530;220;1;3;526;529
8;Barcelona;7;Bages;08113;Manresa;2;5;B;;859;559;300;2;9;548;557
8;Barcelona;7;Bages;08113;Manresa;2;6;U;;616;359;257;0;2;357;359
8;Barcelona;7;Bages;08113;Manresa;2;7;A;;357;208;149;0;2;206;208
8;Barcelona;7;Bages;08113;Manresa;2;7;B;;492;293;199;0;3;290;293
8;Barcelona;7;Bages;08113;Manresa;2;8;U;;620;365;255;2;3;360;363
8;Barcelona;7;Bages;08113;Manresa;2;9;A;;675;422;253;0;1;421;422
8;Barcelona;7;Bages;08113;Manresa;2;9;B;;780;501;279;0;2;499;501
8;Barcelona;7;Bages;08113;Manresa;3;1;U;;658;390;268;1;2;387;389
8;Barcelona;7;Bages;08113;Manresa;3;2;U;;594;367;227;4;1;362;363
8;Barcelona;7;Bages;08113;Manresa;3;4;A;;469;309;160;1;5;303;308
8;Barcelona;7;Bages;08113;Manresa;3;4;B;;590;379;211;3;3;373;376
8;Barcelona;7;Bages;08113;Manresa;3;5;U;;1136;735;401;2;4;729;733
8;Barcelona;7;Bages;08113;Manresa;3;6;A;;370;252;118;0;4;248;252
8;Barcelona;7;Bages;08113;Manresa;3;6;B;;534;346;188;1;5;340;345
8;Barcelona;7;Bages;08113;Manresa;4;1;A;;693;468;225;3;1;464;465
8;Barcelona;7;Bages;08113;Manresa;4;1;B;;703;465;238;1;2;462;464
8;Barcelona;7;Bages;08113;Manresa;4;11;U;;688;446;242;0;6;440;446
8;Barcelona;7;Bages;08113;Manresa;4;12;U;;591;381;210;1;5;375;380
8;Barcelona;7;Bages;08113;Manresa;4;13;U;;1010;662;348;2;6;654;660
8;Barcelona;7;Bages;08113;Manresa;4;3;U;;708;470;238;1;3;466;469
8;Barcelona;7;Bages;08113;Manresa;4;4;A;;634;454;180;0;2;452;454
8;Barcelona;7;Bages;08113;Manresa;4;4;B;;937;648;289;0;5;643;648
8;Barcelona;7;Bages;08113;Manresa;4;5;A;;922;618;304;0;5;613;618
8;Barcelona;7;Bages;08113;Manresa;4;5;B;;1119;751;368;2;8;741;749
8;Barcelona;7;Bages;08113;Manresa;4;6;A;;597;423;174;1;1;421;422
8;Barcelona;7;Bages;08113;Manresa;4;6;B;;756;521;235;2;5;514;519
8;Barcelona;7;Bages;08113;Manresa;4;7;A;;660;439;221;0;2;437;439
8;Barcelona;7;Bages;08113;Manresa;4;7;B;;804;521;283;0;4;517;521
8;Barcelona;7;Bages;08113;Manresa;4;8;A;;797;537;260;0;6;531;537
8;Barcelona;7;Bages;08113;Manresa;4;8;B;;994;673;321;1;6;666;672
8;Barcelona;7;Bages;08113;Manresa;4;9;A;;558;357;201;1;3;353;356
8;Barcelona;7;Bages;08113;Manresa;4;9;B;;686;426;260;2;5;419;424
8;Barcelona;7;Bages;08113;Manresa;5;1;U;;769;432;337;2;1;429;430
8;Barcelona;7;Bages;08113;Manresa;5;10;A;;427;275;152;2;4;269;273
8;Barcelona;7;Bages;08113;Manresa;5;10;B;;529;326;203;2;5;319;324
8;Barcelona;7;Bages;08113;Manresa;5;11;A;;506;336;170;2;1;333;334
8;Barcelona;7;Bages;08113;Manresa;5;11;B;;608;406;202;1;2;403;405
8;Barcelona;7;Bages;08113;Manresa;5;12;U;;755;427;328;1;1;425;426
8;Barcelona;7;Bages;08113;Manresa;5;13;A;;514;341;173;1;1;339;340
8;Barcelona;7;Bages;08113;Manresa;5;13;B;;598;404;194;1;7;396;403
8;Barcelona;7;Bages;08113;Manresa;5;14;A;;495;328;167;0;3;325;328
8;Barcelona;7;Bages;08113;Manresa;5;14;B;;616;449;167;0;7;442;449
8;Barcelona;7;Bages;08113;Manresa;5;15;A;;577;273;304;2;4;267;271
8;Barcelona;7;Bages;08113;Manresa;5;15;B;;635;327;308;2;1;324;325
8;Barcelona;7;Bages;08113;Manresa;5;16;U;;468;277;191;0;2;275;277
8;Barcelona;7;Bages;08113;Manresa;5;17;A;;545;366;179;1;3;362;365
8;Barcelona;7;Bages;08113;Manresa;5;17;B;;807;533;274;0;9;524;533
8;Barcelona;7;Bages;08113;Manresa;5;18;U;;699;343;356;0;2;341;343
8;Barcelona;7;Bages;08113;Manresa;5;2;A;;422;249;173;1;0;248;248
8;Barcelona;7;Bages;08113;Manresa;5;2;B;;549;312;237;1;2;309;311
8;Barcelona;7;Bages;08113;Manresa;5;3;U;;1093;705;388;1;7;697;704
8;Barcelona;7;Bages;08113;Manresa;5;4;U;;555;367;188;0;0;367;367
8;Barcelona;7;Bages;08113;Manresa;5;5;A;;686;418;268;0;4;414;418
8;Barcelona;7;Bages;08113;Manresa;5;5;B;;779;499;280;1;3;495;498
8;Barcelona;7;Bages;08113;Manresa;5;6;A;;632;381;251;0;1;380;381
8;Barcelona;7;Bages;08113;Manresa;5;6;B;;819;515;304;1;5;509;514
8;Barcelona;7;Bages;08113;Manresa;5;7;U;;370;206;164;1;1;204;205
8;Barcelona;7;Bages;08113;Manresa;5;8;U;;556;356;200;1;0;355;355
8;Barcelona;7;Bages;08113;Manresa;6;1;A;;452;264;188;2;0;262;262
8;Barcelona;7;Bages;08113;Manresa;6;1;B;;534;306;228;4;3;299;302
8;Barcelona;7;Bages;08113;Manresa;6;2;U;;829;515;314;3;4;508;512
43;Tarragona;29;Priorat;43076;Marçà;1;1;U;;505;374;131;0;3;371;374
43;Tarragona;29;Priorat;43075;Margalef;1;1;U;;113;88;25;0;2;86;88
8;Barcelona;7;Bages;08242;Marganell;1;1;U;;209;147;62;0;1;146;147
8;Barcelona;11;Baix Llobregat;08114;Martorell;1;1;A;;471;314;157;1;5;308;313
8;Barcelona;11;Baix Llobregat;08114;Martorell;1;1;B;;442;274;168;0;3;271;274
8;Barcelona;11;Baix Llobregat;08114;Martorell;1;2;U;;540;316;224;0;2;314;316
8;Barcelona;11;Baix Llobregat;08114;Martorell;1;3;A;;442;284;158;0;3;281;284
8;Barcelona;11;Baix Llobregat;08114;Martorell;1;3;B;;465;306;159;0;0;306;306
8;Barcelona;11;Baix Llobregat;08114;Martorell;2;3;A;;639;385;254;2;3;380;383
8;Barcelona;11;Baix Llobregat;08114;Martorell;2;3;B;;641;379;262;0;0;379;379
8;Barcelona;11;Baix Llobregat;08114;Martorell;2;3;C;;588;345;243;0;3;342;345
8;Barcelona;11;Baix Llobregat;08114;Martorell;3;2;A;;610;369;241;2;3;364;367
8;Barcelona;11;Baix Llobregat;08114;Martorell;3;2;B;;702;405;297;0;3;402;405
8;Barcelona;11;Baix Llobregat;08114;Martorell;3;4;A;;450;269;181;2;1;266;267
8;Barcelona;11;Baix Llobregat;08114;Martorell;3;4;B;;513;277;236;1;3;273;276
8;Barcelona;11;Baix Llobregat;08114;Martorell;3;4;C;;486;276;210;0;1;275;276
8;Barcelona;11;Baix Llobregat;08114;Martorell;3;5;A;;495;291;204;2;3;286;289
8;Barcelona;11;Baix Llobregat;08114;Martorell;3;5;B;;542;336;206;5;3;328;331
8;Barcelona;11;Baix Llobregat;08114;Martorell;3;6;A;;498;321;177;4;1;316;317
8;Barcelona;11;Baix Llobregat;08114;Martorell;3;6;B;;433;278;155;1;1;276;277
8;Barcelona;11;Baix Llobregat;08114;Martorell;3;6;C;;481;313;168;0;1;312;313
8;Barcelona;11;Baix Llobregat;08114;Martorell;3;7;A;;636;429;207;2;5;422;427
8;Barcelona;11;Baix Llobregat;08114;Martorell;3;7;B;;627;384;243;1;5;378;383
8;Barcelona;11;Baix Llobregat;08114;Martorell;3;8;A;;607;391;216;0;5;386;391
8;Barcelona;11;Baix Llobregat;08114;Martorell;3;8;B;;868;558;310;2;6;550;556
8;Barcelona;11;Baix Llobregat;08114;Martorell;3;8;C;;640;389;251;0;8;381;389
8;Barcelona;11;Baix Llobregat;08114;Martorell;4;1;A;;544;307;237;0;4;303;307
8;Barcelona;11;Baix Llobregat;08114;Martorell;4;1;B;;660;369;291;0;1;368;369
8;Barcelona;11;Baix Llobregat;08114;Martorell;4;1;C;;571;314;257;0;2;312;314
8;Barcelona;11;Baix Llobregat;08114;Martorell;4;2;A;;491;309;182;0;4;305;309
8;Barcelona;11;Baix Llobregat;08114;Martorell;4;2;B;;622;376;246;1;6;369;375
8;Barcelona;11;Baix Llobregat;08114;Martorell;4;2;C;;569;365;204;3;8;354;362
8;Barcelona;11;Baix Llobregat;08114;Martorell;4;3;A;;981;577;404;1;4;572;576
8;Barcelona;11;Baix Llobregat;08114;Martorell;4;3;B;;1053;612;441;1;5;606;611
8;Barcelona;41;Vallès Oriental;08115;Martorelles;1;1;A;;414;234;180;0;0;234;234
8;Barcelona;41;Vallès Oriental;08115;Martorelles;1;1;B;;525;288;237;1;4;283;287
8;Barcelona;41;Vallès Oriental;08115;Martorelles;1;1;C;;571;336;235;1;1;334;335
8;Barcelona;41;Vallès Oriental;08115;Martorelles;1;2;A;;550;334;216;1;4;329;333
8;Barcelona;41;Vallès Oriental;08115;Martorelles;1;2;B;;787;518;269;2;6;510;516
8;Barcelona;41;Vallès Oriental;08115;Martorelles;1;3;A;;528;317;211;0;9;308;317
8;Barcelona;41;Vallès Oriental;08115;Martorelles;1;3;B;;640;362;278;3;2;357;359
17;Girona;2;Alt Empordà;17100;Masarac;1;1;U;;206;160;46;1;3;156;159
43;Tarragona;22;Montsià;43077;Mas de Barberans;1;1;U;;574;415;159;1;5;409;414
43;Tarragona;22;Montsià;43078;Masdenverge;1;1;U;;747;594;153;2;3;589;592
8;Barcelona;24;Osona;08116;Masies de Roda, les;1;1;U;;570;460;110;0;2;458;460
8;Barcelona;24;Osona;08117;Masies de Voltregà, les;1;1;A;;677;470;207;4;7;459;466
8;Barcelona;24;Osona;08117;Masies de Voltregà, les;1;1;B;;550;419;131;0;4;415;419
8;Barcelona;24;Osona;08117;Masies de Voltregà, les;1;1;C;;550;437;113;1;2;434;436
8;Barcelona;24;Osona;08117;Masies de Voltregà, les;2;1;U;;593;405;188;0;3;402;405
43;Tarragona;12;Baix Penedès;43079;Masllorenç;1;1;U;;352;284;68;0;5;279;284
8;Barcelona;21;Maresme;08118;Masnou, el;1;1;A;;705;452;253;1;3;448;451
8;Barcelona;21;Maresme;08118;Masnou, el;1;1;B;;741;500;241;0;10;490;500
8;Barcelona;21;Maresme;08118;Masnou, el;1;10;A;;504;350;154;0;4;346;350
8;Barcelona;21;Maresme;08118;Masnou, el;1;10;B;;505;349;156;1;3;345;348
8;Barcelona;21;Maresme;08118;Masnou, el;1;2;A;;667;440;227;0;7;433;440
8;Barcelona;21;Maresme;08118;Masnou, el;1;2;B;;855;568;287;0;5;563;568
8;Barcelona;21;Maresme;08118;Masnou, el;1;3;A;;431;306;125;0;3;303;306
8;Barcelona;21;Maresme;08118;Masnou, el;1;3;B;;498;331;167;0;9;322;331
8;Barcelona;21;Maresme;08118;Masnou, el;1;4;A;;629;434;195;1;5;428;433
8;Barcelona;21;Maresme;08118;Masnou, el;1;4;B;;741;529;212;0;1;528;529
8;Barcelona;21;Maresme;08118;Masnou, el;1;5;A;;653;444;209;0;9;435;444
8;Barcelona;21;Maresme;08118;Masnou, el;1;5;B;;738;486;252;0;0;486;486
8;Barcelona;21;Maresme;08118;Masnou, el;1;6;A;;666;423;243;1;2;420;422
8;Barcelona;21;Maresme;08118;Masnou, el;1;6;B;;779;470;309;1;2;467;469
8;Barcelona;21;Maresme;08118;Masnou, el;1;7;A;;645;404;241;0;12;392;404
8;Barcelona;21;Maresme;08118;Masnou, el;1;7;B;;671;420;251;0;1;419;420
8;Barcelona;21;Maresme;08118;Masnou, el;1;8;U;;1146;662;484;5;11;646;657
8;Barcelona;21;Maresme;08118;Masnou, el;1;9;U;;604;427;177;0;2;425;427
8;Barcelona;21;Maresme;08118;Masnou, el;2;1;A;;671;471;200;1;2;468;470
8;Barcelona;21;Maresme;08118;Masnou, el;2;1;B;;698;490;208;2;6;482;488
8;Barcelona;21;Maresme;08118;Masnou, el;2;2;U;;812;589;223;2;6;581;587
8;Barcelona;21;Maresme;08118;Masnou, el;2;3;A;;489;339;150;0;1;338;339
8;Barcelona;21;Maresme;08118;Masnou, el;2;3;B;;533;350;183;0;2;348;350
8;Barcelona;21;Maresme;08118;Masnou, el;2;4;A;;637;410;227;0;2;408;410
8;Barcelona;21;Maresme;08118;Masnou, el;2;4;B;;728;480;248;2;4;474;478
43;Tarragona;1;Alt Camp;43080;Masó, la;1;1;U;;251;183;68;0;5;178;183
43;Tarragona;8;Baix Camp;43081;Maspujols;1;1;U;;407;338;69;1;4;333;337
8;Barcelona;6;Anoia;08119;Masquefa;1;1;A;;416;246;170;5;3;238;241
8;Barcelona;6;Anoia;08119;Masquefa;1;1;B;;630;397;233;0;10;387;397
8;Barcelona;6;Anoia;08119;Masquefa;1;1;C;;655;408;247;0;6;402;408
8;Barcelona;6;Anoia;08119;Masquefa;1;1;D;;584;348;236;0;2;346;348
8;Barcelona;6;Anoia;08119;Masquefa;1;1;E;;541;324;217;1;1;322;323
8;Barcelona;6;Anoia;08119;Masquefa;1;1;F;;460;283;177;0;1;282;283
8;Barcelona;6;Anoia;08119;Masquefa;1;2;A;;580;271;309;2;1;268;269
8;Barcelona;6;Anoia;08119;Masquefa;1;2;B;;593;270;323;0;0;270;270
8;Barcelona;6;Anoia;08119;Masquefa;1;2;C;;605;302;303;3;1;298;299
43;Tarragona;29;Priorat;43082;Masroig, el;1;1;U;;445;385;60;2;1;382;383
25;Lleida;33;Segrià;25131;Massalcoreig;1;1;U;;508;367;141;3;0;364;364
17;Girona;34;Selva;17101;Massanes;1;1;U;;491;312;179;1;4;307;311
25;Lleida;32;Segarra;25132;Massoteres;1;1;U;;159;117;42;0;1;116;117
8;Barcelona;40;Vallès Occidental;08120;Matadepera;1;1;A;;692;548;144;1;4;543;547
8;Barcelona;40;Vallès Occidental;08120;Matadepera;1;1;B;;683;492;191;2;4;486;490
8;Barcelona;40;Vallès Occidental;08120;Matadepera;1;2;A;;789;605;184;0;8;597;605
8;Barcelona;40;Vallès Occidental;08120;Matadepera;1;2;B;;763;566;197;0;5;561;566
8;Barcelona;40;Vallès Occidental;08120;Matadepera;1;3;A;;756;556;200;0;6;550;556
8;Barcelona;40;Vallès Occidental;08120;Matadepera;1;3;B;;855;598;257;0;3;595;598
8;Barcelona;40;Vallès Occidental;08120;Matadepera;1;4;A;;565;427;138;1;2;424;426
8;Barcelona;40;Vallès Occidental;08120;Matadepera;1;4;B;;649;467;182;0;11;456;467
8;Barcelona;21;Maresme;08121;Mataró;1;1;U;;697;474;223;0;6;468;474
8;Barcelona;21;Maresme;08121;Mataró;1;2;A;;438;310;128;0;3;307;310
8;Barcelona;21;Maresme;08121;Mataró;1;2;B;;492;342;150;0;2;340;342
8;Barcelona;21;Maresme;08121;Mataró;1;3;A;;484;364;120;1;2;361;363
8;Barcelona;21;Maresme;08121;Mataró;1;3;B;;458;342;116;0;7;335;342
8;Barcelona;21;Maresme;08121;Mataró;1;4;A;;421;327;94;0;4;323;327
8;Barcelona;21;Maresme;08121;Mataró;1;4;B;;464;353;111;0;0;353;353
8;Barcelona;21;Maresme;08121;Mataró;1;5;A;;601;476;125;0;4;472;476
8;Barcelona;21;Maresme;08121;Mataró;1;5;B;;646;492;154;0;7;485;492
8;Barcelona;21;Maresme;08121;Mataró;1;6;A;;688;525;163;0;4;521;525
8;Barcelona;21;Maresme;08121;Mataró;1;6;B;;502;352;150;0;3;349;352
8;Barcelona;21;Maresme;08121;Mataró;1;6;C;;700;516;184;5;0;511;511
8;Barcelona;21;Maresme;08121;Mataró;1;7;A;;579;431;148;0;1;430;431
8;Barcelona;21;Maresme;08121;Mataró;1;7;B;;631;474;157;2;5;467;472
8;Barcelona;21;Maresme;08121;Mataró;1;8;U;;489;385;104;0;4;381;385
8;Barcelona;21;Maresme;08121;Mataró;2;1;A;;713;520;193;1;8;511;519
8;Barcelona;21;Maresme;08121;Mataró;2;1;B;;774;565;209;1;3;561;564
8;Barcelona;21;Maresme;08121;Mataró;2;10;U;;886;627;259;0;9;618;627
8;Barcelona;21;Maresme;08121;Mataró;2;11;A;;506;355;151;2;6;347;353
8;Barcelona;21;Maresme;08121;Mataró;2;11;B;;480;353;127;3;3;347;350
8;Barcelona;21;Maresme;08121;Mataró;2;12;U;;861;616;245;1;6;609;615
8;Barcelona;21;Maresme;08121;Mataró;2;2;U;;866;572;294;0;2;570;572
8;Barcelona;21;Maresme;08121;Mataró;2;3;U;;736;468;268;2;4;462;466
8;Barcelona;21;Maresme;08121;Mataró;2;4;U;;569;309;260;1;6;302;308
8;Barcelona;21;Maresme;08121;Mataró;2;5;A;;715;465;250;2;8;455;463
8;Barcelona;21;Maresme;08121;Mataró;2;5;B;;780;501;279;0;4;497;501
8;Barcelona;21;Maresme;08121;Mataró;2;6;A;;515;331;184;3;2;326;328
8;Barcelona;21;Maresme;08121;Mataró;2;6;B;;622;348;274;1;1;346;347
8;Barcelona;21;Maresme;08121;Mataró;2;7;U;;561;383;178;0;0;383;383
8;Barcelona;21;Maresme;08121;Mataró;2;8;A;;635;421;214;0;8;413;421
8;Barcelona;21;Maresme;08121;Mataró;2;8;B;;624;449;175;0;4;445;449
8;Barcelona;21;Maresme;08121;Mataró;2;9;A;;430;320;110;1;1;318;319
8;Barcelona;21;Maresme;08121;Mataró;2;9;B;;552;397;155;1;0;396;396
8;Barcelona;21;Maresme;08121;Mataró;3;1;A;;469;286;183;1;8;277;285
8;Barcelona;21;Maresme;08121;Mataró;3;1;B;;568;345;223;2;4;339;343
8;Barcelona;21;Maresme;08121;Mataró;3;10;U;;596;449;147;1;3;445;448
8;Barcelona;21;Maresme;08121;Mataró;3;11;A;;509;341;168;1;4;336;340
8;Barcelona;21;Maresme;08121;Mataró;3;11;B;;622;409;213;0;4;405;409
8;Barcelona;21;Maresme;08121;Mataró;3;12;A;;480;306;174;0;3;303;306
8;Barcelona;21;Maresme;08121;Mataró;3;12;B;;600;389;211;0;2;387;389
8;Barcelona;21;Maresme;08121;Mataró;3;13;A;;582;372;210;2;6;364;370
8;Barcelona;21;Maresme;08121;Mataró;3;13;B;;712;425;287;1;8;416;424
8;Barcelona;21;Maresme;08121;Mataró;3;13;C;;706;405;301;2;1;402;403
8;Barcelona;21;Maresme;08121;Mataró;3;14;A;;453;282;171;0;2;280;282
8;Barcelona;21;Maresme;08121;Mataró;3;14;B;;559;352;207;0;4;348;352
8;Barcelona;21;Maresme;08121;Mataró;3;2;A;;529;320;209;2;1;317;318
8;Barcelona;21;Maresme;08121;Mataró;3;2;B;;613;373;240;2;2;369;371
8;Barcelona;21;Maresme;08121;Mataró;3;3;A;;493;273;220;2;1;270;271
8;Barcelona;21;Maresme;08121;Mataró;3;3;B;;586;353;233;0;2;351;353
8;Barcelona;21;Maresme;08121;Mataró;3;4;A;;409;205;204;0;1;204;205
8;Barcelona;21;Maresme;08121;Mataró;3;4;B;;575;297;278;0;2;295;297
8;Barcelona;21;Maresme;08121;Mataró;3;4;C;;552;303;249;0;2;301;303
8;Barcelona;21;Maresme;08121;Mataró;3;5;A;;547;280;267;0;3;277;280
8;Barcelona;21;Maresme;08121;Mataró;3;5;B;;699;363;336;1;2;360;362
8;Barcelona;21;Maresme;08121;Mataró;3;6;A;;540;304;236;1;0;303;303
8;Barcelona;21;Maresme;08121;Mataró;3;6;B;;649;386;263;1;2;383;385
8;Barcelona;21;Maresme;08121;Mataró;3;7;A;;438;244;194;0;5;239;244
8;Barcelona;21;Maresme;08121;Mataró;3;7;B;;560;341;219;0;6;335;341
8;Barcelona;21;Maresme;08121;Mataró;3;8;A;;411;225;186;2;0;223;223
8;Barcelona;21;Maresme;08121;Mataró;3;8;B;;527;302;225;0;4;298;302
8;Barcelona;21;Maresme;08121;Mataró;3;9;A;;563;338;225;0;1;337;338
8;Barcelona;21;Maresme;08121;Mataró;3;9;B;;582;359;223;0;3;356;359
8;Barcelona;21;Maresme;08121;Mataró;3;9;C;;647;357;290;0;2;355;357
8;Barcelona;21;Maresme;08121;Mataró;4;1;A;;479;295;184;1;2;292;294
8;Barcelona;21;Maresme;08121;Mataró;4;1;B;;515;353;162;0;5;348;353
8;Barcelona;21;Maresme;08121;Mataró;4;2;A;;491;267;224;1;2;264;266
8;Barcelona;21;Maresme;08121;Mataró;4;2;B;;619;351;268;1;0;350;350
8;Barcelona;21;Maresme;08121;Mataró;4;3;U;;800;477;323;1;2;474;476
8;Barcelona;21;Maresme;08121;Mataró;4;4;A;;545;295;250;1;3;291;294
8;Barcelona;21;Maresme;08121;Mataró;4;4;B;;687;392;295;0;4;388;392
8;Barcelona;21;Maresme;08121;Mataró;4;4;C;;675;354;321;1;4;349;353
8;Barcelona;21;Maresme;08121;Mataró;4;5;A;;789;473;316;3;6;464;470
8;Barcelona;21;Maresme;08121;Mataró;4;5;B;;1070;613;457;2;2;609;611
8;Barcelona;21;Maresme;08121;Mataró;4;6;A;;663;394;269;1;8;385;393
8;Barcelona;21;Maresme;08121;Mataró;4;6;B;;825;505;320;3;9;493;502
8;Barcelona;21;Maresme;08121;Mataró;4;6;C;;819;503;316;3;5;495;500
8;Barcelona;21;Maresme;08121;Mataró;4;7;U;;950;502;448;0;5;497;502
8;Barcelona;21;Maresme;08121;Mataró;5;1;A;;538;329;209;0;1;328;329
8;Barcelona;21;Maresme;08121;Mataró;5;1;B;;665;391;274;1;3;387;390
8;Barcelona;21;Maresme;08121;Mataró;5;1;C;;621;356;265;0;4;352;356
8;Barcelona;21;Maresme;08121;Mataró;5;10;U;;419;238;181;0;2;236;238
8;Barcelona;21;Maresme;08121;Mataró;5;11;A;;587;322;265;1;5;316;321
8;Barcelona;21;Maresme;08121;Mataró;5;11;B;;700;377;323;2;4;371;375
8;Barcelona;21;Maresme;08121;Mataró;5;12;A;;505;279;226;0;1;278;279
8;Barcelona;21;Maresme;08121;Mataró;5;12;B;;583;344;239;0;1;343;344
8;Barcelona;21;Maresme;08121;Mataró;5;13;A;;454;274;180;0;2;272;274
8;Barcelona;21;Maresme;08121;Mataró;5;13;B;;563;319;244;0;0;319;319
8;Barcelona;21;Maresme;08121;Mataró;5;13;C;;534;319;215;2;1;316;317
8;Barcelona;21;Maresme;08121;Mataró;5;14;U;;571;307;264;0;2;305;307
8;Barcelona;21;Maresme;08121;Mataró;5;15;U;;854;484;370;0;5;479;484
8;Barcelona;21;Maresme;08121;Mataró;5;16;A;;495;259;236;0;4;255;259
8;Barcelona;21;Maresme;08121;Mataró;5;16;B;;488;246;242;1;0;245;245
8;Barcelona;21;Maresme;08121;Mataró;5;17;U;;719;383;336;3;6;374;380
8;Barcelona;21;Maresme;08121;Mataró;5;18;U;;395;219;176;0;2;217;219
8;Barcelona;21;Maresme;08121;Mataró;5;19;U;;702;387;315;1;7;379;386
8;Barcelona;21;Maresme;08121;Mataró;5;2;A;;685;359;326;0;3;356;359
8;Barcelona;21;Maresme;08121;Mataró;5;2;B;;710;411;299;1;6;404;410
8;Barcelona;21;Maresme;08121;Mataró;5;20;A;;518;268;250;1;3;264;267
8;Barcelona;21;Maresme;08121;Mataró;5;20;B;;605;322;283;0;2;320;322
8;Barcelona;21;Maresme;08121;Mataró;5;21;U;;688;403;285;1;4;398;402
8;Barcelona;21;Maresme;08121;Mataró;5;3;A;;612;312;300;0;3;309;312
8;Barcelona;21;Maresme;08121;Mataró;5;3;B;;709;371;338;1;8;362;370
8;Barcelona;21;Maresme;08121;Mataró;5;4;A;;457;250;207;0;4;246;250
8;Barcelona;21;Maresme;08121;Mataró;5;4;B;;559;327;232;0;6;321;327
8;Barcelona;21;Maresme;08121;Mataró;5;5;U;;692;387;305;0;1;386;387
8;Barcelona;21;Maresme;08121;Mataró;5;6;A;;566;274;292;1;2;271;273
8;Barcelona;21;Maresme;08121;Mataró;5;6;B;;668;317;351;1;1;315;316
8;Barcelona;21;Maresme;08121;Mataró;5;7;A;;590;313;277;1;3;309;312
8;Barcelona;21;Maresme;08121;Mataró;5;7;B;;645;311;334;1;6;304;310
8;Barcelona;21;Maresme;08121;Mataró;5;8;A;;429;217;212;0;2;215;217
8;Barcelona;21;Maresme;08121;Mataró;5;8;B;;527;294;233;1;4;289;293
8;Barcelona;21;Maresme;08121;Mataró;5;9;U;;822;451;371;3;2;446;448
8;Barcelona;21;Maresme;08121;Mataró;6;1;A;;709;470;239;0;5;465;470
8;Barcelona;21;Maresme;08121;Mataró;6;1;B;;896;608;288;1;4;603;607
8;Barcelona;21;Maresme;08121;Mataró;6;10;A;;615;396;219;0;0;396;396
8;Barcelona;21;Maresme;08121;Mataró;6;10;B;;615;383;232;0;4;379;383
8;Barcelona;21;Maresme;08121;Mataró;6;10;C;;688;411;277;0;4;407;411
8;Barcelona;21;Maresme;08121;Mataró;6;11;A;;623;425;198;0;3;422;425
8;Barcelona;21;Maresme;08121;Mataró;6;11;B;;648;417;231;0;4;413;417
8;Barcelona;21;Maresme;08121;Mataró;6;11;C;;826;542;284;3;2;537;539
8;Barcelona;21;Maresme;08121;Mataró;6;12;A;;458;279;179;0;2;277;279
8;Barcelona;21;Maresme;08121;Mataró;6;12;B;;551;342;209;1;1;340;341
8;Barcelona;21;Maresme;08121;Mataró;6;12;C;;541;299;242;0;0;299;299
8;Barcelona;21;Maresme;08121;Mataró;6;13;U;;885;545;340;1;2;542;544
8;Barcelona;21;Maresme;08121;Mataró;6;2;U;;650;476;174;1;3;472;475
8;Barcelona;21;Maresme;08121;Mataró;6;3;A;;571;429;142;0;1;428;429
8;Barcelona;21;Maresme;08121;Mataró;6;3;B;;633;452;181;0;3;449;452
8;Barcelona;21;Maresme;08121;Mataró;6;4;A;;538;390;148;0;2;388;390
8;Barcelona;21;Maresme;08121;Mataró;6;4;B;;570;409;161;1;3;405;408
8;Barcelona;21;Maresme;08121;Mataró;6;5;A;;756;484;272;3;1;480;481
8;Barcelona;21;Maresme;08121;Mataró;6;5;B;;774;476;298;1;2;473;475
8;Barcelona;21;Maresme;08121;Mataró;6;6;A;;647;455;192;1;7;447;454
8;Barcelona;21;Maresme;08121;Mataró;6;6;B;;666;452;214;3;3;446;449
8;Barcelona;21;Maresme;08121;Mataró;6;7;A;;611;378;233;0;2;376;378
8;Barcelona;21;Maresme;08121;Mataró;6;7;B;;718;496;222;0;8;488;496
8;Barcelona;21;Maresme;08121;Mataró;6;8;A;;682;441;241;1;1;439;440
8;Barcelona;21;Maresme;08121;Mataró;6;8;B;;730;481;249;1;6;474;480
8;Barcelona;21;Maresme;08121;Mataró;6;9;A;;367;190;177;0;1;189;190
8;Barcelona;21;Maresme;08121;Mataró;6;9;B;;431;219;212;1;2;216;218
8;Barcelona;3;Alt Penedès;08122;Mediona;1;1;U;;1410;952;458;0;10;942;952
25;Lleida;23;Noguera;25134;Menàrguens;1;1;U;;701;487;214;1;2;484;486
17;Girona;15;Cerdanya;17099;Meranges;1;1;U;;79;58;21;0;0;58;58
17;Girona;19;Garrotxa;17105;Mieres;1;1;U;;266;204;62;1;2;201;203
43;Tarragona;1;Alt Camp;43083;Milà, el;1;1;U;;151;119;32;0;2;117;119
25;Lleida;27;Pla d'Urgell;25135;Miralcamp;1;1;U;;1052;784;268;3;10;771;781
43;Tarragona;30;Ribera d'Ebre;43084;Miravet;1;1;U;;644;486;158;2;0;484;484
8;Barcelona;;;08138;Moià;1;1;A;;649;472;177;1;2;469;471
8;Barcelona;;;08138;Moià;1;1;B;;684;507;177;3;4;500;504
8;Barcelona;;;08138;Moià;1;2;A;;693;475;218;1;3;471;474
8;Barcelona;;;08138;Moià;1;2;B;;804;553;251;0;4;549;553
8;Barcelona;;;08138;Moià;1;3;U;;716;525;191;0;4;521;525
43;Tarragona;29;Priorat;43085;Molar, el;1;1;U;;248;199;49;0;3;196;199
8;Barcelona;11;Baix Llobregat;08123;Molins de Rei;1;1;A;;448;315;133;0;0;315;315
8;Barcelona;11;Baix Llobregat;08123;Molins de Rei;1;1;B;;529;341;188;2;6;333;339
8;Barcelona;11;Baix Llobregat;08123;Molins de Rei;1;2;A;;584;405;179;0;7;398;405
8;Barcelona;11;Baix Llobregat;08123;Molins de Rei;1;2;B;;783;494;289;1;3;490;493
8;Barcelona;11;Baix Llobregat;08123;Molins de Rei;1;3;A;;677;472;205;0;4;468;472
8;Barcelona;11;Baix Llobregat;08123;Molins de Rei;1;3;B;;762;502;260;0;3;499;502
8;Barcelona;11;Baix Llobregat;08123;Molins de Rei;2;1;A;;944;597;347;0;4;593;597
8;Barcelona;11;Baix Llobregat;08123;Molins de Rei;2;1;B;;1068;714;354;1;6;707;713
8;Barcelona;11;Baix Llobregat;08123;Molins de Rei;2;2;A;;524;374;150;0;3;371;374
8;Barcelona;11;Baix Llobregat;08123;Molins de Rei;2;2;B;;547;386;161;3;2;381;383
8;Barcelona;11;Baix Llobregat;08123;Molins de Rei;2;3;A;;545;378;167;2;3;373;376
8;Barcelona;11;Baix Llobregat;08123;Molins de Rei;2;3;B;;598;402;196;1;3;398;401
8;Barcelona;11;Baix Llobregat;08123;Molins de Rei;2;3;C;;673;459;214;3;4;452;456
8;Barcelona;11;Baix Llobregat;08123;Molins de Rei;2;4;U;;1169;705;464;2;8;695;703
8;Barcelona;11;Baix Llobregat;08123;Molins de Rei;3;1;A;;677;457;220;2;8;447;455
8;Barcelona;11;Baix Llobregat;08123;Molins de Rei;3;1;B;;697;447;250;3;6;438;444
8;Barcelona;11;Baix Llobregat;08123;Molins de Rei;3;1;C;;779;544;235;0;5;539;544
8;Barcelona;11;Baix Llobregat;08123;Molins de Rei;3;2;A;;744;544;200;0;3;541;544
8;Barcelona;11;Baix Llobregat;08123;Molins de Rei;3;2;B;;628;453;175;0;2;451;453
8;Barcelona;11;Baix Llobregat;08123;Molins de Rei;3;2;C;;766;561;205;0;4;557;561
8;Barcelona;11;Baix Llobregat;08123;Molins de Rei;3;3;A;;598;428;170;2;3;423;426
8;Barcelona;11;Baix Llobregat;08123;Molins de Rei;3;3;B;;777;527;250;0;7;520;527
8;Barcelona;11;Baix Llobregat;08123;Molins de Rei;3;4;A;;788;520;268;1;0;519;519
8;Barcelona;11;Baix Llobregat;08123;Molins de Rei;3;4;B;;958;602;356;2;5;595;600
8;Barcelona;11;Baix Llobregat;08123;Molins de Rei;4;1;U;;843;512;331;0;8;504;512
25;Lleida;27;Pla d'Urgell;25137;Mollerussa;1;1;A;;831;601;230;2;6;593;599
25;Lleida;27;Pla d'Urgell;25137;Mollerussa;1;1;B;;878;635;243;1;8;626;634
25;Lleida;27;Pla d'Urgell;25137;Mollerussa;1;2;A;;747;540;207;5;2;533;535
25;Lleida;27;Pla d'Urgell;25137;Mollerussa;1;2;B;;868;631;237;3;3;625;628
25;Lleida;27;Pla d'Urgell;25137;Mollerussa;1;3;U;;911;611;300;8;3;600;603
25;Lleida;27;Pla d'Urgell;25137;Mollerussa;1;4;A;;534;358;176;2;6;350;356
25;Lleida;27;Pla d'Urgell;25137;Mollerussa;1;4;B;;740;493;247;0;6;487;493
25;Lleida;27;Pla d'Urgell;25137;Mollerussa;1;5;A;;492;361;131;0;1;360;361
25;Lleida;27;Pla d'Urgell;25137;Mollerussa;1;5;B;;652;450;202;3;7;440;447
25;Lleida;27;Pla d'Urgell;25137;Mollerussa;1;6;A;;561;356;205;1;5;350;355
25;Lleida;27;Pla d'Urgell;25137;Mollerussa;1;6;B;;683;459;224;0;4;455;459
8;Barcelona;41;Vallès Oriental;08124;Mollet del Vallès;1;1;U;;605;351;254;1;2;348;350
8;Barcelona;41;Vallès Oriental;08124;Mollet del Vallès;1;2;A;;642;347;295;0;4;343;347
8;Barcelona;41;Vallès Oriental;08124;Mollet del Vallès;1;2;B;;739;426;313;0;1;425;426
8;Barcelona;41;Vallès Oriental;08124;Mollet del Vallès;1;3;A;;438;240;198;0;3;237;240
8;Barcelona;41;Vallès Oriental;08124;Mollet del Vallès;1;3;B;;472;276;196;0;4;272;276
8;Barcelona;41;Vallès Oriental;08124;Mollet del Vallès;1;3;C;;543;328;215;0;2;326;328
8;Barcelona;41;Vallès Oriental;08124;Mollet del Vallès;1;4;A;;723;466;257;4;3;459;462
8;Barcelona;41;Vallès Oriental;08124;Mollet del Vallès;1;4;B;;882;583;299;1;2;580;582
8;Barcelona;41;Vallès Oriental;08124;Mollet del Vallès;1;5;A;;645;366;279;0;5;361;366
8;Barcelona;41;Vallès Oriental;08124;Mollet del Vallès;1;5;B;;819;438;381;1;0;437;437
8;Barcelona;41;Vallès Oriental;08124;Mollet del Vallès;1;6;A;;537;329;208;0;2;327;329
8;Barcelona;41;Vallès Oriental;08124;Mollet del Vallès;1;6;B;;505;295;210;0;3;292;295
8;Barcelona;41;Vallès Oriental;08124;Mollet del Vallès;1;6;C;;557;324;233;0;5;319;324
8;Barcelona;41;Vallès Oriental;08124;Mollet del Vallès;1;7;A;;583;301;282;1;2;298;300
8;Barcelona;41;Vallès Oriental;08124;Mollet del Vallès;1;7;B;;684;320;364;1;2;317;319
8;Barcelona;41;Vallès Oriental;08124;Mollet del Vallès;2;1;A;;477;280;197;0;2;278;280
8;Barcelona;41;Vallès Oriental;08124;Mollet del Vallès;2;1;B;;535;308;227;0;3;305;308
8;Barcelona;41;Vallès Oriental;08124;Mollet del Vallès;2;1;C;;590;374;216;1;3;370;373
8;Barcelona;41;Vallès Oriental;08124;Mollet del Vallès;2;2;A;;614;387;227;0;4;383;387
8;Barcelona;41;Vallès Oriental;08124;Mollet del Vallès;2;2;B;;757;457;300;0;4;453;457
8;Barcelona;41;Vallès Oriental;08124;Mollet del Vallès;2;3;A;;765;459;306;0;1;458;459
8;Barcelona;41;Vallès Oriental;08124;Mollet del Vallès;2;3;B;;896;479;417;1;5;473;478
8;Barcelona;41;Vallès Oriental;08124;Mollet del Vallès;2;4;A;;570;318;252;3;1;314;315
8;Barcelona;41;Vallès Oriental;08124;Mollet del Vallès;2;4;B;;579;338;241;1;6;331;337
8;Barcelona;41;Vallès Oriental;08124;Mollet del Vallès;2;5;A;;431;247;184;1;3;243;246
8;Barcelona;41;Vallès Oriental;08124;Mollet del Vallès;2;5;B;;595;345;250;0;1;344;345
8;Barcelona;41;Vallès Oriental;08124;Mollet del Vallès;2;6;A;;464;250;214;1;2;247;249
8;Barcelona;41;Vallès Oriental;08124;Mollet del Vallès;2;6;B;;553;296;257;0;7;289;296
8;Barcelona;41;Vallès Oriental;08124;Mollet del Vallès;2;7;A;;752;379;373;0;5;374;379
8;Barcelona;41;Vallès Oriental;08124;Mollet del Vallès;2;7;B;;910;427;483;0;3;424;427
8;Barcelona;41;Vallès Oriental;08124;Mollet del Vallès;2;8;A;;577;385;192;1;4;380;384
8;Barcelona;41;Vallès Oriental;08124;Mollet del Vallès;2;8;B;;681;455;226;0;2;453;455
8;Barcelona;41;Vallès Oriental;08124;Mollet del Vallès;3;1;A;;586;352;234;0;3;349;352
8;Barcelona;41;Vallès Oriental;08124;Mollet del Vallès;3;1;B;;572;325;247;0;1;324;325
8;Barcelona;41;Vallès Oriental;08124;Mollet del Vallès;3;1;C;;625;363;262;1;5;357;362
8;Barcelona;41;Vallès Oriental;08124;Mollet del Vallès;3;10;U;;841;398;443;1;4;393;397
8;Barcelona;41;Vallès Oriental;08124;Mollet del Vallès;3;11;A;;1086;590;496;0;4;586;590
8;Barcelona;41;Vallès Oriental;08124;Mollet del Vallès;3;11;B;;1288;629;659;0;4;625;629
8;Barcelona;41;Vallès Oriental;08124;Mollet del Vallès;3;12;A;;662;341;321;0;7;334;341
8;Barcelona;41;Vallès Oriental;08124;Mollet del Vallès;3;12;B;;724;393;331;0;6;387;393
8;Barcelona;41;Vallès Oriental;08124;Mollet del Vallès;3;13;A;;624;330;294;0;3;327;330
8;Barcelona;41;Vallès Oriental;08124;Mollet del Vallès;3;13;B;;730;379;351;1;1;377;378
8;Barcelona;41;Vallès Oriental;08124;Mollet del Vallès;3;13;C;;677;371;306;0;4;367;371
8;Barcelona;41;Vallès Oriental;08124;Mollet del Vallès;3;2;A;;717;404;313;0;1;403;404
8;Barcelona;41;Vallès Oriental;08124;Mollet del Vallès;3;2;B;;767;453;314;1;4;448;452
8;Barcelona;41;Vallès Oriental;08124;Mollet del Vallès;3;3;A;;438;286;152;1;3;282;285
8;Barcelona;41;Vallès Oriental;08124;Mollet del Vallès;3;3;B;;456;299;157;2;0;297;297
8;Barcelona;41;Vallès Oriental;08124;Mollet del Vallès;3;4;A;;672;393;279;2;5;386;391
8;Barcelona;41;Vallès Oriental;08124;Mollet del Vallès;3;4;B;;780;477;303;1;3;473;476
8;Barcelona;41;Vallès Oriental;08124;Mollet del Vallès;3;5;A;;704;445;259;0;1;444;445
8;Barcelona;41;Vallès Oriental;08124;Mollet del Vallès;3;5;B;;881;576;305;1;5;570;575
8;Barcelona;41;Vallès Oriental;08124;Mollet del Vallès;3;6;A;;543;279;264;1;3;275;278
8;Barcelona;41;Vallès Oriental;08124;Mollet del Vallès;3;6;B;;595;283;312;1;2;280;282
8;Barcelona;41;Vallès Oriental;08124;Mollet del Vallès;3;7;A;;419;218;201;0;2;216;218
8;Barcelona;41;Vallès Oriental;08124;Mollet del Vallès;3;7;B;;544;256;288;1;1;254;255
8;Barcelona;41;Vallès Oriental;08124;Mollet del Vallès;3;7;C;;596;286;310;0;4;282;286
8;Barcelona;41;Vallès Oriental;08124;Mollet del Vallès;3;8;U;;716;407;309;0;2;405;407
8;Barcelona;41;Vallès Oriental;08124;Mollet del Vallès;3;9;A;;347;194;153;0;1;193;194
8;Barcelona;41;Vallès Oriental;08124;Mollet del Vallès;3;9;B;;475;290;185;0;2;288;290
17;Girona;2;Alt Empordà;17106;Mollet de Peralada;1;1;U;;148;113;35;1;1;111;112
17;Girona;31;Ripollès;17107;Molló;1;1;U;;307;234;73;2;1;231;232
25;Lleida;35;Solsonès;25136;Molsosa, la;1;1;U;;115;91;24;0;1;90;91
8;Barcelona;;;08128;Monistrol de Calders;1;1;U;;526;407;119;0;3;404;407
8;Barcelona;7;Bages;08127;Monistrol de Montserrat;1;1;U;;694;497;197;1;8;488;496
8;Barcelona;7;Bages;08127;Monistrol de Montserrat;1;2;A;;690;445;245;2;2;441;443
8;Barcelona;7;Bages;08127;Monistrol de Montserrat;1;2;B;;745;487;258;1;4;482;486
17;Girona;19;Garrotxa;17109;Montagut i Oix;1;1;U;;695;462;233;2;3;457;460
43;Tarragona;16;Conca de Barberà;43086;Montblanc;1;1;U;;644;405;239;2;3;400;403
43;Tarragona;16;Conca de Barberà;43086;Montblanc;1;2;U;;587;336;251;0;6;330;336
43;Tarragona;16;Conca de Barberà;43086;Montblanc;2;1;A;;634;411;223;1;4;406;410
43;Tarragona;16;Conca de Barberà;43086;Montblanc;2;1;B;;686;454;232;1;4;449;453
43;Tarragona;16;Conca de Barberà;43086;Montblanc;2;2;A;;649;445;204;2;1;442;443
43;Tarragona;16;Conca de Barberà;43086;Montblanc;2;2;B;;868;564;304;2;2;560;562
43;Tarragona;16;Conca de Barberà;43086;Montblanc;2;3;A;;461;320;141;4;1;315;316
43;Tarragona;16;Conca de Barberà;43086;Montblanc;2;3;B;;577;387;190;1;0;386;386
43;Tarragona;8;Baix Camp;43088;Montbrió del Camp;1;1;A;;628;464;164;2;7;455;462
43;Tarragona;8;Baix Camp;43088;Montbrió del Camp;1;1;B;;615;459;156;1;2;456;458
8;Barcelona;40;Vallès Occidental;08125;Montcada i Reixac;1;1;U;;886;564;322;0;3;561;564
8;Barcelona;40;Vallès Occidental;08125;Montcada i Reixac;1;2;U;;1065;772;293;2;5;765;770
8;Barcelona;40;Vallès Occidental;08125;Montcada i Reixac;1;4;A;;607;350;257;1;2;347;349
8;Barcelona;40;Vallès Occidental;08125;Montcada i Reixac;1;4;B;;630;386;244;0;2;384;386
8;Barcelona;40;Vallès Occidental;08125;Montcada i Reixac;1;5;A;;563;355;208;0;6;349;355
8;Barcelona;40;Vallès Occidental;08125;Montcada i Reixac;1;5;B;;667;435;232;0;3;432;435
8;Barcelona;40;Vallès Occidental;08125;Montcada i Reixac;2;1;A;;665;310;355;0;4;306;310
8;Barcelona;40;Vallès Occidental;08125;Montcada i Reixac;2;1;B;;707;330;377;0;1;329;330
8;Barcelona;40;Vallès Occidental;08125;Montcada i Reixac;2;2;A;;808;469;339;1;1;467;468
8;Barcelona;40;Vallès Occidental;08125;Montcada i Reixac;2;2;B;;953;567;386;0;2;565;567
8;Barcelona;40;Vallès Occidental;08125;Montcada i Reixac;2;3;A;;814;557;257;1;3;553;556
8;Barcelona;40;Vallès Occidental;08125;Montcada i Reixac;2;3;B;;955;627;328;0;9;618;627
8;Barcelona;40;Vallès Occidental;08125;Montcada i Reixac;3;1;A;;736;466;270;0;4;462;466
8;Barcelona;40;Vallès Occidental;08125;Montcada i Reixac;3;1;B;;941;572;369;1;4;567;571
8;Barcelona;40;Vallès Occidental;08125;Montcada i Reixac;3;2;A;;593;312;281;0;3;309;312
8;Barcelona;40;Vallès Occidental;08125;Montcada i Reixac;3;2;B;;759;398;361;1;5;392;397
8;Barcelona;40;Vallès Occidental;08125;Montcada i Reixac;3;3;A;;932;551;381;0;7;544;551
8;Barcelona;40;Vallès Occidental;08125;Montcada i Reixac;3;3;B;;1150;649;501;1;7;641;648
8;Barcelona;40;Vallès Occidental;08125;Montcada i Reixac;3;3;C;;1083;666;417;3;9;654;663
8;Barcelona;40;Vallès Occidental;08125;Montcada i Reixac;4;1;A;;951;578;373;0;5;573;578
8;Barcelona;40;Vallès Occidental;08125;Montcada i Reixac;4;1;B;;1192;724;468;0;5;719;724
8;Barcelona;40;Vallès Occidental;08125;Montcada i Reixac;5;1;A;;792;433;359;0;2;431;433
8;Barcelona;40;Vallès Occidental;08125;Montcada i Reixac;5;1;B;;888;463;425;1;4;458;462
8;Barcelona;40;Vallès Occidental;08125;Montcada i Reixac;5;2;U;;1072;606;466;0;15;591;606
8;Barcelona;40;Vallès Occidental;08125;Montcada i Reixac;5;3;U;;1105;505;600;0;1;504;505
8;Barcelona;40;Vallès Occidental;08125;Montcada i Reixac;6;1;A;;1096;583;513;0;6;577;583
8;Barcelona;40;Vallès Occidental;08125;Montcada i Reixac;6;1;B;;1246;674;572;0;12;662;674
8;Barcelona;14;Berguedà;08130;Montclar;1;1;U;;96;71;25;0;0;71;71
25;Lleida;15;Cerdanya;25139;Montellà i Martinet;1;1;U;;473;317;156;1;3;313;316
8;Barcelona;24;Osona;08131;Montesquiu;1;1;U;;699;525;174;1;2;522;524
25;Lleida;4;Alt Urgell;25140;Montferrer i Castellbò;1;1;U;;675;450;225;3;3;444;447
43;Tarragona;1;Alt Camp;43089;Montferri;1;1;U;;147;101;46;0;0;101;101
25;Lleida;23;Noguera;25138;Montgai;1;1;A;;450;365;85;2;3;360;363
25;Lleida;23;Noguera;25138;Montgai;1;1;B;;231;177;54;1;2;174;176
8;Barcelona;21;Maresme;08126;Montgat;1;1;A;;646;411;235;1;3;407;410
8;Barcelona;21;Maresme;08126;Montgat;1;1;B;;813;483;330;1;2;480;482
8;Barcelona;21;Maresme;08126;Montgat;1;2;A;;515;292;223;1;5;286;291
8;Barcelona;21;Maresme;08126;Montgat;1;2;B;;633;383;250;0;0;383;383
8;Barcelona;21;Maresme;08126;Montgat;1;2;C;;692;423;269;1;2;420;422
8;Barcelona;21;Maresme;08126;Montgat;1;3;A;;713;461;252;0;7;454;461
8;Barcelona;21;Maresme;08126;Montgat;1;3;B;;757;492;265;1;5;486;491
8;Barcelona;21;Maresme;08126;Montgat;1;3;C;;871;570;301;1;7;562;569
8;Barcelona;21;Maresme;08126;Montgat;1;4;A;;704;446;258;3;3;440;443
8;Barcelona;21;Maresme;08126;Montgat;1;4;B;;770;467;303;0;2;465;467
8;Barcelona;14;Berguedà;08132;Montmajor;1;1;U;;402;308;94;2;1;305;306
8;Barcelona;6;Anoia;08133;Montmaneu;1;1;U;;181;126;55;0;2;124;126
43;Tarragona;12;Baix Penedès;43090;Montmell, el;1;1;U;;661;313;348;2;2;309;311
8;Barcelona;41;Vallès Oriental;08135;Montmeló;1;1;A;;620;388;232;3;3;382;385
8;Barcelona;41;Vallès Oriental;08135;Montmeló;1;1;B;;765;470;295;1;1;468;469
8;Barcelona;41;Vallès Oriental;08135;Montmeló;1;1;C;;644;398;246;0;1;397;398
8;Barcelona;41;Vallès Oriental;08135;Montmeló;1;2;A;;522;319;203;2;1;316;317
8;Barcelona;41;Vallès Oriental;08135;Montmeló;1;2;B;;703;447;256;3;2;442;444
8;Barcelona;41;Vallès Oriental;08135;Montmeló;1;3;A;;739;487;252;1;4;482;486
8;Barcelona;41;Vallès Oriental;08135;Montmeló;1;3;B;;882;567;315;4;4;559;563
8;Barcelona;41;Vallès Oriental;08135;Montmeló;1;4;U;;966;603;363;0;4;599;603
8;Barcelona;41;Vallès Oriental;08135;Montmeló;1;5;U;;941;607;334;0;5;602;607
25;Lleida;33;Segrià;25142;Montoliu de Lleida;1;1;U;;416;293;123;16;1;276;277
25;Lleida;32;Segarra;25141;Montoliu de Segarra;1;1;U;;179;131;48;1;3;127;130
8;Barcelona;41;Vallès Oriental;08136;Montornès del Vallès;1;1;A;;643;345;298;0;2;343;345
8;Barcelona;41;Vallès Oriental;08136;Montornès del Vallès;1;1;B;;749;367;382;1;1;365;366
8;Barcelona;41;Vallès Oriental;08136;Montornès del Vallès;1;2;A;;401;239;162;0;2;237;239
8;Barcelona;41;Vallès Oriental;08136;Montornès del Vallès;1;2;B;;565;302;263;1;2;299;301
8;Barcelona;41;Vallès Oriental;08136;Montornès del Vallès;1;2;C;;416;221;195;0;0;221;221
8;Barcelona;41;Vallès Oriental;08136;Montornès del Vallès;1;3;A;;550;305;245;0;5;300;305
8;Barcelona;41;Vallès Oriental;08136;Montornès del Vallès;1;3;B;;675;381;294;1;3;377;380
8;Barcelona;41;Vallès Oriental;08136;Montornès del Vallès;1;3;C;;555;332;223;1;3;328;331
8;Barcelona;41;Vallès Oriental;08136;Montornès del Vallès;1;4;A;;554;337;217;1;4;332;336
8;Barcelona;41;Vallès Oriental;08136;Montornès del Vallès;1;4;B;;702;419;283;2;9;408;417
8;Barcelona;41;Vallès Oriental;08136;Montornès del Vallès;1;4;C;;579;350;229;1;4;345;349
8;Barcelona;41;Vallès Oriental;08136;Montornès del Vallès;1;5;A;;558;312;246;3;8;301;309
8;Barcelona;41;Vallès Oriental;08136;Montornès del Vallès;1;5;B;;622;344;278;0;5;339;344
8;Barcelona;41;Vallès Oriental;08136;Montornès del Vallès;1;5;C;;528;318;210;0;4;314;318
8;Barcelona;41;Vallès Oriental;08136;Montornès del Vallès;2;1;A;;333;141;192;0;1;140;141
8;Barcelona;41;Vallès Oriental;08136;Montornès del Vallès;2;1;B;;354;161;193;4;2;155;157
8;Barcelona;41;Vallès Oriental;08136;Montornès del Vallès;2;2;A;;334;179;155;0;0;179;179
8;Barcelona;41;Vallès Oriental;08136;Montornès del Vallès;2;2;B;;435;248;187;0;1;247;248
8;Barcelona;41;Vallès Oriental;08136;Montornès del Vallès;2;3;A;;389;210;179;3;4;203;207
8;Barcelona;41;Vallès Oriental;08136;Montornès del Vallès;2;3;B;;475;240;235;1;1;238;239
25;Lleida;32;Segarra;25143;Montornès de Segarra;1;1;U;;98;73;25;0;0;73;73
43;Tarragona;1;Alt Camp;43091;Mont-ral;1;1;U;;156;111;45;0;0;111;111
17;Girona;10;Baix Empordà;17110;Mont-ras;1;1;A;;655;436;219;0;2;434;436
17;Girona;10;Baix Empordà;17110;Mont-ras;1;1;B;;663;446;217;0;0;446;446
43;Tarragona;8;Baix Camp;43092;Mont-roig del Camp;1;1;A;;503;323;180;2;1;320;321
43;Tarragona;8;Baix Camp;43092;Mont-roig del Camp;1;1;B;;453;295;158;0;1;294;295
43;Tarragona;8;Baix Camp;43092;Mont-roig del Camp;1;2;U;;657;310;347;0;2;308;310
43;Tarragona;8;Baix Camp;43092;Mont-roig del Camp;1;3;A;;537;351;186;3;3;345;348
43;Tarragona;8;Baix Camp;43092;Mont-roig del Camp;1;3;B;;582;400;182;2;0;398;398
43;Tarragona;8;Baix Camp;43092;Mont-roig del Camp;1;4;A;;623;279;344;0;2;277;279
43;Tarragona;8;Baix Camp;43092;Mont-roig del Camp;1;4;B;;690;318;372;0;1;317;318
43;Tarragona;8;Baix Camp;43092;Mont-roig del Camp;1;5;A;;560;291;269;2;2;287;289
43;Tarragona;8;Baix Camp;43092;Mont-roig del Camp;1;5;B;;634;327;307;1;3;323;326
8;Barcelona;41;Vallès Oriental;08137;Montseny;1;1;U;;276;215;61;0;0;215;215
43;Tarragona;30;Ribera d'Ebre;43093;Móra d'Ebre;1;1;A;;659;468;191;0;2;466;468
43;Tarragona;30;Ribera d'Ebre;43093;Móra d'Ebre;1;1;B;;657;472;185;1;4;467;471
43;Tarragona;30;Ribera d'Ebre;43093;Móra d'Ebre;1;2;A;;637;477;160;3;6;468;474
43;Tarragona;30;Ribera d'Ebre;43093;Móra d'Ebre;1;2;B;;645;460;185;0;10;450;460
43;Tarragona;30;Ribera d'Ebre;43093;Móra d'Ebre;2;1;A;;621;448;173;1;1;446;447
43;Tarragona;30;Ribera d'Ebre;43093;Móra d'Ebre;2;1;B;;683;470;213;1;6;463;469
43;Tarragona;30;Ribera d'Ebre;43094;Móra la Nova;1;1;A;;569;435;134;4;2;429;431
43;Tarragona;30;Ribera d'Ebre;43094;Móra la Nova;1;1;B;;665;507;158;0;8;499;507
43;Tarragona;30;Ribera d'Ebre;43094;Móra la Nova;2;1;A;;421;333;88;0;5;328;333
43;Tarragona;30;Ribera d'Ebre;43094;Móra la Nova;2;1;B;;568;426;142;0;0;426;426
43;Tarragona;36;Tarragonès;43095;Morell, el;1;1;A;;934;645;289;8;5;632;637
43;Tarragona;36;Tarragonès;43095;Morell, el;1;1;B;;1004;665;339;2;9;654;663
43;Tarragona;29;Priorat;43096;Morera de Montsant, la;1;1;U;;146;96;50;1;0;95;95
8;Barcelona;24;Osona;08129;Muntanyola;1;1;U;;293;223;70;0;0;223;223
8;Barcelona;7;Bages;08139;Mura;1;1;U;;200;155;45;0;1;154;155
25;Lleida;38;Urgell;25145;Nalec;1;1;U;;90;73;17;0;1;72;73
25;Lleida;39;Consell General d'Aran;25025;Naut Aran;1;1;A;;787;459;328;1;9;449;458
25;Lleida;39;Consell General d'Aran;25025;Naut Aran;1;1;B;;483;310;173;0;4;306;310
8;Barcelona;7;Bages;08140;Navarcles;1;1;A;;647;456;191;3;3;450;453
8;Barcelona;7;Bages;08140;Navarcles;1;1;B;;769;514;255;1;9;504;513
8;Barcelona;7;Bages;08140;Navarcles;1;2;A;;671;507;164;2;5;500;505
8;Barcelona;7;Bages;08140;Navarcles;1;2;B;;761;563;198;0;3;560;563
8;Barcelona;7;Bages;08140;Navarcles;1;3;A;;730;502;228;2;3;497;500
8;Barcelona;7;Bages;08140;Navarcles;1;3;B;;932;606;326;1;4;601;605
8;Barcelona;7;Bages;08141;Navàs;1;1;A;;469;359;110;4;3;352;355
8;Barcelona;7;Bages;08141;Navàs;1;1;B;;524;388;136;1;4;383;387
8;Barcelona;7;Bages;08141;Navàs;1;2;U;;711;504;207;1;1;502;503
8;Barcelona;7;Bages;08141;Navàs;1;3;A;;706;464;242;1;0;463;463
8;Barcelona;7;Bages;08141;Navàs;1;3;B;;869;541;328;1;2;538;540
8;Barcelona;7;Bages;08141;Navàs;1;4;A;;485;340;145;0;4;336;340
8;Barcelona;7;Bages;08141;Navàs;1;4;B;;606;465;141;2;1;462;463
8;Barcelona;7;Bages;08141;Navàs;2;1;U;;235;182;53;0;1;181;182
17;Girona;2;Alt Empordà;17111;Navata;1;1;U;;584;443;141;0;5;438;443
25;Lleida;35;Solsonès;25146;Navès;1;1;U;;241;189;52;2;1;186;187
8;Barcelona;14;Berguedà;08142;Nou de Berguedà, la;1;1;U;;125;101;24;0;2;99;101
43;Tarragona;36;Tarragonès;43097;Nou de Gaià, la;1;1;U;;326;249;77;0;3;246;249
43;Tarragona;1;Alt Camp;43098;Nulles;1;1;U;;323;233;90;0;0;233;233
25;Lleida;35;Solsonès;25148;Odèn;1;1;U;;242;181;61;0;0;181;181
8;Barcelona;6;Anoia;08143;Òdena;1;1;A;;696;467;229;1;1;465;466
8;Barcelona;6;Anoia;08143;Òdena;1;1;B;;791;558;233;2;6;550;556
8;Barcelona;6;Anoia;08143;Òdena;1;2;U;;770;507;263;2;4;501;505
17;Girona;31;Ripollès;17112;Ogassa;1;1;U;;222;164;58;0;0;164;164
8;Barcelona;3;Alt Penedès;08145;Olèrdola;1;1;A;;500;324;176;0;2;322;324
8;Barcelona;3;Alt Penedès;08145;Olèrdola;1;1;B;;619;400;219;1;1;398;399
8;Barcelona;3;Alt Penedès;08145;Olèrdola;1;2;A;;425;341;84;2;2;337;339
8;Barcelona;3;Alt Penedès;08145;Olèrdola;1;2;B;;493;405;88;2;0;403;403
8;Barcelona;3;Alt Penedès;08146;Olesa de Bonesvalls;1;1;A;;463;275;188;2;1;272;273
8;Barcelona;3;Alt Penedès;08146;Olesa de Bonesvalls;1;1;B;;512;314;198;2;2;310;312
8;Barcelona;11;Baix Llobregat;08147;Olesa de Montserrat;1;1;A;;577;319;258;0;0;319;319
8;Barcelona;11;Baix Llobregat;08147;Olesa de Montserrat;1;1;B;;539;294;245;1;3;290;293
8;Barcelona;11;Baix Llobregat;08147;Olesa de Montserrat;1;1;C;;771;429;342;2;4;423;427
8;Barcelona;11;Baix Llobregat;08147;Olesa de Montserrat;1;1;D;;607;337;270;4;4;329;333
8;Barcelona;11;Baix Llobregat;08147;Olesa de Montserrat;1;2;A;;860;502;358;2;5;495;500
8;Barcelona;11;Baix Llobregat;08147;Olesa de Montserrat;1;2;B;;946;555;391;2;10;543;553
8;Barcelona;11;Baix Llobregat;08147;Olesa de Montserrat;1;3;A;;422;296;126;0;4;292;296
8;Barcelona;11;Baix Llobregat;08147;Olesa de Montserrat;1;3;B;;458;304;154;0;3;301;304
8;Barcelona;11;Baix Llobregat;08147;Olesa de Montserrat;1;4;A;;551;401;150;3;3;395;398
8;Barcelona;11;Baix Llobregat;08147;Olesa de Montserrat;1;4;B;;522;338;184;1;4;333;337
8;Barcelona;11;Baix Llobregat;08147;Olesa de Montserrat;1;4;C;;512;353;159;0;2;351;353
8;Barcelona;11;Baix Llobregat;08147;Olesa de Montserrat;1;5;A;;689;441;248;1;5;435;440
8;Barcelona;11;Baix Llobregat;08147;Olesa de Montserrat;1;5;B;;846;498;348;0;8;490;498
8;Barcelona;11;Baix Llobregat;08147;Olesa de Montserrat;1;5;C;;636;383;253;0;5;378;383
8;Barcelona;11;Baix Llobregat;08147;Olesa de Montserrat;1;6;A;;694;427;267;3;4;420;424
8;Barcelona;11;Baix Llobregat;08147;Olesa de Montserrat;1;6;B;;817;476;341;2;3;471;474
8;Barcelona;11;Baix Llobregat;08147;Olesa de Montserrat;1;6;C;;703;405;298;1;4;400;404
8;Barcelona;11;Baix Llobregat;08147;Olesa de Montserrat;1;7;A;;639;411;228;1;4;406;410
8;Barcelona;11;Baix Llobregat;08147;Olesa de Montserrat;1;7;B;;830;505;325;2;6;497;503
8;Barcelona;11;Baix Llobregat;08147;Olesa de Montserrat;1;8;A;;498;349;149;2;0;347;347
8;Barcelona;11;Baix Llobregat;08147;Olesa de Montserrat;1;8;B;;512;339;173;4;0;335;335
8;Barcelona;11;Baix Llobregat;08147;Olesa de Montserrat;1;8;C;;507;345;162;2;1;342;343
8;Barcelona;11;Baix Llobregat;08147;Olesa de Montserrat;1;9;A;;581;343;238;1;3;339;342
8;Barcelona;11;Baix Llobregat;08147;Olesa de Montserrat;1;9;B;;636;361;275;1;5;355;360
25;Lleida;4;Alt Urgell;25149;Oliana;1;1;A;;721;529;192;5;1;523;524
25;Lleida;4;Alt Urgell;25149;Oliana;1;1;B;;852;682;170;2;5;675;680
25;Lleida;23;Noguera;25150;Oliola;1;1;U;;255;194;61;0;4;190;194
25;Lleida;35;Solsonès;25151;Olius;1;1;U;;468;360;108;0;1;359;360
8;Barcelona;17;Garraf;08148;Olivella;1;1;A;;633;345;288;0;3;342;345
8;Barcelona;17;Garraf;08148;Olivella;1;1;B;;741;395;346;0;4;391;395
8;Barcelona;24;Osona;08149;Olost;1;1;A;;432;330;102;0;2;328;330
8;Barcelona;24;Osona;08149;Olost;1;1;B;;558;459;99;4;1;454;455
17;Girona;19;Garrotxa;17114;Olot;1;1;A;;454;254;200;0;2;252;254
17;Girona;19;Garrotxa;17114;Olot;1;1;B;;297;170;127;0;1;169;170
17;Girona;19;Garrotxa;17114;Olot;1;1;C;;399;257;142;0;2;255;257
17;Girona;19;Garrotxa;17114;Olot;1;2;A;;389;242;147;0;1;241;242
17;Girona;19;Garrotxa;17114;Olot;1;2;B;;389;265;124;0;3;262;265
17;Girona;19;Garrotxa;17114;Olot;1;3;A;;375;266;109;1;1;264;265
17;Girona;19;Garrotxa;17114;Olot;1;3;B;;380;281;99;1;3;277;280
17;Girona;19;Garrotxa;17114;Olot;1;4;A;;392;280;112;0;0;280;280
17;Girona;19;Garrotxa;17114;Olot;1;4;B;;333;249;84;2;1;246;247
17;Girona;19;Garrotxa;17114;Olot;1;5;U;;620;486;134;2;8;476;484
17;Girona;19;Garrotxa;17114;Olot;1;6;U;;578;424;154;1;3;420;423
17;Girona;19;Garrotxa;17114;Olot;1;7;A;;570;416;154;1;7;408;415
17;Girona;19;Garrotxa;17114;Olot;1;7;B;;550;406;144;0;3;403;406
17;Girona;19;Garrotxa;17114;Olot;2;1;A;;612;438;174;3;3;432;435
17;Girona;19;Garrotxa;17114;Olot;2;1;B;;380;251;129;1;0;250;250
17;Girona;19;Garrotxa;17114;Olot;2;1;C;;590;412;178;4;3;405;408
17;Girona;19;Garrotxa;17114;Olot;2;2;A;;575;404;171;1;1;402;403
17;Girona;19;Garrotxa;17114;Olot;2;2;B;;441;281;160;1;2;278;280
17;Girona;19;Garrotxa;17114;Olot;2;2;C;;599;439;160;5;6;428;434
17;Girona;19;Garrotxa;17114;Olot;2;3;A;;480;317;163;0;3;314;317
17;Girona;19;Garrotxa;17114;Olot;2;3;B;;500;336;164;1;1;334;335
17;Girona;19;Garrotxa;17114;Olot;2;4;A;;472;300;172;0;1;299;300
17;Girona;19;Garrotxa;17114;Olot;2;4;B;;488;323;165;1;2;320;322
17;Girona;19;Garrotxa;17114;Olot;2;5;A;;562;379;183;0;4;375;379
17;Girona;19;Garrotxa;17114;Olot;2;5;B;;480;334;146;0;2;332;334
17;Girona;19;Garrotxa;17114;Olot;3;1;U;;652;439;213;1;6;432;438
17;Girona;19;Garrotxa;17114;Olot;3;2;A;;666;499;167;1;6;492;498
17;Girona;19;Garrotxa;17114;Olot;3;2;B;;652;466;186;1;2;463;465
17;Girona;19;Garrotxa;17114;Olot;3;3;A;;661;484;177;2;9;473;482
17;Girona;19;Garrotxa;17114;Olot;3;3;B;;450;308;142;3;0;305;305
17;Girona;19;Garrotxa;17114;Olot;3;3;C;;649;456;193;0;6;450;456
17;Girona;19;Garrotxa;17114;Olot;4;1;A;;525;353;172;0;5;348;353
17;Girona;19;Garrotxa;17114;Olot;4;1;B;;487;291;196;0;0;291;291
17;Girona;19;Garrotxa;17114;Olot;4;2;A;;499;356;143;0;3;353;356
17;Girona;19;Garrotxa;17114;Olot;4;2;B;;410;265;145;1;3;261;264
17;Girona;19;Garrotxa;17114;Olot;4;2;C;;472;323;149;0;1;322;323
17;Girona;19;Garrotxa;17114;Olot;5;1;A;;484;334;150;0;4;330;334
17;Girona;19;Garrotxa;17114;Olot;5;1;B;;428;303;125;0;3;300;303
17;Girona;19;Garrotxa;17114;Olot;5;2;A;;546;427;119;1;2;424;426
17;Girona;19;Garrotxa;17114;Olot;5;2;B;;459;336;123;0;2;334;336
17;Girona;19;Garrotxa;17114;Olot;5;3;A;;704;493;211;0;0;493;493
17;Girona;19;Garrotxa;17114;Olot;5;3;B;;433;269;164;1;4;264;268
17;Girona;19;Garrotxa;17114;Olot;5;3;C;;660;465;195;1;6;458;464
17;Girona;19;Garrotxa;17114;Olot;5;4;A;;639;488;151;1;4;483;487
17;Girona;19;Garrotxa;17114;Olot;5;4;B;;548;409;139;0;5;404;409
25;Lleida;32;Segarra;25152;Oluges, les;1;1;U;;168;115;53;1;3;111;114
8;Barcelona;14;Berguedà;08144;Olvan;1;1;A;;370;240;130;0;0;240;240
8;Barcelona;14;Berguedà;08144;Olvan;1;1;B;;408;306;102;0;2;304;306
25;Lleida;18;Garrigues;25153;Omellons, els;1;1;U;;223;174;49;2;2;170;172
25;Lleida;38;Urgell;25154;Omells de na Gaia, els;1;1;U;;134;95;39;0;0;95;95
17;Girona;2;Alt Empordà;17115;Ordis;1;1;U;;281;220;61;0;1;219;220
25;Lleida;4;Alt Urgell;25155;Organyà;1;1;U;;822;603;219;2;1;600;601
8;Barcelona;24;Osona;08150;Orís;1;1;U;;207;157;50;1;3;153;156
8;Barcelona;24;Osona;08151;Oristà;1;1;U;;519;380;139;0;3;377;380
8;Barcelona;6;Anoia;08152;Orpí;1;1;U;;157;124;33;0;0;124;124
8;Barcelona;21;Maresme;08153;Òrrius;1;1;U;;384;303;81;0;3;300;303
25;Lleida;23;Noguera;25156;Os de Balaguer;1;1;A;;389;286;103;1;2;283;285
25;Lleida;23;Noguera;25156;Os de Balaguer;1;1;B;;307;215;92;1;7;207;214
17;Girona;34;Selva;17116;Osor;1;1;U;;428;281;147;2;0;279;279
25;Lleida;38;Urgell;25157;Ossó de Sió;1;1;U;;209;165;44;1;0;164;164
8;Barcelona;3;Alt Penedès;08154;Pacs del Penedès;1;1;U;;559;451;108;2;4;445;449
8;Barcelona;21;Maresme;08155;Palafolls;1;1;A;;620;386;234;0;1;385;386
8;Barcelona;21;Maresme;08155;Palafolls;1;1;B;;978;667;311;0;6;661;667
8;Barcelona;21;Maresme;08155;Palafolls;1;2;A;;739;467;272;2;2;463;465
8;Barcelona;21;Maresme;08155;Palafolls;1;2;B;;967;587;380;4;4;579;583
8;Barcelona;21;Maresme;08155;Palafolls;1;2;C;;501;282;219;1;0;281;281
8;Barcelona;21;Maresme;08155;Palafolls;1;3;A;;598;307;291;0;1;306;307
8;Barcelona;21;Maresme;08155;Palafolls;1;3;B;;617;316;301;0;3;313;316
17;Girona;10;Baix Empordà;17117;Palafrugell;1;1;A;;549;352;197;2;2;348;350
17;Girona;10;Baix Empordà;17117;Palafrugell;1;1;B;;499;306;193;4;2;300;302
17;Girona;10;Baix Empordà;17117;Palafrugell;1;1;C;;518;328;190;2;3;323;326
17;Girona;10;Baix Empordà;17117;Palafrugell;1;2;A;;616;384;232;4;3;377;380
17;Girona;10;Baix Empordà;17117;Palafrugell;1;2;B;;593;346;247;0;1;345;346
17;Girona;10;Baix Empordà;17117;Palafrugell;1;2;C;;651;411;240;1;1;409;410
17;Girona;10;Baix Empordà;17117;Palafrugell;1;3;A;;416;273;143;2;2;269;271
17;Girona;10;Baix Empordà;17117;Palafrugell;1;3;B;;407;250;157;0;2;248;250
17;Girona;10;Baix Empordà;17117;Palafrugell;1;3;C;;389;245;144;0;3;242;245
17;Girona;10;Baix Empordà;17117;Palafrugell;1;4;A;;608;361;247;0;0;361;361
17;Girona;10;Baix Empordà;17117;Palafrugell;1;4;B;;655;397;258;5;8;384;392
17;Girona;10;Baix Empordà;17117;Palafrugell;2;1;A;;516;342;174;1;1;340;341
17;Girona;10;Baix Empordà;17117;Palafrugell;2;1;B;;519;317;202;3;2;312;314
17;Girona;10;Baix Empordà;17117;Palafrugell;2;1;C;;535;324;211;0;1;323;324
17;Girona;10;Baix Empordà;17117;Palafrugell;2;2;A;;442;265;177;0;2;263;265
17;Girona;10;Baix Empordà;17117;Palafrugell;2;2;B;;479;293;186;3;2;288;290
17;Girona;10;Baix Empordà;17117;Palafrugell;2;2;C;;531;340;191;0;0;340;340
17;Girona;10;Baix Empordà;17117;Palafrugell;2;3;A;;926;479;447;2;3;474;477
17;Girona;10;Baix Empordà;17117;Palafrugell;2;3;B;;840;548;292;1;9;538;547
17;Girona;10;Baix Empordà;17117;Palafrugell;3;1;A;;961;537;424;6;2;529;531
17;Girona;10;Baix Empordà;17117;Palafrugell;3;1;B;;909;543;366;3;5;535;540
17;Girona;10;Baix Empordà;17117;Palafrugell;3;2;A;;655;424;231;1;5;418;423
17;Girona;10;Baix Empordà;17117;Palafrugell;3;2;B;;671;456;215;1;3;452;455
17;Girona;10;Baix Empordà;17117;Palafrugell;3;2;C;;239;176;63;0;1;175;176
17;Girona;10;Baix Empordà;17118;Palamós;1;1;A;;645;429;216;3;6;420;426
17;Girona;10;Baix Empordà;17118;Palamós;1;1;B;;654;440;214;0;5;435;440
17;Girona;10;Baix Empordà;17118;Palamós;1;2;A;;634;407;227;3;2;402;404
17;Girona;10;Baix Empordà;17118;Palamós;1;2;B;;620;399;221;3;5;391;396
17;Girona;10;Baix Empordà;17118;Palamós;1;3;A;;611;389;222;1;4;384;388
17;Girona;10;Baix Empordà;17118;Palamós;1;3;B;;631;404;227;2;6;396;402
17;Girona;10;Baix Empordà;17118;Palamós;1;4;U;;722;465;257;0;4;461;465
17;Girona;10;Baix Empordà;17118;Palamós;2;1;A;;467;313;154;0;3;310;313
17;Girona;10;Baix Empordà;17118;Palamós;2;1;B;;413;278;135;1;3;274;277
17;Girona;10;Baix Empordà;17118;Palamós;2;2;A;;539;337;202;2;4;331;335
17;Girona;10;Baix Empordà;17118;Palamós;2;2;B;;498;320;178;1;3;316;319
17;Girona;10;Baix Empordà;17118;Palamós;3;1;A;;400;236;164;1;2;233;235
17;Girona;10;Baix Empordà;17118;Palamós;3;1;B;;659;416;243;2;3;411;414
17;Girona;10;Baix Empordà;17118;Palamós;3;2;A;;546;311;235;4;2;305;307
17;Girona;10;Baix Empordà;17118;Palamós;3;2;B;;494;285;209;1;2;282;284
17;Girona;10;Baix Empordà;17118;Palamós;3;3;A;;698;448;250;0;6;442;448
17;Girona;10;Baix Empordà;17118;Palamós;3;3;B;;682;409;273;0;3;406;409
17;Girona;10;Baix Empordà;17118;Palamós;4;1;A;;669;403;266;2;2;399;401
17;Girona;10;Baix Empordà;17118;Palamós;4;1;B;;646;378;268;2;4;372;376
17;Girona;10;Baix Empordà;17118;Palamós;4;2;A;;503;286;217;2;1;283;284
17;Girona;10;Baix Empordà;17118;Palamós;4;2;B;;399;243;156;1;3;239;242
25;Lleida;27;Pla d'Urgell;25158;Palau d'Anglesola, el;1;1;A;;565;417;148;4;6;407;413
25;Lleida;27;Pla d'Urgell;25158;Palau d'Anglesola, el;1;1;B;;862;658;204;11;4;643;647
17;Girona;2;Alt Empordà;17119;Palau de Santa Eulàlia;1;1;U;;78;62;16;0;1;61;62
17;Girona;10;Baix Empordà;17121;Palau-sator;1;1;U;;248;186;62;0;2;184;186
17;Girona;2;Alt Empordà;17120;Palau-saverdera;1;1;U;;681;496;185;2;2;492;494
8;Barcelona;40;Vallès Occidental;08156;Palau-solità i Plegamans;1;1;A;;493;292;201;0;4;288;292
8;Barcelona;40;Vallès Occidental;08156;Palau-solità i Plegamans;1;1;B;;583;325;258;1;1;323;324
8;Barcelona;40;Vallès Occidental;08156;Palau-solità i Plegamans;1;1;C;;530;317;213;2;2;313;315
8;Barcelona;40;Vallès Occidental;08156;Palau-solità i Plegamans;1;2;A;;529;332;197;2;3;327;330
8;Barcelona;40;Vallès Occidental;08156;Palau-solità i Plegamans;1;2;B;;527;309;218;1;3;305;308
8;Barcelona;40;Vallès Occidental;08156;Palau-solità i Plegamans;1;2;C;;538;322;216;2;0;320;320
8;Barcelona;40;Vallès Occidental;08156;Palau-solità i Plegamans;1;2;D;;495;322;173;2;1;319;320
8;Barcelona;40;Vallès Occidental;08156;Palau-solità i Plegamans;1;3;A;;571;344;227;0;2;342;344
8;Barcelona;40;Vallès Occidental;08156;Palau-solità i Plegamans;1;3;B;;663;412;251;3;2;407;409
8;Barcelona;40;Vallès Occidental;08156;Palau-solità i Plegamans;1;4;A;;677;405;272;0;4;401;405
8;Barcelona;40;Vallès Occidental;08156;Palau-solità i Plegamans;1;4;B;;652;415;237;2;2;411;413
8;Barcelona;40;Vallès Occidental;08156;Palau-solità i Plegamans;1;4;C;;656;389;267;1;0;388;388
8;Barcelona;40;Vallès Occidental;08156;Palau-solità i Plegamans;1;4;D;;682;432;250;0;5;427;432
8;Barcelona;40;Vallès Occidental;08156;Palau-solità i Plegamans;1;5;U;;668;449;219;0;4;445;449
8;Barcelona;40;Vallès Occidental;08156;Palau-solità i Plegamans;1;6;A;;527;307;220;1;5;301;306
8;Barcelona;40;Vallès Occidental;08156;Palau-solità i Plegamans;1;6;B;;561;348;213;0;3;345;348
43;Tarragona;36;Tarragonès;43100;Pallaresos, els;1;1;U;;698;465;233;0;5;460;465
43;Tarragona;36;Tarragonès;43100;Pallaresos, els;1;2;A;;667;376;291;0;1;375;376
43;Tarragona;36;Tarragonès;43100;Pallaresos, els;1;2;B;;783;384;399;0;5;379;384
8;Barcelona;11;Baix Llobregat;08157;Pallejà;1;1;A;;514;329;185;2;3;324;327
8;Barcelona;11;Baix Llobregat;08157;Pallejà;1;1;B;;695;433;262;1;4;428;432
8;Barcelona;11;Baix Llobregat;08157;Pallejà;1;1;C;;579;365;214;2;3;360;363
8;Barcelona;11;Baix Llobregat;08157;Pallejà;1;2;A;;572;337;235;0;4;333;337
8;Barcelona;11;Baix Llobregat;08157;Pallejà;1;2;B;;752;420;332;0;0;420;420
8;Barcelona;11;Baix Llobregat;08157;Pallejà;1;2;C;;663;393;270;4;0;389;389
8;Barcelona;11;Baix Llobregat;08157;Pallejà;1;3;A;;738;455;283;1;5;449;454
8;Barcelona;11;Baix Llobregat;08157;Pallejà;1;3;B;;763;470;293;1;4;465;469
8;Barcelona;11;Baix Llobregat;08157;Pallejà;1;4;A;;513;347;166;0;0;347;347
8;Barcelona;11;Baix Llobregat;08157;Pallejà;1;4;B;;566;381;185;0;1;380;381
8;Barcelona;11;Baix Llobregat;08157;Pallejà;1;5;A;;517;351;166;0;1;350;351
8;Barcelona;11;Baix Llobregat;08157;Pallejà;1;5;B;;587;366;221;2;4;360;364
43;Tarragona;30;Ribera d'Ebre;43099;Palma d'Ebre, la;1;1;U;;357;300;57;0;1;299;300
8;Barcelona;11;Baix Llobregat;08905;Palma de Cervelló, la;1;1;A;;728;518;210;3;7;508;515
8;Barcelona;11;Baix Llobregat;08905;Palma de Cervelló, la;1;1;B;;743;511;232;4;6;501;507
8;Barcelona;11;Baix Llobregat;08905;Palma de Cervelló, la;1;1;C;;729;509;220;3;8;498;506
17;Girona;28;Pla de l'Estany;17123;Palol de Revardit;1;1;U;;352;287;65;0;2;285;287
17;Girona;10;Baix Empordà;17124;Pals;1;1;A;;791;561;230;7;4;550;554
17;Girona;10;Baix Empordà;17124;Pals;1;1;B;;775;579;196;0;7;572;579
8;Barcelona;11;Baix Llobregat;08158;Papiol, el;1;1;A;;710;475;235;3;3;469;472
8;Barcelona;11;Baix Llobregat;08158;Papiol, el;1;1;B;;810;519;291;1;1;517;518
8;Barcelona;11;Baix Llobregat;08158;Papiol, el;1;2;A;;612;386;226;0;2;384;386
8;Barcelona;11;Baix Llobregat;08158;Papiol, el;1;2;B;;679;414;265;1;0;413;413
17;Girona;31;Ripollès;17125;Pardines;1;1;U;;125;102;23;0;1;101;102
8;Barcelona;41;Vallès Oriental;08159;Parets del Vallès;1;1;A;;498;316;182;0;2;314;316
8;Barcelona;41;Vallès Oriental;08159;Parets del Vallès;1;1;B;;564;339;225;1;4;334;338
8;Barcelona;41;Vallès Oriental;08159;Parets del Vallès;1;2;A;;652;415;237;2;4;409;413
8;Barcelona;41;Vallès Oriental;08159;Parets del Vallès;1;2;B;;828;522;306;0;1;521;522
8;Barcelona;41;Vallès Oriental;08159;Parets del Vallès;1;2;C;;752;506;246;0;4;502;506
8;Barcelona;41;Vallès Oriental;08159;Parets del Vallès;1;3;A;;558;353;205;0;1;352;353
8;Barcelona;41;Vallès Oriental;08159;Parets del Vallès;1;3;B;;719;435;284;1;2;432;434
8;Barcelona;41;Vallès Oriental;08159;Parets del Vallès;2;1;A;;442;261;181;0;1;260;261
8;Barcelona;41;Vallès Oriental;08159;Parets del Vallès;2;1;B;;514;300;214;1;7;292;299
8;Barcelona;41;Vallès Oriental;08159;Parets del Vallès;2;2;A;;388;232;156;1;0;231;231
8;Barcelona;41;Vallès Oriental;08159;Parets del Vallès;2;2;B;;443;275;168;2;3;270;273
8;Barcelona;41;Vallès Oriental;08159;Parets del Vallès;2;3;A;;695;381;314;1;3;377;380
8;Barcelona;41;Vallès Oriental;08159;Parets del Vallès;2;3;B;;830;441;389;1;3;437;440
8;Barcelona;41;Vallès Oriental;08159;Parets del Vallès;2;4;A;;620;383;237;0;1;382;383
8;Barcelona;41;Vallès Oriental;08159;Parets del Vallès;2;4;B;;588;321;267;0;1;320;321
8;Barcelona;41;Vallès Oriental;08159;Parets del Vallès;2;4;C;;856;501;355;3;1;497;498
8;Barcelona;41;Vallès Oriental;08159;Parets del Vallès;2;4;D;;614;367;247;0;5;362;367
8;Barcelona;41;Vallès Oriental;08159;Parets del Vallès;2;5;A;;767;449;318;0;4;445;449
8;Barcelona;41;Vallès Oriental;08159;Parets del Vallès;2;5;B;;855;511;344;0;5;506;511
17;Girona;10;Baix Empordà;17126;Parlavà;1;1;U;;296;228;68;0;12;216;228
43;Tarragona;16;Conca de Barberà;43101;Passanant i Belltall;1;1;U;;187;134;53;2;1;131;132
17;Girona;2;Alt Empordà;17128;Pau;1;1;U;;271;209;62;0;0;209;209
43;Tarragona;9;Baix Ebre;43102;Paüls;1;1;U;;541;489;52;1;0;488;488
17;Girona;2;Alt Empordà;17129;Pedret i Marzà;1;1;U;;112;81;31;0;1;80;81
25;Lleida;23;Noguera;25164;Penelles;1;1;U;;451;320;131;2;2;316;318
17;Girona;10;Baix Empordà;17130;Pera, la;1;1;U;;333;263;70;0;8;255;263
8;Barcelona;24;Osona;08160;Perafita;1;1;U;;297;230;67;0;4;226;230
43;Tarragona;36;Tarragonès;43103;Perafort;1;1;U;;595;395;200;1;3;391;394
17;Girona;2;Alt Empordà;17132;Peralada;1;1;A;;923;718;205;1;4;713;717
17;Girona;2;Alt Empordà;17132;Peralada;1;1;B;;207;147;60;1;0;146;146
25;Lleida;4;Alt Urgell;25165;Peramola;1;1;U;;319;252;67;0;0;252;252
43;Tarragona;9;Baix Ebre;43104;Perelló, el;1;1;U;;641;483;158;3;7;473;480
43;Tarragona;9;Baix Ebre;43104;Perelló, el;1;2;A;;482;369;113;1;2;366;368
43;Tarragona;9;Baix Ebre;43104;Perelló, el;1;2;B;;630;502;128;0;3;499;502
8;Barcelona;6;Anoia;08161;Piera;1;1;U;;706;416;290;1;4;411;415
8;Barcelona;6;Anoia;08161;Piera;1;2;A;;844;514;330;3;3;508;511
8;Barcelona;6;Anoia;08161;Piera;1;2;B;;848;509;339;0;1;508;509
8;Barcelona;6;Anoia;08161;Piera;1;3;A;;804;491;313;1;0;490;490
8;Barcelona;6;Anoia;08161;Piera;1;3;B;;913;562;351;0;3;559;562
8;Barcelona;6;Anoia;08161;Piera;1;4;A;;365;259;106;0;2;257;259
8;Barcelona;6;Anoia;08161;Piera;1;4;B;;732;361;371;2;3;356;359
8;Barcelona;6;Anoia;08161;Piera;1;5;A;;1001;499;502;0;4;495;499
8;Barcelona;6;Anoia;08161;Piera;1;5;B;;1126;610;516;1;6;603;609
8;Barcelona;6;Anoia;08161;Piera;1;6;U;;1369;593;776;0;4;589;593
43;Tarragona;16;Conca de Barberà;43105;Piles, les;1;1;U;;149;112;37;2;4;106;110
8;Barcelona;21;Maresme;08163;Pineda de Mar;1;1;A;;631;395;236;1;0;394;394
8;Barcelona;21;Maresme;08163;Pineda de Mar;1;1;B;;786;501;285;2;5;494;499
8;Barcelona;21;Maresme;08163;Pineda de Mar;1;10;U;;1025;582;443;0;2;580;582
8;Barcelona;21;Maresme;08163;Pineda de Mar;1;11;U;;958;591;367;0;6;585;591
8;Barcelona;21;Maresme;08163;Pineda de Mar;1;12;U;;916;518;398;1;4;513;517
8;Barcelona;21;Maresme;08163;Pineda de Mar;1;13;A;;557;358;199;2;2;354;356
8;Barcelona;21;Maresme;08163;Pineda de Mar;1;13;B;;761;463;298;1;2;460;462
8;Barcelona;21;Maresme;08163;Pineda de Mar;1;2;A;;657;429;228;3;3;423;426
8;Barcelona;21;Maresme;08163;Pineda de Mar;1;2;B;;711;444;267;0;3;441;444
8;Barcelona;21;Maresme;08163;Pineda de Mar;1;3;A;;511;318;193;0;4;314;318
8;Barcelona;21;Maresme;08163;Pineda de Mar;1;3;B;;633;391;242;2;2;387;389
8;Barcelona;21;Maresme;08163;Pineda de Mar;1;4;A;;856;462;394;0;0;462;462
8;Barcelona;21;Maresme;08163;Pineda de Mar;1;4;B;;1018;555;463;1;4;550;554
8;Barcelona;21;Maresme;08163;Pineda de Mar;1;5;A;;950;501;449;2;1;498;499
8;Barcelona;21;Maresme;08163;Pineda de Mar;1;5;B;;1195;628;567;2;6;620;626
8;Barcelona;21;Maresme;08163;Pineda de Mar;1;6;U;;929;540;389;0;3;537;540
8;Barcelona;21;Maresme;08163;Pineda de Mar;1;7;A;;655;432;223;2;4;426;430
8;Barcelona;21;Maresme;08163;Pineda de Mar;1;7;B;;839;546;293;0;3;543;546
8;Barcelona;21;Maresme;08163;Pineda de Mar;1;8;A;;470;268;202;1;1;266;267
8;Barcelona;21;Maresme;08163;Pineda de Mar;1;8;B;;572;296;276;1;1;294;295
8;Barcelona;21;Maresme;08163;Pineda de Mar;1;9;A;;707;396;311;1;3;392;395
8;Barcelona;21;Maresme;08163;Pineda de Mar;1;9;B;;688;404;284;0;5;399;404
43;Tarragona;37;Terra Alta;43106;Pinell de Brai, el;1;1;U;;916;699;217;4;6;689;695
25;Lleida;35;Solsonès;25166;Pinell de Solsonès;1;1;U;;192;155;37;0;4;151;155
25;Lleida;35;Solsonès;25167;Pinós;1;1;U;;275;218;57;1;2;215;217
43;Tarragona;16;Conca de Barberà;43107;Pira;1;1;U;;371;256;115;4;9;243;252
8;Barcelona;3;Alt Penedès;08164;Pla del Penedès, el;1;1;U;;756;563;193;4;2;557;559
43;Tarragona;1;Alt Camp;43108;Pla de Santa Maria, el;1;1;A;;701;523;178;1;2;520;522
43;Tarragona;1;Alt Camp;43108;Pla de Santa Maria, el;1;1;B;;698;495;203;0;4;491;495
17;Girona;19;Garrotxa;17133;Planes d'Hostoles, les;1;1;A;;812;608;204;0;10;598;608
17;Girona;19;Garrotxa;17133;Planes d'Hostoles, les;1;1;B;;642;498;144;0;3;495;498
17;Girona;31;Ripollès;17134;Planoles;1;1;U;;268;195;73;0;1;194;195
25;Lleida;32;Segarra;25911;Plans de Sió, els;1;1;U;;518;388;130;1;2;385;387
25;Lleida;27;Pla d'Urgell;25168;Poal, el;1;1;U;;520;407;113;0;4;403;407
25;Lleida;18;Garrigues;25169;Pobla de Cérvoles, la;1;1;U;;198;142;56;1;0;141;141
8;Barcelona;6;Anoia;08165;Pobla de Claramunt, la;1;1;A;;692;475;217;2;0;473;473
8;Barcelona;6;Anoia;08165;Pobla de Claramunt, la;1;1;B;;814;579;235;2;4;573;577
8;Barcelona;14;Berguedà;08166;Pobla de Lillet, la;1;1;U;;375;274;101;2;3;269;272
8;Barcelona;14;Berguedà;08166;Pobla de Lillet, la;1;2;A;;469;331;138;0;4;327;331
8;Barcelona;14;Berguedà;08166;Pobla de Lillet, la;1;2;B;;397;301;96;1;2;298;300
43;Tarragona;36;Tarragonès;43109;Pobla de Mafumet, la;1;1;A;;461;305;156;0;1;304;305
43;Tarragona;36;Tarragonès;43109;Pobla de Mafumet, la;1;1;B;;545;370;175;2;0;368;368
43;Tarragona;37;Terra Alta;43110;Pobla de Massaluca, la;1;1;U;;369;240;129;0;7;233;240
43;Tarragona;36;Tarragonès;43111;Pobla de Montornès, la;1;1;A;;650;364;286;2;2;360;362
43;Tarragona;36;Tarragonès;43111;Pobla de Montornès, la;1;1;B;;772;442;330;4;1;437;438
25;Lleida;25;Pallars Jussà;25171;Pobla de Segur, la;1;1;A;;516;364;152;1;3;360;363
25;Lleida;25;Pallars Jussà;25171;Pobla de Segur, la;1;1;B;;626;428;198;2;4;422;426
25;Lleida;25;Pallars Jussà;25171;Pobla de Segur, la;1;2;A;;649;442;207;5;5;432;437
25;Lleida;25;Pallars Jussà;25171;Pobla de Segur, la;1;2;B;;654;457;197;3;3;451;454
43;Tarragona;29;Priorat;43112;Poboleda;1;1;U;;302;220;82;0;0;220;220
8;Barcelona;40;Vallès Occidental;08167;Polinyà;1;1;A;;361;191;170;3;0;188;188
8;Barcelona;40;Vallès Occidental;08167;Polinyà;1;1;B;;414;217;197;0;2;215;217
8;Barcelona;40;Vallès Occidental;08167;Polinyà;1;1;C;;483;268;215;0;1;267;268
8;Barcelona;40;Vallès Occidental;08167;Polinyà;1;1;D;;428;267;161;0;0;267;267
8;Barcelona;40;Vallès Occidental;08167;Polinyà;1;2;A;;323;165;158;2;2;161;163
8;Barcelona;40;Vallès Occidental;08167;Polinyà;1;2;B;;386;187;199;1;2;184;186
8;Barcelona;40;Vallès Occidental;08167;Polinyà;1;2;C;;480;246;234;0;1;245;246
8;Barcelona;40;Vallès Occidental;08167;Polinyà;1;3;A;;476;256;220;0;2;254;256
8;Barcelona;40;Vallès Occidental;08167;Polinyà;1;3;B;;474;277;197;0;3;274;277
8;Barcelona;40;Vallès Occidental;08167;Polinyà;1;3;C;;512;296;216;2;2;292;294
43;Tarragona;1;Alt Camp;43113;Pont d'Armentera, el;1;1;U;;486;377;109;6;3;368;371
25;Lleida;4;Alt Urgell;25030;Pont de Bar, el;1;1;U;;142;102;40;1;1;100;101
17;Girona;2;Alt Empordà;17135;Pont de Molins;1;1;U;;374;242;132;0;0;242;242
25;Lleida;5;Alta Ribagorça;25173;Pont de Suert, el;1;1;A;;517;345;172;1;4;340;344
25;Lleida;5;Alta Ribagorça;25173;Pont de Suert, el;1;1;B;;584;392;192;3;1;388;389
25;Lleida;5;Alta Ribagorça;25173;Pont de Suert, el;1;2;U;;687;463;224;0;2;461;463
8;Barcelona;7;Bages;08182;Pont de Vilomara i Rocafort, el;1;1;A;;630;377;253;1;1;375;376
8;Barcelona;7;Bages;08182;Pont de Vilomara i Rocafort, el;1;1;B;;870;542;328;0;1;541;542
8;Barcelona;7;Bages;08182;Pont de Vilomara i Rocafort, el;1;1;C;;810;532;278;1;4;527;531
43;Tarragona;16;Conca de Barberà;43141;Pontils;1;1;U;;128;87;41;4;0;83;83
8;Barcelona;3;Alt Penedès;08168;Pontons;1;1;U;;365;249;116;0;1;248;249
17;Girona;2;Alt Empordà;17136;Pontós;1;1;U;;187;138;49;0;0;138;138
25;Lleida;23;Noguera;25172;Ponts;1;1;U;;837;642;195;4;5;633;638
25;Lleida;23;Noguera;25172;Ponts;1;2;A;;515;384;131;4;0;380;380
25;Lleida;23;Noguera;25172;Ponts;1;2;B;;561;436;125;0;4;432;436
17;Girona;28;Pla de l'Estany;17137;Porqueres;1;1;U;;584;379;205;0;5;374;379
17;Girona;28;Pla de l'Estany;17137;Porqueres;1;2;A;;662;494;168;0;5;489;494
17;Girona;28;Pla de l'Estany;17137;Porqueres;1;2;B;;751;545;206;2;4;539;543
17;Girona;28;Pla de l'Estany;17137;Porqueres;1;3;A;;542;391;151;0;3;388;391
17;Girona;28;Pla de l'Estany;17137;Porqueres;1;3;B;;550;394;156;2;3;389;392
43;Tarragona;29;Priorat;43114;Porrera;1;1;U;;401;260;141;1;2;257;259
17;Girona;2;Alt Empordà;17138;Portbou;1;1;A;;599;431;168;3;3;425;428
17;Girona;2;Alt Empordà;17138;Portbou;1;1;B;;602;436;166;4;4;428;432
17;Girona;2;Alt Empordà;17140;Port de la Selva, el;1;1;U;;687;504;183;5;4;495;499
25;Lleida;33;Segrià;25174;Portella, la;1;1;U;;505;396;109;4;2;390;392
43;Tarragona;29;Priorat;43115;Pradell de la Teixeta;1;1;U;;171;124;47;1;2;121;123
43;Tarragona;8;Baix Camp;43116;Prades;1;1;U;;499;391;108;4;1;386;387
43;Tarragona;37;Terra Alta;43117;Prat de Comte;1;1;U;;173;131;42;1;3;127;130
8;Barcelona;11;Baix Llobregat;08169;Prat de Llobregat, el;1;1;A;;609;380;229;2;2;376;378
8;Barcelona;11;Baix Llobregat;08169;Prat de Llobregat, el;1;1;B;;776;467;309;0;2;465;467
8;Barcelona;11;Baix Llobregat;08169;Prat de Llobregat, el;1;2;A;;627;409;218;3;3;403;406
8;Barcelona;11;Baix Llobregat;08169;Prat de Llobregat, el;1;2;B;;765;497;268;1;3;493;496
8;Barcelona;11;Baix Llobregat;08169;Prat de Llobregat, el;1;3;A;;460;293;167;1;4;288;292
8;Barcelona;11;Baix Llobregat;08169;Prat de Llobregat, el;1;3;B;;536;335;201;0;2;333;335
8;Barcelona;11;Baix Llobregat;08169;Prat de Llobregat, el;1;4;A;;694;431;263;1;3;427;430
8;Barcelona;11;Baix Llobregat;08169;Prat de Llobregat, el;1;4;B;;763;453;310;1;14;438;452
8;Barcelona;11;Baix Llobregat;08169;Prat de Llobregat, el;1;5;A;;564;339;225;0;3;336;339
8;Barcelona;11;Baix Llobregat;08169;Prat de Llobregat, el;1;5;B;;675;370;305;0;5;365;370
8;Barcelona;11;Baix Llobregat;08169;Prat de Llobregat, el;2;1;A;;652;412;240;1;3;408;411
8;Barcelona;11;Baix Llobregat;08169;Prat de Llobregat, el;2;1;B;;785;479;306;0;3;476;479
8;Barcelona;11;Baix Llobregat;08169;Prat de Llobregat, el;2;2;A;;711;426;285;0;6;420;426
8;Barcelona;11;Baix Llobregat;08169;Prat de Llobregat, el;2;2;B;;833;491;342;1;2;488;490
8;Barcelona;11;Baix Llobregat;08169;Prat de Llobregat, el;2;3;A;;470;267;203;0;1;266;267
8;Barcelona;11;Baix Llobregat;08169;Prat de Llobregat, el;2;3;B;;536;292;244;1;0;291;291
8;Barcelona;11;Baix Llobregat;08169;Prat de Llobregat, el;2;4;A;;659;363;296;0;1;362;363
8;Barcelona;11;Baix Llobregat;08169;Prat de Llobregat, el;2;4;B;;779;424;355;1;1;422;423
8;Barcelona;11;Baix Llobregat;08169;Prat de Llobregat, el;2;5;A;;704;383;321;2;2;379;381
8;Barcelona;11;Baix Llobregat;08169;Prat de Llobregat, el;2;5;B;;720;427;293;1;3;423;426
8;Barcelona;11;Baix Llobregat;08169;Prat de Llobregat, el;2;6;A;;910;573;337;1;10;562;572
8;Barcelona;11;Baix Llobregat;08169;Prat de Llobregat, el;2;6;B;;940;557;383;0;1;556;557
8;Barcelona;11;Baix Llobregat;08169;Prat de Llobregat, el;2;7;A;;666;398;268;2;6;390;396
8;Barcelona;11;Baix Llobregat;08169;Prat de Llobregat, el;2;7;B;;735;417;318;2;5;410;415
8;Barcelona;11;Baix Llobregat;08169;Prat de Llobregat, el;3;1;A;;534;354;180;0;7;347;354
8;Barcelona;11;Baix Llobregat;08169;Prat de Llobregat, el;3;1;B;;633;415;218;4;1;410;411
8;Barcelona;11;Baix Llobregat;08169;Prat de Llobregat, el;3;10;A;;735;359;376;1;2;356;358
8;Barcelona;11;Baix Llobregat;08169;Prat de Llobregat, el;3;10;B;;713;367;346;2;4;361;365
8;Barcelona;11;Baix Llobregat;08169;Prat de Llobregat, el;3;2;A;;750;399;351;0;5;394;399
8;Barcelona;11;Baix Llobregat;08169;Prat de Llobregat, el;3;2;B;;835;443;392;1;6;436;442
8;Barcelona;11;Baix Llobregat;08169;Prat de Llobregat, el;3;2;C;;892;459;433;0;8;451;459
8;Barcelona;11;Baix Llobregat;08169;Prat de Llobregat, el;3;3;A;;627;333;294;1;8;324;332
8;Barcelona;11;Baix Llobregat;08169;Prat de Llobregat, el;3;3;B;;694;366;328;0;10;356;366
8;Barcelona;11;Baix Llobregat;08169;Prat de Llobregat, el;3;4;A;;557;305;252;1;2;302;304
8;Barcelona;11;Baix Llobregat;08169;Prat de Llobregat, el;3;4;B;;685;389;296;0;1;388;389
8;Barcelona;11;Baix Llobregat;08169;Prat de Llobregat, el;3;5;A;;805;481;324;1;8;472;480
8;Barcelona;11;Baix Llobregat;08169;Prat de Llobregat, el;3;5;B;;907;531;376;1;5;525;530
8;Barcelona;11;Baix Llobregat;08169;Prat de Llobregat, el;3;6;A;;533;294;239;1;7;286;293
8;Barcelona;11;Baix Llobregat;08169;Prat de Llobregat, el;3;6;B;;637;343;294;0;8;335;343
8;Barcelona;11;Baix Llobregat;08169;Prat de Llobregat, el;3;7;A;;795;465;330;3;3;459;462
8;Barcelona;11;Baix Llobregat;08169;Prat de Llobregat, el;3;7;B;;931;488;443;0;7;481;488
8;Barcelona;11;Baix Llobregat;08169;Prat de Llobregat, el;3;8;A;;795;424;371;1;2;421;423
8;Barcelona;11;Baix Llobregat;08169;Prat de Llobregat, el;3;8;B;;981;494;487;1;3;490;493
8;Barcelona;11;Baix Llobregat;08169;Prat de Llobregat, el;3;9;A;;949;487;462;0;8;479;487
8;Barcelona;11;Baix Llobregat;08169;Prat de Llobregat, el;3;9;B;;939;464;475;3;2;459;461
8;Barcelona;11;Baix Llobregat;08169;Prat de Llobregat, el;4;1;U;;881;474;407;3;5;466;471
8;Barcelona;11;Baix Llobregat;08169;Prat de Llobregat, el;4;2;A;;642;263;379;1;3;259;262
8;Barcelona;11;Baix Llobregat;08169;Prat de Llobregat, el;4;2;B;;738;289;449;1;3;285;288
8;Barcelona;11;Baix Llobregat;08169;Prat de Llobregat, el;4;3;A;;513;222;291;1;0;221;221
8;Barcelona;11;Baix Llobregat;08169;Prat de Llobregat, el;4;3;B;;642;288;354;0;1;287;288
8;Barcelona;11;Baix Llobregat;08169;Prat de Llobregat, el;4;4;U;;1038;383;655;0;1;382;383
8;Barcelona;11;Baix Llobregat;08169;Prat de Llobregat, el;4;5;A;;505;232;273;1;4;227;231
8;Barcelona;11;Baix Llobregat;08169;Prat de Llobregat, el;4;5;B;;613;264;349;0;1;263;264
8;Barcelona;11;Baix Llobregat;08169;Prat de Llobregat, el;4;6;U;;843;168;675;0;0;168;168
8;Barcelona;11;Baix Llobregat;08169;Prat de Llobregat, el;5;1;A;;526;311;215;1;1;309;310
8;Barcelona;11;Baix Llobregat;08169;Prat de Llobregat, el;5;1;B;;584;348;236;2;2;344;346
8;Barcelona;11;Baix Llobregat;08169;Prat de Llobregat, el;5;2;A;;575;314;261;2;6;306;312
8;Barcelona;11;Baix Llobregat;08169;Prat de Llobregat, el;5;2;B;;570;321;249;3;4;314;318
8;Barcelona;11;Baix Llobregat;08169;Prat de Llobregat, el;5;3;A;;498;243;255;0;1;242;243
8;Barcelona;11;Baix Llobregat;08169;Prat de Llobregat, el;5;3;B;;531;272;259;1;2;269;271
8;Barcelona;11;Baix Llobregat;08169;Prat de Llobregat, el;5;4;A;;656;383;273;2;6;375;381
8;Barcelona;11;Baix Llobregat;08169;Prat de Llobregat, el;5;4;B;;706;414;292;0;6;408;414
8;Barcelona;11;Baix Llobregat;08169;Prat de Llobregat, el;5;5;A;;699;379;320;0;5;374;379
8;Barcelona;11;Baix Llobregat;08169;Prat de Llobregat, el;5;5;B;;801;461;340;0;2;459;461
8;Barcelona;11;Baix Llobregat;08169;Prat de Llobregat, el;5;6;A;;754;408;346;1;8;399;407
8;Barcelona;11;Baix Llobregat;08169;Prat de Llobregat, el;5;6;B;;883;485;398;0;11;474;485
8;Barcelona;11;Baix Llobregat;08169;Prat de Llobregat, el;5;7;A;;834;441;393;0;2;439;441
8;Barcelona;11;Baix Llobregat;08169;Prat de Llobregat, el;5;7;B;;945;516;429;0;3;513;516
8;Barcelona;11;Baix Llobregat;08169;Prat de Llobregat, el;5;8;A;;884;504;380;0;8;496;504
8;Barcelona;11;Baix Llobregat;08169;Prat de Llobregat, el;5;8;B;;1077;607;470;3;11;593;604
43;Tarragona;8;Baix Camp;43118;Pratdip;1;1;U;;443;367;76;1;1;365;366
8;Barcelona;24;Osona;08171;Prats de Lluçanès;1;1;A;;505;366;139;0;2;364;366
8;Barcelona;24;Osona;08171;Prats de Lluçanès;1;1;B;;555;377;178;1;1;375;376
8;Barcelona;24;Osona;08171;Prats de Lluçanès;1;2;A;;499;352;147;0;2;350;352
8;Barcelona;24;Osona;08171;Prats de Lluçanès;1;2;B;;594;422;172;1;5;416;421
8;Barcelona;6;Anoia;08170;Prats de Rei, els;1;1;U;;464;346;118;2;6;338;344
25;Lleida;15;Cerdanya;25175;Prats i Sansor;1;1;U;;172;117;55;0;2;115;117
25;Lleida;38;Urgell;25176;Preixana;1;1;U;;380;287;93;2;2;283;285
25;Lleida;23;Noguera;25177;Preixens;1;1;U;;457;324;133;2;1;321;322
8;Barcelona;21;Maresme;08230;Premià de Dalt;1;1;A;;688;520;168;1;6;513;519
8;Barcelona;21;Maresme;08230;Premià de Dalt;1;1;B;;746;576;170;2;4;570;574
8;Barcelona;21;Maresme;08230;Premià de Dalt;1;2;A;;674;461;213;1;6;454;460
8;Barcelona;21;Maresme;08230;Premià de Dalt;1;2;B;;854;601;253;1;5;595;600
8;Barcelona;21;Maresme;08230;Premià de Dalt;1;3;A;;554;311;243;0;4;307;311
8;Barcelona;21;Maresme;08230;Premià de Dalt;1;3;B;;672;401;271;1;2;398;400
8;Barcelona;21;Maresme;08230;Premià de Dalt;1;4;A;;619;421;198;0;3;418;421
8;Barcelona;21;Maresme;08230;Premià de Dalt;1;4;B;;636;448;188;1;3;444;447
8;Barcelona;21;Maresme;08230;Premià de Dalt;1;5;U;;758;436;322;0;7;429;436
8;Barcelona;21;Maresme;08230;Premià de Dalt;1;6;A;;528;385;143;3;2;380;382
8;Barcelona;21;Maresme;08230;Premià de Dalt;1;6;B;;655;490;165;4;2;484;486
8;Barcelona;21;Maresme;08172;Premià de Mar;1;1;A;;919;630;289;1;5;624;629
8;Barcelona;21;Maresme;08172;Premià de Mar;1;1;B;;919;613;306;1;2;610;612
8;Barcelona;21;Maresme;08172;Premià de Mar;1;2;A;;835;588;247;0;4;584;588
8;Barcelona;21;Maresme;08172;Premià de Mar;1;2;B;;883;620;263;1;3;616;619
8;Barcelona;21;Maresme;08172;Premià de Mar;1;3;A;;835;547;288;0;5;542;547
8;Barcelona;21;Maresme;08172;Premià de Mar;1;3;B;;938;628;310;1;5;622;627
8;Barcelona;21;Maresme;08172;Premià de Mar;2;1;A;;682;467;215;2;4;461;465
8;Barcelona;21;Maresme;08172;Premià de Mar;2;1;B;;828;597;231;0;5;592;597
8;Barcelona;21;Maresme;08172;Premià de Mar;2;2;A;;465;269;196;0;2;267;269
8;Barcelona;21;Maresme;08172;Premià de Mar;2;2;B;;556;337;219;2;3;332;335
8;Barcelona;21;Maresme;08172;Premià de Mar;2;2;C;;599;380;219;0;3;377;380
8;Barcelona;21;Maresme;08172;Premià de Mar;2;3;A;;647;357;290;0;4;353;357
8;Barcelona;21;Maresme;08172;Premià de Mar;2;3;B;;767;464;303;2;1;461;462
8;Barcelona;21;Maresme;08172;Premià de Mar;2;4;A;;554;325;229;0;0;325;325
8;Barcelona;21;Maresme;08172;Premià de Mar;2;4;B;;658;399;259;4;4;391;395
8;Barcelona;21;Maresme;08172;Premià de Mar;3;1;A;;507;335;172;1;4;330;334
8;Barcelona;21;Maresme;08172;Premià de Mar;3;1;B;;616;378;238;0;2;376;378
8;Barcelona;21;Maresme;08172;Premià de Mar;3;2;A;;513;300;213;0;6;294;300
8;Barcelona;21;Maresme;08172;Premià de Mar;3;2;B;;552;324;228;0;2;322;324
8;Barcelona;21;Maresme;08172;Premià de Mar;3;3;A;;502;329;173;1;4;324;328
8;Barcelona;21;Maresme;08172;Premià de Mar;3;3;B;;533;335;198;0;4;331;335
8;Barcelona;21;Maresme;08172;Premià de Mar;3;4;A;;588;385;203;0;4;381;385
8;Barcelona;21;Maresme;08172;Premià de Mar;3;4;B;;674;406;268;0;3;403;406
8;Barcelona;21;Maresme;08172;Premià de Mar;3;5;A;;454;237;217;0;2;235;237
8;Barcelona;21;Maresme;08172;Premià de Mar;3;5;B;;584;308;276;1;1;306;307
8;Barcelona;21;Maresme;08172;Premià de Mar;3;6;A;;460;313;147;0;3;310;313
8;Barcelona;21;Maresme;08172;Premià de Mar;3;6;B;;592;401;191;0;2;399;401
8;Barcelona;21;Maresme;08172;Premià de Mar;3;7;A;;530;357;173;0;7;350;357
8;Barcelona;21;Maresme;08172;Premià de Mar;3;7;B;;547;344;203;1;3;340;343
8;Barcelona;21;Maresme;08172;Premià de Mar;3;8;U;;795;525;270;0;6;519;525
8;Barcelona;21;Maresme;08172;Premià de Mar;3;9;A;;468;293;175;0;5;288;293
8;Barcelona;21;Maresme;08172;Premià de Mar;3;9;B;;544;342;202;0;2;340;342
17;Girona;19;Garrotxa;17139;Preses, les;1;1;A;;840;666;174;2;6;658;664
17;Girona;19;Garrotxa;17139;Preses, les;1;1;B;;456;343;113;1;9;333;342
25;Lleida;15;Cerdanya;25179;Prullans;1;1;U;;191;150;41;1;0;149;149
17;Girona;15;Cerdanya;17141;Puigcerdà;1;1;A;;346;204;142;1;0;203;203
17;Girona;15;Cerdanya;17141;Puigcerdà;1;1;B;;313;182;131;1;3;178;181
17;Girona;15;Cerdanya;17141;Puigcerdà;1;2;A;;754;456;298;1;4;451;455
17;Girona;15;Cerdanya;17141;Puigcerdà;1;2;B;;725;432;293;2;7;423;430
17;Girona;15;Cerdanya;17141;Puigcerdà;1;3;A;;725;442;283;3;2;437;439
17;Girona;15;Cerdanya;17141;Puigcerdà;1;3;B;;613;365;248;4;2;359;361
17;Girona;15;Cerdanya;17141;Puigcerdà;1;4;A;;844;451;393;2;3;446;449
17;Girona;15;Cerdanya;17141;Puigcerdà;1;4;B;;739;431;308;0;4;427;431
17;Girona;15;Cerdanya;17141;Puigcerdà;1;5;U;;775;447;328;4;11;432;443
8;Barcelona;3;Alt Penedès;08174;Puigdàlber;1;1;U;;305;246;59;3;6;237;243
25;Lleida;18;Garrigues;25180;Puiggròs;1;1;U;;241;177;64;0;3;174;177
43;Tarragona;1;Alt Camp;43119;Puigpelat;1;1;U;;542;291;251;3;1;287;288
8;Barcelona;14;Berguedà;08175;Puig-reig;1;1;A;;889;644;245;0;5;639;644
8;Barcelona;14;Berguedà;08175;Puig-reig;1;1;B;;964;708;256;9;6;693;699
8;Barcelona;14;Berguedà;08175;Puig-reig;1;2;A;;516;376;140;0;2;374;376
8;Barcelona;14;Berguedà;08175;Puig-reig;1;2;B;;614;462;152;1;2;459;461
8;Barcelona;14;Berguedà;08175;Puig-reig;2;1;A;;220;168;52;1;1;166;167
8;Barcelona;14;Berguedà;08175;Puig-reig;2;1;B;;144;75;69;0;0;75;75
8;Barcelona;14;Berguedà;08175;Puig-reig;2;1;C;;256;206;50;2;0;204;204
25;Lleida;38;Urgell;25181;Puigverd d'Agramunt;1;1;U;;198;162;36;0;3;159;162
25;Lleida;33;Segrià;25182;Puigverd de Lleida;1;1;U;;946;680;266;2;7;671;678
8;Barcelona;6;Anoia;08176;Pujalt;1;1;U;;174;133;41;0;0;133;133
8;Barcelona;14;Berguedà;08177;Quar, la;1;1;U;;65;41;24;0;0;41;41
17;Girona;20;Gironès;17142;Quart;1;1;A;;537;391;146;3;5;383;388
17;Girona;20;Gironès;17142;Quart;1;1;B;;498;371;127;1;3;367;370
17;Girona;20;Gironès;17142;Quart;1;2;A;;519;399;120;2;5;392;397
17;Girona;20;Gironès;17142;Quart;1;2;B;;263;200;63;1;0;199;199
17;Girona;20;Gironès;17142;Quart;1;2;C;;203;138;65;1;0;137;137
17;Girona;31;Ripollès;17043;Queralbs;1;1;U;;166;132;34;1;1;130;131
43;Tarragona;1;Alt Camp;43120;Querol;1;1;U;;258;145;113;1;0;144;144
17;Girona;2;Alt Empordà;17143;Rabós;1;1;U;;125;90;35;0;1;89;90
8;Barcelona;7;Bages;08178;Rajadell;1;1;U;;416;296;120;3;3;290;293
43;Tarragona;30;Ribera d'Ebre;43121;Rasquera;1;1;U;;700;427;273;1;5;421;426
17;Girona;10;Baix Empordà;17144;Regencós;1;1;U;;226;170;56;0;2;168;170
8;Barcelona;40;Vallès Occidental;08179;Rellinars;1;1;U;;449;350;99;0;1;349;350
43;Tarragona;36;Tarragonès;43122;Renau;1;1;U;;63;55;8;0;0;55;55
43;Tarragona;8;Baix Camp;43123;Reus;1;1;U;;401;245;156;0;4;241;245
43;Tarragona;8;Baix Camp;43123;Reus;1;2;U;;385;225;160;0;3;222;225
43;Tarragona;8;Baix Camp;43123;Reus;1;3;A;;474;305;169;0;2;303;305
43;Tarragona;8;Baix Camp;43123;Reus;1;3;B;;554;341;213;1;0;340;340
43;Tarragona;8;Baix Camp;43123;Reus;1;4;A;;381;267;114;0;3;264;267
43;Tarragona;8;Baix Camp;43123;Reus;1;4;B;;338;219;119;3;1;215;216
43;Tarragona;8;Baix Camp;43123;Reus;1;4;C;;433;288;145;0;1;287;288
43;Tarragona;8;Baix Camp;43123;Reus;10;1;A;;456;258;198;1;7;250;257
43;Tarragona;8;Baix Camp;43123;Reus;10;1;B;;587;317;270;1;9;307;316
43;Tarragona;8;Baix Camp;43123;Reus;2;1;A;;295;171;124;0;0;171;171
43;Tarragona;8;Baix Camp;43123;Reus;2;1;B;;321;165;156;0;2;163;165
43;Tarragona;8;Baix Camp;43123;Reus;2;10;A;;528;341;187;0;2;339;341
43;Tarragona;8;Baix Camp;43123;Reus;2;10;B;;532;313;219;0;1;312;313
43;Tarragona;8;Baix Camp;43123;Reus;2;10;C;;600;365;235;0;5;360;365
43;Tarragona;8;Baix Camp;43123;Reus;2;11;A;;413;248;165;0;0;248;248
43;Tarragona;8;Baix Camp;43123;Reus;2;11;B;;477;265;212;0;1;264;265
43;Tarragona;8;Baix Camp;43123;Reus;2;12;A;;483;294;189;0;0;294;294
43;Tarragona;8;Baix Camp;43123;Reus;2;12;B;;577;322;255;0;0;322;322
43;Tarragona;8;Baix Camp;43123;Reus;2;13;A;;412;242;170;0;3;239;242
43;Tarragona;8;Baix Camp;43123;Reus;2;13;B;;547;318;229;2;2;314;316
43;Tarragona;8;Baix Camp;43123;Reus;2;14;A;;302;194;108;0;3;191;194
43;Tarragona;8;Baix Camp;43123;Reus;2;14;B;;367;240;127;1;2;237;239
43;Tarragona;8;Baix Camp;43123;Reus;2;15;A;;334;252;82;0;2;250;252
43;Tarragona;8;Baix Camp;43123;Reus;2;15;B;;391;276;115;3;5;268;273
43;Tarragona;8;Baix Camp;43123;Reus;2;2;A;;570;374;196;2;4;368;372
43;Tarragona;8;Baix Camp;43123;Reus;2;2;B;;518;299;219;0;1;298;299
43;Tarragona;8;Baix Camp;43123;Reus;2;2;C;;564;332;232;1;2;329;331
43;Tarragona;8;Baix Camp;43123;Reus;2;3;A;;385;261;124;1;4;256;260
43;Tarragona;8;Baix Camp;43123;Reus;2;3;B;;443;301;142;0;2;299;301
43;Tarragona;8;Baix Camp;43123;Reus;2;4;U;;584;317;267;3;1;313;314
43;Tarragona;8;Baix Camp;43123;Reus;2;5;A;;423;231;192;0;0;231;231
43;Tarragona;8;Baix Camp;43123;Reus;2;5;B;;436;260;176;2;3;255;258
43;Tarragona;8;Baix Camp;43123;Reus;2;6;A;;550;300;250;2;2;296;298
43;Tarragona;8;Baix Camp;43123;Reus;2;6;B;;605;333;272;0;5;328;333
43;Tarragona;8;Baix Camp;43123;Reus;2;6;C;;601;337;264;0;2;335;337
43;Tarragona;8;Baix Camp;43123;Reus;2;7;A;;499;303;196;0;0;303;303
43;Tarragona;8;Baix Camp;43123;Reus;2;7;B;;550;338;212;1;2;335;337
43;Tarragona;8;Baix Camp;43123;Reus;2;8;A;;252;145;107;2;0;143;143
43;Tarragona;8;Baix Camp;43123;Reus;2;8;B;;231;124;107;0;0;124;124
43;Tarragona;8;Baix Camp;43123;Reus;2;8;C;;278;155;123;1;1;153;154
43;Tarragona;8;Baix Camp;43123;Reus;2;9;A;;427;330;97;0;1;329;330
43;Tarragona;8;Baix Camp;43123;Reus;2;9;B;;489;349;140;0;6;343;349
43;Tarragona;8;Baix Camp;43123;Reus;3;1;A;;250;151;99;1;0;150;150
43;Tarragona;8;Baix Camp;43123;Reus;3;1;B;;255;145;110;0;1;144;145
43;Tarragona;8;Baix Camp;43123;Reus;3;10;A;;391;209;182;2;1;206;207
43;Tarragona;8;Baix Camp;43123;Reus;3;10;B;;495;222;273;0;2;220;222
43;Tarragona;8;Baix Camp;43123;Reus;3;10;C;;474;226;248;0;0;226;226
43;Tarragona;8;Baix Camp;43123;Reus;3;11;A;;534;254;280;2;1;251;252
43;Tarragona;8;Baix Camp;43123;Reus;3;11;B;;640;279;361;1;1;277;278
43;Tarragona;8;Baix Camp;43123;Reus;3;11;C;;595;291;304;0;5;286;291
43;Tarragona;8;Baix Camp;43123;Reus;3;12;A;;311;184;127;2;2;180;182
43;Tarragona;8;Baix Camp;43123;Reus;3;12;B;;395;207;188;3;2;202;204
43;Tarragona;8;Baix Camp;43123;Reus;3;12;C;;385;187;198;7;3;177;180
43;Tarragona;8;Baix Camp;43123;Reus;3;13;A;;461;235;226;3;4;228;232
43;Tarragona;8;Baix Camp;43123;Reus;3;13;B;;528;300;228;3;1;296;297
43;Tarragona;8;Baix Camp;43123;Reus;3;2;U;;426;256;170;0;3;253;256
43;Tarragona;8;Baix Camp;43123;Reus;3;3;A;;436;245;191;0;0;245;245
43;Tarragona;8;Baix Camp;43123;Reus;3;3;B;;482;277;205;0;3;274;277
43;Tarragona;8;Baix Camp;43123;Reus;3;4;A;;481;271;210;1;0;270;270
43;Tarragona;8;Baix Camp;43123;Reus;3;4;B;;586;320;266;0;2;318;320
43;Tarragona;8;Baix Camp;43123;Reus;3;5;A;;371;216;155;0;2;214;216
43;Tarragona;8;Baix Camp;43123;Reus;3;5;B;;410;246;164;0;2;244;246
43;Tarragona;8;Baix Camp;43123;Reus;3;6;U;;478;275;203;2;4;269;273
43;Tarragona;8;Baix Camp;43123;Reus;3;7;U;;703;332;371;0;6;326;332
43;Tarragona;8;Baix Camp;43123;Reus;3;8;A;;417;261;156;1;4;256;260
43;Tarragona;8;Baix Camp;43123;Reus;3;8;B;;445;259;186;1;2;256;258
43;Tarragona;8;Baix Camp;43123;Reus;3;8;C;;488;287;201;2;5;280;285
43;Tarragona;8;Baix Camp;43123;Reus;3;9;A;;464;260;204;1;1;258;259
43;Tarragona;8;Baix Camp;43123;Reus;3;9;B;;541;295;246;3;3;289;292
43;Tarragona;8;Baix Camp;43123;Reus;4;1;U;;427;217;210;0;5;212;217
43;Tarragona;8;Baix Camp;43123;Reus;4;2;A;;429;266;163;0;2;264;266
43;Tarragona;8;Baix Camp;43123;Reus;4;2;B;;366;209;157;1;1;207;208
43;Tarragona;8;Baix Camp;43123;Reus;4;2;C;;448;262;186;1;1;260;261
43;Tarragona;8;Baix Camp;43123;Reus;4;3;U;;521;268;253;3;4;261;265
43;Tarragona;8;Baix Camp;43123;Reus;4;4;A;;496;261;235;0;3;258;261
43;Tarragona;8;Baix Camp;43123;Reus;4;4;B;;628;353;275;1;0;352;352
43;Tarragona;8;Baix Camp;43123;Reus;4;5;A;;361;212;149;0;4;208;212
43;Tarragona;8;Baix Camp;43123;Reus;4;5;B;;343;195;148;0;1;194;195
43;Tarragona;8;Baix Camp;43123;Reus;4;6;A;;428;216;212;3;3;210;213
43;Tarragona;8;Baix Camp;43123;Reus;4;6;B;;407;203;204;0;0;203;203
43;Tarragona;8;Baix Camp;43123;Reus;4;7;A;;379;170;209;0;1;169;170
43;Tarragona;8;Baix Camp;43123;Reus;4;7;B;;409;192;217;0;1;191;192
43;Tarragona;8;Baix Camp;43123;Reus;4;7;C;;450;203;247;0;2;201;203
43;Tarragona;8;Baix Camp;43123;Reus;4;8;A;;406;211;195;0;3;208;211
43;Tarragona;8;Baix Camp;43123;Reus;4;8;B;;392;198;194;0;0;198;198
43;Tarragona;8;Baix Camp;43123;Reus;4;8;C;;409;230;179;0;1;229;230
43;Tarragona;8;Baix Camp;43123;Reus;5;1;A;;402;223;179;1;6;216;222
43;Tarragona;8;Baix Camp;43123;Reus;5;1;B;;401;212;189;2;3;207;210
43;Tarragona;8;Baix Camp;43123;Reus;5;1;C;;420;238;182;0;3;235;238
43;Tarragona;8;Baix Camp;43123;Reus;5;2;A;;321;192;129;0;1;191;192
43;Tarragona;8;Baix Camp;43123;Reus;5;2;B;;377;221;156;1;0;220;220
43;Tarragona;8;Baix Camp;43123;Reus;5;2;C;;406;242;164;0;3;239;242
43;Tarragona;8;Baix Camp;43123;Reus;5;3;A;;453;230;223;2;1;227;228
43;Tarragona;8;Baix Camp;43123;Reus;5;3;B;;496;288;208;1;2;285;287
43;Tarragona;8;Baix Camp;43123;Reus;5;4;A;;494;271;223;0;1;270;271
43;Tarragona;8;Baix Camp;43123;Reus;5;4;B;;489;269;220;1;2;266;268
43;Tarragona;8;Baix Camp;43123;Reus;5;4;C;;499;289;210;0;4;285;289
43;Tarragona;8;Baix Camp;43123;Reus;5;5;A;;416;223;193;0;2;221;223
43;Tarragona;8;Baix Camp;43123;Reus;5;5;B;;451;242;209;0;0;242;242
43;Tarragona;8;Baix Camp;43123;Reus;5;5;C;;513;279;234;3;4;272;276
43;Tarragona;8;Baix Camp;43123;Reus;5;6;U;;509;304;205;6;2;296;298
43;Tarragona;8;Baix Camp;43123;Reus;5;7;A;;456;264;192;0;8;256;264
43;Tarragona;8;Baix Camp;43123;Reus;5;7;B;;531;305;226;0;7;298;305
43;Tarragona;8;Baix Camp;43123;Reus;6;1;A;;350;213;137;1;3;209;212
43;Tarragona;8;Baix Camp;43123;Reus;6;1;B;;411;252;159;0;0;252;252
43;Tarragona;8;Baix Camp;43123;Reus;6;10;U;;495;255;240;1;2;252;254
43;Tarragona;8;Baix Camp;43123;Reus;6;11;A;;524;396;128;1;6;389;395
43;Tarragona;8;Baix Camp;43123;Reus;6;11;B;;402;278;124;0;5;273;278
43;Tarragona;8;Baix Camp;43123;Reus;6;11;C;;522;368;154;0;5;363;368
43;Tarragona;8;Baix Camp;43123;Reus;6;12;A;;419;262;157;0;0;262;262
43;Tarragona;8;Baix Camp;43123;Reus;6;12;B;;520;340;180;2;6;332;338
43;Tarragona;8;Baix Camp;43123;Reus;6;13;A;;382;244;138;0;1;243;244
43;Tarragona;8;Baix Camp;43123;Reus;6;13;B;;382;248;134;0;0;248;248
43;Tarragona;8;Baix Camp;43123;Reus;6;2;A;;408;301;107;0;4;297;301
43;Tarragona;8;Baix Camp;43123;Reus;6;2;B;;322;204;118;3;3;198;201
43;Tarragona;8;Baix Camp;43123;Reus;6;2;C;;420;312;108;2;2;308;310
43;Tarragona;8;Baix Camp;43123;Reus;6;3;A;;491;349;142;2;3;344;347
43;Tarragona;8;Baix Camp;43123;Reus;6;3;B;;476;286;190;5;3;278;281
43;Tarragona;8;Baix Camp;43123;Reus;6;3;C;;562;366;196;0;4;362;366
43;Tarragona;8;Baix Camp;43123;Reus;6;4;A;;451;351;100;1;2;348;350
43;Tarragona;8;Baix Camp;43123;Reus;6;4;B;;437;334;103;0;3;331;334
43;Tarragona;8;Baix Camp;43123;Reus;6;4;C;;532;394;138;0;4;390;394
43;Tarragona;8;Baix Camp;43123;Reus;6;5;A;;484;220;264;0;3;217;220
43;Tarragona;8;Baix Camp;43123;Reus;6;5;B;;558;273;285;1;1;271;272
43;Tarragona;8;Baix Camp;43123;Reus;6;6;A;;524;345;179;0;2;343;345
43;Tarragona;8;Baix Camp;43123;Reus;6;6;B;;404;265;139;0;1;264;265
43;Tarragona;8;Baix Camp;43123;Reus;6;6;C;;486;319;167;0;2;317;319
43;Tarragona;8;Baix Camp;43123;Reus;6;7;A;;441;303;138;0;4;299;303
43;Tarragona;8;Baix Camp;43123;Reus;6;7;B;;442;284;158;1;2;281;283
43;Tarragona;8;Baix Camp;43123;Reus;6;8;A;;424;266;158;3;2;261;263
43;Tarragona;8;Baix Camp;43123;Reus;6;8;B;;465;268;197;0;1;267;268
43;Tarragona;8;Baix Camp;43123;Reus;6;9;A;;287;138;149;0;2;136;138
43;Tarragona;8;Baix Camp;43123;Reus;6;9;B;;367;157;210;0;1;156;157
43;Tarragona;8;Baix Camp;43123;Reus;7;1;A;;444;162;282;0;1;161;162
43;Tarragona;8;Baix Camp;43123;Reus;7;1;B;;512;173;339;0;1;172;173
43;Tarragona;8;Baix Camp;43123;Reus;7;1;C;;497;176;321;0;2;174;176
43;Tarragona;8;Baix Camp;43123;Reus;7;2;A;;477;170;307;0;3;167;170
43;Tarragona;8;Baix Camp;43123;Reus;7;2;B;;515;189;326;0;0;189;189
43;Tarragona;8;Baix Camp;43123;Reus;7;2;C;;585;208;377;0;3;205;208
43;Tarragona;8;Baix Camp;43123;Reus;7;3;A;;407;225;182;0;0;225;225
43;Tarragona;8;Baix Camp;43123;Reus;7;3;B;;484;235;249;1;0;234;234
43;Tarragona;8;Baix Camp;43123;Reus;7;3;C;;435;221;214;0;2;219;221
43;Tarragona;8;Baix Camp;43123;Reus;8;1;A;;249;121;128;0;2;119;121
43;Tarragona;8;Baix Camp;43123;Reus;8;1;B;;331;169;162;0;0;169;169
43;Tarragona;8;Baix Camp;43123;Reus;8;1;C;;321;143;178;0;0;143;143
43;Tarragona;8;Baix Camp;43123;Reus;8;2;A;;488;247;241;0;2;245;247
43;Tarragona;8;Baix Camp;43123;Reus;8;2;B;;424;242;182;1;1;240;241
43;Tarragona;8;Baix Camp;43123;Reus;8;3;U;;739;436;303;2;4;430;434
43;Tarragona;8;Baix Camp;43123;Reus;8;4;A;;440;243;197;1;2;240;242
43;Tarragona;8;Baix Camp;43123;Reus;8;4;B;;490;262;228;0;3;259;262
43;Tarragona;8;Baix Camp;43123;Reus;8;5;U;;508;273;235;3;1;269;270
43;Tarragona;8;Baix Camp;43123;Reus;8;6;A;;536;313;223;1;3;309;312
43;Tarragona;8;Baix Camp;43123;Reus;8;6;B;;688;381;307;1;5;375;380
43;Tarragona;8;Baix Camp;43123;Reus;8;7;A;;366;225;141;1;2;222;224
43;Tarragona;8;Baix Camp;43123;Reus;8;7;B;;436;263;173;0;6;257;263
43;Tarragona;8;Baix Camp;43123;Reus;8;7;C;;405;242;163;0;3;239;242
43;Tarragona;8;Baix Camp;43123;Reus;9;1;A;;527;339;188;0;1;338;339
43;Tarragona;8;Baix Camp;43123;Reus;9;1;B;;618;417;201;0;1;416;417
43;Tarragona;8;Baix Camp;43123;Reus;9;2;A;;363;84;279;1;0;83;83
43;Tarragona;8;Baix Camp;43123;Reus;9;2;B;;361;102;259;0;0;102;102
25;Lleida;26;Pallars Sobirà;25183;Rialp;1;1;U;;463;327;136;1;4;322;326
43;Tarragona;1;Alt Camp;43124;Riba, la;1;1;U;;604;442;162;1;5;436;441
43;Tarragona;30;Ribera d'Ebre;43125;Riba-roja d'Ebre;1;1;A;;625;432;193;1;6;425;431
43;Tarragona;30;Ribera d'Ebre;43125;Riba-roja d'Ebre;1;1;B;;481;318;163;1;2;315;317
25;Lleida;32;Segarra;25905;Ribera d'Ondara;1;1;U;;420;307;113;4;1;302;303
25;Lleida;4;Alt Urgell;25185;Ribera d'Urgellet;1;1;U;;698;459;239;0;5;454;459
17;Girona;31;Ripollès;17145;Ribes de Freser;1;1;A;;364;270;94;3;2;265;267
17;Girona;31;Ripollès;17145;Ribes de Freser;1;1;B;;459;340;119;2;3;335;338
17;Girona;31;Ripollès;17145;Ribes de Freser;1;2;A;;410;287;123;2;4;281;285
17;Girona;31;Ripollès;17145;Ribes de Freser;1;2;B;;530;388;142;0;2;386;388
17;Girona;34;Selva;17146;Riells i Viabrea;1;1;A;;1058;664;394;5;3;656;659
17;Girona;34;Selva;17146;Riells i Viabrea;1;1;B;;985;607;378;3;3;601;604
43;Tarragona;36;Tarragonès;43126;Riera de Gaià, la;1;1;U;;937;680;257;2;2;676;678
25;Lleida;35;Solsonès;25186;Riner;1;1;U;;236;186;50;2;1;183;184
17;Girona;31;Ripollès;17147;Ripoll;1;1;U;;532;369;163;2;4;363;367
17;Girona;31;Ripollès;17147;Ripoll;1;2;U;;575;373;202;0;5;368;373
17;Girona;31;Ripollès;17147;Ripoll;2;1;U;;774;567;207;0;3;564;567
17;Girona;31;Ripollès;17147;Ripoll;2;2;A;;742;493;249;2;7;484;491
17;Girona;31;Ripollès;17147;Ripoll;2;2;B;;310;190;120;0;4;186;190
17;Girona;31;Ripollès;17147;Ripoll;3;1;A;;470;309;161;0;6;303;309
17;Girona;31;Ripollès;17147;Ripoll;3;1;B;;496;363;133;0;2;361;363
17;Girona;31;Ripollès;17147;Ripoll;3;2;U;;717;517;200;4;7;506;513
17;Girona;31;Ripollès;17147;Ripoll;3;3;A;;837;583;254;1;12;570;582
17;Girona;31;Ripollès;17147;Ripoll;3;3;B;;893;685;208;0;10;675;685
17;Girona;31;Ripollès;17147;Ripoll;3;4;A;;799;551;248;4;10;537;547
17;Girona;31;Ripollès;17147;Ripoll;3;4;B;;838;570;268;3;4;563;567
17;Girona;31;Ripollès;17147;Ripoll;4;1;U;;878;634;244;0;7;627;634
8;Barcelona;40;Vallès Occidental;08180;Ripollet;1;1;A;;961;526;435;0;6;520;526
8;Barcelona;40;Vallès Occidental;08180;Ripollet;1;1;B;;931;502;429;0;3;499;502
8;Barcelona;40;Vallès Occidental;08180;Ripollet;1;1;C;;1237;683;554;0;4;679;683
8;Barcelona;40;Vallès Occidental;08180;Ripollet;1;1;D;;933;516;417;0;4;512;516
8;Barcelona;40;Vallès Occidental;08180;Ripollet;1;2;A;;574;345;229;1;1;343;344
8;Barcelona;40;Vallès Occidental;08180;Ripollet;1;2;B;;725;439;286;3;3;433;436
8;Barcelona;40;Vallès Occidental;08180;Ripollet;1;2;C;;668;382;286;1;0;381;381
8;Barcelona;40;Vallès Occidental;08180;Ripollet;1;3;A;;558;337;221;1;1;335;336
8;Barcelona;40;Vallès Occidental;08180;Ripollet;1;3;B;;693;355;338;1;4;350;354
8;Barcelona;40;Vallès Occidental;08180;Ripollet;1;4;A;;472;301;171;1;6;294;300
8;Barcelona;40;Vallès Occidental;08180;Ripollet;1;4;B;;538;342;196;1;1;340;341
8;Barcelona;40;Vallès Occidental;08180;Ripollet;1;5;A;;697;378;319;0;4;374;378
8;Barcelona;40;Vallès Occidental;08180;Ripollet;1;5;B;;854;426;428;0;4;422;426
8;Barcelona;40;Vallès Occidental;08180;Ripollet;1;6;A;;602;328;274;0;4;324;328
8;Barcelona;40;Vallès Occidental;08180;Ripollet;1;6;B;;753;401;352;0;3;398;401
8;Barcelona;40;Vallès Occidental;08180;Ripollet;1;7;A;;842;449;393;0;5;444;449
8;Barcelona;40;Vallès Occidental;08180;Ripollet;1;7;B;;923;482;441;0;6;476;482
8;Barcelona;40;Vallès Occidental;08180;Ripollet;1;8;A;;834;472;362;0;2;470;472
8;Barcelona;40;Vallès Occidental;08180;Ripollet;1;8;B;;910;487;423;2;0;485;485
8;Barcelona;40;Vallès Occidental;08180;Ripollet;1;9;A;;877;507;370;6;6;495;501
8;Barcelona;40;Vallès Occidental;08180;Ripollet;1;9;B;;1055;635;420;13;14;608;622
8;Barcelona;40;Vallès Occidental;08180;Ripollet;2;1;A;;556;319;237;0;4;315;319
8;Barcelona;40;Vallès Occidental;08180;Ripollet;2;1;B;;760;407;353;1;6;400;406
8;Barcelona;40;Vallès Occidental;08180;Ripollet;2;2;A;;672;366;306;1;1;364;365
8;Barcelona;40;Vallès Occidental;08180;Ripollet;2;2;B;;726;408;318;1;5;402;407
8;Barcelona;40;Vallès Occidental;08180;Ripollet;2;3;A;;698;351;347;2;4;345;349
8;Barcelona;40;Vallès Occidental;08180;Ripollet;2;3;B;;910;443;467;0;5;438;443
8;Barcelona;40;Vallès Occidental;08180;Ripollet;2;4;A;;618;353;265;0;5;348;353
8;Barcelona;40;Vallès Occidental;08180;Ripollet;2;4;B;;718;382;336;1;3;378;381
8;Barcelona;40;Vallès Occidental;08180;Ripollet;2;5;A;;472;225;247;0;1;224;225
8;Barcelona;40;Vallès Occidental;08180;Ripollet;2;5;B;;544;259;285;0;3;256;259
8;Barcelona;40;Vallès Occidental;08180;Ripollet;2;6;A;;604;314;290;0;6;308;314
8;Barcelona;40;Vallès Occidental;08180;Ripollet;2;6;B;;757;393;364;0;6;387;393
8;Barcelona;40;Vallès Occidental;08180;Ripollet;2;7;A;;462;219;243;0;1;218;219
8;Barcelona;40;Vallès Occidental;08180;Ripollet;2;7;B;;583;268;315;1;1;266;267
17;Girona;34;Selva;17148;Riudarenes;1;1;A;;579;390;189;2;2;386;388
17;Girona;34;Selva;17148;Riudarenes;1;1;B;;597;411;186;4;5;402;407
17;Girona;19;Garrotxa;17149;Riudaura;1;1;U;;358;272;86;1;2;269;271
43;Tarragona;8;Baix Camp;43127;Riudecanyes;1;1;U;;593;449;144;2;2;445;447
25;Lleida;15;Cerdanya;25913;Riu de Cerdanya;1;1;U;;93;65;28;1;0;64;64
43;Tarragona;8;Baix Camp;43128;Riudecols;1;1;A;;347;255;92;0;2;253;255
43;Tarragona;8;Baix Camp;43128;Riudecols;1;1;B;;450;342;108;0;1;341;342
17;Girona;34;Selva;17150;Riudellots de la Selva;1;1;A;;674;496;178;0;0;496;496
17;Girona;34;Selva;17150;Riudellots de la Selva;1;1;B;;697;499;198;2;4;493;497
43;Tarragona;8;Baix Camp;43129;Riudoms;1;1;A;;531;347;184;8;6;333;339
43;Tarragona;8;Baix Camp;43129;Riudoms;1;1;B;;481;290;191;2;0;288;288
43;Tarragona;8;Baix Camp;43129;Riudoms;2;1;A;;353;231;122;1;3;227;230
43;Tarragona;8;Baix Camp;43129;Riudoms;2;1;B;;359;227;132;3;1;223;224
43;Tarragona;8;Baix Camp;43129;Riudoms;2;2;A;;699;455;244;3;4;448;452
43;Tarragona;8;Baix Camp;43129;Riudoms;2;2;B;;666;409;257;3;3;403;406
43;Tarragona;8;Baix Camp;43129;Riudoms;2;2;C;;678;468;210;2;4;462;466
43;Tarragona;8;Baix Camp;43129;Riudoms;2;3;U;;459;348;111;0;5;343;348
17;Girona;2;Alt Empordà;17151;Riumors;1;1;U;;172;115;57;1;2;112;114
8;Barcelona;41;Vallès Oriental;08181;Roca del Vallès, la;1;1;A;;542;336;206;0;1;335;336
8;Barcelona;41;Vallès Oriental;08181;Roca del Vallès, la;1;1;B;;633;367;266;0;4;363;367
8;Barcelona;41;Vallès Oriental;08181;Roca del Vallès, la;1;1;C;;376;214;162;4;0;210;210
8;Barcelona;41;Vallès Oriental;08181;Roca del Vallès, la;1;1;D;;484;357;127;1;5;351;356
8;Barcelona;41;Vallès Oriental;08181;Roca del Vallès, la;1;2;A;;679;410;269;2;2;406;408
8;Barcelona;41;Vallès Oriental;08181;Roca del Vallès, la;1;2;B;;719;446;273;2;4;440;444
8;Barcelona;41;Vallès Oriental;08181;Roca del Vallès, la;1;2;C;;725;430;295;3;5;422;427
8;Barcelona;41;Vallès Oriental;08181;Roca del Vallès, la;1;2;D;;647;403;244;0;4;399;403
8;Barcelona;41;Vallès Oriental;08181;Roca del Vallès, la;1;3;A;;621;379;242;3;4;372;376
8;Barcelona;41;Vallès Oriental;08181;Roca del Vallès, la;1;3;B;;731;424;307;0;5;419;424
8;Barcelona;41;Vallès Oriental;08181;Roca del Vallès, la;1;3;C;;690;417;273;1;4;412;416
43;Tarragona;16;Conca de Barberà;43130;Rocafort de Queralt;1;1;U;;236;180;56;0;0;180;180
43;Tarragona;36;Tarragonès;43131;Roda de Berà;1;1;A;;575;339;236;1;3;335;338
43;Tarragona;36;Tarragonès;43131;Roda de Berà;1;1;B;;700;385;315;1;4;380;384
43;Tarragona;36;Tarragonès;43131;Roda de Berà;1;2;U;;945;466;479;3;6;457;463
43;Tarragona;36;Tarragonès;43131;Roda de Berà;1;3;A;;528;322;206;3;2;317;319
43;Tarragona;36;Tarragonès;43131;Roda de Berà;1;3;B;;593;343;250;0;5;338;343
8;Barcelona;24;Osona;08183;Roda de Ter;1;1;A;;580;403;177;0;5;398;403
8;Barcelona;24;Osona;08183;Roda de Ter;1;1;B;;671;463;208;3;1;459;460
8;Barcelona;24;Osona;08183;Roda de Ter;1;2;U;;954;742;212;4;3;735;738
8;Barcelona;24;Osona;08183;Roda de Ter;1;3;A;;518;378;140;0;4;374;378
8;Barcelona;24;Osona;08183;Roda de Ter;1;3;B;;577;407;170;0;1;406;407
8;Barcelona;24;Osona;08183;Roda de Ter;2;1;U;;841;620;221;0;2;618;620
43;Tarragona;1;Alt Camp;43132;Rodonyà;1;1;U;;344;251;93;1;4;246;250
43;Tarragona;9;Baix Ebre;43133;Roquetes;1;1;A;;671;409;262;3;5;401;406
43;Tarragona;9;Baix Ebre;43133;Roquetes;1;1;B;;491;271;220;1;7;263;270
43;Tarragona;9;Baix Ebre;43133;Roquetes;1;2;A;;602;379;223;3;5;371;376
43;Tarragona;9;Baix Ebre;43133;Roquetes;1;2;B;;529;302;227;1;5;296;301
43;Tarragona;9;Baix Ebre;43133;Roquetes;2;1;A;;859;526;333;4;7;515;522
43;Tarragona;9;Baix Ebre;43133;Roquetes;2;1;B;;430;273;157;1;8;264;272
43;Tarragona;9;Baix Ebre;43133;Roquetes;2;1;C;;613;393;220;3;2;388;390
43;Tarragona;9;Baix Ebre;43133;Roquetes;2;2;A;;663;372;291;1;8;363;371
43;Tarragona;9;Baix Ebre;43133;Roquetes;2;2;B;;605;324;281;0;3;321;324
17;Girona;2;Alt Empordà;17152;Roses;1;1;U;;558;370;188;3;1;366;367
17;Girona;2;Alt Empordà;17152;Roses;1;2;A;;436;246;190;0;1;245;246
17;Girona;2;Alt Empordà;17152;Roses;1;2;B;;424;245;179;1;2;242;244
17;Girona;2;Alt Empordà;17152;Roses;1;3;A;;475;238;237;2;2;234;236
17;Girona;2;Alt Empordà;17152;Roses;1;3;B;;490;246;244;2;1;243;244
17;Girona;2;Alt Empordà;17152;Roses;1;3;C;;437;223;214;0;3;220;223
17;Girona;2;Alt Empordà;17152;Roses;1;4;A;;550;300;250;0;2;298;300
17;Girona;2;Alt Empordà;17152;Roses;1;4;B;;651;354;297;0;1;353;354
17;Girona;2;Alt Empordà;17152;Roses;1;4;C;;622;337;285;1;4;332;336
17;Girona;2;Alt Empordà;17152;Roses;2;1;U;;526;333;193;4;1;328;329
17;Girona;2;Alt Empordà;17152;Roses;2;2;A;;428;285;143;0;1;284;285
17;Girona;2;Alt Empordà;17152;Roses;2;2;B;;428;246;182;2;1;243;244
17;Girona;2;Alt Empordà;17152;Roses;2;2;C;;420;239;181;1;5;233;238
17;Girona;2;Alt Empordà;17152;Roses;2;3;A;;465;304;161;3;3;298;301
17;Girona;2;Alt Empordà;17152;Roses;2;3;B;;534;311;223;2;3;306;309
17;Girona;2;Alt Empordà;17152;Roses;2;3;C;;544;327;217;0;2;325;327
17;Girona;2;Alt Empordà;17152;Roses;2;4;A;;603;389;214;0;6;383;389
17;Girona;2;Alt Empordà;17152;Roses;2;4;B;;617;382;235;3;1;378;379
25;Lleida;33;Segrià;25189;Rosselló;1;1;A;;792;511;281;3;5;503;508
25;Lleida;33;Segrià;25189;Rosselló;1;1;B;;786;493;293;4;2;487;489
43;Tarragona;1;Alt Camp;43134;Rourell, el;1;1;U;;250;175;75;1;1;173;174
8;Barcelona;40;Vallès Occidental;08184;Rubí;1;1;A;;612;341;271;0;2;339;341
8;Barcelona;40;Vallès Occidental;08184;Rubí;1;1;B;;823;430;393;2;3;425;428
8;Barcelona;40;Vallès Occidental;08184;Rubí;1;1;C;;759;424;335;2;3;419;422
8;Barcelona;40;Vallès Occidental;08184;Rubí;1;2;A;;677;337;340;1;4;332;336
8;Barcelona;40;Vallès Occidental;08184;Rubí;1;2;B;;788;393;395;0;6;387;393
8;Barcelona;40;Vallès Occidental;08184;Rubí;1;3;A;;469;259;210;0;1;258;259
8;Barcelona;40;Vallès Occidental;08184;Rubí;1;3;B;;601;316;285;1;5;310;315
8;Barcelona;40;Vallès Occidental;08184;Rubí;2;1;A;;790;373;417;0;4;369;373
8;Barcelona;40;Vallès Occidental;08184;Rubí;2;1;B;;782;370;412;0;2;368;370
8;Barcelona;40;Vallès Occidental;08184;Rubí;2;1;C;;878;412;466;0;6;406;412
8;Barcelona;40;Vallès Occidental;08184;Rubí;2;3;A;;866;416;450;0;3;413;416
8;Barcelona;40;Vallès Occidental;08184;Rubí;2;3;B;;951;436;515;0;5;431;436
8;Barcelona;40;Vallès Occidental;08184;Rubí;2;3;C;;1034;477;557;0;3;474;477
8;Barcelona;40;Vallès Occidental;08184;Rubí;3;1;A;;895;551;344;0;6;545;551
8;Barcelona;40;Vallès Occidental;08184;Rubí;3;1;B;;940;565;375;1;7;557;564
8;Barcelona;40;Vallès Occidental;08184;Rubí;3;1;C;;999;585;414;0;7;578;585
8;Barcelona;40;Vallès Occidental;08184;Rubí;3;2;U;;539;277;262;0;1;276;277
8;Barcelona;40;Vallès Occidental;08184;Rubí;3;3;A;;421;201;220;0;1;200;201
8;Barcelona;40;Vallès Occidental;08184;Rubí;3;3;B;;525;287;238;0;6;281;287
8;Barcelona;40;Vallès Occidental;08184;Rubí;3;4;A;;739;344;395;0;7;337;344
8;Barcelona;40;Vallès Occidental;08184;Rubí;3;4;B;;805;407;398;1;3;403;406
8;Barcelona;40;Vallès Occidental;08184;Rubí;3;5;A;;706;407;299;1;2;404;406
8;Barcelona;40;Vallès Occidental;08184;Rubí;3;5;B;;958;520;438;0;7;513;520
8;Barcelona;40;Vallès Occidental;08184;Rubí;3;6;A;;682;370;312;0;5;365;370
8;Barcelona;40;Vallès Occidental;08184;Rubí;3;6;B;;783;430;353;1;3;426;429
8;Barcelona;40;Vallès Occidental;08184;Rubí;3;7;A;;533;282;251;0;4;278;282
8;Barcelona;40;Vallès Occidental;08184;Rubí;3;7;B;;616;354;262;0;4;350;354
8;Barcelona;40;Vallès Occidental;08184;Rubí;3;8;A;;523;267;256;2;0;265;265
8;Barcelona;40;Vallès Occidental;08184;Rubí;3;8;B;;602;339;263;0;1;338;339
8;Barcelona;40;Vallès Occidental;08184;Rubí;4;1;A;;478;305;173;1;1;303;304
8;Barcelona;40;Vallès Occidental;08184;Rubí;4;1;B;;625;398;227;0;4;394;398
8;Barcelona;40;Vallès Occidental;08184;Rubí;4;10;A;;645;327;318;0;3;324;327
8;Barcelona;40;Vallès Occidental;08184;Rubí;4;10;B;;843;415;428;1;4;410;414
8;Barcelona;40;Vallès Occidental;08184;Rubí;4;10;C;;807;372;435;0;1;371;372
8;Barcelona;40;Vallès Occidental;08184;Rubí;4;11;A;;497;303;194;0;5;298;303
8;Barcelona;40;Vallès Occidental;08184;Rubí;4;11;B;;641;333;308;0;4;329;333
8;Barcelona;40;Vallès Occidental;08184;Rubí;4;11;C;;638;352;286;0;3;349;352
8;Barcelona;40;Vallès Occidental;08184;Rubí;4;12;A;;546;274;272;3;2;269;271
8;Barcelona;40;Vallès Occidental;08184;Rubí;4;12;B;;736;389;347;2;2;385;387
8;Barcelona;40;Vallès Occidental;08184;Rubí;4;13;A;;664;375;289;0;4;371;375
8;Barcelona;40;Vallès Occidental;08184;Rubí;4;13;B;;694;373;321;0;3;370;373
8;Barcelona;40;Vallès Occidental;08184;Rubí;4;13;C;;708;371;337;2;3;366;369
8;Barcelona;40;Vallès Occidental;08184;Rubí;4;14;A;;862;434;428;0;2;432;434
8;Barcelona;40;Vallès Occidental;08184;Rubí;4;14;B;;1006;469;537;1;1;467;468
8;Barcelona;40;Vallès Occidental;08184;Rubí;4;15;A;;473;238;235;3;2;233;235
8;Barcelona;40;Vallès Occidental;08184;Rubí;4;15;B;;612;294;318;0;2;292;294
8;Barcelona;40;Vallès Occidental;08184;Rubí;4;16;A;;627;314;313;0;4;310;314
8;Barcelona;40;Vallès Occidental;08184;Rubí;4;16;B;;752;394;358;1;7;386;393
8;Barcelona;40;Vallès Occidental;08184;Rubí;4;16;C;;778;408;370;1;4;403;407
8;Barcelona;40;Vallès Occidental;08184;Rubí;4;16;D;;345;143;202;0;1;142;143
8;Barcelona;40;Vallès Occidental;08184;Rubí;4;18;A;;486;314;172;0;6;308;314
8;Barcelona;40;Vallès Occidental;08184;Rubí;4;18;B;;526;315;211;1;6;308;314
8;Barcelona;40;Vallès Occidental;08184;Rubí;4;19;A;;473;257;216;2;5;250;255
8;Barcelona;40;Vallès Occidental;08184;Rubí;4;19;B;;533;273;260;0;1;272;273
8;Barcelona;40;Vallès Occidental;08184;Rubí;4;2;U;;855;556;299;2;3;551;554
8;Barcelona;40;Vallès Occidental;08184;Rubí;4;20;U;;962;470;492;2;9;459;468
8;Barcelona;40;Vallès Occidental;08184;Rubí;4;21;A;;658;352;306;0;5;347;352
8;Barcelona;40;Vallès Occidental;08184;Rubí;4;21;B;;782;402;380;0;0;402;402
8;Barcelona;40;Vallès Occidental;08184;Rubí;4;22;U;;944;521;423;0;14;507;521
8;Barcelona;40;Vallès Occidental;08184;Rubí;4;3;A;;495;301;194;2;6;293;299
8;Barcelona;40;Vallès Occidental;08184;Rubí;4;3;B;;588;344;244;1;5;338;343
8;Barcelona;40;Vallès Occidental;08184;Rubí;4;4;A;;685;340;345;1;3;336;339
8;Barcelona;40;Vallès Occidental;08184;Rubí;4;4;B;;769;409;360;0;4;405;409
8;Barcelona;40;Vallès Occidental;08184;Rubí;4;5;A;;568;387;181;0;1;386;387
8;Barcelona;40;Vallès Occidental;08184;Rubí;4;5;B;;623;420;203;2;3;415;418
8;Barcelona;40;Vallès Occidental;08184;Rubí;4;6;A;;548;321;227;1;2;318;320
8;Barcelona;40;Vallès Occidental;08184;Rubí;4;6;B;;584;357;227;2;0;355;355
8;Barcelona;40;Vallès Occidental;08184;Rubí;4;7;A;;563;368;195;2;1;365;366
8;Barcelona;40;Vallès Occidental;08184;Rubí;4;7;B;;633;395;238;1;3;391;394
8;Barcelona;40;Vallès Occidental;08184;Rubí;4;8;U;;841;437;404;0;4;433;437
8;Barcelona;40;Vallès Occidental;08184;Rubí;4;9;A;;580;307;273;0;2;305;307
8;Barcelona;40;Vallès Occidental;08184;Rubí;4;9;B;;776;392;384;0;6;386;392
8;Barcelona;6;Anoia;08185;Rubió;1;1;U;;103;77;26;0;1;76;77
17;Girona;10;Baix Empordà;17153;Rupià;1;1;U;;171;147;24;0;2;145;147
8;Barcelona;24;Osona;08901;Rupit i Pruit;1;1;U;;284;234;50;0;1;233;234
8;Barcelona;40;Vallès Occidental;08187;Sabadell;1;1;U;;582;460;122;2;1;457;458
8;Barcelona;40;Vallès Occidental;08187;Sabadell;1;10;U;;690;490;200;0;2;488;490
8;Barcelona;40;Vallès Occidental;08187;Sabadell;1;11;U;;916;711;205;2;6;703;709
8;Barcelona;40;Vallès Occidental;08187;Sabadell;1;12;U;;867;640;227;3;6;631;637
8;Barcelona;40;Vallès Occidental;08187;Sabadell;1;13;U;;638;443;195;0;6;437;443
8;Barcelona;40;Vallès Occidental;08187;Sabadell;1;14;A;;603;464;139;1;2;461;463
8;Barcelona;40;Vallès Occidental;08187;Sabadell;1;14;B;;723;566;157;1;6;559;565
8;Barcelona;40;Vallès Occidental;08187;Sabadell;1;15;A;;519;392;127;0;0;392;392
8;Barcelona;40;Vallès Occidental;08187;Sabadell;1;15;B;;715;538;177;0;0;538;538
8;Barcelona;40;Vallès Occidental;08187;Sabadell;1;16;A;;631;494;137;0;5;489;494
8;Barcelona;40;Vallès Occidental;08187;Sabadell;1;16;B;;712;541;171;0;6;535;541
8;Barcelona;40;Vallès Occidental;08187;Sabadell;1;17;A;;664;455;209;1;6;448;454
8;Barcelona;40;Vallès Occidental;08187;Sabadell;1;17;B;;847;571;276;1;3;567;570
8;Barcelona;40;Vallès Occidental;08187;Sabadell;1;18;A;;613;401;212;3;3;395;398
8;Barcelona;40;Vallès Occidental;08187;Sabadell;1;18;B;;727;469;258;1;3;465;468
8;Barcelona;40;Vallès Occidental;08187;Sabadell;1;19;A;;634;453;181;0;9;444;453
8;Barcelona;40;Vallès Occidental;08187;Sabadell;1;19;B;;694;508;186;1;5;502;507
8;Barcelona;40;Vallès Occidental;08187;Sabadell;1;2;U;;930;739;191;0;10;729;739
8;Barcelona;40;Vallès Occidental;08187;Sabadell;1;20;A;;544;369;175;3;1;365;366
8;Barcelona;40;Vallès Occidental;08187;Sabadell;1;20;B;;584;393;191;0;2;391;393
8;Barcelona;40;Vallès Occidental;08187;Sabadell;1;21;U;;809;561;248;0;3;558;561
8;Barcelona;40;Vallès Occidental;08187;Sabadell;1;22;A;;653;456;197;0;6;450;456
8;Barcelona;40;Vallès Occidental;08187;Sabadell;1;22;B;;861;600;261;0;7;593;600
8;Barcelona;40;Vallès Occidental;08187;Sabadell;1;23;A;;617;392;225;0;2;390;392
8;Barcelona;40;Vallès Occidental;08187;Sabadell;1;23;B;;815;520;295;0;9;511;520
8;Barcelona;40;Vallès Occidental;08187;Sabadell;1;24;A;;578;367;211;1;2;364;366
8;Barcelona;40;Vallès Occidental;08187;Sabadell;1;24;B;;673;401;272;0;4;397;401
8;Barcelona;40;Vallès Occidental;08187;Sabadell;1;25;A;;544;366;178;0;5;361;366
8;Barcelona;40;Vallès Occidental;08187;Sabadell;1;25;B;;653;416;237;5;1;410;411
8;Barcelona;40;Vallès Occidental;08187;Sabadell;1;26;U;;727;503;224;3;4;496;500
8;Barcelona;40;Vallès Occidental;08187;Sabadell;1;27;U;;817;539;278;0;5;534;539
8;Barcelona;40;Vallès Occidental;08187;Sabadell;1;28;U;;981;667;314;1;7;659;666
8;Barcelona;40;Vallès Occidental;08187;Sabadell;1;29;U;;829;566;263;0;8;558;566
8;Barcelona;40;Vallès Occidental;08187;Sabadell;1;3;U;;807;640;167;2;6;632;638
8;Barcelona;40;Vallès Occidental;08187;Sabadell;1;30;U;;887;708;179;0;7;701;708
8;Barcelona;40;Vallès Occidental;08187;Sabadell;1;31;U;;810;622;188;1;3;618;621
8;Barcelona;40;Vallès Occidental;08187;Sabadell;1;32;U;;948;707;241;0;6;701;707
8;Barcelona;40;Vallès Occidental;08187;Sabadell;1;33;U;;910;585;325;5;5;575;580
8;Barcelona;40;Vallès Occidental;08187;Sabadell;1;34;U;;813;595;218;1;4;590;594
8;Barcelona;40;Vallès Occidental;08187;Sabadell;1;4;A;;743;579;164;1;6;572;578
8;Barcelona;40;Vallès Occidental;08187;Sabadell;1;4;B;;921;666;255;2;5;659;664
8;Barcelona;40;Vallès Occidental;08187;Sabadell;1;5;A;;606;425;181;2;2;421;423
8;Barcelona;40;Vallès Occidental;08187;Sabadell;1;5;B;;666;489;177;1;3;485;488
8;Barcelona;40;Vallès Occidental;08187;Sabadell;1;6;A;;682;532;150;0;9;523;532
8;Barcelona;40;Vallès Occidental;08187;Sabadell;1;6;B;;875;669;206;1;3;665;668
8;Barcelona;40;Vallès Occidental;08187;Sabadell;1;7;A;;696;548;148;0;8;540;548
8;Barcelona;40;Vallès Occidental;08187;Sabadell;1;7;B;;724;570;154;3;3;564;567
8;Barcelona;40;Vallès Occidental;08187;Sabadell;1;8;A;;475;379;96;0;0;379;379
8;Barcelona;40;Vallès Occidental;08187;Sabadell;1;8;B;;625;508;117;0;3;505;508
8;Barcelona;40;Vallès Occidental;08187;Sabadell;1;9;A;;667;527;140;0;1;526;527
8;Barcelona;40;Vallès Occidental;08187;Sabadell;1;9;B;;660;522;138;1;5;516;521
8;Barcelona;40;Vallès Occidental;08187;Sabadell;2;1;A;;592;451;141;0;7;444;451
8;Barcelona;40;Vallès Occidental;08187;Sabadell;2;1;B;;716;574;142;0;4;570;574
8;Barcelona;40;Vallès Occidental;08187;Sabadell;2;10;U;;751;499;252;3;1;495;496
8;Barcelona;40;Vallès Occidental;08187;Sabadell;2;11;U;;716;270;446;0;1;269;270
8;Barcelona;40;Vallès Occidental;08187;Sabadell;2;12;A;;597;337;260;0;2;335;337
8;Barcelona;40;Vallès Occidental;08187;Sabadell;2;12;B;;746;421;325;0;3;418;421
8;Barcelona;40;Vallès Occidental;08187;Sabadell;2;13;U;;868;479;389;1;2;476;478
8;Barcelona;40;Vallès Occidental;08187;Sabadell;2;14;A;;575;299;276;0;1;298;299
8;Barcelona;40;Vallès Occidental;08187;Sabadell;2;14;B;;695;343;352;0;4;339;343
8;Barcelona;40;Vallès Occidental;08187;Sabadell;2;15;A;;526;305;221;0;3;302;305
8;Barcelona;40;Vallès Occidental;08187;Sabadell;2;15;B;;641;378;263;0;4;374;378
8;Barcelona;40;Vallès Occidental;08187;Sabadell;2;16;A;;664;521;143;1;6;514;520
8;Barcelona;40;Vallès Occidental;08187;Sabadell;2;16;B;;732;574;158;0;5;569;574
8;Barcelona;40;Vallès Occidental;08187;Sabadell;2;17;U;;751;533;218;1;4;528;532
8;Barcelona;40;Vallès Occidental;08187;Sabadell;2;2;U;;1011;784;227;2;3;779;782
8;Barcelona;40;Vallès Occidental;08187;Sabadell;2;3;A;;513;335;178;0;4;331;335
8;Barcelona;40;Vallès Occidental;08187;Sabadell;2;3;B;;614;391;223;0;5;386;391
8;Barcelona;40;Vallès Occidental;08187;Sabadell;2;4;A;;644;475;169;1;1;473;474
8;Barcelona;40;Vallès Occidental;08187;Sabadell;2;4;B;;819;587;232;0;2;585;587
8;Barcelona;40;Vallès Occidental;08187;Sabadell;2;5;A;;628;440;188;0;0;440;440
8;Barcelona;40;Vallès Occidental;08187;Sabadell;2;5;B;;793;578;215;1;0;577;577
8;Barcelona;40;Vallès Occidental;08187;Sabadell;2;6;A;;553;376;177;0;2;374;376
8;Barcelona;40;Vallès Occidental;08187;Sabadell;2;6;B;;753;488;265;5;2;481;483
8;Barcelona;40;Vallès Occidental;08187;Sabadell;2;7;A;;602;425;177;2;3;420;423
8;Barcelona;40;Vallès Occidental;08187;Sabadell;2;7;B;;704;516;188;2;3;511;514
8;Barcelona;40;Vallès Occidental;08187;Sabadell;2;8;U;;697;509;188;0;11;498;509
8;Barcelona;40;Vallès Occidental;08187;Sabadell;2;9;U;;924;696;228;1;4;691;695
8;Barcelona;40;Vallès Occidental;08187;Sabadell;3;1;A;;550;293;257;1;2;290;292
8;Barcelona;40;Vallès Occidental;08187;Sabadell;3;1;B;;655;365;290;0;3;362;365
8;Barcelona;40;Vallès Occidental;08187;Sabadell;3;10;U;;770;387;383;0;3;384;387
8;Barcelona;40;Vallès Occidental;08187;Sabadell;3;11;U;;1068;592;476;0;6;586;592
8;Barcelona;40;Vallès Occidental;08187;Sabadell;3;12;U;;1104;616;488;8;2;606;608
8;Barcelona;40;Vallès Occidental;08187;Sabadell;3;13;U;;976;550;426;1;5;544;549
8;Barcelona;40;Vallès Occidental;08187;Sabadell;3;14;A;;613;342;271;0;0;342;342
8;Barcelona;40;Vallès Occidental;08187;Sabadell;3;14;B;;767;453;314;0;2;451;453
8;Barcelona;40;Vallès Occidental;08187;Sabadell;3;15;A;;543;287;256;1;2;284;286
8;Barcelona;40;Vallès Occidental;08187;Sabadell;3;15;B;;708;379;329;1;5;373;378
8;Barcelona;40;Vallès Occidental;08187;Sabadell;3;16;A;;482;242;240;0;1;241;242
8;Barcelona;40;Vallès Occidental;08187;Sabadell;3;16;B;;621;351;270;0;2;349;351
8;Barcelona;40;Vallès Occidental;08187;Sabadell;3;17;A;;372;193;179;0;0;193;193
8;Barcelona;40;Vallès Occidental;08187;Sabadell;3;17;B;;514;277;237;1;0;276;276
8;Barcelona;40;Vallès Occidental;08187;Sabadell;3;18;A;;494;289;205;0;1;288;289
8;Barcelona;40;Vallès Occidental;08187;Sabadell;3;18;B;;667;362;305;1;0;361;361
8;Barcelona;40;Vallès Occidental;08187;Sabadell;3;19;U;;881;496;385;1;10;485;495
8;Barcelona;40;Vallès Occidental;08187;Sabadell;3;2;A;;463;222;241;0;1;221;222
8;Barcelona;40;Vallès Occidental;08187;Sabadell;3;2;B;;580;282;298;0;1;281;282
8;Barcelona;40;Vallès Occidental;08187;Sabadell;3;20;U;;1060;599;461;0;7;592;599
8;Barcelona;40;Vallès Occidental;08187;Sabadell;3;21;A;;488;278;210;1;3;274;277
8;Barcelona;40;Vallès Occidental;08187;Sabadell;3;21;B;;639;347;292;2;3;342;345
8;Barcelona;40;Vallès Occidental;08187;Sabadell;3;22;U;;730;383;347;0;1;382;383
8;Barcelona;40;Vallès Occidental;08187;Sabadell;3;23;U;;622;316;306;1;0;315;315
8;Barcelona;40;Vallès Occidental;08187;Sabadell;3;24;A;;516;312;204;0;1;311;312
8;Barcelona;40;Vallès Occidental;08187;Sabadell;3;24;B;;634;366;268;0;3;363;366
8;Barcelona;40;Vallès Occidental;08187;Sabadell;3;25;U;;1034;562;472;0;7;555;562
8;Barcelona;40;Vallès Occidental;08187;Sabadell;3;26;U;;1178;688;490;0;1;687;688
8;Barcelona;40;Vallès Occidental;08187;Sabadell;3;27;U;;604;313;291;0;4;309;313
8;Barcelona;40;Vallès Occidental;08187;Sabadell;3;3;A;;573;289;284;0;1;288;289
8;Barcelona;40;Vallès Occidental;08187;Sabadell;3;3;B;;788;402;386;0;3;399;402
8;Barcelona;40;Vallès Occidental;08187;Sabadell;3;4;A;;583;308;275;0;3;305;308
8;Barcelona;40;Vallès Occidental;08187;Sabadell;3;4;B;;736;407;329;0;9;398;407
8;Barcelona;40;Vallès Occidental;08187;Sabadell;3;5;U;;815;485;330;1;2;482;484
8;Barcelona;40;Vallès Occidental;08187;Sabadell;3;6;A;;563;334;229;1;5;328;333
8;Barcelona;40;Vallès Occidental;08187;Sabadell;3;6;B;;679;390;289;0;3;387;390
8;Barcelona;40;Vallès Occidental;08187;Sabadell;3;7;U;;707;454;253;2;4;448;452
8;Barcelona;40;Vallès Occidental;08187;Sabadell;3;8;A;;470;268;202;0;1;267;268
8;Barcelona;40;Vallès Occidental;08187;Sabadell;3;8;B;;557;295;262;0;2;293;295
8;Barcelona;40;Vallès Occidental;08187;Sabadell;3;9;U;;711;344;367;1;2;341;343
8;Barcelona;40;Vallès Occidental;08187;Sabadell;4;1;A;;702;363;339;2;0;361;361
8;Barcelona;40;Vallès Occidental;08187;Sabadell;4;1;B;;835;475;360;1;1;473;474
8;Barcelona;40;Vallès Occidental;08187;Sabadell;4;10;A;;606;344;262;1;2;341;343
8;Barcelona;40;Vallès Occidental;08187;Sabadell;4;10;B;;676;391;285;1;7;383;390
8;Barcelona;40;Vallès Occidental;08187;Sabadell;4;11;U;;886;485;401;3;6;476;482
8;Barcelona;40;Vallès Occidental;08187;Sabadell;4;12;U;;947;516;431;1;3;512;515
8;Barcelona;40;Vallès Occidental;08187;Sabadell;4;13;A;;566;299;267;0;4;295;299
8;Barcelona;40;Vallès Occidental;08187;Sabadell;4;13;B;;666;355;311;0;4;351;355
8;Barcelona;40;Vallès Occidental;08187;Sabadell;4;14;A;;568;374;194;3;0;371;371
8;Barcelona;40;Vallès Occidental;08187;Sabadell;4;14;B;;598;385;213;0;2;383;385
8;Barcelona;40;Vallès Occidental;08187;Sabadell;4;15;U;;796;434;362;0;4;430;434
8;Barcelona;40;Vallès Occidental;08187;Sabadell;4;16;A;;601;345;256;0;4;341;345
8;Barcelona;40;Vallès Occidental;08187;Sabadell;4;16;B;;758;443;315;0;6;437;443
8;Barcelona;40;Vallès Occidental;08187;Sabadell;4;17;A;;649;358;291;1;2;355;357
8;Barcelona;40;Vallès Occidental;08187;Sabadell;4;17;B;;838;486;352;0;4;482;486
8;Barcelona;40;Vallès Occidental;08187;Sabadell;4;18;U;;560;311;249;0;2;309;311
8;Barcelona;40;Vallès Occidental;08187;Sabadell;4;19;A;;490;239;251;0;1;238;239
8;Barcelona;40;Vallès Occidental;08187;Sabadell;4;19;B;;597;299;298;0;4;295;299
8;Barcelona;40;Vallès Occidental;08187;Sabadell;4;2;A;;422;255;167;0;3;252;255
8;Barcelona;40;Vallès Occidental;08187;Sabadell;4;2;B;;542;308;234;1;0;307;307
8;Barcelona;40;Vallès Occidental;08187;Sabadell;4;20;A;;671;380;291;1;4;375;379
8;Barcelona;40;Vallès Occidental;08187;Sabadell;4;20;B;;827;458;369;0;1;457;458
8;Barcelona;40;Vallès Occidental;08187;Sabadell;4;20;C;;1173;728;445;0;5;723;728
8;Barcelona;40;Vallès Occidental;08187;Sabadell;4;21;U;;957;552;405;3;7;542;549
8;Barcelona;40;Vallès Occidental;08187;Sabadell;4;22;U;;734;414;320;1;3;410;413
8;Barcelona;40;Vallès Occidental;08187;Sabadell;4;3;U;;907;576;331;1;3;572;575
8;Barcelona;40;Vallès Occidental;08187;Sabadell;4;4;A;;659;406;253;1;6;399;405
8;Barcelona;40;Vallès Occidental;08187;Sabadell;4;4;B;;781;480;301;2;2;476;478
8;Barcelona;40;Vallès Occidental;08187;Sabadell;4;5;A;;614;395;219;3;1;391;392
8;Barcelona;40;Vallès Occidental;08187;Sabadell;4;5;B;;774;484;290;0;1;483;484
8;Barcelona;40;Vallès Occidental;08187;Sabadell;4;6;A;;627;401;226;0;5;396;401
8;Barcelona;40;Vallès Occidental;08187;Sabadell;4;6;B;;810;491;319;0;3;488;491
8;Barcelona;40;Vallès Occidental;08187;Sabadell;4;7;U;;972;594;378;1;2;591;593
8;Barcelona;40;Vallès Occidental;08187;Sabadell;4;8;A;;606;414;192;0;3;411;414
8;Barcelona;40;Vallès Occidental;08187;Sabadell;4;8;B;;718;499;219;1;5;493;498
8;Barcelona;40;Vallès Occidental;08187;Sabadell;4;9;U;;1029;676;353;0;5;671;676
8;Barcelona;40;Vallès Occidental;08187;Sabadell;5;1;U;;1088;703;385;1;8;694;702
8;Barcelona;40;Vallès Occidental;08187;Sabadell;5;10;U;;616;281;335;2;1;278;279
8;Barcelona;40;Vallès Occidental;08187;Sabadell;5;11;U;;822;434;388;0;3;431;434
8;Barcelona;40;Vallès Occidental;08187;Sabadell;5;12;U;;877;539;338;1;3;535;538
8;Barcelona;40;Vallès Occidental;08187;Sabadell;5;13;A;;606;376;230;2;2;372;374
8;Barcelona;40;Vallès Occidental;08187;Sabadell;5;13;B;;851;499;352;0;3;496;499
8;Barcelona;40;Vallès Occidental;08187;Sabadell;5;14;U;;795;529;266;1;5;523;528
8;Barcelona;40;Vallès Occidental;08187;Sabadell;5;15;U;;972;706;266;2;6;698;704
8;Barcelona;40;Vallès Occidental;08187;Sabadell;5;2;U;;1062;793;269;0;2;791;793
8;Barcelona;40;Vallès Occidental;08187;Sabadell;5;3;U;;787;602;185;1;3;598;601
8;Barcelona;40;Vallès Occidental;08187;Sabadell;5;4;U;;597;390;207;1;3;386;389
8;Barcelona;40;Vallès Occidental;08187;Sabadell;5;5;A;;472;301;171;0;1;300;301
8;Barcelona;40;Vallès Occidental;08187;Sabadell;5;5;B;;530;351;179;0;3;348;351
8;Barcelona;40;Vallès Occidental;08187;Sabadell;5;6;U;;828;600;228;0;2;598;600
8;Barcelona;40;Vallès Occidental;08187;Sabadell;5;7;A;;405;247;158;3;0;244;244
8;Barcelona;40;Vallès Occidental;08187;Sabadell;5;7;B;;538;303;235;0;1;302;303
8;Barcelona;40;Vallès Occidental;08187;Sabadell;5;8;U;;623;333;290;2;0;331;331
8;Barcelona;40;Vallès Occidental;08187;Sabadell;5;9;U;;1177;689;488;0;8;681;689
8;Barcelona;40;Vallès Occidental;08187;Sabadell;6;1;U;;677;393;284;2;3;388;391
8;Barcelona;40;Vallès Occidental;08187;Sabadell;6;10;U;;783;419;364;0;0;419;419
8;Barcelona;40;Vallès Occidental;08187;Sabadell;6;11;U;;707;329;378;2;0;327;327
8;Barcelona;40;Vallès Occidental;08187;Sabadell;6;12;U;;909;488;421;1;3;484;487
8;Barcelona;40;Vallès Occidental;08187;Sabadell;6;13;U;;852;401;451;0;2;399;401
8;Barcelona;40;Vallès Occidental;08187;Sabadell;6;14;U;;493;270;223;0;0;270;270
8;Barcelona;40;Vallès Occidental;08187;Sabadell;6;15;A;;474;245;229;1;4;240;244
8;Barcelona;40;Vallès Occidental;08187;Sabadell;6;15;B;;705;370;335;0;4;366;370
8;Barcelona;40;Vallès Occidental;08187;Sabadell;6;16;A;;656;391;265;0;3;388;391
8;Barcelona;40;Vallès Occidental;08187;Sabadell;6;16;B;;737;449;288;0;1;448;449
8;Barcelona;40;Vallès Occidental;08187;Sabadell;6;17;A;;561;331;230;0;0;331;331
8;Barcelona;40;Vallès Occidental;08187;Sabadell;6;17;B;;758;482;276;0;4;478;482
8;Barcelona;40;Vallès Occidental;08187;Sabadell;6;18;U;;871;534;337;0;0;534;534
8;Barcelona;40;Vallès Occidental;08187;Sabadell;6;19;U;;618;338;280;4;1;333;334
8;Barcelona;40;Vallès Occidental;08187;Sabadell;6;2;U;;769;441;328;0;0;441;441
8;Barcelona;40;Vallès Occidental;08187;Sabadell;6;20;U;;900;523;377;0;2;521;523
8;Barcelona;40;Vallès Occidental;08187;Sabadell;6;21;U;;871;505;366;4;3;498;501
8;Barcelona;40;Vallès Occidental;08187;Sabadell;6;22;A;;610;319;291;0;6;313;319
8;Barcelona;40;Vallès Occidental;08187;Sabadell;6;22;B;;779;444;335;2;5;437;442
8;Barcelona;40;Vallès Occidental;08187;Sabadell;6;23;A;;651;396;255;0;3;393;396
8;Barcelona;40;Vallès Occidental;08187;Sabadell;6;23;B;;804;490;314;0;3;487;490
8;Barcelona;40;Vallès Occidental;08187;Sabadell;6;24;U;;891;538;353;1;4;533;537
8;Barcelona;40;Vallès Occidental;08187;Sabadell;6;3;U;;684;389;295;1;3;385;388
8;Barcelona;40;Vallès Occidental;08187;Sabadell;6;4;U;;1086;597;489;0;2;595;597
8;Barcelona;40;Vallès Occidental;08187;Sabadell;6;5;U;;921;472;449;2;0;470;470
8;Barcelona;40;Vallès Occidental;08187;Sabadell;6;6;U;;804;415;389;0;3;412;415
8;Barcelona;40;Vallès Occidental;08187;Sabadell;6;7;U;;753;403;350;1;2;400;402
8;Barcelona;40;Vallès Occidental;08187;Sabadell;6;8;U;;1145;674;471;0;5;669;674
8;Barcelona;40;Vallès Occidental;08187;Sabadell;6;9;A;;705;369;336;1;4;364;368
8;Barcelona;40;Vallès Occidental;08187;Sabadell;6;9;B;;784;423;361;4;4;415;419
8;Barcelona;40;Vallès Occidental;08187;Sabadell;7;1;U;;879;487;392;2;5;480;485
8;Barcelona;40;Vallès Occidental;08187;Sabadell;7;2;A;;511;300;211;1;3;296;299
8;Barcelona;40;Vallès Occidental;08187;Sabadell;7;2;B;;687;417;270;9;3;405;408
8;Barcelona;40;Vallès Occidental;08187;Sabadell;7;3;A;;620;270;350;0;0;270;270
8;Barcelona;40;Vallès Occidental;08187;Sabadell;7;3;B;;755;340;415;2;3;335;338
8;Barcelona;40;Vallès Occidental;08187;Sabadell;7;4;U;;653;373;280;0;3;370;373
8;Barcelona;40;Vallès Occidental;08187;Sabadell;7;5;U;;755;408;347;0;3;405;408
8;Barcelona;40;Vallès Occidental;08187;Sabadell;7;6;U;;599;385;214;0;3;382;385
8;Barcelona;14;Berguedà;08188;Sagàs;1;1;U;;118;94;24;0;1;93;94
25;Lleida;25;Pallars Jussà;25190;Salàs de Pallars;1;1;U;;292;219;73;0;1;218;219
8;Barcelona;14;Berguedà;08190;Saldes;1;1;U;;277;194;83;2;3;189;192
17;Girona;19;Garrotxa;17154;Sales de Llierca;1;1;U;;62;46;16;0;1;45;46
8;Barcelona;7;Bages;08191;Sallent;1;1;U;;501;342;159;1;2;339;341
8;Barcelona;7;Bages;08191;Sallent;1;2;U;;593;407;186;0;1;406;407
8;Barcelona;7;Bages;08191;Sallent;1;3;A;;517;359;158;0;0;359;359
8;Barcelona;7;Bages;08191;Sallent;1;3;B;;545;364;181;1;0;363;363
8;Barcelona;7;Bages;08191;Sallent;1;4;A;;531;329;202;0;5;324;329
8;Barcelona;7;Bages;08191;Sallent;1;4;B;;528;339;189;0;4;335;339
8;Barcelona;7;Bages;08191;Sallent;1;5;U;;945;644;301;3;1;640;641
8;Barcelona;7;Bages;08191;Sallent;1;6;U;;702;476;226;0;2;474;476
8;Barcelona;7;Bages;08191;Sallent;1;7;U;;625;397;228;1;2;394;396
8;Barcelona;7;Bages;08191;Sallent;2;1;A;;232;154;78;0;0;154;154
8;Barcelona;7;Bages;08191;Sallent;2;1;B;;258;186;72;0;2;184;186
43;Tarragona;36;Tarragonès;43135;Salomó;1;1;U;;337;277;60;3;3;271;274
43;Tarragona;36;Tarragonès;43905;Salou;1;1;A;;490;232;258;1;1;230;231
43;Tarragona;36;Tarragonès;43905;Salou;1;1;B;;561;279;282;0;2;277;279
43;Tarragona;36;Tarragonès;43905;Salou;1;10;A;;579;297;282;2;6;289;295
43;Tarragona;36;Tarragonès;43905;Salou;1;10;B;;657;329;328;0;4;325;329
43;Tarragona;36;Tarragonès;43905;Salou;1;2;A;;535;228;307;0;2;226;228
43;Tarragona;36;Tarragonès;43905;Salou;1;2;B;;550;226;324;1;3;222;225
43;Tarragona;36;Tarragonès;43905;Salou;1;3;A;;440;202;238;1;4;197;201
43;Tarragona;36;Tarragonès;43905;Salou;1;3;B;;419;215;204;1;2;212;214
43;Tarragona;36;Tarragonès;43905;Salou;1;4;U;;830;434;396;1;3;430;433
43;Tarragona;36;Tarragonès;43905;Salou;1;5;U;;883;438;445;0;2;436;438
43;Tarragona;36;Tarragonès;43905;Salou;1;6;A;;663;301;362;1;1;299;300
43;Tarragona;36;Tarragonès;43905;Salou;1;6;B;;752;296;456;1;2;293;295
43;Tarragona;36;Tarragonès;43905;Salou;1;7;A;;642;335;307;0;6;329;335
43;Tarragona;36;Tarragonès;43905;Salou;1;7;B;;697;357;340;4;2;351;353
43;Tarragona;36;Tarragonès;43905;Salou;1;8;A;;541;273;268;1;1;271;272
43;Tarragona;36;Tarragonès;43905;Salou;1;8;B;;636;319;317;0;1;318;319
43;Tarragona;36;Tarragonès;43905;Salou;1;9;A;;449;270;179;2;2;266;268
43;Tarragona;36;Tarragonès;43905;Salou;1;9;B;;456;244;212;1;2;241;243
17;Girona;20;Gironès;17155;Salt;1;1;A;;593;436;157;5;0;431;431
17;Girona;20;Gironès;17155;Salt;1;1;B;;506;373;133;2;3;368;371
17;Girona;20;Gironès;17155;Salt;1;2;U;;844;548;296;1;5;542;547
17;Girona;20;Gironès;17155;Salt;1;3;A;;557;286;271;2;4;280;284
17;Girona;20;Gironès;17155;Salt;1;3;B;;568;304;264;3;3;298;301
17;Girona;20;Gironès;17155;Salt;1;4;A;;868;550;318;4;4;542;546
17;Girona;20;Gironès;17155;Salt;1;4;B;;784;488;296;0;4;484;488
17;Girona;20;Gironès;17155;Salt;1;5;A;;954;511;443;2;5;504;509
17;Girona;20;Gironès;17155;Salt;1;5;B;;817;432;385;0;6;426;432
17;Girona;20;Gironès;17155;Salt;1;6;A;;631;313;318;0;1;312;313
17;Girona;20;Gironès;17155;Salt;1;6;B;;610;318;292;0;6;312;318
17;Girona;20;Gironès;17155;Salt;1;7;U;;727;362;365;0;2;360;362
17;Girona;20;Gironès;17155;Salt;1;8;U;;844;525;319;1;4;520;524
17;Girona;20;Gironès;17155;Salt;1;9;U;;780;567;213;0;0;567;567
17;Girona;20;Gironès;17155;Salt;2;1;A;;557;330;227;1;0;329;329
17;Girona;20;Gironès;17155;Salt;2;1;B;;574;383;191;3;5;375;380
17;Girona;20;Gironès;17155;Salt;2;2;U;;1067;585;482;3;9;573;582
17;Girona;20;Gironès;17155;Salt;2;3;A;;576;330;246;0;2;328;330
17;Girona;20;Gironès;17155;Salt;2;3;B;;526;303;223;3;3;297;300
17;Girona;20;Gironès;17155;Salt;2;4;A;;852;422;430;0;4;418;422
17;Girona;20;Gironès;17155;Salt;2;4;B;;788;435;353;4;6;425;431
17;Girona;20;Gironès;17155;Salt;2;5;U;;806;567;239;0;5;562;567
17;Girona;20;Gironès;17155;Salt;2;6;U;;846;466;380;8;1;457;458
25;Lleida;32;Segarra;25191;Sanaüja;1;1;U;;388;307;81;0;0;307;307
43;Tarragona;22;Montsià;43138;Santa Bàrbara;1;1;A;;494;380;114;6;14;360;374
43;Tarragona;22;Montsià;43138;Santa Bàrbara;1;1;B;;277;211;66;3;3;205;208
43;Tarragona;22;Montsià;43138;Santa Bàrbara;1;1;C;;332;260;72;1;4;255;259
43;Tarragona;22;Montsià;43138;Santa Bàrbara;1;1;D;;378;274;104;0;3;271;274
43;Tarragona;22;Montsià;43138;Santa Bàrbara;2;1;A;;641;475;166;4;3;468;471
43;Tarragona;22;Montsià;43138;Santa Bàrbara;2;1;B;;597;433;164;5;1;427;428
8;Barcelona;24;Osona;08243;Santa Cecília de Voltregà;1;1;U;;152;126;26;0;2;124;126
8;Barcelona;11;Baix Llobregat;08244;Santa Coloma de Cervelló;1;1;A;;684;438;246;1;3;434;437
8;Barcelona;11;Baix Llobregat;08244;Santa Coloma de Cervelló;1;1;B;;899;607;292;0;5;602;607
8;Barcelona;11;Baix Llobregat;08244;Santa Coloma de Cervelló;1;2;U;;621;480;141;0;1;479;480
8;Barcelona;11;Baix Llobregat;08244;Santa Coloma de Cervelló;1;3;A;;817;517;300;0;7;510;517
8;Barcelona;11;Baix Llobregat;08244;Santa Coloma de Cervelló;1;3;B;;911;568;343;0;8;560;568
8;Barcelona;11;Baix Llobregat;08244;Santa Coloma de Cervelló;1;4;A;;474;280;194;2;1;277;278
8;Barcelona;11;Baix Llobregat;08244;Santa Coloma de Cervelló;1;4;B;;593;340;253;2;5;333;338
17;Girona;34;Selva;17180;Santa Coloma de Farners;1;1;A;;555;345;210;1;4;340;344
17;Girona;34;Selva;17180;Santa Coloma de Farners;1;1;B;;447;280;167;3;2;275;277
17;Girona;34;Selva;17180;Santa Coloma de Farners;1;1;C;;555;362;193;4;4;354;358
17;Girona;34;Selva;17180;Santa Coloma de Farners;1;2;A;;520;387;133;0;3;384;387
17;Girona;34;Selva;17180;Santa Coloma de Farners;1;2;B;;483;347;136;1;3;343;346
17;Girona;34;Selva;17180;Santa Coloma de Farners;1;3;A;;755;520;235;1;5;514;519
17;Girona;34;Selva;17180;Santa Coloma de Farners;1;3;B;;715;444;271;2;2;440;442
17;Girona;34;Selva;17180;Santa Coloma de Farners;1;4;A;;770;503;267;2;3;498;501
17;Girona;34;Selva;17180;Santa Coloma de Farners;1;4;B;;697;450;247;1;8;441;449
17;Girona;34;Selva;17180;Santa Coloma de Farners;1;5;A;;585;370;215;3;1;366;367
17;Girona;34;Selva;17180;Santa Coloma de Farners;1;5;B;;608;388;220;1;4;383;387
17;Girona;34;Selva;17180;Santa Coloma de Farners;1;6;U;;807;392;415;1;3;388;391
8;Barcelona;13;Barcelonès;08245;Santa Coloma de Gramenet;1;1;U;;854;609;245;4;7;598;605
8;Barcelona;13;Barcelonès;08245;Santa Coloma de Gramenet;1;10;A;;569;296;273;0;2;294;296
8;Barcelona;13;Barcelonès;08245;Santa Coloma de Gramenet;1;10;B;;619;337;282;1;1;335;336
8;Barcelona;13;Barcelonès;08245;Santa Coloma de Gramenet;1;11;A;;483;265;218;0;4;261;265
8;Barcelona;13;Barcelonès;08245;Santa Coloma de Gramenet;1;11;B;;496;289;207;1;3;285;288
8;Barcelona;13;Barcelonès;08245;Santa Coloma de Gramenet;1;12;U;;748;448;300;1;4;443;447
8;Barcelona;13;Barcelonès;08245;Santa Coloma de Gramenet;1;13;A;;531;306;225;1;2;303;305
8;Barcelona;13;Barcelonès;08245;Santa Coloma de Gramenet;1;13;B;;571;346;225;0;10;336;346
8;Barcelona;13;Barcelonès;08245;Santa Coloma de Gramenet;1;13;C;;544;329;215;1;2;326;328
8;Barcelona;13;Barcelonès;08245;Santa Coloma de Gramenet;1;14;U;;855;555;300;2;7;546;553
8;Barcelona;13;Barcelonès;08245;Santa Coloma de Gramenet;1;15;U;;600;362;238;0;2;360;362
8;Barcelona;13;Barcelonès;08245;Santa Coloma de Gramenet;1;16;U;;721;418;303;0;5;413;418
8;Barcelona;13;Barcelonès;08245;Santa Coloma de Gramenet;1;17;A;;608;332;276;0;3;329;332
8;Barcelona;13;Barcelonès;08245;Santa Coloma de Gramenet;1;17;B;;771;430;341;0;8;422;430
8;Barcelona;13;Barcelonès;08245;Santa Coloma de Gramenet;1;18;A;;510;292;218;0;2;290;292
8;Barcelona;13;Barcelonès;08245;Santa Coloma de Gramenet;1;18;B;;584;326;258;0;5;321;326
8;Barcelona;13;Barcelonès;08245;Santa Coloma de Gramenet;1;19;A;;602;335;267;0;3;332;335
8;Barcelona;13;Barcelonès;08245;Santa Coloma de Gramenet;1;19;B;;679;350;329;0;3;347;350
8;Barcelona;13;Barcelonès;08245;Santa Coloma de Gramenet;1;2;U;;697;428;269;6;5;417;422
8;Barcelona;13;Barcelonès;08245;Santa Coloma de Gramenet;1;3;A;;441;265;176;3;4;258;262
8;Barcelona;13;Barcelonès;08245;Santa Coloma de Gramenet;1;3;B;;572;336;236;0;4;332;336
8;Barcelona;13;Barcelonès;08245;Santa Coloma de Gramenet;1;4;U;;629;362;267;0;3;359;362
8;Barcelona;13;Barcelonès;08245;Santa Coloma de Gramenet;1;5;U;;707;411;296;1;6;404;410
8;Barcelona;13;Barcelonès;08245;Santa Coloma de Gramenet;1;6;U;;703;389;314;0;3;386;389
8;Barcelona;13;Barcelonès;08245;Santa Coloma de Gramenet;1;7;U;;506;258;248;1;5;252;257
8;Barcelona;13;Barcelonès;08245;Santa Coloma de Gramenet;1;8;U;;520;280;240;2;2;276;278
8;Barcelona;13;Barcelonès;08245;Santa Coloma de Gramenet;1;9;A;;468;242;226;0;5;237;242
8;Barcelona;13;Barcelonès;08245;Santa Coloma de Gramenet;1;9;B;;551;302;249;1;1;300;301
8;Barcelona;13;Barcelonès;08245;Santa Coloma de Gramenet;2;1;U;;854;525;329;0;5;520;525
8;Barcelona;13;Barcelonès;08245;Santa Coloma de Gramenet;2;10;U;;692;338;354;0;2;336;338
8;Barcelona;13;Barcelonès;08245;Santa Coloma de Gramenet;2;11;A;;512;232;280;0;1;231;232
8;Barcelona;13;Barcelonès;08245;Santa Coloma de Gramenet;2;11;B;;613;297;316;1;3;293;296
8;Barcelona;13;Barcelonès;08245;Santa Coloma de Gramenet;2;2;A;;397;240;157;0;2;238;240
8;Barcelona;13;Barcelonès;08245;Santa Coloma de Gramenet;2;2;B;;444;258;186;1;4;253;257
8;Barcelona;13;Barcelonès;08245;Santa Coloma de Gramenet;2;2;C;;434;254;180;0;8;246;254
8;Barcelona;13;Barcelonès;08245;Santa Coloma de Gramenet;2;3;A;;603;316;287;1;6;309;315
8;Barcelona;13;Barcelonès;08245;Santa Coloma de Gramenet;2;3;B;;761;351;410;0;4;347;351
8;Barcelona;13;Barcelonès;08245;Santa Coloma de Gramenet;2;4;A;;441;247;194;0;3;244;247
8;Barcelona;13;Barcelonès;08245;Santa Coloma de Gramenet;2;4;B;;538;294;244;0;2;292;294
8;Barcelona;13;Barcelonès;08245;Santa Coloma de Gramenet;2;5;A;;497;258;239;0;3;255;258
8;Barcelona;13;Barcelonès;08245;Santa Coloma de Gramenet;2;5;B;;526;283;243;0;2;281;283
8;Barcelona;13;Barcelonès;08245;Santa Coloma de Gramenet;2;6;A;;505;305;200;0;3;302;305
8;Barcelona;13;Barcelonès;08245;Santa Coloma de Gramenet;2;6;B;;594;342;252;1;4;337;341
8;Barcelona;13;Barcelonès;08245;Santa Coloma de Gramenet;2;7;A;;493;244;249;0;3;241;244
8;Barcelona;13;Barcelonès;08245;Santa Coloma de Gramenet;2;7;B;;574;273;301;0;2;271;273
8;Barcelona;13;Barcelonès;08245;Santa Coloma de Gramenet;2;7;C;;580;268;312;0;3;265;268
8;Barcelona;13;Barcelonès;08245;Santa Coloma de Gramenet;2;8;A;;583;316;267;0;8;308;316
8;Barcelona;13;Barcelonès;08245;Santa Coloma de Gramenet;2;8;B;;681;369;312;1;7;361;368
8;Barcelona;13;Barcelonès;08245;Santa Coloma de Gramenet;2;9;A;;478;266;212;0;3;263;266
8;Barcelona;13;Barcelonès;08245;Santa Coloma de Gramenet;2;9;B;;569;333;236;0;3;330;333
8;Barcelona;13;Barcelonès;08245;Santa Coloma de Gramenet;3;1;U;;721;385;336;0;11;374;385
8;Barcelona;13;Barcelonès;08245;Santa Coloma de Gramenet;3;10;U;;491;263;228;0;4;259;263
8;Barcelona;13;Barcelonès;08245;Santa Coloma de Gramenet;3;11;U;;700;386;314;0;1;385;386
8;Barcelona;13;Barcelonès;08245;Santa Coloma de Gramenet;3;12;A;;547;330;217;0;1;329;330
8;Barcelona;13;Barcelonès;08245;Santa Coloma de Gramenet;3;12;B;;712;369;343;0;4;365;369
8;Barcelona;13;Barcelonès;08245;Santa Coloma de Gramenet;3;13;A;;402;227;175;1;4;222;226
8;Barcelona;13;Barcelonès;08245;Santa Coloma de Gramenet;3;13;B;;505;303;202;1;3;299;302
8;Barcelona;13;Barcelonès;08245;Santa Coloma de Gramenet;3;13;C;;543;325;218;0;2;323;325
8;Barcelona;13;Barcelonès;08245;Santa Coloma de Gramenet;3;14;A;;487;258;229;0;4;254;258
8;Barcelona;13;Barcelonès;08245;Santa Coloma de Gramenet;3;14;B;;597;305;292;0;1;304;305
8;Barcelona;13;Barcelonès;08245;Santa Coloma de Gramenet;3;15;A;;429;253;176;1;5;247;252
8;Barcelona;13;Barcelonès;08245;Santa Coloma de Gramenet;3;15;B;;455;251;204;0;1;250;251
8;Barcelona;13;Barcelonès;08245;Santa Coloma de Gramenet;3;16;U;;895;495;400;0;4;491;495
8;Barcelona;13;Barcelonès;08245;Santa Coloma de Gramenet;3;17;U;;718;320;398;2;5;313;318
8;Barcelona;13;Barcelonès;08245;Santa Coloma de Gramenet;3;2;U;;570;299;271;0;5;294;299
8;Barcelona;13;Barcelonès;08245;Santa Coloma de Gramenet;3;3;U;;723;410;313;0;3;407;410
8;Barcelona;13;Barcelonès;08245;Santa Coloma de Gramenet;3;4;A;;437;225;212;1;2;222;224
8;Barcelona;13;Barcelonès;08245;Santa Coloma de Gramenet;3;4;B;;475;273;202;2;0;271;271
8;Barcelona;13;Barcelonès;08245;Santa Coloma de Gramenet;3;5;A;;416;180;236;0;4;176;180
8;Barcelona;13;Barcelonès;08245;Santa Coloma de Gramenet;3;5;B;;568;258;310;0;3;255;258
8;Barcelona;13;Barcelonès;08245;Santa Coloma de Gramenet;3;6;A;;408;215;193;0;0;215;215
8;Barcelona;13;Barcelonès;08245;Santa Coloma de Gramenet;3;6;B;;558;311;247;0;3;308;311
8;Barcelona;13;Barcelonès;08245;Santa Coloma de Gramenet;3;7;A;;456;265;191;0;8;257;265
8;Barcelona;13;Barcelonès;08245;Santa Coloma de Gramenet;3;7;B;;615;335;280;2;9;324;333
8;Barcelona;13;Barcelonès;08245;Santa Coloma de Gramenet;3;7;C;;519;277;242;0;4;273;277
8;Barcelona;13;Barcelonès;08245;Santa Coloma de Gramenet;3;8;U;;687;404;283;0;3;401;404
8;Barcelona;13;Barcelonès;08245;Santa Coloma de Gramenet;3;9;U;;1017;580;437;1;8;571;579
8;Barcelona;13;Barcelonès;08245;Santa Coloma de Gramenet;4;1;U;;868;465;403;0;4;461;465
8;Barcelona;13;Barcelonès;08245;Santa Coloma de Gramenet;4;10;A;;450;258;192;0;2;256;258
8;Barcelona;13;Barcelonès;08245;Santa Coloma de Gramenet;4;10;B;;528;308;220;0;5;303;308
8;Barcelona;13;Barcelonès;08245;Santa Coloma de Gramenet;4;11;A;;431;262;169;0;4;258;262
8;Barcelona;13;Barcelonès;08245;Santa Coloma de Gramenet;4;11;B;;477;278;199;0;6;272;278
8;Barcelona;13;Barcelonès;08245;Santa Coloma de Gramenet;4;12;A;;402;236;166;0;1;235;236
8;Barcelona;13;Barcelonès;08245;Santa Coloma de Gramenet;4;12;B;;515;309;206;0;3;306;309
8;Barcelona;13;Barcelonès;08245;Santa Coloma de Gramenet;4;13;A;;626;339;287;0;3;336;339
8;Barcelona;13;Barcelonès;08245;Santa Coloma de Gramenet;4;13;B;;742;414;328;0;8;406;414
8;Barcelona;13;Barcelonès;08245;Santa Coloma de Gramenet;4;14;A;;472;265;207;0;2;263;265
8;Barcelona;13;Barcelonès;08245;Santa Coloma de Gramenet;4;14;B;;551;301;250;0;3;298;301
8;Barcelona;13;Barcelonès;08245;Santa Coloma de Gramenet;4;14;C;;516;311;205;0;3;308;311
8;Barcelona;13;Barcelonès;08245;Santa Coloma de Gramenet;4;15;A;;526;283;243;3;1;279;280
8;Barcelona;13;Barcelonès;08245;Santa Coloma de Gramenet;4;15;B;;652;357;295;0;4;353;357
8;Barcelona;13;Barcelonès;08245;Santa Coloma de Gramenet;4;16;A;;439;244;195;1;2;241;243
8;Barcelona;13;Barcelonès;08245;Santa Coloma de Gramenet;4;16;B;;505;285;220;1;6;278;284
8;Barcelona;13;Barcelonès;08245;Santa Coloma de Gramenet;4;2;A;;529;344;185;0;5;339;344
8;Barcelona;13;Barcelonès;08245;Santa Coloma de Gramenet;4;2;B;;520;347;173;0;0;347;347
8;Barcelona;13;Barcelonès;08245;Santa Coloma de Gramenet;4;3;A;;535;308;227;0;7;301;308
8;Barcelona;13;Barcelonès;08245;Santa Coloma de Gramenet;4;3;B;;635;373;262;2;4;367;371
8;Barcelona;13;Barcelonès;08245;Santa Coloma de Gramenet;4;4;A;;615;331;284;0;5;326;331
8;Barcelona;13;Barcelonès;08245;Santa Coloma de Gramenet;4;4;B;;724;414;310;2;5;407;412
8;Barcelona;13;Barcelonès;08245;Santa Coloma de Gramenet;4;5;U;;876;478;398;2;7;469;476
8;Barcelona;13;Barcelonès;08245;Santa Coloma de Gramenet;4;6;A;;488;307;181;0;0;307;307
8;Barcelona;13;Barcelonès;08245;Santa Coloma de Gramenet;4;6;B;;589;352;237;8;0;344;344
8;Barcelona;13;Barcelonès;08245;Santa Coloma de Gramenet;4;7;A;;611;358;253;3;5;350;355
8;Barcelona;13;Barcelonès;08245;Santa Coloma de Gramenet;4;7;B;;697;423;274;1;6;416;422
8;Barcelona;13;Barcelonès;08245;Santa Coloma de Gramenet;4;8;A;;418;220;198;1;4;215;219
8;Barcelona;13;Barcelonès;08245;Santa Coloma de Gramenet;4;8;B;;475;269;206;0;2;267;269
8;Barcelona;13;Barcelonès;08245;Santa Coloma de Gramenet;4;8;C;;544;321;223;1;1;319;320
8;Barcelona;13;Barcelonès;08245;Santa Coloma de Gramenet;4;9;A;;657;375;282;0;6;369;375
8;Barcelona;13;Barcelonès;08245;Santa Coloma de Gramenet;4;9;B;;680;414;266;0;4;410;414
8;Barcelona;13;Barcelonès;08245;Santa Coloma de Gramenet;5;1;U;;716;358;358;1;3;354;357
8;Barcelona;13;Barcelonès;08245;Santa Coloma de Gramenet;5;10;U;;608;290;318;1;3;286;289
8;Barcelona;13;Barcelonès;08245;Santa Coloma de Gramenet;5;11;A;;564;219;345;1;1;217;218
8;Barcelona;13;Barcelonès;08245;Santa Coloma de Gramenet;5;11;B;;590;235;355;0;1;234;235
8;Barcelona;13;Barcelonès;08245;Santa Coloma de Gramenet;5;12;U;;729;315;414;1;4;310;314
8;Barcelona;13;Barcelonès;08245;Santa Coloma de Gramenet;5;13;A;;502;225;277;0;3;222;225
8;Barcelona;13;Barcelonès;08245;Santa Coloma de Gramenet;5;13;B;;500;222;278;0;0;222;222
8;Barcelona;13;Barcelonès;08245;Santa Coloma de Gramenet;5;14;A;;499;250;249;1;4;245;249
8;Barcelona;13;Barcelonès;08245;Santa Coloma de Gramenet;5;14;B;;624;326;298;1;2;323;325
8;Barcelona;13;Barcelonès;08245;Santa Coloma de Gramenet;5;15;A;;454;220;234;0;1;219;220
8;Barcelona;13;Barcelonès;08245;Santa Coloma de Gramenet;5;15;B;;560;263;297;0;5;258;263
8;Barcelona;13;Barcelonès;08245;Santa Coloma de Gramenet;5;16;U;;827;446;381;0;2;444;446
8;Barcelona;13;Barcelonès;08245;Santa Coloma de Gramenet;5;17;U;;604;256;348;0;1;255;256
8;Barcelona;13;Barcelonès;08245;Santa Coloma de Gramenet;5;18;A;;354;124;230;0;2;122;124
8;Barcelona;13;Barcelonès;08245;Santa Coloma de Gramenet;5;18;B;;363;146;217;0;0;146;146
8;Barcelona;13;Barcelonès;08245;Santa Coloma de Gramenet;5;19;U;;872;489;383;0;16;473;489
8;Barcelona;13;Barcelonès;08245;Santa Coloma de Gramenet;5;2;A;;514;285;229;0;6;279;285
8;Barcelona;13;Barcelonès;08245;Santa Coloma de Gramenet;5;2;B;;618;337;281;0;5;332;337
8;Barcelona;13;Barcelonès;08245;Santa Coloma de Gramenet;5;3;U;;778;436;342;0;3;433;436
8;Barcelona;13;Barcelonès;08245;Santa Coloma de Gramenet;5;4;U;;681;376;305;0;1;375;376
8;Barcelona;13;Barcelonès;08245;Santa Coloma de Gramenet;5;5;A;;459;226;233;0;2;224;226
8;Barcelona;13;Barcelonès;08245;Santa Coloma de Gramenet;5;5;B;;487;213;274;1;1;211;212
8;Barcelona;13;Barcelonès;08245;Santa Coloma de Gramenet;5;6;U;;796;398;398;0;5;393;398
8;Barcelona;13;Barcelonès;08245;Santa Coloma de Gramenet;5;7;A;;423;247;176;0;1;246;247
8;Barcelona;13;Barcelonès;08245;Santa Coloma de Gramenet;5;7;B;;498;281;217;0;3;278;281
8;Barcelona;13;Barcelonès;08245;Santa Coloma de Gramenet;5;8;U;;715;312;403;3;9;300;309
8;Barcelona;13;Barcelonès;08245;Santa Coloma de Gramenet;5;9;U;;938;400;538;0;4;396;400
8;Barcelona;13;Barcelonès;08245;Santa Coloma de Gramenet;6;1;U;;512;281;231;0;1;280;281
8;Barcelona;13;Barcelonès;08245;Santa Coloma de Gramenet;6;10;U;;654;284;370;0;2;282;284
8;Barcelona;13;Barcelonès;08245;Santa Coloma de Gramenet;6;11;U;;648;277;371;0;4;273;277
8;Barcelona;13;Barcelonès;08245;Santa Coloma de Gramenet;6;12;U;;609;324;285;0;2;322;324
8;Barcelona;13;Barcelonès;08245;Santa Coloma de Gramenet;6;13;U;;496;259;237;0;0;259;259
8;Barcelona;13;Barcelonès;08245;Santa Coloma de Gramenet;6;14;A;;367;171;196;0;2;169;171
8;Barcelona;13;Barcelonès;08245;Santa Coloma de Gramenet;6;14;B;;505;211;294;0;0;211;211
8;Barcelona;13;Barcelonès;08245;Santa Coloma de Gramenet;6;15;U;;453;189;264;0;1;188;189
8;Barcelona;13;Barcelonès;08245;Santa Coloma de Gramenet;6;16;U;;481;148;333;0;0;148;148
8;Barcelona;13;Barcelonès;08245;Santa Coloma de Gramenet;6;17;U;;625;274;351;1;4;269;273
8;Barcelona;13;Barcelonès;08245;Santa Coloma de Gramenet;6;2;U;;751;424;327;3;1;420;421
8;Barcelona;13;Barcelonès;08245;Santa Coloma de Gramenet;6;3;A;;347;160;187;0;2;158;160
8;Barcelona;13;Barcelonès;08245;Santa Coloma de Gramenet;6;3;B;;423;195;228;1;1;193;194
8;Barcelona;13;Barcelonès;08245;Santa Coloma de Gramenet;6;4;A;;352;198;154;1;3;194;197
8;Barcelona;13;Barcelonès;08245;Santa Coloma de Gramenet;6;4;B;;456;259;197;0;5;254;259
8;Barcelona;13;Barcelonès;08245;Santa Coloma de Gramenet;6;5;U;;730;407;323;0;3;404;407
8;Barcelona;13;Barcelonès;08245;Santa Coloma de Gramenet;6;6;U;;606;320;286;0;2;318;320
8;Barcelona;13;Barcelonès;08245;Santa Coloma de Gramenet;6;7;U;;412;215;197;3;2;210;212
8;Barcelona;13;Barcelonès;08245;Santa Coloma de Gramenet;6;8;A;;450;219;231;1;4;214;218
8;Barcelona;13;Barcelonès;08245;Santa Coloma de Gramenet;6;8;B;;456;258;198;0;2;256;258
8;Barcelona;13;Barcelonès;08245;Santa Coloma de Gramenet;6;9;U;;453;247;206;0;5;242;247
43;Tarragona;16;Conca de Barberà;43139;Santa Coloma de Queralt;1;1;A;;687;451;236;5;4;442;446
43;Tarragona;16;Conca de Barberà;43139;Santa Coloma de Queralt;1;1;B;;828;575;253;1;2;572;574
43;Tarragona;16;Conca de Barberà;43139;Santa Coloma de Queralt;2;1;U;;708;497;211;0;10;487;497
17;Girona;10;Baix Empordà;17181;Santa Cristina d'Aro;1;1;A;;587;427;160;0;3;424;427
17;Girona;10;Baix Empordà;17181;Santa Cristina d'Aro;1;1;B;;515;341;174;1;3;337;340
17;Girona;10;Baix Empordà;17181;Santa Cristina d'Aro;1;2;A;;668;441;227;2;5;434;439
17;Girona;10;Baix Empordà;17181;Santa Cristina d'Aro;1;2;B;;639;397;242;0;1;396;397
8;Barcelona;13;Barcelonès;08194;Sant Adrià de Besòs;1;1;A;;544;331;213;1;0;330;330
8;Barcelona;13;Barcelonès;08194;Sant Adrià de Besòs;1;1;B;;685;416;269;5;0;411;411
8;Barcelona;13;Barcelonès;08194;Sant Adrià de Besòs;1;2;A;;529;345;184;1;5;339;344
8;Barcelona;13;Barcelonès;08194;Sant Adrià de Besòs;1;2;B;;590;362;228;2;5;355;360
8;Barcelona;13;Barcelonès;08194;Sant Adrià de Besòs;1;3;A;;690;396;294;2;3;391;394
8;Barcelona;13;Barcelonès;08194;Sant Adrià de Besòs;1;3;B;;788;452;336;1;5;446;451
8;Barcelona;13;Barcelonès;08194;Sant Adrià de Besòs;1;4;A;;619;364;255;1;2;361;363
8;Barcelona;13;Barcelonès;08194;Sant Adrià de Besòs;1;4;B;;665;399;266;1;6;392;398
8;Barcelona;13;Barcelonès;08194;Sant Adrià de Besòs;1;5;A;;762;462;300;3;8;451;459
8;Barcelona;13;Barcelonès;08194;Sant Adrià de Besòs;1;5;B;;824;518;306;0;7;511;518
8;Barcelona;13;Barcelonès;08194;Sant Adrià de Besòs;1;6;A;;492;300;192;5;0;295;295
8;Barcelona;13;Barcelonès;08194;Sant Adrià de Besòs;1;6;B;;574;357;217;0;4;353;357
8;Barcelona;13;Barcelonès;08194;Sant Adrià de Besòs;2;1;A;;536;315;221;1;5;309;314
8;Barcelona;13;Barcelonès;08194;Sant Adrià de Besòs;2;1;B;;626;364;262;1;3;360;363
8;Barcelona;13;Barcelonès;08194;Sant Adrià de Besòs;2;2;A;;578;277;301;5;0;272;272
8;Barcelona;13;Barcelonès;08194;Sant Adrià de Besòs;2;2;B;;703;339;364;1;4;334;338
8;Barcelona;13;Barcelonès;08194;Sant Adrià de Besòs;2;3;A;;586;303;283;2;1;300;301
8;Barcelona;13;Barcelonès;08194;Sant Adrià de Besòs;2;3;B;;745;372;373;0;2;370;372
8;Barcelona;13;Barcelonès;08194;Sant Adrià de Besòs;2;4;A;;528;328;200;1;5;322;327
8;Barcelona;13;Barcelonès;08194;Sant Adrià de Besòs;2;4;B;;491;281;210;0;2;279;281
8;Barcelona;13;Barcelonès;08194;Sant Adrià de Besòs;2;4;C;;688;374;314;0;1;373;374
8;Barcelona;13;Barcelonès;08194;Sant Adrià de Besòs;2;4;D;;538;290;248;0;2;288;290
8;Barcelona;13;Barcelonès;08194;Sant Adrià de Besòs;3;1;U;;457;257;200;0;1;256;257
8;Barcelona;13;Barcelonès;08194;Sant Adrià de Besòs;4;1;U;;286;147;139;0;3;144;147
8;Barcelona;13;Barcelonès;08194;Sant Adrià de Besòs;5;1;A;;629;358;271;5;0;353;353
8;Barcelona;13;Barcelonès;08194;Sant Adrià de Besòs;5;1;B;;701;414;287;0;0;414;414
8;Barcelona;13;Barcelonès;08194;Sant Adrià de Besòs;5;2;A;;608;326;282;1;5;320;325
8;Barcelona;13;Barcelonès;08194;Sant Adrià de Besòs;5;2;B;;638;331;307;2;0;329;329
8;Barcelona;13;Barcelonès;08194;Sant Adrià de Besòs;5;3;U;;808;468;340;0;6;462;468
8;Barcelona;13;Barcelonès;08194;Sant Adrià de Besòs;5;4;A;;496;281;215;1;2;278;280
8;Barcelona;13;Barcelonès;08194;Sant Adrià de Besòs;5;4;B;;550;312;238;0;1;311;312
8;Barcelona;13;Barcelonès;08194;Sant Adrià de Besòs;6;1;U;;387;167;220;0;1;166;167
8;Barcelona;13;Barcelonès;08194;Sant Adrià de Besòs;6;2;A;;606;209;397;1;1;207;208
8;Barcelona;13;Barcelonès;08194;Sant Adrià de Besòs;6;2;B;;518;172;346;0;0;172;172
8;Barcelona;13;Barcelonès;08194;Sant Adrià de Besòs;6;3;U;;472;146;326;0;0;146;146
8;Barcelona;13;Barcelonès;08194;Sant Adrià de Besòs;6;4;A;;916;216;700;0;1;215;216
8;Barcelona;13;Barcelonès;08194;Sant Adrià de Besòs;6;4;B;;521;184;337;0;1;183;184
8;Barcelona;13;Barcelonès;08194;Sant Adrià de Besòs;6;5;A;;523;244;279;1;0;243;243
8;Barcelona;13;Barcelonès;08194;Sant Adrià de Besòs;6;5;B;;576;307;269;0;1;306;307
8;Barcelona;13;Barcelonès;08194;Sant Adrià de Besòs;6;6;A;;678;192;486;4;1;187;188
8;Barcelona;13;Barcelonès;08194;Sant Adrià de Besòs;6;6;B;;562;199;363;0;3;196;199
8;Barcelona;13;Barcelonès;08194;Sant Adrià de Besòs;6;7;A;;416;168;248;0;3;165;168
8;Barcelona;13;Barcelonès;08194;Sant Adrià de Besòs;6;7;B;;423;196;227;0;2;194;196
8;Barcelona;24;Osona;08246;Santa Eugènia de Berga;1;1;A;;754;588;166;3;6;579;585
8;Barcelona;24;Osona;08246;Santa Eugènia de Berga;1;1;B;;831;652;179;1;3;648;651
8;Barcelona;24;Osona;08247;Santa Eulàlia de Riuprimer;1;1;U;;719;530;189;0;4;526;530
8;Barcelona;41;Vallès Oriental;08248;Santa Eulàlia de Ronçana;1;1;A;;720;475;245;0;4;471;475
8;Barcelona;41;Vallès Oriental;08248;Santa Eulàlia de Ronçana;1;1;B;;782;472;310;0;4;468;472
8;Barcelona;41;Vallès Oriental;08248;Santa Eulàlia de Ronçana;1;1;C;;662;405;257;1;5;399;404
8;Barcelona;41;Vallès Oriental;08248;Santa Eulàlia de Ronçana;1;2;A;;732;477;255;0;1;476;477
8;Barcelona;41;Vallès Oriental;08248;Santa Eulàlia de Ronçana;1;2;B;;786;478;308;3;2;473;475
8;Barcelona;41;Vallès Oriental;08248;Santa Eulàlia de Ronçana;1;2;C;;687;442;245;3;2;437;439
8;Barcelona;3;Alt Penedès;08249;Santa Fe del Penedès;1;1;U;;257;215;42;1;0;214;214
8;Barcelona;24;Osona;08195;Sant Agustí de Lluçanès;1;1;U;;83;60;23;0;0;60;60
17;Girona;2;Alt Empordà;17182;Santa Llogaia d'Àlguema;1;1;U;;238;150;88;0;0;150;150
8;Barcelona;6;Anoia;08250;Santa Margarida de Montbui;1;1;U;;677;489;188;0;3;486;489
8;Barcelona;6;Anoia;08250;Santa Margarida de Montbui;1;2;A;;835;448;387;2;3;443;446
8;Barcelona;6;Anoia;08250;Santa Margarida de Montbui;1;2;B;;865;447;418;2;4;441;445
8;Barcelona;6;Anoia;08250;Santa Margarida de Montbui;1;3;U;;827;471;356;5;7;459;466
8;Barcelona;6;Anoia;08250;Santa Margarida de Montbui;1;4;U;;705;414;291;2;3;409;412
8;Barcelona;6;Anoia;08250;Santa Margarida de Montbui;1;5;A;;638;316;322;0;2;314;316
8;Barcelona;6;Anoia;08250;Santa Margarida de Montbui;1;5;B;;668;336;332;1;0;335;335
8;Barcelona;6;Anoia;08250;Santa Margarida de Montbui;1;5;C;;672;339;333;2;3;334;337
8;Barcelona;6;Anoia;08250;Santa Margarida de Montbui;1;6;U;;716;338;378;4;1;333;334
8;Barcelona;6;Anoia;08250;Santa Margarida de Montbui;1;7;U;;686;364;322;1;3;360;363
8;Barcelona;3;Alt Penedès;08251;Santa Margarida i els Monjos;1;1;A;;573;365;208;3;0;362;362
8;Barcelona;3;Alt Penedès;08251;Santa Margarida i els Monjos;1;1;B;;549;318;231;1;4;313;317
8;Barcelona;3;Alt Penedès;08251;Santa Margarida i els Monjos;1;1;C;;600;384;216;1;2;381;383
8;Barcelona;3;Alt Penedès;08251;Santa Margarida i els Monjos;1;2;U;;911;605;306;4;0;601;601
8;Barcelona;3;Alt Penedès;08251;Santa Margarida i els Monjos;1;3;A;;663;405;258;0;6;399;405
8;Barcelona;3;Alt Penedès;08251;Santa Margarida i els Monjos;1;3;B;;827;508;319;4;2;502;504
8;Barcelona;;;08258;Santa Maria d'Oló;1;1;U;;887;736;151;0;7;729;736
8;Barcelona;24;Osona;08253;Santa Maria de Besora;1;1;U;;146;101;45;0;0;101;101
8;Barcelona;41;Vallès Oriental;08256;Santa Maria de Martorelles;1;1;U;;552;421;131;0;1;420;421
8;Barcelona;14;Berguedà;08255;Santa Maria de Merlès;1;1;U;;132;87;45;0;1;86;87
8;Barcelona;6;Anoia;08257;Santa Maria de Miralles;1;1;U;;96;78;18;2;0;76;76
8;Barcelona;41;Vallès Oriental;08259;Santa Maria de Palautordera;1;1;A;;858;570;288;2;5;563;568
8;Barcelona;41;Vallès Oriental;08259;Santa Maria de Palautordera;1;1;B;;950;657;293;6;9;642;651
8;Barcelona;41;Vallès Oriental;08259;Santa Maria de Palautordera;1;2;A;;651;473;178;4;6;463;469
8;Barcelona;41;Vallès Oriental;08259;Santa Maria de Palautordera;1;2;B;;647;438;209;1;3;434;437
8;Barcelona;41;Vallès Oriental;08259;Santa Maria de Palautordera;1;2;C;;714;518;196;2;4;512;516
8;Barcelona;41;Vallès Oriental;08259;Santa Maria de Palautordera;1;2;D;;279;171;108;0;0;171;171
8;Barcelona;41;Vallès Oriental;08259;Santa Maria de Palautordera;1;3;A;;353;241;112;0;3;238;241
8;Barcelona;41;Vallès Oriental;08259;Santa Maria de Palautordera;1;3;B;;721;515;206;1;4;510;514
8;Barcelona;41;Vallès Oriental;08259;Santa Maria de Palautordera;1;3;C;;409;295;114;1;6;288;294
8;Barcelona;11;Baix Llobregat;08196;Sant Andreu de la Barca;1;1;A;;764;414;350;2;5;407;412
8;Barcelona;11;Baix Llobregat;08196;Sant Andreu de la Barca;1;1;B;;711;352;359;2;3;347;350
8;Barcelona;11;Baix Llobregat;08196;Sant Andreu de la Barca;1;1;C;;937;497;440;2;1;494;495
8;Barcelona;11;Baix Llobregat;08196;Sant Andreu de la Barca;1;1;D;;743;385;358;0;5;380;385
8;Barcelona;11;Baix Llobregat;08196;Sant Andreu de la Barca;1;2;A;;881;440;441;0;2;438;440
8;Barcelona;11;Baix Llobregat;08196;Sant Andreu de la Barca;1;2;B;;1061;514;547;1;8;505;513
8;Barcelona;11;Baix Llobregat;08196;Sant Andreu de la Barca;1;2;C;;996;490;506;2;7;481;488
8;Barcelona;11;Baix Llobregat;08196;Sant Andreu de la Barca;1;3;A;;647;341;306;1;4;336;340
8;Barcelona;11;Baix Llobregat;08196;Sant Andreu de la Barca;1;3;B;;789;419;370;1;7;411;418
8;Barcelona;11;Baix Llobregat;08196;Sant Andreu de la Barca;1;3;C;;724;394;330;0;1;393;394
8;Barcelona;11;Baix Llobregat;08196;Sant Andreu de la Barca;1;4;A;;519;308;211;0;2;306;308
8;Barcelona;11;Baix Llobregat;08196;Sant Andreu de la Barca;1;4;B;;682;397;285;0;2;395;397
8;Barcelona;11;Baix Llobregat;08196;Sant Andreu de la Barca;1;5;A;;620;338;282;0;3;335;338
8;Barcelona;11;Baix Llobregat;08196;Sant Andreu de la Barca;1;5;B;;610;313;297;0;3;310;313
8;Barcelona;11;Baix Llobregat;08196;Sant Andreu de la Barca;1;5;C;;879;473;406;0;7;466;473
8;Barcelona;11;Baix Llobregat;08196;Sant Andreu de la Barca;1;5;D;;647;368;279;0;1;367;368
8;Barcelona;11;Baix Llobregat;08196;Sant Andreu de la Barca;1;6;A;;620;328;292;0;8;320;328
8;Barcelona;11;Baix Llobregat;08196;Sant Andreu de la Barca;1;6;B;;889;485;404;2;1;482;483
8;Barcelona;11;Baix Llobregat;08196;Sant Andreu de la Barca;1;6;C;;793;445;348;0;2;443;445
8;Barcelona;11;Baix Llobregat;08196;Sant Andreu de la Barca;1;7;A;;674;378;296;0;4;374;378
8;Barcelona;11;Baix Llobregat;08196;Sant Andreu de la Barca;1;7;B;;754;432;322;0;6;426;432
8;Barcelona;11;Baix Llobregat;08196;Sant Andreu de la Barca;1;8;A;;945;529;416;0;5;524;529
8;Barcelona;11;Baix Llobregat;08196;Sant Andreu de la Barca;1;8;B;;1038;589;449;1;3;585;588
8;Barcelona;21;Maresme;08197;Sant Andreu de Llavaneres;1;1;A;;636;449;187;0;3;446;449
8;Barcelona;21;Maresme;08197;Sant Andreu de Llavaneres;1;1;B;;571;395;176;0;5;390;395
8;Barcelona;21;Maresme;08197;Sant Andreu de Llavaneres;1;2;A;;658;439;219;0;4;435;439
8;Barcelona;21;Maresme;08197;Sant Andreu de Llavaneres;1;2;B;;618;429;189;0;6;423;429
8;Barcelona;21;Maresme;08197;Sant Andreu de Llavaneres;1;3;A;;634;430;204;2;2;426;428
8;Barcelona;21;Maresme;08197;Sant Andreu de Llavaneres;1;3;B;;637;418;219;0;2;416;418
8;Barcelona;21;Maresme;08197;Sant Andreu de Llavaneres;2;1;A;;672;452;220;0;2;450;452
8;Barcelona;21;Maresme;08197;Sant Andreu de Llavaneres;2;1;B;;669;456;213;3;3;450;453
8;Barcelona;21;Maresme;08197;Sant Andreu de Llavaneres;2;1;C;;562;375;187;0;6;369;375
8;Barcelona;21;Maresme;08197;Sant Andreu de Llavaneres;2;1;D;;656;450;206;1;5;444;449
17;Girona;20;Gironès;17157;Sant Andreu Salou;1;1;U;;116;98;18;0;1;97;98
17;Girona;19;Garrotxa;17183;Sant Aniol de Finestres;1;1;U;;239;193;46;0;0;193;193
8;Barcelona;41;Vallès Oriental;08198;Sant Antoni de Vilamajor;1;1;A;;865;642;223;1;2;639;641
8;Barcelona;41;Vallès Oriental;08198;Sant Antoni de Vilamajor;1;1;B;;927;644;283;0;4;640;644
8;Barcelona;41;Vallès Oriental;08198;Sant Antoni de Vilamajor;1;2;A;;734;428;306;3;2;423;425
8;Barcelona;41;Vallès Oriental;08198;Sant Antoni de Vilamajor;1;2;B;;712;440;272;5;2;433;435
43;Tarragona;12;Baix Penedès;43140;Santa Oliva;1;1;A;;691;467;224;4;9;454;463
43;Tarragona;12;Baix Penedès;43140;Santa Oliva;1;1;B;;900;476;424;3;5;468;473
43;Tarragona;12;Baix Penedès;43140;Santa Oliva;1;1;C;;349;199;150;0;1;198;199
17;Girona;19;Garrotxa;17184;Santa Pau;1;1;A;;613;446;167;1;3;442;445
17;Girona;19;Garrotxa;17184;Santa Pau;1;1;B;;642;467;175;2;2;463;465
8;Barcelona;40;Vallès Occidental;08260;Santa Perpètua de Mogoda;1;1;A;;545;321;224;1;4;316;320
8;Barcelona;40;Vallès Occidental;08260;Santa Perpètua de Mogoda;1;1;B;;550;304;246;0;1;303;304
8;Barcelona;40;Vallès Occidental;08260;Santa Perpètua de Mogoda;1;10;U;;690;453;237;0;4;449;453
8;Barcelona;40;Vallès Occidental;08260;Santa Perpètua de Mogoda;1;11;U;;874;489;385;0;6;483;489
8;Barcelona;40;Vallès Occidental;08260;Santa Perpètua de Mogoda;1;12;A;;877;498;379;0;2;496;498
8;Barcelona;40;Vallès Occidental;08260;Santa Perpètua de Mogoda;1;12;B;;1004;544;460;2;7;535;542
8;Barcelona;40;Vallès Occidental;08260;Santa Perpètua de Mogoda;1;13;U;;905;506;399;0;8;498;506
8;Barcelona;40;Vallès Occidental;08260;Santa Perpètua de Mogoda;1;2;A;;653;388;265;1;3;384;387
8;Barcelona;40;Vallès Occidental;08260;Santa Perpètua de Mogoda;1;2;B;;749;400;349;4;1;395;396
8;Barcelona;40;Vallès Occidental;08260;Santa Perpètua de Mogoda;1;2;C;;600;334;266;2;1;331;332
8;Barcelona;40;Vallès Occidental;08260;Santa Perpètua de Mogoda;1;3;A;;847;519;328;2;6;511;517
8;Barcelona;40;Vallès Occidental;08260;Santa Perpètua de Mogoda;1;3;B;;765;483;282;2;2;479;481
8;Barcelona;40;Vallès Occidental;08260;Santa Perpètua de Mogoda;1;4;A;;806;342;464;0;0;342;342
8;Barcelona;40;Vallès Occidental;08260;Santa Perpètua de Mogoda;1;4;B;;644;279;365;1;2;276;278
8;Barcelona;40;Vallès Occidental;08260;Santa Perpètua de Mogoda;1;5;U;;1116;548;568;2;2;544;546
8;Barcelona;40;Vallès Occidental;08260;Santa Perpètua de Mogoda;1;6;U;;856;446;410;2;5;439;444
8;Barcelona;40;Vallès Occidental;08260;Santa Perpètua de Mogoda;1;7;U;;991;552;439;0;3;549;552
8;Barcelona;40;Vallès Occidental;08260;Santa Perpètua de Mogoda;1;8;A;;566;284;282;2;1;281;282
8;Barcelona;40;Vallès Occidental;08260;Santa Perpètua de Mogoda;1;8;B;;724;363;361;0;3;360;363
8;Barcelona;40;Vallès Occidental;08260;Santa Perpètua de Mogoda;1;9;A;;1032;566;466;1;1;564;565
8;Barcelona;40;Vallès Occidental;08260;Santa Perpètua de Mogoda;1;9;B;;904;517;387;0;3;514;517
8;Barcelona;21;Maresme;08261;Santa Susanna;1;1;A;;866;585;281;0;0;585;585
8;Barcelona;21;Maresme;08261;Santa Susanna;1;1;B;;991;653;338;1;5;647;652
8;Barcelona;24;Osona;08199;Sant Bartomeu del Grau;1;1;U;;768;529;239;1;8;520;528
8;Barcelona;11;Baix Llobregat;08200;Sant Boi de Llobregat;1;1;A;;409;222;187;0;1;221;222
8;Barcelona;11;Baix Llobregat;08200;Sant Boi de Llobregat;1;1;B;;407;221;186;0;1;220;221
8;Barcelona;11;Baix Llobregat;08200;Sant Boi de Llobregat;1;2;A;;580;366;214;0;9;357;366
8;Barcelona;11;Baix Llobregat;08200;Sant Boi de Llobregat;1;2;B;;701;390;311;2;1;387;388
8;Barcelona;11;Baix Llobregat;08200;Sant Boi de Llobregat;1;3;A;;444;278;166;1;2;275;277
8;Barcelona;11;Baix Llobregat;08200;Sant Boi de Llobregat;1;3;B;;507;319;188;0;6;313;319
8;Barcelona;11;Baix Llobregat;08200;Sant Boi de Llobregat;1;4;A;;550;338;212;2;1;335;336
8;Barcelona;11;Baix Llobregat;08200;Sant Boi de Llobregat;1;4;B;;686;386;300;3;2;381;383
8;Barcelona;11;Baix Llobregat;08200;Sant Boi de Llobregat;1;5;A;;667;274;393;1;0;273;273
8;Barcelona;11;Baix Llobregat;08200;Sant Boi de Llobregat;1;5;B;;745;298;447;3;0;295;295
8;Barcelona;11;Baix Llobregat;08200;Sant Boi de Llobregat;1;6;A;;329;208;121;1;2;205;207
8;Barcelona;11;Baix Llobregat;08200;Sant Boi de Llobregat;1;6;B;;529;300;229;9;1;290;291
8;Barcelona;11;Baix Llobregat;08200;Sant Boi de Llobregat;1;7;A;;470;264;206;1;0;263;263
8;Barcelona;11;Baix Llobregat;08200;Sant Boi de Llobregat;1;7;B;;538;319;219;2;5;312;317
8;Barcelona;11;Baix Llobregat;08200;Sant Boi de Llobregat;2;1;A;;620;372;248;1;5;366;371
8;Barcelona;11;Baix Llobregat;08200;Sant Boi de Llobregat;2;1;B;;745;469;276;0;4;465;469
8;Barcelona;11;Baix Llobregat;08200;Sant Boi de Llobregat;2;1;C;;629;361;268;0;2;359;361
8;Barcelona;11;Baix Llobregat;08200;Sant Boi de Llobregat;2;10;A;;505;286;219;1;1;284;285
8;Barcelona;11;Baix Llobregat;08200;Sant Boi de Llobregat;2;10;B;;567;343;224;0;7;336;343
8;Barcelona;11;Baix Llobregat;08200;Sant Boi de Llobregat;2;10;C;;616;326;290;1;3;322;325
8;Barcelona;11;Baix Llobregat;08200;Sant Boi de Llobregat;2;11;A;;641;370;271;2;3;365;368
8;Barcelona;11;Baix Llobregat;08200;Sant Boi de Llobregat;2;11;B;;756;481;275;0;4;477;481
8;Barcelona;11;Baix Llobregat;08200;Sant Boi de Llobregat;2;12;A;;541;298;243;0;6;292;298
8;Barcelona;11;Baix Llobregat;08200;Sant Boi de Llobregat;2;12;B;;721;393;328;1;4;388;392
8;Barcelona;11;Baix Llobregat;08200;Sant Boi de Llobregat;2;12;C;;567;305;262;0;5;300;305
8;Barcelona;11;Baix Llobregat;08200;Sant Boi de Llobregat;2;13;A;;422;279;143;2;1;276;277
8;Barcelona;11;Baix Llobregat;08200;Sant Boi de Llobregat;2;13;B;;361;235;126;0;5;230;235
8;Barcelona;11;Baix Llobregat;08200;Sant Boi de Llobregat;2;13;C;;405;294;111;0;3;291;294
8;Barcelona;11;Baix Llobregat;08200;Sant Boi de Llobregat;2;14;A;;638;353;285;2;4;347;351
8;Barcelona;11;Baix Llobregat;08200;Sant Boi de Llobregat;2;14;B;;735;355;380;0;3;352;355
8;Barcelona;11;Baix Llobregat;08200;Sant Boi de Llobregat;2;15;A;;504;227;277;2;3;222;225
8;Barcelona;11;Baix Llobregat;08200;Sant Boi de Llobregat;2;15;B;;527;238;289;1;0;237;237
8;Barcelona;11;Baix Llobregat;08200;Sant Boi de Llobregat;2;15;C;;577;257;320;0;1;256;257
8;Barcelona;11;Baix Llobregat;08200;Sant Boi de Llobregat;2;16;A;;490;314;176;0;4;310;314
8;Barcelona;11;Baix Llobregat;08200;Sant Boi de Llobregat;2;16;B;;663;403;260;1;4;398;402
8;Barcelona;11;Baix Llobregat;08200;Sant Boi de Llobregat;2;17;A;;503;293;210;3;3;287;290
8;Barcelona;11;Baix Llobregat;08200;Sant Boi de Llobregat;2;17;B;;557;325;232;0;4;321;325
8;Barcelona;11;Baix Llobregat;08200;Sant Boi de Llobregat;2;18;A;;485;298;187;0;3;295;298
8;Barcelona;11;Baix Llobregat;08200;Sant Boi de Llobregat;2;18;B;;591;344;247;0;8;336;344
8;Barcelona;11;Baix Llobregat;08200;Sant Boi de Llobregat;2;19;U;;678;401;277;0;4;397;401
8;Barcelona;11;Baix Llobregat;08200;Sant Boi de Llobregat;2;2;A;;668;359;309;1;2;356;358
8;Barcelona;11;Baix Llobregat;08200;Sant Boi de Llobregat;2;2;B;;783;375;408;1;1;373;374
8;Barcelona;11;Baix Llobregat;08200;Sant Boi de Llobregat;2;3;A;;411;229;182;0;2;227;229
8;Barcelona;11;Baix Llobregat;08200;Sant Boi de Llobregat;2;3;B;;463;244;219;2;2;240;242
8;Barcelona;11;Baix Llobregat;08200;Sant Boi de Llobregat;2;3;C;;564;290;274;2;1;287;288
8;Barcelona;11;Baix Llobregat;08200;Sant Boi de Llobregat;2;4;A;;469;242;227;1;0;241;241
8;Barcelona;11;Baix Llobregat;08200;Sant Boi de Llobregat;2;4;B;;508;266;242;0;2;264;266
8;Barcelona;11;Baix Llobregat;08200;Sant Boi de Llobregat;2;5;A;;493;279;214;0;2;277;279
8;Barcelona;11;Baix Llobregat;08200;Sant Boi de Llobregat;2;5;B;;580;338;242;3;4;331;335
8;Barcelona;11;Baix Llobregat;08200;Sant Boi de Llobregat;2;6;A;;371;201;170;1;3;197;200
8;Barcelona;11;Baix Llobregat;08200;Sant Boi de Llobregat;2;6;B;;419;224;195;0;1;223;224
8;Barcelona;11;Baix Llobregat;08200;Sant Boi de Llobregat;2;6;C;;468;254;214;0;2;252;254
8;Barcelona;11;Baix Llobregat;08200;Sant Boi de Llobregat;2;7;A;;399;208;191;1;0;207;207
8;Barcelona;11;Baix Llobregat;08200;Sant Boi de Llobregat;2;7;B;;471;265;206;1;0;264;264
8;Barcelona;11;Baix Llobregat;08200;Sant Boi de Llobregat;2;8;A;;566;357;209;0;1;356;357
8;Barcelona;11;Baix Llobregat;08200;Sant Boi de Llobregat;2;8;B;;662;420;242;1;0;419;419
8;Barcelona;11;Baix Llobregat;08200;Sant Boi de Llobregat;2;9;A;;606;331;275;0;5;326;331
8;Barcelona;11;Baix Llobregat;08200;Sant Boi de Llobregat;2;9;B;;695;364;331;0;8;356;364
8;Barcelona;11;Baix Llobregat;08200;Sant Boi de Llobregat;3;1;A;;593;415;178;0;0;415;415
8;Barcelona;11;Baix Llobregat;08200;Sant Boi de Llobregat;3;1;B;;625;421;204;0;1;420;421
8;Barcelona;11;Baix Llobregat;08200;Sant Boi de Llobregat;3;2;A;;668;396;272;0;4;392;396
8;Barcelona;11;Baix Llobregat;08200;Sant Boi de Llobregat;3;2;B;;806;481;325;0;5;476;481
8;Barcelona;11;Baix Llobregat;08200;Sant Boi de Llobregat;3;3;A;;477;286;191;3;0;283;283
8;Barcelona;11;Baix Llobregat;08200;Sant Boi de Llobregat;3;3;B;;521;302;219;0;4;298;302
8;Barcelona;11;Baix Llobregat;08200;Sant Boi de Llobregat;3;3;C;;615;363;252;0;2;361;363
8;Barcelona;11;Baix Llobregat;08200;Sant Boi de Llobregat;3;4;U;;683;396;287;1;7;388;395
8;Barcelona;11;Baix Llobregat;08200;Sant Boi de Llobregat;3;5;A;;478;301;177;0;0;301;301
8;Barcelona;11;Baix Llobregat;08200;Sant Boi de Llobregat;3;5;B;;578;342;236;0;4;338;342
8;Barcelona;11;Baix Llobregat;08200;Sant Boi de Llobregat;3;5;C;;636;384;252;0;2;382;384
8;Barcelona;11;Baix Llobregat;08200;Sant Boi de Llobregat;3;6;A;;523;324;199;4;2;318;320
8;Barcelona;11;Baix Llobregat;08200;Sant Boi de Llobregat;3;6;B;;644;401;243;8;3;390;393
8;Barcelona;11;Baix Llobregat;08200;Sant Boi de Llobregat;3;7;A;;495;316;179;0;0;316;316
8;Barcelona;11;Baix Llobregat;08200;Sant Boi de Llobregat;3;7;B;;574;350;224;1;4;345;349
8;Barcelona;11;Baix Llobregat;08200;Sant Boi de Llobregat;3;7;C;;597;380;217;0;6;374;380
8;Barcelona;11;Baix Llobregat;08200;Sant Boi de Llobregat;3;8;U;;572;350;222;2;5;343;348
8;Barcelona;11;Baix Llobregat;08200;Sant Boi de Llobregat;3;9;A;;402;262;140;1;3;258;261
8;Barcelona;11;Baix Llobregat;08200;Sant Boi de Llobregat;3;9;B;;552;334;218;0;1;333;334
8;Barcelona;11;Baix Llobregat;08200;Sant Boi de Llobregat;4;1;A;;497;288;209;2;5;281;286
8;Barcelona;11;Baix Llobregat;08200;Sant Boi de Llobregat;4;1;B;;513;288;225;1;0;287;287
8;Barcelona;11;Baix Llobregat;08200;Sant Boi de Llobregat;4;1;C;;588;324;264;0;5;319;324
8;Barcelona;11;Baix Llobregat;08200;Sant Boi de Llobregat;4;2;A;;505;303;202;1;3;299;302
8;Barcelona;11;Baix Llobregat;08200;Sant Boi de Llobregat;4;2;B;;604;364;240;0;1;363;364
8;Barcelona;11;Baix Llobregat;08200;Sant Boi de Llobregat;4;2;C;;575;347;228;0;4;343;347
8;Barcelona;11;Baix Llobregat;08200;Sant Boi de Llobregat;4;3;A;;501;299;202;1;1;297;298
8;Barcelona;11;Baix Llobregat;08200;Sant Boi de Llobregat;4;3;B;;581;345;236;3;3;339;342
8;Barcelona;11;Baix Llobregat;08200;Sant Boi de Llobregat;4;4;A;;481;289;192;0;1;288;289
8;Barcelona;11;Baix Llobregat;08200;Sant Boi de Llobregat;4;4;B;;613;353;260;1;1;351;352
8;Barcelona;11;Baix Llobregat;08200;Sant Boi de Llobregat;4;5;A;;612;368;244;0;0;368;368
8;Barcelona;11;Baix Llobregat;08200;Sant Boi de Llobregat;4;5;B;;767;421;346;3;2;416;418
8;Barcelona;11;Baix Llobregat;08200;Sant Boi de Llobregat;4;6;A;;513;265;248;1;2;262;264
8;Barcelona;11;Baix Llobregat;08200;Sant Boi de Llobregat;4;6;B;;646;348;298;3;2;343;345
8;Barcelona;11;Baix Llobregat;08200;Sant Boi de Llobregat;4;6;C;;609;330;279;1;4;325;329
8;Barcelona;11;Baix Llobregat;08200;Sant Boi de Llobregat;4;7;A;;700;381;319;0;2;379;381
8;Barcelona;11;Baix Llobregat;08200;Sant Boi de Llobregat;4;7;B;;762;432;330;0;2;430;432
8;Barcelona;11;Baix Llobregat;08200;Sant Boi de Llobregat;4;8;A;;695;381;314;0;2;379;381
8;Barcelona;11;Baix Llobregat;08200;Sant Boi de Llobregat;4;8;B;;844;448;396;3;5;440;445
8;Barcelona;11;Baix Llobregat;08200;Sant Boi de Llobregat;4;9;A;;468;269;199;0;1;268;269
8;Barcelona;11;Baix Llobregat;08200;Sant Boi de Llobregat;4;9;B;;513;290;223;1;2;287;289
8;Barcelona;11;Baix Llobregat;08200;Sant Boi de Llobregat;5;1;A;;439;213;226;0;1;212;213
8;Barcelona;11;Baix Llobregat;08200;Sant Boi de Llobregat;5;1;B;;520;261;259;1;0;260;260
8;Barcelona;11;Baix Llobregat;08200;Sant Boi de Llobregat;5;1;C;;600;303;297;0;3;300;303
8;Barcelona;11;Baix Llobregat;08200;Sant Boi de Llobregat;5;2;A;;430;184;246;3;2;179;181
8;Barcelona;11;Baix Llobregat;08200;Sant Boi de Llobregat;5;2;B;;502;249;253;0;1;248;249
8;Barcelona;11;Baix Llobregat;08200;Sant Boi de Llobregat;5;3;U;;565;263;302;0;4;259;263
8;Barcelona;11;Baix Llobregat;08200;Sant Boi de Llobregat;5;4;A;;352;169;183;0;0;169;169
8;Barcelona;11;Baix Llobregat;08200;Sant Boi de Llobregat;5;4;B;;435;225;210;1;0;224;224
8;Barcelona;11;Baix Llobregat;08200;Sant Boi de Llobregat;6;1;A;;458;231;227;0;3;228;231
8;Barcelona;11;Baix Llobregat;08200;Sant Boi de Llobregat;6;1;B;;628;326;302;0;5;321;326
8;Barcelona;11;Baix Llobregat;08200;Sant Boi de Llobregat;6;1;C;;635;329;306;0;2;327;329
8;Barcelona;11;Baix Llobregat;08200;Sant Boi de Llobregat;6;2;A;;435;241;194;0;3;238;241
8;Barcelona;11;Baix Llobregat;08200;Sant Boi de Llobregat;6;2;B;;556;332;224;1;2;329;331
8;Barcelona;11;Baix Llobregat;08200;Sant Boi de Llobregat;6;2;C;;575;304;271;0;5;299;304
8;Barcelona;11;Baix Llobregat;08200;Sant Boi de Llobregat;6;3;A;;463;241;222;0;4;237;241
8;Barcelona;11;Baix Llobregat;08200;Sant Boi de Llobregat;6;3;B;;521;268;253;0;3;265;268
8;Barcelona;24;Osona;08201;Sant Boi de Lluçanès;1;1;U;;506;364;142;4;2;358;360
43;Tarragona;22;Montsià;43136;Sant Carles de la Ràpita;1;1;A;;603;355;248;0;4;351;355
43;Tarragona;22;Montsià;43136;Sant Carles de la Ràpita;1;1;B;;740;435;305;4;4;427;431
43;Tarragona;22;Montsià;43136;Sant Carles de la Ràpita;1;2;U;;882;523;359;0;6;517;523
43;Tarragona;22;Montsià;43136;Sant Carles de la Ràpita;1;3;A;;489;313;176;0;3;310;313
43;Tarragona;22;Montsià;43136;Sant Carles de la Ràpita;1;3;B;;483;304;179;0;4;300;304
43;Tarragona;22;Montsià;43136;Sant Carles de la Ràpita;1;4;A;;648;405;243;3;2;400;402
43;Tarragona;22;Montsià;43136;Sant Carles de la Ràpita;1;4;B;;694;408;286;4;4;400;404
43;Tarragona;22;Montsià;43136;Sant Carles de la Ràpita;1;5;U;;816;471;345;4;6;461;467
43;Tarragona;22;Montsià;43136;Sant Carles de la Ràpita;2;1;U;;719;423;296;0;1;422;423
43;Tarragona;22;Montsià;43136;Sant Carles de la Ràpita;2;2;U;;654;419;235;2;4;413;417
43;Tarragona;22;Montsià;43136;Sant Carles de la Ràpita;2;3;U;;817;481;336;6;3;472;475
43;Tarragona;22;Montsià;43136;Sant Carles de la Ràpita;2;4;A;;929;554;375;0;4;550;554
43;Tarragona;22;Montsià;43136;Sant Carles de la Ràpita;2;4;B;;881;520;361;2;8;510;518
8;Barcelona;21;Maresme;08203;Sant Cebrià de Vallalta;1;1;A;;765;490;275;0;10;480;490
8;Barcelona;21;Maresme;08203;Sant Cebrià de Vallalta;1;1;B;;912;571;341;0;7;564;571
8;Barcelona;41;Vallès Oriental;08202;Sant Celoni;1;1;A;;762;560;202;7;1;552;553
8;Barcelona;41;Vallès Oriental;08202;Sant Celoni;1;1;B;;546;405;141;2;1;402;403
8;Barcelona;41;Vallès Oriental;08202;Sant Celoni;1;1;C;;447;331;116;0;3;328;331
8;Barcelona;41;Vallès Oriental;08202;Sant Celoni;1;2;A;;661;477;184;1;6;470;476
8;Barcelona;41;Vallès Oriental;08202;Sant Celoni;1;2;B;;813;602;211;0;5;597;602
8;Barcelona;41;Vallès Oriental;08202;Sant Celoni;1;3;A;;693;477;216;2;3;472;475
8;Barcelona;41;Vallès Oriental;08202;Sant Celoni;1;3;B;;928;609;319;0;5;604;609
8;Barcelona;41;Vallès Oriental;08202;Sant Celoni;1;4;A;;535;345;190;1;0;344;344
8;Barcelona;41;Vallès Oriental;08202;Sant Celoni;1;4;B;;736;429;307;4;4;421;425
8;Barcelona;41;Vallès Oriental;08202;Sant Celoni;1;5;A;;704;488;216;1;6;481;487
8;Barcelona;41;Vallès Oriental;08202;Sant Celoni;1;5;B;;930;626;304;0;9;617;626
8;Barcelona;41;Vallès Oriental;08202;Sant Celoni;1;6;A;;660;489;171;1;8;480;488
8;Barcelona;41;Vallès Oriental;08202;Sant Celoni;1;6;B;;829;563;266;1;5;557;562
8;Barcelona;41;Vallès Oriental;08202;Sant Celoni;1;7;A;;321;220;101;0;0;220;220
8;Barcelona;41;Vallès Oriental;08202;Sant Celoni;1;7;B;;409;275;134;1;2;272;274
8;Barcelona;41;Vallès Oriental;08202;Sant Celoni;2;1;A;;470;332;138;0;1;331;332
8;Barcelona;41;Vallès Oriental;08202;Sant Celoni;2;1;B;;483;287;196;0;1;286;287
8;Barcelona;11;Baix Llobregat;08204;Sant Climent de Llobregat;1;1;A;;628;384;244;0;5;379;384
8;Barcelona;11;Baix Llobregat;08204;Sant Climent de Llobregat;1;1;B;;639;398;241;0;7;391;398
8;Barcelona;11;Baix Llobregat;08204;Sant Climent de Llobregat;1;1;C;;769;519;250;0;13;506;519
8;Barcelona;11;Baix Llobregat;08204;Sant Climent de Llobregat;1;1;D;;647;429;218;2;2;425;427
17;Girona;2;Alt Empordà;17158;Sant Climent Sescebes;1;1;U;;363;271;92;3;4;264;268
8;Barcelona;40;Vallès Occidental;08205;Sant Cugat del Vallès;1;1;A;;720;490;230;0;2;488;490
8;Barcelona;40;Vallès Occidental;08205;Sant Cugat del Vallès;1;1;B;;684;436;248;0;4;432;436
8;Barcelona;40;Vallès Occidental;08205;Sant Cugat del Vallès;1;10;A;;494;305;189;1;3;301;304
8;Barcelona;40;Vallès Occidental;08205;Sant Cugat del Vallès;1;10;B;;571;333;238;0;6;327;333
8;Barcelona;40;Vallès Occidental;08205;Sant Cugat del Vallès;1;11;A;;837;629;208;0;9;620;629
8;Barcelona;40;Vallès Occidental;08205;Sant Cugat del Vallès;1;11;B;;908;637;271;2;9;626;635
8;Barcelona;40;Vallès Occidental;08205;Sant Cugat del Vallès;1;11;C;;915;644;271;2;6;636;642
8;Barcelona;40;Vallès Occidental;08205;Sant Cugat del Vallès;1;12;A;;798;555;243;0;12;543;555
8;Barcelona;40;Vallès Occidental;08205;Sant Cugat del Vallès;1;12;B;;807;569;238;2;9;558;567
8;Barcelona;40;Vallès Occidental;08205;Sant Cugat del Vallès;1;2;A;;550;395;155;0;1;394;395
8;Barcelona;40;Vallès Occidental;08205;Sant Cugat del Vallès;1;2;B;;481;343;138;0;2;341;343
8;Barcelona;40;Vallès Occidental;08205;Sant Cugat del Vallès;1;3;A;;795;583;212;2;7;574;581
8;Barcelona;40;Vallès Occidental;08205;Sant Cugat del Vallès;1;3;B;;847;600;247;0;8;592;600
8;Barcelona;40;Vallès Occidental;08205;Sant Cugat del Vallès;1;4;A;;688;505;183;2;3;500;503
8;Barcelona;40;Vallès Occidental;08205;Sant Cugat del Vallès;1;4;B;;711;516;195;1;5;510;515
8;Barcelona;40;Vallès Occidental;08205;Sant Cugat del Vallès;1;5;A;;1193;883;310;0;12;871;883
8;Barcelona;40;Vallès Occidental;08205;Sant Cugat del Vallès;1;5;B;;814;598;216;1;13;584;597
8;Barcelona;40;Vallès Occidental;08205;Sant Cugat del Vallès;1;5;C;;943;645;298;0;6;639;645
8;Barcelona;40;Vallès Occidental;08205;Sant Cugat del Vallès;1;5;D;;880;641;239;1;8;632;640
8;Barcelona;40;Vallès Occidental;08205;Sant Cugat del Vallès;1;5;E;;727;551;176;0;2;549;551
8;Barcelona;40;Vallès Occidental;08205;Sant Cugat del Vallès;1;6;A;;587;379;208;1;5;373;378
8;Barcelona;40;Vallès Occidental;08205;Sant Cugat del Vallès;1;6;B;;778;503;275;1;8;494;502
8;Barcelona;40;Vallès Occidental;08205;Sant Cugat del Vallès;1;6;C;;589;396;193;0;3;393;396
8;Barcelona;40;Vallès Occidental;08205;Sant Cugat del Vallès;1;7;A;;694;458;236;0;3;455;458
8;Barcelona;40;Vallès Occidental;08205;Sant Cugat del Vallès;1;7;B;;854;517;337;1;9;507;516
8;Barcelona;40;Vallès Occidental;08205;Sant Cugat del Vallès;1;8;A;;715;458;257;0;2;456;458
8;Barcelona;40;Vallès Occidental;08205;Sant Cugat del Vallès;1;8;B;;867;555;312;1;13;541;554
8;Barcelona;40;Vallès Occidental;08205;Sant Cugat del Vallès;1;9;A;;615;475;140;0;9;466;475
8;Barcelona;40;Vallès Occidental;08205;Sant Cugat del Vallès;1;9;B;;652;512;140;3;7;502;509
8;Barcelona;40;Vallès Occidental;08205;Sant Cugat del Vallès;2;1;A;;633;503;130;1;7;495;502
8;Barcelona;40;Vallès Occidental;08205;Sant Cugat del Vallès;2;1;B;;511;395;116;0;4;391;395
8;Barcelona;40;Vallès Occidental;08205;Sant Cugat del Vallès;2;1;C;;632;508;124;0;6;502;508
8;Barcelona;40;Vallès Occidental;08205;Sant Cugat del Vallès;2;2;A;;718;527;191;0;7;520;527
8;Barcelona;40;Vallès Occidental;08205;Sant Cugat del Vallès;2;2;B;;722;538;184;4;6;528;534
8;Barcelona;40;Vallès Occidental;08205;Sant Cugat del Vallès;2;3;U;;861;549;312;2;7;540;547
8;Barcelona;40;Vallès Occidental;08205;Sant Cugat del Vallès;2;4;A;;488;339;149;0;4;335;339
8;Barcelona;40;Vallès Occidental;08205;Sant Cugat del Vallès;2;4;B;;517;384;133;1;7;376;383
8;Barcelona;40;Vallès Occidental;08205;Sant Cugat del Vallès;2;5;A;;496;323;173;1;4;318;322
8;Barcelona;40;Vallès Occidental;08205;Sant Cugat del Vallès;2;5;B;;479;308;171;0;7;301;308
8;Barcelona;40;Vallès Occidental;08205;Sant Cugat del Vallès;2;6;A;;584;445;139;0;5;440;445
8;Barcelona;40;Vallès Occidental;08205;Sant Cugat del Vallès;2;6;B;;589;455;134;0;5;450;455
8;Barcelona;40;Vallès Occidental;08205;Sant Cugat del Vallès;2;6;C;;675;511;164;0;4;507;511
8;Barcelona;40;Vallès Occidental;08205;Sant Cugat del Vallès;2;7;A;;554;401;153;0;6;395;401
8;Barcelona;40;Vallès Occidental;08205;Sant Cugat del Vallès;2;7;B;;610;437;173;0;4;433;437
8;Barcelona;40;Vallès Occidental;08205;Sant Cugat del Vallès;2;8;A;;1002;790;212;0;7;783;790
8;Barcelona;40;Vallès Occidental;08205;Sant Cugat del Vallès;2;8;B;;753;595;158;0;5;590;595
8;Barcelona;40;Vallès Occidental;08205;Sant Cugat del Vallès;2;8;C;;858;680;178;1;6;673;679
8;Barcelona;40;Vallès Occidental;08205;Sant Cugat del Vallès;2;8;D;;867;698;169;0;4;694;698
8;Barcelona;40;Vallès Occidental;08205;Sant Cugat del Vallès;3;1;A;;472;347;125;1;1;345;346
8;Barcelona;40;Vallès Occidental;08205;Sant Cugat del Vallès;3;1;B;;525;367;158;1;3;363;366
8;Barcelona;40;Vallès Occidental;08205;Sant Cugat del Vallès;3;2;A;;605;456;149;0;2;454;456
8;Barcelona;40;Vallès Occidental;08205;Sant Cugat del Vallès;3;2;B;;727;543;184;0;3;540;543
8;Barcelona;40;Vallès Occidental;08205;Sant Cugat del Vallès;3;3;A;;540;387;153;1;4;382;386
8;Barcelona;40;Vallès Occidental;08205;Sant Cugat del Vallès;3;3;B;;519;364;155;0;6;358;364
8;Barcelona;40;Vallès Occidental;08205;Sant Cugat del Vallès;3;4;A;;605;423;182;2;5;416;421
8;Barcelona;40;Vallès Occidental;08205;Sant Cugat del Vallès;3;4;B;;639;447;192;1;5;441;446
8;Barcelona;40;Vallès Occidental;08205;Sant Cugat del Vallès;4;1;U;;955;599;356;1;3;595;598
8;Barcelona;40;Vallès Occidental;08205;Sant Cugat del Vallès;4;2;U;;862;528;334;1;3;524;527
8;Barcelona;40;Vallès Occidental;08205;Sant Cugat del Vallès;4;3;A;;513;329;184;1;4;324;328
8;Barcelona;40;Vallès Occidental;08205;Sant Cugat del Vallès;4;3;B;;516;330;186;0;0;330;330
8;Barcelona;40;Vallès Occidental;08205;Sant Cugat del Vallès;5;1;A;;998;782;216;0;8;774;782
8;Barcelona;40;Vallès Occidental;08205;Sant Cugat del Vallès;5;1;B;;948;722;226;0;2;720;722
8;Barcelona;40;Vallès Occidental;08205;Sant Cugat del Vallès;5;1;C;;920;689;231;2;6;681;687
8;Barcelona;40;Vallès Occidental;08205;Sant Cugat del Vallès;5;2;A;;790;572;218;0;3;569;572
8;Barcelona;40;Vallès Occidental;08205;Sant Cugat del Vallès;5;2;B;;897;622;275;0;11;611;622
8;Barcelona;40;Vallès Occidental;08205;Sant Cugat del Vallès;5;2;C;;810;567;243;3;6;558;564
8;Barcelona;40;Vallès Occidental;08205;Sant Cugat del Vallès;6;1;U;;817;370;447;0;1;369;370
8;Barcelona;3;Alt Penedès;08206;Sant Cugat Sesgarrigues;1;1;U;;633;524;109;0;5;519;524
25;Lleida;25;Pallars Jussà;25196;Sant Esteve de la Sarga;1;1;U;;140;87;53;0;1;86;87
8;Barcelona;41;Vallès Oriental;08207;Sant Esteve de Palautordera;1;1;A;;579;448;131;2;4;442;446
8;Barcelona;41;Vallès Oriental;08207;Sant Esteve de Palautordera;1;1;B;;697;563;134;2;6;555;561
8;Barcelona;11;Baix Llobregat;08208;Sant Esteve Sesrovires;1;1;A;;523;327;196;1;1;325;326
8;Barcelona;11;Baix Llobregat;08208;Sant Esteve Sesrovires;1;1;B;;576;372;204;0;3;369;372
8;Barcelona;11;Baix Llobregat;08208;Sant Esteve Sesrovires;1;1;C;;486;320;166;1;3;316;319
8;Barcelona;11;Baix Llobregat;08208;Sant Esteve Sesrovires;1;2;A;;497;359;138;0;4;355;359
8;Barcelona;11;Baix Llobregat;08208;Sant Esteve Sesrovires;1;2;B;;600;432;168;3;3;426;429
8;Barcelona;11;Baix Llobregat;08208;Sant Esteve Sesrovires;1;2;C;;505;367;138;0;2;365;367
8;Barcelona;11;Baix Llobregat;08208;Sant Esteve Sesrovires;1;3;U;;635;449;186;1;5;443;448
8;Barcelona;11;Baix Llobregat;08208;Sant Esteve Sesrovires;1;4;U;;556;367;189;0;2;365;367
17;Girona;34;Selva;17159;Sant Feliu de Buixalleu;1;1;U;;615;465;150;2;3;460;463
8;Barcelona;41;Vallès Oriental;08210;Sant Feliu de Codines;1;1;U;;865;593;272;3;4;586;590
8;Barcelona;41;Vallès Oriental;08210;Sant Feliu de Codines;1;2;A;;507;347;160;1;5;341;346
8;Barcelona;41;Vallès Oriental;08210;Sant Feliu de Codines;1;2;B;;634;424;210;1;6;417;423
8;Barcelona;41;Vallès Oriental;08210;Sant Feliu de Codines;2;1;A;;498;289;209;1;1;287;288
8;Barcelona;41;Vallès Oriental;08210;Sant Feliu de Codines;2;1;B;;525;341;184;0;3;338;341
8;Barcelona;41;Vallès Oriental;08210;Sant Feliu de Codines;2;2;U;;686;492;194;2;4;486;490
17;Girona;10;Baix Empordà;17160;Sant Feliu de Guíxols;1;1;A;;558;366;192;3;3;360;363
17;Girona;10;Baix Empordà;17160;Sant Feliu de Guíxols;1;1;B;;539;370;169;1;1;368;369
17;Girona;10;Baix Empordà;17160;Sant Feliu de Guíxols;1;2;A;;600;427;173;4;3;420;423
17;Girona;10;Baix Empordà;17160;Sant Feliu de Guíxols;1;2;B;;642;445;197;0;5;440;445
17;Girona;10;Baix Empordà;17160;Sant Feliu de Guíxols;2;1;A;;555;356;199;4;1;351;352
17;Girona;10;Baix Empordà;17160;Sant Feliu de Guíxols;2;1;B;;540;353;187;1;1;351;352
17;Girona;10;Baix Empordà;17160;Sant Feliu de Guíxols;2;2;A;;822;494;328;1;5;488;493
17;Girona;10;Baix Empordà;17160;Sant Feliu de Guíxols;2;2;B;;865;532;333;2;3;527;530
17;Girona;10;Baix Empordà;17160;Sant Feliu de Guíxols;2;3;A;;839;479;360;0;6;473;479
17;Girona;10;Baix Empordà;17160;Sant Feliu de Guíxols;2;3;B;;854;474;380;2;1;471;472
17;Girona;10;Baix Empordà;17160;Sant Feliu de Guíxols;2;4;U;;833;494;339;0;4;490;494
17;Girona;10;Baix Empordà;17160;Sant Feliu de Guíxols;2;5;A;;597;301;296;0;2;299;301
17;Girona;10;Baix Empordà;17160;Sant Feliu de Guíxols;2;5;B;;679;324;355;0;1;323;324
17;Girona;10;Baix Empordà;17160;Sant Feliu de Guíxols;3;1;A;;883;576;307;1;1;574;575
17;Girona;10;Baix Empordà;17160;Sant Feliu de Guíxols;3;1;B;;899;590;309;0;4;586;590
17;Girona;10;Baix Empordà;17160;Sant Feliu de Guíxols;3;2;A;;507;302;205;2;0;300;300
17;Girona;10;Baix Empordà;17160;Sant Feliu de Guíxols;3;2;B;;551;332;219;0;1;331;332
17;Girona;10;Baix Empordà;17160;Sant Feliu de Guíxols;3;3;A;;492;290;202;0;2;288;290
17;Girona;10;Baix Empordà;17160;Sant Feliu de Guíxols;3;3;B;;513;309;204;2;1;306;307
17;Girona;10;Baix Empordà;17160;Sant Feliu de Guíxols;4;1;A;;650;431;219;2;2;427;429
17;Girona;10;Baix Empordà;17160;Sant Feliu de Guíxols;4;1;B;;634;392;242;0;4;388;392
17;Girona;10;Baix Empordà;17160;Sant Feliu de Guíxols;4;2;U;;690;489;201;0;2;487;489
8;Barcelona;11;Baix Llobregat;08211;Sant Feliu de Llobregat;1;1;A;;616;468;148;3;5;460;465
8;Barcelona;11;Baix Llobregat;08211;Sant Feliu de Llobregat;1;1;B;;672;494;178;0;5;489;494
8;Barcelona;11;Baix Llobregat;08211;Sant Feliu de Llobregat;1;2;A;;482;366;116;0;4;362;366
8;Barcelona;11;Baix Llobregat;08211;Sant Feliu de Llobregat;1;2;B;;556;400;156;2;9;389;398
8;Barcelona;11;Baix Llobregat;08211;Sant Feliu de Llobregat;1;3;A;;499;369;130;1;5;363;368
8;Barcelona;11;Baix Llobregat;08211;Sant Feliu de Llobregat;1;3;B;;585;412;173;3;5;404;409
8;Barcelona;11;Baix Llobregat;08211;Sant Feliu de Llobregat;1;4;A;;705;487;218;1;10;476;486
8;Barcelona;11;Baix Llobregat;08211;Sant Feliu de Llobregat;1;4;B;;785;565;220;1;7;557;564
8;Barcelona;11;Baix Llobregat;08211;Sant Feliu de Llobregat;2;1;A;;425;286;139;0;6;280;286
8;Barcelona;11;Baix Llobregat;08211;Sant Feliu de Llobregat;2;1;B;;502;350;152;1;5;344;349
8;Barcelona;11;Baix Llobregat;08211;Sant Feliu de Llobregat;2;2;U;;532;366;166;1;2;363;365
8;Barcelona;11;Baix Llobregat;08211;Sant Feliu de Llobregat;2;3;A;;526;304;222;0;3;301;304
8;Barcelona;11;Baix Llobregat;08211;Sant Feliu de Llobregat;2;3;B;;554;311;243;0;1;310;311
8;Barcelona;11;Baix Llobregat;08211;Sant Feliu de Llobregat;2;4;U;;617;380;237;0;5;375;380
8;Barcelona;11;Baix Llobregat;08211;Sant Feliu de Llobregat;2;5;U;;827;578;249;3;3;572;575
8;Barcelona;11;Baix Llobregat;08211;Sant Feliu de Llobregat;2;6;A;;586;348;238;7;3;338;341
8;Barcelona;11;Baix Llobregat;08211;Sant Feliu de Llobregat;2;6;B;;684;401;283;2;5;394;399
8;Barcelona;11;Baix Llobregat;08211;Sant Feliu de Llobregat;2;7;A;;624;390;234;1;5;384;389
8;Barcelona;11;Baix Llobregat;08211;Sant Feliu de Llobregat;2;7;B;;649;396;253;0;0;396;396
8;Barcelona;11;Baix Llobregat;08211;Sant Feliu de Llobregat;2;8;A;;704;412;292;1;8;403;411
8;Barcelona;11;Baix Llobregat;08211;Sant Feliu de Llobregat;2;8;B;;741;428;313;0;6;422;428
8;Barcelona;11;Baix Llobregat;08211;Sant Feliu de Llobregat;3;1;A;;434;290;144;3;6;281;287
8;Barcelona;11;Baix Llobregat;08211;Sant Feliu de Llobregat;3;1;B;;499;316;183;3;9;304;313
8;Barcelona;11;Baix Llobregat;08211;Sant Feliu de Llobregat;3;1;C;;537;325;212;0;6;319;325
8;Barcelona;11;Baix Llobregat;08211;Sant Feliu de Llobregat;3;2;A;;400;250;150;0;2;248;250
8;Barcelona;11;Baix Llobregat;08211;Sant Feliu de Llobregat;3;2;B;;486;299;187;0;0;299;299
8;Barcelona;11;Baix Llobregat;08211;Sant Feliu de Llobregat;3;3;A;;613;413;200;1;8;404;412
8;Barcelona;11;Baix Llobregat;08211;Sant Feliu de Llobregat;3;3;B;;678;484;194;0;2;482;484
8;Barcelona;11;Baix Llobregat;08211;Sant Feliu de Llobregat;3;4;A;;665;467;198;1;7;459;466
8;Barcelona;11;Baix Llobregat;08211;Sant Feliu de Llobregat;3;4;B;;726;518;208;3;10;505;515
8;Barcelona;11;Baix Llobregat;08211;Sant Feliu de Llobregat;3;5;A;;673;461;212;1;3;457;460
8;Barcelona;11;Baix Llobregat;08211;Sant Feliu de Llobregat;3;5;B;;740;494;246;0;5;489;494
8;Barcelona;11;Baix Llobregat;08211;Sant Feliu de Llobregat;4;1;U;;828;505;323;1;4;500;504
8;Barcelona;11;Baix Llobregat;08211;Sant Feliu de Llobregat;4;2;A;;389;240;149;1;2;237;239
8;Barcelona;11;Baix Llobregat;08211;Sant Feliu de Llobregat;4;2;B;;560;341;219;0;4;337;341
8;Barcelona;11;Baix Llobregat;08211;Sant Feliu de Llobregat;4;3;U;;895;473;422;0;12;461;473
8;Barcelona;11;Baix Llobregat;08211;Sant Feliu de Llobregat;4;4;A;;656;391;265;1;3;387;390
8;Barcelona;11;Baix Llobregat;08211;Sant Feliu de Llobregat;4;4;B;;709;423;286;0;1;422;423
8;Barcelona;11;Baix Llobregat;08211;Sant Feliu de Llobregat;4;5;U;;443;215;228;0;2;213;215
8;Barcelona;11;Baix Llobregat;08211;Sant Feliu de Llobregat;5;1;A;;457;226;231;1;3;222;225
8;Barcelona;11;Baix Llobregat;08211;Sant Feliu de Llobregat;5;1;B;;494;268;226;1;3;264;267
8;Barcelona;11;Baix Llobregat;08211;Sant Feliu de Llobregat;5;2;U;;826;424;402;3;7;414;421
8;Barcelona;11;Baix Llobregat;08211;Sant Feliu de Llobregat;6;1;A;;417;231;186;0;5;226;231
8;Barcelona;11;Baix Llobregat;08211;Sant Feliu de Llobregat;6;1;B;;609;321;288;0;3;318;321
8;Barcelona;11;Baix Llobregat;08211;Sant Feliu de Llobregat;6;1;C;;566;288;278;0;5;283;288
8;Barcelona;11;Baix Llobregat;08211;Sant Feliu de Llobregat;6;2;U;;714;435;279;3;4;428;432
8;Barcelona;11;Baix Llobregat;08211;Sant Feliu de Llobregat;6;3;U;;730;434;296;1;5;428;433
8;Barcelona;11;Baix Llobregat;08211;Sant Feliu de Llobregat;6;4;A;;441;278;163;3;3;272;275
8;Barcelona;11;Baix Llobregat;08211;Sant Feliu de Llobregat;6;4;B;;535;355;180;0;4;351;355
8;Barcelona;11;Baix Llobregat;08211;Sant Feliu de Llobregat;7;1;A;;646;454;192;0;8;446;454
8;Barcelona;11;Baix Llobregat;08211;Sant Feliu de Llobregat;7;1;B;;739;554;185;1;11;542;553
8;Barcelona;11;Baix Llobregat;08211;Sant Feliu de Llobregat;7;2;A;;662;485;177;3;6;476;482
8;Barcelona;11;Baix Llobregat;08211;Sant Feliu de Llobregat;7;2;B;;780;557;223;0;8;549;557
8;Barcelona;11;Baix Llobregat;08211;Sant Feliu de Llobregat;7;3;U;;713;472;241;0;10;462;472
17;Girona;19;Garrotxa;17161;Sant Feliu de Pallerols;1;1;A;;481;394;87;2;2;390;392
17;Girona;19;Garrotxa;17161;Sant Feliu de Pallerols;1;1;B;;502;390;112;0;1;389;390
8;Barcelona;7;Bages;08212;Sant Feliu Sasserra;1;1;U;;521;406;115;1;5;400;405
17;Girona;19;Garrotxa;17162;Sant Ferriol;1;1;U;;147;86;61;0;2;84;86
8;Barcelona;41;Vallès Oriental;08209;Sant Fost de Campsentelles;1;1;A;;658;412;246;0;1;411;412
8;Barcelona;41;Vallès Oriental;08209;Sant Fost de Campsentelles;1;1;B;;767;491;276;1;3;487;490
8;Barcelona;41;Vallès Oriental;08209;Sant Fost de Campsentelles;1;2;A;;441;276;165;0;2;274;276
8;Barcelona;41;Vallès Oriental;08209;Sant Fost de Campsentelles;1;2;B;;581;372;209;1;0;371;371
8;Barcelona;41;Vallès Oriental;08209;Sant Fost de Campsentelles;1;3;A;;584;374;210;1;3;370;373
8;Barcelona;41;Vallès Oriental;08209;Sant Fost de Campsentelles;1;3;B;;630;369;261;2;5;362;367
8;Barcelona;41;Vallès Oriental;08209;Sant Fost de Campsentelles;1;3;C;;659;432;227;0;3;429;432
8;Barcelona;41;Vallès Oriental;08209;Sant Fost de Campsentelles;1;4;A;;611;363;248;1;0;362;362
8;Barcelona;41;Vallès Oriental;08209;Sant Fost de Campsentelles;1;4;B;;703;380;323;2;3;375;378
8;Barcelona;7;Bages;08213;Sant Fruitós de Bages;1;1;A;;898;609;289;2;5;602;607
8;Barcelona;7;Bages;08213;Sant Fruitós de Bages;1;1;B;;911;528;383;2;3;523;526
8;Barcelona;7;Bages;08213;Sant Fruitós de Bages;1;1;C;;1021;690;331;1;6;683;689
8;Barcelona;7;Bages;08213;Sant Fruitós de Bages;1;2;A;;715;428;287;1;4;423;427
8;Barcelona;7;Bages;08213;Sant Fruitós de Bages;1;2;B;;835;492;343;3;0;489;489
8;Barcelona;7;Bages;08213;Sant Fruitós de Bages;1;2;C;;709;563;146;1;6;556;562
17;Girona;20;Gironès;17163;Sant Gregori;1;1;A;;556;419;137;0;10;409;419
17;Girona;20;Gironès;17163;Sant Gregori;1;1;B;;575;469;106;0;3;466;469
17;Girona;20;Gironès;17163;Sant Gregori;1;2;A;;655;448;207;3;8;437;445
17;Girona;20;Gironès;17163;Sant Gregori;1;2;B;;316;243;73;0;3;240;243
25;Lleida;32;Segarra;25192;Sant Guim de Freixenet;1;1;U;;819;591;228;4;6;581;587
25;Lleida;32;Segarra;25197;Sant Guim de la Plana;1;1;U;;157;116;41;0;2;114;116
17;Girona;34;Selva;17164;Sant Hilari Sacalm;1;1;A;;535;372;163;2;2;368;370
17;Girona;34;Selva;17164;Sant Hilari Sacalm;1;1;B;;675;464;211;3;3;458;461
17;Girona;34;Selva;17164;Sant Hilari Sacalm;1;2;A;;516;364;152;2;4;358;362
17;Girona;34;Selva;17164;Sant Hilari Sacalm;1;2;B;;597;421;176;2;5;414;419
17;Girona;34;Selva;17164;Sant Hilari Sacalm;1;3;A;;864;570;294;0;6;564;570
17;Girona;34;Selva;17164;Sant Hilari Sacalm;1;3;B;;852;569;283;0;3;566;569
8;Barcelona;24;Osona;08215;Sant Hipòlit de Voltregà;1;1;U;;764;535;229;2;3;530;533
8;Barcelona;24;Osona;08215;Sant Hipòlit de Voltregà;1;2;U;;826;666;160;3;7;656;663
8;Barcelona;24;Osona;08215;Sant Hipòlit de Voltregà;1;3;U;;898;704;194;2;7;695;702
8;Barcelona;21;Maresme;08193;Sant Iscle de Vallalta;1;1;U;;772;548;224;3;2;543;545
43;Tarragona;22;Montsià;43902;Sant Jaume d'Enveja;1;1;A;;789;472;317;0;6;466;472
43;Tarragona;22;Montsià;43902;Sant Jaume d'Enveja;1;1;B;;425;349;76;0;8;341;349
43;Tarragona;22;Montsià;43902;Sant Jaume d'Enveja;1;2;A;;790;470;320;6;7;457;464
43;Tarragona;22;Montsià;43902;Sant Jaume d'Enveja;1;2;B;;744;475;269;0;9;466;475
8;Barcelona;14;Berguedà;08216;Sant Jaume de Frontanyà;1;1;U;;29;21;8;0;0;21;21
17;Girona;19;Garrotxa;17165;Sant Jaume de Llierca;1;1;U;;615;476;139;5;5;466;471
43;Tarragona;12;Baix Penedès;43137;Sant Jaume dels Domenys;1;1;A;;591;406;185;3;3;400;403
43;Tarragona;12;Baix Penedès;43137;Sant Jaume dels Domenys;1;1;B;;754;527;227;5;6;516;522
17;Girona;31;Ripollès;17167;Sant Joan de les Abadesses;1;1;A;;297;210;87;1;1;208;209
17;Girona;31;Ripollès;17167;Sant Joan de les Abadesses;1;1;B;;326;245;81;1;3;241;244
17;Girona;31;Ripollès;17167;Sant Joan de les Abadesses;1;2;A;;551;409;142;0;1;408;409
17;Girona;31;Ripollès;17167;Sant Joan de les Abadesses;1;2;B;;492;366;126;0;2;364;366
17;Girona;31;Ripollès;17167;Sant Joan de les Abadesses;1;2;C;;555;409;146;0;3;406;409
17;Girona;31;Ripollès;17167;Sant Joan de les Abadesses;1;3;A;;421;298;123;0;5;293;298
17;Girona;31;Ripollès;17167;Sant Joan de les Abadesses;1;3;B;;404;297;107;3;4;290;294
17;Girona;20;Gironès;17168;Sant Joan de Mollet;1;1;U;;354;302;52;1;4;297;301
8;Barcelona;11;Baix Llobregat;08217;Sant Joan Despí;1;1;U;;808;537;271;0;5;532;537
8;Barcelona;11;Baix Llobregat;08217;Sant Joan Despí;1;10;U;;952;664;288;2;8;654;662
8;Barcelona;11;Baix Llobregat;08217;Sant Joan Despí;1;2;A;;444;286;158;1;3;282;285
8;Barcelona;11;Baix Llobregat;08217;Sant Joan Despí;1;2;B;;526;369;157;0;8;361;369
8;Barcelona;11;Baix Llobregat;08217;Sant Joan Despí;1;3;A;;635;443;192;0;6;437;443
8;Barcelona;11;Baix Llobregat;08217;Sant Joan Despí;1;3;B;;761;484;277;3;7;474;481
8;Barcelona;11;Baix Llobregat;08217;Sant Joan Despí;1;4;A;;743;489;254;1;7;481;488
8;Barcelona;11;Baix Llobregat;08217;Sant Joan Despí;1;4;B;;847;541;306;1;8;532;540
8;Barcelona;11;Baix Llobregat;08217;Sant Joan Despí;1;5;A;;396;277;119;1;4;272;276
8;Barcelona;11;Baix Llobregat;08217;Sant Joan Despí;1;5;B;;459;300;159;0;5;295;300
8;Barcelona;11;Baix Llobregat;08217;Sant Joan Despí;1;5;C;;509;332;177;0;5;327;332
8;Barcelona;11;Baix Llobregat;08217;Sant Joan Despí;1;6;A;;437;255;182;0;2;253;255
8;Barcelona;11;Baix Llobregat;08217;Sant Joan Despí;1;6;B;;478;268;210;0;0;268;268
8;Barcelona;11;Baix Llobregat;08217;Sant Joan Despí;1;7;A;;565;335;230;0;7;328;335
8;Barcelona;11;Baix Llobregat;08217;Sant Joan Despí;1;7;B;;574;341;233;4;2;335;337
8;Barcelona;11;Baix Llobregat;08217;Sant Joan Despí;1;8;A;;599;391;208;0;11;380;391
8;Barcelona;11;Baix Llobregat;08217;Sant Joan Despí;1;8;B;;686;439;247;0;7;432;439
8;Barcelona;11;Baix Llobregat;08217;Sant Joan Despí;1;9;U;;741;472;269;0;3;469;472
8;Barcelona;11;Baix Llobregat;08217;Sant Joan Despí;2;2;A;;585;354;231;5;3;346;349
8;Barcelona;11;Baix Llobregat;08217;Sant Joan Despí;2;2;B;;584;356;228;0;5;351;356
8;Barcelona;11;Baix Llobregat;08217;Sant Joan Despí;2;3;U;;601;345;256;0;7;338;345
8;Barcelona;11;Baix Llobregat;08217;Sant Joan Despí;2;4;A;;438;269;169;0;4;265;269
8;Barcelona;11;Baix Llobregat;08217;Sant Joan Despí;2;4;B;;568;313;255;1;1;311;312
8;Barcelona;11;Baix Llobregat;08217;Sant Joan Despí;3;1;A;;328;203;125;0;3;200;203
8;Barcelona;11;Baix Llobregat;08217;Sant Joan Despí;3;1;B;;402;219;183;0;3;216;219
8;Barcelona;11;Baix Llobregat;08217;Sant Joan Despí;3;1;C;;377;228;149;1;1;226;227
8;Barcelona;11;Baix Llobregat;08217;Sant Joan Despí;3;2;A;;624;348;276;1;9;338;347
8;Barcelona;11;Baix Llobregat;08217;Sant Joan Despí;3;2;B;;634;370;264;1;7;362;369
8;Barcelona;11;Baix Llobregat;08217;Sant Joan Despí;3;3;A;;421;245;176;0;4;241;245
8;Barcelona;11;Baix Llobregat;08217;Sant Joan Despí;3;3;B;;371;228;143;0;2;226;228
8;Barcelona;11;Baix Llobregat;08217;Sant Joan Despí;3;4;A;;670;406;264;0;3;403;406
8;Barcelona;11;Baix Llobregat;08217;Sant Joan Despí;3;4;B;;765;464;301;2;5;457;462
8;Barcelona;11;Baix Llobregat;08217;Sant Joan Despí;3;5;A;;497;324;173;0;2;322;324
8;Barcelona;11;Baix Llobregat;08217;Sant Joan Despí;3;5;B;;546;340;206;0;4;336;340
8;Barcelona;11;Baix Llobregat;08217;Sant Joan Despí;4;1;A;;758;542;216;0;6;536;542
8;Barcelona;11;Baix Llobregat;08217;Sant Joan Despí;4;1;B;;895;654;241;1;8;645;653
8;Barcelona;11;Baix Llobregat;08217;Sant Joan Despí;5;1;A;;823;533;290;0;10;523;533
8;Barcelona;11;Baix Llobregat;08217;Sant Joan Despí;5;1;B;;973;635;338;1;10;624;634
8;Barcelona;11;Baix Llobregat;08217;Sant Joan Despí;5;1;C;;999;645;354;0;11;634;645
8;Barcelona;7;Bages;08218;Sant Joan de Vilatorrada;1;1;A;;567;368;199;0;3;365;368
8;Barcelona;7;Bages;08218;Sant Joan de Vilatorrada;1;1;B;;595;364;231;1;3;360;363
8;Barcelona;7;Bages;08218;Sant Joan de Vilatorrada;1;1;C;;723;480;243;2;5;473;478
8;Barcelona;7;Bages;08218;Sant Joan de Vilatorrada;1;2;A;;708;420;288;9;3;408;411
8;Barcelona;7;Bages;08218;Sant Joan de Vilatorrada;1;2;B;;866;481;385;2;10;469;479
8;Barcelona;7;Bages;08218;Sant Joan de Vilatorrada;1;3;A;;547;334;213;1;5;328;333
8;Barcelona;7;Bages;08218;Sant Joan de Vilatorrada;1;3;B;;640;411;229;1;6;404;410
8;Barcelona;7;Bages;08218;Sant Joan de Vilatorrada;1;3;C;;186;130;56;0;0;130;130
8;Barcelona;7;Bages;08218;Sant Joan de Vilatorrada;1;5;A;;581;385;196;3;1;381;382
8;Barcelona;7;Bages;08218;Sant Joan de Vilatorrada;1;5;B;;694;448;246;0;7;441;448
8;Barcelona;7;Bages;08218;Sant Joan de Vilatorrada;1;6;A;;503;289;214;0;2;287;289
8;Barcelona;7;Bages;08218;Sant Joan de Vilatorrada;1;6;B;;642;359;283;0;2;357;359
8;Barcelona;7;Bages;08218;Sant Joan de Vilatorrada;1;6;C;;636;347;289;0;5;342;347
17;Girona;19;Garrotxa;17185;Sant Joan les Fonts;1;1;A;;521;404;117;6;5;393;398
17;Girona;19;Garrotxa;17185;Sant Joan les Fonts;1;1;B;;533;409;124;1;1;407;408
17;Girona;19;Garrotxa;17185;Sant Joan les Fonts;1;2;U;;503;346;157;0;3;343;346
17;Girona;19;Garrotxa;17185;Sant Joan les Fonts;1;3;A;;572;440;132;3;1;436;437
17;Girona;19;Garrotxa;17185;Sant Joan les Fonts;1;3;B;;206;158;48;1;1;156;157
17;Girona;20;Gironès;17166;Sant Jordi Desvalls;1;1;U;;502;395;107;2;3;390;393
8;Barcelona;14;Berguedà;08903;Sant Julià de Cerdanyola;1;1;U;;214;184;30;0;1;183;184
17;Girona;34;Selva;17903;Sant Julià del Llor i Bonmatí;1;1;U;;770;557;213;3;4;550;554
17;Girona;20;Gironès;17169;Sant Julià de Ramis;1;1;A;;555;400;155;0;0;400;400
17;Girona;20;Gironès;17169;Sant Julià de Ramis;1;1;B;;559;417;142;2;5;410;415
17;Girona;20;Gironès;17169;Sant Julià de Ramis;1;1;C;;648;472;176;2;1;469;470
8;Barcelona;24;Osona;08220;Sant Julià de Vilatorta;1;1;A;;752;583;169;2;3;578;581
8;Barcelona;24;Osona;08220;Sant Julià de Vilatorta;1;1;B;;444;335;109;0;8;327;335
8;Barcelona;24;Osona;08220;Sant Julià de Vilatorta;1;1;C;;818;644;174;1;6;637;643
8;Barcelona;11;Baix Llobregat;08221;Sant Just Desvern;1;1;A;;721;507;214;0;15;492;507
8;Barcelona;11;Baix Llobregat;08221;Sant Just Desvern;1;1;B;;794;579;215;0;7;572;579
8;Barcelona;11;Baix Llobregat;08221;Sant Just Desvern;1;2;U;;750;500;250;1;5;494;499
8;Barcelona;11;Baix Llobregat;08221;Sant Just Desvern;1;3;A;;778;560;218;0;6;554;560
8;Barcelona;11;Baix Llobregat;08221;Sant Just Desvern;1;3;B;;854;604;250;0;7;597;604
8;Barcelona;11;Baix Llobregat;08221;Sant Just Desvern;1;4;A;;587;414;173;0;1;413;414
8;Barcelona;11;Baix Llobregat;08221;Sant Just Desvern;1;4;B;;814;532;282;2;6;524;530
8;Barcelona;11;Baix Llobregat;08221;Sant Just Desvern;1;5;A;;656;479;177;1;5;473;478
8;Barcelona;11;Baix Llobregat;08221;Sant Just Desvern;1;5;B;;835;601;234;0;5;596;601
8;Barcelona;11;Baix Llobregat;08221;Sant Just Desvern;1;6;A;;734;548;186;2;8;538;546
8;Barcelona;11;Baix Llobregat;08221;Sant Just Desvern;1;6;B;;891;653;238;0;7;646;653
8;Barcelona;11;Baix Llobregat;08221;Sant Just Desvern;1;7;A;;448;322;126;0;3;319;322
8;Barcelona;11;Baix Llobregat;08221;Sant Just Desvern;1;7;B;;575;385;190;0;7;378;385
8;Barcelona;11;Baix Llobregat;08221;Sant Just Desvern;1;8;A;;484;334;150;1;4;329;333
8;Barcelona;11;Baix Llobregat;08221;Sant Just Desvern;1;8;B;;568;391;177;0;2;389;391
8;Barcelona;11;Baix Llobregat;08221;Sant Just Desvern;1;9;A;;409;294;115;0;6;288;294
8;Barcelona;11;Baix Llobregat;08221;Sant Just Desvern;1;9;B;;405;300;105;0;4;296;300
8;Barcelona;3;Alt Penedès;08222;Sant Llorenç d'Hortons;1;1;A;;733;536;197;2;6;528;534
8;Barcelona;3;Alt Penedès;08222;Sant Llorenç d'Hortons;1;1;B;;742;510;232;1;4;505;509
17;Girona;2;Alt Empordà;17171;Sant Llorenç de la Muga;1;1;U;;154;122;32;0;0;122;122
25;Lleida;35;Solsonès;25193;Sant Llorenç de Morunys;1;1;U;;779;594;185;5;9;580;589
8;Barcelona;40;Vallès Occidental;08223;Sant Llorenç Savall;1;1;A;;809;536;273;5;1;530;531
8;Barcelona;40;Vallès Occidental;08223;Sant Llorenç Savall;1;1;B;;979;652;327;5;2;645;647
8;Barcelona;24;Osona;08225;Sant Martí d'Albars;1;1;U;;104;72;32;0;2;70;72
8;Barcelona;24;Osona;08224;Sant Martí de Centelles;1;1;U;;637;469;168;0;0;469;469
17;Girona;20;Gironès;17172;Sant Martí de Llémena;1;1;U;;379;272;107;1;4;267;271
25;Lleida;38;Urgell;25902;Sant Martí de Riucorb;1;1;U;;632;467;165;2;3;462;465
8;Barcelona;6;Anoia;08226;Sant Martí de Tous;1;1;U;;846;650;196;0;4;646;650
8;Barcelona;3;Alt Penedès;08227;Sant Martí Sarroca;1;1;A;;684;487;197;0;5;482;487
8;Barcelona;3;Alt Penedès;08227;Sant Martí Sarroca;1;1;B;;817;568;249;1;1;566;567
8;Barcelona;3;Alt Penedès;08227;Sant Martí Sarroca;1;2;U;;541;390;151;1;1;388;389
8;Barcelona;6;Anoia;08228;Sant Martí Sesgueioles;1;1;U;;284;224;60;0;1;223;224
17;Girona;20;Gironès;17173;Sant Martí Vell;1;1;U;;173;105;68;1;0;104;104
8;Barcelona;7;Bages;08229;Sant Mateu de Bages;1;1;A;;166;120;46;0;1;119;120
8;Barcelona;7;Bages;08229;Sant Mateu de Bages;1;1;B;;437;350;87;1;1;348;349
17;Girona;28;Pla de l'Estany;17174;Sant Miquel de Campmajor;1;1;U;;163;120;43;1;3;116;119
17;Girona;2;Alt Empordà;17175;Sant Miquel de Fluvià;1;1;U;;457;299;158;1;3;295;298
17;Girona;2;Alt Empordà;17176;Sant Mori;1;1;U;;141;110;31;0;2;108;110
17;Girona;31;Ripollès;17177;Sant Pau de Segúries;1;1;U;;549;474;75;11;7;456;463
8;Barcelona;7;Bages;08192;Santpedor;1;1;A;;532;377;155;3;3;371;374
8;Barcelona;7;Bages;08192;Santpedor;1;1;B;;610;413;197;2;1;410;411
8;Barcelona;7;Bages;08192;Santpedor;1;2;A;;595;428;167;1;4;423;427
8;Barcelona;7;Bages;08192;Santpedor;1;2;B;;526;337;189;1;2;334;336
8;Barcelona;7;Bages;08192;Santpedor;1;2;C;;643;449;194;0;1;448;449
8;Barcelona;7;Bages;08192;Santpedor;1;3;A;;574;430;144;1;8;421;429
8;Barcelona;7;Bages;08192;Santpedor;1;3;B;;532;359;173;2;2;355;357
8;Barcelona;7;Bages;08192;Santpedor;1;3;C;;642;477;165;0;3;474;477
8;Barcelona;17;Garraf;08231;Sant Pere de Ribes;1;1;A;;728;484;244;1;8;475;483
8;Barcelona;17;Garraf;08231;Sant Pere de Ribes;1;1;B;;798;525;273;1;8;516;524
8;Barcelona;17;Garraf;08231;Sant Pere de Ribes;1;10;A;;942;476;466;3;4;469;473
8;Barcelona;17;Garraf;08231;Sant Pere de Ribes;1;10;B;;729;373;356;0;2;371;373
8;Barcelona;17;Garraf;08231;Sant Pere de Ribes;1;10;C;;489;242;247;1;1;240;241
8;Barcelona;17;Garraf;08231;Sant Pere de Ribes;1;11;A;;463;217;246;0;3;214;217
8;Barcelona;17;Garraf;08231;Sant Pere de Ribes;1;11;B;;435;232;203;1;0;231;231
8;Barcelona;17;Garraf;08231;Sant Pere de Ribes;1;2;A;;575;356;219;0;3;353;356
8;Barcelona;17;Garraf;08231;Sant Pere de Ribes;1;2;B;;657;406;251;0;5;401;406
8;Barcelona;17;Garraf;08231;Sant Pere de Ribes;1;3;A;;1005;574;431;3;4;567;571
8;Barcelona;17;Garraf;08231;Sant Pere de Ribes;1;3;B;;1121;671;450;6;2;663;665
8;Barcelona;17;Garraf;08231;Sant Pere de Ribes;1;4;A;;660;287;373;3;1;283;284
8;Barcelona;17;Garraf;08231;Sant Pere de Ribes;1;4;B;;841;401;440;1;3;397;400
8;Barcelona;17;Garraf;08231;Sant Pere de Ribes;1;5;A;;885;415;470;0;2;413;415
8;Barcelona;17;Garraf;08231;Sant Pere de Ribes;1;5;B;;792;390;402;0;6;384;390
8;Barcelona;17;Garraf;08231;Sant Pere de Ribes;1;5;C;;439;214;225;0;5;209;214
8;Barcelona;17;Garraf;08231;Sant Pere de Ribes;1;6;A;;578;284;294;1;2;281;283
8;Barcelona;17;Garraf;08231;Sant Pere de Ribes;1;6;B;;745;383;362;3;4;376;380
8;Barcelona;17;Garraf;08231;Sant Pere de Ribes;1;7;A;;579;266;313;2;0;264;264
8;Barcelona;17;Garraf;08231;Sant Pere de Ribes;1;7;B;;789;383;406;0;3;380;383
8;Barcelona;17;Garraf;08231;Sant Pere de Ribes;1;8;A;;1057;649;408;3;7;639;646
8;Barcelona;17;Garraf;08231;Sant Pere de Ribes;1;8;B;;809;492;317;1;3;488;491
8;Barcelona;17;Garraf;08231;Sant Pere de Ribes;1;8;C;;623;370;253;1;3;366;369
8;Barcelona;17;Garraf;08231;Sant Pere de Ribes;1;9;A;;782;469;313;0;2;467;469
8;Barcelona;17;Garraf;08231;Sant Pere de Ribes;1;9;B;;780;461;319;0;3;458;461
8;Barcelona;3;Alt Penedès;08232;Sant Pere de Riudebitlles;1;1;A;;600;428;172;3;0;425;425
8;Barcelona;3;Alt Penedès;08232;Sant Pere de Riudebitlles;1;1;B;;563;392;171;1;6;385;391
8;Barcelona;3;Alt Penedès;08232;Sant Pere de Riudebitlles;1;1;C;;581;412;169;2;1;409;410
8;Barcelona;24;Osona;08233;Sant Pere de Torelló;1;1;U;;728;547;181;0;6;541;547
8;Barcelona;24;Osona;08233;Sant Pere de Torelló;1;2;U;;1088;764;324;7;4;753;757
8;Barcelona;41;Vallès Oriental;08234;Sant Pere de Vilamajor;1;1;A;;1135;746;389;3;5;738;743
8;Barcelona;41;Vallès Oriental;08234;Sant Pere de Vilamajor;1;1;B;;1313;834;479;0;6;828;834
17;Girona;2;Alt Empordà;17178;Sant Pere Pescador;1;1;U;;1019;773;246;3;7;763;770
8;Barcelona;6;Anoia;08189;Sant Pere Sallavinera;1;1;U;;135;120;15;0;1;119;120
8;Barcelona;21;Maresme;08235;Sant Pol de Mar;1;1;A;;853;619;234;2;3;614;617
8;Barcelona;21;Maresme;08235;Sant Pol de Mar;1;1;B;;1082;792;290;0;5;787;792
8;Barcelona;21;Maresme;08235;Sant Pol de Mar;1;2;A;;591;426;165;0;0;426;426
8;Barcelona;21;Maresme;08235;Sant Pol de Mar;1;2;B;;810;614;196;3;3;608;611
8;Barcelona;3;Alt Penedès;08236;Sant Quintí de Mediona;1;1;A;;703;494;209;0;3;491;494
8;Barcelona;3;Alt Penedès;08236;Sant Quintí de Mediona;1;1;B;;780;623;157;0;0;623;623
8;Barcelona;24;Osona;08237;Sant Quirze de Besora;1;1;A;;474;359;115;2;0;357;357
8;Barcelona;24;Osona;08237;Sant Quirze de Besora;1;1;B;;523;384;139;2;4;378;382
8;Barcelona;24;Osona;08237;Sant Quirze de Besora;1;2;U;;645;526;119;1;4;521;525
8;Barcelona;40;Vallès Occidental;08238;Sant Quirze del Vallès;1;1;A;;543;396;147;3;1;392;393
8;Barcelona;40;Vallès Occidental;08238;Sant Quirze del Vallès;1;1;B;;634;496;138;1;5;490;495
8;Barcelona;40;Vallès Occidental;08238;Sant Quirze del Vallès;1;2;A;;472;338;134;0;1;337;338
8;Barcelona;40;Vallès Occidental;08238;Sant Quirze del Vallès;1;2;B;;409;293;116;0;3;290;293
8;Barcelona;40;Vallès Occidental;08238;Sant Quirze del Vallès;1;2;C;;429;305;124;0;0;305;305
8;Barcelona;40;Vallès Occidental;08238;Sant Quirze del Vallès;1;3;A;;487;289;198;0;4;285;289
8;Barcelona;40;Vallès Occidental;08238;Sant Quirze del Vallès;1;3;B;;662;408;254;0;4;404;408
8;Barcelona;40;Vallès Occidental;08238;Sant Quirze del Vallès;1;4;A;;551;385;166;0;4;381;385
8;Barcelona;40;Vallès Occidental;08238;Sant Quirze del Vallès;1;4;B;;437;311;126;2;2;307;309
8;Barcelona;40;Vallès Occidental;08238;Sant Quirze del Vallès;1;4;C;;576;408;168;1;5;402;407
8;Barcelona;40;Vallès Occidental;08238;Sant Quirze del Vallès;1;4;D;;503;365;138;2;2;361;363
8;Barcelona;40;Vallès Occidental;08238;Sant Quirze del Vallès;1;5;A;;647;433;214;5;3;425;428
8;Barcelona;40;Vallès Occidental;08238;Sant Quirze del Vallès;1;5;B;;715;461;254;0;7;454;461
8;Barcelona;40;Vallès Occidental;08238;Sant Quirze del Vallès;1;5;C;;619;442;177;0;2;440;442
8;Barcelona;40;Vallès Occidental;08238;Sant Quirze del Vallès;1;6;A;;602;381;221;0;3;378;381
8;Barcelona;40;Vallès Occidental;08238;Sant Quirze del Vallès;1;6;B;;738;458;280;2;3;453;456
8;Barcelona;40;Vallès Occidental;08238;Sant Quirze del Vallès;1;6;C;;623;388;235;5;0;383;383
8;Barcelona;40;Vallès Occidental;08238;Sant Quirze del Vallès;1;7;A;;474;340;134;1;9;330;339
8;Barcelona;40;Vallès Occidental;08238;Sant Quirze del Vallès;1;7;B;;562;399;163;0;7;392;399
8;Barcelona;40;Vallès Occidental;08238;Sant Quirze del Vallès;1;8;A;;355;267;88;0;2;265;267
8;Barcelona;40;Vallès Occidental;08238;Sant Quirze del Vallès;1;8;B;;450;335;115;1;8;326;334
8;Barcelona;;;08239;Sant Quirze Safaja;1;1;U;;368;252;116;1;2;249;251
25;Lleida;32;Segarra;25194;Sant Ramon;1;1;U;;484;335;149;0;4;331;335
8;Barcelona;3;Alt Penedès;08240;Sant Sadurní d'Anoia;1;1;A;;432;315;117;0;1;314;315
8;Barcelona;3;Alt Penedès;08240;Sant Sadurní d'Anoia;1;1;B;;514;381;133;2;1;378;379
8;Barcelona;3;Alt Penedès;08240;Sant Sadurní d'Anoia;1;2;A;;538;382;156;0;9;373;382
8;Barcelona;3;Alt Penedès;08240;Sant Sadurní d'Anoia;1;2;B;;477;316;161;1;2;313;315
8;Barcelona;3;Alt Penedès;08240;Sant Sadurní d'Anoia;1;2;C;;606;419;187;1;3;415;418
8;Barcelona;3;Alt Penedès;08240;Sant Sadurní d'Anoia;1;3;A;;416;290;126;0;3;287;290
8;Barcelona;3;Alt Penedès;08240;Sant Sadurní d'Anoia;1;3;B;;416;280;136;2;1;277;278
8;Barcelona;3;Alt Penedès;08240;Sant Sadurní d'Anoia;1;4;A;;580;401;179;1;2;398;400
8;Barcelona;3;Alt Penedès;08240;Sant Sadurní d'Anoia;1;4;B;;537;377;160;0;0;377;377
8;Barcelona;3;Alt Penedès;08240;Sant Sadurní d'Anoia;1;4;C;;630;440;190;2;3;435;438
8;Barcelona;3;Alt Penedès;08240;Sant Sadurní d'Anoia;2;1;A;;402;291;111;0;1;290;291
8;Barcelona;3;Alt Penedès;08240;Sant Sadurní d'Anoia;2;1;B;;482;356;126;0;4;352;356
8;Barcelona;3;Alt Penedès;08240;Sant Sadurní d'Anoia;2;2;A;;654;460;194;0;6;454;460
8;Barcelona;3;Alt Penedès;08240;Sant Sadurní d'Anoia;2;2;B;;735;486;249;1;2;483;485
8;Barcelona;3;Alt Penedès;08240;Sant Sadurní d'Anoia;2;3;A;;444;315;129;1;2;312;314
8;Barcelona;3;Alt Penedès;08240;Sant Sadurní d'Anoia;2;3;B;;559;408;151;1;2;405;407
8;Barcelona;24;Osona;08241;Sant Sadurní d'Osormort;1;1;U;;70;56;14;0;0;56;56
8;Barcelona;7;Bages;08098;Sant Salvador de Guardiola;1;1;A;;547;354;193;0;0;354;354
8;Barcelona;7;Bages;08098;Sant Salvador de Guardiola;1;1;B;;512;356;156;0;0;356;356
8;Barcelona;7;Bages;08098;Sant Salvador de Guardiola;1;1;C;;446;232;214;0;2;230;232
8;Barcelona;7;Bages;08098;Sant Salvador de Guardiola;1;1;D;;490;272;218;1;4;267;271
8;Barcelona;7;Bages;08262;Sant Vicenç de Castellet;1;1;A;;526;337;189;0;4;333;337
8;Barcelona;7;Bages;08262;Sant Vicenç de Castellet;1;1;B;;554;348;206;0;4;344;348
8;Barcelona;7;Bages;08262;Sant Vicenç de Castellet;1;1;C;;639;381;258;1;4;376;380
8;Barcelona;7;Bages;08262;Sant Vicenç de Castellet;1;1;D;;536;325;211;1;3;321;324
8;Barcelona;7;Bages;08262;Sant Vicenç de Castellet;1;2;A;;559;372;187;2;2;368;370
8;Barcelona;7;Bages;08262;Sant Vicenç de Castellet;1;2;B;;668;441;227;0;3;438;441
8;Barcelona;7;Bages;08262;Sant Vicenç de Castellet;2;1;A;;524;320;204;0;2;318;320
8;Barcelona;7;Bages;08262;Sant Vicenç de Castellet;2;1;B;;528;292;236;1;4;287;291
8;Barcelona;7;Bages;08262;Sant Vicenç de Castellet;2;1;C;;577;355;222;0;4;351;355
8;Barcelona;7;Bages;08262;Sant Vicenç de Castellet;2;2;A;;512;335;177;2;1;332;333
8;Barcelona;7;Bages;08262;Sant Vicenç de Castellet;2;2;B;;552;360;192;0;1;359;360
8;Barcelona;11;Baix Llobregat;08263;Sant Vicenç dels Horts;1;1;U;;670;437;233;0;1;436;437
8;Barcelona;11;Baix Llobregat;08263;Sant Vicenç dels Horts;1;10;A;;443;261;182;0;2;259;261
8;Barcelona;11;Baix Llobregat;08263;Sant Vicenç dels Horts;1;10;B;;534;333;201;0;2;331;333
8;Barcelona;11;Baix Llobregat;08263;Sant Vicenç dels Horts;1;11;U;;936;519;417;0;2;517;519
8;Barcelona;11;Baix Llobregat;08263;Sant Vicenç dels Horts;1;12;U;;748;382;366;1;7;374;381
8;Barcelona;11;Baix Llobregat;08263;Sant Vicenç dels Horts;1;2;A;;656;420;236;3;5;412;417
8;Barcelona;11;Baix Llobregat;08263;Sant Vicenç dels Horts;1;2;B;;724;473;251;0;7;466;473
8;Barcelona;11;Baix Llobregat;08263;Sant Vicenç dels Horts;1;3;A;;444;291;153;1;1;289;290
8;Barcelona;11;Baix Llobregat;08263;Sant Vicenç dels Horts;1;3;B;;483;291;192;0;3;288;291
8;Barcelona;11;Baix Llobregat;08263;Sant Vicenç dels Horts;1;4;A;;699;426;273;1;3;422;425
8;Barcelona;11;Baix Llobregat;08263;Sant Vicenç dels Horts;1;4;B;;798;491;307;0;6;485;491
8;Barcelona;11;Baix Llobregat;08263;Sant Vicenç dels Horts;1;5;A;;574;325;249;0;5;320;325
8;Barcelona;11;Baix Llobregat;08263;Sant Vicenç dels Horts;1;5;B;;589;340;249;1;2;337;339
8;Barcelona;11;Baix Llobregat;08263;Sant Vicenç dels Horts;1;6;A;;286;164;122;0;0;164;164
8;Barcelona;11;Baix Llobregat;08263;Sant Vicenç dels Horts;1;6;B;;360;169;191;0;0;169;169
8;Barcelona;11;Baix Llobregat;08263;Sant Vicenç dels Horts;1;7;A;;581;328;253;0;1;327;328
8;Barcelona;11;Baix Llobregat;08263;Sant Vicenç dels Horts;1;7;B;;640;375;265;3;3;369;372
8;Barcelona;11;Baix Llobregat;08263;Sant Vicenç dels Horts;1;8;U;;890;516;374;1;6;509;515
8;Barcelona;11;Baix Llobregat;08263;Sant Vicenç dels Horts;1;9;U;;639;358;281;1;3;354;357
8;Barcelona;11;Baix Llobregat;08263;Sant Vicenç dels Horts;2;1;A;;498;212;286;0;1;211;212
8;Barcelona;11;Baix Llobregat;08263;Sant Vicenç dels Horts;2;1;B;;554;228;326;0;2;226;228
8;Barcelona;11;Baix Llobregat;08263;Sant Vicenç dels Horts;2;2;A;;470;233;237;0;2;231;233
8;Barcelona;11;Baix Llobregat;08263;Sant Vicenç dels Horts;2;2;B;;580;235;345;0;3;232;235
8;Barcelona;11;Baix Llobregat;08263;Sant Vicenç dels Horts;2;3;A;;428;202;226;1;1;200;201
8;Barcelona;11;Baix Llobregat;08263;Sant Vicenç dels Horts;2;3;B;;472;190;282;2;1;187;188
8;Barcelona;11;Baix Llobregat;08263;Sant Vicenç dels Horts;3;1;A;;672;325;347;2;0;323;323
8;Barcelona;11;Baix Llobregat;08263;Sant Vicenç dels Horts;3;1;B;;803;380;423;1;4;375;379
8;Barcelona;11;Baix Llobregat;08263;Sant Vicenç dels Horts;3;2;A;;583;265;318;0;3;262;265
8;Barcelona;11;Baix Llobregat;08263;Sant Vicenç dels Horts;3;2;B;;654;319;335;0;3;316;319
8;Barcelona;11;Baix Llobregat;08263;Sant Vicenç dels Horts;4;1;A;;490;258;232;3;3;252;255
8;Barcelona;11;Baix Llobregat;08263;Sant Vicenç dels Horts;4;1;B;;578;324;254;0;0;324;324
8;Barcelona;11;Baix Llobregat;08263;Sant Vicenç dels Horts;4;2;A;;363;232;131;2;5;225;230
8;Barcelona;11;Baix Llobregat;08263;Sant Vicenç dels Horts;4;2;B;;712;369;343;0;4;365;369
8;Barcelona;11;Baix Llobregat;08263;Sant Vicenç dels Horts;4;3;U;;758;401;357;1;2;398;400
8;Barcelona;21;Maresme;08264;Sant Vicenç de Montalt;1;1;A;;974;710;264;1;6;703;709
8;Barcelona;21;Maresme;08264;Sant Vicenç de Montalt;1;1;B;;947;663;284;2;4;657;661
8;Barcelona;21;Maresme;08264;Sant Vicenç de Montalt;1;2;A;;638;391;247;0;3;388;391
8;Barcelona;21;Maresme;08264;Sant Vicenç de Montalt;1;2;B;;777;497;280;0;0;497;497
8;Barcelona;24;Osona;08265;Sant Vicenç de Torelló;1;1;U;;1165;893;272;1;3;889;892
8;Barcelona;24;Osona;08265;Sant Vicenç de Torelló;1;2;U;;333;259;74;1;0;258;258
43;Tarragona;16;Conca de Barberà;43142;Sarral;1;1;A;;479;313;166;1;5;307;312
43;Tarragona;16;Conca de Barberà;43142;Sarral;1;1;B;;679;485;194;3;6;476;482
17;Girona;20;Gironès;17186;Sarrià de Ter;1;1;A;;900;620;280;3;3;614;617
17;Girona;20;Gironès;17186;Sarrià de Ter;1;1;B;;976;678;298;2;4;672;676
17;Girona;20;Gironès;17186;Sarrià de Ter;1;2;A;;621;433;188;5;3;425;428
17;Girona;20;Gironès;17186;Sarrià de Ter;1;2;B;;737;493;244;1;5;487;492
25;Lleida;25;Pallars Jussà;25201;Sarroca de Bellera;1;1;U;;138;87;51;1;0;86;86
25;Lleida;33;Segrià;25200;Sarroca de Lleida;1;1;U;;390;309;81;2;1;306;307
17;Girona;2;Alt Empordà;17187;Saus, Camallera i Llampaies;1;1;U;;574;446;128;1;2;443;445
43;Tarragona;16;Conca de Barberà;43143;Savallà del Comtat;1;1;U;;59;47;12;0;0;47;47
43;Tarragona;36;Tarragonès;43144;Secuita, la;1;1;U;;941;642;299;3;10;629;639
43;Tarragona;8;Baix Camp;43145;Selva del Camp, la;1;1;A;;784;551;233;4;4;543;547
43;Tarragona;8;Baix Camp;43145;Selva del Camp, la;1;1;B;;818;547;271;7;3;537;540
43;Tarragona;8;Baix Camp;43145;Selva del Camp, la;2;1;A;;876;620;256;4;5;611;616
43;Tarragona;8;Baix Camp;43145;Selva del Camp, la;2;1;B;;974;701;273;8;7;686;693
17;Girona;2;Alt Empordà;17188;Selva de Mar, la;1;1;U;;167;134;33;0;1;133;134
43;Tarragona;16;Conca de Barberà;43146;Senan;1;1;U;;31;27;4;0;1;26;27
43;Tarragona;22;Montsià;43044;Sénia, la;1;1;A;;726;440;286;3;4;433;437
43;Tarragona;22;Montsià;43044;Sénia, la;1;1;B;;868;513;355;1;12;500;512
43;Tarragona;22;Montsià;43044;Sénia, la;2;1;A;;758;479;279;3;8;468;476
43;Tarragona;22;Montsià;43044;Sénia, la;2;1;B;;827;502;325;3;6;493;499
43;Tarragona;22;Montsià;43044;Sénia, la;2;2;U;;913;532;381;0;12;520;532
25;Lleida;25;Pallars Jussà;25202;Senterada;1;1;U;;89;71;18;0;1;70;71
25;Lleida;23;Noguera;25035;Sentiu de Sió, la;1;1;U;;433;326;107;0;2;324;326
8;Barcelona;40;Vallès Occidental;08267;Sentmenat;1;1;A;;582;343;239;0;5;338;343
8;Barcelona;40;Vallès Occidental;08267;Sentmenat;1;1;B;;580;340;240;2;7;331;338
8;Barcelona;40;Vallès Occidental;08267;Sentmenat;1;2;A;;698;472;226;1;7;464;471
8;Barcelona;40;Vallès Occidental;08267;Sentmenat;1;2;B;;874;600;274;1;7;592;599
8;Barcelona;40;Vallès Occidental;08267;Sentmenat;1;2;C;;757;445;312;0;3;442;445
8;Barcelona;40;Vallès Occidental;08267;Sentmenat;1;3;A;;705;440;265;1;0;439;439
8;Barcelona;40;Vallès Occidental;08267;Sentmenat;1;3;B;;928;590;338;0;4;586;590
17;Girona;28;Pla de l'Estany;17190;Serinyà;1;1;U;;724;556;168;1;6;549;555
25;Lleida;33;Segrià;25204;Seròs;1;1;U;;620;445;175;5;6;434;440
25;Lleida;33;Segrià;25204;Seròs;1;2;U;;852;631;221;2;6;623;629
17;Girona;10;Baix Empordà;17191;Serra de Daró;1;1;U;;147;121;26;1;0;120;120
17;Girona;31;Ripollès;17192;Setcases;1;1;U;;153;127;26;0;0;127;127
25;Lleida;4;Alt Urgell;25203;Seu d'Urgell, la;1;1;U;;734;393;341;1;0;392;392
25;Lleida;4;Alt Urgell;25203;Seu d'Urgell, la;1;2;U;;1159;643;516;3;7;633;640
25;Lleida;4;Alt Urgell;25203;Seu d'Urgell, la;1;3;U;;1142;640;502;0;7;633;640
25;Lleida;4;Alt Urgell;25203;Seu d'Urgell, la;1;4;A;;1093;733;360;1;7;725;732
25;Lleida;4;Alt Urgell;25203;Seu d'Urgell, la;1;4;B;;790;492;298;0;2;490;492
25;Lleida;4;Alt Urgell;25203;Seu d'Urgell, la;1;5;A;;658;395;263;2;0;393;393
25;Lleida;4;Alt Urgell;25203;Seu d'Urgell, la;1;5;B;;719;409;310;0;6;403;409
25;Lleida;4;Alt Urgell;25203;Seu d'Urgell, la;1;6;A;;400;260;140;0;3;257;260
25;Lleida;4;Alt Urgell;25203;Seu d'Urgell, la;1;6;B;;488;332;156;1;3;328;331
25;Lleida;4;Alt Urgell;25203;Seu d'Urgell, la;1;6;C;;358;239;119;1;3;235;238
25;Lleida;4;Alt Urgell;25203;Seu d'Urgell, la;1;7;A;;696;419;277;2;6;411;417
25;Lleida;4;Alt Urgell;25203;Seu d'Urgell, la;1;7;B;;784;451;333;1;7;443;450
8;Barcelona;24;Osona;08269;Seva;1;1;U;;1302;1011;291;1;2;1008;1010
8;Barcelona;24;Osona;08269;Seva;1;2;U;;937;710;227;2;2;706;708
25;Lleida;27;Pla d'Urgell;25205;Sidamon;1;1;U;;552;376;176;5;3;368;371
17;Girona;34;Selva;17193;Sils;1;1;A;;697;434;263;1;5;428;433
17;Girona;34;Selva;17193;Sils;1;1;B;;664;362;302;1;2;359;361
17;Girona;34;Selva;17193;Sils;1;1;C;;715;437;278;0;4;433;437
17;Girona;34;Selva;17193;Sils;1;2;U;;727;458;269;1;2;455;457
8;Barcelona;17;Garraf;08270;Sitges;1;1;A;;487;325;162;0;2;323;325
8;Barcelona;17;Garraf;08270;Sitges;1;1;B;;550;363;187;0;1;362;363
8;Barcelona;17;Garraf;08270;Sitges;1;2;A;;525;358;167;1;2;355;357
8;Barcelona;17;Garraf;08270;Sitges;1;2;B;;687;472;215;2;3;467;470
8;Barcelona;17;Garraf;08270;Sitges;1;3;A;;604;392;212;2;5;385;390
8;Barcelona;17;Garraf;08270;Sitges;1;3;B;;714;479;235;1;5;473;478
8;Barcelona;17;Garraf;08270;Sitges;1;4;A;;591;389;202;1;7;381;388
8;Barcelona;17;Garraf;08270;Sitges;1;4;B;;645;432;213;2;1;429;430
8;Barcelona;17;Garraf;08270;Sitges;2;1;A;;702;487;215;2;9;476;485
8;Barcelona;17;Garraf;08270;Sitges;2;1;B;;911;630;281;2;3;625;628
8;Barcelona;17;Garraf;08270;Sitges;2;2;A;;797;546;251;0;3;543;546
8;Barcelona;17;Garraf;08270;Sitges;2;2;B;;921;611;310;3;2;606;608
8;Barcelona;17;Garraf;08270;Sitges;2;3;A;;632;425;207;1;4;420;424
8;Barcelona;17;Garraf;08270;Sitges;2;3;B;;815;545;270;0;7;538;545
8;Barcelona;17;Garraf;08270;Sitges;2;4;A;;544;327;217;0;1;326;327
8;Barcelona;17;Garraf;08270;Sitges;2;4;B;;703;424;279;1;3;420;423
8;Barcelona;17;Garraf;08270;Sitges;2;5;A;;418;287;131;0;1;286;287
8;Barcelona;17;Garraf;08270;Sitges;2;5;B;;557;368;189;1;2;365;367
8;Barcelona;17;Garraf;08270;Sitges;2;6;A;;954;616;338;0;12;604;616
8;Barcelona;17;Garraf;08270;Sitges;2;6;B;;1106;677;429;0;9;668;677
8;Barcelona;17;Garraf;08270;Sitges;2;7;U;;602;357;245;1;4;352;356
8;Barcelona;17;Garraf;08270;Sitges;2;8;U;;552;356;196;0;4;352;356
8;Barcelona;17;Garraf;08270;Sitges;2;9;A;;201;148;53;1;1;146;147
8;Barcelona;17;Garraf;08270;Sitges;2;9;B;;927;570;357;0;4;566;570
17;Girona;2;Alt Empordà;17052;Siurana;1;1;U;;138;95;43;1;0;94;94
8;Barcelona;24;Osona;08271;Sobremunt;1;1;U;;69;44;25;0;0;44;44
25;Lleida;18;Garrigues;25206;Soleràs, el;1;1;U;;347;288;59;0;4;284;288
43;Tarragona;16;Conca de Barberà;43147;Solivella;1;1;U;;530;382;148;3;4;375;379
25;Lleida;35;Solsonès;25207;Solsona;1;1;A;;812;555;257;1;8;546;554
25;Lleida;35;Solsonès;25207;Solsona;1;1;B;;1054;736;318;1;7;728;735
25;Lleida;35;Solsonès;25207;Solsona;1;2;A;;624;404;220;1;7;396;403
25;Lleida;35;Solsonès;25207;Solsona;1;2;B;;683;434;249;5;4;425;429
25;Lleida;35;Solsonès;25207;Solsona;1;3;A;;469;306;163;3;1;302;303
25;Lleida;35;Solsonès;25207;Solsona;1;3;B;;556;373;183;0;0;373;373
25;Lleida;35;Solsonès;25207;Solsona;2;1;U;;821;614;207;1;4;609;613
25;Lleida;35;Solsonès;25207;Solsona;2;2;A;;465;326;139;4;2;320;322
25;Lleida;35;Solsonès;25207;Solsona;2;2;B;;626;462;164;2;5;455;460
8;Barcelona;24;Osona;08272;Sora;1;1;U;;154;99;55;0;5;94;99
25;Lleida;26;Pallars Sobirà;25208;Soriguera;1;1;U;;284;169;115;0;1;168;169
25;Lleida;26;Pallars Sobirà;25209;Sort;1;1;A;;696;518;178;1;2;515;517
25;Lleida;26;Pallars Sobirà;25209;Sort;1;1;B;;830;623;207;3;4;616;620
25;Lleida;33;Segrià;25210;Soses;1;1;U;;1233;858;375;3;1;854;855
8;Barcelona;3;Alt Penedès;08273;Subirats;1;1;U;;606;459;147;4;3;452;455
8;Barcelona;3;Alt Penedès;08273;Subirats;1;2;A;;473;364;109;3;0;361;361
8;Barcelona;3;Alt Penedès;08273;Subirats;1;2;B;;418;250;168;5;0;245;245
8;Barcelona;3;Alt Penedès;08273;Subirats;1;3;U;;628;485;143;4;2;479;481
25;Lleida;33;Segrià;25211;Sudanell;1;1;U;;659;378;281;0;4;374;378
25;Lleida;33;Segrià;25212;Sunyer;1;1;U;;250;204;46;0;1;203;204
8;Barcelona;7;Bages;08274;Súria;1;1;A;;730;554;176;2;4;548;552
8;Barcelona;7;Bages;08274;Súria;1;1;B;;753;551;202;1;3;547;550
8;Barcelona;7;Bages;08274;Súria;1;2;U;;631;442;189;3;1;438;439
8;Barcelona;7;Bages;08274;Súria;1;3;U;;322;215;107;3;3;209;212
8;Barcelona;7;Bages;08274;Súria;1;4;A;;740;481;259;0;3;478;481
8;Barcelona;7;Bages;08274;Súria;1;4;B;;774;527;247;6;5;516;521
8;Barcelona;7;Bages;08274;Súria;1;5;A;;539;398;141;0;5;393;398
8;Barcelona;7;Bages;08274;Súria;1;5;B;;571;416;155;0;5;411;416
17;Girona;34;Selva;17194;Susqueda;1;1;U;;102;68;34;0;0;68;68
8;Barcelona;41;Vallès Oriental;08276;Tagamanent;1;1;U;;197;137;60;1;0;136;136
8;Barcelona;7;Bages;08277;Talamanca;1;1;U;;102;74;28;0;0;74;74
25;Lleida;25;Pallars Jussà;25215;Talarn;1;1;U;;300;209;91;2;1;206;207
25;Lleida;32;Segarra;25216;Talavera;1;1;U;;269;208;61;0;2;206;208
17;Girona;10;Baix Empordà;17195;Tallada d'Empordà, la;1;1;U;;273;200;73;2;0;198;198
8;Barcelona;24;Osona;08278;Taradell;1;1;A;;715;544;171;2;2;540;542
8;Barcelona;24;Osona;08278;Taradell;1;1;B;;816;595;221;1;2;592;594
8;Barcelona;24;Osona;08278;Taradell;1;1;C;;702;544;158;1;7;536;543
8;Barcelona;24;Osona;08278;Taradell;1;2;A;;873;639;234;2;4;633;637
8;Barcelona;24;Osona;08278;Taradell;1;2;B;;525;362;163;0;3;359;362
8;Barcelona;24;Osona;08278;Taradell;1;2;C;;608;453;155;0;6;447;453
43;Tarragona;36;Tarragonès;43148;Tarragona;1;1;A;;541;327;214;3;2;322;324
43;Tarragona;36;Tarragonès;43148;Tarragona;1;1;B;;609;379;230;1;6;372;378
43;Tarragona;36;Tarragonès;43148;Tarragona;2;1;A;;436;246;190;0;4;242;246
43;Tarragona;36;Tarragonès;43148;Tarragona;2;1;B;;457;274;183;3;4;267;271
43;Tarragona;36;Tarragonès;43148;Tarragona;3;1;A;;450;301;149;0;4;297;301
43;Tarragona;36;Tarragonès;43148;Tarragona;3;1;B;;463;302;161;0;2;300;302
43;Tarragona;36;Tarragonès;43148;Tarragona;3;2;A;;617;441;176;3;7;431;438
43;Tarragona;36;Tarragonès;43148;Tarragona;3;2;B;;583;408;175;0;5;403;408
43;Tarragona;36;Tarragonès;43148;Tarragona;3;3;A;;476;375;101;0;0;375;375
43;Tarragona;36;Tarragonès;43148;Tarragona;3;3;B;;455;352;103;0;6;346;352
43;Tarragona;36;Tarragonès;43148;Tarragona;3;3;C;;534;413;121;0;6;407;413
43;Tarragona;36;Tarragonès;43148;Tarragona;4;1;U;;612;446;166;0;8;438;446
43;Tarragona;36;Tarragonès;43148;Tarragona;4;10;A;;495;343;152;0;6;337;343
43;Tarragona;36;Tarragonès;43148;Tarragona;4;10;B;;573;376;197;0;3;373;376
43;Tarragona;36;Tarragonès;43148;Tarragona;4;11;U;;496;332;164;2;3;327;330
43;Tarragona;36;Tarragonès;43148;Tarragona;4;12;U;;631;436;195;6;2;428;430
43;Tarragona;36;Tarragonès;43148;Tarragona;4;13;U;;704;394;310;2;1;391;392
43;Tarragona;36;Tarragonès;43148;Tarragona;4;14;A;;481;338;143;0;3;335;338
43;Tarragona;36;Tarragonès;43148;Tarragona;4;14;B;;509;336;173;0;3;333;336
43;Tarragona;36;Tarragonès;43148;Tarragona;4;14;C;;531;361;170;2;3;356;359
43;Tarragona;36;Tarragonès;43148;Tarragona;4;15;U;;729;501;228;2;6;493;499
43;Tarragona;36;Tarragonès;43148;Tarragona;4;16;A;;566;422;144;3;5;414;419
43;Tarragona;36;Tarragonès;43148;Tarragona;4;16;B;;648;498;150;1;6;491;497
43;Tarragona;36;Tarragonès;43148;Tarragona;4;2;U;;647;448;199;1;0;447;447
43;Tarragona;36;Tarragonès;43148;Tarragona;4;3;U;;657;423;234;0;4;419;423
43;Tarragona;36;Tarragonès;43148;Tarragona;4;4;A;;419;293;126;1;2;290;292
43;Tarragona;36;Tarragonès;43148;Tarragona;4;4;B;;485;334;151;0;7;327;334
43;Tarragona;36;Tarragonès;43148;Tarragona;4;5;A;;436;308;128;0;6;302;308
43;Tarragona;36;Tarragonès;43148;Tarragona;4;5;B;;508;345;163;2;5;338;343
43;Tarragona;36;Tarragonès;43148;Tarragona;4;6;A;;565;384;181;0;5;379;384
43;Tarragona;36;Tarragonès;43148;Tarragona;4;6;B;;633;434;199;0;1;433;434
43;Tarragona;36;Tarragonès;43148;Tarragona;4;7;U;;698;483;215;0;5;478;483
43;Tarragona;36;Tarragonès;43148;Tarragona;4;8;A;;476;339;137;0;2;337;339
43;Tarragona;36;Tarragonès;43148;Tarragona;4;8;B;;420;292;128;0;1;291;292
43;Tarragona;36;Tarragonès;43148;Tarragona;4;8;C;;467;334;133;0;3;331;334
43;Tarragona;36;Tarragonès;43148;Tarragona;4;9;A;;460;345;115;3;5;337;342
43;Tarragona;36;Tarragonès;43148;Tarragona;4;9;B;;570;418;152;0;3;415;418
43;Tarragona;36;Tarragonès;43148;Tarragona;5;1;A;;418;289;129;0;2;287;289
43;Tarragona;36;Tarragonès;43148;Tarragona;5;1;B;;483;345;138;0;7;338;345
43;Tarragona;36;Tarragonès;43148;Tarragona;5;2;A;;442;307;135;0;1;306;307
43;Tarragona;36;Tarragonès;43148;Tarragona;5;2;B;;451;293;158;0;5;288;293
43;Tarragona;36;Tarragonès;43148;Tarragona;5;3;A;;418;275;143;1;2;272;274
43;Tarragona;36;Tarragonès;43148;Tarragona;5;3;B;;497;321;176;2;1;318;319
43;Tarragona;36;Tarragonès;43148;Tarragona;5;4;A;;411;270;141;1;1;268;269
43;Tarragona;36;Tarragonès;43148;Tarragona;5;4;B;;511;320;191;0;2;318;320
43;Tarragona;36;Tarragonès;43148;Tarragona;5;5;A;;514;304;210;1;5;298;303
43;Tarragona;36;Tarragonès;43148;Tarragona;5;5;B;;582;369;213;1;3;365;368
43;Tarragona;36;Tarragonès;43148;Tarragona;5;6;A;;400;212;188;0;3;209;212
43;Tarragona;36;Tarragonès;43148;Tarragona;5;6;B;;426;240;186;0;3;237;240
43;Tarragona;36;Tarragonès;43148;Tarragona;5;7;A;;365;233;132;0;2;231;233
43;Tarragona;36;Tarragonès;43148;Tarragona;5;7;B;;442;289;153;3;4;282;286
43;Tarragona;36;Tarragonès;43148;Tarragona;5;8;A;;622;430;192;0;4;426;430
43;Tarragona;36;Tarragonès;43148;Tarragona;5;8;B;;675;451;224;4;2;445;447
43;Tarragona;36;Tarragonès;43148;Tarragona;5;9;U;;597;425;172;0;3;422;425
43;Tarragona;36;Tarragonès;43148;Tarragona;6;1;A;;457;325;132;1;6;318;324
43;Tarragona;36;Tarragonès;43148;Tarragona;6;1;B;;448;316;132;1;7;308;315
43;Tarragona;36;Tarragonès;43148;Tarragona;6;1;C;;493;353;140;0;2;351;353
43;Tarragona;36;Tarragonès;43148;Tarragona;6;10;A;;433;299;134;0;4;295;299
43;Tarragona;36;Tarragonès;43148;Tarragona;6;10;B;;408;290;118;0;1;289;290
43;Tarragona;36;Tarragonès;43148;Tarragona;6;10;C;;458;336;122;0;4;332;336
43;Tarragona;36;Tarragonès;43148;Tarragona;6;11;A;;450;299;151;1;4;294;298
43;Tarragona;36;Tarragonès;43148;Tarragona;6;11;B;;389;249;140;0;5;244;249
43;Tarragona;36;Tarragonès;43148;Tarragona;6;11;C;;518;347;171;1;7;339;346
43;Tarragona;36;Tarragonès;43148;Tarragona;6;12;A;;543;411;132;0;8;403;411
43;Tarragona;36;Tarragonès;43148;Tarragona;6;12;B;;605;430;175;0;7;423;430
43;Tarragona;36;Tarragonès;43148;Tarragona;6;13;A;;408;285;123;1;2;282;284
43;Tarragona;36;Tarragonès;43148;Tarragona;6;13;B;;419;262;157;3;0;259;259
43;Tarragona;36;Tarragonès;43148;Tarragona;6;14;U;;588;371;217;0;3;368;371
43;Tarragona;36;Tarragonès;43148;Tarragona;6;15;A;;366;197;169;0;3;194;197
43;Tarragona;36;Tarragonès;43148;Tarragona;6;15;B;;472;254;218;1;2;251;253
43;Tarragona;36;Tarragonès;43148;Tarragona;6;16;A;;562;396;166;0;2;394;396
43;Tarragona;36;Tarragonès;43148;Tarragona;6;16;B;;505;356;149;0;3;353;356
43;Tarragona;36;Tarragonès;43148;Tarragona;6;16;C;;581;437;144;0;4;433;437
43;Tarragona;36;Tarragonès;43148;Tarragona;6;2;A;;509;349;160;1;4;344;348
43;Tarragona;36;Tarragonès;43148;Tarragona;6;2;B;;509;365;144;0;5;360;365
43;Tarragona;36;Tarragonès;43148;Tarragona;6;2;C;;601;394;207;0;1;393;394
43;Tarragona;36;Tarragonès;43148;Tarragona;6;3;A;;529;314;215;3;2;309;311
43;Tarragona;36;Tarragonès;43148;Tarragona;6;3;B;;492;272;220;5;3;264;267
43;Tarragona;36;Tarragonès;43148;Tarragona;6;3;C;;432;250;182;5;2;243;245
43;Tarragona;36;Tarragonès;43148;Tarragona;6;4;U;;712;424;288;0;0;424;424
43;Tarragona;36;Tarragonès;43148;Tarragona;6;5;U;;660;351;309;0;4;347;351
43;Tarragona;36;Tarragonès;43148;Tarragona;6;6;U;;738;366;372;0;6;360;366
43;Tarragona;36;Tarragonès;43148;Tarragona;6;7;U;;446;266;180;0;2;264;266
43;Tarragona;36;Tarragonès;43148;Tarragona;6;8;A;;404;298;106;1;4;293;297
43;Tarragona;36;Tarragonès;43148;Tarragona;6;8;B;;474;355;119;1;4;350;354
43;Tarragona;36;Tarragonès;43148;Tarragona;6;9;A;;525;369;156;1;5;363;368
43;Tarragona;36;Tarragonès;43148;Tarragona;6;9;B;;480;301;179;1;3;297;300
43;Tarragona;36;Tarragonès;43148;Tarragona;6;9;C;;557;401;156;2;4;395;399
43;Tarragona;36;Tarragonès;43148;Tarragona;7;1;U;;595;368;227;0;2;366;368
43;Tarragona;36;Tarragonès;43148;Tarragona;7;10;A;;571;291;280;2;3;286;289
43;Tarragona;36;Tarragonès;43148;Tarragona;7;10;B;;647;365;282;1;2;362;364
43;Tarragona;36;Tarragonès;43148;Tarragona;7;11;A;;566;306;260;3;4;299;303
43;Tarragona;36;Tarragonès;43148;Tarragona;7;11;B;;535;304;231;0;6;298;304
43;Tarragona;36;Tarragonès;43148;Tarragona;7;11;C;;551;307;244;0;2;305;307
43;Tarragona;36;Tarragonès;43148;Tarragona;7;12;A;;535;299;236;0;4;295;299
43;Tarragona;36;Tarragonès;43148;Tarragona;7;12;B;;569;291;278;0;3;288;291
43;Tarragona;36;Tarragonès;43148;Tarragona;7;12;C;;557;280;277;0;3;277;280
43;Tarragona;36;Tarragonès;43148;Tarragona;7;13;A;;587;401;186;0;1;400;401
43;Tarragona;36;Tarragonès;43148;Tarragona;7;13;B;;602;403;199;0;5;398;403
43;Tarragona;36;Tarragonès;43148;Tarragona;7;13;C;;680;487;193;1;6;480;486
43;Tarragona;36;Tarragonès;43148;Tarragona;7;14;U;;772;588;184;2;7;579;586
43;Tarragona;36;Tarragonès;43148;Tarragona;7;15;A;;581;377;204;0;3;374;377
43;Tarragona;36;Tarragonès;43148;Tarragona;7;15;B;;648;407;241;2;3;402;405
43;Tarragona;36;Tarragonès;43148;Tarragona;7;16;A;;675;469;206;0;4;465;469
43;Tarragona;36;Tarragonès;43148;Tarragona;7;16;B;;696;449;247;1;5;443;448
43;Tarragona;36;Tarragonès;43148;Tarragona;7;17;A;;592;427;165;0;7;420;427
43;Tarragona;36;Tarragonès;43148;Tarragona;7;17;B;;629;438;191;1;4;433;437
43;Tarragona;36;Tarragonès;43148;Tarragona;7;18;A;;481;288;193;0;1;287;288
43;Tarragona;36;Tarragonès;43148;Tarragona;7;18;B;;587;341;246;1;3;337;340
43;Tarragona;36;Tarragonès;43148;Tarragona;7;19;A;;585;329;256;2;2;325;327
43;Tarragona;36;Tarragonès;43148;Tarragona;7;19;B;;620;351;269;2;4;345;349
43;Tarragona;36;Tarragonès;43148;Tarragona;7;19;C;;727;421;306;1;3;417;420
43;Tarragona;36;Tarragonès;43148;Tarragona;7;2;A;;453;275;178;0;5;270;275
43;Tarragona;36;Tarragonès;43148;Tarragona;7;2;B;;544;340;204;0;1;339;340
43;Tarragona;36;Tarragonès;43148;Tarragona;7;3;A;;466;227;239;1;0;226;226
43;Tarragona;36;Tarragonès;43148;Tarragona;7;3;B;;489;245;244;0;4;241;245
43;Tarragona;36;Tarragonès;43148;Tarragona;7;3;C;;541;254;287;1;5;248;253
43;Tarragona;36;Tarragonès;43148;Tarragona;7;4;A;;574;343;231;0;4;339;343
43;Tarragona;36;Tarragonès;43148;Tarragona;7;4;B;;624;348;276;0;5;343;348
43;Tarragona;36;Tarragonès;43148;Tarragona;7;5;A;;404;163;241;0;0;163;163
43;Tarragona;36;Tarragonès;43148;Tarragona;7;5;B;;504;198;306;0;1;197;198
43;Tarragona;36;Tarragonès;43148;Tarragona;7;6;A;;529;287;242;1;3;283;286
43;Tarragona;36;Tarragonès;43148;Tarragona;7;6;B;;535;309;226;0;1;308;309
43;Tarragona;36;Tarragonès;43148;Tarragona;7;7;A;;760;529;231;0;7;522;529
43;Tarragona;36;Tarragonès;43148;Tarragona;7;7;B;;826;559;267;0;6;553;559
43;Tarragona;36;Tarragonès;43148;Tarragona;7;7;C;;304;178;126;2;3;173;176
43;Tarragona;36;Tarragonès;43148;Tarragona;7;8;A;;505;356;149;1;5;350;355
43;Tarragona;36;Tarragonès;43148;Tarragona;7;8;B;;557;368;189;1;10;357;367
43;Tarragona;36;Tarragonès;43148;Tarragona;7;8;C;;621;436;185;0;3;433;436
43;Tarragona;36;Tarragonès;43148;Tarragona;7;9;U;;667;327;340;1;2;324;326
43;Tarragona;36;Tarragonès;43148;Tarragona;8;1;A;;449;240;209;1;2;237;239
43;Tarragona;36;Tarragonès;43148;Tarragona;8;1;B;;436;214;222;1;1;212;213
43;Tarragona;36;Tarragonès;43148;Tarragona;8;1;C;;465;249;216;3;0;246;246
43;Tarragona;36;Tarragonès;43148;Tarragona;8;10;A;;453;164;289;0;1;163;164
43;Tarragona;36;Tarragonès;43148;Tarragona;8;10;B;;529;221;308;0;6;215;221
43;Tarragona;36;Tarragonès;43148;Tarragona;8;11;A;;497;262;235;3;0;259;259
43;Tarragona;36;Tarragonès;43148;Tarragona;8;11;B;;530;290;240;1;0;289;289
43;Tarragona;36;Tarragonès;43148;Tarragona;8;12;U;;600;158;442;0;2;156;158
43;Tarragona;36;Tarragonès;43148;Tarragona;8;13;A;;419;211;208;1;2;208;210
43;Tarragona;36;Tarragonès;43148;Tarragona;8;13;B;;412;225;187;0;1;224;225
43;Tarragona;36;Tarragonès;43148;Tarragona;8;14;U;;536;283;253;0;1;282;283
43;Tarragona;36;Tarragonès;43148;Tarragona;8;2;A;;478;256;222;0;1;255;256
43;Tarragona;36;Tarragonès;43148;Tarragona;8;2;B;;510;285;225;1;1;283;284
43;Tarragona;36;Tarragonès;43148;Tarragona;8;3;A;;440;237;203;1;1;235;236
43;Tarragona;36;Tarragonès;43148;Tarragona;8;3;B;;465;253;212;2;5;246;251
43;Tarragona;36;Tarragonès;43148;Tarragona;8;3;C;;515;274;241;2;3;269;272
43;Tarragona;36;Tarragonès;43148;Tarragona;8;4;A;;510;293;217;0;4;289;293
43;Tarragona;36;Tarragonès;43148;Tarragona;8;4;B;;548;321;227;0;4;317;321
43;Tarragona;36;Tarragonès;43148;Tarragona;8;5;A;;441;230;211;0;3;227;230
43;Tarragona;36;Tarragonès;43148;Tarragona;8;5;B;;590;321;269;1;5;315;320
43;Tarragona;36;Tarragonès;43148;Tarragona;8;6;A;;439;271;168;0;2;269;271
43;Tarragona;36;Tarragonès;43148;Tarragona;8;6;B;;528;308;220;2;2;304;306
43;Tarragona;36;Tarragonès;43148;Tarragona;8;6;C;;512;285;227;0;1;284;285
43;Tarragona;36;Tarragonès;43148;Tarragona;8;7;A;;451;227;224;0;6;221;227
43;Tarragona;36;Tarragonès;43148;Tarragona;8;7;B;;517;258;259;4;3;251;254
43;Tarragona;36;Tarragonès;43148;Tarragona;8;7;C;;462;259;203;2;5;252;257
43;Tarragona;36;Tarragonès;43148;Tarragona;8;8;A;;471;175;296;0;0;175;175
43;Tarragona;36;Tarragonès;43148;Tarragona;8;8;B;;600;250;350;1;1;248;249
43;Tarragona;36;Tarragonès;43148;Tarragona;8;9;A;;516;287;229;0;2;285;287
43;Tarragona;36;Tarragonès;43148;Tarragona;8;9;B;;578;293;285;1;2;290;292
43;Tarragona;36;Tarragonès;43148;Tarragona;8;9;C;;575;286;289;0;7;279;286
43;Tarragona;36;Tarragonès;43148;Tarragona;9;1;A;;430;231;199;0;0;231;231
43;Tarragona;36;Tarragonès;43148;Tarragona;9;1;B;;532;265;267;1;2;262;264
43;Tarragona;36;Tarragonès;43148;Tarragona;9;10;A;;466;234;232;0;1;233;234
43;Tarragona;36;Tarragonès;43148;Tarragona;9;10;B;;531;253;278;1;3;249;252
43;Tarragona;36;Tarragonès;43148;Tarragona;9;2;A;;418;209;209;1;1;207;208
43;Tarragona;36;Tarragonès;43148;Tarragona;9;2;B;;465;211;254;3;0;208;208
43;Tarragona;36;Tarragonès;43148;Tarragona;9;3;A;;346;170;176;0;1;169;170
43;Tarragona;36;Tarragonès;43148;Tarragona;9;3;B;;431;214;217;1;3;210;213
43;Tarragona;36;Tarragonès;43148;Tarragona;9;4;A;;442;217;225;1;0;216;216
43;Tarragona;36;Tarragonès;43148;Tarragona;9;4;B;;583;277;306;0;1;276;277
43;Tarragona;36;Tarragonès;43148;Tarragona;9;5;A;;497;308;189;2;1;305;306
43;Tarragona;36;Tarragonès;43148;Tarragona;9;5;B;;580;366;214;0;4;362;366
43;Tarragona;36;Tarragonès;43148;Tarragona;9;6;A;;551;319;232;2;4;313;317
43;Tarragona;36;Tarragonès;43148;Tarragona;9;6;B;;631;345;286;0;2;343;345
43;Tarragona;36;Tarragonès;43148;Tarragona;9;6;C;;592;353;239;1;3;349;352
43;Tarragona;36;Tarragonès;43148;Tarragona;9;7;A;;375;263;112;1;4;258;262
43;Tarragona;36;Tarragonès;43148;Tarragona;9;7;B;;402;272;130;1;1;270;271
43;Tarragona;36;Tarragonès;43148;Tarragona;9;8;U;;656;309;347;2;2;305;307
43;Tarragona;36;Tarragonès;43148;Tarragona;9;9;U;;643;335;308;5;3;327;330
25;Lleida;38;Urgell;25217;Tàrrega;1;1;A;;619;398;221;1;4;393;397
25;Lleida;38;Urgell;25217;Tàrrega;1;1;B;;732;455;277;4;3;448;451
25;Lleida;38;Urgell;25217;Tàrrega;1;2;U;;641;442;199;0;4;438;442
25;Lleida;38;Urgell;25217;Tàrrega;2;1;U;;888;619;269;4;6;609;615
25;Lleida;38;Urgell;25217;Tàrrega;2;2;A;;564;404;160;2;7;395;402
25;Lleida;38;Urgell;25217;Tàrrega;2;2;B;;684;483;201;4;6;473;479
25;Lleida;38;Urgell;25217;Tàrrega;2;3;U;;823;527;296;0;5;522;527
25;Lleida;38;Urgell;25217;Tàrrega;3;1;A;;521;335;186;0;4;331;335
25;Lleida;38;Urgell;25217;Tàrrega;3;1;B;;659;444;215;0;3;441;444
25;Lleida;38;Urgell;25217;Tàrrega;3;2;U;;688;478;210;3;13;462;475
25;Lleida;38;Urgell;25217;Tàrrega;3;3;U;;921;651;270;2;13;636;649
25;Lleida;38;Urgell;25217;Tàrrega;4;1;U;;677;451;226;5;2;444;446
25;Lleida;38;Urgell;25217;Tàrrega;4;2;A;;505;345;160;1;4;340;344
25;Lleida;38;Urgell;25217;Tàrrega;4;2;B;;595;430;165;5;4;421;425
25;Lleida;38;Urgell;25217;Tàrrega;5;1;A;;338;246;92;0;2;244;246
25;Lleida;38;Urgell;25217;Tàrrega;5;1;B;;205;152;53;0;2;150;152
25;Lleida;18;Garrigues;25218;Tarrés;1;1;U;;104;79;25;0;1;78;79
25;Lleida;32;Segarra;25219;Tarroja de Segarra;1;1;U;;143;115;28;0;1;114;115
8;Barcelona;24;Osona;08275;Tavèrnoles;1;1;U;;233;194;39;0;3;191;194
8;Barcelona;24;Osona;08280;Tavertet;1;1;U;;127;100;27;0;0;100;100
8;Barcelona;21;Maresme;08281;Teià;1;1;A;;733;520;213;0;4;516;520
8;Barcelona;21;Maresme;08281;Teià;1;1;B;;834;634;200;1;5;628;633
8;Barcelona;21;Maresme;08281;Teià;1;2;A;;689;505;184;1;10;494;504
8;Barcelona;21;Maresme;08281;Teià;1;2;B;;754;537;217;0;6;531;537
8;Barcelona;21;Maresme;08281;Teià;1;3;A;;681;492;189;2;1;489;490
8;Barcelona;21;Maresme;08281;Teià;1;3;B;;734;503;231;0;6;497;503
25;Lleida;23;Noguera;25220;Térmens;1;1;A;;503;359;144;1;1;357;358
25;Lleida;23;Noguera;25220;Térmens;1;1;B;;654;495;159;3;3;489;492
17;Girona;2;Alt Empordà;17196;Terrades;1;1;U;;181;136;45;2;0;134;134
8;Barcelona;40;Vallès Occidental;08279;Terrassa;1;1;A;;521;413;108;0;2;411;413
8;Barcelona;40;Vallès Occidental;08279;Terrassa;1;1;B;;570;471;99;1;1;469;470
8;Barcelona;40;Vallès Occidental;08279;Terrassa;1;10;U;;789;565;224;0;7;558;565
8;Barcelona;40;Vallès Occidental;08279;Terrassa;1;11;U;;780;490;290;0;6;484;490
8;Barcelona;40;Vallès Occidental;08279;Terrassa;1;12;U;;1043;615;428;2;1;612;613
8;Barcelona;40;Vallès Occidental;08279;Terrassa;1;13;U;;576;343;233;1;3;339;342
8;Barcelona;40;Vallès Occidental;08279;Terrassa;1;14;A;;494;298;196;0;3;295;298
8;Barcelona;40;Vallès Occidental;08279;Terrassa;1;14;B;;598;356;242;3;4;349;353
8;Barcelona;40;Vallès Occidental;08279;Terrassa;1;14;C;;593;367;226;0;4;363;367
8;Barcelona;40;Vallès Occidental;08279;Terrassa;1;15;U;;926;610;316;3;6;601;607
8;Barcelona;40;Vallès Occidental;08279;Terrassa;1;16;A;;829;577;252;0;0;577;577
8;Barcelona;40;Vallès Occidental;08279;Terrassa;1;16;B;;984;666;318;1;10;655;665
8;Barcelona;40;Vallès Occidental;08279;Terrassa;1;17;A;;765;568;197;0;4;564;568
8;Barcelona;40;Vallès Occidental;08279;Terrassa;1;17;B;;938;710;228;6;5;699;704
8;Barcelona;40;Vallès Occidental;08279;Terrassa;1;18;U;;372;259;113;1;2;256;258
8;Barcelona;40;Vallès Occidental;08279;Terrassa;1;19;U;;920;591;329;1;1;589;590
8;Barcelona;40;Vallès Occidental;08279;Terrassa;1;2;A;;493;356;137;0;5;351;356
8;Barcelona;40;Vallès Occidental;08279;Terrassa;1;2;B;;588;424;164;1;2;421;423
8;Barcelona;40;Vallès Occidental;08279;Terrassa;1;20;U;;770;565;205;0;5;560;565
8;Barcelona;40;Vallès Occidental;08279;Terrassa;1;21;U;;996;643;353;1;8;634;642
8;Barcelona;40;Vallès Occidental;08279;Terrassa;1;4;A;;559;416;143;0;4;412;416
8;Barcelona;40;Vallès Occidental;08279;Terrassa;1;4;B;;603;431;172;1;8;422;430
8;Barcelona;40;Vallès Occidental;08279;Terrassa;1;5;A;;1162;831;331;2;5;824;829
8;Barcelona;40;Vallès Occidental;08279;Terrassa;1;5;B;;1350;919;431;0;8;911;919
8;Barcelona;40;Vallès Occidental;08279;Terrassa;1;6;A;;842;629;213;1;3;625;628
8;Barcelona;40;Vallès Occidental;08279;Terrassa;1;6;B;;961;708;253;5;2;701;703
8;Barcelona;40;Vallès Occidental;08279;Terrassa;1;7;A;;549;413;136;0;5;408;413
8;Barcelona;40;Vallès Occidental;08279;Terrassa;1;7;B;;612;432;180;3;4;425;429
8;Barcelona;40;Vallès Occidental;08279;Terrassa;1;8;U;;936;652;284;1;8;643;651
8;Barcelona;40;Vallès Occidental;08279;Terrassa;1;9;U;;794;572;222;2;2;568;570
8;Barcelona;40;Vallès Occidental;08279;Terrassa;2;1;A;;520;311;209;0;4;307;311
8;Barcelona;40;Vallès Occidental;08279;Terrassa;2;1;B;;662;400;262;3;2;395;397
8;Barcelona;40;Vallès Occidental;08279;Terrassa;2;10;U;;515;280;235;1;1;278;279
8;Barcelona;40;Vallès Occidental;08279;Terrassa;2;11;U;;749;435;314;2;10;423;433
8;Barcelona;40;Vallès Occidental;08279;Terrassa;2;12;A;;404;227;177;0;5;222;227
8;Barcelona;40;Vallès Occidental;08279;Terrassa;2;12;B;;506;277;229;2;4;271;275
8;Barcelona;40;Vallès Occidental;08279;Terrassa;2;14;A;;664;328;336;3;5;320;325
8;Barcelona;40;Vallès Occidental;08279;Terrassa;2;14;B;;878;401;477;1;6;394;400
8;Barcelona;40;Vallès Occidental;08279;Terrassa;2;15;U;;681;268;413;0;4;264;268
8;Barcelona;40;Vallès Occidental;08279;Terrassa;2;2;A;;357;140;217;0;0;140;140
8;Barcelona;40;Vallès Occidental;08279;Terrassa;2;2;B;;455;225;230;0;0;225;225
8;Barcelona;40;Vallès Occidental;08279;Terrassa;2;3;U;;642;333;309;0;3;330;333
8;Barcelona;40;Vallès Occidental;08279;Terrassa;2;4;A;;401;231;170;0;6;225;231
8;Barcelona;40;Vallès Occidental;08279;Terrassa;2;4;B;;539;313;226;2;3;308;311
8;Barcelona;40;Vallès Occidental;08279;Terrassa;2;5;A;;404;251;153;0;4;247;251
8;Barcelona;40;Vallès Occidental;08279;Terrassa;2;5;B;;516;293;223;0;4;289;293
8;Barcelona;40;Vallès Occidental;08279;Terrassa;2;6;U;;770;473;297;1;7;465;472
8;Barcelona;40;Vallès Occidental;08279;Terrassa;2;7;U;;446;251;195;2;6;243;249
8;Barcelona;40;Vallès Occidental;08279;Terrassa;2;8;U;;809;437;372;1;7;429;436
8;Barcelona;40;Vallès Occidental;08279;Terrassa;2;9;U;;665;394;271;3;0;391;391
8;Barcelona;40;Vallès Occidental;08279;Terrassa;3;1;U;;1203;717;486;0;10;707;717
8;Barcelona;40;Vallès Occidental;08279;Terrassa;3;10;A;;751;329;422;0;3;326;329
8;Barcelona;40;Vallès Occidental;08279;Terrassa;3;10;B;;988;450;538;3;0;447;447
8;Barcelona;40;Vallès Occidental;08279;Terrassa;3;11;A;;522;235;287;0;3;232;235
8;Barcelona;40;Vallès Occidental;08279;Terrassa;3;11;B;;707;247;460;0;0;247;247
8;Barcelona;40;Vallès Occidental;08279;Terrassa;3;12;A;;738;389;349;1;1;387;388
8;Barcelona;40;Vallès Occidental;08279;Terrassa;3;12;B;;886;486;400;0;5;481;486
8;Barcelona;40;Vallès Occidental;08279;Terrassa;3;13;U;;519;295;224;1;3;291;294
8;Barcelona;40;Vallès Occidental;08279;Terrassa;3;14;A;;568;286;282;0;3;283;286
8;Barcelona;40;Vallès Occidental;08279;Terrassa;3;14;B;;687;356;331;1;3;352;355
8;Barcelona;40;Vallès Occidental;08279;Terrassa;3;15;U;;839;468;371;0;2;466;468
8;Barcelona;40;Vallès Occidental;08279;Terrassa;3;16;U;;734;350;384;0;3;347;350
8;Barcelona;40;Vallès Occidental;08279;Terrassa;3;17;A;;467;246;221;0;2;244;246
8;Barcelona;40;Vallès Occidental;08279;Terrassa;3;17;B;;602;301;301;1;0;300;300
8;Barcelona;40;Vallès Occidental;08279;Terrassa;3;18;U;;765;312;453;0;2;310;312
8;Barcelona;40;Vallès Occidental;08279;Terrassa;3;19;A;;448;244;204;1;3;240;243
8;Barcelona;40;Vallès Occidental;08279;Terrassa;3;19;B;;620;334;286;0;6;328;334
8;Barcelona;40;Vallès Occidental;08279;Terrassa;3;2;U;;1010;640;370;1;9;630;639
8;Barcelona;40;Vallès Occidental;08279;Terrassa;3;20;U;;1047;580;467;3;2;575;577
8;Barcelona;40;Vallès Occidental;08279;Terrassa;3;3;A;;496;268;228;0;0;268;268
8;Barcelona;40;Vallès Occidental;08279;Terrassa;3;3;B;;635;325;310;0;4;321;325
8;Barcelona;40;Vallès Occidental;08279;Terrassa;3;4;U;;888;446;442;0;3;443;446
8;Barcelona;40;Vallès Occidental;08279;Terrassa;3;5;A;;482;309;173;0;0;309;309
8;Barcelona;40;Vallès Occidental;08279;Terrassa;3;5;B;;662;403;259;1;3;399;402
8;Barcelona;40;Vallès Occidental;08279;Terrassa;3;6;U;;1118;769;349;0;3;766;769
8;Barcelona;40;Vallès Occidental;08279;Terrassa;3;7;U;;1207;774;433;2;4;768;772
8;Barcelona;40;Vallès Occidental;08279;Terrassa;3;8;A;;605;318;287;0;0;318;318
8;Barcelona;40;Vallès Occidental;08279;Terrassa;3;8;B;;776;386;390;0;3;383;386
8;Barcelona;40;Vallès Occidental;08279;Terrassa;3;9;U;;1085;664;421;0;4;660;664
8;Barcelona;40;Vallès Occidental;08279;Terrassa;4;1;A;;490;367;123;1;8;358;366
8;Barcelona;40;Vallès Occidental;08279;Terrassa;4;1;B;;542;406;136;5;4;397;401
8;Barcelona;40;Vallès Occidental;08279;Terrassa;4;10;U;;571;305;266;0;4;301;305
8;Barcelona;40;Vallès Occidental;08279;Terrassa;4;11;U;;606;311;295;2;1;308;309
8;Barcelona;40;Vallès Occidental;08279;Terrassa;4;12;A;;460;276;184;1;0;275;275
8;Barcelona;40;Vallès Occidental;08279;Terrassa;4;12;B;;552;344;208;1;5;338;343
8;Barcelona;40;Vallès Occidental;08279;Terrassa;4;13;A;;559;400;159;2;1;397;398
8;Barcelona;40;Vallès Occidental;08279;Terrassa;4;13;B;;638;437;201;1;0;436;436
8;Barcelona;40;Vallès Occidental;08279;Terrassa;4;14;A;;933;707;226;1;5;701;706
8;Barcelona;40;Vallès Occidental;08279;Terrassa;4;14;B;;1024;750;274;1;7;742;749
8;Barcelona;40;Vallès Occidental;08279;Terrassa;4;15;U;;859;643;216;0;5;638;643
8;Barcelona;40;Vallès Occidental;08279;Terrassa;4;16;A;;429;324;105;0;2;322;324
8;Barcelona;40;Vallès Occidental;08279;Terrassa;4;16;B;;521;401;120;0;5;396;401
8;Barcelona;40;Vallès Occidental;08279;Terrassa;4;17;U;;880;655;225;0;11;644;655
8;Barcelona;40;Vallès Occidental;08279;Terrassa;4;18;A;;643;437;206;0;3;434;437
8;Barcelona;40;Vallès Occidental;08279;Terrassa;4;18;B;;829;571;258;1;1;569;570
8;Barcelona;40;Vallès Occidental;08279;Terrassa;4;19;A;;489;303;186;0;2;301;303
8;Barcelona;40;Vallès Occidental;08279;Terrassa;4;19;B;;511;315;196;1;2;312;314
8;Barcelona;40;Vallès Occidental;08279;Terrassa;4;2;A;;573;382;191;2;3;377;380
8;Barcelona;40;Vallès Occidental;08279;Terrassa;4;2;B;;603;428;175;3;3;422;425
8;Barcelona;40;Vallès Occidental;08279;Terrassa;4;20;U;;585;316;269;0;4;312;316
8;Barcelona;40;Vallès Occidental;08279;Terrassa;4;21;A;;387;207;180;0;4;203;207
8;Barcelona;40;Vallès Occidental;08279;Terrassa;4;21;B;;504;301;203;0;1;300;301
8;Barcelona;40;Vallès Occidental;08279;Terrassa;4;22;A;;657;369;288;0;4;365;369
8;Barcelona;40;Vallès Occidental;08279;Terrassa;4;22;B;;823;422;401;0;5;417;422
8;Barcelona;40;Vallès Occidental;08279;Terrassa;4;23;A;;599;315;284;0;5;310;315
8;Barcelona;40;Vallès Occidental;08279;Terrassa;4;23;B;;841;431;410;1;4;426;430
8;Barcelona;40;Vallès Occidental;08279;Terrassa;4;24;U;;913;371;542;0;4;367;371
8;Barcelona;40;Vallès Occidental;08279;Terrassa;4;3;A;;492;335;157;2;2;331;333
8;Barcelona;40;Vallès Occidental;08279;Terrassa;4;3;B;;650;421;229;1;2;418;420
8;Barcelona;40;Vallès Occidental;08279;Terrassa;4;4;A;;544;335;209;2;6;327;333
8;Barcelona;40;Vallès Occidental;08279;Terrassa;4;4;B;;571;359;212;1;1;357;358
8;Barcelona;40;Vallès Occidental;08279;Terrassa;4;5;A;;887;521;366;0;6;515;521
8;Barcelona;40;Vallès Occidental;08279;Terrassa;4;5;B;;1025;592;433;1;4;587;591
8;Barcelona;40;Vallès Occidental;08279;Terrassa;4;6;A;;569;336;233;0;2;334;336
8;Barcelona;40;Vallès Occidental;08279;Terrassa;4;6;B;;810;445;365;2;1;442;443
8;Barcelona;40;Vallès Occidental;08279;Terrassa;4;7;A;;734;374;360;0;7;367;374
8;Barcelona;40;Vallès Occidental;08279;Terrassa;4;7;B;;930;500;430;0;2;498;500
8;Barcelona;40;Vallès Occidental;08279;Terrassa;4;8;U;;684;424;260;0;4;420;424
8;Barcelona;40;Vallès Occidental;08279;Terrassa;4;9;U;;750;352;398;0;3;349;352
8;Barcelona;40;Vallès Occidental;08279;Terrassa;5;1;U;;1339;797;542;3;11;783;794
8;Barcelona;40;Vallès Occidental;08279;Terrassa;5;10;A;;810;483;327;0;4;479;483
8;Barcelona;40;Vallès Occidental;08279;Terrassa;5;10;B;;887;509;378;0;3;506;509
8;Barcelona;40;Vallès Occidental;08279;Terrassa;5;11;A;;691;440;251;1;5;434;439
8;Barcelona;40;Vallès Occidental;08279;Terrassa;5;11;B;;818;538;280;1;5;532;537
8;Barcelona;40;Vallès Occidental;08279;Terrassa;5;12;U;;617;333;284;0;3;330;333
8;Barcelona;40;Vallès Occidental;08279;Terrassa;5;13;U;;968;458;510;2;4;452;456
8;Barcelona;40;Vallès Occidental;08279;Terrassa;5;14;A;;388;230;158;1;0;229;229
8;Barcelona;40;Vallès Occidental;08279;Terrassa;5;14;B;;604;348;256;3;3;342;345
8;Barcelona;40;Vallès Occidental;08279;Terrassa;5;14;C;;544;337;207;0;0;337;337
8;Barcelona;40;Vallès Occidental;08279;Terrassa;5;15;A;;694;361;333;2;4;355;359
8;Barcelona;40;Vallès Occidental;08279;Terrassa;5;15;B;;817;411;406;5;6;400;406
8;Barcelona;40;Vallès Occidental;08279;Terrassa;5;16;A;;704;388;316;0;2;386;388
8;Barcelona;40;Vallès Occidental;08279;Terrassa;5;16;B;;939;539;400;3;2;534;536
8;Barcelona;40;Vallès Occidental;08279;Terrassa;5;17;U;;1178;663;515;2;8;653;661
8;Barcelona;40;Vallès Occidental;08279;Terrassa;5;18;A;;513;317;196;0;1;316;317
8;Barcelona;40;Vallès Occidental;08279;Terrassa;5;18;B;;664;385;279;1;9;375;384
8;Barcelona;40;Vallès Occidental;08279;Terrassa;5;19;U;;1348;712;636;1;8;703;711
8;Barcelona;40;Vallès Occidental;08279;Terrassa;5;2;A;;538;275;263;0;2;273;275
8;Barcelona;40;Vallès Occidental;08279;Terrassa;5;2;B;;736;382;354;0;0;382;382
8;Barcelona;40;Vallès Occidental;08279;Terrassa;5;20;A;;486;304;182;1;1;302;303
8;Barcelona;40;Vallès Occidental;08279;Terrassa;5;20;B;;592;397;195;1;5;391;396
8;Barcelona;40;Vallès Occidental;08279;Terrassa;5;21;A;;622;400;222;1;2;397;399
8;Barcelona;40;Vallès Occidental;08279;Terrassa;5;21;B;;822;504;318;1;3;500;503
8;Barcelona;40;Vallès Occidental;08279;Terrassa;5;22;U;;547;316;231;1;1;314;315
8;Barcelona;40;Vallès Occidental;08279;Terrassa;5;23;U;;1031;693;338;2;2;689;691
8;Barcelona;40;Vallès Occidental;08279;Terrassa;5;24;U;;1039;619;420;1;6;612;618
8;Barcelona;40;Vallès Occidental;08279;Terrassa;5;25;U;;859;508;351;1;7;500;507
8;Barcelona;40;Vallès Occidental;08279;Terrassa;5;3;A;;647;396;251;0;3;393;396
8;Barcelona;40;Vallès Occidental;08279;Terrassa;5;3;B;;807;540;267;1;5;534;539
8;Barcelona;40;Vallès Occidental;08279;Terrassa;5;4;A;;795;543;252;3;9;531;540
8;Barcelona;40;Vallès Occidental;08279;Terrassa;5;4;B;;942;657;285;1;5;651;656
8;Barcelona;40;Vallès Occidental;08279;Terrassa;5;5;U;;719;461;258;1;3;457;460
8;Barcelona;40;Vallès Occidental;08279;Terrassa;5;6;A;;727;479;248;1;2;476;478
8;Barcelona;40;Vallès Occidental;08279;Terrassa;5;6;B;;812;548;264;0;4;544;548
8;Barcelona;40;Vallès Occidental;08279;Terrassa;5;7;A;;876;572;304;2;3;567;570
8;Barcelona;40;Vallès Occidental;08279;Terrassa;5;7;B;;1035;717;318;1;4;712;716
8;Barcelona;40;Vallès Occidental;08279;Terrassa;5;8;A;;667;489;178;0;5;484;489
8;Barcelona;40;Vallès Occidental;08279;Terrassa;5;8;B;;772;512;260;1;3;508;511
8;Barcelona;40;Vallès Occidental;08279;Terrassa;5;9;A;;647;423;224;1;1;421;422
8;Barcelona;40;Vallès Occidental;08279;Terrassa;5;9;B;;753;474;279;0;1;473;474
8;Barcelona;40;Vallès Occidental;08279;Terrassa;6;1;U;;970;534;436;1;4;529;533
8;Barcelona;40;Vallès Occidental;08279;Terrassa;6;10;A;;979;516;463;0;4;512;516
8;Barcelona;40;Vallès Occidental;08279;Terrassa;6;10;B;;1298;682;616;2;10;670;680
8;Barcelona;40;Vallès Occidental;08279;Terrassa;6;11;A;;675;259;416;0;2;257;259
8;Barcelona;40;Vallès Occidental;08279;Terrassa;6;11;B;;761;322;439;1;1;320;321
8;Barcelona;40;Vallès Occidental;08279;Terrassa;6;12;A;;426;229;197;0;1;228;229
8;Barcelona;40;Vallès Occidental;08279;Terrassa;6;12;B;;632;343;289;0;1;342;343
8;Barcelona;40;Vallès Occidental;08279;Terrassa;6;13;U;;719;447;272;0;6;441;447
8;Barcelona;40;Vallès Occidental;08279;Terrassa;6;14;U;;810;373;437;2;2;369;371
8;Barcelona;40;Vallès Occidental;08279;Terrassa;6;16;A;;433;234;199;0;1;233;234
8;Barcelona;40;Vallès Occidental;08279;Terrassa;6;16;B;;625;294;331;2;2;290;292
8;Barcelona;40;Vallès Occidental;08279;Terrassa;6;18;U;;579;312;267;1;0;311;311
8;Barcelona;40;Vallès Occidental;08279;Terrassa;6;19;U;;526;300;226;0;3;297;300
8;Barcelona;40;Vallès Occidental;08279;Terrassa;6;2;A;;474;271;203;2;4;265;269
8;Barcelona;40;Vallès Occidental;08279;Terrassa;6;2;B;;665;381;284;0;3;378;381
8;Barcelona;40;Vallès Occidental;08279;Terrassa;6;20;U;;581;321;260;0;2;319;321
8;Barcelona;40;Vallès Occidental;08279;Terrassa;6;21;U;;878;429;449;2;1;426;427
8;Barcelona;40;Vallès Occidental;08279;Terrassa;6;23;U;;1062;526;536;0;6;520;526
8;Barcelona;40;Vallès Occidental;08279;Terrassa;6;24;A;;811;398;413;2;2;394;396
8;Barcelona;40;Vallès Occidental;08279;Terrassa;6;24;B;;1101;480;621;0;0;480;480
8;Barcelona;40;Vallès Occidental;08279;Terrassa;6;25;A;;611;319;292;0;3;316;319
8;Barcelona;40;Vallès Occidental;08279;Terrassa;6;25;B;;898;437;461;2;0;435;435
8;Barcelona;40;Vallès Occidental;08279;Terrassa;6;26;U;;1228;610;618;8;13;589;602
8;Barcelona;40;Vallès Occidental;08279;Terrassa;6;27;A;;469;267;202;2;0;265;265
8;Barcelona;40;Vallès Occidental;08279;Terrassa;6;27;B;;587;305;282;0;1;304;305
8;Barcelona;40;Vallès Occidental;08279;Terrassa;6;28;U;;1233;620;613;1;12;607;619
8;Barcelona;40;Vallès Occidental;08279;Terrassa;6;3;A;;633;336;297;0;3;333;336
8;Barcelona;40;Vallès Occidental;08279;Terrassa;6;3;B;;912;454;458;1;8;445;453
8;Barcelona;40;Vallès Occidental;08279;Terrassa;6;4;A;;489;302;187;0;4;298;302
8;Barcelona;40;Vallès Occidental;08279;Terrassa;6;4;B;;537;292;245;0;4;288;292
8;Barcelona;40;Vallès Occidental;08279;Terrassa;6;5;U;;834;385;449;0;2;383;385
8;Barcelona;40;Vallès Occidental;08279;Terrassa;6;6;A;;919;450;469;0;7;443;450
8;Barcelona;40;Vallès Occidental;08279;Terrassa;6;6;B;;1198;560;638;4;5;551;556
8;Barcelona;40;Vallès Occidental;08279;Terrassa;6;8;A;;666;408;258;0;2;406;408
8;Barcelona;40;Vallès Occidental;08279;Terrassa;6;8;B;;888;541;347;0;6;535;541
8;Barcelona;40;Vallès Occidental;08279;Terrassa;6;9;A;;422;220;202;0;0;220;220
8;Barcelona;40;Vallès Occidental;08279;Terrassa;6;9;B;;526;248;278;1;3;244;247
8;Barcelona;21;Maresme;08282;Tiana;1;1;A;;509;368;141;0;3;365;368
8;Barcelona;21;Maresme;08282;Tiana;1;1;B;;553;392;161;0;5;387;392
8;Barcelona;21;Maresme;08282;Tiana;1;2;A;;495;361;134;1;1;359;360
8;Barcelona;21;Maresme;08282;Tiana;1;2;B;;392;279;113;1;2;276;278
8;Barcelona;21;Maresme;08282;Tiana;1;2;C;;571;399;172;1;2;396;398
8;Barcelona;21;Maresme;08282;Tiana;1;2;D;;512;369;143;1;2;366;368
8;Barcelona;21;Maresme;08282;Tiana;1;3;A;;596;423;173;0;8;415;423
8;Barcelona;21;Maresme;08282;Tiana;1;3;B;;431;294;137;0;4;290;294
8;Barcelona;21;Maresme;08282;Tiana;1;3;C;;642;457;185;1;4;452;456
8;Barcelona;21;Maresme;08282;Tiana;1;3;D;;495;365;130;0;8;357;365
25;Lleida;26;Pallars Sobirà;25221;Tírvia;1;1;U;;115;90;25;0;0;90;90
25;Lleida;23;Noguera;25222;Tiurana;1;1;U;;27;24;3;0;0;24;24
43;Tarragona;9;Baix Ebre;43149;Tivenys;1;1;U;;799;604;195;2;2;600;602
43;Tarragona;30;Ribera d'Ebre;43150;Tivissa;1;1;A;;558;445;113;3;1;441;442
43;Tarragona;30;Ribera d'Ebre;43150;Tivissa;1;1;B;;632;475;157;2;1;472;473
43;Tarragona;30;Ribera d'Ebre;43150;Tivissa;1;1;C;;245;180;65;0;0;180;180
8;Barcelona;24;Osona;08283;Tona;1;1;A;;508;362;146;0;2;360;362
8;Barcelona;24;Osona;08283;Tona;1;1;B;;671;474;197;1;5;468;473
8;Barcelona;24;Osona;08283;Tona;1;2;A;;806;582;224;4;0;578;578
8;Barcelona;24;Osona;08283;Tona;1;2;B;;858;599;259;4;5;590;595
8;Barcelona;24;Osona;08283;Tona;1;2;C;;661;476;185;1;7;468;475
8;Barcelona;24;Osona;08283;Tona;1;3;A;;798;545;253;2;4;539;543
8;Barcelona;24;Osona;08283;Tona;1;3;B;;860;630;230;3;7;620;627
25;Lleida;32;Segarra;25223;Torà;1;1;A;;402;298;104;0;3;295;298
25;Lleida;32;Segarra;25223;Torà;1;1;B;;574;420;154;3;10;407;417
8;Barcelona;21;Maresme;08284;Tordera;1;1;A;;589;394;195;2;1;391;392
8;Barcelona;21;Maresme;08284;Tordera;1;1;B;;753;540;213;4;5;531;536
8;Barcelona;21;Maresme;08284;Tordera;1;2;A;;489;291;198;2;0;289;289
8;Barcelona;21;Maresme;08284;Tordera;1;2;B;;621;379;242;1;5;373;378
8;Barcelona;21;Maresme;08284;Tordera;1;3;A;;441;278;163;0;2;276;278
8;Barcelona;21;Maresme;08284;Tordera;1;3;B;;580;400;180;9;2;389;391
8;Barcelona;21;Maresme;08284;Tordera;1;4;A;;520;336;184;1;2;333;335
8;Barcelona;21;Maresme;08284;Tordera;1;4;B;;686;454;232;1;3;450;453
8;Barcelona;21;Maresme;08284;Tordera;2;1;A;;752;442;310;0;5;437;442
8;Barcelona;21;Maresme;08284;Tordera;2;1;B;;874;535;339;0;3;532;535
8;Barcelona;21;Maresme;08284;Tordera;2;2;A;;555;302;253;1;1;300;301
8;Barcelona;21;Maresme;08284;Tordera;2;2;B;;790;395;395;1;1;393;394
8;Barcelona;21;Maresme;08284;Tordera;2;3;A;;580;257;323;0;0;257;257
8;Barcelona;21;Maresme;08284;Tordera;2;3;B;;719;357;362;0;0;357;357
8;Barcelona;24;Osona;08285;Torelló;1;1;A;;333;227;106;1;4;222;226
8;Barcelona;24;Osona;08285;Torelló;1;1;B;;386;260;126;1;0;259;259
8;Barcelona;24;Osona;08285;Torelló;1;2;A;;765;535;230;0;6;529;535
8;Barcelona;24;Osona;08285;Torelló;1;2;B;;769;551;218;0;2;549;551
8;Barcelona;24;Osona;08285;Torelló;1;4;A;;686;459;227;0;3;456;459
8;Barcelona;24;Osona;08285;Torelló;1;4;B;;714;472;242;0;4;468;472
8;Barcelona;24;Osona;08285;Torelló;2;1;A;;566;417;149;0;4;413;417
8;Barcelona;24;Osona;08285;Torelló;2;1;B;;552;406;146;1;2;403;405
8;Barcelona;24;Osona;08285;Torelló;2;2;A;;491;349;142;1;3;345;348
8;Barcelona;24;Osona;08285;Torelló;2;2;B;;491;358;133;1;3;354;357
8;Barcelona;24;Osona;08285;Torelló;3;1;A;;611;429;182;0;2;427;429
8;Barcelona;24;Osona;08285;Torelló;3;1;B;;789;544;245;2;5;537;542
8;Barcelona;24;Osona;08285;Torelló;3;2;A;;591;412;179;1;4;407;411
8;Barcelona;24;Osona;08285;Torelló;3;2;B;;716;488;228;0;3;485;488
8;Barcelona;24;Osona;08285;Torelló;3;3;A;;644;450;194;0;4;446;450
8;Barcelona;24;Osona;08285;Torelló;3;3;B;;818;605;213;0;5;600;605
25;Lleida;18;Garrigues;25224;Torms, els;1;1;U;;163;133;30;1;0;132;132
25;Lleida;38;Urgell;25225;Tornabous;1;1;U;;645;471;174;5;6;460;466
25;Lleida;33;Segrià;25226;Torrebesses;1;1;U;;258;192;66;2;4;186;190
25;Lleida;25;Pallars Jussà;25227;Torre de Cabdella, la;1;1;U;;646;426;220;2;3;421;424
8;Barcelona;6;Anoia;08286;Torre de Claramunt, la;1;1;A;;699;461;238;1;2;458;460
8;Barcelona;6;Anoia;08286;Torre de Claramunt, la;1;1;B;;791;490;301;0;5;485;490
8;Barcelona;6;Anoia;08286;Torre de Claramunt, la;1;2;U;;744;376;368;4;5;367;372
43;Tarragona;29;Priorat;43151;Torre de Fontaubella, la;1;1;U;;126;99;27;1;2;96;98
43;Tarragona;30;Ribera d'Ebre;43152;Torre de l'Espanyol, la;1;1;U;;547;456;91;5;0;451;451
43;Tarragona;36;Tarragonès;43153;Torredembarra;1;1;A;;550;341;209;0;0;341;341
43;Tarragona;36;Tarragonès;43153;Torredembarra;1;1;B;;729;439;290;0;6;433;439
43;Tarragona;36;Tarragonès;43153;Torredembarra;1;2;A;;478;272;206;0;1;271;272
43;Tarragona;36;Tarragonès;43153;Torredembarra;1;2;B;;540;306;234;1;5;300;305
43;Tarragona;36;Tarragonès;43153;Torredembarra;1;2;C;;620;381;239;0;2;379;381
43;Tarragona;36;Tarragonès;43153;Torredembarra;1;3;A;;507;300;207;3;3;294;297
43;Tarragona;36;Tarragonès;43153;Torredembarra;1;3;B;;526;293;233;3;5;285;290
43;Tarragona;36;Tarragonès;43153;Torredembarra;1;3;C;;631;377;254;5;1;371;372
43;Tarragona;36;Tarragonès;43153;Torredembarra;1;4;A;;668;430;238;2;4;424;428
43;Tarragona;36;Tarragonès;43153;Torredembarra;1;4;B;;821;509;312;2;4;503;507
43;Tarragona;36;Tarragonès;43153;Torredembarra;1;5;A;;490;287;203;1;1;285;286
43;Tarragona;36;Tarragonès;43153;Torredembarra;1;5;B;;633;359;274;3;4;352;356
43;Tarragona;36;Tarragonès;43153;Torredembarra;1;6;A;;498;297;201;1;2;294;296
43;Tarragona;36;Tarragonès;43153;Torredembarra;1;6;B;;595;336;259;2;7;327;334
43;Tarragona;36;Tarragonès;43153;Torredembarra;1;6;C;;593;324;269;0;2;322;324
25;Lleida;33;Segrià;25228;Torrefarrera;1;1;A;;850;629;221;0;4;625;629
25;Lleida;33;Segrià;25228;Torrefarrera;1;1;B;;952;675;277;3;1;671;672
25;Lleida;32;Segarra;25907;Torrefeta i Florejacs;1;1;U;;543;366;177;2;3;361;364
25;Lleida;27;Pla d'Urgell;25230;Torregrossa;1;1;U;;554;455;99;8;2;445;447
25;Lleida;27;Pla d'Urgell;25230;Torregrossa;1;2;A;;593;477;116;3;6;468;474
25;Lleida;27;Pla d'Urgell;25230;Torregrossa;1;2;B;;649;525;124;0;3;522;525
25;Lleida;23;Noguera;25231;Torrelameu;1;1;U;;496;400;96;0;4;396;400
8;Barcelona;3;Alt Penedès;08287;Torrelavit;1;1;U;;975;753;222;1;2;750;752
8;Barcelona;3;Alt Penedès;08288;Torrelles de Foix;1;1;A;;675;435;240;0;2;433;435
8;Barcelona;3;Alt Penedès;08288;Torrelles de Foix;1;1;B;;818;515;303;0;1;514;515
8;Barcelona;11;Baix Llobregat;08289;Torrelles de Llobregat;1;1;A;;632;449;183;0;3;446;449
8;Barcelona;11;Baix Llobregat;08289;Torrelles de Llobregat;1;1;B;;888;644;244;2;10;632;642
8;Barcelona;11;Baix Llobregat;08289;Torrelles de Llobregat;1;2;A;;808;436;372;0;3;433;436
8;Barcelona;11;Baix Llobregat;08289;Torrelles de Llobregat;1;2;B;;845;492;353;0;5;487;492
17;Girona;10;Baix Empordà;17197;Torrent;1;1;U;;144;102;42;0;0;102;102
25;Lleida;33;Segrià;25232;Torres de Segre;1;1;A;;720;511;209;0;6;505;511
25;Lleida;33;Segrià;25232;Torres de Segre;1;1;B;;828;569;259;1;8;560;568
25;Lleida;33;Segrià;25233;Torre-serona;1;1;U;;280;220;60;0;1;219;220
17;Girona;2;Alt Empordà;17198;Torroella de Fluvià;1;1;U;;284;209;75;2;2;205;207
17;Girona;10;Baix Empordà;17199;Torroella de Montgrí;1;1;A;;608;445;163;1;5;439;444
17;Girona;10;Baix Empordà;17199;Torroella de Montgrí;1;1;B;;521;356;165;0;1;355;356
17;Girona;10;Baix Empordà;17199;Torroella de Montgrí;1;1;C;;587;398;189;1;2;395;397
17;Girona;10;Baix Empordà;17199;Torroella de Montgrí;1;2;A;;588;399;189;2;2;395;397
17;Girona;10;Baix Empordà;17199;Torroella de Montgrí;1;2;B;;537;341;196;1;0;340;340
17;Girona;10;Baix Empordà;17199;Torroella de Montgrí;1;3;A;;615;371;244;0;3;368;371
17;Girona;10;Baix Empordà;17199;Torroella de Montgrí;1;3;B;;713;418;295;2;2;414;416
17;Girona;10;Baix Empordà;17199;Torroella de Montgrí;1;4;A;;687;489;198;0;3;486;489
17;Girona;10;Baix Empordà;17199;Torroella de Montgrí;1;4;B;;706;486;220;1;9;476;485
17;Girona;10;Baix Empordà;17199;Torroella de Montgrí;1;5;U;;714;486;228;0;6;480;486
43;Tarragona;29;Priorat;43154;Torroja del Priorat;1;1;U;;142;107;35;0;1;106;107
17;Girona;19;Garrotxa;17200;Tortellà;1;1;U;;592;462;130;2;1;459;460
43;Tarragona;9;Baix Ebre;43155;Tortosa;1;1;U;;614;362;252;7;9;346;355
43;Tarragona;9;Baix Ebre;43155;Tortosa;1;2;U;;359;221;138;3;5;213;218
43;Tarragona;9;Baix Ebre;43155;Tortosa;1;3;A;;592;394;198;7;9;378;387
43;Tarragona;9;Baix Ebre;43155;Tortosa;1;3;B;;511;342;169;6;10;326;336
43;Tarragona;9;Baix Ebre;43155;Tortosa;1;4;A;;735;475;260;0;5;470;475
43;Tarragona;9;Baix Ebre;43155;Tortosa;1;4;B;;699;462;237;4;6;452;458
43;Tarragona;9;Baix Ebre;43155;Tortosa;1;5;U;;393;169;224;5;8;156;164
43;Tarragona;9;Baix Ebre;43155;Tortosa;1;6;A;;508;321;187;6;14;301;315
43;Tarragona;9;Baix Ebre;43155;Tortosa;1;6;B;;471;288;183;2;5;281;286
43;Tarragona;9;Baix Ebre;43155;Tortosa;1;7;A;;928;606;322;0;13;593;606
43;Tarragona;9;Baix Ebre;43155;Tortosa;1;7;B;;937;608;329;5;13;590;603
43;Tarragona;9;Baix Ebre;43155;Tortosa;2;1;U;;535;228;307;0;6;222;228
43;Tarragona;9;Baix Ebre;43155;Tortosa;2;2;A;;686;456;230;1;8;447;455
43;Tarragona;9;Baix Ebre;43155;Tortosa;2;2;B;;631;422;209;1;11;410;421
43;Tarragona;9;Baix Ebre;43155;Tortosa;2;3;A;;753;478;275;11;15;452;467
43;Tarragona;9;Baix Ebre;43155;Tortosa;2;3;B;;792;490;302;6;15;469;484
43;Tarragona;9;Baix Ebre;43155;Tortosa;2;4;U;;795;445;350;3;16;426;442
43;Tarragona;9;Baix Ebre;43155;Tortosa;2;5;U;;944;658;286;6;7;645;652
43;Tarragona;9;Baix Ebre;43155;Tortosa;3;1;A;;397;185;212;0;4;181;185
43;Tarragona;9;Baix Ebre;43155;Tortosa;3;1;B;;326;148;178;1;4;143;147
43;Tarragona;9;Baix Ebre;43155;Tortosa;3;2;U;;956;652;304;9;13;630;643
43;Tarragona;9;Baix Ebre;43155;Tortosa;3;3;A;;496;262;234;1;4;257;261
43;Tarragona;9;Baix Ebre;43155;Tortosa;3;3;B;;405;214;191;1;5;208;213
43;Tarragona;9;Baix Ebre;43155;Tortosa;3;4;A;;650;378;272;1;7;370;377
43;Tarragona;9;Baix Ebre;43155;Tortosa;3;4;B;;621;364;257;2;9;353;362
43;Tarragona;9;Baix Ebre;43155;Tortosa;4;1;A;;876;535;341;1;15;519;534
43;Tarragona;9;Baix Ebre;43155;Tortosa;4;1;B;;762;469;293;3;6;460;466
43;Tarragona;9;Baix Ebre;43155;Tortosa;4;2;A;;480;315;165;1;5;309;314
43;Tarragona;9;Baix Ebre;43155;Tortosa;4;2;B;;344;242;102;1;7;234;241
43;Tarragona;9;Baix Ebre;43155;Tortosa;4;2;C;;375;236;139;1;3;232;235
43;Tarragona;9;Baix Ebre;43155;Tortosa;4;3;A;;652;353;299;2;4;347;351
43;Tarragona;9;Baix Ebre;43155;Tortosa;4;3;B;;597;301;296;0;11;290;301
43;Tarragona;9;Baix Ebre;43155;Tortosa;4;4;A;;491;276;215;0;7;269;276
43;Tarragona;9;Baix Ebre;43155;Tortosa;4;4;B;;429;243;186;1;5;237;242
43;Tarragona;9;Baix Ebre;43155;Tortosa;4;5;A;;651;410;241;1;6;403;409
43;Tarragona;9;Baix Ebre;43155;Tortosa;4;5;B;;524;336;188;1;6;329;335
43;Tarragona;9;Baix Ebre;43155;Tortosa;4;6;U;;738;459;279;4;7;448;455
43;Tarragona;9;Baix Ebre;43155;Tortosa;4;7;A;;531;380;151;0;6;374;380
43;Tarragona;9;Baix Ebre;43155;Tortosa;4;7;B;;276;175;101;0;5;170;175
43;Tarragona;9;Baix Ebre;43155;Tortosa;4;8;U;;619;413;206;5;11;397;408
17;Girona;31;Ripollès;17201;Toses;1;1;U;;127;92;35;0;0;92;92
17;Girona;34;Selva;17202;Tossa de Mar;1;1;U;;847;539;308;6;4;529;533
17;Girona;34;Selva;17202;Tossa de Mar;1;2;U;;1066;712;354;5;3;704;707
17;Girona;34;Selva;17202;Tossa de Mar;1;3;A;;812;526;286;0;1;525;526
17;Girona;34;Selva;17202;Tossa de Mar;1;3;B;;784;557;227;0;5;552;557
25;Lleida;25;Pallars Jussà;25234;Tremp;1;1;U;;752;539;213;2;12;525;537
25;Lleida;25;Pallars Jussà;25234;Tremp;1;2;U;;883;629;254;3;5;621;626
25;Lleida;25;Pallars Jussà;25234;Tremp;2;1;A;;501;354;147;0;2;352;354
25;Lleida;25;Pallars Jussà;25234;Tremp;2;1;B;;541;381;160;1;5;375;380
25;Lleida;25;Pallars Jussà;25234;Tremp;2;2;A;;562;405;157;2;4;399;403
25;Lleida;25;Pallars Jussà;25234;Tremp;2;2;B;;542;364;178;2;6;356;362
25;Lleida;25;Pallars Jussà;25234;Tremp;3;1;U;;526;280;246;1;1;278;279
17;Girona;10;Baix Empordà;17204;Ullà;1;1;A;;341;244;97;0;7;237;244
17;Girona;10;Baix Empordà;17204;Ullà;1;1;B;;272;152;120;0;0;152;152
8;Barcelona;40;Vallès Occidental;08290;Ullastrell;1;1;A;;492;358;134;1;1;356;357
8;Barcelona;40;Vallès Occidental;08290;Ullastrell;1;1;B;;597;455;142;1;2;452;454
17;Girona;10;Baix Empordà;17205;Ullastret;1;1;U;;183;141;42;0;2;139;141
43;Tarragona;22;Montsià;43156;Ulldecona;1;1;U;;893;625;268;3;10;612;622
43;Tarragona;22;Montsià;43156;Ulldecona;1;2;A;;841;600;241;4;8;588;596
43;Tarragona;22;Montsià;43156;Ulldecona;1;2;B;;935;670;265;14;2;654;656
43;Tarragona;22;Montsià;43156;Ulldecona;2;1;U;;487;360;127;4;8;348;356
43;Tarragona;22;Montsià;43156;Ulldecona;2;2;U;;550;405;145;5;7;393;400
43;Tarragona;22;Montsià;43156;Ulldecona;3;1;U;;505;335;170;0;6;329;335
43;Tarragona;29;Priorat;43157;Ulldemolins;1;1;U;;449;369;80;6;5;358;363
17;Girona;10;Baix Empordà;17203;Ultramort;1;1;U;;181;139;42;0;0;139;139
17;Girona;15;Cerdanya;17206;Urús;1;1;U;;162;119;43;2;0;117;117
8;Barcelona;40;Vallès Occidental;08291;Vacarisses;1;1;A;;743;477;266;0;4;473;477
8;Barcelona;40;Vallès Occidental;08291;Vacarisses;1;1;B;;814;437;377;2;5;430;435
8;Barcelona;40;Vallès Occidental;08291;Vacarisses;1;1;C;;745;432;313;1;4;427;431
8;Barcelona;40;Vallès Occidental;08291;Vacarisses;1;1;D;;683;404;279;0;1;403;404
17;Girona;2;Alt Empordà;17014;Vajol, la;1;1;U;;76;61;15;0;2;59;61
8;Barcelona;6;Anoia;08292;Vallbona d'Anoia;1;1;U;;916;660;256;3;2;655;657
25;Lleida;38;Urgell;25238;Vallbona de les Monges;1;1;U;;251;175;76;0;5;170;175
8;Barcelona;14;Berguedà;08293;Vallcebre;1;1;U;;247;180;67;0;1;179;180
43;Tarragona;16;Conca de Barberà;43158;Vallclara;1;1;U;;99;70;29;0;0;70;70
17;Girona;19;Garrotxa;17207;Vall d'en Bas, la;1;1;A;;890;680;210;1;4;675;679
17;Girona;19;Garrotxa;17207;Vall d'en Bas, la;1;1;B;;211;174;37;1;1;172;173
17;Girona;19;Garrotxa;17207;Vall d'en Bas, la;1;2;A;;863;654;209;8;2;644;646
17;Girona;19;Garrotxa;17207;Vall d'en Bas, la;1;2;B;;227;160;67;0;1;159;160
17;Girona;19;Garrotxa;17208;Vall de Bianya, la;1;1;A;;427;322;105;0;5;317;322
17;Girona;19;Garrotxa;17208;Vall de Bianya, la;1;1;B;;526;385;141;1;2;382;384
25;Lleida;5;Alta Ribagorça;25043;Vall de Boí, la;1;1;U;;796;476;320;1;5;470;475
25;Lleida;26;Pallars Sobirà;25901;Vall de Cardós;1;1;U;;259;195;64;1;1;193;194
25;Lleida;23;Noguera;25240;Vallfogona de Balaguer;1;1;A;;751;578;173;5;4;569;573
25;Lleida;23;Noguera;25240;Vallfogona de Balaguer;1;1;B;;526;352;174;1;3;348;351
17;Girona;31;Ripollès;17170;Vallfogona de Ripollès;1;1;U;;183;136;47;0;0;136;136
43;Tarragona;16;Conca de Barberà;43159;Vallfogona de Riucorb;1;1;U;;144;102;42;5;0;97;97
8;Barcelona;41;Vallès Oriental;08294;Vallgorguina;1;1;A;;807;581;226;0;4;577;581
8;Barcelona;41;Vallès Oriental;08294;Vallgorguina;1;1;B;;526;307;219;0;2;305;307
8;Barcelona;11;Baix Llobregat;08295;Vallirana;1;1;A;;698;429;269;0;7;422;429
8;Barcelona;11;Baix Llobregat;08295;Vallirana;1;1;B;;665;419;246;0;3;416;419
8;Barcelona;11;Baix Llobregat;08295;Vallirana;1;2;A;;510;327;183;1;5;321;326
8;Barcelona;11;Baix Llobregat;08295;Vallirana;1;2;B;;498;296;202;1;3;292;295
8;Barcelona;11;Baix Llobregat;08295;Vallirana;1;2;C;;566;361;205;0;5;356;361
8;Barcelona;11;Baix Llobregat;08295;Vallirana;1;3;A;;628;389;239;1;0;388;388
8;Barcelona;11;Baix Llobregat;08295;Vallirana;1;3;B;;569;379;190;0;2;377;379
8;Barcelona;11;Baix Llobregat;08295;Vallirana;1;4;A;;411;255;156;0;4;251;255
8;Barcelona;11;Baix Llobregat;08295;Vallirana;1;4;B;;323;209;114;1;4;204;208
8;Barcelona;11;Baix Llobregat;08295;Vallirana;1;5;A;;836;417;419;2;3;412;415
8;Barcelona;11;Baix Llobregat;08295;Vallirana;1;5;B;;723;376;347;0;4;372;376
8;Barcelona;11;Baix Llobregat;08295;Vallirana;1;6;A;;598;307;291;3;4;300;304
8;Barcelona;11;Baix Llobregat;08295;Vallirana;1;6;B;;557;310;247;4;2;304;306
8;Barcelona;11;Baix Llobregat;08295;Vallirana;1;7;A;;582;292;290;1;4;287;291
8;Barcelona;11;Baix Llobregat;08295;Vallirana;1;7;B;;560;265;295;1;2;262;264
17;Girona;10;Baix Empordà;17209;Vall-llobrega;1;1;U;;436;322;114;1;6;315;321
43;Tarragona;1;Alt Camp;43160;Vallmoll;1;1;A;;508;340;168;1;1;338;339
43;Tarragona;1;Alt Camp;43160;Vallmoll;1;1;B;;624;370;254;1;2;367;369
8;Barcelona;41;Vallès Oriental;08296;Vallromanes;1;1;A;;628;447;181;1;5;441;446
8;Barcelona;41;Vallès Oriental;08296;Vallromanes;1;1;B;;655;475;180;0;2;473;475
43;Tarragona;1;Alt Camp;43161;Valls;1;1;A;;331;208;123;2;0;206;206
43;Tarragona;1;Alt Camp;43161;Valls;1;1;B;;327;195;132;0;1;194;195
43;Tarragona;1;Alt Camp;43161;Valls;2;1;A;;300;156;144;0;1;155;156
43;Tarragona;1;Alt Camp;43161;Valls;2;1;B;;408;216;192;1;2;213;215
43;Tarragona;1;Alt Camp;43161;Valls;3;1;A;;683;478;205;0;4;474;478
43;Tarragona;1;Alt Camp;43161;Valls;3;1;B;;716;422;294;3;5;414;419
43;Tarragona;1;Alt Camp;43161;Valls;4;1;U;;936;690;246;1;5;684;689
43;Tarragona;1;Alt Camp;43161;Valls;4;2;A;;387;214;173;2;1;211;212
43;Tarragona;1;Alt Camp;43161;Valls;4;2;B;;548;315;233;1;1;313;314
43;Tarragona;1;Alt Camp;43161;Valls;4;2;C;;338;281;57;0;0;281;281
43;Tarragona;1;Alt Camp;43161;Valls;4;3;U;;969;540;429;3;4;533;537
43;Tarragona;1;Alt Camp;43161;Valls;5;1;A;;505;371;134;1;3;367;370
43;Tarragona;1;Alt Camp;43161;Valls;5;1;B;;472;305;167;1;1;303;304
43;Tarragona;1;Alt Camp;43161;Valls;5;1;C;;608;425;183;5;0;420;420
43;Tarragona;1;Alt Camp;43161;Valls;5;2;A;;544;377;167;0;1;376;377
43;Tarragona;1;Alt Camp;43161;Valls;5;2;B;;544;355;189;0;1;354;355
43;Tarragona;1;Alt Camp;43161;Valls;5;2;C;;681;466;215;1;3;462;465
43;Tarragona;1;Alt Camp;43161;Valls;5;3;U;;870;437;433;3;6;428;434
43;Tarragona;1;Alt Camp;43161;Valls;6;1;A;;778;459;319;1;10;448;458
43;Tarragona;1;Alt Camp;43161;Valls;6;1;B;;928;617;311;2;4;611;615
43;Tarragona;1;Alt Camp;43161;Valls;6;2;A;;655;449;206;0;2;447;449
43;Tarragona;1;Alt Camp;43161;Valls;6;2;B;;736;472;264;0;3;469;472
43;Tarragona;1;Alt Camp;43161;Valls;6;3;U;;758;571;187;3;3;565;568
43;Tarragona;1;Alt Camp;43161;Valls;6;4;U;;841;537;304;2;10;525;535
43;Tarragona;1;Alt Camp;43161;Valls;6;5;A;;611;358;253;1;3;354;357
43;Tarragona;1;Alt Camp;43161;Valls;6;5;B;;660;403;257;0;1;402;403
43;Tarragona;1;Alt Camp;43161;Valls;6;6;U;;814;505;309;0;3;502;505
25;Lleida;4;Alt Urgell;25906;Valls d'Aguilar, les;1;1;U;;261;167;94;0;0;167;167
25;Lleida;4;Alt Urgell;25239;Valls de Valira, les;1;1;U;;576;329;247;0;1;328;329
43;Tarragona;8;Baix Camp;43162;Vandellòs i l'Hospitalet de l'Infant;1;1;U;;870;644;226;2;2;640;642
43;Tarragona;8;Baix Camp;43162;Vandellòs i l'Hospitalet de l'Infant;1;2;A;;693;429;264;1;5;423;428
43;Tarragona;8;Baix Camp;43162;Vandellòs i l'Hospitalet de l'Infant;1;2;B;;626;369;257;1;8;360;368
43;Tarragona;8;Baix Camp;43162;Vandellòs i l'Hospitalet de l'Infant;1;3;A;;494;321;173;3;8;310;318
43;Tarragona;8;Baix Camp;43162;Vandellòs i l'Hospitalet de l'Infant;1;3;B;;515;329;186;0;2;327;329
43;Tarragona;8;Baix Camp;43162;Vandellòs i l'Hospitalet de l'Infant;1;4;U;;479;271;208;0;6;265;271
25;Lleida;4;Alt Urgell;25909;Vansa i Fórnols, la;1;1;U;;150;103;47;0;0;103;103
8;Barcelona;6;Anoia;08297;Veciana;1;1;U;;141;106;35;0;0;106;106
43;Tarragona;12;Baix Penedès;43163;Vendrell, el;1;1;A;;814;520;294;3;1;516;517
43;Tarragona;12;Baix Penedès;43163;Vendrell, el;1;1;B;;880;555;325;3;7;545;552
43;Tarragona;12;Baix Penedès;43163;Vendrell, el;1;2;U;;783;512;271;7;5;500;505
43;Tarragona;12;Baix Penedès;43163;Vendrell, el;2;1;U;;903;528;375;0;2;526;528
43;Tarragona;12;Baix Penedès;43163;Vendrell, el;2;2;A;;612;344;268;2;0;342;342
43;Tarragona;12;Baix Penedès;43163;Vendrell, el;2;2;B;;755;429;326;0;4;425;429
43;Tarragona;12;Baix Penedès;43163;Vendrell, el;2;3;A;;654;342;312;1;2;339;341
43;Tarragona;12;Baix Penedès;43163;Vendrell, el;2;3;B;;788;407;381;3;1;403;404
43;Tarragona;12;Baix Penedès;43163;Vendrell, el;2;4;U;;944;489;455;1;3;485;488
43;Tarragona;12;Baix Penedès;43163;Vendrell, el;2;5;A;;650;311;339;3;5;303;308
43;Tarragona;12;Baix Penedès;43163;Vendrell, el;2;5;B;;740;349;391;4;3;342;345
43;Tarragona;12;Baix Penedès;43163;Vendrell, el;3;1;A;;550;316;234;1;4;311;315
43;Tarragona;12;Baix Penedès;43163;Vendrell, el;3;1;B;;622;404;218;2;2;400;402
43;Tarragona;12;Baix Penedès;43163;Vendrell, el;3;2;A;;533;277;256;0;3;274;277
43;Tarragona;12;Baix Penedès;43163;Vendrell, el;3;2;B;;622;335;287;2;2;331;333
43;Tarragona;12;Baix Penedès;43163;Vendrell, el;3;3;A;;709;403;306;2;3;398;401
43;Tarragona;12;Baix Penedès;43163;Vendrell, el;3;3;B;;835;454;381;0;7;447;454
43;Tarragona;12;Baix Penedès;43163;Vendrell, el;3;4;A;;772;489;283;2;6;481;487
43;Tarragona;12;Baix Penedès;43163;Vendrell, el;3;4;B;;987;596;391;1;9;586;595
43;Tarragona;12;Baix Penedès;43163;Vendrell, el;3;5;U;;1000;634;366;2;10;622;632
43;Tarragona;12;Baix Penedès;43163;Vendrell, el;3;6;A;;614;402;212;0;6;396;402
43;Tarragona;12;Baix Penedès;43163;Vendrell, el;3;6;B;;727;463;264;0;3;460;463
43;Tarragona;12;Baix Penedès;43163;Vendrell, el;3;7;A;;728;383;345;3;3;377;380
43;Tarragona;12;Baix Penedès;43163;Vendrell, el;3;7;B;;829;444;385;1;2;441;443
43;Tarragona;12;Baix Penedès;43163;Vendrell, el;3;8;A;;664;365;299;1;4;360;364
43;Tarragona;12;Baix Penedès;43163;Vendrell, el;3;8;B;;862;526;336;3;5;518;523
43;Tarragona;12;Baix Penedès;43163;Vendrell, el;3;9;U;;609;355;254;0;2;353;355
17;Girona;2;Alt Empordà;17210;Ventalló;1;1;U;;525;361;164;2;2;357;359
25;Lleida;38;Urgell;25242;Verdú;1;1;U;;932;613;319;139;4;470;474
17;Girona;10;Baix Empordà;17211;Verges;1;1;U;;879;653;226;4;7;642;649
43;Tarragona;36;Tarragonès;43164;Vespella de Gaià;1;1;U;;191;138;53;0;3;135;138
8;Barcelona;24;Osona;08298;Vic;1;1;U;;459;330;129;0;2;328;330
8;Barcelona;24;Osona;08298;Vic;1;2;U;;556;394;162;3;3;388;391
8;Barcelona;24;Osona;08298;Vic;1;3;U;;489;384;105;0;4;380;384
8;Barcelona;24;Osona;08298;Vic;2;1;U;;637;453;184;2;4;447;451
8;Barcelona;24;Osona;08298;Vic;2;2;A;;302;235;67;1;2;232;234
8;Barcelona;24;Osona;08298;Vic;2;2;B;;214;153;61;0;2;151;153
8;Barcelona;24;Osona;08298;Vic;2;2;C;;338;258;80;1;1;256;257
8;Barcelona;24;Osona;08298;Vic;2;3;A;;615;463;152;2;3;458;461
8;Barcelona;24;Osona;08298;Vic;2;3;B;;717;550;167;1;4;545;549
8;Barcelona;24;Osona;08298;Vic;2;4;A;;821;569;252;1;12;556;568
8;Barcelona;24;Osona;08298;Vic;2;4;B;;589;348;241;0;1;347;348
8;Barcelona;24;Osona;08298;Vic;2;4;C;;847;615;232;0;4;611;615
8;Barcelona;24;Osona;08298;Vic;2;5;A;;673;493;180;4;3;486;489
8;Barcelona;24;Osona;08298;Vic;2;5;B;;812;608;204;2;5;601;606
8;Barcelona;24;Osona;08298;Vic;3;1;A;;500;408;92;0;6;402;408
8;Barcelona;24;Osona;08298;Vic;3;1;B;;506;403;103;1;0;402;402
8;Barcelona;24;Osona;08298;Vic;3;10;U;;638;487;151;0;6;481;487
8;Barcelona;24;Osona;08298;Vic;3;11;A;;478;305;173;0;0;305;305
8;Barcelona;24;Osona;08298;Vic;3;11;B;;446;282;164;2;1;279;280
8;Barcelona;24;Osona;08298;Vic;3;2;U;;595;404;191;0;4;400;404
8;Barcelona;24;Osona;08298;Vic;3;3;A;;532;379;153;0;3;376;379
8;Barcelona;24;Osona;08298;Vic;3;3;B;;406;286;120;1;1;284;285
8;Barcelona;24;Osona;08298;Vic;3;3;C;;576;421;155;2;5;414;419
8;Barcelona;24;Osona;08298;Vic;3;4;U;;808;546;262;0;3;543;546
8;Barcelona;24;Osona;08298;Vic;3;5;A;;624;421;203;1;1;419;420
8;Barcelona;24;Osona;08298;Vic;3;5;B;;705;460;245;0;0;460;460
8;Barcelona;24;Osona;08298;Vic;3;6;A;;476;328;148;3;0;325;325
8;Barcelona;24;Osona;08298;Vic;3;6;B;;540;357;183;2;1;354;355
8;Barcelona;24;Osona;08298;Vic;3;7;A;;1039;791;248;3;6;782;788
8;Barcelona;24;Osona;08298;Vic;3;7;B;;1198;932;266;1;6;925;931
8;Barcelona;24;Osona;08298;Vic;3;8;A;;695;441;254;1;5;435;440
8;Barcelona;24;Osona;08298;Vic;3;8;B;;733;460;273;0;7;453;460
8;Barcelona;24;Osona;08298;Vic;3;9;U;;696;531;165;2;4;525;529
8;Barcelona;24;Osona;08298;Vic;4;1;A;;581;423;158;0;2;421;423
8;Barcelona;24;Osona;08298;Vic;4;1;B;;629;470;159;2;6;462;468
8;Barcelona;24;Osona;08298;Vic;4;2;A;;608;439;169;2;3;434;437
8;Barcelona;24;Osona;08298;Vic;4;2;B;;778;548;230;1;4;543;547
8;Barcelona;24;Osona;08298;Vic;4;3;A;;628;405;223;0;2;403;405
8;Barcelona;24;Osona;08298;Vic;4;3;B;;481;312;169;0;3;309;312
8;Barcelona;24;Osona;08298;Vic;4;3;C;;795;550;245;0;3;547;550
8;Barcelona;24;Osona;08298;Vic;5;1;U;;564;437;127;0;4;433;437
17;Girona;24;Osona;17212;Vidrà;1;1;U;;129;105;24;0;2;103;105
17;Girona;34;Selva;17213;Vidreres;1;1;A;;701;475;226;0;3;472;475
17;Girona;34;Selva;17213;Vidreres;1;1;B;;734;489;245;0;2;487;489
17;Girona;34;Selva;17213;Vidreres;1;2;U;;872;575;297;2;0;573;573
17;Girona;34;Selva;17213;Vidreres;1;3;A;;920;507;413;0;3;504;507
17;Girona;34;Selva;17213;Vidreres;1;3;B;;1011;549;462;2;3;544;547
25;Lleida;39;Consell General d'Aran;25243;Vielha e Mijaran;1;1;A;;609;330;279;1;5;324;329
25;Lleida;39;Consell General d'Aran;25243;Vielha e Mijaran;1;1;B;;634;361;273;0;3;358;361
25;Lleida;39;Consell General d'Aran;25243;Vielha e Mijaran;1;2;A;;400;250;150;0;3;247;250
25;Lleida;39;Consell General d'Aran;25243;Vielha e Mijaran;1;2;B;;413;197;216;0;2;195;197
25;Lleida;39;Consell General d'Aran;25243;Vielha e Mijaran;1;2;C;;480;237;243;2;2;233;235
25;Lleida;39;Consell General d'Aran;25243;Vielha e Mijaran;1;3;U;;905;473;432;0;7;466;473
43;Tarragona;1;Alt Camp;43165;Vilabella;1;1;U;;630;480;150;3;1;476;477
17;Girona;2;Alt Empordà;17214;Vilabertran;1;1;U;;659;474;185;1;3;470;473
17;Girona;20;Gironès;17215;Vilablareix;1;1;A;;582;425;157;1;5;419;424
17;Girona;20;Gironès;17215;Vilablareix;1;1;B;;626;434;192;0;0;434;434
17;Girona;20;Gironès;17215;Vilablareix;1;1;C;;496;366;130;0;3;363;366
8;Barcelona;14;Berguedà;08299;Vilada;1;1;U;;465;349;116;0;5;344;349
17;Girona;2;Alt Empordà;17217;Viladamat;1;1;U;;332;268;64;0;3;265;268
17;Girona;20;Gironès;17216;Viladasens;1;1;U;;138;99;39;1;0;98;98
8;Barcelona;11;Baix Llobregat;08301;Viladecans;1;1;U;;880;505;375;3;1;501;502
8;Barcelona;11;Baix Llobregat;08301;Viladecans;1;10;A;;454;260;194;0;2;258;260
8;Barcelona;11;Baix Llobregat;08301;Viladecans;1;10;B;;590;303;287;0;2;301;303
8;Barcelona;11;Baix Llobregat;08301;Viladecans;1;11;U;;1178;727;451;7;9;711;720
8;Barcelona;11;Baix Llobregat;08301;Viladecans;1;12;U;;854;480;374;0;2;478;480
8;Barcelona;11;Baix Llobregat;08301;Viladecans;1;13;U;;941;554;387;4;10;540;550
8;Barcelona;11;Baix Llobregat;08301;Viladecans;1;14;U;;869;408;461;1;4;403;407
8;Barcelona;11;Baix Llobregat;08301;Viladecans;1;15;U;;563;303;260;2;4;297;301
8;Barcelona;11;Baix Llobregat;08301;Viladecans;1;2;A;;542;278;264;0;1;277;278
8;Barcelona;11;Baix Llobregat;08301;Viladecans;1;2;B;;651;369;282;1;2;366;368
8;Barcelona;11;Baix Llobregat;08301;Viladecans;1;3;A;;878;527;351;2;5;520;525
8;Barcelona;11;Baix Llobregat;08301;Viladecans;1;3;B;;986;628;358;1;6;621;627
8;Barcelona;11;Baix Llobregat;08301;Viladecans;1;4;A;;923;567;356;1;5;561;566
8;Barcelona;11;Baix Llobregat;08301;Viladecans;1;4;B;;955;580;375;3;4;573;577
8;Barcelona;11;Baix Llobregat;08301;Viladecans;1;5;U;;640;412;228;0;1;411;412
8;Barcelona;11;Baix Llobregat;08301;Viladecans;1;6;A;;617;341;276;0;0;341;341
8;Barcelona;11;Baix Llobregat;08301;Viladecans;1;6;B;;732;439;293;0;1;438;439
8;Barcelona;11;Baix Llobregat;08301;Viladecans;1;7;A;;538;309;229;0;3;306;309
8;Barcelona;11;Baix Llobregat;08301;Viladecans;1;7;B;;523;290;233;1;5;284;289
8;Barcelona;11;Baix Llobregat;08301;Viladecans;1;8;U;;949;556;393;1;2;553;555
8;Barcelona;11;Baix Llobregat;08301;Viladecans;1;9;U;;845;454;391;0;2;452;454
8;Barcelona;11;Baix Llobregat;08301;Viladecans;2;1;A;;488;255;233;0;0;255;255
8;Barcelona;11;Baix Llobregat;08301;Viladecans;2;1;B;;674;356;318;0;2;354;356
8;Barcelona;11;Baix Llobregat;08301;Viladecans;2;10;A;;527;277;250;0;1;276;277
8;Barcelona;11;Baix Llobregat;08301;Viladecans;2;10;B;;682;350;332;2;4;344;348
8;Barcelona;11;Baix Llobregat;08301;Viladecans;2;11;U;;806;407;399;0;3;404;407
8;Barcelona;11;Baix Llobregat;08301;Viladecans;2;12;A;;559;291;268;0;4;287;291
8;Barcelona;11;Baix Llobregat;08301;Viladecans;2;12;B;;591;303;288;2;3;298;301
8;Barcelona;11;Baix Llobregat;08301;Viladecans;2;13;A;;558;295;263;0;1;294;295
8;Barcelona;11;Baix Llobregat;08301;Viladecans;2;13;B;;663;326;337;2;1;323;324
8;Barcelona;11;Baix Llobregat;08301;Viladecans;2;14;U;;865;380;485;0;2;378;380
8;Barcelona;11;Baix Llobregat;08301;Viladecans;2;15;A;;713;344;369;0;2;342;344
8;Barcelona;11;Baix Llobregat;08301;Viladecans;2;15;B;;811;401;410;0;7;394;401
8;Barcelona;11;Baix Llobregat;08301;Viladecans;2;16;A;;559;316;243;0;4;312;316
8;Barcelona;11;Baix Llobregat;08301;Viladecans;2;16;B;;720;413;307;1;6;406;412
8;Barcelona;11;Baix Llobregat;08301;Viladecans;2;17;U;;1304;672;632;0;9;663;672
8;Barcelona;11;Baix Llobregat;08301;Viladecans;2;18;U;;843;386;457;2;3;381;384
8;Barcelona;11;Baix Llobregat;08301;Viladecans;2;19;U;;640;320;320;0;0;320;320
8;Barcelona;11;Baix Llobregat;08301;Viladecans;2;2;U;;1125;545;580;0;5;540;545
8;Barcelona;11;Baix Llobregat;08301;Viladecans;2;20;A;;547;322;225;5;2;315;317
8;Barcelona;11;Baix Llobregat;08301;Viladecans;2;20;B;;720;433;287;0;5;428;433
8;Barcelona;11;Baix Llobregat;08301;Viladecans;2;21;U;;935;446;489;0;5;441;446
8;Barcelona;11;Baix Llobregat;08301;Viladecans;2;22;U;;1111;613;498;3;2;608;610
8;Barcelona;11;Baix Llobregat;08301;Viladecans;2;23;A;;891;492;399;0;5;487;492
8;Barcelona;11;Baix Llobregat;08301;Viladecans;2;23;B;;992;568;424;0;3;565;568
8;Barcelona;11;Baix Llobregat;08301;Viladecans;2;24;U;;770;381;389;0;8;373;381
8;Barcelona;11;Baix Llobregat;08301;Viladecans;2;25;A;;549;277;272;0;2;275;277
8;Barcelona;11;Baix Llobregat;08301;Viladecans;2;25;B;;641;318;323;1;4;313;317
8;Barcelona;11;Baix Llobregat;08301;Viladecans;2;26;A;;555;341;214;2;2;337;339
8;Barcelona;11;Baix Llobregat;08301;Viladecans;2;26;B;;628;369;259;3;1;365;366
8;Barcelona;11;Baix Llobregat;08301;Viladecans;2;27;U;;828;475;353;1;3;471;474
8;Barcelona;11;Baix Llobregat;08301;Viladecans;2;28;U;;573;358;215;0;11;347;358
8;Barcelona;11;Baix Llobregat;08301;Viladecans;2;3;A;;716;413;303;1;2;410;412
8;Barcelona;11;Baix Llobregat;08301;Viladecans;2;3;B;;834;519;315;0;4;515;519
8;Barcelona;11;Baix Llobregat;08301;Viladecans;2;4;U;;896;449;447;0;6;443;449
8;Barcelona;11;Baix Llobregat;08301;Viladecans;2;5;U;;842;489;353;1;6;482;488
8;Barcelona;11;Baix Llobregat;08301;Viladecans;2;6;A;;469;233;236;2;6;225;231
8;Barcelona;11;Baix Llobregat;08301;Viladecans;2;6;B;;606;310;296;0;2;308;310
8;Barcelona;11;Baix Llobregat;08301;Viladecans;2;7;A;;457;229;228;1;0;228;228
8;Barcelona;11;Baix Llobregat;08301;Viladecans;2;7;B;;555;290;265;0;3;287;290
8;Barcelona;11;Baix Llobregat;08301;Viladecans;2;8;U;;1025;533;492;6;5;522;527
8;Barcelona;11;Baix Llobregat;08301;Viladecans;2;9;A;;538;260;278;0;0;260;260
8;Barcelona;11;Baix Llobregat;08301;Viladecans;2;9;B;;589;283;306;0;3;280;283
8;Barcelona;40;Vallès Occidental;08300;Viladecavalls;1;1;A;;560;406;154;0;0;406;406
8;Barcelona;40;Vallès Occidental;08300;Viladecavalls;1;1;B;;529;377;152;0;0;377;377
8;Barcelona;40;Vallès Occidental;08300;Viladecavalls;1;1;C;;589;389;200;0;3;386;389
8;Barcelona;40;Vallès Occidental;08300;Viladecavalls;1;1;D;;495;344;151;1;2;341;343
8;Barcelona;40;Vallès Occidental;08300;Viladecavalls;1;2;A;;577;315;262;0;3;312;315
8;Barcelona;40;Vallès Occidental;08300;Viladecavalls;1;2;B;;867;486;381;2;10;474;484
8;Barcelona;40;Vallès Occidental;08300;Viladecavalls;1;2;C;;677;382;295;0;5;377;382
8;Barcelona;40;Vallès Occidental;08300;Viladecavalls;1;3;U;;922;476;446;1;4;471;475
17;Girona;28;Pla de l'Estany;17218;Vilademuls;1;1;A;;278;205;73;1;2;202;204
17;Girona;28;Pla de l'Estany;17218;Vilademuls;1;1;B;;339;259;80;1;1;257;258
17;Girona;24;Osona;17220;Viladrau;1;1;U;;746;542;204;5;10;527;537
17;Girona;2;Alt Empordà;17221;Vilafant;1;1;A;;870;562;308;6;2;554;556
17;Girona;2;Alt Empordà;17221;Vilafant;1;1;B;;886;531;355;2;5;524;529
17;Girona;2;Alt Empordà;17221;Vilafant;1;2;A;;791;532;259;3;7;522;529
17;Girona;2;Alt Empordà;17221;Vilafant;1;2;B;;989;664;325;0;8;656;664
8;Barcelona;3;Alt Penedès;08305;Vilafranca del Penedès;1;1;A;;371;239;132;4;2;233;235
8;Barcelona;3;Alt Penedès;08305;Vilafranca del Penedès;1;1;B;;344;232;112;0;4;228;232
8;Barcelona;3;Alt Penedès;08305;Vilafranca del Penedès;1;1;C;;444;296;148;0;3;293;296
8;Barcelona;3;Alt Penedès;08305;Vilafranca del Penedès;1;1;D;;384;269;115;0;3;266;269
8;Barcelona;3;Alt Penedès;08305;Vilafranca del Penedès;1;2;A;;579;356;223;4;3;349;352
8;Barcelona;3;Alt Penedès;08305;Vilafranca del Penedès;1;2;B;;450;294;156;1;1;292;293
8;Barcelona;3;Alt Penedès;08305;Vilafranca del Penedès;1;2;C;;649;441;208;0;2;439;441
8;Barcelona;3;Alt Penedès;08305;Vilafranca del Penedès;1;2;D;;518;345;173;1;0;344;344
8;Barcelona;3;Alt Penedès;08305;Vilafranca del Penedès;2;1;A;;776;451;325;1;0;450;450
8;Barcelona;3;Alt Penedès;08305;Vilafranca del Penedès;2;1;B;;596;361;235;3;2;356;358
8;Barcelona;3;Alt Penedès;08305;Vilafranca del Penedès;2;1;C;;465;253;212;2;2;249;251
8;Barcelona;3;Alt Penedès;08305;Vilafranca del Penedès;2;2;A;;399;240;159;0;1;239;240
8;Barcelona;3;Alt Penedès;08305;Vilafranca del Penedès;2;2;B;;572;353;219;1;2;350;352
8;Barcelona;3;Alt Penedès;08305;Vilafranca del Penedès;2;3;A;;509;312;197;0;0;312;312
8;Barcelona;3;Alt Penedès;08305;Vilafranca del Penedès;2;3;B;;590;369;221;0;1;368;369
8;Barcelona;3;Alt Penedès;08305;Vilafranca del Penedès;2;4;A;;592;372;220;0;3;369;372
8;Barcelona;3;Alt Penedès;08305;Vilafranca del Penedès;2;4;B;;697;445;252;2;4;439;443
8;Barcelona;3;Alt Penedès;08305;Vilafranca del Penedès;2;5;A;;640;460;180;0;3;457;460
8;Barcelona;3;Alt Penedès;08305;Vilafranca del Penedès;2;5;B;;444;302;142;1;2;299;301
8;Barcelona;3;Alt Penedès;08305;Vilafranca del Penedès;2;5;C;;404;316;88;0;3;313;316
8;Barcelona;3;Alt Penedès;08305;Vilafranca del Penedès;2;6;A;;660;363;297;0;0;363;363
8;Barcelona;3;Alt Penedès;08305;Vilafranca del Penedès;2;6;B;;597;318;279;0;3;315;318
8;Barcelona;3;Alt Penedès;08305;Vilafranca del Penedès;2;6;C;;431;237;194;1;2;234;236
8;Barcelona;3;Alt Penedès;08305;Vilafranca del Penedès;3;1;A;;510;346;164;0;5;341;346
8;Barcelona;3;Alt Penedès;08305;Vilafranca del Penedès;3;1;B;;422;304;118;0;6;298;304
8;Barcelona;3;Alt Penedès;08305;Vilafranca del Penedès;3;1;C;;606;416;190;0;2;414;416
8;Barcelona;3;Alt Penedès;08305;Vilafranca del Penedès;3;1;D;;490;322;168;2;1;319;320
8;Barcelona;3;Alt Penedès;08305;Vilafranca del Penedès;3;2;A;;423;317;106;0;3;314;317
8;Barcelona;3;Alt Penedès;08305;Vilafranca del Penedès;3;2;B;;489;332;157;0;2;330;332
8;Barcelona;3;Alt Penedès;08305;Vilafranca del Penedès;3;3;A;;786;511;275;4;6;501;507
8;Barcelona;3;Alt Penedès;08305;Vilafranca del Penedès;3;3;B;;591;387;204;0;2;385;387
8;Barcelona;3;Alt Penedès;08305;Vilafranca del Penedès;3;3;C;;494;326;168;1;4;321;325
8;Barcelona;3;Alt Penedès;08305;Vilafranca del Penedès;4;1;A;;612;458;154;1;4;453;457
8;Barcelona;3;Alt Penedès;08305;Vilafranca del Penedès;4;1;B;;700;514;186;0;3;511;514
8;Barcelona;3;Alt Penedès;08305;Vilafranca del Penedès;4;2;A;;606;450;156;2;2;446;448
8;Barcelona;3;Alt Penedès;08305;Vilafranca del Penedès;4;2;B;;690;522;168;1;3;518;521
8;Barcelona;3;Alt Penedès;08305;Vilafranca del Penedès;4;3;A;;782;584;198;3;2;579;581
8;Barcelona;3;Alt Penedès;08305;Vilafranca del Penedès;4;3;B;;640;473;167;5;7;461;468
8;Barcelona;3;Alt Penedès;08305;Vilafranca del Penedès;4;3;C;;441;338;103;0;1;337;338
8;Barcelona;3;Alt Penedès;08305;Vilafranca del Penedès;4;4;A;;553;401;152;0;4;397;401
8;Barcelona;3;Alt Penedès;08305;Vilafranca del Penedès;4;4;B;;730;531;199;1;5;525;530
8;Barcelona;3;Alt Penedès;08305;Vilafranca del Penedès;4;5;A;;810;590;220;1;1;588;589
8;Barcelona;3;Alt Penedès;08305;Vilafranca del Penedès;4;5;B;;622;428;194;3;3;422;425
8;Barcelona;3;Alt Penedès;08305;Vilafranca del Penedès;4;5;C;;468;328;140;0;2;326;328
8;Barcelona;3;Alt Penedès;08305;Vilafranca del Penedès;4;6;A;;443;308;135;0;2;306;308
8;Barcelona;3;Alt Penedès;08305;Vilafranca del Penedès;4;6;B;;578;426;152;3;0;423;423
25;Lleida;38;Urgell;25244;Vilagrassa;1;1;U;;372;301;71;2;0;299;299
17;Girona;2;Alt Empordà;17223;Vilajuïga;1;1;U;;749;503;246;0;3;500;503
43;Tarragona;37;Terra Alta;43175;Vilalba dels Arcs;1;1;U;;638;529;109;1;5;523;528
8;Barcelona;41;Vallès Oriental;08306;Vilalba Sasserra;1;1;U;;425;304;121;2;1;301;302
25;Lleida;5;Alta Ribagorça;25245;Vilaller;1;1;U;;478;316;162;0;7;309;316
43;Tarragona;36;Tarragonès;43166;Vilallonga del Camp;1;1;U;;1057;750;307;3;8;739;747
17;Girona;31;Ripollès;17224;Vilallonga de Ter;1;1;U;;379;296;83;2;1;293;294
17;Girona;2;Alt Empordà;17225;Vilamacolum;1;1;U;;212;166;46;2;3;161;164
17;Girona;2;Alt Empordà;17226;Vilamalla;1;1;U;;763;440;323;0;3;437;440
17;Girona;2;Alt Empordà;17227;Vilamaniscle;1;1;U;;92;70;22;0;0;70;70
25;Lleida;39;Consell General d'Aran;25247;Vilamòs;1;1;U;;115;64;51;0;2;62;64
17;Girona;2;Alt Empordà;17228;Vilanant;1;1;U;;281;198;83;0;0;198;198
43;Tarragona;8;Baix Camp;43167;Vilanova d'Escornalbou;1;1;U;;360;286;74;0;0;286;286
25;Lleida;27;Pla d'Urgell;25248;Vilanova de Bellpuig;1;1;U;;975;764;211;5;4;755;759
25;Lleida;23;Noguera;25249;Vilanova de l'Aguda;1;1;U;;223;163;60;1;3;159;162
25;Lleida;33;Segrià;25254;Vilanova de la Barca;1;1;U;;752;595;157;1;4;590;594
8;Barcelona;6;Anoia;08302;Vilanova del Camí;1;1;A;;411;251;160;0;0;251;251
8;Barcelona;6;Anoia;08302;Vilanova del Camí;1;1;B;;459;272;187;0;1;271;272
8;Barcelona;6;Anoia;08302;Vilanova del Camí;1;1;C;;374;239;135;0;3;236;239
8;Barcelona;6;Anoia;08302;Vilanova del Camí;1;2;A;;531;287;244;0;2;285;287
8;Barcelona;6;Anoia;08302;Vilanova del Camí;1;2;B;;602;343;259;0;2;341;343
8;Barcelona;6;Anoia;08302;Vilanova del Camí;1;2;C;;512;270;242;0;5;265;270
8;Barcelona;6;Anoia;08302;Vilanova del Camí;1;3;A;;530;295;235;1;4;290;294
8;Barcelona;6;Anoia;08302;Vilanova del Camí;1;3;B;;619;335;284;0;5;330;335
8;Barcelona;6;Anoia;08302;Vilanova del Camí;1;3;C;;601;352;249;0;4;348;352
8;Barcelona;6;Anoia;08302;Vilanova del Camí;1;4;A;;663;391;272;0;4;387;391
8;Barcelona;6;Anoia;08302;Vilanova del Camí;1;4;B;;688;383;305;1;2;380;382
8;Barcelona;6;Anoia;08302;Vilanova del Camí;1;4;C;;627;342;285;1;1;340;341
8;Barcelona;6;Anoia;08302;Vilanova del Camí;1;5;A;;588;321;267;0;1;320;321
8;Barcelona;6;Anoia;08302;Vilanova del Camí;1;5;B;;755;422;333;6;3;413;416
8;Barcelona;6;Anoia;08302;Vilanova del Camí;1;5;C;;505;283;222;1;2;280;282
8;Barcelona;41;Vallès Oriental;08902;Vilanova del Vallès;1;1;A;;700;473;227;0;1;472;473
8;Barcelona;41;Vallès Oriental;08902;Vilanova del Vallès;1;1;B;;764;465;299;0;3;462;465
8;Barcelona;41;Vallès Oriental;08902;Vilanova del Vallès;1;1;C;;793;514;279;0;3;511;514
25;Lleida;23;Noguera;25250;Vilanova de Meià;1;1;U;;379;268;111;2;1;265;266
43;Tarragona;16;Conca de Barberà;43168;Vilanova de Prades;1;1;U;;134;92;42;0;0;92;92
8;Barcelona;24;Osona;08303;Vilanova de Sau;1;1;U;;292;216;76;2;1;213;214
25;Lleida;33;Segrià;25251;Vilanova de Segrià;1;1;U;;646;444;202;0;1;443;444
8;Barcelona;17;Garraf;08307;Vilanova i la Geltrú;1;1;A;;853;580;273;3;4;573;577
8;Barcelona;17;Garraf;08307;Vilanova i la Geltrú;1;1;B;;999;634;365;0;5;629;634
8;Barcelona;17;Garraf;08307;Vilanova i la Geltrú;1;2;A;;698;478;220;1;5;472;477
8;Barcelona;17;Garraf;08307;Vilanova i la Geltrú;1;2;B;;718;499;219;2;3;494;497
8;Barcelona;17;Garraf;08307;Vilanova i la Geltrú;1;2;C;;687;479;208;1;0;478;478
8;Barcelona;17;Garraf;08307;Vilanova i la Geltrú;1;3;A;;790;533;257;0;4;529;533
8;Barcelona;17;Garraf;08307;Vilanova i la Geltrú;1;3;B;;928;619;309;1;1;617;618
8;Barcelona;17;Garraf;08307;Vilanova i la Geltrú;1;4;U;;724;505;219;3;8;494;502
8;Barcelona;17;Garraf;08307;Vilanova i la Geltrú;1;5;U;;695;474;221;2;3;469;472
8;Barcelona;17;Garraf;08307;Vilanova i la Geltrú;1;6;A;;585;410;175;0;2;408;410
8;Barcelona;17;Garraf;08307;Vilanova i la Geltrú;1;6;B;;661;439;222;2;1;436;437
8;Barcelona;17;Garraf;08307;Vilanova i la Geltrú;1;7;A;;551;327;224;1;2;324;326
8;Barcelona;17;Garraf;08307;Vilanova i la Geltrú;1;7;B;;644;396;248;1;4;391;395
8;Barcelona;17;Garraf;08307;Vilanova i la Geltrú;1;8;A;;887;577;310;1;11;565;576
8;Barcelona;17;Garraf;08307;Vilanova i la Geltrú;1;8;B;;1053;637;416;0;6;631;637
8;Barcelona;17;Garraf;08307;Vilanova i la Geltrú;1;9;A;;640;372;268;2;3;367;370
8;Barcelona;17;Garraf;08307;Vilanova i la Geltrú;1;9;B;;803;478;325;1;1;476;477
8;Barcelona;17;Garraf;08307;Vilanova i la Geltrú;1;9;C;;648;405;243;2;7;396;403
8;Barcelona;17;Garraf;08307;Vilanova i la Geltrú;2;1;A;;813;548;265;0;7;541;548
8;Barcelona;17;Garraf;08307;Vilanova i la Geltrú;2;1;B;;900;618;282;0;6;612;618
8;Barcelona;17;Garraf;08307;Vilanova i la Geltrú;2;2;A;;805;553;252;0;5;548;553
8;Barcelona;17;Garraf;08307;Vilanova i la Geltrú;2;2;B;;940;602;338;0;4;598;602
8;Barcelona;17;Garraf;08307;Vilanova i la Geltrú;2;3;U;;868;577;291;4;8;565;573
8;Barcelona;17;Garraf;08307;Vilanova i la Geltrú;2;4;A;;747;493;254;0;4;489;493
8;Barcelona;17;Garraf;08307;Vilanova i la Geltrú;2;4;B;;823;538;285;0;7;531;538
8;Barcelona;17;Garraf;08307;Vilanova i la Geltrú;2;5;U;;515;284;231;1;0;283;283
8;Barcelona;17;Garraf;08307;Vilanova i la Geltrú;2;6;A;;626;399;227;1;5;393;398
8;Barcelona;17;Garraf;08307;Vilanova i la Geltrú;2;6;B;;689;414;275;2;4;408;412
8;Barcelona;17;Garraf;08307;Vilanova i la Geltrú;2;7;A;;795;494;301;1;8;485;493
8;Barcelona;17;Garraf;08307;Vilanova i la Geltrú;2;7;B;;850;490;360;0;4;486;490
8;Barcelona;17;Garraf;08307;Vilanova i la Geltrú;3;1;U;;517;305;212;0;1;304;305
8;Barcelona;17;Garraf;08307;Vilanova i la Geltrú;3;2;U;;786;529;257;1;10;518;528
8;Barcelona;17;Garraf;08307;Vilanova i la Geltrú;3;3;U;;808;521;287;3;2;516;518
8;Barcelona;17;Garraf;08307;Vilanova i la Geltrú;3;4;A;;799;443;356;0;4;439;443
8;Barcelona;17;Garraf;08307;Vilanova i la Geltrú;3;4;B;;951;481;470;0;5;476;481
8;Barcelona;17;Garraf;08307;Vilanova i la Geltrú;3;5;U;;1006;518;488;0;4;514;518
8;Barcelona;17;Garraf;08307;Vilanova i la Geltrú;4;1;U;;842;577;265;2;5;570;575
8;Barcelona;17;Garraf;08307;Vilanova i la Geltrú;4;10;A;;725;448;277;0;4;444;448
8;Barcelona;17;Garraf;08307;Vilanova i la Geltrú;4;10;B;;880;549;331;2;6;541;547
8;Barcelona;17;Garraf;08307;Vilanova i la Geltrú;4;11;A;;670;356;314;1;1;354;355
8;Barcelona;17;Garraf;08307;Vilanova i la Geltrú;4;11;B;;857;498;359;1;6;491;497
8;Barcelona;17;Garraf;08307;Vilanova i la Geltrú;4;12;U;;1175;736;439;0;5;731;736
8;Barcelona;17;Garraf;08307;Vilanova i la Geltrú;4;13;U;;782;500;282;1;3;496;499
8;Barcelona;17;Garraf;08307;Vilanova i la Geltrú;4;14;U;;1094;656;438;0;2;654;656
8;Barcelona;17;Garraf;08307;Vilanova i la Geltrú;4;2;U;;527;351;176;0;6;345;351
8;Barcelona;17;Garraf;08307;Vilanova i la Geltrú;4;3;A;;969;528;441;2;6;520;526
8;Barcelona;17;Garraf;08307;Vilanova i la Geltrú;4;3;B;;1075;560;515;1;3;556;559
8;Barcelona;17;Garraf;08307;Vilanova i la Geltrú;4;4;A;;594;371;223;0;6;365;371
8;Barcelona;17;Garraf;08307;Vilanova i la Geltrú;4;4;B;;756;465;291;2;2;461;463
8;Barcelona;17;Garraf;08307;Vilanova i la Geltrú;4;5;A;;654;420;234;1;5;414;419
8;Barcelona;17;Garraf;08307;Vilanova i la Geltrú;4;5;B;;773;472;301;4;2;466;468
8;Barcelona;17;Garraf;08307;Vilanova i la Geltrú;4;6;A;;651;431;220;1;12;418;430
8;Barcelona;17;Garraf;08307;Vilanova i la Geltrú;4;6;B;;798;504;294;2;10;492;502
8;Barcelona;17;Garraf;08307;Vilanova i la Geltrú;4;7;A;;809;422;387;1;2;419;421
8;Barcelona;17;Garraf;08307;Vilanova i la Geltrú;4;7;B;;882;423;459;1;6;416;422
8;Barcelona;17;Garraf;08307;Vilanova i la Geltrú;4;8;U;;758;422;336;0;4;418;422
8;Barcelona;17;Garraf;08307;Vilanova i la Geltrú;4;9;U;;961;618;343;1;5;612;617
43;Tarragona;8;Baix Camp;43169;Vilaplana;1;1;U;;455;379;76;2;2;375;377
43;Tarragona;1;Alt Camp;43170;Vila-rodona;1;1;U;;837;592;245;3;6;583;589
17;Girona;2;Alt Empordà;17230;Vila-sacra;1;1;U;;365;266;99;1;5;260;265
25;Lleida;27;Pla d'Urgell;25252;Vila-sana;1;1;U;;450;313;137;2;4;307;311
43;Tarragona;36;Tarragonès;43171;Vila-seca;1;1;A;;827;549;278;1;2;546;548
43;Tarragona;36;Tarragonès;43171;Vila-seca;1;1;B;;415;269;146;1;0;268;268
43;Tarragona;36;Tarragonès;43171;Vila-seca;1;10;U;;857;456;401;3;9;444;453
43;Tarragona;36;Tarragonès;43171;Vila-seca;1;2;A;;742;408;334;0;5;403;408
43;Tarragona;36;Tarragonès;43171;Vila-seca;1;2;B;;996;587;409;0;9;578;587
43;Tarragona;36;Tarragonès;43171;Vila-seca;1;3;A;;410;231;179;0;0;231;231
43;Tarragona;36;Tarragonès;43171;Vila-seca;1;3;B;;556;305;251;3;4;298;302
43;Tarragona;36;Tarragonès;43171;Vila-seca;1;4;A;;308;219;89;3;0;216;216
43;Tarragona;36;Tarragonès;43171;Vila-seca;1;4;B;;364;253;111;1;0;252;252
43;Tarragona;36;Tarragonès;43171;Vila-seca;1;5;A;;572;350;222;3;5;342;347
43;Tarragona;36;Tarragonès;43171;Vila-seca;1;5;B;;615;381;234;6;3;372;375
43;Tarragona;36;Tarragonès;43171;Vila-seca;1;6;A;;546;332;214;0;2;330;332
43;Tarragona;36;Tarragonès;43171;Vila-seca;1;6;B;;674;390;284;2;3;385;388
43;Tarragona;36;Tarragonès;43171;Vila-seca;1;7;U;;809;432;377;1;8;423;431
43;Tarragona;36;Tarragonès;43171;Vila-seca;1;8;A;;574;240;334;2;1;237;238
43;Tarragona;36;Tarragonès;43171;Vila-seca;1;8;B;;611;263;348;1;0;262;262
43;Tarragona;36;Tarragonès;43171;Vila-seca;1;9;A;;548;305;243;0;2;303;305
43;Tarragona;36;Tarragonès;43171;Vila-seca;1;9;B;;729;431;298;1;4;426;430
8;Barcelona;21;Maresme;08214;Vilassar de Dalt;1;1;A;;519;355;164;1;7;347;354
8;Barcelona;21;Maresme;08214;Vilassar de Dalt;1;1;B;;514;384;130;0;6;378;384
8;Barcelona;21;Maresme;08214;Vilassar de Dalt;1;2;U;;782;521;261;0;4;517;521
8;Barcelona;21;Maresme;08214;Vilassar de Dalt;1;3;A;;511;317;194;3;0;314;314
8;Barcelona;21;Maresme;08214;Vilassar de Dalt;1;3;B;;552;336;216;0;1;335;336
8;Barcelona;21;Maresme;08214;Vilassar de Dalt;1;4;A;;501;369;132;0;3;366;369
8;Barcelona;21;Maresme;08214;Vilassar de Dalt;1;4;B;;567;400;167;0;1;399;400
8;Barcelona;21;Maresme;08214;Vilassar de Dalt;2;1;A;;668;493;175;1;1;491;492
8;Barcelona;21;Maresme;08214;Vilassar de Dalt;2;1;B;;857;614;243;4;4;606;610
8;Barcelona;21;Maresme;08214;Vilassar de Dalt;2;2;A;;514;323;191;0;4;319;323
8;Barcelona;21;Maresme;08214;Vilassar de Dalt;2;2;B;;531;363;168;0;3;360;363
8;Barcelona;21;Maresme;08219;Vilassar de Mar;1;1;U;;762;549;213;2;3;544;547
8;Barcelona;21;Maresme;08219;Vilassar de Mar;1;2;A;;553;381;172;0;5;376;381
8;Barcelona;21;Maresme;08219;Vilassar de Mar;1;2;B;;801;594;207;0;10;584;594
8;Barcelona;21;Maresme;08219;Vilassar de Mar;1;3;A;;650;426;224;1;9;416;425
8;Barcelona;21;Maresme;08219;Vilassar de Mar;1;3;B;;790;489;301;0;11;478;489
8;Barcelona;21;Maresme;08219;Vilassar de Mar;1;4;U;;930;649;281;0;7;642;649
8;Barcelona;21;Maresme;08219;Vilassar de Mar;1;5;A;;492;340;152;0;0;340;340
8;Barcelona;21;Maresme;08219;Vilassar de Mar;1;5;B;;552;371;181;0;4;367;371
8;Barcelona;21;Maresme;08219;Vilassar de Mar;1;6;A;;473;343;130;1;1;341;342
8;Barcelona;21;Maresme;08219;Vilassar de Mar;1;6;B;;516;334;182;2;3;329;332
8;Barcelona;21;Maresme;08219;Vilassar de Mar;2;1;U;;803;580;223;0;3;577;580
8;Barcelona;21;Maresme;08219;Vilassar de Mar;2;2;U;;831;629;202;1;7;621;628
8;Barcelona;21;Maresme;08219;Vilassar de Mar;2;3;U;;900;608;292;0;1;607;608
8;Barcelona;21;Maresme;08219;Vilassar de Mar;2;4;U;;872;619;253;2;6;611;617
8;Barcelona;21;Maresme;08219;Vilassar de Mar;2;5;U;;908;700;208;0;6;694;700
8;Barcelona;21;Maresme;08219;Vilassar de Mar;3;1;A;;470;335;135;0;5;330;335
8;Barcelona;21;Maresme;08219;Vilassar de Mar;3;1;B;;575;394;181;2;5;387;392
8;Barcelona;21;Maresme;08219;Vilassar de Mar;3;2;U;;849;587;262;2;9;576;585
8;Barcelona;21;Maresme;08219;Vilassar de Mar;3;3;U;;776;488;288;0;7;481;488
8;Barcelona;21;Maresme;08219;Vilassar de Mar;3;4;U;;777;473;304;2;4;467;471
17;Girona;2;Alt Empordà;17222;Vilaür;1;1;U;;108;74;34;0;0;74;74
43;Tarragona;16;Conca de Barberà;43172;Vilaverd;1;1;U;;344;280;64;1;0;279;279
43;Tarragona;29;Priorat;43173;Vilella Alta, la;1;1;U;;109;87;22;1;0;86;86
43;Tarragona;29;Priorat;43174;Vilella Baixa, la;1;1;U;;150;116;34;0;0;116;116
17;Girona;34;Selva;17233;Vilobí d'Onyar;1;1;U;;629;464;165;2;3;459;462
17;Girona;34;Selva;17233;Vilobí d'Onyar;1;2;A;;640;458;182;1;7;450;457
17;Girona;34;Selva;17233;Vilobí d'Onyar;1;2;B;;645;481;164;1;4;476;480
8;Barcelona;3;Alt Penedès;08304;Vilobí del Penedès;1;1;U;;789;613;176;3;4;606;610
17;Girona;10;Baix Empordà;17232;Vilopriu;1;1;U;;143;102;41;0;1;101;102
25;Lleida;18;Garrigues;25253;Vilosell, el;1;1;U;;214;169;45;0;3;166;169
43;Tarragona;16;Conca de Barberà;43176;Vimbodí i Poblet;1;1;U;;904;676;228;4;5;667;672
25;Lleida;18;Garrigues;25255;Vinaixa;1;1;U;;523;390;133;1;3;386;389
43;Tarragona;30;Ribera d'Ebre;43177;Vinebre;1;1;U;;388;305;83;7;5;293;298
43;Tarragona;8;Baix Camp;43178;Vinyols i els Arcs;1;1;A;;696;486;210;2;4;480;484
43;Tarragona;8;Baix Camp;43178;Vinyols i els Arcs;1;1;B;;345;225;120;0;0;225;225
8;Barcelona;14;Berguedà;08308;Viver i Serrateix;1;1;U;;172;134;38;0;1;133;134
43;Tarragona;9;Baix Ebre;43052;Xerta;1;1;U;;1021;793;228;9;11;773;784
8;Barcelona;98;Residents Absents;08998;Residents Absents;1;1;U;;75401;13571;61830;52;39;13480;13519
17;Girona;98;Residents Absents;17998;Residents Absents;1;1;U;;7115;1481;5634;2;7;1472;1479
25;Lleida;98;Residents Absents;25998;Residents Absents;1;1;U;;10159;2128;8031;1;6;2121;2127
43;Tarragona;98;Residents Absents;43998;Residents Absents;1;1;U;;7742;1459;6283;2;0;1457;1457
