﻿Codi Província;Nom Província;Codi Comarca;Nom Comarca;Codi Municipi;Nom Municipi;Districte;Secció;Mesa;Població;Cens;Participació 13:00;Participació 18:00;Participació 20:00;Abstenció;Vots nuls;Vots en blanc;Vots a candidatures;Vots vàlids
25;Lleida;25;Pallars Jussà;25001;Abella de la Conca;1;1;U;;145;26;57;88;57;3;2;83;85
8;Barcelona;11;Baix Llobregat;08001;Abrera;1;1;A;;371;108;190;231;140;1;6;224;230
8;Barcelona;11;Baix Llobregat;08001;Abrera;1;1;B;;394;103;188;246;148;3;7;236;243
8;Barcelona;11;Baix Llobregat;08001;Abrera;1;1;C;;409;112;211;244;165;4;6;234;240
8;Barcelona;11;Baix Llobregat;08001;Abrera;1;2;A;;399;116;195;242;157;1;18;223;241
8;Barcelona;11;Baix Llobregat;08001;Abrera;1;2;B;;457;109;216;267;190;4;8;255;263
8;Barcelona;11;Baix Llobregat;08001;Abrera;1;2;C;;449;112;205;249;200;0;4;245;249
8;Barcelona;11;Baix Llobregat;08001;Abrera;1;3;U;;544;162;273;349;195;3;7;339;346
8;Barcelona;11;Baix Llobregat;08001;Abrera;1;4;A;;740;180;359;464;276;2;26;436;462
8;Barcelona;11;Baix Llobregat;08001;Abrera;1;4;B;;477;124;227;292;185;1;7;284;291
8;Barcelona;11;Baix Llobregat;08001;Abrera;1;5;A;;650;158;266;346;304;0;7;339;346
8;Barcelona;11;Baix Llobregat;08001;Abrera;1;5;B;;718;202;348;425;293;3;11;411;422
8;Barcelona;11;Baix Llobregat;08001;Abrera;1;7;A;;518;126;230;293;225;2;5;286;291
8;Barcelona;11;Baix Llobregat;08001;Abrera;1;7;B;;589;122;246;307;282;0;9;298;307
8;Barcelona;11;Baix Llobregat;08001;Abrera;1;7;C;;660;3;288;359;301;5;12;342;354
8;Barcelona;11;Baix Llobregat;08001;Abrera;1;8;A;;460;109;230;296;164;2;6;288;294
8;Barcelona;11;Baix Llobregat;08001;Abrera;1;8;B;;535;128;268;332;203;3;16;313;329
25;Lleida;23;Noguera;25002;Àger;1;1;U;;464;130;230;305;159;6;9;290;299
25;Lleida;38;Urgell;25003;Agramunt;1;1;U;;623;135;261;362;261;3;10;349;359
25;Lleida;38;Urgell;25003;Agramunt;1;2;U;;738;168;323;441;297;5;20;416;436
25;Lleida;38;Urgell;25003;Agramunt;1;3;A;;617;126;258;345;272;4;20;321;341
25;Lleida;38;Urgell;25003;Agramunt;1;3;B;;699;167;320;422;277;1;17;404;421
25;Lleida;38;Urgell;25003;Agramunt;1;4;A;;571;126;243;313;258;6;5;302;307
25;Lleida;38;Urgell;25003;Agramunt;1;4;B;;610;137;288;367;243;2;21;344;365
8;Barcelona;7;Bages;08002;Aguilar de Segarra;1;1;U;;203;76;123;147;56;2;1;144;145
17;Girona;2;Alt Empordà;17001;Agullana;1;1;U;;564;180;329;379;185;3;17;359;376
8;Barcelona;41;Vallès Oriental;08014;Aiguafreda;1;1;A;;887;244;499;610;277;7;17;586;603
8;Barcelona;41;Vallès Oriental;08014;Aiguafreda;1;1;B;;1008;290;595;723;285;7;28;688;716
43;Tarragona;1;Alt Camp;43001;Aiguamúrcia;1;1;A;;292;66;156;200;92;2;6;192;198
43;Tarragona;1;Alt Camp;43001;Aiguamúrcia;1;1;B;;423;84;163;237;186;1;15;221;236
17;Girona;20;Gironès;17002;Aiguaviva;1;1;U;;539;136;327;406;133;7;7;392;399
25;Lleida;33;Segrià;25038;Aitona;1;1;U;;776;185;405;518;258;3;14;501;515
25;Lleida;33;Segrià;25038;Aitona;1;2;U;;839;175;433;548;291;6;10;532;542
25;Lleida;33;Segrià;25004;Alamús, els;1;1;U;;570;170;333;408;162;3;12;393;405
25;Lleida;4;Alt Urgell;25005;Alàs i Cerc;1;1;U;;298;80;162;199;99;3;7;189;196
25;Lleida;18;Garrigues;25006;Albagés, l';1;1;U;;385;86;208;248;137;0;4;244;248
17;Girona;2;Alt Empordà;17003;Albanyà;1;1;U;;100;38;55;69;31;0;3;66;69
25;Lleida;33;Segrià;25007;Albatàrrec;1;1;A;;713;177;350;444;269;4;19;421;440
25;Lleida;33;Segrià;25007;Albatàrrec;1;1;B;;622;110;286;366;256;1;11;354;365
25;Lleida;23;Noguera;25008;Albesa;1;1;A;;600;126;330;421;179;5;13;403;416
25;Lleida;23;Noguera;25008;Albesa;1;1;B;;594;134;341;419;175;5;8;406;414
25;Lleida;18;Garrigues;25009;Albi, l';1;1;U;;689;154;350;475;214;2;17;456;473
43;Tarragona;12;Baix Penedès;43002;Albinyana;1;1;A;;514;175;311;359;155;4;12;343;355
43;Tarragona;12;Baix Penedès;43002;Albinyana;1;1;B;;429;122;180;226;203;2;5;219;224
43;Tarragona;12;Baix Penedès;43002;Albinyana;1;1;C;;424;130;196;236;188;4;5;227;232
43;Tarragona;12;Baix Penedès;43002;Albinyana;1;1;D;;384;91;223;270;114;0;7;263;270
43;Tarragona;8;Baix Camp;43003;Albiol, l';1;1;U;;298;89;149;188;110;5;13;170;183
17;Girona;10;Baix Empordà;17004;Albons;1;1;U;;506;173;285;343;163;2;14;327;341
43;Tarragona;22;Montsià;43004;Alcanar;1;1;A;;527;129;232;293;234;6;11;276;287
43;Tarragona;22;Montsià;43004;Alcanar;1;1;B;;622;159;306;370;252;10;6;354;360
43;Tarragona;22;Montsià;43004;Alcanar;1;2;A;;579;153;281;351;228;8;10;333;343
43;Tarragona;22;Montsià;43004;Alcanar;1;2;B;;641;169;310;397;244;10;13;374;387
43;Tarragona;22;Montsià;43004;Alcanar;1;3;A;;750;202;337;406;344;9;11;386;397
43;Tarragona;22;Montsià;43004;Alcanar;1;3;B;;701;167;298;353;348;2;14;337;351
43;Tarragona;22;Montsià;43004;Alcanar;1;4;A;;480;109;239;305;175;10;14;281;295
43;Tarragona;22;Montsià;43004;Alcanar;1;4;B;;510;129;260;321;189;7;6;308;314
43;Tarragona;22;Montsià;43004;Alcanar;2;1;A;;480;98;190;245;235;2;8;235;243
43;Tarragona;22;Montsià;43004;Alcanar;2;1;B;;530;116;226;293;237;3;12;278;290
43;Tarragona;22;Montsià;43004;Alcanar;2;2;U;;577;158;278;335;242;4;17;314;331
25;Lleida;33;Segrià;25010;Alcanó;1;1;U;;203;30;81;121;82;1;5;115;120
25;Lleida;33;Segrià;25011;Alcarràs;1;1;A;;809;150;366;482;327;4;11;467;478
25;Lleida;33;Segrià;25011;Alcarràs;1;1;B;;740;156;337;456;284;3;12;441;453
25;Lleida;33;Segrià;25011;Alcarràs;1;2;A;;705;120;263;354;351;1;19;334;353
25;Lleida;33;Segrià;25011;Alcarràs;1;2;B;;731;124;284;389;342;0;11;378;389
25;Lleida;33;Segrià;25011;Alcarràs;1;3;U;;901;137;295;476;425;5;15;456;471
25;Lleida;33;Segrià;25011;Alcarràs;1;4;A;;662;141;271;391;271;0;10;381;391
25;Lleida;33;Segrià;25011;Alcarràs;1;4;B;;590;166;354;355;235;0;8;347;355
25;Lleida;33;Segrià;25012;Alcoletge;1;1;A;;1075;242;489;611;464;5;21;585;606
25;Lleida;33;Segrià;25012;Alcoletge;1;1;B;;1014;238;510;604;410;0;15;589;604
43;Tarragona;1;Alt Camp;43005;Alcover;1;1;A;;907;189;409;507;400;8;18;481;499
43;Tarragona;1;Alt Camp;43005;Alcover;1;1;B;;1017;205;450;565;452;2;16;547;563
43;Tarragona;1;Alt Camp;43005;Alcover;2;1;A;;815;154;327;429;386;4;9;416;425
43;Tarragona;1;Alt Camp;43005;Alcover;2;1;B;;792;180;333;415;377;4;9;402;411
43;Tarragona;9;Baix Ebre;43904;Aldea, l';1;1;A;;849;225;425;500;349;15;9;476;485
43;Tarragona;9;Baix Ebre;43904;Aldea, l';1;1;B;;768;174;310;416;352;7;19;390;409
43;Tarragona;9;Baix Ebre;43904;Aldea, l';1;2;A;;740;187;331;427;313;3;22;402;424
43;Tarragona;9;Baix Ebre;43904;Aldea, l';1;2;B;;539;139;253;312;227;0;16;296;312
43;Tarragona;9;Baix Ebre;43006;Aldover;1;1;U;;712;138;345;440;272;5;25;410;435
43;Tarragona;8;Baix Camp;43007;Aleixar, l';1;1;U;;649;148;378;458;191;1;2;455;457
8;Barcelona;21;Maresme;08003;Alella;1;1;A;;858;223;492;593;265;11;19;563;582
8;Barcelona;21;Maresme;08003;Alella;1;1;B;;963;250;513;664;299;2;18;644;662
8;Barcelona;21;Maresme;08003;Alella;1;2;A;;801;210;426;543;258;4;12;527;539
8;Barcelona;21;Maresme;08003;Alella;1;2;B;;1011;254;534;657;354;4;11;642;653
8;Barcelona;21;Maresme;08003;Alella;1;3;A;;818;225;461;585;233;8;17;560;577
8;Barcelona;21;Maresme;08003;Alella;1;3;B;;942;271;555;671;271;2;22;647;669
8;Barcelona;21;Maresme;08003;Alella;1;4;A;;744;206;427;520;224;3;12;505;517
8;Barcelona;21;Maresme;08003;Alella;1;4;B;;854;213;447;579;275;3;14;562;576
43;Tarragona;9;Baix Ebre;43008;Alfara de Carles;1;1;U;;326;77;184;222;104;3;13;206;219
25;Lleida;33;Segrià;25013;Alfarràs;1;1;A;;580;128;278;363;217;3;13;347;360
25;Lleida;33;Segrià;25013;Alfarràs;1;1;B;;656;161;321;402;254;4;15;383;398
25;Lleida;33;Segrià;25013;Alfarràs;1;2;A;;472;92;184;250;222;0;9;241;250
25;Lleida;33;Segrià;25013;Alfarràs;1;2;B;;586;111;224;287;299;0;6;281;287
25;Lleida;33;Segrià;25014;Alfés;1;1;U;;271;61;125;180;91;0;8;172;180
43;Tarragona;8;Baix Camp;43009;Alforja;1;1;A;;661;202;341;418;243;5;14;399;413
43;Tarragona;8;Baix Camp;43009;Alforja;1;1;B;;755;191;368;445;310;1;14;430;444
25;Lleida;23;Noguera;25015;Algerri;1;1;U;;406;103;222;273;133;0;18;255;273
25;Lleida;33;Segrià;25016;Alguaire;1;1;A;;528;120;253;322;206;2;6;314;320
25;Lleida;33;Segrià;25016;Alguaire;1;1;B;;594;134;254;340;254;5;11;324;335
25;Lleida;33;Segrià;25016;Alguaire;1;2;A;;535;97;238;324;211;1;11;312;323
25;Lleida;33;Segrià;25016;Alguaire;1;2;B;;582;143;286;355;227;0;16;339;355
25;Lleida;26;Pallars Sobirà;25017;Alins;1;1;U;;254;58;133;178;76;1;2;175;177
43;Tarragona;1;Alt Camp;43010;Alió;1;1;U;;297;71;179;214;83;1;14;199;213
25;Lleida;33;Segrià;25019;Almacelles;1;1;U;;836;207;387;522;314;5;9;508;517
25;Lleida;33;Segrià;25019;Almacelles;1;2;A;;606;127;255;350;256;0;8;342;350
25;Lleida;33;Segrià;25019;Almacelles;1;2;B;;734;153;317;401;333;1;14;386;400
25;Lleida;33;Segrià;25019;Almacelles;2;1;A;;459;103;203;269;190;0;11;258;269
25;Lleida;33;Segrià;25019;Almacelles;2;1;B;;570;112;238;300;270;1;8;291;299
25;Lleida;33;Segrià;25019;Almacelles;2;2;A;;646;142;295;360;286;0;17;343;360
25;Lleida;33;Segrià;25019;Almacelles;2;2;B;;762;158;314;409;353;5;22;382;404
25;Lleida;33;Segrià;25020;Almatret;1;1;U;;345;86;177;212;133;4;6;202;208
25;Lleida;33;Segrià;25021;Almenar;1;1;U;;656;126;255;327;329;2;11;314;325
25;Lleida;33;Segrià;25021;Almenar;2;1;A;;503;104;234;309;194;1;14;294;308
25;Lleida;33;Segrià;25021;Almenar;2;1;B;;633;137;277;368;265;1;15;352;367
25;Lleida;33;Segrià;25021;Almenar;2;2;U;;919;143;400;555;364;2;21;532;553
43;Tarragona;8;Baix Camp;43011;Almoster;1;1;A;;334;90;188;234;100;1;6;227;233
43;Tarragona;8;Baix Camp;43011;Almoster;1;1;B;;330;94;187;231;99;1;4;226;230
43;Tarragona;8;Baix Camp;43011;Almoster;1;1;C;;333;106;213;268;65;3;6;259;265
25;Lleida;23;Noguera;25022;Alòs de Balaguer;1;1;U;;129;32;78;87;42;1;6;80;86
17;Girona;15;Cerdanya;17006;Alp;1;1;A;;569;140;280;379;190;6;7;366;373
17;Girona;15;Cerdanya;17006;Alp;1;1;B;;593;141;266;360;233;10;4;346;350
8;Barcelona;24;Osona;08004;Alpens;1;1;U;;230;75;160;194;36;2;11;181;192
25;Lleida;33;Segrià;25023;Alpicat;1;1;A;;656;156;330;447;209;7;20;420;440
25;Lleida;33;Segrià;25023;Alpicat;1;1;B;;817;176;470;514;303;6;15;493;508
25;Lleida;33;Segrià;25023;Alpicat;1;2;A;;818;153;372;519;299;1;26;492;518
25;Lleida;33;Segrià;25023;Alpicat;1;2;B;;906;200;449;598;308;40;1;557;558
25;Lleida;33;Segrià;25023;Alpicat;1;3;A;;593;175;311;405;188;3;10;392;402
25;Lleida;33;Segrià;25023;Alpicat;1;3;B;;634;158;322;418;216;3;21;394;415
43;Tarragona;36;Tarragonès;43012;Altafulla;1;1;A;;381;90;159;213;168;2;7;204;211
43;Tarragona;36;Tarragonès;43012;Altafulla;1;1;B;;470;113;212;273;197;2;12;259;271
43;Tarragona;36;Tarragonès;43012;Altafulla;1;2;A;;367;106;176;215;152;2;5;208;213
43;Tarragona;36;Tarragonès;43012;Altafulla;1;2;B;;472;141;228;269;203;2;5;262;267
43;Tarragona;36;Tarragonès;43012;Altafulla;1;3;A;;419;106;237;311;108;2;16;293;309
43;Tarragona;36;Tarragonès;43012;Altafulla;1;3;B;;383;107;128;253;130;0;11;242;253
43;Tarragona;36;Tarragonès;43012;Altafulla;1;3;C;;420;119;236;296;124;1;7;288;295
43;Tarragona;36;Tarragonès;43012;Altafulla;1;3;D;;442;124;252;316;126;3;6;307;313
25;Lleida;26;Pallars Sobirà;25024;Alt Àneu;1;1;U;;373;78;169;240;133;1;8;231;239
17;Girona;34;Selva;17007;Amer;1;1;A;;585;168;320;366;219;5;13;348;361
17;Girona;34;Selva;17007;Amer;1;1;B;;555;166;311;357;198;7;5;345;350
17;Girona;34;Selva;17007;Amer;1;1;C;;660;177;359;442;218;10;12;420;432
8;Barcelona;41;Vallès Oriental;08005;Ametlla del Vallès, l';1;1;A;;534;130;257;335;199;0;13;322;335
8;Barcelona;41;Vallès Oriental;08005;Ametlla del Vallès, l';1;1;B;;602;142;300;379;223;0;12;367;379
8;Barcelona;41;Vallès Oriental;08005;Ametlla del Vallès, l';1;1;C;;529;120;265;333;196;6;14;313;327
8;Barcelona;41;Vallès Oriental;08005;Ametlla del Vallès, l';1;2;A;;561;164;340;414;147;3;9;402;411
8;Barcelona;41;Vallès Oriental;08005;Ametlla del Vallès, l';1;2;B;;655;179;399;456;199;1;16;439;455
8;Barcelona;41;Vallès Oriental;08005;Ametlla del Vallès, l';1;3;A;;576;156;329;414;162;2;9;403;412
8;Barcelona;41;Vallès Oriental;08005;Ametlla del Vallès, l';1;3;B;;516;141;277;357;159;2;10;345;355
8;Barcelona;41;Vallès Oriental;08005;Ametlla del Vallès, l';1;3;C;;506;156;293;349;157;4;6;339;345
8;Barcelona;41;Vallès Oriental;08005;Ametlla del Vallès, l';1;4;A;;376;87;200;238;138;4;5;229;234
8;Barcelona;41;Vallès Oriental;08005;Ametlla del Vallès, l';1;4;B;;382;110;213;268;114;2;12;254;266
8;Barcelona;41;Vallès Oriental;08005;Ametlla del Vallès, l';1;5;U;;557;133;284;353;204;0;9;344;353
43;Tarragona;9;Baix Ebre;43013;Ametlla de Mar, l';1;1;A;;647;195;374;448;199;3;5;440;445
43;Tarragona;9;Baix Ebre;43013;Ametlla de Mar, l';1;1;B;;716;210;403;459;257;9;2;448;450
43;Tarragona;9;Baix Ebre;43013;Ametlla de Mar, l';1;2;A;;526;149;280;347;179;4;5;338;343
43;Tarragona;9;Baix Ebre;43013;Ametlla de Mar, l';1;2;B;;516;145;252;317;199;5;6;306;312
43;Tarragona;9;Baix Ebre;43013;Ametlla de Mar, l';1;3;A;;659;187;313;399;260;0;11;388;399
43;Tarragona;9;Baix Ebre;43013;Ametlla de Mar, l';1;3;B;;662;171;306;386;276;1;3;382;385
43;Tarragona;9;Baix Ebre;43013;Ametlla de Mar, l';1;3;C;;640;154;257;328;312;1;2;325;327
43;Tarragona;9;Baix Ebre;43906;Ampolla, l';1;1;A;;326;111;180;202;124;3;5;194;199
43;Tarragona;9;Baix Ebre;43906;Ampolla, l';1;1;B;;386;139;231;260;126;4;2;254;256
43;Tarragona;9;Baix Ebre;43906;Ampolla, l';1;1;C;;518;150;269;314;204;2;9;303;312
43;Tarragona;9;Baix Ebre;43906;Ampolla, l';1;1;D;;465;157;249;295;170;3;4;288;292
43;Tarragona;9;Baix Ebre;43906;Ampolla, l';1;1;E;;401;113;209;242;159;1;8;233;241
43;Tarragona;22;Montsià;43014;Amposta;1;1;U;;544;164;263;320;224;4;13;303;316
43;Tarragona;22;Montsià;43014;Amposta;1;2;A;;520;152;245;302;218;1;20;281;301
43;Tarragona;22;Montsià;43014;Amposta;1;2;B;;567;157;260;343;224;4;12;327;339
43;Tarragona;22;Montsià;43014;Amposta;2;1;U;;726;262;426;517;209;9;25;483;508
43;Tarragona;22;Montsià;43014;Amposta;2;2;U;;670;213;321;391;279;8;19;364;383
43;Tarragona;22;Montsià;43014;Amposta;3;1;A;;434;108;197;259;175;2;11;246;257
43;Tarragona;22;Montsià;43014;Amposta;3;1;B;;397;124;213;256;141;2;5;249;254
43;Tarragona;22;Montsià;43014;Amposta;3;2;A;;597;152;245;295;302;0;18;277;295
43;Tarragona;22;Montsià;43014;Amposta;3;2;B;;666;174;321;391;275;6;9;376;385
43;Tarragona;22;Montsià;43014;Amposta;4;1;A;;501;151;246;311;190;2;12;297;309
43;Tarragona;22;Montsià;43014;Amposta;4;1;B;;506;177;265;323;183;5;13;305;318
43;Tarragona;22;Montsià;43014;Amposta;4;2;A;;576;160;286;364;212;2;20;342;362
43;Tarragona;22;Montsià;43014;Amposta;4;2;B;;550;152;262;342;208;3;16;323;339
43;Tarragona;22;Montsià;43014;Amposta;4;3;A;;594;191;312;370;224;2;14;354;368
43;Tarragona;22;Montsià;43014;Amposta;4;3;B;;509;138;246;299;210;1;17;281;298
43;Tarragona;22;Montsià;43014;Amposta;4;3;C;;581;159;293;359;222;4;16;339;355
43;Tarragona;22;Montsià;43014;Amposta;4;4;A;;713;185;332;435;278;8;16;411;427
43;Tarragona;22;Montsià;43014;Amposta;4;4;B;;522;143;254;308;214;3;17;288;305
43;Tarragona;22;Montsià;43014;Amposta;4;4;C;;719;174;354;434;285;5;31;398;429
43;Tarragona;22;Montsià;43014;Amposta;4;5;A;;630;135;247;324;306;8;15;301;316
43;Tarragona;22;Montsià;43014;Amposta;4;5;B;;568;124;244;313;255;5;15;293;308
43;Tarragona;22;Montsià;43014;Amposta;4;5;C;;639;132;254;341;298;6;14;321;335
43;Tarragona;22;Montsià;43014;Amposta;4;6;A;;702;145;294;391;311;3;13;375;388
43;Tarragona;22;Montsià;43014;Amposta;4;6;B;;721;140;281;359;362;8;12;339;351
17;Girona;34;Selva;17008;Anglès;1;1;A;;462;112;249;277;185;3;6;268;274
17;Girona;34;Selva;17008;Anglès;1;1;B;;441;100;220;256;185;3;9;244;253
17;Girona;34;Selva;17008;Anglès;1;2;A;;816;208;426;501;315;7;20;474;494
17;Girona;34;Selva;17008;Anglès;1;2;B;;759;219;404;450;309;8;6;436;442
17;Girona;34;Selva;17008;Anglès;1;3;A;;586;166;306;362;224;3;9;350;359
17;Girona;34;Selva;17008;Anglès;1;3;B;;651;185;335;406;245;6;3;397;400
25;Lleida;38;Urgell;25027;Anglesola;1;1;A;;477;103;247;325;152;7;20;298;318
25;Lleida;38;Urgell;25027;Anglesola;1;1;B;;580;124;302;376;204;3;4;369;373
25;Lleida;18;Garrigues;25029;Arbeca;1;1;U;;827;204;429;531;296;8;16;507;523
25;Lleida;18;Garrigues;25029;Arbeca;1;2;U;;945;254;462;614;331;12;25;577;602
43;Tarragona;12;Baix Penedès;43016;Arboç, l';1;1;A;;433;100;197;249;184;1;10;238;248
43;Tarragona;12;Baix Penedès;43016;Arboç, l';1;1;B;;590;132;249;305;285;0;7;298;305
43;Tarragona;12;Baix Penedès;43016;Arboç, l';1;1;C;;548;128;249;307;241;4;6;297;303
43;Tarragona;12;Baix Penedès;43016;Arboç, l';1;2;A;;591;144;281;367;224;5;9;353;362
43;Tarragona;12;Baix Penedès;43016;Arboç, l';1;2;B;;709;166;317;382;327;1;12;369;381
43;Tarragona;12;Baix Penedès;43016;Arboç, l';1;2;C;;596;145;290;372;224;9;9;354;363
43;Tarragona;8;Baix Camp;43015;Arbolí;1;1;U;;105;48;64;83;22;0;2;81;83
17;Girona;34;Selva;17009;Arbúcies;1;1;A;;733;180;382;441;292;4;10;427;437
17;Girona;34;Selva;17009;Arbúcies;1;1;B;;820;190;420;514;306;7;27;480;507
17;Girona;34;Selva;17009;Arbúcies;1;2;A;;778;216;424;504;274;5;14;485;499
17;Girona;34;Selva;17009;Arbúcies;1;2;B;;774;207;412;509;265;7;19;483;502
17;Girona;34;Selva;17009;Arbúcies;2;1;U;;996;259;525;657;339;7;22;628;650
8;Barcelona;21;Maresme;08006;Arenys de Mar;1;1;A;;742;224;395;468;274;3;13;452;465
8;Barcelona;21;Maresme;08006;Arenys de Mar;1;1;B;;862;259;461;554;308;3;7;544;551
8;Barcelona;21;Maresme;08006;Arenys de Mar;1;2;A;;678;190;354;433;245;3;6;424;430
8;Barcelona;21;Maresme;08006;Arenys de Mar;1;2;B;;768;204;382;462;306;2;12;448;460
8;Barcelona;21;Maresme;08006;Arenys de Mar;1;2;C;;756;212;407;492;264;4;12;476;488
8;Barcelona;21;Maresme;08006;Arenys de Mar;1;3;A;;444;127;227;262;182;4;5;253;258
8;Barcelona;21;Maresme;08006;Arenys de Mar;1;3;B;;540;173;303;358;182;2;8;348;356
8;Barcelona;21;Maresme;08006;Arenys de Mar;2;1;A;;566;172;282;340;226;4;10;326;336
8;Barcelona;21;Maresme;08006;Arenys de Mar;2;1;B;;653;195;341;404;249;4;14;386;400
8;Barcelona;21;Maresme;08006;Arenys de Mar;2;2;A;;681;195;382;452;229;7;14;431;445
8;Barcelona;21;Maresme;08006;Arenys de Mar;2;2;B;;716;241;429;503;213;3;10;490;500
8;Barcelona;21;Maresme;08006;Arenys de Mar;2;3;A;;603;161;312;371;232;1;9;361;370
8;Barcelona;21;Maresme;08006;Arenys de Mar;2;3;B;;744;215;376;456;288;3;20;433;453
8;Barcelona;21;Maresme;08006;Arenys de Mar;2;4;A;;621;160;287;354;267;2;12;340;352
8;Barcelona;21;Maresme;08006;Arenys de Mar;2;4;B;;774;187;365;435;339;8;6;421;427
8;Barcelona;21;Maresme;08006;Arenys de Mar;2;4;C;;732;188;335;405;327;2;8;395;403
8;Barcelona;21;Maresme;08007;Arenys de Munt;1;1;A;;485;163;247;303;182;2;12;289;301
8;Barcelona;21;Maresme;08007;Arenys de Munt;1;1;B;;598;172;334;407;191;12;10;385;395
8;Barcelona;21;Maresme;08007;Arenys de Munt;1;2;A;;539;164;307;367;172;7;12;348;360
8;Barcelona;21;Maresme;08007;Arenys de Munt;1;2;B;;409;114;218;272;137;3;2;267;269
8;Barcelona;21;Maresme;08007;Arenys de Munt;1;2;C;;592;155;303;396;196;4;18;374;392
8;Barcelona;21;Maresme;08007;Arenys de Munt;1;2;D;;571;170;324;386;185;2;16;368;384
8;Barcelona;21;Maresme;08007;Arenys de Munt;2;1;A;;718;214;415;489;229;7;13;469;482
8;Barcelona;21;Maresme;08007;Arenys de Munt;2;1;B;;780;220;451;549;231;2;11;536;547
8;Barcelona;21;Maresme;08007;Arenys de Munt;2;2;A;;527;127;252;323;204;5;8;310;318
8;Barcelona;21;Maresme;08007;Arenys de Munt;2;2;B;;507;120;244;295;212;2;4;289;293
8;Barcelona;21;Maresme;08007;Arenys de Munt;2;2;C;;546;159;269;343;203;3;5;335;340
17;Girona;19;Garrotxa;17010;Argelaguer;1;1;U;;331;91;174;212;119;4;8;200;208
8;Barcelona;6;Anoia;08008;Argençola;1;1;U;;188;41;85;114;74;1;8;105;113
43;Tarragona;8;Baix Camp;43017;Argentera, l';1;1;U;;125;28;78;92;33;0;2;90;92
8;Barcelona;21;Maresme;08009;Argentona;1;1;A;;313;95;179;217;96;0;11;206;217
8;Barcelona;21;Maresme;08009;Argentona;1;1;B;;308;94;175;220;88;0;5;215;220
8;Barcelona;21;Maresme;08009;Argentona;1;2;A;;525;169;300;376;149;1;6;369;375
8;Barcelona;21;Maresme;08009;Argentona;1;2;B;;613;192;361;430;183;0;13;417;430
8;Barcelona;21;Maresme;08009;Argentona;1;3;A;;389;84;175;227;162;0;6;221;227
8;Barcelona;21;Maresme;08009;Argentona;1;3;B;;486;101;218;279;207;0;7;272;279
8;Barcelona;21;Maresme;08009;Argentona;1;4;A;;596;121;246;293;303;0;11;282;293
8;Barcelona;21;Maresme;08009;Argentona;1;4;B;;744;174;304;384;360;1;3;380;383
8;Barcelona;21;Maresme;08009;Argentona;1;5;A;;347;106;211;245;102;1;14;230;244
8;Barcelona;21;Maresme;08009;Argentona;1;5;B;;387;101;213;271;116;2;6;263;269
8;Barcelona;21;Maresme;08009;Argentona;1;6;A;;503;146;291;357;146;3;10;344;354
8;Barcelona;21;Maresme;08009;Argentona;1;6;B;;509;142;280;343;166;1;5;337;342
8;Barcelona;21;Maresme;08009;Argentona;1;6;C;;410;125;232;284;126;4;3;277;280
8;Barcelona;21;Maresme;08009;Argentona;2;1;A;;601;155;323;390;211;5;5;380;385
8;Barcelona;21;Maresme;08009;Argentona;2;1;B;;604;154;295;368;236;1;7;360;367
8;Barcelona;21;Maresme;08009;Argentona;2;1;C;;609;163;322;411;198;4;11;396;407
8;Barcelona;21;Maresme;08009;Argentona;2;2;A;;442;130;245;301;141;2;5;294;299
8;Barcelona;21;Maresme;08009;Argentona;2;2;B;;505;138;301;360;145;5;8;347;355
17;Girona;2;Alt Empordà;17011;Armentera, l';1;1;U;;638;224;416;480;158;0;12;468;480
43;Tarragona;37;Terra Alta;43018;Arnes;1;1;U;;438;173;328;365;73;8;12;345;357
25;Lleida;39;Consell General d'Aran;25031;Arres;1;1;U;;53;5;19;27;26;0;3;24;27
25;Lleida;4;Alt Urgell;25032;Arsèguel;1;1;U;;79;25;32;49;30;1;0;48;48
8;Barcelona;7;Bages;08010;Artés;1;1;A;;493;135;256;316;177;4;6;306;312
8;Barcelona;7;Bages;08010;Artés;1;1;B;;613;147;281;349;264;4;10;335;345
8;Barcelona;7;Bages;08010;Artés;2;1;A;;446;127;223;284;162;4;3;277;280
8;Barcelona;7;Bages;08010;Artés;2;1;B;;566;158;294;371;195;1;9;361;370
8;Barcelona;7;Bages;08010;Artés;2;2;U;;736;200;346;453;283;4;6;443;449
8;Barcelona;7;Bages;08010;Artés;2;3;A;;581;157;306;384;197;1;8;375;383
8;Barcelona;7;Bages;08010;Artés;2;3;B;;689;196;387;461;228;6;8;447;455
25;Lleida;33;Segrià;25033;Artesa de Lleida;1;1;A;;590;157;328;409;181;6;21;382;403
25;Lleida;33;Segrià;25033;Artesa de Lleida;1;1;B;;550;130;273;349;201;10;11;328;339
25;Lleida;23;Noguera;25034;Artesa de Segre;1;1;A;;626;183;366;437;189;9;11;417;428
25;Lleida;23;Noguera;25034;Artesa de Segre;1;1;B;;727;176;399;512;215;9;12;491;503
25;Lleida;23;Noguera;25034;Artesa de Segre;1;2;U;;608;171;297;361;247;5;10;346;356
25;Lleida;23;Noguera;25034;Artesa de Segre;2;1;U;;514;163;253;313;201;0;11;302;313
43;Tarragona;30;Ribera d'Ebre;43019;Ascó;1;1;A;;628;131;300;407;221;13;17;377;394
43;Tarragona;30;Ribera d'Ebre;43019;Ascó;1;1;B;;709;146;340;467;242;15;15;437;452
25;Lleida;33;Segrià;25036;Aspa;1;1;U;;201;48;90;123;78;1;6;116;122
25;Lleida;23;Noguera;25037;Avellanes i Santa Linya, les;1;1;U;;405;80;212;284;121;2;14;268;282
8;Barcelona;14;Berguedà;08011;Avià;1;1;A;;868;235;466;578;290;7;18;553;571
8;Barcelona;14;Berguedà;08011;Avià;1;1;B;;874;220;496;614;260;5;31;578;609
8;Barcelona;7;Bages;08012;Avinyó;1;1;A;;636;170;364;468;168;0;18;450;468
8;Barcelona;7;Bages;08012;Avinyó;1;1;B;;524;151;288;368;156;1;13;354;367
8;Barcelona;7;Bages;08012;Avinyó;1;1;C;;552;160;329;425;127;0;7;418;425
8;Barcelona;3;Alt Penedès;08013;Avinyonet del Penedès;1;1;A;;604;150;307;398;206;0;12;386;398
8;Barcelona;3;Alt Penedès;08013;Avinyonet del Penedès;1;1;B;;625;152;320;422;203;3;15;404;419
17;Girona;2;Alt Empordà;17012;Avinyonet de Puigventós;1;1;U;;1080;246;485;580;500;4;21;555;576
8;Barcelona;13;Barcelonès;08015;Badalona;1;1;A;;504;144;294;382;122;3;10;369;379
8;Barcelona;13;Barcelonès;08015;Badalona;1;1;B;;602;187;355;445;157;1;8;436;444
8;Barcelona;13;Barcelonès;08015;Badalona;1;2;U;;981;285;536;668;313;4;13;651;664
8;Barcelona;13;Barcelonès;08015;Badalona;1;3;U;;754;224;423;510;244;0;5;505;510
8;Barcelona;13;Barcelonès;08015;Badalona;1;4;U;;653;202;385;478;175;2;14;462;476
8;Barcelona;13;Barcelonès;08015;Badalona;1;5;A;;548;190;361;408;140;3;15;390;405
8;Barcelona;13;Barcelonès;08015;Badalona;1;5;B;;597;222;361;437;160;2;11;424;435
8;Barcelona;13;Barcelonès;08015;Badalona;1;7;U;;930;254;545;671;259;11;22;638;660
8;Barcelona;13;Barcelonès;08015;Badalona;1;8;U;;516;182;321;365;151;1;12;352;364
8;Barcelona;13;Barcelonès;08015;Badalona;2;1;A;;478;115;238;291;187;1;15;275;290
8;Barcelona;13;Barcelonès;08015;Badalona;2;1;B;;573;146;262;321;252;9;1;311;312
8;Barcelona;13;Barcelonès;08015;Badalona;2;10;A;;522;121;223;277;245;1;4;272;276
8;Barcelona;13;Barcelonès;08015;Badalona;2;10;B;;588;122;234;291;297;1;10;280;290
8;Barcelona;13;Barcelonès;08015;Badalona;2;11;A;;559;132;253;293;266;1;8;284;292
8;Barcelona;13;Barcelonès;08015;Badalona;2;11;B;;692;144;293;372;320;0;10;362;372
8;Barcelona;13;Barcelonès;08015;Badalona;2;12;U;;826;173;395;414;412;4;5;405;410
8;Barcelona;13;Barcelonès;08015;Badalona;2;13;U;;848;148;333;425;423;7;10;408;418
8;Barcelona;13;Barcelonès;08015;Badalona;2;15;U;;797;166;333;379;418;0;0;379;379
8;Barcelona;13;Barcelonès;08015;Badalona;2;2;A;;615;200;371;450;165;1;10;439;449
8;Barcelona;13;Barcelonès;08015;Badalona;2;2;B;;661;192;376;465;196;4;9;452;461
8;Barcelona;13;Barcelonès;08015;Badalona;2;3;U;;688;214;396;487;201;5;15;467;482
8;Barcelona;13;Barcelonès;08015;Badalona;2;4;A;;715;207;427;518;197;0;11;507;518
8;Barcelona;13;Barcelonès;08015;Badalona;2;4;B;;750;205;427;535;215;17;1;517;518
8;Barcelona;13;Barcelonès;08015;Badalona;2;5;U;;957;212;402;467;490;3;9;455;464
8;Barcelona;13;Barcelonès;08015;Badalona;2;7;U;;927;204;372;479;448;0;9;470;479
8;Barcelona;13;Barcelonès;08015;Badalona;2;8;A;;557;176;303;398;159;0;14;384;398
8;Barcelona;13;Barcelonès;08015;Badalona;2;8;B;;546;131;277;355;191;2;6;347;353
8;Barcelona;13;Barcelonès;08015;Badalona;2;8;C;;578;209;342;400;178;3;6;391;397
8;Barcelona;13;Barcelonès;08015;Badalona;2;9;U;;743;162;273;334;409;0;3;331;334
8;Barcelona;13;Barcelonès;08015;Badalona;3;1;A;;743;178;361;430;313;0;10;420;430
8;Barcelona;13;Barcelonès;08015;Badalona;3;1;B;;843;213;391;492;351;17;2;473;475
8;Barcelona;13;Barcelonès;08015;Badalona;3;10;U;;783;228;442;496;287;3;15;478;493
8;Barcelona;13;Barcelonès;08015;Badalona;3;11;U;;868;197;429;519;349;2;16;501;517
8;Barcelona;13;Barcelonès;08015;Badalona;3;12;U;;920;256;507;619;301;3;16;600;616
8;Barcelona;13;Barcelonès;08015;Badalona;3;13;A;;768;176;373;476;292;2;9;465;474
8;Barcelona;13;Barcelonès;08015;Badalona;3;13;B;;963;258;500;624;339;1;24;599;623
8;Barcelona;13;Barcelonès;08015;Badalona;3;3;A;;615;145;278;351;264;1;18;332;350
8;Barcelona;13;Barcelonès;08015;Badalona;3;3;B;;705;186;342;406;299;1;12;393;405
8;Barcelona;13;Barcelonès;08015;Badalona;3;4;A;;542;138;259;340;202;1;18;321;339
8;Barcelona;13;Barcelonès;08015;Badalona;3;4;B;;683;180;338;424;259;1;19;404;423
8;Barcelona;13;Barcelonès;08015;Badalona;3;5;A;;494;115;201;245;249;0;11;234;245
8;Barcelona;13;Barcelonès;08015;Badalona;3;5;B;;563;126;238;305;258;1;14;290;304
8;Barcelona;13;Barcelonès;08015;Badalona;3;6;U;;862;221;489;604;258;5;18;581;599
8;Barcelona;13;Barcelonès;08015;Badalona;3;7;A;;478;131;252;325;153;3;8;314;322
8;Barcelona;13;Barcelonès;08015;Badalona;3;7;B;;503;167;299;363;140;0;17;346;363
8;Barcelona;13;Barcelonès;08015;Badalona;3;8;U;;502;140;277;326;176;1;7;318;325
8;Barcelona;13;Barcelonès;08015;Badalona;3;9;U;;471;143;296;345;126;2;4;339;343
8;Barcelona;13;Barcelonès;08015;Badalona;4;1;A;;672;104;247;307;365;6;7;294;301
8;Barcelona;13;Barcelonès;08015;Badalona;4;1;B;;792;144;300;385;407;1;9;375;384
8;Barcelona;13;Barcelonès;08015;Badalona;4;10;U;;927;289;393;470;457;3;12;455;467
8;Barcelona;13;Barcelonès;08015;Badalona;4;11;A;;486;105;202;245;241;2;11;232;243
8;Barcelona;13;Barcelonès;08015;Badalona;4;11;B;;566;119;238;305;261;1;10;294;304
8;Barcelona;13;Barcelonès;08015;Badalona;4;12;A;;499;106;213;262;237;0;11;251;262
8;Barcelona;13;Barcelonès;08015;Badalona;4;12;B;;599;124;243;310;289;15;1;294;295
8;Barcelona;13;Barcelonès;08015;Badalona;4;13;U;;892;202;419;529;363;1;16;512;528
8;Barcelona;13;Barcelonès;08015;Badalona;4;14;A;;529;115;255;335;194;0;14;321;335
8;Barcelona;13;Barcelonès;08015;Badalona;4;14;B;;703;139;329;421;282;1;14;406;420
8;Barcelona;13;Barcelonès;08015;Badalona;4;14;C;;701;150;328;434;267;1;20;413;433
8;Barcelona;13;Barcelonès;08015;Badalona;4;15;A;;496;112;197;260;236;0;8;252;260
8;Barcelona;13;Barcelonès;08015;Badalona;4;15;B;;565;100;235;313;252;1;9;303;312
8;Barcelona;13;Barcelonès;08015;Badalona;4;16;A;;626;171;296;375;251;0;11;364;375
8;Barcelona;13;Barcelonès;08015;Badalona;4;16;B;;787;239;399;491;296;0;19;472;491
8;Barcelona;13;Barcelonès;08015;Badalona;4;2;A;;535;133;269;320;215;5;6;309;315
8;Barcelona;13;Barcelonès;08015;Badalona;4;2;B;;669;162;304;381;288;4;11;366;377
8;Barcelona;13;Barcelonès;08015;Badalona;4;3;A;;466;101;202;259;207;2;12;245;257
8;Barcelona;13;Barcelonès;08015;Badalona;4;3;B;;536;124;262;316;220;0;6;310;316
8;Barcelona;13;Barcelonès;08015;Badalona;4;4;A;;530;133;247;312;218;0;8;304;312
8;Barcelona;13;Barcelonès;08015;Badalona;4;4;B;;652;165;296;406;246;0;13;393;406
8;Barcelona;13;Barcelonès;08015;Badalona;4;4;C;;569;179;258;315;254;1;11;303;314
8;Barcelona;13;Barcelonès;08015;Badalona;4;5;A;;544;143;261;301;243;0;6;295;301
8;Barcelona;13;Barcelonès;08015;Badalona;4;5;B;;631;141;298;371;260;2;14;355;369
8;Barcelona;13;Barcelonès;08015;Badalona;4;6;A;;546;117;221;261;285;2;5;254;259
8;Barcelona;13;Barcelonès;08015;Badalona;4;6;B;;700;157;299;361;339;1;10;350;360
8;Barcelona;13;Barcelonès;08015;Badalona;4;6;C;;613;146;266;311;302;6;11;294;305
8;Barcelona;13;Barcelonès;08015;Badalona;4;7;A;;655;146;331;419;236;2;18;399;417
8;Barcelona;13;Barcelonès;08015;Badalona;4;7;B;;786;168;381;464;322;5;13;446;459
8;Barcelona;13;Barcelonès;08015;Badalona;4;8;A;;569;130;225;280;289;1;12;267;279
8;Barcelona;13;Barcelonès;08015;Badalona;4;8;B;;634;146;266;342;292;4;15;323;338
8;Barcelona;13;Barcelonès;08015;Badalona;4;9;U;;719;149;335;431;288;3;20;408;428
8;Barcelona;13;Barcelonès;08015;Badalona;5;1;A;;544;180;307;385;159;0;10;375;385
8;Barcelona;13;Barcelonès;08015;Badalona;5;1;B;;523;185;295;349;174;0;16;333;349
8;Barcelona;13;Barcelonès;08015;Badalona;5;1;C;;620;236;400;460;160;1;18;441;459
8;Barcelona;13;Barcelonès;08015;Badalona;5;2;U;;682;206;408;524;158;0;16;508;524
8;Barcelona;13;Barcelonès;08015;Badalona;5;3;A;;601;172;324;400;201;2;11;387;398
8;Barcelona;13;Barcelonès;08015;Badalona;5;3;B;;609;141;322;404;205;1;10;393;403
8;Barcelona;13;Barcelonès;08015;Badalona;5;3;C;;618;167;353;437;181;4;12;421;433
8;Barcelona;13;Barcelonès;08015;Badalona;5;4;A;;818;219;403;498;320;0;5;493;498
8;Barcelona;13;Barcelonès;08015;Badalona;5;4;B;;846;229;430;515;331;1;12;502;514
8;Barcelona;13;Barcelonès;08015;Badalona;5;5;A;;714;216;377;439;275;1;10;428;438
8;Barcelona;13;Barcelonès;08015;Badalona;5;5;B;;808;197;401;488;320;4;18;466;484
8;Barcelona;13;Barcelonès;08015;Badalona;5;6;A;;470;158;281;340;130;1;11;328;339
8;Barcelona;13;Barcelonès;08015;Badalona;5;6;B;;505;172;317;358;147;0;9;349;358
8;Barcelona;13;Barcelonès;08015;Badalona;6;1;A;;507;97;215;272;235;1;6;265;271
8;Barcelona;13;Barcelonès;08015;Badalona;6;1;B;;535;110;231;295;240;1;9;285;294
8;Barcelona;13;Barcelonès;08015;Badalona;6;2;A;;421;105;207;258;163;0;8;250;258
8;Barcelona;13;Barcelonès;08015;Badalona;6;2;B;;536;112;255;330;206;0;6;324;330
8;Barcelona;13;Barcelonès;08015;Badalona;6;2;C;;354;79;168;209;145;2;4;203;207
8;Barcelona;13;Barcelonès;08015;Badalona;6;3;U;;956;194;338;408;548;4;7;397;404
8;Barcelona;13;Barcelonès;08015;Badalona;6;4;A;;433;67;145;172;261;0;7;165;172
8;Barcelona;13;Barcelonès;08015;Badalona;6;4;B;;585;119;207;265;320;2;2;261;263
8;Barcelona;13;Barcelonès;08015;Badalona;6;5;A;;530;126;232;217;313;2;1;214;215
8;Barcelona;13;Barcelonès;08015;Badalona;6;5;B;;637;89;175;264;373;0;6;258;264
8;Barcelona;13;Barcelonès;08015;Badalona;6;6;U;;853;142;311;353;500;0;9;344;353
8;Barcelona;13;Barcelonès;08015;Badalona;7;1;A;;513;102;219;272;241;0;6;266;272
8;Barcelona;13;Barcelonès;08015;Badalona;7;1;B;;683;144;282;361;322;1;4;356;360
8;Barcelona;13;Barcelonès;08015;Badalona;7;10;U;;577;143;243;282;295;0;4;278;282
8;Barcelona;13;Barcelonès;08015;Badalona;7;11;A;;694;146;283;356;338;2;9;345;354
8;Barcelona;13;Barcelonès;08015;Badalona;7;11;B;;814;171;316;406;408;0;4;402;406
8;Barcelona;13;Barcelonès;08015;Badalona;7;12;A;;466;144;244;239;227;0;2;237;239
8;Barcelona;13;Barcelonès;08015;Badalona;7;12;B;;576;103;196;296;280;0;11;285;296
8;Barcelona;13;Barcelonès;08015;Badalona;7;13;A;;527;114;195;224;303;0;1;223;224
8;Barcelona;13;Barcelonès;08015;Badalona;7;13;B;;636;130;234;278;358;2;3;273;276
8;Barcelona;13;Barcelonès;08015;Badalona;7;14;A;;547;94;164;205;342;0;3;202;205
8;Barcelona;13;Barcelonès;08015;Badalona;7;14;B;;677;110;222;283;394;2;3;278;281
8;Barcelona;13;Barcelonès;08015;Badalona;7;15;U;;576;121;206;243;333;0;10;233;243
8;Barcelona;13;Barcelonès;08015;Badalona;7;17;U;;489;132;182;223;266;2;8;213;221
8;Barcelona;13;Barcelonès;08015;Badalona;7;18;A;;592;138;287;358;234;1;11;346;357
8;Barcelona;13;Barcelonès;08015;Badalona;7;18;B;;706;134;320;392;314;0;12;380;392
8;Barcelona;13;Barcelonès;08015;Badalona;7;2;A;;610;138;274;336;274;0;11;325;336
8;Barcelona;13;Barcelonès;08015;Badalona;7;2;B;;643;146;292;366;277;4;12;350;362
8;Barcelona;13;Barcelonès;08015;Badalona;7;2;C;;590;142;289;352;238;1;9;342;351
8;Barcelona;13;Barcelonès;08015;Badalona;7;20;U;;843;245;389;460;383;0;4;456;460
8;Barcelona;13;Barcelonès;08015;Badalona;7;21;U;;686;148;263;329;357;1;7;321;328
8;Barcelona;13;Barcelonès;08015;Badalona;7;22;U;;617;160;310;367;250;0;12;355;367
8;Barcelona;13;Barcelonès;08015;Badalona;7;23;A;;698;213;374;466;232;5;10;451;461
8;Barcelona;13;Barcelonès;08015;Badalona;7;23;B;;849;255;459;558;291;8;8;542;550
8;Barcelona;13;Barcelonès;08015;Badalona;7;24;A;;570;148;260;336;234;2;15;319;334
8;Barcelona;13;Barcelonès;08015;Badalona;7;24;B;;732;200;361;454;278;4;15;435;450
8;Barcelona;13;Barcelonès;08015;Badalona;7;25;A;;596;121;192;216;380;0;0;216;216
8;Barcelona;13;Barcelonès;08015;Badalona;7;25;B;;685;108;238;285;400;1;4;280;284
8;Barcelona;13;Barcelonès;08015;Badalona;7;28;A;;614;104;203;255;359;1;6;248;254
8;Barcelona;13;Barcelonès;08015;Badalona;7;28;B;;746;159;315;381;365;3;6;372;378
8;Barcelona;13;Barcelonès;08015;Badalona;7;29;A;;458;101;203;271;187;0;10;261;271
8;Barcelona;13;Barcelonès;08015;Badalona;7;29;B;;685;152;309;406;279;3;8;395;403
8;Barcelona;13;Barcelonès;08015;Badalona;7;29;C;;629;134;286;346;283;2;10;334;344
8;Barcelona;13;Barcelonès;08015;Badalona;7;3;A;;532;112;230;287;245;5;12;270;282
8;Barcelona;13;Barcelonès;08015;Badalona;7;3;B;;586;144;264;304;282;9;1;294;295
8;Barcelona;13;Barcelonès;08015;Badalona;7;30;A;;676;121;386;388;288;0;12;376;388
8;Barcelona;13;Barcelonès;08015;Badalona;7;30;B;;832;170;372;477;355;1;8;468;476
8;Barcelona;13;Barcelonès;08015;Badalona;7;31;A;;452;81;169;224;228;0;9;215;224
8;Barcelona;13;Barcelonès;08015;Badalona;7;31;B;;583;95;213;281;302;0;11;270;281
8;Barcelona;13;Barcelonès;08015;Badalona;7;4;U;;845;217;407;496;349;4;11;481;492
8;Barcelona;13;Barcelonès;08015;Badalona;7;5;U;;606;132;250;329;277;0;4;325;329
8;Barcelona;13;Barcelonès;08015;Badalona;7;6;U;;757;198;392;483;274;2;26;455;481
8;Barcelona;13;Barcelonès;08015;Badalona;7;7;U;;595;94;205;247;348;2;2;243;245
8;Barcelona;13;Barcelonès;08015;Badalona;7;8;U;;839;145;277;350;489;0;9;341;350
8;Barcelona;13;Barcelonès;08015;Badalona;7;9;U;;509;124;185;227;282;3;7;217;224
8;Barcelona;13;Barcelonès;08015;Badalona;8;1;U;;472;78;155;180;292;1;4;175;179
8;Barcelona;13;Barcelonès;08015;Badalona;8;10;A;;513;92;178;215;298;0;4;211;215
8;Barcelona;13;Barcelonès;08015;Badalona;8;10;B;;583;90;186;241;342;0;9;232;241
8;Barcelona;13;Barcelonès;08015;Badalona;8;11;U;;674;143;279;350;324;6;15;329;344
8;Barcelona;13;Barcelonès;08015;Badalona;8;12;A;;582;128;268;361;221;1;21;339;360
8;Barcelona;13;Barcelonès;08015;Badalona;8;12;B;;619;132;292;384;235;2;16;366;382
8;Barcelona;13;Barcelonès;08015;Badalona;8;12;C;;587;124;300;379;208;0;24;355;379
8;Barcelona;13;Barcelonès;08015;Badalona;8;13;U;;734;115;265;365;369;3;15;347;362
8;Barcelona;13;Barcelonès;08015;Badalona;8;2;A;;542;100;216;273;269;4;11;258;269
8;Barcelona;13;Barcelonès;08015;Badalona;8;2;B;;666;132;285;360;306;2;10;348;358
8;Barcelona;13;Barcelonès;08015;Badalona;8;2;C;;631;138;283;350;281;1;9;340;349
8;Barcelona;13;Barcelonès;08015;Badalona;8;3;A;;698;122;321;343;355;2;17;324;341
8;Barcelona;13;Barcelonès;08015;Badalona;8;3;B;;807;142;255;418;389;2;15;401;416
8;Barcelona;13;Barcelonès;08015;Badalona;8;4;U;;598;129;240;304;294;0;9;295;304
8;Barcelona;13;Barcelonès;08015;Badalona;8;5;U;;695;128;239;286;409;1;7;278;285
8;Barcelona;13;Barcelonès;08015;Badalona;8;6;A;;607;130;277;342;265;6;12;324;336
8;Barcelona;13;Barcelonès;08015;Badalona;8;6;B;;750;140;318;407;343;3;18;386;404
8;Barcelona;13;Barcelonès;08015;Badalona;8;7;U;;903;158;297;380;523;3;6;371;377
8;Barcelona;13;Barcelonès;08015;Badalona;8;8;A;;704;169;290;370;334;0;10;360;370
8;Barcelona;13;Barcelonès;08015;Badalona;8;8;B;;815;128;339;413;402;1;13;399;412
8;Barcelona;13;Barcelonès;08015;Badalona;8;9;A;;464;102;199;238;226;2;6;230;236
8;Barcelona;13;Barcelonès;08015;Badalona;8;9;B;;538;136;226;268;270;4;6;258;264
8;Barcelona;13;Barcelonès;08015;Badalona;9;1;A;;543;130;227;265;278;0;5;260;265
8;Barcelona;13;Barcelonès;08015;Badalona;9;1;B;;593;117;239;279;314;2;3;274;277
8;Barcelona;13;Barcelonès;08015;Badalona;9;10;A;;500;101;175;200;300;1;2;197;199
8;Barcelona;13;Barcelonès;08015;Badalona;9;10;B;;663;143;223;277;386;0;8;269;277
8;Barcelona;13;Barcelonès;08015;Badalona;9;11;U;;700;174;308;373;327;4;5;364;369
8;Barcelona;13;Barcelonès;08015;Badalona;9;12;A;;525;137;245;284;241;4;2;278;280
8;Barcelona;13;Barcelonès;08015;Badalona;9;12;B;;558;116;240;300;258;3;2;295;297
8;Barcelona;13;Barcelonès;08015;Badalona;9;13;U;;588;141;269;312;276;5;4;303;307
8;Barcelona;13;Barcelonès;08015;Badalona;9;14;A;;510;129;243;293;217;0;7;286;293
8;Barcelona;13;Barcelonès;08015;Badalona;9;14;B;;644;168;297;346;298;0;7;339;346
8;Barcelona;13;Barcelonès;08015;Badalona;9;15;A;;517;89;171;221;296;0;6;215;221
8;Barcelona;13;Barcelonès;08015;Badalona;9;15;B;;644;136;244;293;351;2;10;281;291
8;Barcelona;13;Barcelonès;08015;Badalona;9;16;A;;618;112;225;285;333;1;10;274;284
8;Barcelona;13;Barcelonès;08015;Badalona;9;16;B;;638;132;242;310;328;2;8;300;308
8;Barcelona;13;Barcelonès;08015;Badalona;9;17;U;;848;147;287;350;498;3;6;341;347
8;Barcelona;13;Barcelonès;08015;Badalona;9;18;A;;671;159;295;338;333;0;9;329;338
8;Barcelona;13;Barcelonès;08015;Badalona;9;18;B;;746;178;319;381;365;0;15;366;381
8;Barcelona;13;Barcelonès;08015;Badalona;9;19;U;;776;178;342;403;373;3;13;387;400
8;Barcelona;13;Barcelonès;08015;Badalona;9;2;A;;531;81;138;175;356;0;1;174;175
8;Barcelona;13;Barcelonès;08015;Badalona;9;2;B;;476;81;150;170;306;0;1;169;170
8;Barcelona;13;Barcelonès;08015;Badalona;9;20;U;;540;94;204;275;265;3;4;268;272
8;Barcelona;13;Barcelonès;08015;Badalona;9;21;A;;505;139;229;289;216;0;8;281;289
8;Barcelona;13;Barcelonès;08015;Badalona;9;21;B;;546;122;222;285;261;0;9;276;285
8;Barcelona;13;Barcelonès;08015;Badalona;9;22;A;;464;102;214;254;210;0;6;248;254
8;Barcelona;13;Barcelonès;08015;Badalona;9;22;B;;558;130;243;294;264;0;5;289;294
8;Barcelona;13;Barcelonès;08015;Badalona;9;23;U;;486;92;174;229;257;1;5;223;228
8;Barcelona;13;Barcelonès;08015;Badalona;9;24;A;;716;161;322;401;315;2;6;393;399
8;Barcelona;13;Barcelonès;08015;Badalona;9;24;B;;813;179;358;443;370;1;12;430;442
8;Barcelona;13;Barcelonès;08015;Badalona;9;25;U;;875;120;299;389;486;0;7;382;389
8;Barcelona;13;Barcelonès;08015;Badalona;9;26;A;;454;95;196;250;204;1;7;242;249
8;Barcelona;13;Barcelonès;08015;Badalona;9;26;B;;528;101;230;286;242;0;8;278;286
8;Barcelona;13;Barcelonès;08015;Badalona;9;27;U;;538;114;214;270;268;0;6;264;270
8;Barcelona;13;Barcelonès;08015;Badalona;9;28;A;;740;115;261;282;458;4;1;277;278
8;Barcelona;13;Barcelonès;08015;Badalona;9;28;B;;839;138;213;341;498;0;6;335;341
8;Barcelona;13;Barcelonès;08015;Badalona;9;3;U;;618;106;203;268;350;1;7;260;267
8;Barcelona;13;Barcelonès;08015;Badalona;9;30;U;;951;171;350;441;510;2;3;436;439
8;Barcelona;13;Barcelonès;08015;Badalona;9;31;U;;818;172;328;440;378;1;16;423;439
8;Barcelona;13;Barcelonès;08015;Badalona;9;32;U;;631;118;231;296;335;1;3;292;295
8;Barcelona;13;Barcelonès;08015;Badalona;9;33;A;;543;124;224;275;268;2;5;268;273
8;Barcelona;13;Barcelonès;08015;Badalona;9;33;B;;707;144;290;349;358;3;5;341;346
8;Barcelona;13;Barcelonès;08015;Badalona;9;34;A;;665;144;291;367;298;2;9;356;365
8;Barcelona;13;Barcelonès;08015;Badalona;9;34;B;;761;164;314;417;344;3;12;402;414
8;Barcelona;13;Barcelonès;08015;Badalona;9;35;A;;476;116;192;244;232;2;7;235;242
8;Barcelona;13;Barcelonès;08015;Badalona;9;35;B;;616;123;241;305;311;1;13;291;304
8;Barcelona;13;Barcelonès;08015;Badalona;9;36;U;;948;167;361;436;512;0;10;426;436
8;Barcelona;13;Barcelonès;08015;Badalona;9;37;U;;568;96;172;216;352;3;4;209;213
8;Barcelona;13;Barcelonès;08015;Badalona;9;38;U;;802;160;290;360;442;1;4;355;359
8;Barcelona;13;Barcelonès;08015;Badalona;9;4;U;;894;100;174;209;685;2;8;199;207
8;Barcelona;13;Barcelonès;08015;Badalona;9;42;U;;730;78;140;158;572;1;0;157;157
8;Barcelona;13;Barcelonès;08015;Badalona;9;43;A;;636;146;263;335;301;2;11;322;333
8;Barcelona;13;Barcelonès;08015;Badalona;9;43;B;;758;162;311;393;365;1;9;383;392
8;Barcelona;13;Barcelonès;08015;Badalona;9;44;U;;685;144;250;306;379;1;13;292;305
8;Barcelona;13;Barcelonès;08015;Badalona;9;45;A;;560;151;255;310;250;0;12;298;310
8;Barcelona;13;Barcelonès;08015;Badalona;9;45;B;;692;169;298;372;320;2;5;365;370
8;Barcelona;13;Barcelonès;08015;Badalona;9;47;U;;727;148;292;363;364;1;6;356;362
8;Barcelona;13;Barcelonès;08015;Badalona;9;49;A;;485;120;201;241;244;0;3;238;241
8;Barcelona;13;Barcelonès;08015;Badalona;9;49;B;;516;141;237;282;234;0;13;269;282
8;Barcelona;13;Barcelonès;08015;Badalona;9;5;U;;759;163;263;311;448;0;8;303;311
8;Barcelona;13;Barcelonès;08015;Badalona;9;50;U;;625;132;258;314;311;4;9;301;310
8;Barcelona;13;Barcelonès;08015;Badalona;9;52;U;;683;180;285;349;334;2;11;336;347
8;Barcelona;13;Barcelonès;08015;Badalona;9;53;U;;805;192;340;397;408;0;5;392;397
8;Barcelona;13;Barcelonès;08015;Badalona;9;54;U;;885;214;391;460;425;1;10;449;459
8;Barcelona;13;Barcelonès;08015;Badalona;9;57;U;;932;155;351;457;475;0;9;448;457
8;Barcelona;13;Barcelonès;08015;Badalona;9;58;A;;515;137;236;274;241;5;2;267;269
8;Barcelona;13;Barcelonès;08015;Badalona;9;58;B;;626;128;268;332;294;0;11;321;332
8;Barcelona;13;Barcelonès;08015;Badalona;9;59;U;;863;192;389;475;388;0;12;463;475
8;Barcelona;13;Barcelonès;08015;Badalona;9;6;U;;853;177;300;332;521;1;4;327;331
8;Barcelona;13;Barcelonès;08015;Badalona;9;8;A;;516;104;190;218;298;2;1;215;216
8;Barcelona;13;Barcelonès;08015;Badalona;9;8;B;;594;132;220;261;333;1;10;250;260
8;Barcelona;13;Barcelonès;08015;Badalona;9;9;U;;875;235;434;521;354;4;16;501;517
8;Barcelona;40;Vallès Occidental;08904;Badia del Vallès;1;1;A;;410;71;169;194;216;4;7;183;190
8;Barcelona;40;Vallès Occidental;08904;Badia del Vallès;1;1;B;;466;84;144;240;226;2;3;235;238
8;Barcelona;40;Vallès Occidental;08904;Badia del Vallès;1;10;A;;374;99;164;199;175;0;4;195;199
8;Barcelona;40;Vallès Occidental;08904;Badia del Vallès;1;10;B;;386;97;161;199;187;0;4;195;199
8;Barcelona;40;Vallès Occidental;08904;Badia del Vallès;1;11;A;;476;97;182;227;249;0;6;221;227
8;Barcelona;40;Vallès Occidental;08904;Badia del Vallès;1;11;B;;464;93;169;212;252;0;6;206;212
8;Barcelona;40;Vallès Occidental;08904;Badia del Vallès;1;12;A;;441;85;178;231;210;2;4;225;229
8;Barcelona;40;Vallès Occidental;08904;Badia del Vallès;1;12;B;;431;83;159;190;241;2;7;181;188
8;Barcelona;40;Vallès Occidental;08904;Badia del Vallès;1;2;U;;677;107;212;278;399;2;10;266;276
8;Barcelona;40;Vallès Occidental;08904;Badia del Vallès;1;3;A;;463;78;177;231;232;0;7;224;231
8;Barcelona;40;Vallès Occidental;08904;Badia del Vallès;1;3;B;;488;87;173;225;263;0;8;217;225
8;Barcelona;40;Vallès Occidental;08904;Badia del Vallès;1;4;A;;434;69;129;160;274;0;0;160;160
8;Barcelona;40;Vallès Occidental;08904;Badia del Vallès;1;4;B;;490;88;175;203;287;0;2;201;203
8;Barcelona;40;Vallès Occidental;08904;Badia del Vallès;1;5;A;;434;73;129;165;269;0;0;165;165
8;Barcelona;40;Vallès Occidental;08904;Badia del Vallès;1;5;B;;457;102;165;199;258;3;10;186;196
8;Barcelona;40;Vallès Occidental;08904;Badia del Vallès;1;6;A;;551;105;195;258;293;3;7;248;255
8;Barcelona;40;Vallès Occidental;08904;Badia del Vallès;1;6;B;;604;112;227;294;310;5;10;279;289
8;Barcelona;40;Vallès Occidental;08904;Badia del Vallès;1;7;A;;458;93;168;188;270;0;7;181;188
8;Barcelona;40;Vallès Occidental;08904;Badia del Vallès;1;7;B;;380;99;160;188;192;0;3;185;188
8;Barcelona;40;Vallès Occidental;08904;Badia del Vallès;1;8;A;;489;74;154;201;288;0;8;193;201
8;Barcelona;40;Vallès Occidental;08904;Badia del Vallès;1;8;B;;378;73;141;171;207;0;5;166;171
8;Barcelona;40;Vallès Occidental;08904;Badia del Vallès;1;9;A;;479;87;166;205;274;0;3;202;205
8;Barcelona;40;Vallès Occidental;08904;Badia del Vallès;1;9;B;;395;72;142;176;219;0;7;169;176
8;Barcelona;14;Berguedà;08016;Bagà;1;1;A;;906;249;451;549;357;2;17;530;547
8;Barcelona;14;Berguedà;08016;Bagà;1;1;B;;1044;287;599;714;330;0;17;697;714
25;Lleida;26;Pallars Sobirà;25039;Baix Pallars;1;1;U;;312;60;144;202;110;2;9;191;200
25;Lleida;23;Noguera;25040;Balaguer;1;1;A;;425;93;201;246;179;1;9;236;245
25;Lleida;23;Noguera;25040;Balaguer;1;1;B;;372;97;198;226;146;1;6;219;225
25;Lleida;23;Noguera;25040;Balaguer;1;2;U;;896;189;410;526;370;4;24;498;522
25;Lleida;23;Noguera;25040;Balaguer;2;1;A;;295;69;96;111;184;1;4;106;110
25;Lleida;23;Noguera;25040;Balaguer;2;1;B;;269;41;107;123;146;2;4;117;121
25;Lleida;23;Noguera;25040;Balaguer;2;1;C;;308;43;90;122;186;0;8;114;122
25;Lleida;23;Noguera;25040;Balaguer;3;1;A;;989;228;455;575;414;4;17;554;571
25;Lleida;23;Noguera;25040;Balaguer;3;1;B;;986;225;437;584;402;8;26;550;576
25;Lleida;23;Noguera;25040;Balaguer;3;2;U;;846;184;360;455;391;8;18;429;447
25;Lleida;23;Noguera;25040;Balaguer;4;1;A;;581;153;316;392;189;4;14;374;388
25;Lleida;23;Noguera;25040;Balaguer;4;1;B;;630;158;339;436;194;6;8;422;430
25;Lleida;23;Noguera;25040;Balaguer;4;2;A;;563;141;260;333;230;0;18;315;333
25;Lleida;23;Noguera;25040;Balaguer;4;2;B;;672;167;322;429;243;0;12;417;429
25;Lleida;23;Noguera;25040;Balaguer;4;3;A;;557;121;268;366;191;7;16;343;359
25;Lleida;23;Noguera;25040;Balaguer;4;3;B;;624;142;306;424;200;10;12;402;414
25;Lleida;23;Noguera;25040;Balaguer;4;4;A;;695;152;373;459;236;2;17;440;457
25;Lleida;23;Noguera;25040;Balaguer;4;4;B;;906;213;455;601;305;7;24;570;594
8;Barcelona;24;Osona;08017;Balenyà;1;1;A;;659;182;337;415;244;6;7;402;409
8;Barcelona;24;Osona;08017;Balenyà;1;1;B;;588;140;287;350;238;4;14;332;346
8;Barcelona;24;Osona;08017;Balenyà;1;1;C;;760;174;374;458;302;6;15;437;452
8;Barcelona;24;Osona;08017;Balenyà;1;2;U;;742;185;390;476;266;3;16;457;473
8;Barcelona;7;Bages;08018;Balsareny;1;1;A;;440;88;206;262;178;1;9;252;261
8;Barcelona;7;Bages;08018;Balsareny;1;1;B;;463;87;200;256;207;1;6;249;255
8;Barcelona;7;Bages;08018;Balsareny;1;1;C;;441;114;218;281;160;2;7;272;279
8;Barcelona;7;Bages;08018;Balsareny;1;2;A;;490;105;219;265;225;2;14;249;263
8;Barcelona;7;Bages;08018;Balsareny;1;2;B;;514;120;243;293;221;0;13;280;293
8;Barcelona;7;Bages;08018;Balsareny;1;3;U;;342;97;171;213;129;2;6;205;211
43;Tarragona;12;Baix Penedès;43020;Banyeres del Penedès;1;1;A;;604;148;436;360;244;2;5;353;358
43;Tarragona;12;Baix Penedès;43020;Banyeres del Penedès;1;1;B;;682;176;354;426;256;6;14;406;420
43;Tarragona;12;Baix Penedès;43020;Banyeres del Penedès;1;2;U;;827;202;380;466;361;2;12;452;464
17;Girona;28;Pla de l'Estany;17015;Banyoles;1;1;A;;562;192;303;351;211;5;9;337;346
17;Girona;28;Pla de l'Estany;17015;Banyoles;1;1;B;;617;181;313;392;225;7;12;373;385
17;Girona;28;Pla de l'Estany;17015;Banyoles;1;2;U;;695;220;403;493;202;7;13;473;486
17;Girona;28;Pla de l'Estany;17015;Banyoles;1;3;U;;944;280;451;567;377;9;18;540;558
17;Girona;28;Pla de l'Estany;17015;Banyoles;1;4;A;;572;181;322;371;201;3;16;352;368
17;Girona;28;Pla de l'Estany;17015;Banyoles;1;4;B;;662;201;360;428;234;7;12;409;421
17;Girona;28;Pla de l'Estany;17015;Banyoles;1;5;A;;505;164;285;342;163;5;16;321;337
17;Girona;28;Pla de l'Estany;17015;Banyoles;1;5;B;;528;168;299;353;175;2;5;346;351
17;Girona;28;Pla de l'Estany;17015;Banyoles;2;1;A;;597;202;349;425;172;2;21;402;423
17;Girona;28;Pla de l'Estany;17015;Banyoles;2;1;B;;684;227;371;475;209;9;12;454;466
17;Girona;28;Pla de l'Estany;17015;Banyoles;2;2;U;;887;262;500;625;262;9;25;591;616
17;Girona;28;Pla de l'Estany;17015;Banyoles;2;3;A;;628;166;347;415;213;3;16;396;412
17;Girona;28;Pla de l'Estany;17015;Banyoles;2;3;B;;670;210;391;456;214;3;8;445;453
17;Girona;28;Pla de l'Estany;17015;Banyoles;2;4;U;;550;154;307;380;170;5;11;364;375
17;Girona;28;Pla de l'Estany;17015;Banyoles;2;5;U;;862;254;489;600;262;7;19;574;593
17;Girona;28;Pla de l'Estany;17015;Banyoles;3;1;A;;618;184;391;429;189;11;13;405;418
17;Girona;28;Pla de l'Estany;17015;Banyoles;3;1;B;;654;191;387;450;204;8;16;426;442
17;Girona;28;Pla de l'Estany;17015;Banyoles;3;2;U;;842;218;403;468;374;3;14;451;465
25;Lleida;27;Pla d'Urgell;25041;Barbens;1;1;U;;636;151;323;415;221;7;16;392;408
43;Tarragona;16;Conca de Barberà;43021;Barberà de la Conca;1;1;U;;387;76;167;218;169;0;14;204;218
8;Barcelona;40;Vallès Occidental;08252;Barberà del Vallès;1;1;A;;542;123;249;322;220;3;13;306;319
8;Barcelona;40;Vallès Occidental;08252;Barberà del Vallès;1;1;B;;669;142;284;382;287;4;12;366;378
8;Barcelona;40;Vallès Occidental;08252;Barberà del Vallès;1;1;C;;697;132;285;383;314;1;15;367;382
8;Barcelona;40;Vallès Occidental;08252;Barberà del Vallès;1;10;A;;526;122;253;311;215;1;9;301;310
8;Barcelona;40;Vallès Occidental;08252;Barberà del Vallès;1;10;B;;598;143;280;351;247;2;5;344;349
8;Barcelona;40;Vallès Occidental;08252;Barberà del Vallès;1;11;A;;702;156;357;441;261;4;10;427;437
8;Barcelona;40;Vallès Occidental;08252;Barberà del Vallès;1;11;B;;612;152;289;353;259;0;10;343;353
8;Barcelona;40;Vallès Occidental;08252;Barberà del Vallès;1;18;U;;811;136;290;371;440;0;7;364;371
8;Barcelona;40;Vallès Occidental;08252;Barberà del Vallès;1;19;A;;572;124;254;310;262;2;12;296;308
8;Barcelona;40;Vallès Occidental;08252;Barberà del Vallès;1;19;B;;459;97;207;256;203;2;12;242;254
8;Barcelona;40;Vallès Occidental;08252;Barberà del Vallès;1;2;U;;897;164;343;453;444;1;13;439;452
8;Barcelona;40;Vallès Occidental;08252;Barberà del Vallès;1;20;U;;787;162;314;402;385;1;14;387;401
8;Barcelona;40;Vallès Occidental;08252;Barberà del Vallès;1;21;A;;502;96;216;286;216;1;14;271;285
8;Barcelona;40;Vallès Occidental;08252;Barberà del Vallès;1;21;B;;469;94;207;278;191;5;4;269;273
8;Barcelona;40;Vallès Occidental;08252;Barberà del Vallès;1;22;A;;865;183;383;531;334;3;16;512;528
8;Barcelona;40;Vallès Occidental;08252;Barberà del Vallès;1;22;B;;804;178;373;495;309;0;17;478;495
8;Barcelona;40;Vallès Occidental;08252;Barberà del Vallès;1;23;U;;639;157;300;396;243;2;7;387;394
8;Barcelona;40;Vallès Occidental;08252;Barberà del Vallès;1;24;U;;730;172;303;383;347;2;18;363;381
8;Barcelona;40;Vallès Occidental;08252;Barberà del Vallès;1;25;U;;822;179;343;445;377;3;13;429;442
8;Barcelona;40;Vallès Occidental;08252;Barberà del Vallès;1;26;A;;882;200;416;514;368;4;14;496;510
8;Barcelona;40;Vallès Occidental;08252;Barberà del Vallès;1;26;B;;724;164;333;409;315;1;14;394;408
8;Barcelona;40;Vallès Occidental;08252;Barberà del Vallès;1;27;A;;609;122;283;374;235;3;12;359;371
8;Barcelona;40;Vallès Occidental;08252;Barberà del Vallès;1;27;B;;730;186;364;458;272;2;14;442;456
8;Barcelona;40;Vallès Occidental;08252;Barberà del Vallès;1;27;C;;693;148;332;430;263;2;11;417;428
8;Barcelona;40;Vallès Occidental;08252;Barberà del Vallès;1;28;A;;586;133;247;334;252;0;12;322;334
8;Barcelona;40;Vallès Occidental;08252;Barberà del Vallès;1;28;B;;555;105;235;309;246;1;20;288;308
8;Barcelona;40;Vallès Occidental;08252;Barberà del Vallès;1;3;A;;597;109;229;297;300;2;8;287;295
8;Barcelona;40;Vallès Occidental;08252;Barberà del Vallès;1;3;B;;522;93;195;244;278;2;8;234;242
8;Barcelona;40;Vallès Occidental;08252;Barberà del Vallès;1;4;A;;537;122;236;293;244;2;7;284;291
8;Barcelona;40;Vallès Occidental;08252;Barberà del Vallès;1;4;B;;541;117;247;313;228;1;14;298;312
8;Barcelona;40;Vallès Occidental;08252;Barberà del Vallès;1;5;A;;540;130;230;287;253;3;2;282;284
8;Barcelona;40;Vallès Occidental;08252;Barberà del Vallès;1;5;B;;515;101;218;269;246;3;4;262;266
8;Barcelona;40;Vallès Occidental;08252;Barberà del Vallès;1;6;U;;829;189;355;447;382;8;17;422;439
8;Barcelona;40;Vallès Occidental;08252;Barberà del Vallès;1;7;U;;719;165;327;445;274;3;18;424;442
8;Barcelona;40;Vallès Occidental;08252;Barberà del Vallès;1;8;A;;535;118;200;254;281;8;1;245;246
8;Barcelona;40;Vallès Occidental;08252;Barberà del Vallès;1;8;B;;453;89;169;227;226;1;9;217;226
8;Barcelona;40;Vallès Occidental;08252;Barberà del Vallès;1;9;U;;641;136;267;360;281;0;8;352;360
8;Barcelona;13;Barcelonès;08019;Barcelona;1;1;U;;677;161;288;336;341;3;13;320;333
8;Barcelona;13;Barcelonès;08019;Barcelona;1;10;U;;922;177;317;385;537;2;8;375;383
8;Barcelona;13;Barcelonès;08019;Barcelona;1;11;A;;715;122;225;276;439;1;11;264;275
8;Barcelona;13;Barcelonès;08019;Barcelona;1;11;B;;610;121;246;260;350;2;6;252;258
8;Barcelona;13;Barcelonès;08019;Barcelona;1;12;U;;938;221;411;476;462;2;21;453;474
8;Barcelona;13;Barcelonès;08019;Barcelona;1;13;U;;773;182;356;417;356;5;10;402;412
8;Barcelona;13;Barcelonès;08019;Barcelona;1;14;U;;909;185;360;424;485;3;12;409;421
8;Barcelona;13;Barcelonès;08019;Barcelona;1;15;U;;1078;235;433;504;574;6;10;488;498
8;Barcelona;13;Barcelonès;08019;Barcelona;1;16;U;;931;186;346;411;520;2;6;403;409
8;Barcelona;13;Barcelonès;08019;Barcelona;1;17;U;;1025;195;355;438;587;3;5;430;435
8;Barcelona;13;Barcelonès;08019;Barcelona;1;18;U;;736;178;324;385;351;3;15;367;382
8;Barcelona;13;Barcelonès;08019;Barcelona;1;19;U;;1244;258;450;534;710;6;13;515;528
8;Barcelona;13;Barcelonès;08019;Barcelona;1;2;U;;704;126;236;291;413;3;4;284;288
8;Barcelona;13;Barcelonès;08019;Barcelona;1;20;A;;673;151;319;390;283;2;11;377;388
8;Barcelona;13;Barcelonès;08019;Barcelona;1;20;B;;669;145;327;400;269;7;13;380;393
8;Barcelona;13;Barcelonès;08019;Barcelona;1;21;U;;1217;292;529;668;549;4;24;640;664
8;Barcelona;13;Barcelonès;08019;Barcelona;1;22;U;;808;203;401;504;304;6;10;488;498
8;Barcelona;13;Barcelonès;08019;Barcelona;1;23;U;;1007;248;469;561;446;2;19;540;559
8;Barcelona;13;Barcelonès;08019;Barcelona;1;24;U;;753;71;138;167;586;0;2;165;167
8;Barcelona;13;Barcelonès;08019;Barcelona;1;25;U;;785;186;331;400;385;3;13;384;397
8;Barcelona;13;Barcelonès;08019;Barcelona;1;26;U;;989;202;365;447;542;0;12;435;447
8;Barcelona;13;Barcelonès;08019;Barcelona;1;27;U;;927;220;390;479;448;5;19;455;474
8;Barcelona;13;Barcelonès;08019;Barcelona;1;28;U;;1134;205;437;527;607;5;19;503;522
8;Barcelona;13;Barcelonès;08019;Barcelona;1;29;U;;713;131;286;354;359;2;16;336;352
8;Barcelona;13;Barcelonès;08019;Barcelona;1;3;A;;741;152;261;305;436;0;9;296;305
8;Barcelona;13;Barcelonès;08019;Barcelona;1;3;B;;702;172;277;327;375;5;8;314;322
8;Barcelona;13;Barcelonès;08019;Barcelona;1;30;A;;749;134;252;305;444;0;0;305;305
8;Barcelona;13;Barcelonès;08019;Barcelona;1;30;B;;690;144;273;331;359;3;13;315;328
8;Barcelona;13;Barcelonès;08019;Barcelona;1;31;U;;833;135;321;403;430;4;18;381;399
8;Barcelona;13;Barcelonès;08019;Barcelona;1;32;U;;1216;207;470;581;635;7;18;556;574
8;Barcelona;13;Barcelonès;08019;Barcelona;1;33;U;;701;148;249;293;408;10;4;279;283
8;Barcelona;13;Barcelonès;08019;Barcelona;1;34;U;;681;139;228;285;396;8;7;270;277
8;Barcelona;13;Barcelonès;08019;Barcelona;1;35;U;;835;187;286;336;499;7;6;323;329
8;Barcelona;13;Barcelonès;08019;Barcelona;1;36;U;;865;232;355;410;455;8;14;388;402
8;Barcelona;13;Barcelonès;08019;Barcelona;1;37;U;;976;294;362;435;541;7;6;422;428
8;Barcelona;13;Barcelonès;08019;Barcelona;1;38;U;;836;179;325;392;444;7;14;371;385
8;Barcelona;13;Barcelonès;08019;Barcelona;1;39;U;;948;240;389;449;499;4;28;417;445
8;Barcelona;13;Barcelonès;08019;Barcelona;1;4;A;;766;7;297;355;411;4;1;350;351
8;Barcelona;13;Barcelonès;08019;Barcelona;1;4;B;;710;155;285;360;350;2;10;348;358
8;Barcelona;13;Barcelonès;08019;Barcelona;1;40;U;;724;210;342;389;335;13;8;368;376
8;Barcelona;13;Barcelonès;08019;Barcelona;1;41;U;;854;155;291;335;519;0;0;335;335
8;Barcelona;13;Barcelonès;08019;Barcelona;1;42;A;;713;170;312;367;346;2;13;352;365
8;Barcelona;13;Barcelonès;08019;Barcelona;1;42;B;;647;160;260;317;330;4;12;301;313
8;Barcelona;13;Barcelonès;08019;Barcelona;1;43;U;;678;164;314;389;289;1;9;379;388
8;Barcelona;13;Barcelonès;08019;Barcelona;1;44;U;;882;183;382;467;415;1;23;443;466
8;Barcelona;13;Barcelonès;08019;Barcelona;1;45;U;;1162;240;432;567;595;21;2;544;546
8;Barcelona;13;Barcelonès;08019;Barcelona;1;46;U;;989;245;409;501;488;0;15;486;501
8;Barcelona;13;Barcelonès;08019;Barcelona;1;47;U;;1050;206;356;509;541;10;13;486;499
8;Barcelona;13;Barcelonès;08019;Barcelona;1;48;U;;1189;233;541;520;669;3;12;505;517
8;Barcelona;13;Barcelonès;08019;Barcelona;1;49;U;;848;202;399;482;366;3;21;458;479
8;Barcelona;13;Barcelonès;08019;Barcelona;1;5;U;;1229;217;397;476;753;4;12;460;472
8;Barcelona;13;Barcelonès;08019;Barcelona;1;50;U;;887;229;395;475;412;2;13;460;473
8;Barcelona;13;Barcelonès;08019;Barcelona;1;51;U;;927;208;364;427;500;5;12;410;422
8;Barcelona;13;Barcelonès;08019;Barcelona;1;52;A;;694;180;325;405;289;4;13;388;401
8;Barcelona;13;Barcelonès;08019;Barcelona;1;52;B;;609;156;319;387;222;4;15;368;383
8;Barcelona;13;Barcelonès;08019;Barcelona;1;53;U;;1190;275;492;580;610;6;14;560;574
8;Barcelona;13;Barcelonès;08019;Barcelona;1;54;U;;740;176;311;374;366;4;8;362;370
8;Barcelona;13;Barcelonès;08019;Barcelona;1;55;U;;925;242;459;587;338;2;17;568;585
8;Barcelona;13;Barcelonès;08019;Barcelona;1;6;U;;788;140;255;314;474;0;6;308;314
8;Barcelona;13;Barcelonès;08019;Barcelona;1;7;U;;827;118;230;305;522;0;12;293;305
8;Barcelona;13;Barcelonès;08019;Barcelona;1;8;U;;1131;169;312;357;774;7;10;340;350
8;Barcelona;13;Barcelonès;08019;Barcelona;1;9;U;;1013;260;319;472;541;2;7;463;470
8;Barcelona;13;Barcelonès;08019;Barcelona;10;1;U;;1136;292;515;649;487;1;19;629;648
8;Barcelona;13;Barcelonès;08019;Barcelona;10;10;A;;671;166;331;401;270;3;13;385;398
8;Barcelona;13;Barcelonès;08019;Barcelona;10;10;B;;611;161;310;389;222;2;11;376;387
8;Barcelona;13;Barcelonès;08019;Barcelona;10;100;U;;1183;275;704;714;469;6;21;687;708
8;Barcelona;13;Barcelonès;08019;Barcelona;10;101;A;;685;187;300;371;314;0;9;362;371
8;Barcelona;13;Barcelonès;08019;Barcelona;10;101;B;;691;157;282;356;335;2;12;342;354
8;Barcelona;13;Barcelonès;08019;Barcelona;10;102;A;;1064;249;488;590;474;2;24;564;588
8;Barcelona;13;Barcelonès;08019;Barcelona;10;102;B;;927;233;444;549;378;2;13;534;547
8;Barcelona;13;Barcelonès;08019;Barcelona;10;103;A;;998;272;536;652;346;3;26;623;649
8;Barcelona;13;Barcelonès;08019;Barcelona;10;103;B;;842;247;468;561;281;7;21;533;554
8;Barcelona;13;Barcelonès;08019;Barcelona;10;104;A;;828;199;416;530;298;3;22;505;527
8;Barcelona;13;Barcelonès;08019;Barcelona;10;104;B;;635;137;333;418;217;2;11;405;416
8;Barcelona;13;Barcelonès;08019;Barcelona;10;105;A;;854;202;421;499;355;3;22;474;496
8;Barcelona;13;Barcelonès;08019;Barcelona;10;105;B;;823;196;417;519;304;3;10;506;516
8;Barcelona;13;Barcelonès;08019;Barcelona;10;106;U;;834;211;436;543;291;3;15;525;540
8;Barcelona;13;Barcelonès;08019;Barcelona;10;107;U;;1163;302;574;739;424;0;29;710;739
8;Barcelona;13;Barcelonès;08019;Barcelona;10;108;U;;1141;291;562;688;453;11;11;666;677
8;Barcelona;13;Barcelonès;08019;Barcelona;10;109;U;;1196;300;625;751;445;6;15;730;745
8;Barcelona;13;Barcelonès;08019;Barcelona;10;11;U;;963;246;487;592;371;3;18;571;589
8;Barcelona;13;Barcelonès;08019;Barcelona;10;110;A;;649;194;340;402;247;0;14;388;402
8;Barcelona;13;Barcelonès;08019;Barcelona;10;110;B;;609;165;281;381;228;3;10;368;378
8;Barcelona;13;Barcelonès;08019;Barcelona;10;111;U;;1024;280;531;624;400;2;18;604;622
8;Barcelona;13;Barcelonès;08019;Barcelona;10;112;A;;678;200;362;461;217;3;21;437;458
8;Barcelona;13;Barcelonès;08019;Barcelona;10;112;B;;631;160;315;427;204;3;19;405;424
8;Barcelona;13;Barcelonès;08019;Barcelona;10;113;U;;841;185;385;486;355;3;12;471;483
8;Barcelona;13;Barcelonès;08019;Barcelona;10;114;U;;1021;235;445;506;515;1;11;494;505
8;Barcelona;13;Barcelonès;08019;Barcelona;10;115;U;;1111;225;480;581;530;1;17;563;580
8;Barcelona;13;Barcelonès;08019;Barcelona;10;116;A;;691;183;317;385;306;0;21;364;385
8;Barcelona;13;Barcelonès;08019;Barcelona;10;116;B;;690;172;321;386;304;2;6;378;384
8;Barcelona;13;Barcelonès;08019;Barcelona;10;117;U;;1018;214;468;582;436;1;13;568;581
8;Barcelona;13;Barcelonès;08019;Barcelona;10;118;U;;814;212;434;553;261;2;15;536;551
8;Barcelona;13;Barcelonès;08019;Barcelona;10;119;U;;893;223;430;520;373;13;36;471;507
8;Barcelona;13;Barcelonès;08019;Barcelona;10;12;A;;700;182;379;480;220;0;17;463;480
8;Barcelona;13;Barcelonès;08019;Barcelona;10;12;B;;644;195;343;424;220;6;15;403;418
8;Barcelona;13;Barcelonès;08019;Barcelona;10;120;U;;1083;226;517;619;464;2;20;597;617
8;Barcelona;13;Barcelonès;08019;Barcelona;10;121;U;;1116;232;526;656;460;6;25;625;650
8;Barcelona;13;Barcelonès;08019;Barcelona;10;122;A;;682;183;384;486;196;2;21;463;484
8;Barcelona;13;Barcelonès;08019;Barcelona;10;122;B;;595;182;347;410;185;2;14;394;408
8;Barcelona;13;Barcelonès;08019;Barcelona;10;123;U;;1076;213;524;685;391;2;21;662;683
8;Barcelona;13;Barcelonès;08019;Barcelona;10;124;U;;909;207;413;536;373;2;23;511;534
8;Barcelona;13;Barcelonès;08019;Barcelona;10;125;U;;892;227;438;519;373;3;13;503;516
8;Barcelona;13;Barcelonès;08019;Barcelona;10;126;U;;903;206;458;580;323;3;26;551;577
8;Barcelona;13;Barcelonès;08019;Barcelona;10;127;U;;740;160;367;470;270;0;30;440;470
8;Barcelona;13;Barcelonès;08019;Barcelona;10;128;A;;700;177;342;441;259;3;12;426;438
8;Barcelona;13;Barcelonès;08019;Barcelona;10;128;B;;665;157;322;436;229;5;10;421;431
8;Barcelona;13;Barcelonès;08019;Barcelona;10;129;U;;996;231;492;634;362;2;26;606;632
8;Barcelona;13;Barcelonès;08019;Barcelona;10;13;U;;1046;282;577;700;346;4;21;675;696
8;Barcelona;13;Barcelonès;08019;Barcelona;10;130;U;;953;272;501;612;341;2;20;590;610
8;Barcelona;13;Barcelonès;08019;Barcelona;10;131;U;;990;203;493;654;336;4;18;632;650
8;Barcelona;13;Barcelonès;08019;Barcelona;10;132;U;;980;214;416;630;350;9;24;597;621
8;Barcelona;13;Barcelonès;08019;Barcelona;10;133;A;;717;212;371;431;286;1;16;414;430
8;Barcelona;13;Barcelonès;08019;Barcelona;10;133;B;;587;199;325;390;197;1;7;382;389
8;Barcelona;13;Barcelonès;08019;Barcelona;10;134;A;;659;213;355;428;231;3;4;421;425
8;Barcelona;13;Barcelonès;08019;Barcelona;10;134;B;;593;194;338;391;202;0;11;380;391
8;Barcelona;13;Barcelonès;08019;Barcelona;10;135;U;;942;294;439;533;409;3;7;523;530
8;Barcelona;13;Barcelonès;08019;Barcelona;10;136;U;;1120;240;550;683;437;0;14;669;683
8;Barcelona;13;Barcelonès;08019;Barcelona;10;137;A;;645;124;259;318;327;1;12;305;317
8;Barcelona;13;Barcelonès;08019;Barcelona;10;137;B;;609;112;227;286;323;1;4;281;285
8;Barcelona;13;Barcelonès;08019;Barcelona;10;138;U;;1119;200;400;473;646;3;14;456;470
8;Barcelona;13;Barcelonès;08019;Barcelona;10;139;U;;1202;327;526;623;579;3;15;605;620
8;Barcelona;13;Barcelonès;08019;Barcelona;10;14;U;;1016;289;524;648;368;8;40;600;640
8;Barcelona;13;Barcelonès;08019;Barcelona;10;140;U;;1213;249;512;616;597;2;25;589;614
8;Barcelona;13;Barcelonès;08019;Barcelona;10;141;U;;891;223;376;438;453;4;13;421;434
8;Barcelona;13;Barcelonès;08019;Barcelona;10;142;U;;1190;272;512;582;608;3;7;572;579
8;Barcelona;13;Barcelonès;08019;Barcelona;10;143;A;;676;156;311;374;302;2;7;365;372
8;Barcelona;13;Barcelonès;08019;Barcelona;10;143;B;;609;146;255;323;286;2;8;313;321
8;Barcelona;13;Barcelonès;08019;Barcelona;10;15;A;;678;182;356;432;246;3;15;414;429
8;Barcelona;13;Barcelonès;08019;Barcelona;10;15;B;;641;180;358;430;211;4;15;411;426
8;Barcelona;13;Barcelonès;08019;Barcelona;10;16;U;;955;216;460;607;348;2;19;586;605
8;Barcelona;13;Barcelonès;08019;Barcelona;10;17;U;;1244;410;651;805;439;3;28;774;802
8;Barcelona;13;Barcelonès;08019;Barcelona;10;18;U;;939;201;432;555;384;5;11;539;550
8;Barcelona;13;Barcelonès;08019;Barcelona;10;19;U;;1255;326;650;827;428;7;36;784;820
8;Barcelona;13;Barcelonès;08019;Barcelona;10;2;A;;669;189;346;428;241;1;15;412;427
8;Barcelona;13;Barcelonès;08019;Barcelona;10;2;B;;628;160;296;376;252;10;2;364;366
8;Barcelona;13;Barcelonès;08019;Barcelona;10;20;U;;1131;259;542;626;505;7;27;592;619
8;Barcelona;13;Barcelonès;08019;Barcelona;10;21;U;;981;308;426;639;342;2;18;619;637
8;Barcelona;13;Barcelonès;08019;Barcelona;10;22;U;;912;267;508;603;309;2;29;572;601
8;Barcelona;13;Barcelonès;08019;Barcelona;10;23;U;;1094;297;578;693;401;1;25;667;692
8;Barcelona;13;Barcelonès;08019;Barcelona;10;24;U;;1003;222;505;634;369;1;24;609;633
8;Barcelona;13;Barcelonès;08019;Barcelona;10;25;U;;969;249;483;614;355;7;20;587;607
8;Barcelona;13;Barcelonès;08019;Barcelona;10;26;U;;1054;250;525;655;399;9;22;624;646
8;Barcelona;13;Barcelonès;08019;Barcelona;10;27;U;;1194;280;627;777;417;3;26;748;774
8;Barcelona;13;Barcelonès;08019;Barcelona;10;28;A;;659;192;371;439;220;4;21;414;435
8;Barcelona;13;Barcelonès;08019;Barcelona;10;28;B;;618;155;321;387;231;0;15;372;387
8;Barcelona;13;Barcelonès;08019;Barcelona;10;29;U;;1112;241;526;682;430;2;30;650;680
8;Barcelona;13;Barcelonès;08019;Barcelona;10;3;U;;1046;305;566;680;366;1;17;662;679
8;Barcelona;13;Barcelonès;08019;Barcelona;10;30;A;;687;193;370;439;248;5;17;417;434
8;Barcelona;13;Barcelonès;08019;Barcelona;10;30;B;;661;187;373;440;221;0;19;421;440
8;Barcelona;13;Barcelonès;08019;Barcelona;10;31;U;;1145;296;584;730;415;7;34;689;723
8;Barcelona;13;Barcelonès;08019;Barcelona;10;32;U;;1042;255;546;689;353;1;40;648;688
8;Barcelona;13;Barcelonès;08019;Barcelona;10;33;U;;763;196;402;498;265;1;29;468;497
8;Barcelona;13;Barcelonès;08019;Barcelona;10;34;A;;743;243;398;482;261;3;20;459;479
8;Barcelona;13;Barcelonès;08019;Barcelona;10;34;B;;654;207;326;413;241;4;16;393;409
8;Barcelona;13;Barcelonès;08019;Barcelona;10;35;A;;794;180;380;476;318;1;21;454;475
8;Barcelona;13;Barcelonès;08019;Barcelona;10;35;B;;704;142;333;437;267;3;19;415;434
8;Barcelona;13;Barcelonès;08019;Barcelona;10;36;U;;963;219;515;654;309;3;23;628;651
8;Barcelona;13;Barcelonès;08019;Barcelona;10;37;A;;1204;242;521;680;524;5;26;649;675
8;Barcelona;13;Barcelonès;08019;Barcelona;10;37;B;;1089;231;481;594;495;0;25;569;594
8;Barcelona;13;Barcelonès;08019;Barcelona;10;38;U;;1180;270;577;738;442;1;39;698;737
8;Barcelona;13;Barcelonès;08019;Barcelona;10;39;U;;1109;251;520;675;434;11;27;637;664
8;Barcelona;13;Barcelonès;08019;Barcelona;10;4;U;;1097;273;567;725;372;3;20;702;722
8;Barcelona;13;Barcelonès;08019;Barcelona;10;40;A;;706;225;383;459;247;6;14;439;453
8;Barcelona;13;Barcelonès;08019;Barcelona;10;40;B;;581;175;318;368;213;3;14;351;365
8;Barcelona;13;Barcelonès;08019;Barcelona;10;41;U;;1131;283;602;720;411;1;31;688;719
8;Barcelona;13;Barcelonès;08019;Barcelona;10;42;U;;1006;213;397;474;532;2;15;457;472
8;Barcelona;13;Barcelonès;08019;Barcelona;10;43;U;;894;197;359;434;460;3;17;414;431
8;Barcelona;13;Barcelonès;08019;Barcelona;10;44;U;;1136;261;680;702;434;8;29;665;694
8;Barcelona;13;Barcelonès;08019;Barcelona;10;45;U;;923;241;534;648;275;2;24;622;646
8;Barcelona;13;Barcelonès;08019;Barcelona;10;46;U;;996;257;524;643;353;4;22;617;639
8;Barcelona;13;Barcelonès;08019;Barcelona;10;47;A;;708;177;360;467;241;2;18;447;465
8;Barcelona;13;Barcelonès;08019;Barcelona;10;47;B;;623;262;351;442;181;1;8;433;441
8;Barcelona;13;Barcelonès;08019;Barcelona;10;48;U;;1094;170;560;695;399;2;21;672;693
8;Barcelona;13;Barcelonès;08019;Barcelona;10;49;U;;987;267;542;634;353;4;30;600;630
8;Barcelona;13;Barcelonès;08019;Barcelona;10;5;U;;1241;318;648;809;432;5;28;776;804
8;Barcelona;13;Barcelonès;08019;Barcelona;10;50;U;;1224;344;658;813;411;6;38;769;807
8;Barcelona;13;Barcelonès;08019;Barcelona;10;51;U;;1062;292;589;751;311;2;25;724;749
8;Barcelona;13;Barcelonès;08019;Barcelona;10;52;A;;725;219;400;512;213;0;21;491;512
8;Barcelona;13;Barcelonès;08019;Barcelona;10;52;B;;688;212;420;505;183;2;33;470;503
8;Barcelona;13;Barcelonès;08019;Barcelona;10;53;U;;1179;330;744;919;260;4;38;877;915
8;Barcelona;13;Barcelonès;08019;Barcelona;10;54;U;;651;160;355;472;179;1;16;455;471
8;Barcelona;13;Barcelonès;08019;Barcelona;10;55;A;;812;205;464;607;205;2;28;577;605
8;Barcelona;13;Barcelonès;08019;Barcelona;10;55;B;;695;172;392;530;165;3;18;509;527
8;Barcelona;13;Barcelonès;08019;Barcelona;10;56;U;;1054;213;411;510;544;4;3;503;506
8;Barcelona;13;Barcelonès;08019;Barcelona;10;57;U;;932;200;506;490;442;4;21;465;486
8;Barcelona;13;Barcelonès;08019;Barcelona;10;58;U;;718;164;302;364;354;1;16;347;363
8;Barcelona;13;Barcelonès;08019;Barcelona;10;59;U;;1029;230;443;554;475;5;17;532;549
8;Barcelona;13;Barcelonès;08019;Barcelona;10;6;A;;692;194;377;442;250;1;15;426;441
8;Barcelona;13;Barcelonès;08019;Barcelona;10;6;B;;610;202;328;400;210;1;14;385;399
8;Barcelona;13;Barcelonès;08019;Barcelona;10;60;U;;950;240;453;569;381;2;18;549;567
8;Barcelona;13;Barcelonès;08019;Barcelona;10;61;U;;1220;334;706;874;346;7;25;842;867
8;Barcelona;13;Barcelonès;08019;Barcelona;10;62;U;;1054;287;613;743;311;8;17;718;735
8;Barcelona;13;Barcelonès;08019;Barcelona;10;63;U;;975;248;500;622;353;7;18;597;615
8;Barcelona;13;Barcelonès;08019;Barcelona;10;64;U;;1063;287;550;663;400;5;21;637;658
8;Barcelona;13;Barcelonès;08019;Barcelona;10;65;U;;1131;270;595;764;367;4;22;738;760
8;Barcelona;13;Barcelonès;08019;Barcelona;10;66;A;;752;218;390;484;268;0;22;462;484
8;Barcelona;13;Barcelonès;08019;Barcelona;10;66;B;;636;184;341;410;226;4;16;390;406
8;Barcelona;13;Barcelonès;08019;Barcelona;10;67;U;;1087;287;572;736;351;3;23;710;733
8;Barcelona;13;Barcelonès;08019;Barcelona;10;68;U;;1031;256;551;698;333;4;31;663;694
8;Barcelona;13;Barcelonès;08019;Barcelona;10;69;U;;1242;308;635;775;467;2;30;743;773
8;Barcelona;13;Barcelonès;08019;Barcelona;10;7;U;;1096;323;671;817;279;8;36;773;809
8;Barcelona;13;Barcelonès;08019;Barcelona;10;70;U;;1139;278;572;697;442;12;18;667;685
8;Barcelona;13;Barcelonès;08019;Barcelona;10;71;A;;682;171;333;431;251;1;18;412;430
8;Barcelona;13;Barcelonès;08019;Barcelona;10;71;B;;586;162;306;385;201;2;12;371;383
8;Barcelona;13;Barcelonès;08019;Barcelona;10;72;A;;691;158;320;394;297;0;16;378;394
8;Barcelona;13;Barcelonès;08019;Barcelona;10;72;B;;647;166;292;368;279;6;6;356;362
8;Barcelona;13;Barcelonès;08019;Barcelona;10;73;U;;1164;284;568;704;460;1;24;679;703
8;Barcelona;13;Barcelonès;08019;Barcelona;10;74;U;;1123;316;567;675;448;7;19;649;668
8;Barcelona;13;Barcelonès;08019;Barcelona;10;75;U;;1074;312;528;627;447;4;16;607;623
8;Barcelona;13;Barcelonès;08019;Barcelona;10;76;A;;1069;215;501;633;436;6;22;605;627
8;Barcelona;13;Barcelonès;08019;Barcelona;10;76;B;;1213;250;604;751;462;19;4;728;732
8;Barcelona;13;Barcelonès;08019;Barcelona;10;76;C;;1044;248;514;653;391;3;24;626;650
8;Barcelona;13;Barcelonès;08019;Barcelona;10;77;U;;1039;282;579;724;315;4;31;689;720
8;Barcelona;13;Barcelonès;08019;Barcelona;10;78;A;;665;175;373;490;175;3;23;464;487
8;Barcelona;13;Barcelonès;08019;Barcelona;10;78;B;;615;174;343;468;147;0;26;442;468
8;Barcelona;13;Barcelonès;08019;Barcelona;10;79;A;;636;156;311;389;247;1;12;376;388
8;Barcelona;13;Barcelonès;08019;Barcelona;10;79;B;;636;166;313;394;242;3;12;379;391
8;Barcelona;13;Barcelonès;08019;Barcelona;10;8;A;;667;219;365;439;228;5;15;419;434
8;Barcelona;13;Barcelonès;08019;Barcelona;10;8;B;;599;158;320;392;207;2;12;378;390
8;Barcelona;13;Barcelonès;08019;Barcelona;10;80;U;;999;212;507;661;338;1;10;650;660
8;Barcelona;13;Barcelonès;08019;Barcelona;10;81;U;;1242;246;503;579;663;1;17;561;578
8;Barcelona;13;Barcelonès;08019;Barcelona;10;82;U;;894;195;286;316;578;5;8;303;311
8;Barcelona;13;Barcelonès;08019;Barcelona;10;83;U;;924;194;328;383;541;0;6;377;383
8;Barcelona;13;Barcelonès;08019;Barcelona;10;84;U;;981;230;379;428;553;3;16;409;425
8;Barcelona;13;Barcelonès;08019;Barcelona;10;85;U;;1159;275;459;554;605;4;10;540;550
8;Barcelona;13;Barcelonès;08019;Barcelona;10;86;U;;1238;282;534;611;627;6;9;596;605
8;Barcelona;13;Barcelonès;08019;Barcelona;10;87;U;;1227;188;557;554;673;3;15;536;551
8;Barcelona;13;Barcelonès;08019;Barcelona;10;88;U;;1246;237;557;688;558;0;19;669;688
8;Barcelona;13;Barcelonès;08019;Barcelona;10;89;U;;1111;210;376;467;644;1;10;456;466
8;Barcelona;13;Barcelonès;08019;Barcelona;10;9;U;;1231;350;596;738;493;6;19;713;732
8;Barcelona;13;Barcelonès;08019;Barcelona;10;90;U;;987;225;400;487;500;3;20;464;484
8;Barcelona;13;Barcelonès;08019;Barcelona;10;91;A;;818;164;357;435;383;4;6;425;431
8;Barcelona;13;Barcelonès;08019;Barcelona;10;91;B;;665;182;299;358;307;0;16;342;358
8;Barcelona;13;Barcelonès;08019;Barcelona;10;92;A;;756;178;366;451;305;4;18;429;447
8;Barcelona;13;Barcelonès;08019;Barcelona;10;92;B;;621;147;302;355;266;0;15;340;355
8;Barcelona;13;Barcelonès;08019;Barcelona;10;93;U;;937;245;480;573;364;2;30;541;571
8;Barcelona;13;Barcelonès;08019;Barcelona;10;94;A;;793;160;332;415;378;2;10;403;413
8;Barcelona;13;Barcelonès;08019;Barcelona;10;94;B;;640;143;273;343;297;1;12;330;342
8;Barcelona;13;Barcelonès;08019;Barcelona;10;95;U;;736;149;261;317;419;1;14;302;316
8;Barcelona;13;Barcelonès;08019;Barcelona;10;96;U;;1024;304;558;711;313;0;23;688;711
8;Barcelona;13;Barcelonès;08019;Barcelona;10;97;U;;1057;285;544;662;395;7;21;634;655
8;Barcelona;13;Barcelonès;08019;Barcelona;10;98;A;;739;178;405;506;233;1;17;488;505
8;Barcelona;13;Barcelonès;08019;Barcelona;10;98;B;;681;171;344;414;267;3;19;392;411
8;Barcelona;13;Barcelonès;08019;Barcelona;10;99;U;;821;192;335;389;432;5;13;371;384
8;Barcelona;13;Barcelonès;08019;Barcelona;2;1;U;;806;233;442;521;285;2;18;501;519
8;Barcelona;13;Barcelonès;08019;Barcelona;2;10;U;;883;217;490;593;290;4;15;574;589
8;Barcelona;13;Barcelonès;08019;Barcelona;2;100;U;;1026;350;611;740;286;1;23;716;739
8;Barcelona;13;Barcelonès;08019;Barcelona;2;101;A;;782;248;422;515;267;5;13;497;510
8;Barcelona;13;Barcelonès;08019;Barcelona;2;101;B;;760;215;408;492;268;0;15;477;492
8;Barcelona;13;Barcelonès;08019;Barcelona;2;102;U;;997;280;577;737;260;4;25;708;733
8;Barcelona;13;Barcelonès;08019;Barcelona;2;103;U;;1204;312;620;761;443;5;26;730;756
8;Barcelona;13;Barcelonès;08019;Barcelona;2;104;U;;838;247;489;609;229;3;16;590;606
8;Barcelona;13;Barcelonès;08019;Barcelona;2;105;A;;744;192;384;475;269;1;14;460;474
8;Barcelona;13;Barcelonès;08019;Barcelona;2;105;B;;682;202;365;439;243;1;9;429;438
8;Barcelona;13;Barcelonès;08019;Barcelona;2;106;U;;978;243;550;683;295;7;20;656;676
8;Barcelona;13;Barcelonès;08019;Barcelona;2;107;U;;1200;325;750;904;296;4;22;878;900
8;Barcelona;13;Barcelonès;08019;Barcelona;2;108;U;;1149;298;631;819;330;1;18;800;818
8;Barcelona;13;Barcelonès;08019;Barcelona;2;109;A;;671;209;383;466;205;0;19;447;466
8;Barcelona;13;Barcelonès;08019;Barcelona;2;109;B;;751;203;446;558;193;0;21;537;558
8;Barcelona;13;Barcelonès;08019;Barcelona;2;11;U;;861;231;486;573;288;3;27;543;570
8;Barcelona;13;Barcelonès;08019;Barcelona;2;110;A;;650;169;345;431;219;4;12;415;427
8;Barcelona;13;Barcelonès;08019;Barcelona;2;110;B;;618;148;339;420;198;4;14;402;416
8;Barcelona;13;Barcelonès;08019;Barcelona;2;111;A;;695;164;341;442;253;2;10;430;440
8;Barcelona;13;Barcelonès;08019;Barcelona;2;111;B;;638;153;320;398;240;0;8;390;398
8;Barcelona;13;Barcelonès;08019;Barcelona;2;112;U;;1037;226;574;731;306;2;18;711;729
8;Barcelona;13;Barcelonès;08019;Barcelona;2;113;A;;744;190;437;544;200;8;5;531;536
8;Barcelona;13;Barcelonès;08019;Barcelona;2;113;B;;643;182;386;486;157;2;9;475;484
8;Barcelona;13;Barcelonès;08019;Barcelona;2;114;U;;1231;290;690;857;374;0;24;833;857
8;Barcelona;13;Barcelonès;08019;Barcelona;2;115;U;;957;252;531;646;311;4;17;625;642
8;Barcelona;13;Barcelonès;08019;Barcelona;2;116;U;;793;216;461;586;207;2;14;570;584
8;Barcelona;13;Barcelonès;08019;Barcelona;2;117;U;;905;244;519;646;259;0;24;622;646
8;Barcelona;13;Barcelonès;08019;Barcelona;2;118;U;;1074;276;609;771;303;0;20;751;771
8;Barcelona;13;Barcelonès;08019;Barcelona;2;119;U;;1019;302;612;739;280;7;33;699;732
8;Barcelona;13;Barcelonès;08019;Barcelona;2;12;U;;1093;275;571;702;391;2;12;688;700
8;Barcelona;13;Barcelonès;08019;Barcelona;2;120;U;;937;242;467;601;336;5;21;575;596
8;Barcelona;13;Barcelonès;08019;Barcelona;2;121;U;;961;280;535;662;299;2;17;643;660
8;Barcelona;13;Barcelonès;08019;Barcelona;2;122;U;;821;209;441;563;258;6;16;541;557
8;Barcelona;13;Barcelonès;08019;Barcelona;2;123;U;;814;213;417;536;278;2;16;518;534
8;Barcelona;13;Barcelonès;08019;Barcelona;2;124;U;;906;258;489;634;272;6;19;609;628
8;Barcelona;13;Barcelonès;08019;Barcelona;2;125;A;;701;192;396;490;211;5;24;461;485
8;Barcelona;13;Barcelonès;08019;Barcelona;2;125;B;;595;165;378;429;166;5;10;414;424
8;Barcelona;13;Barcelonès;08019;Barcelona;2;126;U;;1164;265;635;805;359;2;23;780;803
8;Barcelona;13;Barcelonès;08019;Barcelona;2;127;U;;831;234;409;512;319;0;15;497;512
8;Barcelona;13;Barcelonès;08019;Barcelona;2;128;U;;928;222;440;562;366;3;30;529;559
8;Barcelona;13;Barcelonès;08019;Barcelona;2;129;U;;1192;279;600;753;439;4;15;734;749
8;Barcelona;13;Barcelonès;08019;Barcelona;2;13;U;;814;202;403;493;321;6;19;468;487
8;Barcelona;13;Barcelonès;08019;Barcelona;2;130;U;;890;229;503;643;247;3;15;625;640
8;Barcelona;13;Barcelonès;08019;Barcelona;2;131;U;;846;296;466;549;297;2;21;526;547
8;Barcelona;13;Barcelonès;08019;Barcelona;2;132;U;;879;272;481;566;313;0;20;546;566
8;Barcelona;13;Barcelonès;08019;Barcelona;2;133;U;;747;224;421;505;242;4;13;488;501
8;Barcelona;13;Barcelonès;08019;Barcelona;2;134;U;;1145;282;575;746;399;0;25;721;746
8;Barcelona;13;Barcelonès;08019;Barcelona;2;135;A;;800;188;377;485;315;21;4;460;464
8;Barcelona;13;Barcelonès;08019;Barcelona;2;135;B;;706;152;330;416;290;3;13;400;413
8;Barcelona;13;Barcelonès;08019;Barcelona;2;136;U;;732;178;367;511;221;6;12;493;505
8;Barcelona;13;Barcelonès;08019;Barcelona;2;137;U;;1011;294;539;632;379;18;1;613;614
8;Barcelona;13;Barcelonès;08019;Barcelona;2;138;A;;707;192;393;508;199;2;16;490;506
8;Barcelona;13;Barcelonès;08019;Barcelona;2;138;B;;685;191;409;493;192;1;24;468;492
8;Barcelona;13;Barcelonès;08019;Barcelona;2;139;U;;1149;273;569;678;471;5;20;653;673
8;Barcelona;13;Barcelonès;08019;Barcelona;2;14;U;;806;198;375;451;355;3;13;435;448
8;Barcelona;13;Barcelonès;08019;Barcelona;2;140;A;;746;194;412;519;227;4;12;503;515
8;Barcelona;13;Barcelonès;08019;Barcelona;2;140;B;;659;205;390;485;174;3;19;463;482
8;Barcelona;13;Barcelonès;08019;Barcelona;2;141;U;;872;200;432;567;305;4;23;540;563
8;Barcelona;13;Barcelonès;08019;Barcelona;2;142;A;;703;172;354;434;269;0;21;413;434
8;Barcelona;13;Barcelonès;08019;Barcelona;2;142;B;;596;166;313;382;214;1;17;364;381
8;Barcelona;13;Barcelonès;08019;Barcelona;2;143;U;;924;247;525;623;301;2;28;593;621
8;Barcelona;13;Barcelonès;08019;Barcelona;2;144;U;;1045;250;574;721;324;4;26;691;717
8;Barcelona;13;Barcelonès;08019;Barcelona;2;145;U;;845;204;418;519;326;4;15;500;515
8;Barcelona;13;Barcelonès;08019;Barcelona;2;146;U;;851;255;434;525;326;3;19;503;522
8;Barcelona;13;Barcelonès;08019;Barcelona;2;147;A;;762;230;426;507;255;6;10;491;501
8;Barcelona;13;Barcelonès;08019;Barcelona;2;147;B;;716;197;381;469;247;1;15;453;468
8;Barcelona;13;Barcelonès;08019;Barcelona;2;148;U;;1169;249;668;809;360;4;21;784;805
8;Barcelona;13;Barcelonès;08019;Barcelona;2;149;U;;1235;340;653;794;441;8;30;756;786
8;Barcelona;13;Barcelonès;08019;Barcelona;2;15;U;;1095;299;554;679;416;5;33;641;674
8;Barcelona;13;Barcelonès;08019;Barcelona;2;150;U;;991;239;479;599;392;1;15;583;598
8;Barcelona;13;Barcelonès;08019;Barcelona;2;151;U;;987;272;493;612;375;18;3;591;594
8;Barcelona;13;Barcelonès;08019;Barcelona;2;152;U;;977;252;519;679;298;5;24;650;674
8;Barcelona;13;Barcelonès;08019;Barcelona;2;153;U;;1001;328;589;698;303;4;22;672;694
8;Barcelona;13;Barcelonès;08019;Barcelona;2;154;U;;709;212;365;433;276;3;17;413;430
8;Barcelona;13;Barcelonès;08019;Barcelona;2;155;A;;719;195;355;457;262;4;10;443;453
8;Barcelona;13;Barcelonès;08019;Barcelona;2;155;B;;638;183;324;400;238;3;11;386;397
8;Barcelona;13;Barcelonès;08019;Barcelona;2;156;U;;989;290;522;648;341;0;18;630;648
8;Barcelona;13;Barcelonès;08019;Barcelona;2;157;U;;839;240;446;546;293;9;20;517;537
8;Barcelona;13;Barcelonès;08019;Barcelona;2;158;A;;689;214;379;458;231;1;17;440;457
8;Barcelona;13;Barcelonès;08019;Barcelona;2;158;B;;591;170;324;404;187;2;8;394;402
8;Barcelona;13;Barcelonès;08019;Barcelona;2;159;A;;727;247;413;510;217;3;9;498;507
8;Barcelona;13;Barcelonès;08019;Barcelona;2;159;B;;597;164;341;419;178;4;10;405;415
8;Barcelona;13;Barcelonès;08019;Barcelona;2;16;A;;716;188;400;479;237;3;9;467;476
8;Barcelona;13;Barcelonès;08019;Barcelona;2;16;B;;647;179;369;444;203;3;16;425;441
8;Barcelona;13;Barcelonès;08019;Barcelona;2;160;A;;766;191;429;538;228;0;34;504;538
8;Barcelona;13;Barcelonès;08019;Barcelona;2;160;B;;695;172;354;445;250;1;26;418;444
8;Barcelona;13;Barcelonès;08019;Barcelona;2;161;U;;796;235;444;527;269;1;8;518;526
8;Barcelona;13;Barcelonès;08019;Barcelona;2;162;U;;955;228;517;593;362;3;16;574;590
8;Barcelona;13;Barcelonès;08019;Barcelona;2;163;A;;647;173;353;415;232;2;7;406;413
8;Barcelona;13;Barcelonès;08019;Barcelona;2;163;B;;648;184;361;432;216;3;5;424;429
8;Barcelona;13;Barcelonès;08019;Barcelona;2;164;U;;954;275;493;625;329;0;19;606;625
8;Barcelona;13;Barcelonès;08019;Barcelona;2;165;U;;1141;241;567;713;428;6;14;693;707
8;Barcelona;13;Barcelonès;08019;Barcelona;2;166;A;;790;208;426;510;280;2;15;493;508
8;Barcelona;13;Barcelonès;08019;Barcelona;2;166;B;;669;175;347;427;242;1;16;410;426
8;Barcelona;13;Barcelonès;08019;Barcelona;2;167;A;;809;218;436;548;261;1;16;531;547
8;Barcelona;13;Barcelonès;08019;Barcelona;2;167;B;;686;196;196;466;220;4;15;447;462
8;Barcelona;13;Barcelonès;08019;Barcelona;2;168;A;;838;228;382;525;313;3;20;502;522
8;Barcelona;13;Barcelonès;08019;Barcelona;2;168;B;;678;194;341;416;262;2;6;408;414
8;Barcelona;13;Barcelonès;08019;Barcelona;2;169;U;;1115;273;561;675;440;3;37;635;672
8;Barcelona;13;Barcelonès;08019;Barcelona;2;17;A;;693;194;391;476;217;3;10;463;473
8;Barcelona;13;Barcelonès;08019;Barcelona;2;17;B;;675;182;366;473;202;1;16;456;472
8;Barcelona;13;Barcelonès;08019;Barcelona;2;170;U;;1205;310;605;748;457;6;29;713;742
8;Barcelona;13;Barcelonès;08019;Barcelona;2;171;U;;1153;270;547;702;451;5;27;670;697
8;Barcelona;13;Barcelonès;08019;Barcelona;2;172;U;;1102;253;550;637;465;7;16;614;630
8;Barcelona;13;Barcelonès;08019;Barcelona;2;173;U;;1153;294;562;694;459;5;11;678;689
8;Barcelona;13;Barcelonès;08019;Barcelona;2;18;A;;737;200;447;527;210;3;12;512;524
8;Barcelona;13;Barcelonès;08019;Barcelona;2;18;B;;654;210;389;469;185;2;19;448;467
8;Barcelona;13;Barcelonès;08019;Barcelona;2;19;A;;726;221;423;510;216;4;14;492;506
8;Barcelona;13;Barcelonès;08019;Barcelona;2;19;B;;649;176;327;437;212;2;12;423;435
8;Barcelona;13;Barcelonès;08019;Barcelona;2;2;A;;674;191;333;430;244;2;15;413;428
8;Barcelona;13;Barcelonès;08019;Barcelona;2;2;B;;601;178;338;396;205;1;11;384;395
8;Barcelona;13;Barcelonès;08019;Barcelona;2;20;U;;960;263;468;575;385;2;20;553;573
8;Barcelona;13;Barcelonès;08019;Barcelona;2;21;U;;1085;305;554;667;418;2;15;650;665
8;Barcelona;13;Barcelonès;08019;Barcelona;2;22;U;;848;248;458;566;282;1;22;543;565
8;Barcelona;13;Barcelonès;08019;Barcelona;2;23;U;;869;240;458;566;303;2;20;544;564
8;Barcelona;13;Barcelonès;08019;Barcelona;2;24;U;;839;209;433;529;310;0;19;510;529
8;Barcelona;13;Barcelonès;08019;Barcelona;2;25;U;;886;236;498;571;315;1;17;553;570
8;Barcelona;13;Barcelonès;08019;Barcelona;2;26;A;;805;234;453;548;257;4;16;528;544
8;Barcelona;13;Barcelonès;08019;Barcelona;2;26;B;;717;173;374;469;248;4;17;448;465
8;Barcelona;13;Barcelonès;08019;Barcelona;2;27;A;;820;218;447;553;267;6;9;538;547
8;Barcelona;13;Barcelonès;08019;Barcelona;2;27;B;;733;220;403;500;233;4;17;479;496
8;Barcelona;13;Barcelonès;08019;Barcelona;2;28;A;;763;222;409;467;296;7;24;436;460
8;Barcelona;13;Barcelonès;08019;Barcelona;2;28;B;;695;182;380;454;241;2;21;431;452
8;Barcelona;13;Barcelonès;08019;Barcelona;2;29;U;;875;248;461;562;313;2;23;537;560
8;Barcelona;13;Barcelonès;08019;Barcelona;2;3;U;;883;251;464;578;305;1;17;560;577
8;Barcelona;13;Barcelonès;08019;Barcelona;2;30;U;;920;238;486;585;335;3;29;553;582
8;Barcelona;13;Barcelonès;08019;Barcelona;2;31;U;;825;234;468;568;257;8;20;540;560
8;Barcelona;13;Barcelonès;08019;Barcelona;2;32;U;;1042;278;509;589;453;2;19;568;587
8;Barcelona;13;Barcelonès;08019;Barcelona;2;33;U;;866;236;462;563;303;1;15;547;562
8;Barcelona;13;Barcelonès;08019;Barcelona;2;34;U;;849;239;414;516;333;2;17;497;514
8;Barcelona;13;Barcelonès;08019;Barcelona;2;35;U;;994;272;548;662;332;9;20;633;653
8;Barcelona;13;Barcelonès;08019;Barcelona;2;36;U;;893;262;498;621;272;4;36;581;617
8;Barcelona;13;Barcelonès;08019;Barcelona;2;37;U;;937;265;509;651;286;6;27;618;645
8;Barcelona;13;Barcelonès;08019;Barcelona;2;38;U;;1175;312;673;833;342;2;32;799;831
8;Barcelona;13;Barcelonès;08019;Barcelona;2;39;A;;646;160;332;393;253;3;13;377;390
8;Barcelona;13;Barcelonès;08019;Barcelona;2;39;B;;611;175;315;378;233;1;12;365;377
8;Barcelona;13;Barcelonès;08019;Barcelona;2;4;U;;986;254;550;672;314;16;7;649;656
8;Barcelona;13;Barcelonès;08019;Barcelona;2;40;U;;1082;279;494;623;459;4;18;601;619
8;Barcelona;13;Barcelonès;08019;Barcelona;2;41;A;;711;177;351;429;282;1;16;412;428
8;Barcelona;13;Barcelonès;08019;Barcelona;2;41;B;;622;160;304;380;242;1;9;370;379
8;Barcelona;13;Barcelonès;08019;Barcelona;2;42;A;;706;192;396;491;215;5;10;476;486
8;Barcelona;13;Barcelonès;08019;Barcelona;2;42;B;;630;179;369;444;186;2;12;430;442
8;Barcelona;13;Barcelonès;08019;Barcelona;2;43;U;;1081;305;618;745;336;4;24;717;741
8;Barcelona;13;Barcelonès;08019;Barcelona;2;44;U;;865;266;472;587;278;5;21;561;582
8;Barcelona;13;Barcelonès;08019;Barcelona;2;45;U;;893;226;480;588;305;18;4;566;570
8;Barcelona;13;Barcelonès;08019;Barcelona;2;46;A;;710;199;369;442;268;1;14;427;441
8;Barcelona;13;Barcelonès;08019;Barcelona;2;46;B;;668;200;363;422;246;4;17;401;418
8;Barcelona;13;Barcelonès;08019;Barcelona;2;47;A;;681;180;363;466;215;2;13;451;464
8;Barcelona;13;Barcelonès;08019;Barcelona;2;47;B;;677;203;388;490;187;3;14;473;487
8;Barcelona;13;Barcelonès;08019;Barcelona;2;48;U;;797;239;445;523;274;4;16;503;519
8;Barcelona;13;Barcelonès;08019;Barcelona;2;49;A;;787;192;388;484;303;5;17;462;479
8;Barcelona;13;Barcelonès;08019;Barcelona;2;49;B;;701;163;347;409;292;2;12;395;407
8;Barcelona;13;Barcelonès;08019;Barcelona;2;5;A;;831;223;488;594;237;3;12;579;591
8;Barcelona;13;Barcelonès;08019;Barcelona;2;5;B;;725;190;433;531;194;0;12;519;531
8;Barcelona;13;Barcelonès;08019;Barcelona;2;50;U;;1198;269;541;698;500;4;24;670;694
8;Barcelona;13;Barcelonès;08019;Barcelona;2;51;A;;752;191;388;467;285;7;14;446;460
8;Barcelona;13;Barcelonès;08019;Barcelona;2;51;B;;652;176;339;408;244;1;10;397;407
8;Barcelona;13;Barcelonès;08019;Barcelona;2;52;A;;643;184;350;420;223;4;16;400;416
8;Barcelona;13;Barcelonès;08019;Barcelona;2;52;B;;631;190;369;426;205;0;12;414;426
8;Barcelona;13;Barcelonès;08019;Barcelona;2;53;U;;1224;325;642;803;421;4;28;771;799
8;Barcelona;13;Barcelonès;08019;Barcelona;2;54;A;;718;173;393;479;239;2;9;468;477
8;Barcelona;13;Barcelonès;08019;Barcelona;2;54;B;;612;154;308;388;224;15;4;369;373
8;Barcelona;13;Barcelonès;08019;Barcelona;2;55;A;;666;187;348;446;220;0;10;436;446
8;Barcelona;13;Barcelonès;08019;Barcelona;2;55;B;;704;213;404;493;211;3;24;466;490
8;Barcelona;13;Barcelonès;08019;Barcelona;2;56;U;;1041;252;531;657;384;4;25;628;653
8;Barcelona;13;Barcelonès;08019;Barcelona;2;57;U;;883;225;474;612;271;2;23;587;610
8;Barcelona;13;Barcelonès;08019;Barcelona;2;58;U;;1021;283;581;739;282;6;24;709;733
8;Barcelona;13;Barcelonès;08019;Barcelona;2;59;U;;1170;322;665;836;334;19;11;806;817
8;Barcelona;13;Barcelonès;08019;Barcelona;2;6;U;;1134;317;680;845;289;1;32;812;844
8;Barcelona;13;Barcelonès;08019;Barcelona;2;60;U;;1204;377;759;835;369;3;32;800;832
8;Barcelona;13;Barcelonès;08019;Barcelona;2;61;U;;919;244;514;635;284;8;17;610;627
8;Barcelona;13;Barcelonès;08019;Barcelona;2;62;U;;1106;279;611;758;348;2;27;729;756
8;Barcelona;13;Barcelonès;08019;Barcelona;2;63;U;;873;266;528;635;238;2;13;620;633
8;Barcelona;13;Barcelonès;08019;Barcelona;2;64;U;;976;286;605;747;229;3;19;725;744
8;Barcelona;13;Barcelonès;08019;Barcelona;2;65;A;;682;200;365;451;231;4;13;434;447
8;Barcelona;13;Barcelonès;08019;Barcelona;2;65;B;;587;162;315;398;189;3;10;385;395
8;Barcelona;13;Barcelonès;08019;Barcelona;2;66;A;;754;239;408;519;235;4;18;497;515
8;Barcelona;13;Barcelonès;08019;Barcelona;2;66;B;;641;181;337;413;228;0;15;398;413
8;Barcelona;13;Barcelonès;08019;Barcelona;2;67;U;;1159;268;586;754;405;3;33;718;751
8;Barcelona;13;Barcelonès;08019;Barcelona;2;68;U;;1218;310;644;814;404;5;18;791;809
8;Barcelona;13;Barcelonès;08019;Barcelona;2;69;U;;946;291;589;715;231;2;25;688;713
8;Barcelona;13;Barcelonès;08019;Barcelona;2;7;U;;895;254;533;642;253;4;21;617;638
8;Barcelona;13;Barcelonès;08019;Barcelona;2;70;U;;938;297;540;656;282;3;16;637;653
8;Barcelona;13;Barcelonès;08019;Barcelona;2;71;U;;1163;317;594;855;308;2;31;822;853
8;Barcelona;13;Barcelonès;08019;Barcelona;2;72;U;;834;197;446;558;276;1;17;540;557
8;Barcelona;13;Barcelonès;08019;Barcelona;2;73;U;;1085;262;568;736;349;0;26;710;736
8;Barcelona;13;Barcelonès;08019;Barcelona;2;74;U;;755;200;405;528;227;5;15;508;523
8;Barcelona;13;Barcelonès;08019;Barcelona;2;75;U;;766;214;429;547;219;1;19;527;546
8;Barcelona;13;Barcelonès;08019;Barcelona;2;76;U;;1071;268;623;762;309;1;34;727;761
8;Barcelona;13;Barcelonès;08019;Barcelona;2;77;U;;961;224;482;616;345;0;13;603;616
8;Barcelona;13;Barcelonès;08019;Barcelona;2;78;U;;945;209;466;581;364;2;11;568;579
8;Barcelona;13;Barcelonès;08019;Barcelona;2;79;U;;849;208;431;554;295;2;11;541;552
8;Barcelona;13;Barcelonès;08019;Barcelona;2;8;A;;675;190;389;494;181;0;8;486;494
8;Barcelona;13;Barcelonès;08019;Barcelona;2;8;B;;621;165;351;426;195;3;5;418;423
8;Barcelona;13;Barcelonès;08019;Barcelona;2;80;U;;1029;276;546;703;326;0;30;673;703
8;Barcelona;13;Barcelonès;08019;Barcelona;2;81;A;;793;221;466;574;219;3;8;563;571
8;Barcelona;13;Barcelonès;08019;Barcelona;2;81;B;;698;158;380;472;226;1;9;462;471
8;Barcelona;13;Barcelonès;08019;Barcelona;2;82;U;;653;139;324;419;234;2;15;402;417
8;Barcelona;13;Barcelonès;08019;Barcelona;2;83;U;;1106;278;636;815;291;3;13;799;812
8;Barcelona;13;Barcelonès;08019;Barcelona;2;84;A;;757;206;433;505;252;3;15;487;502
8;Barcelona;13;Barcelonès;08019;Barcelona;2;84;B;;685;176;388;461;224;1;17;443;460
8;Barcelona;13;Barcelonès;08019;Barcelona;2;85;U;;957;236;524;660;297;4;24;632;656
8;Barcelona;13;Barcelonès;08019;Barcelona;2;86;U;;954;227;552;695;259;6;14;675;689
8;Barcelona;13;Barcelonès;08019;Barcelona;2;87;U;;1003;269;553;698;305;1;18;679;697
8;Barcelona;13;Barcelonès;08019;Barcelona;2;88;U;;1190;296;676;826;364;5;25;796;821
8;Barcelona;13;Barcelonès;08019;Barcelona;2;89;U;;1131;283;635;818;313;5;17;796;813
8;Barcelona;13;Barcelonès;08019;Barcelona;2;9;U;;1217;314;656;792;425;0;29;763;792
8;Barcelona;13;Barcelonès;08019;Barcelona;2;90;U;;1131;270;567;713;418;5;24;684;708
8;Barcelona;13;Barcelonès;08019;Barcelona;2;91;U;;1151;314;586;742;409;3;30;709;739
8;Barcelona;13;Barcelonès;08019;Barcelona;2;92;U;;1213;195;546;720;493;2;30;688;718
8;Barcelona;13;Barcelonès;08019;Barcelona;2;93;U;;1103;209;585;754;349;2;19;733;752
8;Barcelona;13;Barcelonès;08019;Barcelona;2;94;U;;1066;232;541;686;380;6;19;661;680
8;Barcelona;13;Barcelonès;08019;Barcelona;2;95;U;;1044;261;554;708;336;0;12;696;708
8;Barcelona;13;Barcelonès;08019;Barcelona;2;96;U;;1007;228;485;598;409;6;27;565;592
8;Barcelona;13;Barcelonès;08019;Barcelona;2;97;U;;796;190;406;505;291;5;11;489;500
8;Barcelona;13;Barcelonès;08019;Barcelona;2;98;U;;1041;225;520;637;404;3;17;617;634
8;Barcelona;13;Barcelonès;08019;Barcelona;2;99;U;;1052;346;532;672;380;2;17;653;670
8;Barcelona;13;Barcelonès;08019;Barcelona;3;1;U;;1220;259;566;679;541;1;18;660;678
8;Barcelona;13;Barcelonès;08019;Barcelona;3;10;U;;1020;226;448;550;470;5;28;517;545
8;Barcelona;13;Barcelonès;08019;Barcelona;3;100;U;;873;267;492;567;306;2;18;547;565
8;Barcelona;13;Barcelonès;08019;Barcelona;3;101;U;;1104;235;499;594;510;6;18;570;588
8;Barcelona;13;Barcelonès;08019;Barcelona;3;102;U;;961;204;509;628;333;10;21;597;618
8;Barcelona;13;Barcelonès;08019;Barcelona;3;103;U;;997;289;531;656;341;6;24;626;650
8;Barcelona;13;Barcelonès;08019;Barcelona;3;104;U;;941;222;456;590;351;9;14;567;581
8;Barcelona;13;Barcelonès;08019;Barcelona;3;105;U;;813;225;406;503;310;13;13;477;490
8;Barcelona;13;Barcelonès;08019;Barcelona;3;106;U;;877;230;406;514;363;3;20;491;511
8;Barcelona;13;Barcelonès;08019;Barcelona;3;107;U;;1133;275;607;749;384;6;18;725;743
8;Barcelona;13;Barcelonès;08019;Barcelona;3;108;U;;1077;277;575;682;395;9;28;645;673
8;Barcelona;13;Barcelonès;08019;Barcelona;3;109;U;;1081;276;540;669;412;29;4;636;640
8;Barcelona;13;Barcelonès;08019;Barcelona;3;11;U;;1005;214;378;518;487;8;11;499;510
8;Barcelona;13;Barcelonès;08019;Barcelona;3;110;U;;1065;1065;1065;662;403;6;20;636;656
8;Barcelona;13;Barcelonès;08019;Barcelona;3;111;U;;932;219;490;616;316;4;26;586;612
8;Barcelona;13;Barcelonès;08019;Barcelona;3;112;A;;713;194;371;473;240;2;18;453;471
8;Barcelona;13;Barcelonès;08019;Barcelona;3;112;B;;678;197;385;466;212;1;22;443;465
8;Barcelona;13;Barcelonès;08019;Barcelona;3;113;U;;1210;353;761;827;383;2;18;807;825
8;Barcelona;13;Barcelonès;08019;Barcelona;3;114;U;;1098;298;645;788;310;2;22;764;786
8;Barcelona;13;Barcelonès;08019;Barcelona;3;12;A;;665;168;284;352;313;2;10;340;350
8;Barcelona;13;Barcelonès;08019;Barcelona;3;12;B;;629;155;292;343;286;0;12;331;343
8;Barcelona;13;Barcelonès;08019;Barcelona;3;13;U;;1108;261;486;594;514;2;19;573;592
8;Barcelona;13;Barcelonès;08019;Barcelona;3;14;U;;1107;252;469;555;552;4;16;535;551
8;Barcelona;13;Barcelonès;08019;Barcelona;3;15;A;;962;190;350;482;480;1;12;469;481
8;Barcelona;13;Barcelonès;08019;Barcelona;3;15;B;;865;197;358;435;430;3;8;424;432
8;Barcelona;13;Barcelonès;08019;Barcelona;3;16;U;;667;167;294;359;308;5;9;345;354
8;Barcelona;13;Barcelonès;08019;Barcelona;3;17;U;;1012;186;414;484;528;1;17;466;483
8;Barcelona;13;Barcelonès;08019;Barcelona;3;18;U;;1095;258;426;556;539;2;21;533;554
8;Barcelona;13;Barcelonès;08019;Barcelona;3;19;U;;946;229;388;471;475;6;16;449;465
8;Barcelona;13;Barcelonès;08019;Barcelona;3;2;A;;691;152;328;377;314;1;13;363;376
8;Barcelona;13;Barcelonès;08019;Barcelona;3;2;B;;600;105;242;304;296;3;8;293;301
8;Barcelona;13;Barcelonès;08019;Barcelona;3;20;U;;965;265;433;544;421;0;20;524;544
8;Barcelona;13;Barcelonès;08019;Barcelona;3;21;U;;887;228;398;473;414;2;14;457;471
8;Barcelona;13;Barcelonès;08019;Barcelona;3;22;U;;965;208;403;492;473;3;18;471;489
8;Barcelona;13;Barcelonès;08019;Barcelona;3;23;U;;1092;238;467;576;516;3;23;550;573
8;Barcelona;13;Barcelonès;08019;Barcelona;3;24;U;;1189;254;500;603;586;4;7;592;599
8;Barcelona;13;Barcelonès;08019;Barcelona;3;25;U;;882;110;219;270;612;3;4;263;267
8;Barcelona;13;Barcelonès;08019;Barcelona;3;26;U;;849;231;384;485;364;2;11;472;483
8;Barcelona;13;Barcelonès;08019;Barcelona;3;27;U;;1237;288;569;725;512;4;14;707;721
8;Barcelona;13;Barcelonès;08019;Barcelona;3;28;U;;1294;281;623;797;497;5;21;771;792
8;Barcelona;13;Barcelonès;08019;Barcelona;3;29;U;;1012;232;392;498;514;1;23;474;497
8;Barcelona;13;Barcelonès;08019;Barcelona;3;3;U;;978;231;440;524;454;3;12;509;521
8;Barcelona;13;Barcelonès;08019;Barcelona;3;30;U;;1235;317;596;737;498;3;15;719;734
8;Barcelona;13;Barcelonès;08019;Barcelona;3;31;A;;1010;221;403;483;527;7;8;468;476
8;Barcelona;13;Barcelonès;08019;Barcelona;3;31;B;;883;190;388;460;423;6;6;448;454
8;Barcelona;13;Barcelonès;08019;Barcelona;3;32;U;;1064;272;350;434;630;2;13;419;432
8;Barcelona;13;Barcelonès;08019;Barcelona;3;33;U;;934;200;346;430;504;0;5;425;430
8;Barcelona;13;Barcelonès;08019;Barcelona;3;34;A;;1148;247;490;619;529;2;21;596;617
8;Barcelona;13;Barcelonès;08019;Barcelona;3;34;B;;1049;210;426;556;493;1;18;537;555
8;Barcelona;13;Barcelonès;08019;Barcelona;3;35;A;;1324;303;577;739;585;5;17;717;734
8;Barcelona;13;Barcelonès;08019;Barcelona;3;35;B;;986;217;445;565;421;2;19;544;563
8;Barcelona;13;Barcelonès;08019;Barcelona;3;35;C;;1017;255;489;591;426;4;21;566;587
8;Barcelona;13;Barcelonès;08019;Barcelona;3;35;D;;966;212;431;534;432;6;20;508;528
8;Barcelona;13;Barcelonès;08019;Barcelona;3;35;E;;740;176;324;409;331;1;14;394;408
8;Barcelona;13;Barcelonès;08019;Barcelona;3;36;A;;871;204;436;557;314;3;16;538;554
8;Barcelona;13;Barcelonès;08019;Barcelona;3;36;B;;768;194;406;484;284;6;12;466;478
8;Barcelona;13;Barcelonès;08019;Barcelona;3;37;U;;822;149;341;469;353;1;18;450;468
8;Barcelona;13;Barcelonès;08019;Barcelona;3;38;A;;391;83;146;169;222;0;2;167;169
8;Barcelona;13;Barcelonès;08019;Barcelona;3;38;B;;710;125;212;262;448;2;5;255;260
8;Barcelona;13;Barcelonès;08019;Barcelona;3;39;U;;1248;218;487;562;686;3;6;553;559
8;Barcelona;13;Barcelonès;08019;Barcelona;3;4;U;;1093;270;550;683;410;3;14;666;680
8;Barcelona;13;Barcelonès;08019;Barcelona;3;40;A;;687;166;314;403;284;0;17;386;403
8;Barcelona;13;Barcelonès;08019;Barcelona;3;40;B;;581;165;274;337;244;0;11;326;337
8;Barcelona;13;Barcelonès;08019;Barcelona;3;41;U;;922;229;423;537;385;0;19;518;537
8;Barcelona;13;Barcelonès;08019;Barcelona;3;42;U;;935;227;483;591;344;4;24;563;587
8;Barcelona;13;Barcelonès;08019;Barcelona;3;43;U;;1073;248;476;614;459;6;22;586;608
8;Barcelona;13;Barcelonès;08019;Barcelona;3;44;U;;1242;283;574;739;503;4;30;705;735
8;Barcelona;13;Barcelonès;08019;Barcelona;3;45;U;;752;195;371;438;314;2;17;419;436
8;Barcelona;13;Barcelonès;08019;Barcelona;3;46;U;;1112;258;569;725;387;5;20;700;720
8;Barcelona;13;Barcelonès;08019;Barcelona;3;47;U;;1221;270;566;672;549;6;19;647;666
8;Barcelona;13;Barcelonès;08019;Barcelona;3;48;U;;1058;281;554;708;350;6;17;685;702
8;Barcelona;13;Barcelonès;08019;Barcelona;3;49;U;;1195;333;652;764;431;1;18;745;763
8;Barcelona;13;Barcelonès;08019;Barcelona;3;5;U;;884;217;404;508;376;10;11;487;498
8;Barcelona;13;Barcelonès;08019;Barcelona;3;50;U;;1149;260;565;665;484;0;0;665;665
8;Barcelona;13;Barcelonès;08019;Barcelona;3;51;U;;1194;250;469;648;546;2;24;622;646
8;Barcelona;13;Barcelonès;08019;Barcelona;3;52;U;;825;208;390;474;351;0;10;464;474
8;Barcelona;13;Barcelonès;08019;Barcelona;3;53;A;;686;136;294;385;301;3;7;375;382
8;Barcelona;13;Barcelonès;08019;Barcelona;3;53;B;;591;145;282;361;230;6;18;337;355
8;Barcelona;13;Barcelonès;08019;Barcelona;3;54;A;;690;185;391;468;222;20;4;444;448
8;Barcelona;13;Barcelonès;08019;Barcelona;3;54;B;;587;164;311;393;194;2;16;375;391
8;Barcelona;13;Barcelonès;08019;Barcelona;3;55;U;;1168;319;582;712;456;6;30;676;706
8;Barcelona;13;Barcelonès;08019;Barcelona;3;56;U;;649;173;327;421;228;1;14;406;420
8;Barcelona;13;Barcelonès;08019;Barcelona;3;57;U;;1149;314;617;735;414;4;14;717;731
8;Barcelona;13;Barcelonès;08019;Barcelona;3;58;U;;958;239;497;599;359;9;25;565;590
8;Barcelona;13;Barcelonès;08019;Barcelona;3;59;U;;913;251;469;569;344;2;17;550;567
8;Barcelona;13;Barcelonès;08019;Barcelona;3;6;U;;902;223;406;488;414;0;18;470;488
8;Barcelona;13;Barcelonès;08019;Barcelona;3;60;U;;1055;280;573;710;345;1;29;680;709
8;Barcelona;13;Barcelonès;08019;Barcelona;3;61;U;;872;281;483;579;293;5;29;545;574
8;Barcelona;13;Barcelonès;08019;Barcelona;3;62;U;;1191;373;676;802;389;5;19;778;797
8;Barcelona;13;Barcelonès;08019;Barcelona;3;63;U;;823;224;405;478;345;0;0;478;478
8;Barcelona;13;Barcelonès;08019;Barcelona;3;64;U;;936;259;450;579;357;2;23;554;577
8;Barcelona;13;Barcelonès;08019;Barcelona;3;65;U;;1160;297;558;717;443;8;23;686;709
8;Barcelona;13;Barcelonès;08019;Barcelona;3;66;A;;827;200;408;508;319;4;10;494;504
8;Barcelona;13;Barcelonès;08019;Barcelona;3;66;B;;815;195;405;503;312;4;20;479;499
8;Barcelona;13;Barcelonès;08019;Barcelona;3;67;A;;694;204;360;450;244;0;8;442;450
8;Barcelona;13;Barcelonès;08019;Barcelona;3;67;B;;605;155;308;383;222;0;19;364;383
8;Barcelona;13;Barcelonès;08019;Barcelona;3;68;U;;896;240;442;542;354;0;8;534;542
8;Barcelona;13;Barcelonès;08019;Barcelona;3;69;U;;914;165;481;581;333;1;21;559;580
8;Barcelona;13;Barcelonès;08019;Barcelona;3;7;U;;1082;257;520;617;465;2;18;597;615
8;Barcelona;13;Barcelonès;08019;Barcelona;3;70;U;;992;240;463;578;414;3;19;556;575
8;Barcelona;13;Barcelonès;08019;Barcelona;3;71;U;;901;218;413;505;396;0;16;489;505
8;Barcelona;13;Barcelonès;08019;Barcelona;3;72;U;;997;244;473;589;408;1;18;570;588
8;Barcelona;13;Barcelonès;08019;Barcelona;3;73;U;;1209;314;664;818;391;5;20;793;813
8;Barcelona;13;Barcelonès;08019;Barcelona;3;74;A;;633;150;323;402;231;0;15;387;402
8;Barcelona;13;Barcelonès;08019;Barcelona;3;74;B;;642;159;331;413;229;3;12;398;410
8;Barcelona;13;Barcelonès;08019;Barcelona;3;75;U;;1221;276;608;751;470;0;22;729;751
8;Barcelona;13;Barcelonès;08019;Barcelona;3;76;U;;815;189;412;483;332;1;11;471;482
8;Barcelona;13;Barcelonès;08019;Barcelona;3;77;U;;952;232;495;582;370;2;14;566;580
8;Barcelona;13;Barcelonès;08019;Barcelona;3;78;U;;1133;281;522;675;458;1;27;647;674
8;Barcelona;13;Barcelonès;08019;Barcelona;3;79;U;;1162;341;598;684;478;5;23;656;679
8;Barcelona;13;Barcelonès;08019;Barcelona;3;8;U;;789;205;367;438;351;3;18;417;435
8;Barcelona;13;Barcelonès;08019;Barcelona;3;80;U;;1177;269;567;726;451;3;22;701;723
8;Barcelona;13;Barcelonès;08019;Barcelona;3;81;A;;743;219;374;458;285;1;19;438;457
8;Barcelona;13;Barcelonès;08019;Barcelona;3;81;B;;664;194;345;421;243;6;9;406;415
8;Barcelona;13;Barcelonès;08019;Barcelona;3;82;A;;735;191;382;484;251;0;16;468;484
8;Barcelona;13;Barcelonès;08019;Barcelona;3;82;B;;629;174;344;428;201;4;13;411;424
8;Barcelona;13;Barcelonès;08019;Barcelona;3;83;U;;1056;150;461;644;412;7;18;619;637
8;Barcelona;13;Barcelonès;08019;Barcelona;3;84;U;;1142;235;587;786;356;4;22;760;782
8;Barcelona;13;Barcelonès;08019;Barcelona;3;85;U;;909;237;442;560;349;1;16;543;559
8;Barcelona;13;Barcelonès;08019;Barcelona;3;86;U;;1095;278;623;795;300;6;35;754;789
8;Barcelona;13;Barcelonès;08019;Barcelona;3;87;U;;1152;331;634;798;354;3;26;769;795
8;Barcelona;13;Barcelonès;08019;Barcelona;3;88;U;;1057;278;588;743;314;9;25;709;734
8;Barcelona;13;Barcelonès;08019;Barcelona;3;89;U;;986;271;543;687;299;7;16;664;680
8;Barcelona;13;Barcelonès;08019;Barcelona;3;9;U;;820;236;387;446;374;9;2;435;437
8;Barcelona;13;Barcelonès;08019;Barcelona;3;90;U;;816;260;483;589;227;7;15;567;582
8;Barcelona;13;Barcelonès;08019;Barcelona;3;91;U;;1041;240;539;682;359;8;24;650;674
8;Barcelona;13;Barcelonès;08019;Barcelona;3;92;U;;845;306;404;515;330;5;17;493;510
8;Barcelona;13;Barcelonès;08019;Barcelona;3;93;U;;1170;212;639;797;373;5;35;757;792
8;Barcelona;13;Barcelonès;08019;Barcelona;3;94;U;;914;273;487;585;329;2;8;575;583
8;Barcelona;13;Barcelonès;08019;Barcelona;3;95;U;;1156;360;647;769;387;2;46;721;767
8;Barcelona;13;Barcelonès;08019;Barcelona;3;96;U;;978;235;483;592;386;7;16;569;585
8;Barcelona;13;Barcelonès;08019;Barcelona;3;97;U;;980;219;414;526;454;7;18;501;519
8;Barcelona;13;Barcelonès;08019;Barcelona;3;98;U;;900;216;417;507;393;3;17;487;504
8;Barcelona;13;Barcelonès;08019;Barcelona;3;99;U;;736;244;396;456;280;4;12;440;452
8;Barcelona;13;Barcelonès;08019;Barcelona;4;1;U;;868;240;467;569;299;4;17;548;565
8;Barcelona;13;Barcelonès;08019;Barcelona;4;10;U;;678;201;405;514;164;0;14;500;514
8;Barcelona;13;Barcelonès;08019;Barcelona;4;11;A;;684;193;385;490;194;2;14;474;488
8;Barcelona;13;Barcelonès;08019;Barcelona;4;11;B;;680;196;425;524;156;5;12;507;519
8;Barcelona;13;Barcelonès;08019;Barcelona;4;12;U;;1197;287;686;851;346;3;29;819;848
8;Barcelona;13;Barcelonès;08019;Barcelona;4;13;U;;1002;241;529;731;271;19;4;708;712
8;Barcelona;13;Barcelonès;08019;Barcelona;4;14;U;;715;211;390;467;248;1;11;455;466
8;Barcelona;13;Barcelonès;08019;Barcelona;4;15;A;;803;240;481;578;225;6;21;551;572
8;Barcelona;13;Barcelonès;08019;Barcelona;4;15;B;;704;206;403;507;197;2;17;488;505
8;Barcelona;13;Barcelonès;08019;Barcelona;4;16;U;;886;244;516;635;251;3;16;616;632
8;Barcelona;13;Barcelonès;08019;Barcelona;4;17;U;;937;238;495;640;297;0;28;612;640
8;Barcelona;13;Barcelonès;08019;Barcelona;4;18;U;;1121;263;623;787;334;0;18;769;787
8;Barcelona;13;Barcelonès;08019;Barcelona;4;19;U;;989;241;627;724;265;1;21;702;723
8;Barcelona;13;Barcelonès;08019;Barcelona;4;2;A;;772;241;447;572;200;1;17;554;571
8;Barcelona;13;Barcelonès;08019;Barcelona;4;2;B;;619;168;335;445;174;2;19;424;443
8;Barcelona;13;Barcelonès;08019;Barcelona;4;20;U;;995;248;606;735;260;1;17;717;734
8;Barcelona;13;Barcelonès;08019;Barcelona;4;21;U;;991;264;568;723;268;3;13;707;720
8;Barcelona;13;Barcelonès;08019;Barcelona;4;22;U;;1184;283;639;812;372;3;20;789;809
8;Barcelona;13;Barcelonès;08019;Barcelona;4;23;U;;791;196;477;598;193;1;12;585;597
8;Barcelona;13;Barcelonès;08019;Barcelona;4;24;U;;767;221;462;605;162;0;9;596;605
8;Barcelona;13;Barcelonès;08019;Barcelona;4;25;U;;879;251;503;619;260;3;18;598;616
8;Barcelona;13;Barcelonès;08019;Barcelona;4;26;U;;983;302;562;698;285;3;26;669;695
8;Barcelona;13;Barcelonès;08019;Barcelona;4;27;U;;900;220;492;617;283;7;9;601;610
8;Barcelona;13;Barcelonès;08019;Barcelona;4;28;U;;1029;313;609;723;306;8;17;698;715
8;Barcelona;13;Barcelonès;08019;Barcelona;4;29;U;;1072;280;583;723;349;2;11;710;721
8;Barcelona;13;Barcelonès;08019;Barcelona;4;3;U;;845;257;500;612;233;1;27;584;611
8;Barcelona;13;Barcelonès;08019;Barcelona;4;30;A;;672;204;402;502;170;4;16;482;498
8;Barcelona;13;Barcelonès;08019;Barcelona;4;30;B;;670;200;410;509;161;1;9;499;508
8;Barcelona;13;Barcelonès;08019;Barcelona;4;31;U;;1111;273;611;740;371;7;27;706;733
8;Barcelona;13;Barcelonès;08019;Barcelona;4;32;A;;671;169;373;484;187;4;21;459;480
8;Barcelona;13;Barcelonès;08019;Barcelona;4;32;B;;588;149;316;411;177;4;16;391;407
8;Barcelona;13;Barcelonès;08019;Barcelona;4;33;U;;914;280;535;650;264;7;22;621;643
8;Barcelona;13;Barcelonès;08019;Barcelona;4;34;U;;1253;370;777;991;262;1;32;958;990
8;Barcelona;13;Barcelonès;08019;Barcelona;4;35;U;;1157;325;654;827;330;7;31;789;820
8;Barcelona;13;Barcelonès;08019;Barcelona;4;36;A;;614;218;374;439;175;2;15;422;437
8;Barcelona;13;Barcelonès;08019;Barcelona;4;36;B;;653;214;352;424;229;0;15;409;424
8;Barcelona;13;Barcelonès;08019;Barcelona;4;37;A;;872;235;497;626;246;3;13;610;623
8;Barcelona;13;Barcelonès;08019;Barcelona;4;37;B;;796;191;442;561;235;1;16;544;560
8;Barcelona;13;Barcelonès;08019;Barcelona;4;38;U;;1014;271;561;678;336;4;17;657;674
8;Barcelona;13;Barcelonès;08019;Barcelona;4;39;U;;854;178;456;538;316;1;18;519;537
8;Barcelona;13;Barcelonès;08019;Barcelona;4;4;U;;777;232;427;519;258;3;19;497;516
8;Barcelona;13;Barcelonès;08019;Barcelona;4;40;U;;1073;231;477;588;485;5;12;571;583
8;Barcelona;13;Barcelonès;08019;Barcelona;4;41;U;;961;250;508;639;322;3;13;623;636
8;Barcelona;13;Barcelonès;08019;Barcelona;4;42;A;;674;165;369;461;213;1;7;453;460
8;Barcelona;13;Barcelonès;08019;Barcelona;4;42;B;;682;176;361;465;217;1;13;451;464
8;Barcelona;13;Barcelonès;08019;Barcelona;4;43;A;;731;167;366;503;228;1;14;488;502
8;Barcelona;13;Barcelonès;08019;Barcelona;4;43;B;;640;161;375;461;179;2;14;445;459
8;Barcelona;13;Barcelonès;08019;Barcelona;4;44;U;;1238;252;612;777;461;19;2;756;758
8;Barcelona;13;Barcelonès;08019;Barcelona;4;45;U;;1067;236;560;705;362;6;26;673;699
8;Barcelona;13;Barcelonès;08019;Barcelona;4;46;A;;1038;243;576;747;291;0;14;733;747
8;Barcelona;13;Barcelonès;08019;Barcelona;4;46;B;;946;254;600;735;211;2;21;712;733
8;Barcelona;13;Barcelonès;08019;Barcelona;4;47;A;;701;197;374;486;215;0;17;469;486
8;Barcelona;13;Barcelonès;08019;Barcelona;4;47;B;;571;168;324;398;173;1;14;383;397
8;Barcelona;13;Barcelonès;08019;Barcelona;4;48;A;;1154;311;677;858;296;3;28;827;855
8;Barcelona;13;Barcelonès;08019;Barcelona;4;48;B;;1088;308;663;817;271;0;27;790;817
8;Barcelona;13;Barcelonès;08019;Barcelona;4;49;U;;826;171;433;579;247;2;15;562;577
8;Barcelona;13;Barcelonès;08019;Barcelona;4;5;U;;969;272;530;661;308;7;33;621;654
8;Barcelona;13;Barcelonès;08019;Barcelona;4;50;A;;760;221;480;590;170;0;10;580;590
8;Barcelona;13;Barcelonès;08019;Barcelona;4;50;B;;719;192;447;562;157;0;9;553;562
8;Barcelona;13;Barcelonès;08019;Barcelona;4;51;U;;1214;275;671;843;371;4;1;838;839
8;Barcelona;13;Barcelonès;08019;Barcelona;4;52;A;;826;234;518;649;177;4;9;636;645
8;Barcelona;13;Barcelonès;08019;Barcelona;4;52;B;;725;191;436;562;163;2;5;555;560
8;Barcelona;13;Barcelonès;08019;Barcelona;4;53;U;;980;232;497;607;373;1;10;596;606
8;Barcelona;13;Barcelonès;08019;Barcelona;4;54;U;;824;193;517;641;183;2;7;632;639
8;Barcelona;13;Barcelonès;08019;Barcelona;4;55;U;;1016;508;651;810;206;2;13;795;808
8;Barcelona;13;Barcelonès;08019;Barcelona;4;56;U;;1117;334;647;809;308;2;7;800;807
8;Barcelona;13;Barcelonès;08019;Barcelona;4;6;U;;919;223;488;629;290;3;29;597;626
8;Barcelona;13;Barcelonès;08019;Barcelona;4;7;U;;898;233;398;508;390;2;11;495;506
8;Barcelona;13;Barcelonès;08019;Barcelona;4;8;U;;815;230;451;547;268;1;10;536;546
8;Barcelona;13;Barcelonès;08019;Barcelona;4;9;U;;1063;296;584;695;368;4;27;664;691
8;Barcelona;13;Barcelonès;08019;Barcelona;5;1;U;;993;247;487;620;373;7;29;584;613
8;Barcelona;13;Barcelonès;08019;Barcelona;5;10;U;;1069;309;655;810;259;2;19;789;808
8;Barcelona;13;Barcelonès;08019;Barcelona;5;11;U;;1033;244;364;764;269;3;29;732;761
8;Barcelona;13;Barcelonès;08019;Barcelona;5;12;U;;993;309;581;709;284;0;24;685;709
8;Barcelona;13;Barcelonès;08019;Barcelona;5;13;U;;1138;290;669;858;280;6;28;824;852
8;Barcelona;13;Barcelonès;08019;Barcelona;5;14;U;;1126;286;673;853;273;3;26;824;850
8;Barcelona;13;Barcelonès;08019;Barcelona;5;15;U;;1036;259;564;769;267;2;18;749;767
8;Barcelona;13;Barcelonès;08019;Barcelona;5;16;U;;1222;260;642;834;388;5;12;817;829
8;Barcelona;13;Barcelonès;08019;Barcelona;5;17;U;;1074;204;680;809;265;1;13;795;808
8;Barcelona;13;Barcelonès;08019;Barcelona;5;18;U;;946;272;551;688;258;13;17;658;675
8;Barcelona;13;Barcelonès;08019;Barcelona;5;19;U;;1203;283;747;970;233;1;29;940;969
8;Barcelona;13;Barcelonès;08019;Barcelona;5;2;U;;1076;268;591;732;344;6;27;699;726
8;Barcelona;13;Barcelonès;08019;Barcelona;5;20;U;;809;230;489;598;211;2;15;581;596
8;Barcelona;13;Barcelonès;08019;Barcelona;5;21;U;;749;224;438;574;175;2;10;562;572
8;Barcelona;13;Barcelonès;08019;Barcelona;5;22;U;;1268;297;717;968;300;3;18;947;965
8;Barcelona;13;Barcelonès;08019;Barcelona;5;23;U;;1067;310;591;763;304;5;13;745;758
8;Barcelona;13;Barcelonès;08019;Barcelona;5;24;A;;749;182;447;576;173;2;5;569;574
8;Barcelona;13;Barcelonès;08019;Barcelona;5;24;B;;601;160;353;476;125;2;2;472;474
8;Barcelona;13;Barcelonès;08019;Barcelona;5;25;U;;948;248;590;734;214;1;5;728;733
8;Barcelona;13;Barcelonès;08019;Barcelona;5;26;U;;989;240;584;758;231;1;16;741;757
8;Barcelona;13;Barcelonès;08019;Barcelona;5;27;U;;941;256;621;764;177;2;5;757;762
8;Barcelona;13;Barcelonès;08019;Barcelona;5;28;U;;1017;341;662;805;212;0;13;792;805
8;Barcelona;13;Barcelonès;08019;Barcelona;5;29;U;;1067;260;670;868;199;1;15;852;867
8;Barcelona;13;Barcelonès;08019;Barcelona;5;3;U;;897;266;512;618;279;3;14;601;615
8;Barcelona;13;Barcelonès;08019;Barcelona;5;30;U;;1006;266;624;817;189;1;11;805;816
8;Barcelona;13;Barcelonès;08019;Barcelona;5;31;U;;1108;326;694;852;256;2;14;836;850
8;Barcelona;13;Barcelonès;08019;Barcelona;5;32;U;;1103;330;678;807;296;1;6;800;806
8;Barcelona;13;Barcelonès;08019;Barcelona;5;33;U;;927;249;504;626;301;1;12;613;625
8;Barcelona;13;Barcelonès;08019;Barcelona;5;34;U;;840;221;481;596;244;4;17;575;592
8;Barcelona;13;Barcelonès;08019;Barcelona;5;35;U;;902;220;526;671;231;1;12;658;670
8;Barcelona;13;Barcelonès;08019;Barcelona;5;36;U;;1196;263;701;907;289;1;19;887;906
8;Barcelona;13;Barcelonès;08019;Barcelona;5;37;U;;974;249;531;697;277;1;23;673;696
8;Barcelona;13;Barcelonès;08019;Barcelona;5;38;U;;905;251;469;625;280;0;16;609;625
8;Barcelona;13;Barcelonès;08019;Barcelona;5;39;U;;1144;271;733;903;241;5;24;874;898
8;Barcelona;13;Barcelonès;08019;Barcelona;5;4;U;;736;190;439;528;208;1;9;518;527
8;Barcelona;13;Barcelonès;08019;Barcelona;5;40;U;;976;233;531;689;287;1;16;672;688
8;Barcelona;13;Barcelonès;08019;Barcelona;5;41;U;;1023;266;591;748;275;4;22;722;744
8;Barcelona;13;Barcelonès;08019;Barcelona;5;42;U;;911;295;565;689;222;4;14;671;685
8;Barcelona;13;Barcelonès;08019;Barcelona;5;43;U;;972;233;541;717;255;3;30;684;714
8;Barcelona;13;Barcelonès;08019;Barcelona;5;44;U;;918;223;483;618;300;2;14;602;616
8;Barcelona;13;Barcelonès;08019;Barcelona;5;45;U;;1100;285;632;812;288;3;12;797;809
8;Barcelona;13;Barcelonès;08019;Barcelona;5;46;U;;897;260;605;699;198;2;14;683;697
8;Barcelona;13;Barcelonès;08019;Barcelona;5;47;U;;883;263;545;703;180;5;8;690;698
8;Barcelona;13;Barcelonès;08019;Barcelona;5;48;U;;934;259;550;678;256;1;16;661;677
8;Barcelona;13;Barcelonès;08019;Barcelona;5;49;U;;1161;257;693;892;269;2;14;876;890
8;Barcelona;13;Barcelonès;08019;Barcelona;5;5;U;;760;201;390;490;270;0;10;480;490
8;Barcelona;13;Barcelonès;08019;Barcelona;5;50;U;;1147;233;607;796;351;3;16;777;793
8;Barcelona;13;Barcelonès;08019;Barcelona;5;51;U;;1141;276;804;915;226;2;27;886;913
8;Barcelona;13;Barcelonès;08019;Barcelona;5;52;U;;1018;242;603;800;218;0;7;793;800
8;Barcelona;13;Barcelonès;08019;Barcelona;5;53;U;;1097;183;650;877;220;0;16;861;877
8;Barcelona;13;Barcelonès;08019;Barcelona;5;54;U;;808;193;453;603;205;0;5;598;603
8;Barcelona;13;Barcelonès;08019;Barcelona;5;55;U;;1057;232;655;836;221;1;11;824;835
8;Barcelona;13;Barcelonès;08019;Barcelona;5;56;U;;933;235;504;677;256;2;11;664;675
8;Barcelona;13;Barcelonès;08019;Barcelona;5;57;A;;661;170;389;492;169;0;9;483;492
8;Barcelona;13;Barcelonès;08019;Barcelona;5;57;B;;638;228;400;510;128;3;8;499;507
8;Barcelona;13;Barcelonès;08019;Barcelona;5;58;U;;1097;250;621;791;306;1;13;777;790
8;Barcelona;13;Barcelonès;08019;Barcelona;5;59;U;;1113;230;605;768;345;1;12;755;767
8;Barcelona;13;Barcelonès;08019;Barcelona;5;6;U;;1106;280;667;854;252;3;8;843;851
8;Barcelona;13;Barcelonès;08019;Barcelona;5;60;U;;770;174;443;564;206;1;7;556;563
8;Barcelona;13;Barcelonès;08019;Barcelona;5;61;U;;1055;294;532;644;411;7;14;623;637
8;Barcelona;13;Barcelonès;08019;Barcelona;5;62;U;;1153;336;719;871;282;1;18;852;870
8;Barcelona;13;Barcelonès;08019;Barcelona;5;63;U;;1157;216;700;844;313;1;24;819;843
8;Barcelona;13;Barcelonès;08019;Barcelona;5;64;U;;1147;297;660;828;319;7;15;806;821
8;Barcelona;13;Barcelonès;08019;Barcelona;5;65;U;;1141;293;615;786;355;1;14;771;785
8;Barcelona;13;Barcelonès;08019;Barcelona;5;66;U;;963;231;546;700;263;2;20;678;698
8;Barcelona;13;Barcelonès;08019;Barcelona;5;67;U;;939;240;574;703;236;1;12;690;702
8;Barcelona;13;Barcelonès;08019;Barcelona;5;68;U;;1049;259;589;779;270;6;26;747;773
8;Barcelona;13;Barcelonès;08019;Barcelona;5;69;U;;1174;288;665;870;304;3;32;835;867
8;Barcelona;13;Barcelonès;08019;Barcelona;5;7;U;;1119;356;690;827;292;6;27;794;821
8;Barcelona;13;Barcelonès;08019;Barcelona;5;70;U;;1074;298;641;807;267;2;19;786;805
8;Barcelona;13;Barcelonès;08019;Barcelona;5;71;U;;1093;295;605;763;330;2;15;746;761
8;Barcelona;13;Barcelonès;08019;Barcelona;5;72;U;;1193;399;726;880;313;3;18;859;877
8;Barcelona;13;Barcelonès;08019;Barcelona;5;73;U;;1198;330;645;855;343;2;14;839;853
8;Barcelona;13;Barcelonès;08019;Barcelona;5;74;U;;1175;338;870;904;271;6;19;879;898
8;Barcelona;13;Barcelonès;08019;Barcelona;5;75;A;;649;189;349;458;191;1;10;447;457
8;Barcelona;13;Barcelonès;08019;Barcelona;5;75;B;;609;190;358;450;159;3;10;437;447
8;Barcelona;13;Barcelonès;08019;Barcelona;5;76;U;;1017;266;557;711;306;1;10;700;710
8;Barcelona;13;Barcelonès;08019;Barcelona;5;77;U;;983;242;562;727;256;2;13;712;725
8;Barcelona;13;Barcelonès;08019;Barcelona;5;78;A;;716;206;409;533;183;3;7;523;530
8;Barcelona;13;Barcelonès;08019;Barcelona;5;78;B;;675;179;383;508;167;0;5;503;508
8;Barcelona;13;Barcelonès;08019;Barcelona;5;79;U;;904;218;537;683;221;2;18;663;681
8;Barcelona;13;Barcelonès;08019;Barcelona;5;8;U;;1072;310;348;818;254;3;10;805;815
8;Barcelona;13;Barcelonès;08019;Barcelona;5;80;U;;929;253;630;663;266;3;22;638;660
8;Barcelona;13;Barcelonès;08019;Barcelona;5;81;U;;1099;326;648;818;281;9;19;790;809
8;Barcelona;13;Barcelonès;08019;Barcelona;5;82;U;;1118;322;654;807;311;5;24;778;802
8;Barcelona;13;Barcelonès;08019;Barcelona;5;83;U;;951;283;570;694;257;3;13;678;691
8;Barcelona;13;Barcelonès;08019;Barcelona;5;84;U;;983;306;623;746;237;6;22;718;740
8;Barcelona;13;Barcelonès;08019;Barcelona;5;85;U;;995;208;488;609;386;5;20;584;604
8;Barcelona;13;Barcelonès;08019;Barcelona;5;86;U;;917;251;530;649;268;2;19;628;647
8;Barcelona;13;Barcelonès;08019;Barcelona;5;87;U;;1161;279;614;781;380;2;20;759;779
8;Barcelona;13;Barcelonès;08019;Barcelona;5;88;U;;1234;286;692;901;333;1;17;883;900
8;Barcelona;13;Barcelonès;08019;Barcelona;5;89;U;;1203;300;681;883;320;7;27;849;876
8;Barcelona;13;Barcelonès;08019;Barcelona;5;9;U;;1162;398;748;874;288;7;20;847;867
8;Barcelona;13;Barcelonès;08019;Barcelona;5;90;A;;687;147;347;447;240;2;16;429;445
8;Barcelona;13;Barcelonès;08019;Barcelona;5;90;B;;613;156;319;422;191;2;15;405;420
8;Barcelona;13;Barcelonès;08019;Barcelona;5;91;U;;1102;235;601;784;318;5;18;761;779
8;Barcelona;13;Barcelonès;08019;Barcelona;5;92;U;;1123;288;624;786;337;0;26;760;786
8;Barcelona;13;Barcelonès;08019;Barcelona;5;93;U;;753;255;445;547;206;11;1;535;536
8;Barcelona;13;Barcelonès;08019;Barcelona;5;94;A;;929;260;567;728;201;1;55;672;727
8;Barcelona;13;Barcelonès;08019;Barcelona;5;94;B;;918;272;511;656;262;1;13;642;655
8;Barcelona;13;Barcelonès;08019;Barcelona;5;95;U;;1190;321;669;851;339;5;14;832;846
8;Barcelona;13;Barcelonès;08019;Barcelona;5;96;U;;798;228;457;578;220;1;36;541;577
8;Barcelona;13;Barcelonès;08019;Barcelona;5;97;U;;1111;307;654;839;272;3;27;809;836
8;Barcelona;13;Barcelonès;08019;Barcelona;5;98;U;;1078;273;617;773;305;2;41;730;771
8;Barcelona;13;Barcelonès;08019;Barcelona;6;1;U;;752;197;383;477;275;2;9;466;475
8;Barcelona;13;Barcelonès;08019;Barcelona;6;10;U;;797;203;436;552;245;6;20;526;546
8;Barcelona;13;Barcelonès;08019;Barcelona;6;11;U;;1000;280;548;686;314;4;23;659;682
8;Barcelona;13;Barcelonès;08019;Barcelona;6;12;U;;831;265;477;586;245;6;10;570;580
8;Barcelona;13;Barcelonès;08019;Barcelona;6;13;U;;1195;318;604;766;429;2;21;743;764
8;Barcelona;13;Barcelonès;08019;Barcelona;6;14;U;;1077;239;504;641;436;0;26;615;641
8;Barcelona;13;Barcelonès;08019;Barcelona;6;15;U;;1000;235;410;515;485;10;22;483;505
8;Barcelona;13;Barcelonès;08019;Barcelona;6;16;U;;1082;238;489;635;447;3;25;607;632
8;Barcelona;13;Barcelonès;08019;Barcelona;6;17;U;;934;260;478;579;355;0;23;556;579
8;Barcelona;13;Barcelonès;08019;Barcelona;6;18;U;;959;102;441;564;395;16;20;528;548
8;Barcelona;13;Barcelonès;08019;Barcelona;6;19;U;;1051;298;549;674;377;7;30;637;667
8;Barcelona;13;Barcelonès;08019;Barcelona;6;2;U;;1049;285;591;720;329;7;14;699;713
8;Barcelona;13;Barcelonès;08019;Barcelona;6;20;U;;850;266;479;576;274;2;15;559;574
8;Barcelona;13;Barcelonès;08019;Barcelona;6;21;U;;1016;266;582;738;278;2;26;710;736
8;Barcelona;13;Barcelonès;08019;Barcelona;6;22;U;;975;255;450;600;375;1;19;580;599
8;Barcelona;13;Barcelonès;08019;Barcelona;6;23;U;;1108;258;599;816;292;28;4;784;788
8;Barcelona;13;Barcelonès;08019;Barcelona;6;24;U;;1204;362;687;837;367;14;23;800;823
8;Barcelona;13;Barcelonès;08019;Barcelona;6;25;U;;1107;335;636;783;324;1;24;758;782
8;Barcelona;13;Barcelonès;08019;Barcelona;6;26;U;;738;217;395;477;261;2;12;463;475
8;Barcelona;13;Barcelonès;08019;Barcelona;6;27;U;;934;247;535;649;285;6;17;626;643
8;Barcelona;13;Barcelonès;08019;Barcelona;6;28;U;;986;279;530;650;336;3;12;635;647
8;Barcelona;13;Barcelonès;08019;Barcelona;6;29;U;;967;294;541;660;307;3;20;637;657
8;Barcelona;13;Barcelonès;08019;Barcelona;6;3;U;;1128;255;544;703;425;2;27;674;701
8;Barcelona;13;Barcelonès;08019;Barcelona;6;30;U;;1008;273;525;646;362;4;17;625;642
8;Barcelona;13;Barcelonès;08019;Barcelona;6;31;U;;872;262;485;598;274;8;22;568;590
8;Barcelona;13;Barcelonès;08019;Barcelona;6;32;U;;850;218;429;565;285;5;26;534;560
8;Barcelona;13;Barcelonès;08019;Barcelona;6;33;U;;965;270;525;670;295;9;31;630;661
8;Barcelona;13;Barcelonès;08019;Barcelona;6;34;U;;937;258;519;650;287;9;12;629;641
8;Barcelona;13;Barcelonès;08019;Barcelona;6;35;U;;773;208;441;551;222;4;18;529;547
8;Barcelona;13;Barcelonès;08019;Barcelona;6;36;U;;994;330;534;665;329;2;28;635;663
8;Barcelona;13;Barcelonès;08019;Barcelona;6;37;U;;773;197;393;502;271;1;8;493;501
8;Barcelona;13;Barcelonès;08019;Barcelona;6;38;U;;1032;236;569;693;339;30;2;661;663
8;Barcelona;13;Barcelonès;08019;Barcelona;6;39;U;;1110;237;532;700;410;7;26;667;693
8;Barcelona;13;Barcelonès;08019;Barcelona;6;4;U;;885;91;399;505;380;3;18;484;502
8;Barcelona;13;Barcelonès;08019;Barcelona;6;40;U;;1178;330;682;825;353;2;15;808;823
8;Barcelona;13;Barcelonès;08019;Barcelona;6;41;U;;1145;293;618;761;384;2;27;732;759
8;Barcelona;13;Barcelonès;08019;Barcelona;6;42;U;;1102;290;590;739;363;5;21;713;734
8;Barcelona;13;Barcelonès;08019;Barcelona;6;43;U;;907;226;486;607;300;4;28;575;603
8;Barcelona;13;Barcelonès;08019;Barcelona;6;44;U;;1049;299;592;730;319;5;16;709;725
8;Barcelona;13;Barcelonès;08019;Barcelona;6;45;U;;870;211;422;540;330;3;21;516;537
8;Barcelona;13;Barcelonès;08019;Barcelona;6;46;U;;807;182;381;495;312;2;17;476;493
8;Barcelona;13;Barcelonès;08019;Barcelona;6;47;U;;1031;232;445;531;500;4;19;508;527
8;Barcelona;13;Barcelonès;08019;Barcelona;6;48;U;;944;227;467;565;379;10;21;534;555
8;Barcelona;13;Barcelonès;08019;Barcelona;6;49;U;;759;189;397;481;278;14;2;465;467
8;Barcelona;13;Barcelonès;08019;Barcelona;6;5;U;;766;211;391;495;271;0;26;469;495
8;Barcelona;13;Barcelonès;08019;Barcelona;6;50;U;;817;194;407;482;335;3;17;462;479
8;Barcelona;13;Barcelonès;08019;Barcelona;6;51;U;;881;275;464;593;288;1;17;575;592
8;Barcelona;13;Barcelonès;08019;Barcelona;6;52;U;;1128;318;583;731;397;7;29;695;724
8;Barcelona;13;Barcelonès;08019;Barcelona;6;53;U;;1044;273;542;674;370;8;22;644;666
8;Barcelona;13;Barcelonès;08019;Barcelona;6;54;U;;1172;311;605;734;438;5;26;703;729
8;Barcelona;13;Barcelonès;08019;Barcelona;6;55;U;;1081;305;578;706;375;4;22;680;702
8;Barcelona;13;Barcelonès;08019;Barcelona;6;56;U;;1078;265;517;649;429;5;14;630;644
8;Barcelona;13;Barcelonès;08019;Barcelona;6;57;U;;1097;256;540;673;424;3;26;644;670
8;Barcelona;13;Barcelonès;08019;Barcelona;6;58;U;;1174;305;585;747;427;5;22;720;742
8;Barcelona;13;Barcelonès;08019;Barcelona;6;59;U;;1124;240;501;673;451;1;21;651;672
8;Barcelona;13;Barcelonès;08019;Barcelona;6;6;U;;736;192;410;524;212;0;17;507;524
8;Barcelona;13;Barcelonès;08019;Barcelona;6;60;A;;650;162;305;387;263;4;8;375;383
8;Barcelona;13;Barcelonès;08019;Barcelona;6;60;B;;609;177;312;380;229;2;12;366;378
8;Barcelona;13;Barcelonès;08019;Barcelona;6;61;U;;962;237;498;636;326;2;17;617;634
8;Barcelona;13;Barcelonès;08019;Barcelona;6;62;U;;972;278;522;672;300;3;22;647;669
8;Barcelona;13;Barcelonès;08019;Barcelona;6;63;U;;1083;290;535;685;398;3;17;665;682
8;Barcelona;13;Barcelonès;08019;Barcelona;6;64;A;;724;260;447;528;196;12;2;514;516
8;Barcelona;13;Barcelonès;08019;Barcelona;6;64;B;;680;215;402;477;203;3;13;461;474
8;Barcelona;13;Barcelonès;08019;Barcelona;6;65;U;;843;271;440;607;236;25;2;580;582
8;Barcelona;13;Barcelonès;08019;Barcelona;6;66;U;;804;214;425;510;294;2;21;487;508
8;Barcelona;13;Barcelonès;08019;Barcelona;6;67;A;;670;148;327;423;247;4;17;402;419
8;Barcelona;13;Barcelonès;08019;Barcelona;6;67;B;;629;184;353;416;213;3;12;401;413
8;Barcelona;13;Barcelonès;08019;Barcelona;6;68;U;;1108;310;647;768;340;7;33;728;761
8;Barcelona;13;Barcelonès;08019;Barcelona;6;69;U;;807;204;429;529;278;7;19;503;522
8;Barcelona;13;Barcelonès;08019;Barcelona;6;7;U;;1146;266;593;757;389;7;41;709;750
8;Barcelona;13;Barcelonès;08019;Barcelona;6;70;A;;700;182;375;465;235;1;18;446;464
8;Barcelona;13;Barcelonès;08019;Barcelona;6;70;B;;648;1;349;412;236;2;15;395;410
8;Barcelona;13;Barcelonès;08019;Barcelona;6;71;U;;753;214;445;544;209;3;16;525;541
8;Barcelona;13;Barcelonès;08019;Barcelona;6;72;U;;1232;366;705;883;349;1;38;844;882
8;Barcelona;13;Barcelonès;08019;Barcelona;6;73;U;;1040;264;575;717;323;4;21;692;713
8;Barcelona;13;Barcelonès;08019;Barcelona;6;74;U;;765;422;423;497;268;3;17;477;494
8;Barcelona;13;Barcelonès;08019;Barcelona;6;75;U;;873;268;518;640;233;2;17;621;638
8;Barcelona;13;Barcelonès;08019;Barcelona;6;76;U;;1023;292;629;751;272;3;17;731;748
8;Barcelona;13;Barcelonès;08019;Barcelona;6;77;U;;907;235;429;537;370;2;21;514;535
8;Barcelona;13;Barcelonès;08019;Barcelona;6;78;U;;921;262;491;625;296;22;1;602;603
8;Barcelona;13;Barcelonès;08019;Barcelona;6;79;U;;857;242;451;560;297;4;22;534;556
8;Barcelona;13;Barcelonès;08019;Barcelona;6;8;A;;724;178;394;496;228;4;15;477;492
8;Barcelona;13;Barcelonès;08019;Barcelona;6;8;B;;663;182;392;462;201;1;15;446;461
8;Barcelona;13;Barcelonès;08019;Barcelona;6;80;U;;917;267;516;617;300;2;17;598;615
8;Barcelona;13;Barcelonès;08019;Barcelona;6;81;U;;971;254;492;614;357;4;19;591;610
8;Barcelona;13;Barcelonès;08019;Barcelona;6;82;A;;660;206;377;462;198;3;11;448;459
8;Barcelona;13;Barcelonès;08019;Barcelona;6;82;B;;629;179;340;436;193;2;9;425;434
8;Barcelona;13;Barcelonès;08019;Barcelona;6;83;A;;693;217;340;478;215;2;11;465;476
8;Barcelona;13;Barcelonès;08019;Barcelona;6;83;B;;662;203;391;491;171;1;19;471;490
8;Barcelona;13;Barcelonès;08019;Barcelona;6;84;U;;1091;350;657;752;339;7;24;721;745
8;Barcelona;13;Barcelonès;08019;Barcelona;6;85;U;;936;307;534;664;272;3;26;635;661
8;Barcelona;13;Barcelonès;08019;Barcelona;6;86;U;;797;257;479;596;201;2;20;574;594
8;Barcelona;13;Barcelonès;08019;Barcelona;6;87;A;;796;233;460;577;219;3;25;549;574
8;Barcelona;13;Barcelonès;08019;Barcelona;6;87;B;;773;237;452;566;207;4;12;550;562
8;Barcelona;13;Barcelonès;08019;Barcelona;6;88;U;;942;214;637;689;253;3;19;667;686
8;Barcelona;13;Barcelonès;08019;Barcelona;6;9;U;;868;254;485;611;257;1;27;583;610
8;Barcelona;13;Barcelonès;08019;Barcelona;7;1;A;;703;194;320;413;290;2;7;404;411
8;Barcelona;13;Barcelonès;08019;Barcelona;7;1;B;;634;158;311;375;259;3;18;354;372
8;Barcelona;13;Barcelonès;08019;Barcelona;7;10;U;;937;242;444;567;370;5;27;535;562
8;Barcelona;13;Barcelonès;08019;Barcelona;7;100;U;;944;271;535;620;324;0;21;599;620
8;Barcelona;13;Barcelonès;08019;Barcelona;7;101;U;;1070;293;592;679;391;3;24;652;676
8;Barcelona;13;Barcelonès;08019;Barcelona;7;102;U;;305;76;108;141;164;1;5;135;140
8;Barcelona;13;Barcelonès;08019;Barcelona;7;103;U;;1058;225;445;546;512;3;10;533;543
8;Barcelona;13;Barcelonès;08019;Barcelona;7;104;U;;1227;251;518;642;585;4;20;618;638
8;Barcelona;13;Barcelonès;08019;Barcelona;7;105;U;;861;298;510;555;306;1;26;528;554
8;Barcelona;13;Barcelonès;08019;Barcelona;7;106;U;;933;260;515;611;322;5;24;582;606
8;Barcelona;13;Barcelonès;08019;Barcelona;7;107;U;;982;264;542;679;303;6;22;651;673
8;Barcelona;13;Barcelonès;08019;Barcelona;7;108;U;;999;264;515;647;352;4;23;620;643
8;Barcelona;13;Barcelonès;08019;Barcelona;7;109;A;;693;192;338;414;279;2;11;401;412
8;Barcelona;13;Barcelonès;08019;Barcelona;7;109;B;;676;185;314;393;283;5;27;361;388
8;Barcelona;13;Barcelonès;08019;Barcelona;7;11;U;;827;201;413;501;326;0;24;477;501
8;Barcelona;13;Barcelonès;08019;Barcelona;7;110;U;;864;277;457;535;329;1;15;519;534
8;Barcelona;13;Barcelonès;08019;Barcelona;7;111;U;;791;232;460;574;217;3;22;549;571
8;Barcelona;13;Barcelonès;08019;Barcelona;7;112;U;;956;250;499;600;356;1;25;574;599
8;Barcelona;13;Barcelonès;08019;Barcelona;7;113;U;;905;247;478;565;340;6;18;541;559
8;Barcelona;13;Barcelonès;08019;Barcelona;7;114;U;;926;261;519;609;317;5;16;588;604
8;Barcelona;13;Barcelonès;08019;Barcelona;7;115;U;;855;243;457;588;267;2;24;562;586
8;Barcelona;13;Barcelonès;08019;Barcelona;7;116;U;;1207;273;554;716;491;4;28;684;712
8;Barcelona;13;Barcelonès;08019;Barcelona;7;117;U;;965;221;442;570;395;2;22;546;568
8;Barcelona;13;Barcelonès;08019;Barcelona;7;118;U;;951;239;469;618;333;2;24;592;616
8;Barcelona;13;Barcelonès;08019;Barcelona;7;119;U;;904;215;421;521;383;3;10;508;518
8;Barcelona;13;Barcelonès;08019;Barcelona;7;12;U;;1188;250;560;682;506;6;25;651;676
8;Barcelona;13;Barcelonès;08019;Barcelona;7;120;U;;981;235;462;571;410;9;23;539;562
8;Barcelona;13;Barcelonès;08019;Barcelona;7;121;U;;870;244;423;496;374;2;14;480;494
8;Barcelona;13;Barcelonès;08019;Barcelona;7;122;U;;1015;241;525;629;386;2;17;610;627
8;Barcelona;13;Barcelonès;08019;Barcelona;7;123;U;;1071;256;521;650;421;6;29;615;644
8;Barcelona;13;Barcelonès;08019;Barcelona;7;13;U;;1013;267;576;532;481;2;15;515;530
8;Barcelona;13;Barcelonès;08019;Barcelona;7;14;U;;701;190;354;409;292;12;12;385;397
8;Barcelona;13;Barcelonès;08019;Barcelona;7;15;U;;1053;280;539;669;384;4;24;641;665
8;Barcelona;13;Barcelonès;08019;Barcelona;7;16;U;;984;262;503;663;321;2;38;623;661
8;Barcelona;13;Barcelonès;08019;Barcelona;7;17;U;;1232;324;594;765;467;3;22;740;762
8;Barcelona;13;Barcelonès;08019;Barcelona;7;18;U;;1147;315;580;713;434;0;27;686;713
8;Barcelona;13;Barcelonès;08019;Barcelona;7;19;U;;1123;274;541;713;410;5;16;692;708
8;Barcelona;13;Barcelonès;08019;Barcelona;7;2;U;;878;279;462;598;280;4;29;565;594
8;Barcelona;13;Barcelonès;08019;Barcelona;7;20;U;;1089;292;580;719;370;1;19;699;718
8;Barcelona;13;Barcelonès;08019;Barcelona;7;21;U;;830;236;430;529;301;10;15;504;519
8;Barcelona;13;Barcelonès;08019;Barcelona;7;22;U;;919;202;382;499;420;1;18;480;498
8;Barcelona;13;Barcelonès;08019;Barcelona;7;23;U;;959;209;439;513;446;3;13;497;510
8;Barcelona;13;Barcelonès;08019;Barcelona;7;24;U;;1053;298;528;637;416;17;2;618;620
8;Barcelona;13;Barcelonès;08019;Barcelona;7;25;U;;1004;258;458;560;444;2;29;529;558
8;Barcelona;13;Barcelonès;08019;Barcelona;7;26;U;;892;272;461;557;335;1;10;546;556
8;Barcelona;13;Barcelonès;08019;Barcelona;7;27;A;;744;211;369;461;283;5;11;445;456
8;Barcelona;13;Barcelonès;08019;Barcelona;7;27;B;;661;207;369;433;228;5;8;420;428
8;Barcelona;13;Barcelonès;08019;Barcelona;7;28;U;;978;269;485;578;400;1;21;556;577
8;Barcelona;13;Barcelonès;08019;Barcelona;7;29;U;;1007;430;515;616;391;4;26;586;612
8;Barcelona;13;Barcelonès;08019;Barcelona;7;3;U;;938;262;533;640;298;8;27;605;632
8;Barcelona;13;Barcelonès;08019;Barcelona;7;30;U;;1002;350;609;580;422;2;20;558;578
8;Barcelona;13;Barcelonès;08019;Barcelona;7;31;U;;1081;282;483;598;483;0;20;578;598
8;Barcelona;13;Barcelonès;08019;Barcelona;7;32;U;;973;234;518;639;334;4;18;617;635
8;Barcelona;13;Barcelonès;08019;Barcelona;7;33;U;;1097;291;581;713;384;9;19;685;704
8;Barcelona;13;Barcelonès;08019;Barcelona;7;34;U;;1108;325;603;736;372;3;24;709;733
8;Barcelona;13;Barcelonès;08019;Barcelona;7;35;A;;669;192;371;461;208;0;16;445;461
8;Barcelona;13;Barcelonès;08019;Barcelona;7;35;B;;615;172;320;413;202;5;12;396;408
8;Barcelona;13;Barcelonès;08019;Barcelona;7;36;U;;1036;253;561;691;345;3;15;673;688
8;Barcelona;13;Barcelonès;08019;Barcelona;7;37;U;;1076;295;622;741;335;5;20;716;736
8;Barcelona;13;Barcelonès;08019;Barcelona;7;38;U;;986;282;528;652;334;8;24;620;644
8;Barcelona;13;Barcelonès;08019;Barcelona;7;39;U;;1155;250;558;704;451;8;26;670;696
8;Barcelona;13;Barcelonès;08019;Barcelona;7;4;U;;1111;279;607;717;394;7;23;687;710
8;Barcelona;13;Barcelonès;08019;Barcelona;7;40;U;;1072;310;539;676;396;0;23;653;676
8;Barcelona;13;Barcelonès;08019;Barcelona;7;41;U;;931;226;358;530;401;3;14;513;527
8;Barcelona;13;Barcelonès;08019;Barcelona;7;42;U;;1119;255;509;697;422;2;10;685;695
8;Barcelona;13;Barcelonès;08019;Barcelona;7;43;U;;1030;287;555;659;371;0;19;640;659
8;Barcelona;13;Barcelonès;08019;Barcelona;7;44;U;;1041;333;582;722;319;8;23;691;714
8;Barcelona;13;Barcelonès;08019;Barcelona;7;45;U;;1106;282;566;704;402;7;18;679;697
8;Barcelona;13;Barcelonès;08019;Barcelona;7;46;U;;992;233;501;620;372;4;12;604;616
8;Barcelona;13;Barcelonès;08019;Barcelona;7;47;U;;1013;244;446;566;447;6;19;541;560
8;Barcelona;13;Barcelonès;08019;Barcelona;7;48;U;;950;244;473;606;344;3;13;590;603
8;Barcelona;13;Barcelonès;08019;Barcelona;7;49;U;;937;208;452;577;360;3;24;550;574
8;Barcelona;13;Barcelonès;08019;Barcelona;7;5;U;;1103;245;555;688;415;1;13;674;687
8;Barcelona;13;Barcelonès;08019;Barcelona;7;50;U;;845;200;387;482;363;0;10;472;482
8;Barcelona;13;Barcelonès;08019;Barcelona;7;51;U;;1239;322;604;723;516;1;19;703;722
8;Barcelona;13;Barcelonès;08019;Barcelona;7;52;U;;1032;263;566;699;333;3;39;657;696
8;Barcelona;13;Barcelonès;08019;Barcelona;7;53;U;;1153;242;626;774;379;0;26;748;774
8;Barcelona;13;Barcelonès;08019;Barcelona;7;54;U;;1159;297;611;802;357;5;35;762;797
8;Barcelona;13;Barcelonès;08019;Barcelona;7;55;U;;957;223;611;719;238;2;16;701;717
8;Barcelona;13;Barcelonès;08019;Barcelona;7;56;U;;936;205;444;541;395;2;21;518;539
8;Barcelona;13;Barcelonès;08019;Barcelona;7;57;U;;1149;278;582;743;406;5;26;712;738
8;Barcelona;13;Barcelonès;08019;Barcelona;7;58;U;;1096;251;513;665;431;4;21;640;661
8;Barcelona;13;Barcelonès;08019;Barcelona;7;59;U;;1014;218;384;456;558;0;15;441;456
8;Barcelona;13;Barcelonès;08019;Barcelona;7;6;U;;823;211;429;545;278;6;13;526;539
8;Barcelona;13;Barcelonès;08019;Barcelona;7;60;A;;763;157;277;351;412;2;9;340;349
8;Barcelona;13;Barcelonès;08019;Barcelona;7;60;B;;637;154;240;290;347;4;6;280;286
8;Barcelona;13;Barcelonès;08019;Barcelona;7;61;U;;1005;223;433;544;461;1;12;531;543
8;Barcelona;13;Barcelonès;08019;Barcelona;7;62;U;;917;194;441;528;389;4;21;503;524
8;Barcelona;13;Barcelonès;08019;Barcelona;7;63;U;;1117;264;521;518;599;4;18;496;514
8;Barcelona;13;Barcelonès;08019;Barcelona;7;64;A;;675;157;297;362;313;3;11;348;359
8;Barcelona;13;Barcelonès;08019;Barcelona;7;64;B;;604;123;250;311;293;1;13;297;310
8;Barcelona;13;Barcelonès;08019;Barcelona;7;65;U;;1225;267;472;578;647;3;25;550;575
8;Barcelona;13;Barcelonès;08019;Barcelona;7;66;A;;666;158;246;295;371;3;2;290;292
8;Barcelona;13;Barcelonès;08019;Barcelona;7;66;B;;606;118;238;285;321;0;7;278;285
8;Barcelona;13;Barcelonès;08019;Barcelona;7;67;U;;1081;256;432;511;570;4;11;496;507
8;Barcelona;13;Barcelonès;08019;Barcelona;7;68;U;;871;181;348;429;442;1;7;421;428
8;Barcelona;13;Barcelonès;08019;Barcelona;7;69;U;;1065;241;417;517;548;12;4;501;505
8;Barcelona;13;Barcelonès;08019;Barcelona;7;7;U;;1103;260;500;615;488;2;19;594;613
8;Barcelona;13;Barcelonès;08019;Barcelona;7;70;U;;1037;225;448;524;513;3;9;512;521
8;Barcelona;13;Barcelonès;08019;Barcelona;7;71;U;;1047;263;486;592;455;3;15;574;589
8;Barcelona;13;Barcelonès;08019;Barcelona;7;72;U;;1004;218;416;540;464;4;12;524;536
8;Barcelona;13;Barcelonès;08019;Barcelona;7;73;U;;884;218;422;515;369;3;24;488;512
8;Barcelona;13;Barcelonès;08019;Barcelona;7;74;U;;1246;310;597;694;552;5;12;677;689
8;Barcelona;13;Barcelonès;08019;Barcelona;7;75;U;;885;234;420;512;373;4;19;489;508
8;Barcelona;13;Barcelonès;08019;Barcelona;7;76;U;;962;245;419;503;459;1;21;481;502
8;Barcelona;13;Barcelonès;08019;Barcelona;7;77;U;;962;192;367;449;513;0;24;425;449
8;Barcelona;13;Barcelonès;08019;Barcelona;7;78;U;;1010;185;388;469;541;2;10;457;467
8;Barcelona;13;Barcelonès;08019;Barcelona;7;79;U;;1135;275;505;607;528;0;15;592;607
8;Barcelona;13;Barcelonès;08019;Barcelona;7;8;U;;1135;286;610;763;372;5;27;731;758
8;Barcelona;13;Barcelonès;08019;Barcelona;7;80;U;;1245;294;553;657;588;2;19;636;655
8;Barcelona;13;Barcelonès;08019;Barcelona;7;81;A;;810;181;360;443;367;0;22;421;443
8;Barcelona;13;Barcelonès;08019;Barcelona;7;81;B;;764;159;334;429;335;2;11;416;427
8;Barcelona;13;Barcelonès;08019;Barcelona;7;82;U;;965;219;406;498;467;0;22;476;498
8;Barcelona;13;Barcelonès;08019;Barcelona;7;83;U;;977;215;401;490;487;2;26;462;488
8;Barcelona;13;Barcelonès;08019;Barcelona;7;84;U;;929;272;405;482;447;3;17;462;479
8;Barcelona;13;Barcelonès;08019;Barcelona;7;85;U;;1015;175;394;510;505;3;18;489;507
8;Barcelona;13;Barcelonès;08019;Barcelona;7;86;U;;1044;279;490;583;461;4;13;566;579
8;Barcelona;13;Barcelonès;08019;Barcelona;7;87;U;;1181;276;596;681;500;6;22;653;675
8;Barcelona;13;Barcelonès;08019;Barcelona;7;88;U;;890;210;410;491;399;5;22;464;486
8;Barcelona;13;Barcelonès;08019;Barcelona;7;89;U;;1042;250;503;620;422;0;24;596;620
8;Barcelona;13;Barcelonès;08019;Barcelona;7;9;U;;880;178;438;696;184;2;33;661;694
8;Barcelona;13;Barcelonès;08019;Barcelona;7;90;U;;1113;224;476;579;534;5;22;552;574
8;Barcelona;13;Barcelonès;08019;Barcelona;7;91;U;;899;223;402;499;400;4;20;475;495
8;Barcelona;13;Barcelonès;08019;Barcelona;7;92;U;;1074;252;508;590;484;10;16;564;580
8;Barcelona;13;Barcelonès;08019;Barcelona;7;93;A;;646;142;294;374;272;5;17;352;369
8;Barcelona;13;Barcelonès;08019;Barcelona;7;93;B;;605;132;267;334;271;3;17;314;331
8;Barcelona;13;Barcelonès;08019;Barcelona;7;94;U;;971;250;457;550;421;6;23;521;544
8;Barcelona;13;Barcelonès;08019;Barcelona;7;95;U;;1159;318;596;737;422;20;22;695;717
8;Barcelona;13;Barcelonès;08019;Barcelona;7;96;U;;1087;278;595;699;388;8;13;678;691
8;Barcelona;13;Barcelonès;08019;Barcelona;7;97;U;;795;216;367;390;405;3;6;381;387
8;Barcelona;13;Barcelonès;08019;Barcelona;7;98;A;;729;221;404;511;218;1;22;488;510
8;Barcelona;13;Barcelonès;08019;Barcelona;7;98;B;;635;195;373;469;166;3;16;450;466
8;Barcelona;13;Barcelonès;08019;Barcelona;7;99;U;;902;228;476;620;282;7;20;593;613
8;Barcelona;13;Barcelonès;08019;Barcelona;8;1;U;;1019;249;483;605;414;5;24;576;600
8;Barcelona;13;Barcelonès;08019;Barcelona;8;10;U;;842;230;437;522;320;6;11;505;516
8;Barcelona;13;Barcelonès;08019;Barcelona;8;100;U;;902;240;392;471;431;1;20;450;470
8;Barcelona;13;Barcelonès;08019;Barcelona;8;101;A;;671;195;332;392;279;3;12;377;389
8;Barcelona;13;Barcelonès;08019;Barcelona;8;101;B;;627;175;305;354;273;4;10;340;350
8;Barcelona;13;Barcelonès;08019;Barcelona;8;102;U;;894;225;413;494;400;7;15;472;487
8;Barcelona;13;Barcelonès;08019;Barcelona;8;103;U;;1022;191;309;361;661;7;9;345;354
8;Barcelona;13;Barcelonès;08019;Barcelona;8;104;U;;914;186;309;370;544;0;13;357;370
8;Barcelona;13;Barcelonès;08019;Barcelona;8;105;U;;1053;236;449;500;553;1;9;490;499
8;Barcelona;13;Barcelonès;08019;Barcelona;8;106;U;;1007;202;333;384;623;1;6;377;383
8;Barcelona;13;Barcelonès;08019;Barcelona;8;107;U;;1285;260;415;474;811;3;7;464;471
8;Barcelona;13;Barcelonès;08019;Barcelona;8;108;U;;805;115;212;276;529;1;2;273;275
8;Barcelona;13;Barcelonès;08019;Barcelona;8;109;U;;750;116;173;205;545;0;5;200;205
8;Barcelona;13;Barcelonès;08019;Barcelona;8;11;U;;903;277;486;610;293;4;20;586;606
8;Barcelona;13;Barcelonès;08019;Barcelona;8;110;U;;988;185;320;364;624;1;11;352;363
8;Barcelona;13;Barcelonès;08019;Barcelona;8;111;U;;917;212;372;428;489;0;9;419;428
8;Barcelona;13;Barcelonès;08019;Barcelona;8;112;U;;915;195;364;454;461;2;10;442;452
8;Barcelona;13;Barcelonès;08019;Barcelona;8;113;U;;985;224;359;439;546;2;21;416;437
8;Barcelona;13;Barcelonès;08019;Barcelona;8;114;U;;1156;258;473;539;617;0;16;523;539
8;Barcelona;13;Barcelonès;08019;Barcelona;8;115;U;;925;197;403;494;431;3;10;481;491
8;Barcelona;13;Barcelonès;08019;Barcelona;8;116;U;;945;203;327;388;557;6;11;371;382
8;Barcelona;13;Barcelonès;08019;Barcelona;8;12;U;;974;243;574;652;322;4;28;620;648
8;Barcelona;13;Barcelonès;08019;Barcelona;8;13;U;;891;225;466;597;294;8;24;565;589
8;Barcelona;13;Barcelonès;08019;Barcelona;8;14;U;;850;230;459;545;305;2;17;526;543
8;Barcelona;13;Barcelonès;08019;Barcelona;8;15;U;;1000;262;500;605;395;3;18;584;602
8;Barcelona;13;Barcelonès;08019;Barcelona;8;16;U;;856;243;421;510;346;0;22;488;510
8;Barcelona;13;Barcelonès;08019;Barcelona;8;17;U;;1100;327;582;720;380;9;31;680;711
8;Barcelona;13;Barcelonès;08019;Barcelona;8;18;U;;1164;311;591;724;440;1;31;692;723
8;Barcelona;13;Barcelonès;08019;Barcelona;8;19;U;;1241;303;593;709;532;4;25;680;705
8;Barcelona;13;Barcelonès;08019;Barcelona;8;2;U;;966;292;526;618;348;0;22;596;618
8;Barcelona;13;Barcelonès;08019;Barcelona;8;20;U;;939;265;471;562;377;3;19;540;559
8;Barcelona;13;Barcelonès;08019;Barcelona;8;21;U;;1054;304;515;637;417;0;19;618;637
8;Barcelona;13;Barcelonès;08019;Barcelona;8;22;U;;1010;238;485;623;387;3;27;593;620
8;Barcelona;13;Barcelonès;08019;Barcelona;8;23;U;;949;225;432;578;371;2;9;567;576
8;Barcelona;13;Barcelonès;08019;Barcelona;8;24;U;;1019;226;490;614;405;2;22;590;612
8;Barcelona;13;Barcelonès;08019;Barcelona;8;25;U;;871;235;443;546;325;1;24;521;545
8;Barcelona;13;Barcelonès;08019;Barcelona;8;26;U;;936;274;476;559;377;3;20;536;556
8;Barcelona;13;Barcelonès;08019;Barcelona;8;27;U;;986;230;421;529;457;1;18;510;528
8;Barcelona;13;Barcelonès;08019;Barcelona;8;28;U;;878;200;378;473;405;3;20;450;470
8;Barcelona;13;Barcelonès;08019;Barcelona;8;29;U;;1116;239;457;577;539;3;20;554;574
8;Barcelona;13;Barcelonès;08019;Barcelona;8;3;U;;962;246;517;623;339;3;21;599;620
8;Barcelona;13;Barcelonès;08019;Barcelona;8;30;U;;1012;221;437;566;446;2;17;547;564
8;Barcelona;13;Barcelonès;08019;Barcelona;8;31;U;;1031;251;500;595;436;6;21;568;589
8;Barcelona;13;Barcelonès;08019;Barcelona;8;32;U;;1043;259;514;640;403;6;15;619;634
8;Barcelona;13;Barcelonès;08019;Barcelona;8;33;U;;1015;248;489;570;445;7;12;551;563
8;Barcelona;13;Barcelonès;08019;Barcelona;8;34;U;;866;230;385;452;414;2;9;441;450
8;Barcelona;13;Barcelonès;08019;Barcelona;8;35;U;;1046;270;480;568;478;3;22;543;565
8;Barcelona;13;Barcelonès;08019;Barcelona;8;36;U;;1026;229;418;506;520;4;17;485;502
8;Barcelona;13;Barcelonès;08019;Barcelona;8;37;U;;1066;280;530;627;439;3;20;604;624
8;Barcelona;13;Barcelonès;08019;Barcelona;8;38;U;;1061;256;475;583;478;2;21;560;581
8;Barcelona;13;Barcelonès;08019;Barcelona;8;39;U;;1080;271;528;633;447;2;30;601;631
8;Barcelona;13;Barcelonès;08019;Barcelona;8;4;U;;1010;245;513;619;391;8;17;594;611
8;Barcelona;13;Barcelonès;08019;Barcelona;8;40;U;;1080;249;453;529;551;3;11;515;526
8;Barcelona;13;Barcelonès;08019;Barcelona;8;41;U;;1234;242;458;552;682;3;15;534;549
8;Barcelona;13;Barcelonès;08019;Barcelona;8;42;U;;993;279;552;653;340;6;13;634;647
8;Barcelona;13;Barcelonès;08019;Barcelona;8;43;U;;907;199;397;481;426;3;18;460;478
8;Barcelona;13;Barcelonès;08019;Barcelona;8;44;U;;1009;223;395;466;543;1;9;456;465
8;Barcelona;13;Barcelonès;08019;Barcelona;8;45;U;;1049;259;445;560;489;2;13;545;558
8;Barcelona;13;Barcelonès;08019;Barcelona;8;46;U;;994;274;457;515;479;2;17;496;513
8;Barcelona;13;Barcelonès;08019;Barcelona;8;47;U;;1012;236;408;473;539;2;8;463;471
8;Barcelona;13;Barcelonès;08019;Barcelona;8;48;U;;855;160;284;338;517;1;14;323;337
8;Barcelona;13;Barcelonès;08019;Barcelona;8;49;U;;968;205;369;459;509;5;11;443;454
8;Barcelona;13;Barcelonès;08019;Barcelona;8;5;U;;903;230;460;564;339;10;11;543;554
8;Barcelona;13;Barcelonès;08019;Barcelona;8;50;A;;1212;275;610;745;467;8;20;717;737
8;Barcelona;13;Barcelonès;08019;Barcelona;8;50;B;;992;243;471;582;410;2;11;569;580
8;Barcelona;13;Barcelonès;08019;Barcelona;8;51;U;;990;234;492;624;366;4;18;602;620
8;Barcelona;13;Barcelonès;08019;Barcelona;8;52;U;;755;216;379;462;293;5;24;433;457
8;Barcelona;13;Barcelonès;08019;Barcelona;8;53;U;;881;262;457;559;322;2;16;541;557
8;Barcelona;13;Barcelonès;08019;Barcelona;8;54;A;;713;215;371;452;261;3;11;438;449
8;Barcelona;13;Barcelonès;08019;Barcelona;8;54;B;;677;185;334;421;256;6;9;406;415
8;Barcelona;13;Barcelonès;08019;Barcelona;8;55;A;;784;176;399;506;278;3;14;489;503
8;Barcelona;13;Barcelonès;08019;Barcelona;8;55;B;;770;199;405;512;258;6;16;490;506
8;Barcelona;13;Barcelonès;08019;Barcelona;8;56;U;;1186;300;593;721;465;3;17;701;718
8;Barcelona;13;Barcelonès;08019;Barcelona;8;57;U;;1041;287;525;595;446;4;25;566;591
8;Barcelona;13;Barcelonès;08019;Barcelona;8;58;A;;732;181;347;392;340;0;12;380;392
8;Barcelona;13;Barcelonès;08019;Barcelona;8;58;B;;580;151;262;309;271;0;13;296;309
8;Barcelona;13;Barcelonès;08019;Barcelona;8;59;U;;837;185;333;426;411;4;12;410;422
8;Barcelona;13;Barcelonès;08019;Barcelona;8;6;U;;1055;244;539;674;381;3;22;649;671
8;Barcelona;13;Barcelonès;08019;Barcelona;8;60;U;;1099;235;508;624;475;2;30;592;622
8;Barcelona;13;Barcelonès;08019;Barcelona;8;61;A;;722;163;296;370;352;4;12;354;366
8;Barcelona;13;Barcelonès;08019;Barcelona;8;61;B;;650;150;278;347;303;0;13;334;347
8;Barcelona;13;Barcelonès;08019;Barcelona;8;62;U;;1053;261;516;626;427;0;29;597;626
8;Barcelona;13;Barcelonès;08019;Barcelona;8;63;U;;1033;160;501;603;430;7;4;592;596
8;Barcelona;13;Barcelonès;08019;Barcelona;8;64;A;;770;171;309;389;381;5;13;371;384
8;Barcelona;13;Barcelonès;08019;Barcelona;8;64;B;;644;150;269;323;321;0;7;316;323
8;Barcelona;13;Barcelonès;08019;Barcelona;8;65;U;;1071;185;332;435;636;3;5;427;432
8;Barcelona;13;Barcelonès;08019;Barcelona;8;66;U;;1057;191;316;401;656;2;16;383;399
8;Barcelona;13;Barcelonès;08019;Barcelona;8;67;U;;1136;253;450;557;579;2;18;537;555
8;Barcelona;13;Barcelonès;08019;Barcelona;8;68;U;;1177;246;449;561;616;5;14;542;556
8;Barcelona;13;Barcelonès;08019;Barcelona;8;69;U;;992;296;495;477;515;4;15;458;473
8;Barcelona;13;Barcelonès;08019;Barcelona;8;7;U;;997;308;527;647;350;6;20;621;641
8;Barcelona;13;Barcelonès;08019;Barcelona;8;70;U;;890;185;348;437;453;0;8;429;437
8;Barcelona;13;Barcelonès;08019;Barcelona;8;71;U;;1173;231;452;555;618;4;15;536;551
8;Barcelona;13;Barcelonès;08019;Barcelona;8;72;U;;894;235;415;521;373;6;16;499;515
8;Barcelona;13;Barcelonès;08019;Barcelona;8;73;U;;1137;202;365;444;693;1;10;433;443
8;Barcelona;13;Barcelonès;08019;Barcelona;8;74;U;;941;197;396;485;456;2;12;471;483
8;Barcelona;13;Barcelonès;08019;Barcelona;8;75;A;;676;164;308;357;319;0;8;349;357
8;Barcelona;13;Barcelonès;08019;Barcelona;8;75;B;;622;153;273;308;314;2;14;292;306
8;Barcelona;13;Barcelonès;08019;Barcelona;8;76;U;;1193;271;543;673;520;7;7;659;666
8;Barcelona;13;Barcelonès;08019;Barcelona;8;77;U;;1115;175;322;383;732;0;7;376;383
8;Barcelona;13;Barcelonès;08019;Barcelona;8;78;U;;1099;223;441;513;586;8;14;491;505
8;Barcelona;13;Barcelonès;08019;Barcelona;8;79;U;;902;206;363;426;476;4;15;407;422
8;Barcelona;13;Barcelonès;08019;Barcelona;8;8;U;;1204;233;587;765;439;10;20;735;755
8;Barcelona;13;Barcelonès;08019;Barcelona;8;80;U;;1035;247;448;576;459;9;15;552;567
8;Barcelona;13;Barcelonès;08019;Barcelona;8;81;U;;964;237;440;512;452;1;15;496;511
8;Barcelona;13;Barcelonès;08019;Barcelona;8;82;U;;1144;256;467;601;543;6;26;569;595
8;Barcelona;13;Barcelonès;08019;Barcelona;8;83;U;;892;234;415;495;397;6;6;483;489
8;Barcelona;13;Barcelonès;08019;Barcelona;8;84;U;;873;246;416;514;359;1;13;500;513
8;Barcelona;13;Barcelonès;08019;Barcelona;8;85;U;;1025;232;450;562;463;3;25;534;559
8;Barcelona;13;Barcelonès;08019;Barcelona;8;86;U;;1204;280;550;662;542;13;16;633;649
8;Barcelona;13;Barcelonès;08019;Barcelona;8;87;U;;931;230;423;517;414;6;11;500;511
8;Barcelona;13;Barcelonès;08019;Barcelona;8;88;U;;896;200;375;446;450;0;13;433;446
8;Barcelona;13;Barcelonès;08019;Barcelona;8;89;U;;912;221;376;467;445;2;11;454;465
8;Barcelona;13;Barcelonès;08019;Barcelona;8;9;U;;1220;283;596;730;490;1;17;712;729
8;Barcelona;13;Barcelonès;08019;Barcelona;8;90;U;;933;237;455;544;389;2;15;527;542
8;Barcelona;13;Barcelonès;08019;Barcelona;8;91;U;;921;240;446;516;405;3;14;499;513
8;Barcelona;13;Barcelonès;08019;Barcelona;8;92;U;;808;223;402;479;329;4;16;459;475
8;Barcelona;13;Barcelonès;08019;Barcelona;8;93;U;;926;240;427;515;411;5;11;499;510
8;Barcelona;13;Barcelonès;08019;Barcelona;8;94;U;;1224;316;581;695;529;5;15;675;690
8;Barcelona;13;Barcelonès;08019;Barcelona;8;95;U;;908;181;440;566;342;5;18;543;561
8;Barcelona;13;Barcelonès;08019;Barcelona;8;96;U;;1070;209;510;559;511;4;17;538;555
8;Barcelona;13;Barcelonès;08019;Barcelona;8;97;U;;940;202;433;535;405;3;21;511;532
8;Barcelona;13;Barcelonès;08019;Barcelona;8;98;U;;926;241;435;500;426;3;23;474;497
8;Barcelona;13;Barcelonès;08019;Barcelona;8;99;U;;971;203;407;492;479;7;15;470;485
8;Barcelona;13;Barcelonès;08019;Barcelona;9;1;U;;1212;225;471;528;684;0;10;518;528
8;Barcelona;13;Barcelonès;08019;Barcelona;9;10;U;;1186;260;532;658;528;0;26;632;658
8;Barcelona;13;Barcelonès;08019;Barcelona;9;11;U;;886;157;287;365;521;1;6;358;364
8;Barcelona;13;Barcelonès;08019;Barcelona;9;12;U;;873;170;320;390;483;7;2;381;383
8;Barcelona;13;Barcelonès;08019;Barcelona;9;13;U;;1212;256;492;581;631;11;20;550;570
8;Barcelona;13;Barcelonès;08019;Barcelona;9;14;U;;1089;233;444;531;558;2;24;505;529
8;Barcelona;13;Barcelonès;08019;Barcelona;9;15;U;;1173;258;478;594;579;3;25;566;591
8;Barcelona;13;Barcelonès;08019;Barcelona;9;16;U;;1142;324;558;740;402;4;29;707;736
8;Barcelona;13;Barcelonès;08019;Barcelona;9;17;U;;1067;251;510;639;428;2;23;614;637
8;Barcelona;13;Barcelonès;08019;Barcelona;9;18;U;;1185;307;560;718;467;3;22;693;715
8;Barcelona;13;Barcelonès;08019;Barcelona;9;19;A;;931;208;472;589;342;6;19;564;583
8;Barcelona;13;Barcelonès;08019;Barcelona;9;19;B;;900;197;412;562;338;5;17;540;557
8;Barcelona;13;Barcelonès;08019;Barcelona;9;2;U;;1112;215;454;558;554;10;2;546;548
8;Barcelona;13;Barcelonès;08019;Barcelona;9;20;U;;960;287;536;687;273;2;22;663;685
8;Barcelona;13;Barcelonès;08019;Barcelona;9;21;U;;1067;272;580;737;330;4;14;719;733
8;Barcelona;13;Barcelonès;08019;Barcelona;9;22;U;;977;293;538;663;314;1;25;637;662
8;Barcelona;13;Barcelonès;08019;Barcelona;9;23;U;;916;276;519;651;265;1;25;625;650
8;Barcelona;13;Barcelonès;08019;Barcelona;9;24;U;;932;276;483;610;322;3;19;588;607
8;Barcelona;13;Barcelonès;08019;Barcelona;9;25;U;;921;296;509;621;300;2;29;590;619
8;Barcelona;13;Barcelonès;08019;Barcelona;9;26;U;;1178;284;564;751;427;6;38;707;745
8;Barcelona;13;Barcelonès;08019;Barcelona;9;27;U;;1101;234;507;696;405;12;32;652;684
8;Barcelona;13;Barcelonès;08019;Barcelona;9;28;U;;1120;260;563;744;376;2;24;718;742
8;Barcelona;13;Barcelonès;08019;Barcelona;9;29;U;;981;226;435;592;389;3;18;571;589
8;Barcelona;13;Barcelonès;08019;Barcelona;9;3;U;;1237;284;493;573;664;5;19;549;568
8;Barcelona;13;Barcelonès;08019;Barcelona;9;30;U;;1091;271;580;715;376;3;34;678;712
8;Barcelona;13;Barcelonès;08019;Barcelona;9;31;U;;857;225;465;602;255;0;31;571;602
8;Barcelona;13;Barcelonès;08019;Barcelona;9;32;U;;1028;230;456;553;475;2;11;540;551
8;Barcelona;13;Barcelonès;08019;Barcelona;9;33;A;;1157;209;539;669;488;10;29;630;659
8;Barcelona;13;Barcelonès;08019;Barcelona;9;33;B;;1104;255;494;608;496;2;18;588;606
8;Barcelona;13;Barcelonès;08019;Barcelona;9;34;U;;1148;319;582;698;450;3;39;656;695
8;Barcelona;13;Barcelonès;08019;Barcelona;9;35;U;;1232;296;568;720;512;3;36;681;717
8;Barcelona;13;Barcelonès;08019;Barcelona;9;36;U;;1212;311;630;777;435;10;39;728;767
8;Barcelona;13;Barcelonès;08019;Barcelona;9;37;U;;1133;270;564;655;478;2;30;623;653
8;Barcelona;13;Barcelonès;08019;Barcelona;9;38;U;;1222;292;668;842;380;38;2;802;804
8;Barcelona;13;Barcelonès;08019;Barcelona;9;39;U;;1222;274;590;746;476;12;28;706;734
8;Barcelona;13;Barcelonès;08019;Barcelona;9;4;U;;1023;244;423;494;529;3;16;475;491
8;Barcelona;13;Barcelonès;08019;Barcelona;9;40;U;;1125;317;529;674;451;3;25;646;671
8;Barcelona;13;Barcelonès;08019;Barcelona;9;41;U;;1096;261;553;676;420;15;22;639;661
8;Barcelona;13;Barcelonès;08019;Barcelona;9;42;U;;995;246;485;622;373;1;27;594;621
8;Barcelona;13;Barcelonès;08019;Barcelona;9;43;U;;1054;292;533;649;405;1;20;628;648
8;Barcelona;13;Barcelonès;08019;Barcelona;9;44;U;;1164;296;605;770;394;2;30;738;768
8;Barcelona;13;Barcelonès;08019;Barcelona;9;45;U;;1094;285;556;677;417;5;33;639;672
8;Barcelona;13;Barcelonès;08019;Barcelona;9;46;U;;1062;258;523;697;365;1;29;667;696
8;Barcelona;13;Barcelonès;08019;Barcelona;9;47;U;;1152;315;587;761;391;6;31;724;755
8;Barcelona;13;Barcelonès;08019;Barcelona;9;48;U;;1051;303;567;701;350;6;24;671;695
8;Barcelona;13;Barcelonès;08019;Barcelona;9;49;U;;1002;278;495;631;371;2;26;603;629
8;Barcelona;13;Barcelonès;08019;Barcelona;9;5;U;;983;230;438;530;453;1;14;515;529
8;Barcelona;13;Barcelonès;08019;Barcelona;9;50;A;;660;188;369;458;202;1;28;429;457
8;Barcelona;13;Barcelonès;08019;Barcelona;9;50;B;;588;177;328;407;181;5;10;392;402
8;Barcelona;13;Barcelonès;08019;Barcelona;9;51;U;;934;251;496;608;326;3;27;578;605
8;Barcelona;13;Barcelonès;08019;Barcelona;9;52;U;;926;250;496;588;338;4;23;561;584
8;Barcelona;13;Barcelonès;08019;Barcelona;9;53;U;;1168;458;750;793;375;5;25;763;788
8;Barcelona;13;Barcelonès;08019;Barcelona;9;54;U;;909;258;494;598;311;1;24;573;597
8;Barcelona;13;Barcelonès;08019;Barcelona;9;55;A;;1186;266;567;724;462;2;27;695;722
8;Barcelona;13;Barcelonès;08019;Barcelona;9;55;B;;1103;222;521;665;438;5;19;641;660
8;Barcelona;13;Barcelonès;08019;Barcelona;9;56;U;;1004;256;506;625;379;3;22;600;622
8;Barcelona;13;Barcelonès;08019;Barcelona;9;57;U;;1181;301;619;734;447;23;7;704;711
8;Barcelona;13;Barcelonès;08019;Barcelona;9;58;U;;978;240;517;663;315;15;11;637;648
8;Barcelona;13;Barcelonès;08019;Barcelona;9;59;U;;1024;266;551;677;347;3;19;655;674
8;Barcelona;13;Barcelonès;08019;Barcelona;9;6;U;;919;129;264;331;588;4;6;321;327
8;Barcelona;13;Barcelonès;08019;Barcelona;9;60;U;;1007;258;505;631;376;7;20;604;624
8;Barcelona;13;Barcelonès;08019;Barcelona;9;61;U;;1256;280;646;798;458;1;29;768;797
8;Barcelona;13;Barcelonès;08019;Barcelona;9;62;U;;778;222;407;496;282;6;9;481;490
8;Barcelona;13;Barcelonès;08019;Barcelona;9;63;U;;915;213;412;536;379;6;20;510;530
8;Barcelona;13;Barcelonès;08019;Barcelona;9;64;U;;994;243;547;647;347;2;23;622;645
8;Barcelona;13;Barcelonès;08019;Barcelona;9;65;A;;828;222;451;543;285;4;27;512;539
8;Barcelona;13;Barcelonès;08019;Barcelona;9;65;B;;722;205;410;485;237;2;22;461;483
8;Barcelona;13;Barcelonès;08019;Barcelona;9;66;U;;1010;245;572;685;325;7;17;661;678
8;Barcelona;13;Barcelonès;08019;Barcelona;9;67;U;;1068;279;534;648;420;7;25;616;641
8;Barcelona;13;Barcelonès;08019;Barcelona;9;68;U;;1204;251;596;770;434;4;24;742;766
8;Barcelona;13;Barcelonès;08019;Barcelona;9;69;U;;746;229;396;464;282;0;22;442;464
8;Barcelona;13;Barcelonès;08019;Barcelona;9;7;U;;892;140;277;351;541;2;6;343;349
8;Barcelona;13;Barcelonès;08019;Barcelona;9;70;A;;637;153;290;362;275;4;5;353;358
8;Barcelona;13;Barcelonès;08019;Barcelona;9;70;B;;642;173;306;364;278;5;13;346;359
8;Barcelona;13;Barcelonès;08019;Barcelona;9;71;A;;688;194;370;448;240;1;12;435;447
8;Barcelona;13;Barcelonès;08019;Barcelona;9;71;B;;673;179;311;380;293;1;10;369;379
8;Barcelona;13;Barcelonès;08019;Barcelona;9;72;U;;994;217;459;551;443;2;15;534;549
8;Barcelona;13;Barcelonès;08019;Barcelona;9;73;U;;1255;325;671;839;416;9;27;803;830
8;Barcelona;13;Barcelonès;08019;Barcelona;9;74;U;;1228;320;661;773;455;3;30;740;770
8;Barcelona;13;Barcelonès;08019;Barcelona;9;75;U;;1092;274;570;716;376;9;18;689;707
8;Barcelona;13;Barcelonès;08019;Barcelona;9;76;U;;1086;341;584;677;409;2;25;650;675
8;Barcelona;13;Barcelonès;08019;Barcelona;9;77;U;;1189;330;626;767;422;5;24;738;762
8;Barcelona;13;Barcelonès;08019;Barcelona;9;78;U;;1003;267;545;658;345;4;21;633;654
8;Barcelona;13;Barcelonès;08019;Barcelona;9;79;U;;1210;261;628;804;406;4;33;767;800
8;Barcelona;13;Barcelonès;08019;Barcelona;9;8;U;;1128;246;544;737;391;4;34;699;733
8;Barcelona;13;Barcelonès;08019;Barcelona;9;80;U;;1035;268;547;673;362;2;17;654;671
8;Barcelona;13;Barcelonès;08019;Barcelona;9;81;U;;1255;351;656;779;476;2;25;752;777
8;Barcelona;13;Barcelonès;08019;Barcelona;9;82;A;;655;164;335;401;254;13;5;383;388
8;Barcelona;13;Barcelonès;08019;Barcelona;9;82;B;;651;152;348;408;243;3;20;385;405
8;Barcelona;13;Barcelonès;08019;Barcelona;9;83;U;;1261;276;571;719;542;1;28;690;718
8;Barcelona;13;Barcelonès;08019;Barcelona;9;84;U;;1231;333;664;828;403;4;33;791;824
8;Barcelona;13;Barcelonès;08019;Barcelona;9;85;U;;1227;311;667;815;412;6;27;782;809
8;Barcelona;13;Barcelonès;08019;Barcelona;9;86;U;;991;285;499;619;372;0;38;581;619
8;Barcelona;13;Barcelonès;08019;Barcelona;9;87;U;;971;250;544;652;319;4;18;630;648
8;Barcelona;13;Barcelonès;08019;Barcelona;9;88;A;;632;180;331;415;217;2;12;401;413
8;Barcelona;13;Barcelonès;08019;Barcelona;9;88;B;;611;183;323;397;214;1;11;385;396
8;Barcelona;13;Barcelonès;08019;Barcelona;9;89;U;;1134;347;611;745;389;3;23;719;742
8;Barcelona;13;Barcelonès;08019;Barcelona;9;9;U;;1040;256;461;590;450;0;22;568;590
8;Barcelona;13;Barcelonès;08019;Barcelona;9;90;U;;1176;304;579;705;471;0;16;689;705
8;Barcelona;13;Barcelonès;08019;Barcelona;9;91;A;;768;222;416;520;248;1;10;509;519
8;Barcelona;13;Barcelonès;08019;Barcelona;9;91;B;;629;166;327;409;220;4;11;394;405
8;Barcelona;13;Barcelonès;08019;Barcelona;9;92;A;;796;207;395;493;303;5;19;469;488
8;Barcelona;13;Barcelonès;08019;Barcelona;9;92;B;;685;149;333;423;262;4;20;399;419
8;Barcelona;13;Barcelonès;08019;Barcelona;9;93;U;;1058;237;555;697;361;0;33;664;697
8;Barcelona;13;Barcelonès;08019;Barcelona;9;94;A;;770;236;430;505;265;5;13;487;500
8;Barcelona;13;Barcelonès;08019;Barcelona;9;94;B;;676;197;399;484;192;13;0;471;471
8;Barcelona;13;Barcelonès;08019;Barcelona;9;95;A;;793;220;407;529;264;2;29;498;527
8;Barcelona;13;Barcelonès;08019;Barcelona;9;95;B;;700;174;376;469;231;7;11;451;462
25;Lleida;23;Noguera;25042;Baronia de Rialb, la;1;1;U;;212;60;110;142;70;1;1;140;141
17;Girona;2;Alt Empordà;17016;Bàscara;1;1;U;;719;256;430;504;215;2;17;485;502
25;Lleida;4;Alt Urgell;25044;Bassella;1;1;U;;201;43;118;147;54;0;2;145;147
43;Tarragona;37;Terra Alta;43022;Batea;1;1;A;;394;110;234;306;88;5;3;298;301
43;Tarragona;37;Terra Alta;43022;Batea;1;1;B;;457;108;244;332;125;4;7;321;328
43;Tarragona;37;Terra Alta;43022;Batea;1;2;A;;366;89;205;261;105;3;7;251;258
43;Tarragona;37;Terra Alta;43022;Batea;1;2;B;;342;96;202;254;88;1;8;245;253
25;Lleida;39;Consell General d'Aran;25045;Bausen;1;1;U;;49;13;20;30;19;0;1;29;30
8;Barcelona;11;Baix Llobregat;08020;Begues;1;1;A;;763;188;426;542;221;3;22;517;539
8;Barcelona;11;Baix Llobregat;08020;Begues;1;1;B;;810;218;463;588;222;7;20;561;581
8;Barcelona;11;Baix Llobregat;08020;Begues;1;2;A;;662;180;365;455;207;1;12;442;454
8;Barcelona;11;Baix Llobregat;08020;Begues;1;2;B;;655;186;378;474;181;3;11;460;471
8;Barcelona;11;Baix Llobregat;08020;Begues;1;3;A;;760;178;378;490;270;0;25;465;490
8;Barcelona;11;Baix Llobregat;08020;Begues;1;3;B;;800;179;393;514;286;6;19;489;508
17;Girona;10;Baix Empordà;17013;Begur;1;1;A;;604;182;275;347;257;3;7;337;344
17;Girona;10;Baix Empordà;17013;Begur;1;1;B;;593;140;275;326;267;7;8;311;319
17;Girona;10;Baix Empordà;17013;Begur;1;2;U;;598;145;329;385;213;5;15;365;380
17;Girona;10;Baix Empordà;17013;Begur;1;3;A;;507;212;303;345;162;7;10;328;338
17;Girona;10;Baix Empordà;17013;Begur;1;3;B;;467;143;253;289;178;4;7;278;285
25;Lleida;38;Urgell;25046;Belianes;1;1;U;;439;121;274;330;109;3;20;307;327
25;Lleida;18;Garrigues;25170;Bellaguarda;1;1;U;;270;55;130;187;83;0;12;175;187
17;Girona;10;Baix Empordà;17018;Bellcaire d'Empordà;1;1;U;;478;151;268;323;155;0;3;320;323
25;Lleida;23;Noguera;25047;Bellcaire d'Urgell;1;1;A;;500;150;291;349;151;4;11;334;345
25;Lleida;23;Noguera;25047;Bellcaire d'Urgell;1;1;B;;561;201;371;434;127;2;10;422;432
25;Lleida;27;Pla d'Urgell;25048;Bell-lloc d'Urgell;1;1;U;;767;228;407;531;236;11;16;504;520
25;Lleida;27;Pla d'Urgell;25048;Bell-lloc d'Urgell;1;2;U;;926;252;487;611;315;8;18;585;603
25;Lleida;23;Noguera;25049;Bellmunt d'Urgell;1;1;U;;168;29;88;110;58;0;3;107;110
43;Tarragona;29;Priorat;43023;Bellmunt del Priorat;1;1;U;;247;61;137;165;82;2;7;156;163
8;Barcelona;6;Anoia;08021;Bellprat;1;1;U;;77;17;32;49;28;0;2;47;49
25;Lleida;38;Urgell;25050;Bellpuig;1;1;A;;706;161;284;478;228;7;16;455;471
25;Lleida;38;Urgell;25050;Bellpuig;1;1;B;;708;188;329;437;271;8;14;415;429
25;Lleida;38;Urgell;25050;Bellpuig;1;2;A;;485;115;237;308;177;4;20;284;304
25;Lleida;38;Urgell;25050;Bellpuig;1;2;B;;556;135;288;364;192;2;12;350;362
25;Lleida;38;Urgell;25050;Bellpuig;1;3;U;;788;201;418;529;259;2;17;510;527
43;Tarragona;12;Baix Penedès;43024;Bellvei;1;1;A;;597;154;292;348;249;2;15;331;346
43;Tarragona;12;Baix Penedès;43024;Bellvei;1;1;B;;834;223;440;521;313;3;23;495;518
25;Lleida;15;Cerdanya;25051;Bellver de Cerdanya;1;1;A;;755;170;375;490;265;4;5;481;486
25;Lleida;15;Cerdanya;25051;Bellver de Cerdanya;1;1;B;;926;238;450;585;341;7;17;561;578
25;Lleida;27;Pla d'Urgell;25052;Bellvís;1;1;A;;857;198;495;576;281;7;13;556;569
25;Lleida;27;Pla d'Urgell;25052;Bellvís;1;1;B;;770;196;457;547;223;4;19;524;543
25;Lleida;33;Segrià;25053;Benavent de Segrià;1;1;A;;551;113;257;345;206;3;14;328;342
25;Lleida;33;Segrià;25053;Benavent de Segrià;1;1;B;;538;129;262;343;195;1;10;332;342
43;Tarragona;9;Baix Ebre;43025;Benifallet;1;1;U;;667;169;369;473;194;15;16;442;458
43;Tarragona;30;Ribera d'Ebre;43026;Benissanet;1;1;U;;804;156;360;524;280;9;11;504;515
8;Barcelona;14;Berguedà;08022;Berga;1;1;A;;540;144;275;341;199;3;13;325;338
8;Barcelona;14;Berguedà;08022;Berga;1;1;B;;566;156;283;326;240;5;4;317;321
8;Barcelona;14;Berguedà;08022;Berga;1;2;A;;469;147;244;295;174;2;10;283;293
8;Barcelona;14;Berguedà;08022;Berga;1;2;B;;503;148;260;329;174;4;9;316;325
8;Barcelona;14;Berguedà;08022;Berga;1;3;U;;749;238;441;548;201;3;11;534;545
8;Barcelona;14;Berguedà;08022;Berga;1;4;A;;742;206;374;473;269;6;25;442;467
8;Barcelona;14;Berguedà;08022;Berga;1;4;B;;850;254;450;548;302;4;22;522;544
8;Barcelona;14;Berguedà;08022;Berga;1;5;A;;672;226;398;462;210;4;12;446;458
8;Barcelona;14;Berguedà;08022;Berga;1;5;B;;724;216;413;499;225;1;23;475;498
8;Barcelona;14;Berguedà;08022;Berga;1;6;A;;313;83;156;184;129;2;3;179;182
8;Barcelona;14;Berguedà;08022;Berga;1;6;B;;310;90;155;180;130;1;4;175;179
8;Barcelona;14;Berguedà;08022;Berga;2;1;A;;359;95;146;174;185;11;3;160;163
8;Barcelona;14;Berguedà;08022;Berga;2;1;B;;353;81;137;164;189;4;7;153;160
8;Barcelona;14;Berguedà;08022;Berga;2;2;U;;709;193;318;377;332;4;8;365;373
8;Barcelona;14;Berguedà;08022;Berga;2;3;A;;501;139;139;320;181;2;6;312;318
8;Barcelona;14;Berguedà;08022;Berga;2;3;B;;687;182;348;413;274;1;15;397;412
8;Barcelona;14;Berguedà;08022;Berga;2;4;A;;629;198;413;415;214;3;13;399;412
8;Barcelona;14;Berguedà;08022;Berga;2;4;B;;780;232;351;494;286;10;10;474;484
8;Barcelona;14;Berguedà;08022;Berga;2;5;A;;423;121;175;196;227;3;4;189;193
8;Barcelona;14;Berguedà;08022;Berga;2;5;B;;490;138;204;235;255;1;5;229;234
8;Barcelona;14;Berguedà;08022;Berga;3;1;A;;207;55;96;115;92;0;6;109;115
8;Barcelona;14;Berguedà;08022;Berga;3;1;B;;274;88;164;205;69;4;1;200;201
8;Barcelona;14;Berguedà;08022;Berga;4;1;U;;604;145;307;394;210;6;16;372;388
17;Girona;19;Garrotxa;17019;Besalú;1;1;A;;850;279;533;622;228;11;14;597;611
17;Girona;19;Garrotxa;17019;Besalú;1;1;B;;924;326;584;680;244;13;14;653;667
17;Girona;20;Gironès;17020;Bescanó;1;1;A;;396;104;226;274;122;1;5;268;273
17;Girona;20;Gironès;17020;Bescanó;1;1;B;;426;119;242;271;155;0;5;266;271
17;Girona;20;Gironès;17020;Bescanó;1;1;C;;330;98;198;236;94;1;5;230;235
17;Girona;20;Gironès;17020;Bescanó;1;2;A;;422;115;219;249;173;1;10;238;248
17;Girona;20;Gironès;17020;Bescanó;1;2;B;;351;112;197;252;99;3;7;242;249
17;Girona;20;Gironès;17020;Bescanó;1;3;A;;481;142;278;343;138;9;16;318;334
17;Girona;20;Gironès;17020;Bescanó;1;3;B;;513;151;280;331;182;7;8;316;324
17;Girona;20;Gironès;17020;Bescanó;1;3;C;;465;129;275;323;142;3;11;309;320
17;Girona;19;Garrotxa;17021;Beuda;1;1;U;;114;52;80;88;26;1;1;86;87
8;Barcelona;41;Vallès Oriental;08023;Bigues i Riells;1;1;A;;678;189;348;428;250;2;10;416;426
8;Barcelona;41;Vallès Oriental;08023;Bigues i Riells;1;1;B;;718;175;353;452;266;3;15;434;449
8;Barcelona;41;Vallès Oriental;08023;Bigues i Riells;1;2;A;;679;134;312;412;267;2;6;404;410
8;Barcelona;41;Vallès Oriental;08023;Bigues i Riells;1;2;B;;737;160;348;436;301;1;11;424;435
8;Barcelona;41;Vallès Oriental;08023;Bigues i Riells;1;3;A;;680;169;347;375;305;4;9;362;371
8;Barcelona;41;Vallès Oriental;08023;Bigues i Riells;1;3;B;;911;220;398;477;434;2;13;462;475
8;Barcelona;41;Vallès Oriental;08023;Bigues i Riells;1;4;A;;625;167;280;336;289;4;9;323;332
8;Barcelona;41;Vallès Oriental;08023;Bigues i Riells;1;4;B;;785;172;323;402;383;3;10;389;399
8;Barcelona;41;Vallès Oriental;08023;Bigues i Riells;1;5;U;;677;186;347;445;232;1;11;433;444
25;Lleida;32;Segarra;25055;Biosca;1;1;U;;189;40;90;118;71;1;2;115;117
17;Girona;10;Baix Empordà;17022;Bisbal d'Empordà, la;1;2;A;;570;140;292;351;219;2;12;337;349
17;Girona;10;Baix Empordà;17022;Bisbal d'Empordà, la;1;2;B;;530;132;284;331;199;5;22;304;326
17;Girona;10;Baix Empordà;17022;Bisbal d'Empordà, la;1;3;A;;619;168;304;360;259;2;16;342;358
17;Girona;10;Baix Empordà;17022;Bisbal d'Empordà, la;1;3;B;;611;138;277;338;273;3;13;322;335
17;Girona;10;Baix Empordà;17022;Bisbal d'Empordà, la;1;4;A;;757;189;368;444;313;9;16;419;435
17;Girona;10;Baix Empordà;17022;Bisbal d'Empordà, la;1;4;B;;760;177;388;473;287;6;14;453;467
17;Girona;10;Baix Empordà;17022;Bisbal d'Empordà, la;2;1;A;;605;149;294;362;243;0;10;352;362
17;Girona;10;Baix Empordà;17022;Bisbal d'Empordà, la;2;1;B;;568;158;256;317;251;3;11;303;314
17;Girona;10;Baix Empordà;17022;Bisbal d'Empordà, la;2;2;A;;474;127;239;277;197;3;9;265;274
17;Girona;10;Baix Empordà;17022;Bisbal d'Empordà, la;2;2;B;;455;113;215;270;185;3;12;255;267
17;Girona;10;Baix Empordà;17022;Bisbal d'Empordà, la;2;3;U;;835;212;413;477;358;7;16;454;470
43;Tarragona;29;Priorat;43027;Bisbal de Falset, la;1;1;U;;182;47;100;121;61;1;4;116;120
43;Tarragona;12;Baix Penedès;43028;Bisbal del Penedès, la;1;1;A;;832;204;356;435;397;14;7;414;421
43;Tarragona;12;Baix Penedès;43028;Bisbal del Penedès, la;1;1;B;;823;192;342;439;384;13;4;422;426
43;Tarragona;12;Baix Penedès;43028;Bisbal del Penedès, la;1;1;C;;916;222;400;493;423;10;12;471;483
17;Girona;2;Alt Empordà;17234;Biure;1;1;U;;175;56;106;120;55;1;4;115;119
43;Tarragona;16;Conca de Barberà;43029;Blancafort;1;1;U;;338;54;162;202;136;0;11;191;202
17;Girona;34;Selva;17023;Blanes;1;1;A;;477;147;273;313;164;4;3;306;309
17;Girona;34;Selva;17023;Blanes;1;1;B;;470;140;266;325;145;5;7;313;320
17;Girona;34;Selva;17023;Blanes;1;2;A;;653;230;433;421;232;6;14;401;415
17;Girona;34;Selva;17023;Blanes;1;2;B;;645;210;354;431;214;0;13;418;431
17;Girona;34;Selva;17023;Blanes;1;4;A;;674;212;344;392;282;5;9;378;387
17;Girona;34;Selva;17023;Blanes;1;4;B;;737;237;379;431;306;2;14;415;429
17;Girona;34;Selva;17023;Blanes;1;6;U;;1323;238;498;602;721;12;21;569;590
17;Girona;34;Selva;17023;Blanes;1;7;U;;742;207;414;488;254;13;23;452;475
17;Girona;34;Selva;17023;Blanes;2;1;A;;820;232;422;492;328;3;23;466;489
17;Girona;34;Selva;17023;Blanes;2;1;B;;865;252;422;496;369;0;14;482;496
17;Girona;34;Selva;17023;Blanes;2;10;A;;845;151;292;376;469;1;7;368;375
17;Girona;34;Selva;17023;Blanes;2;10;B;;778;134;273;337;441;1;6;330;336
17;Girona;34;Selva;17023;Blanes;2;11;A;;863;184;359;469;394;2;15;452;467
17;Girona;34;Selva;17023;Blanes;2;11;B;;757;170;334;445;312;3;11;431;442
17;Girona;34;Selva;17023;Blanes;2;12;U;;727;190;330;402;325;4;13;385;398
17;Girona;34;Selva;17023;Blanes;2;2;U;;932;271;449;509;423;6;14;489;503
17;Girona;34;Selva;17023;Blanes;2;3;A;;624;111;230;284;340;7;13;264;277
17;Girona;34;Selva;17023;Blanes;2;3;B;;671;145;275;337;334;5;12;320;332
17;Girona;34;Selva;17023;Blanes;2;4;A;;783;229;386;453;330;0;13;440;453
17;Girona;34;Selva;17023;Blanes;2;4;B;;807;218;370;441;366;1;16;424;440
17;Girona;34;Selva;17023;Blanes;2;5;A;;892;195;376;464;428;2;14;448;462
17;Girona;34;Selva;17023;Blanes;2;5;B;;827;183;373;452;375;1;17;434;451
17;Girona;34;Selva;17023;Blanes;2;6;A;;967;207;478;592;375;2;14;576;590
17;Girona;34;Selva;17023;Blanes;2;6;B;;881;227;445;539;342;6;15;518;533
17;Girona;34;Selva;17023;Blanes;2;7;A;;848;163;382;457;391;6;12;439;451
17;Girona;34;Selva;17023;Blanes;2;7;B;;875;186;396;481;394;3;10;468;478
17;Girona;34;Selva;17023;Blanes;2;8;U;;855;205;435;548;307;8;18;522;540
17;Girona;34;Selva;17023;Blanes;2;9;U;;662;183;341;375;287;4;10;361;371
17;Girona;34;Selva;17023;Blanes;3;1;A;;539;108;230;280;259;3;10;267;277
17;Girona;34;Selva;17023;Blanes;3;1;B;;539;108;242;283;256;0;9;274;283
17;Girona;34;Selva;17023;Blanes;3;2;A;;450;119;211;246;204;1;5;240;245
17;Girona;34;Selva;17023;Blanes;3;2;B;;435;142;229;260;175;0;6;254;260
17;Girona;34;Selva;17023;Blanes;3;3;A;;557;114;235;286;271;5;10;271;281
17;Girona;34;Selva;17023;Blanes;3;3;B;;583;117;248;309;274;2;10;297;307
17;Girona;34;Selva;17023;Blanes;3;3;C;;245;90;144;162;83;3;1;158;159
17;Girona;34;Selva;17023;Blanes;3;4;A;;554;107;188;233;321;2;10;221;231
17;Girona;34;Selva;17023;Blanes;3;4;B;;1035;187;434;547;488;1;20;526;546
17;Girona;2;Alt Empordà;17029;Boadella i les Escaules;1;1;U;;194;67;112;143;51;1;1;141;142
17;Girona;15;Cerdanya;17024;Bolvir;1;1;U;;297;90;162;211;86;1;1;209;210
43;Tarragona;12;Baix Penedès;43030;Bonastre;1;1;U;;459;121;232;277;182;2;15;260;275
25;Lleida;39;Consell General d'Aran;25057;Bòrdes, es;1;1;U;;199;32;80;114;85;2;2;110;112
17;Girona;20;Gironès;17025;Bordils;1;1;U;;1127;306;635;782;345;9;23;750;773
25;Lleida;18;Garrigues;25058;Borges Blanques, les;1;1;U;;682;122;261;380;302;0;11;369;380
25;Lleida;18;Garrigues;25058;Borges Blanques, les;1;2;A;;519;106;247;342;177;2;11;329;340
25;Lleida;18;Garrigues;25058;Borges Blanques, les;1;2;B;;639;114;291;403;236;2;6;395;401
25;Lleida;18;Garrigues;25058;Borges Blanques, les;2;1;A;;683;140;303;424;259;1;11;412;423
25;Lleida;18;Garrigues;25058;Borges Blanques, les;2;1;B;;746;153;334;455;291;3;26;426;452
25;Lleida;18;Garrigues;25058;Borges Blanques, les;2;2;A;;498;116;226;294;204;4;4;286;290
25;Lleida;18;Garrigues;25058;Borges Blanques, les;2;2;B;;604;101;239;341;263;0;14;327;341
43;Tarragona;8;Baix Camp;43031;Borges del Camp, les;1;1;A;;524;120;303;366;158;5;12;349;361
43;Tarragona;8;Baix Camp;43031;Borges del Camp, les;1;1;B;;483;134;257;324;159;1;11;312;323
43;Tarragona;8;Baix Camp;43031;Borges del Camp, les;1;1;C;;508;141;276;348;160;2;9;337;346
17;Girona;2;Alt Empordà;17026;Borrassà;1;1;U;;531;157;319;385;146;2;10;373;383
8;Barcelona;14;Berguedà;08024;Borredà;1;1;U;;407;123;209;268;139;0;11;257;268
25;Lleida;39;Consell General d'Aran;25059;Bossòst;1;1;U;;789;201;405;481;308;2;7;472;479
43;Tarragona;37;Terra Alta;43032;Bot;1;1;U;;588;157;340;435;153;0;10;425;435
43;Tarragona;8;Baix Camp;43033;Botarell;1;1;U;;748;184;378;481;267;0;16;465;481
25;Lleida;18;Garrigues;25056;Bovera;1;1;U;;301;52;129;183;118;2;6;175;181
43;Tarragona;1;Alt Camp;43034;Bràfim;1;1;U;;496;143;283;340;156;5;14;321;335
17;Girona;34;Selva;17027;Breda;1;1;A;;552;136;302;360;192;1;11;348;359
17;Girona;34;Selva;17027;Breda;1;1;B;;589;141;294;351;238;4;9;338;347
17;Girona;34;Selva;17027;Breda;1;1;C;;460;92;245;302;158;10;10;282;292
17;Girona;34;Selva;17027;Breda;1;2;A;;629;153;329;405;224;3;10;392;402
17;Girona;34;Selva;17027;Breda;1;2;B;;673;168;377;447;226;2;12;433;445
8;Barcelona;6;Anoia;08025;Bruc, el;1;1;A;;650;157;327;406;244;3;15;388;403
8;Barcelona;6;Anoia;08025;Bruc, el;1;1;B;;781;185;391;480;301;2;14;464;478
8;Barcelona;24;Osona;08026;Brull, el;1;1;U;;180;61;131;146;34;0;0;146;146
17;Girona;34;Selva;17028;Brunyola i Sant Martí Sapresa;1;1;U;;310;104;192;211;99;0;6;205;211
43;Tarragona;29;Priorat;43035;Cabacés;1;1;U;;279;75;155;193;86;2;6;185;191
25;Lleida;23;Noguera;25060;Cabanabona;1;1;U;;92;24;48;55;37;0;2;53;55
17;Girona;2;Alt Empordà;17031;Cabanelles;1;1;U;;172;30;74;99;73;2;6;91;97
17;Girona;2;Alt Empordà;17030;Cabanes;1;1;U;;627;159;330;374;253;6;9;359;368
8;Barcelona;3;Alt Penedès;08027;Cabanyes, les;1;1;U;;659;251;390;497;162;6;6;485;491
25;Lleida;4;Alt Urgell;25061;Cabó;1;1;U;;78;15;34;45;33;0;0;45;45
43;Tarragona;1;Alt Camp;43036;Cabra del Camp;1;1;U;;829;151;350;404;425;2;7;395;402
8;Barcelona;6;Anoia;08028;Cabrera d'Anoia;1;1;U;;1043;258;468;550;493;1;5;544;549
8;Barcelona;21;Maresme;08029;Cabrera de Mar;1;1;A;;603;182;359;436;167;1;6;429;435
8;Barcelona;21;Maresme;08029;Cabrera de Mar;1;1;B;;532;161;310;368;164;17;2;349;351
8;Barcelona;21;Maresme;08029;Cabrera de Mar;1;1;C;;636;193;377;476;160;3;9;464;473
8;Barcelona;21;Maresme;08029;Cabrera de Mar;1;2;A;;604;178;372;471;133;3;8;460;468
8;Barcelona;21;Maresme;08029;Cabrera de Mar;1;2;B;;536;140;300;363;173;3;8;352;360
8;Barcelona;21;Maresme;08029;Cabrera de Mar;1;2;C;;453;142;266;319;134;1;8;310;318
8;Barcelona;21;Maresme;08030;Cabrils;1;1;A;;892;257;514;649;243;2;20;627;647
8;Barcelona;21;Maresme;08030;Cabrils;1;1;B;;769;229;432;523;246;1;12;510;522
8;Barcelona;21;Maresme;08030;Cabrils;1;1;C;;762;220;417;517;245;2;11;504;515
8;Barcelona;21;Maresme;08030;Cabrils;1;2;A;;825;233;466;585;240;2;19;564;583
8;Barcelona;21;Maresme;08030;Cabrils;1;2;B;;812;217;452;566;246;1;13;552;565
8;Barcelona;21;Maresme;08030;Cabrils;1;2;C;;759;238;454;561;198;1;14;546;560
17;Girona;2;Alt Empordà;17032;Cadaqués;1;1;A;;819;249;377;453;366;2;11;440;451
17;Girona;2;Alt Empordà;17032;Cadaqués;1;1;B;;778;225;369;441;337;1;9;431;440
8;Barcelona;6;Anoia;08031;Calaf;1;1;U;;505;138;282;346;159;1;9;336;345
8;Barcelona;6;Anoia;08031;Calaf;1;2;A;;601;129;313;424;177;6;14;404;418
8;Barcelona;6;Anoia;08031;Calaf;1;2;B;;541;113;256;344;197;2;14;328;342
8;Barcelona;6;Anoia;08031;Calaf;1;2;C;;656;154;360;458;198;2;13;443;456
43;Tarragona;12;Baix Penedès;43037;Calafell;1;1;A;;856;216;371;456;400;4;10;442;452
43;Tarragona;12;Baix Penedès;43037;Calafell;1;1;B;;795;194;328;400;395;6;5;389;394
43;Tarragona;12;Baix Penedès;43037;Calafell;1;1;C;;831;197;335;411;420;3;16;392;408
43;Tarragona;12;Baix Penedès;43037;Calafell;1;1;D;;851;217;369;443;408;8;11;424;435
43;Tarragona;12;Baix Penedès;43037;Calafell;1;1;E;;274;65;114;147;127;3;4;140;144
43;Tarragona;12;Baix Penedès;43037;Calafell;1;2;A;;590;159;269;322;268;6;4;312;316
43;Tarragona;12;Baix Penedès;43037;Calafell;1;2;B;;654;167;307;375;279;2;4;369;373
43;Tarragona;12;Baix Penedès;43037;Calafell;1;3;A;;453;119;203;261;192;2;7;252;259
43;Tarragona;12;Baix Penedès;43037;Calafell;1;3;B;;445;111;219;265;180;1;8;256;264
43;Tarragona;12;Baix Penedès;43037;Calafell;1;3;C;;730;183;364;449;281;4;5;440;445
43;Tarragona;12;Baix Penedès;43037;Calafell;2;1;A;;526;133;230;302;224;0;10;292;302
43;Tarragona;12;Baix Penedès;43037;Calafell;2;1;B;;448;128;219;265;183;3;9;253;262
43;Tarragona;12;Baix Penedès;43037;Calafell;2;1;C;;646;169;308;375;271;3;10;362;372
43;Tarragona;12;Baix Penedès;43037;Calafell;2;1;D;;639;175;313;393;246;3;17;373;390
43;Tarragona;12;Baix Penedès;43037;Calafell;2;2;A;;715;153;279;344;371;5;15;324;339
43;Tarragona;12;Baix Penedès;43037;Calafell;2;2;B;;852;153;337;414;438;3;7;404;411
43;Tarragona;12;Baix Penedès;43037;Calafell;2;2;C;;820;150;322;401;419;4;15;382;397
43;Tarragona;12;Baix Penedès;43037;Calafell;2;3;A;;678;147;227;275;403;1;1;273;274
43;Tarragona;12;Baix Penedès;43037;Calafell;2;3;B;;615;151;231;251;364;4;5;242;247
43;Tarragona;12;Baix Penedès;43037;Calafell;2;3;C;;590;132;226;253;337;2;7;244;251
43;Tarragona;12;Baix Penedès;43037;Calafell;2;3;D;;426;86;146;169;257;0;1;168;169
43;Tarragona;12;Baix Penedès;43037;Calafell;2;3;E;;430;102;171;197;233;3;5;189;194
43;Tarragona;12;Baix Penedès;43037;Calafell;3;1;A;;818;174;303;353;465;3;13;337;350
43;Tarragona;12;Baix Penedès;43037;Calafell;3;1;B;;941;201;338;405;536;2;9;394;403
43;Tarragona;12;Baix Penedès;43037;Calafell;3;1;C;;935;224;338;411;524;3;9;399;408
8;Barcelona;;;08034;Calders;1;1;U;;739;246;445;534;205;6;9;519;528
8;Barcelona;21;Maresme;08032;Caldes d'Estrac;1;1;A;;909;272;507;617;292;4;11;602;613
8;Barcelona;21;Maresme;08032;Caldes d'Estrac;1;1;B;;1046;256;534;655;391;1;19;635;654
17;Girona;34;Selva;17033;Caldes de Malavella;1;1;A;;725;229;367;438;287;3;11;424;435
17;Girona;34;Selva;17033;Caldes de Malavella;1;1;B;;736;173;376;446;290;5;15;426;441
17;Girona;34;Selva;17033;Caldes de Malavella;1;2;A;;777;185;278;349;428;3;6;340;346
17;Girona;34;Selva;17033;Caldes de Malavella;1;2;B;;828;214;319;399;429;3;19;377;396
17;Girona;34;Selva;17033;Caldes de Malavella;1;3;U;;955;376;519;612;343;4;17;591;608
17;Girona;34;Selva;17033;Caldes de Malavella;1;4;A;;548;154;218;257;291;3;7;247;254
17;Girona;34;Selva;17033;Caldes de Malavella;1;4;B;;552;174;216;260;292;2;7;251;258
8;Barcelona;41;Vallès Oriental;08033;Caldes de Montbui;1;1;A;;511;147;285;352;159;1;10;341;351
8;Barcelona;41;Vallès Oriental;08033;Caldes de Montbui;1;1;B;;673;197;353;443;230;2;7;434;441
8;Barcelona;41;Vallès Oriental;08033;Caldes de Montbui;1;2;A;;547;153;278;348;199;3;12;333;345
8;Barcelona;41;Vallès Oriental;08033;Caldes de Montbui;1;2;B;;611;168;298;345;266;2;11;332;343
8;Barcelona;41;Vallès Oriental;08033;Caldes de Montbui;1;2;C;;549;135;245;302;247;3;7;292;299
8;Barcelona;41;Vallès Oriental;08033;Caldes de Montbui;1;3;U;;676;187;369;436;240;3;19;414;433
8;Barcelona;41;Vallès Oriental;08033;Caldes de Montbui;2;1;A;;552;161;298;382;170;2;11;369;380
8;Barcelona;41;Vallès Oriental;08033;Caldes de Montbui;2;1;B;;583;151;274;354;229;1;10;343;353
8;Barcelona;41;Vallès Oriental;08033;Caldes de Montbui;2;1;C;;580;153;315;382;198;2;11;369;380
8;Barcelona;41;Vallès Oriental;08033;Caldes de Montbui;3;1;A;;610;172;316;396;214;4;8;384;392
8;Barcelona;41;Vallès Oriental;08033;Caldes de Montbui;3;1;B;;740;164;365;449;291;6;12;431;443
8;Barcelona;41;Vallès Oriental;08033;Caldes de Montbui;3;2;U;;654;174;325;396;258;4;4;388;392
8;Barcelona;41;Vallès Oriental;08033;Caldes de Montbui;3;3;A;;772;194;350;465;307;0;23;442;465
8;Barcelona;41;Vallès Oriental;08033;Caldes de Montbui;3;3;B;;791;195;354;456;335;1;18;437;455
8;Barcelona;41;Vallès Oriental;08033;Caldes de Montbui;3;3;C;;754;174;332;410;344;2;8;400;408
8;Barcelona;41;Vallès Oriental;08033;Caldes de Montbui;3;3;D;;817;207;378;477;340;1;14;462;476
8;Barcelona;41;Vallès Oriental;08033;Caldes de Montbui;3;4;A;;612;168;316;401;211;2;12;387;399
8;Barcelona;41;Vallès Oriental;08033;Caldes de Montbui;3;4;B;;679;216;361;452;227;1;11;440;451
8;Barcelona;41;Vallès Oriental;08033;Caldes de Montbui;3;4;C;;665;195;360;435;230;1;11;423;434
8;Barcelona;21;Maresme;08035;Calella;1;1;A;;509;150;246;283;226;1;6;276;282
8;Barcelona;21;Maresme;08035;Calella;1;1;B;;631;148;282;358;273;3;0;355;355
8;Barcelona;21;Maresme;08035;Calella;1;2;A;;374;102;205;252;122;3;4;245;249
8;Barcelona;21;Maresme;08035;Calella;1;2;B;;403;123;224;276;127;2;3;271;274
8;Barcelona;21;Maresme;08035;Calella;1;3;A;;456;138;208;257;199;2;8;247;255
8;Barcelona;21;Maresme;08035;Calella;1;3;B;;482;118;204;239;243;0;6;233;239
8;Barcelona;21;Maresme;08035;Calella;1;3;C;;513;131;218;266;247;4;4;258;262
8;Barcelona;21;Maresme;08035;Calella;2;1;U;;719;189;379;461;258;3;7;451;458
8;Barcelona;21;Maresme;08035;Calella;2;2;A;;472;122;233;283;189;2;1;280;281
8;Barcelona;21;Maresme;08035;Calella;2;2;B;;510;133;258;314;196;1;7;306;313
8;Barcelona;21;Maresme;08035;Calella;2;2;C;;540;186;296;354;186;2;5;347;352
8;Barcelona;21;Maresme;08035;Calella;3;1;A;;545;173;300;358;187;1;5;352;357
8;Barcelona;21;Maresme;08035;Calella;3;1;B;;588;156;297;361;227;4;9;348;357
8;Barcelona;21;Maresme;08035;Calella;3;1;C;;617;173;343;407;210;1;9;397;406
8;Barcelona;21;Maresme;08035;Calella;3;2;A;;482;130;221;280;202;0;7;273;280
8;Barcelona;21;Maresme;08035;Calella;3;2;B;;499;110;210;269;230;3;3;263;266
8;Barcelona;21;Maresme;08035;Calella;3;2;C;;497;159;265;303;194;5;5;293;298
8;Barcelona;21;Maresme;08035;Calella;3;2;D;;515;151;256;311;204;2;5;304;309
8;Barcelona;21;Maresme;08035;Calella;3;3;A;;609;162;320;404;205;2;5;397;402
8;Barcelona;21;Maresme;08035;Calella;3;3;B;;506;122;242;302;204;0;14;288;302
8;Barcelona;21;Maresme;08035;Calella;3;3;C;;546;131;241;306;240;7;1;298;299
8;Barcelona;21;Maresme;08035;Calella;3;3;D;;502;138;237;317;185;0;3;314;317
8;Barcelona;21;Maresme;08035;Calella;3;3;E;;414;115;223;271;143;0;7;264;271
8;Barcelona;24;Osona;08037;Calldetenes;1;1;A;;903;304;521;674;229;6;21;647;668
8;Barcelona;24;Osona;08037;Calldetenes;1;1;B;;916;305;545;666;250;10;27;629;656
8;Barcelona;7;Bages;08038;Callús;1;1;A;;615;134;308;384;231;2;21;361;382
8;Barcelona;7;Bages;08038;Callús;1;1;B;;756;190;395;477;279;6;17;454;471
17;Girona;10;Baix Empordà;17034;Calonge i Sant Antoni;1;1;A;;526;132;250;308;218;2;5;301;306
17;Girona;10;Baix Empordà;17034;Calonge i Sant Antoni;1;1;B;;594;123;239;290;304;4;6;280;286
17;Girona;10;Baix Empordà;17034;Calonge i Sant Antoni;1;1;C;;699;167;338;400;299;4;3;393;396
17;Girona;10;Baix Empordà;17034;Calonge i Sant Antoni;1;2;A;;496;139;226;279;217;7;10;262;272
17;Girona;10;Baix Empordà;17034;Calonge i Sant Antoni;1;2;B;;605;180;260;316;289;3;7;306;313
17;Girona;10;Baix Empordà;17034;Calonge i Sant Antoni;1;3;A;;672;175;334;389;283;4;11;374;385
17;Girona;10;Baix Empordà;17034;Calonge i Sant Antoni;1;3;B;;624;162;299;360;264;4;10;346;356
17;Girona;10;Baix Empordà;17034;Calonge i Sant Antoni;1;4;A;;644;131;271;335;309;2;10;323;333
17;Girona;10;Baix Empordà;17034;Calonge i Sant Antoni;1;4;B;;694;154;308;381;313;2;17;362;379
17;Girona;10;Baix Empordà;17034;Calonge i Sant Antoni;1;5;A;;507;150;220;265;242;2;6;257;263
17;Girona;10;Baix Empordà;17034;Calonge i Sant Antoni;1;5;B;;584;187;254;316;268;2;8;306;314
8;Barcelona;6;Anoia;08036;Calonge de Segarra;1;1;U;;165;47;96;125;40;1;2;122;124
25;Lleida;23;Noguera;25062;Camarasa;1;1;U;;814;211;407;526;288;4;25;497;522
43;Tarragona;9;Baix Ebre;43903;Camarles;1;1;A;;612;153;294;375;237;8;18;349;367
43;Tarragona;9;Baix Ebre;43903;Camarles;1;1;B;;548;124;252;318;230;3;10;305;315
43;Tarragona;9;Baix Ebre;43903;Camarles;1;1;C;;457;114;221;272;185;1;1;270;271
43;Tarragona;9;Baix Ebre;43903;Camarles;1;2;A;;394;75;172;201;193;0;5;196;201
43;Tarragona;9;Baix Ebre;43903;Camarles;1;2;B;;372;80;171;196;176;2;5;189;194
43;Tarragona;8;Baix Camp;43038;Cambrils;1;1;A;;602;156;234;298;304;0;10;288;298
43;Tarragona;8;Baix Camp;43038;Cambrils;1;1;B;;732;185;298;370;362;5;7;358;365
43;Tarragona;8;Baix Camp;43038;Cambrils;1;2;A;;575;114;219;286;289;1;5;280;285
43;Tarragona;8;Baix Camp;43038;Cambrils;1;2;B;;637;135;240;303;334;1;7;295;302
43;Tarragona;8;Baix Camp;43038;Cambrils;1;2;C;;621;132;246;340;281;4;9;327;336
43;Tarragona;8;Baix Camp;43038;Cambrils;1;3;A;;601;137;257;309;292;1;12;296;308
43;Tarragona;8;Baix Camp;43038;Cambrils;1;3;B;;592;139;267;323;269;5;15;303;318
43;Tarragona;8;Baix Camp;43038;Cambrils;1;3;C;;573;111;229;290;283;3;5;282;287
43;Tarragona;8;Baix Camp;43038;Cambrils;1;4;A;;579;133;223;273;306;3;5;265;270
43;Tarragona;8;Baix Camp;43038;Cambrils;1;4;B;;727;141;277;364;363;1;5;358;363
43;Tarragona;8;Baix Camp;43038;Cambrils;1;4;C;;662;134;252;318;344;3;14;301;315
43;Tarragona;8;Baix Camp;43038;Cambrils;1;5;A;;554;140;245;324;230;5;8;311;319
43;Tarragona;8;Baix Camp;43038;Cambrils;1;5;B;;630;152;291;374;256;0;9;365;374
43;Tarragona;8;Baix Camp;43038;Cambrils;2;1;A;;605;172;314;381;224;0;10;371;381
43;Tarragona;8;Baix Camp;43038;Cambrils;2;1;B;;643;167;307;380;263;5;6;369;375
43;Tarragona;8;Baix Camp;43038;Cambrils;2;2;A;;491;142;217;262;229;1;7;254;261
43;Tarragona;8;Baix Camp;43038;Cambrils;2;2;B;;534;141;232;270;264;2;12;256;268
43;Tarragona;8;Baix Camp;43038;Cambrils;2;3;A;;667;157;313;384;283;2;8;374;382
43;Tarragona;8;Baix Camp;43038;Cambrils;2;3;B;;850;183;402;486;364;4;14;468;482
43;Tarragona;8;Baix Camp;43038;Cambrils;2;4;A;;451;107;174;207;244;0;5;202;207
43;Tarragona;8;Baix Camp;43038;Cambrils;2;4;B;;518;117;206;249;269;4;2;243;245
43;Tarragona;8;Baix Camp;43038;Cambrils;2;5;A;;933;230;404;506;427;2;12;492;504
43;Tarragona;8;Baix Camp;43038;Cambrils;2;5;B;;1058;267;472;586;472;3;13;570;583
43;Tarragona;8;Baix Camp;43038;Cambrils;2;6;A;;805;160;296;386;419;0;11;375;386
43;Tarragona;8;Baix Camp;43038;Cambrils;2;6;B;;911;169;327;435;476;1;10;424;434
43;Tarragona;8;Baix Camp;43038;Cambrils;2;7;A;;640;135;289;371;269;1;6;364;370
43;Tarragona;8;Baix Camp;43038;Cambrils;2;7;B;;747;166;351;437;310;1;7;429;436
43;Tarragona;8;Baix Camp;43038;Cambrils;2;8;A;;397;88;180;215;182;3;2;210;212
43;Tarragona;8;Baix Camp;43038;Cambrils;2;8;B;;439;80;162;218;221;2;4;212;216
43;Tarragona;8;Baix Camp;43038;Cambrils;2;9;A;;710;169;331;427;283;1;9;417;426
43;Tarragona;8;Baix Camp;43038;Cambrils;2;9;B;;795;200;391;493;302;2;16;475;491
17;Girona;28;Pla de l'Estany;17035;Camós;1;1;U;;554;166;328;394;160;1;4;389;393
17;Girona;31;Ripollès;17036;Campdevànol;1;1;A;;562;129;304;365;197;6;12;347;359
17;Girona;31;Ripollès;17036;Campdevànol;1;1;B;;612;173;361;417;195;5;15;397;412
17;Girona;31;Ripollès;17036;Campdevànol;1;2;U;;870;207;445;532;338;3;21;508;529
17;Girona;31;Ripollès;17036;Campdevànol;1;3;U;;814;180;404;487;327;6;15;466;481
17;Girona;31;Ripollès;17037;Campelles;1;1;U;;109;21;50;72;37;0;1;71;72
8;Barcelona;41;Vallès Oriental;08039;Campins;1;1;U;;346;121;218;256;90;8;1;247;248
17;Girona;20;Gironès;17038;Campllong;1;1;U;;331;97;209;253;78;3;3;247;250
17;Girona;31;Ripollès;17039;Camprodon;1;1;A;;599;196;354;427;172;3;12;412;424
17;Girona;31;Ripollès;17039;Camprodon;1;1;B;;592;201;371;442;150;7;20;415;435
17;Girona;31;Ripollès;17039;Camprodon;1;2;U;;695;209;353;444;251;10;6;428;434
25;Lleida;39;Consell General d'Aran;25063;Canejan;1;1;U;;93;23;50;59;34;0;3;56;59
17;Girona;20;Gironès;17040;Canet d'Adri;1;1;U;;510;144;267;332;178;0;10;322;332
8;Barcelona;21;Maresme;08040;Canet de Mar;1;1;A;;625;176;350;414;211;4;17;393;410
8;Barcelona;21;Maresme;08040;Canet de Mar;1;1;B;;747;230;428;506;241;1;15;490;505
8;Barcelona;21;Maresme;08040;Canet de Mar;1;2;A;;675;203;354;412;263;2;15;395;410
8;Barcelona;21;Maresme;08040;Canet de Mar;1;2;B;;713;229;382;453;260;4;14;435;449
8;Barcelona;21;Maresme;08040;Canet de Mar;1;3;A;;452;103;219;258;194;3;8;247;255
8;Barcelona;21;Maresme;08040;Canet de Mar;1;3;B;;533;144;261;317;216;2;9;306;315
8;Barcelona;21;Maresme;08040;Canet de Mar;1;4;A;;801;194;410;531;270;6;19;506;525
8;Barcelona;21;Maresme;08040;Canet de Mar;1;4;B;;958;233;499;609;349;4;22;583;605
8;Barcelona;21;Maresme;08040;Canet de Mar;1;5;A;;492;151;260;290;202;2;12;276;288
8;Barcelona;21;Maresme;08040;Canet de Mar;1;5;B;;575;143;245;324;251;8;3;313;316
8;Barcelona;21;Maresme;08040;Canet de Mar;1;6;U;;969;173;337;432;537;4;14;414;428
8;Barcelona;21;Maresme;08040;Canet de Mar;1;7;A;;731;205;384;482;249;4;11;467;478
8;Barcelona;21;Maresme;08040;Canet de Mar;1;7;B;;902;271;459;566;336;2;13;551;564
8;Barcelona;21;Maresme;08040;Canet de Mar;1;8;A;;561;140;280;346;215;3;19;324;343
8;Barcelona;21;Maresme;08040;Canet de Mar;1;8;B;;681;171;336;413;268;6;13;394;407
8;Barcelona;41;Vallès Oriental;08041;Canovelles;1;1;A;;646;163;321;387;259;1;14;372;386
8;Barcelona;41;Vallès Oriental;08041;Canovelles;1;1;B;;843;188;415;507;336;3;14;490;504
8;Barcelona;41;Vallès Oriental;08041;Canovelles;1;2;A;;488;151;233;271;217;0;5;266;271
8;Barcelona;41;Vallès Oriental;08041;Canovelles;1;2;B;;604;169;269;331;273;2;7;322;329
8;Barcelona;41;Vallès Oriental;08041;Canovelles;1;3;A;;503;123;203;238;265;0;6;232;238
8;Barcelona;41;Vallès Oriental;08041;Canovelles;1;3;B;;591;133;248;288;303;2;6;280;286
8;Barcelona;41;Vallès Oriental;08041;Canovelles;1;4;U;;1043;233;409;489;554;4;15;470;485
8;Barcelona;41;Vallès Oriental;08041;Canovelles;1;5;A;;349;100;160;199;150;0;9;190;199
8;Barcelona;41;Vallès Oriental;08041;Canovelles;1;5;B;;510;143;209;263;247;0;8;255;263
8;Barcelona;41;Vallès Oriental;08041;Canovelles;1;6;A;;554;141;267;317;237;1;4;312;316
8;Barcelona;41;Vallès Oriental;08041;Canovelles;1;6;B;;789;237;405;471;318;4;4;463;467
8;Barcelona;41;Vallès Oriental;08041;Canovelles;1;7;A;;658;173;362;428;230;7;6;415;421
8;Barcelona;41;Vallès Oriental;08041;Canovelles;1;7;B;;855;210;437;556;299;6;15;535;550
8;Barcelona;41;Vallès Oriental;08041;Canovelles;1;8;A;;656;172;341;431;225;1;7;423;430
8;Barcelona;41;Vallès Oriental;08041;Canovelles;1;8;B;;893;239;442;563;330;4;15;544;559
8;Barcelona;41;Vallès Oriental;08042;Cànoves i Samalús;1;1;A;;717;236;361;435;282;2;10;423;433
8;Barcelona;41;Vallès Oriental;08042;Cànoves i Samalús;1;1;B;;743;218;333;422;321;0;10;412;422
8;Barcelona;41;Vallès Oriental;08042;Cànoves i Samalús;1;1;C;;670;205;323;413;257;1;11;401;412
17;Girona;2;Alt Empordà;17041;Cantallops;1;1;U;;231;57;114;145;86;1;7;137;144
8;Barcelona;17;Garraf;08043;Canyelles;1;1;A;;748;214;383;442;306;4;11;427;438
8;Barcelona;17;Garraf;08043;Canyelles;1;1;B;;875;251;433;512;363;2;16;494;510
8;Barcelona;17;Garraf;08043;Canyelles;1;2;A;;625;168;282;333;292;1;8;324;332
8;Barcelona;17;Garraf;08043;Canyelles;1;2;B;;787;221;339;408;379;2;10;396;406
43;Tarragona;8;Baix Camp;43039;Capafonts;1;1;U;;120;32;60;80;40;1;3;76;79
43;Tarragona;29;Priorat;43040;Capçanes;1;1;U;;352;99;216;260;92;5;9;246;255
8;Barcelona;6;Anoia;08044;Capellades;1;1;A;;586;146;271;335;251;0;5;330;335
8;Barcelona;6;Anoia;08044;Capellades;1;1;B;;690;147;287;360;330;1;8;351;359
8;Barcelona;6;Anoia;08044;Capellades;1;1;C;;615;126;258;331;284;1;4;326;330
8;Barcelona;6;Anoia;08044;Capellades;2;1;A;;487;164;255;315;172;4;10;301;311
8;Barcelona;6;Anoia;08044;Capellades;2;1;B;;622;201;326;398;224;1;12;385;397
8;Barcelona;6;Anoia;08044;Capellades;2;2;A;;557;168;283;353;204;1;9;343;352
8;Barcelona;6;Anoia;08044;Capellades;2;2;B;;715;203;394;463;252;0;13;450;463
17;Girona;2;Alt Empordà;17042;Capmany;1;1;U;;419;82;247;285;134;5;10;270;280
8;Barcelona;14;Berguedà;08045;Capolat;1;1;U;;67;16;35;44;23;0;2;42;44
8;Barcelona;41;Vallès Oriental;08046;Cardedeu;1;1;A;;550;165;307;384;166;3;16;365;381
8;Barcelona;41;Vallès Oriental;08046;Cardedeu;1;1;B;;495;139;279;344;151;3;15;326;341
8;Barcelona;41;Vallès Oriental;08046;Cardedeu;1;2;A;;682;195;404;485;197;1;17;467;484
8;Barcelona;41;Vallès Oriental;08046;Cardedeu;1;2;B;;706;209;405;496;210;2;21;473;494
8;Barcelona;41;Vallès Oriental;08046;Cardedeu;1;3;A;;548;157;284;353;195;0;8;345;353
8;Barcelona;41;Vallès Oriental;08046;Cardedeu;1;3;B;;575;177;304;377;198;2;13;362;375
8;Barcelona;41;Vallès Oriental;08046;Cardedeu;2;1;A;;541;150;262;322;219;1;9;312;321
8;Barcelona;41;Vallès Oriental;08046;Cardedeu;2;1;B;;618;158;303;384;234;0;12;372;384
8;Barcelona;41;Vallès Oriental;08046;Cardedeu;2;1;C;;632;166;313;389;243;0;6;383;389
8;Barcelona;41;Vallès Oriental;08046;Cardedeu;2;2;A;;607;165;297;399;208;2;12;385;397
8;Barcelona;41;Vallès Oriental;08046;Cardedeu;2;2;B;;565;157;301;368;197;4;13;351;364
8;Barcelona;41;Vallès Oriental;08046;Cardedeu;2;3;A;;693;202;385;473;220;1;19;453;472
8;Barcelona;41;Vallès Oriental;08046;Cardedeu;2;3;B;;607;167;324;417;190;1;16;400;416
8;Barcelona;41;Vallès Oriental;08046;Cardedeu;2;4;A;;667;209;378;449;218;3;10;436;446
8;Barcelona;41;Vallès Oriental;08046;Cardedeu;2;4;B;;740;199;380;482;258;3;15;464;479
8;Barcelona;41;Vallès Oriental;08046;Cardedeu;2;4;C;;741;194;386;481;260;2;16;463;479
8;Barcelona;41;Vallès Oriental;08046;Cardedeu;3;1;A;;593;140;268;340;253;3;10;327;337
8;Barcelona;41;Vallès Oriental;08046;Cardedeu;3;1;B;;636;157;285;366;270;5;8;353;361
8;Barcelona;41;Vallès Oriental;08046;Cardedeu;3;1;C;;597;145;290;357;240;1;15;341;356
8;Barcelona;41;Vallès Oriental;08046;Cardedeu;3;1;D;;599;145;287;360;239;6;15;339;354
8;Barcelona;7;Bages;08047;Cardona;1;1;U;;971;230;457;562;409;8;10;544;554
8;Barcelona;7;Bages;08047;Cardona;1;2;U;;760;214;356;433;327;8;19;406;425
8;Barcelona;7;Bages;08047;Cardona;1;3;A;;661;147;292;358;303;6;18;334;352
8;Barcelona;7;Bages;08047;Cardona;1;3;B;;664;143;312;394;270;8;9;377;386
8;Barcelona;7;Bages;08047;Cardona;2;1;U;;672;182;303;386;286;3;7;376;383
8;Barcelona;7;Bages;08047;Cardona;2;3;U;;444;128;221;271;173;1;3;267;270
8;Barcelona;6;Anoia;08048;Carme;1;1;U;;632;150;374;429;203;5;18;406;424
43;Tarragona;37;Terra Alta;43041;Caseres;1;1;U;;239;41;133;169;70;1;0;168;168
17;Girona;20;Gironès;17044;Cassà de la Selva;1;1;A;;745;204;454;543;202;9;23;511;534
17;Girona;20;Gironès;17044;Cassà de la Selva;1;1;B;;725;229;456;535;190;4;18;513;531
17;Girona;20;Gironès;17044;Cassà de la Selva;1;2;A;;539;172;280;332;207;4;7;321;328
17;Girona;20;Gironès;17044;Cassà de la Selva;1;2;B;;578;142;286;366;212;5;8;353;361
17;Girona;20;Gironès;17044;Cassà de la Selva;2;1;A;;875;232;451;541;334;6;17;518;535
17;Girona;20;Gironès;17044;Cassà de la Selva;2;1;B;;887;228;452;562;325;5;19;538;557
17;Girona;20;Gironès;17044;Cassà de la Selva;2;2;A;;818;250;464;532;286;5;13;514;527
17;Girona;20;Gironès;17044;Cassà de la Selva;2;2;B;;753;234;411;479;274;6;15;458;473
17;Girona;20;Gironès;17044;Cassà de la Selva;2;3;U;;670;207;408;479;191;3;18;458;476
8;Barcelona;14;Berguedà;08049;Casserres;1;1;A;;1112;25;615;764;348;12;33;719;752
8;Barcelona;14;Berguedà;08049;Casserres;1;1;B;;220;46;107;137;83;3;3;131;134
25;Lleida;35;Solsonès;25064;Castellar de la Ribera;1;1;U;;123;46;74;100;23;0;4;96;100
8;Barcelona;14;Berguedà;08050;Castellar del Riu;1;1;U;;136;36;64;92;44;0;2;90;92
8;Barcelona;40;Vallès Occidental;08051;Castellar del Vallès;1;1;U;;884;276;472;582;302;2;17;563;580
8;Barcelona;40;Vallès Occidental;08051;Castellar del Vallès;1;10;A;;509;131;266;343;166;1;14;328;342
8;Barcelona;40;Vallès Occidental;08051;Castellar del Vallès;1;10;B;;593;152;294;390;203;1;16;373;389
8;Barcelona;40;Vallès Occidental;08051;Castellar del Vallès;1;11;U;;794;196;430;547;247;0;20;527;547
8;Barcelona;40;Vallès Occidental;08051;Castellar del Vallès;1;12;U;;721;138;283;371;350;1;17;353;370
8;Barcelona;40;Vallès Occidental;08051;Castellar del Vallès;1;13;A;;613;135;318;398;215;2;9;387;396
8;Barcelona;40;Vallès Occidental;08051;Castellar del Vallès;1;13;B;;751;161;368;476;275;2;8;466;474
8;Barcelona;40;Vallès Occidental;08051;Castellar del Vallès;1;2;A;;582;164;315;391;191;3;13;375;388
8;Barcelona;40;Vallès Occidental;08051;Castellar del Vallès;1;2;B;;701;204;378;469;232;3;22;444;466
8;Barcelona;40;Vallès Occidental;08051;Castellar del Vallès;1;2;C;;784;211;413;536;248;2;14;520;534
8;Barcelona;40;Vallès Occidental;08051;Castellar del Vallès;1;3;A;;590;155;301;370;220;1;16;353;369
8;Barcelona;40;Vallès Occidental;08051;Castellar del Vallès;1;3;B;;708;189;421;434;274;1;14;419;433
8;Barcelona;40;Vallès Occidental;08051;Castellar del Vallès;1;4;A;;712;174;342;446;266;2;15;429;444
8;Barcelona;40;Vallès Occidental;08051;Castellar del Vallès;1;4;B;;851;218;409;519;332;6;9;504;513
8;Barcelona;40;Vallès Occidental;08051;Castellar del Vallès;1;5;A;;615;175;352;427;188;0;4;423;427
8;Barcelona;40;Vallès Occidental;08051;Castellar del Vallès;1;5;B;;725;228;413;508;217;6;13;489;502
8;Barcelona;40;Vallès Occidental;08051;Castellar del Vallès;1;6;A;;618;138;288;342;276;0;4;338;342
8;Barcelona;40;Vallès Occidental;08051;Castellar del Vallès;1;6;B;;622;137;268;341;281;0;5;336;341
8;Barcelona;40;Vallès Occidental;08051;Castellar del Vallès;1;7;A;;799;198;401;488;311;5;11;472;483
8;Barcelona;40;Vallès Occidental;08051;Castellar del Vallès;1;7;B;;871;184;387;508;363;1;23;484;507
8;Barcelona;40;Vallès Occidental;08051;Castellar del Vallès;1;8;A;;695;197;328;446;249;2;11;433;444
8;Barcelona;40;Vallès Occidental;08051;Castellar del Vallès;1;8;B;;827;214;376;487;340;2;13;472;485
8;Barcelona;40;Vallès Occidental;08051;Castellar del Vallès;1;9;A;;819;204;450;568;251;1;11;556;567
8;Barcelona;40;Vallès Occidental;08051;Castellar del Vallès;1;9;B;;858;216;433;564;294;3;27;534;561
8;Barcelona;14;Berguedà;08052;Castellar de n'Hug;1;1;U;;151;42;88;107;44;2;1;104;105
8;Barcelona;7;Bages;08053;Castellbell i el Vilar;1;1;A;;641;134;321;394;247;2;6;386;392
8;Barcelona;7;Bages;08053;Castellbell i el Vilar;1;1;B;;826;231;432;498;328;1;8;489;497
8;Barcelona;7;Bages;08053;Castellbell i el Vilar;1;2;A;;670;155;255;308;362;1;6;301;307
8;Barcelona;7;Bages;08053;Castellbell i el Vilar;1;2;B;;755;179;318;395;360;0;11;384;395
8;Barcelona;40;Vallès Occidental;08054;Castellbisbal;1;1;A;;543;153;287;363;180;0;14;349;363
8;Barcelona;40;Vallès Occidental;08054;Castellbisbal;1;1;B;;616;163;292;369;247;1;17;351;368
8;Barcelona;40;Vallès Occidental;08054;Castellbisbal;1;1;C;;672;154;335;412;260;4;14;394;408
8;Barcelona;40;Vallès Occidental;08054;Castellbisbal;1;2;U;;811;199;423;510;301;2;18;490;508
8;Barcelona;40;Vallès Occidental;08054;Castellbisbal;1;3;A;;725;188;378;462;263;2;11;449;460
8;Barcelona;40;Vallès Occidental;08054;Castellbisbal;1;3;B;;695;165;379;461;234;1;8;452;460
8;Barcelona;40;Vallès Occidental;08054;Castellbisbal;1;4;A;;829;136;448;565;264;1;15;549;564
8;Barcelona;40;Vallès Occidental;08054;Castellbisbal;1;4;B;;818;117;408;554;264;7;15;532;547
8;Barcelona;40;Vallès Occidental;08054;Castellbisbal;1;5;A;;835;196;379;477;358;1;12;464;476
8;Barcelona;40;Vallès Occidental;08054;Castellbisbal;1;5;B;;805;203;384;462;343;1;11;450;461
8;Barcelona;40;Vallès Occidental;08054;Castellbisbal;1;6;A;;701;146;271;332;369;4;5;323;328
8;Barcelona;40;Vallès Occidental;08054;Castellbisbal;1;6;B;;650;127;256;341;309;1;4;336;340
8;Barcelona;;;08055;Castellcir;1;1;U;;477;155;274;317;160;1;9;307;316
25;Lleida;18;Garrigues;25067;Castelldans;1;1;U;;762;125;348;447;315;3;11;433;444
8;Barcelona;11;Baix Llobregat;08056;Castelldefels;1;1;U;;696;138;250;302;394;1;5;296;301
8;Barcelona;11;Baix Llobregat;08056;Castelldefels;1;2;A;;679;150;284;338;341;2;9;327;336
8;Barcelona;11;Baix Llobregat;08056;Castelldefels;1;2;B;;737;165;310;355;382;2;6;347;353
8;Barcelona;11;Baix Llobregat;08056;Castelldefels;1;3;A;;973;245;450;562;411;2;18;542;560
8;Barcelona;11;Baix Llobregat;08056;Castelldefels;1;3;B;;1077;253;534;663;414;2;25;636;661
8;Barcelona;11;Baix Llobregat;08056;Castelldefels;1;4;A;;723;143;322;385;338;2;12;371;383
8;Barcelona;11;Baix Llobregat;08056;Castelldefels;1;4;B;;742;170;323;400;342;3;19;378;397
8;Barcelona;11;Baix Llobregat;08056;Castelldefels;1;5;A;;581;154;273;331;250;0;10;321;331
8;Barcelona;11;Baix Llobregat;08056;Castelldefels;1;5;B;;689;181;317;374;315;1;14;359;373
8;Barcelona;11;Baix Llobregat;08056;Castelldefels;1;6;A;;555;129;243;307;248;1;10;296;306
8;Barcelona;11;Baix Llobregat;08056;Castelldefels;1;6;B;;752;168;324;417;335;0;8;409;417
8;Barcelona;11;Baix Llobregat;08056;Castelldefels;1;6;C;;614;137;259;327;287;0;8;319;327
8;Barcelona;11;Baix Llobregat;08056;Castelldefels;1;7;A;;1012;229;485;612;400;2;22;588;610
8;Barcelona;11;Baix Llobregat;08056;Castelldefels;1;7;B;;1174;233;518;692;482;0;22;670;692
8;Barcelona;11;Baix Llobregat;08056;Castelldefels;2;1;A;;576;155;276;343;233;1;11;331;342
8;Barcelona;11;Baix Llobregat;08056;Castelldefels;2;1;B;;607;180;276;334;273;1;33;300;333
8;Barcelona;11;Baix Llobregat;08056;Castelldefels;2;2;A;;538;143;289;356;182;3;3;350;353
8;Barcelona;11;Baix Llobregat;08056;Castelldefels;2;2;B;;612;174;321;402;210;2;6;394;400
8;Barcelona;11;Baix Llobregat;08056;Castelldefels;2;3;A;;535;122;266;316;219;0;5;311;316
8;Barcelona;11;Baix Llobregat;08056;Castelldefels;2;3;B;;552;139;281;346;206;2;8;336;344
8;Barcelona;11;Baix Llobregat;08056;Castelldefels;2;4;A;;839;203;427;505;334;2;21;482;503
8;Barcelona;11;Baix Llobregat;08056;Castelldefels;2;4;B;;911;185;437;525;386;1;17;507;524
8;Barcelona;11;Baix Llobregat;08056;Castelldefels;2;5;A;;548;156;291;351;197;1;11;339;350
8;Barcelona;11;Baix Llobregat;08056;Castelldefels;2;5;B;;615;160;346;413;202;1;10;402;412
8;Barcelona;11;Baix Llobregat;08056;Castelldefels;2;6;A;;490;112;209;259;231;2;17;240;257
8;Barcelona;11;Baix Llobregat;08056;Castelldefels;2;6;B;;598;140;289;345;253;1;5;339;344
8;Barcelona;11;Baix Llobregat;08056;Castelldefels;3;1;U;;780;174;331;407;373;0;7;400;407
8;Barcelona;11;Baix Llobregat;08056;Castelldefels;3;2;A;;681;165;334;417;264;2;13;402;415
8;Barcelona;11;Baix Llobregat;08056;Castelldefels;3;2;B;;668;140;354;425;243;1;10;414;424
8;Barcelona;11;Baix Llobregat;08056;Castelldefels;3;3;A;;554;119;221;297;257;3;14;280;294
8;Barcelona;11;Baix Llobregat;08056;Castelldefels;3;3;B;;703;147;286;358;345;3;10;345;355
8;Barcelona;11;Baix Llobregat;08056;Castelldefels;3;3;C;;623;152;276;333;290;0;15;318;333
8;Barcelona;11;Baix Llobregat;08056;Castelldefels;3;4;A;;751;174;387;510;241;1;17;492;509
8;Barcelona;11;Baix Llobregat;08056;Castelldefels;3;4;B;;866;198;431;550;316;1;17;532;549
8;Barcelona;11;Baix Llobregat;08056;Castelldefels;3;5;U;;786;190;416;541;245;1;25;515;540
8;Barcelona;11;Baix Llobregat;08056;Castelldefels;4;1;A;;722;186;391;489;233;1;13;475;488
8;Barcelona;11;Baix Llobregat;08056;Castelldefels;4;1;B;;774;194;391;507;267;6;15;486;501
8;Barcelona;11;Baix Llobregat;08056;Castelldefels;4;1;C;;758;189;410;499;259;1;12;486;498
8;Barcelona;11;Baix Llobregat;08056;Castelldefels;4;2;A;;650;152;279;338;312;0;9;329;338
8;Barcelona;11;Baix Llobregat;08056;Castelldefels;4;2;B;;726;188;350;417;309;1;11;405;416
8;Barcelona;11;Baix Llobregat;08056;Castelldefels;4;3;A;;748;205;346;415;333;2;13;400;413
8;Barcelona;11;Baix Llobregat;08056;Castelldefels;4;3;B;;863;212;388;477;386;0;12;465;477
8;Barcelona;11;Baix Llobregat;08056;Castelldefels;4;4;A;;896;200;368;450;446;5;10;435;445
8;Barcelona;11;Baix Llobregat;08056;Castelldefels;4;4;B;;890;209;400;456;434;0;10;446;456
8;Barcelona;11;Baix Llobregat;08056;Castelldefels;5;1;A;;911;212;447;554;357;0;19;535;554
8;Barcelona;11;Baix Llobregat;08056;Castelldefels;5;1;B;;1038;230;520;649;389;0;20;629;649
8;Barcelona;11;Baix Llobregat;08056;Castelldefels;5;2;A;;852;175;400;480;372;0;11;469;480
8;Barcelona;11;Baix Llobregat;08056;Castelldefels;5;2;B;;929;197;432;510;419;0;14;496;510
8;Barcelona;11;Baix Llobregat;08056;Castelldefels;5;3;A;;766;187;287;362;404;1;7;354;361
8;Barcelona;11;Baix Llobregat;08056;Castelldefels;5;3;B;;823;150;343;411;412;2;11;398;409
8;Barcelona;11;Baix Llobregat;08056;Castelldefels;5;4;A;;830;243;452;570;260;5;17;548;565
8;Barcelona;11;Baix Llobregat;08056;Castelldefels;5;4;B;;941;239;495;633;308;1;23;609;632
8;Barcelona;14;Berguedà;08057;Castell de l'Areny;1;1;U;;59;23;33;44;15;0;0;44;44
25;Lleida;25;Pallars Jussà;25904;Castell de Mur;1;1;U;;145;31;78;109;36;1;2;106;108
8;Barcelona;3;Alt Penedès;08058;Castellet i la Gornal;1;1;U;;439;97;234;297;142;3;5;289;294
8;Barcelona;3;Alt Penedès;08058;Castellet i la Gornal;1;2;A;;544;129;225;273;271;2;2;269;271
8;Barcelona;3;Alt Penedès;08058;Castellet i la Gornal;1;2;B;;720;175;292;366;354;4;9;353;362
17;Girona;19;Garrotxa;17046;Castellfollit de la Roca;1;1;U;;743;247;437;508;235;4;14;490;504
8;Barcelona;7;Bages;08059;Castellfollit del Boix;1;1;U;;319;75;149;198;121;2;10;186;196
8;Barcelona;6;Anoia;08060;Castellfollit de Riubregós;1;1;U;;174;38;99;120;54;0;0;120;120
8;Barcelona;7;Bages;08061;Castellgalí;1;1;A;;674;160;321;382;292;3;9;370;379
8;Barcelona;7;Bages;08061;Castellgalí;1;1;B;;765;175;355;449;316;6;9;434;443
8;Barcelona;7;Bages;08062;Castellnou de Bages;1;1;U;;837;234;465;560;277;3;12;545;557
25;Lleida;27;Pla d'Urgell;25068;Castellnou de Seana;1;1;U;;585;151;333;394;191;6;13;375;388
17;Girona;2;Alt Empordà;17047;Castelló d'Empúries;1;1;A;;679;164;318;365;314;4;2;359;361
17;Girona;2;Alt Empordà;17047;Castelló d'Empúries;1;1;B;;711;196;354;399;312;4;7;388;395
17;Girona;2;Alt Empordà;17047;Castelló d'Empúries;1;2;A;;620;216;354;406;214;3;11;392;403
17;Girona;2;Alt Empordà;17047;Castelló d'Empúries;1;2;B;;579;189;330;372;207;3;9;360;369
17;Girona;2;Alt Empordà;17047;Castelló d'Empúries;1;3;A;;606;136;241;294;312;0;3;291;294
17;Girona;2;Alt Empordà;17047;Castelló d'Empúries;1;3;B;;615;106;196;244;371;4;3;237;240
17;Girona;2;Alt Empordà;17047;Castelló d'Empúries;1;4;A;;518;97;169;225;293;1;9;215;224
17;Girona;2;Alt Empordà;17047;Castelló d'Empúries;1;4;B;;484;94;160;200;284;3;5;192;197
25;Lleida;23;Noguera;25069;Castelló de Farfanya;1;1;U;;472;62;188;269;203;1;11;257;268
8;Barcelona;6;Anoia;08063;Castellolí;1;1;U;;409;101;278;334;75;0;7;327;334
17;Girona;10;Baix Empordà;17048;Castell-Platja d'Aro;1;1;U;;1101;322;587;696;405;2;12;682;694
17;Girona;10;Baix Empordà;17048;Castell-Platja d'Aro;1;2;A;;862;202;345;407;455;0;9;398;407
17;Girona;10;Baix Empordà;17048;Castell-Platja d'Aro;1;2;B;;785;203;362;420;365;0;7;413;420
17;Girona;10;Baix Empordà;17048;Castell-Platja d'Aro;1;3;A;;828;214;409;479;349;4;13;462;475
17;Girona;10;Baix Empordà;17048;Castell-Platja d'Aro;1;3;B;;783;217;376;452;331;5;14;433;447
17;Girona;10;Baix Empordà;17048;Castell-Platja d'Aro;1;4;U;;814;211;355;440;374;0;5;435;440
17;Girona;10;Baix Empordà;17048;Castell-Platja d'Aro;1;5;U;;913;258;431;505;408;2;4;499;503
25;Lleida;38;Urgell;25070;Castellserà;1;1;U;;889;228;493;606;283;5;16;585;601
8;Barcelona;;;08064;Castellterçol;1;1;A;;723;219;434;538;185;13;10;515;525
8;Barcelona;;;08064;Castellterçol;1;1;B;;473;116;246;314;159;4;10;300;310
8;Barcelona;;;08064;Castellterçol;1;1;C;;610;234;387;461;149;7;7;447;454
43;Tarragona;8;Baix Camp;43042;Castellvell del Camp;1;1;A;;450;128;255;310;140;4;3;303;306
43;Tarragona;8;Baix Camp;43042;Castellvell del Camp;1;1;B;;402;103;201;260;142;1;6;253;259
43;Tarragona;8;Baix Camp;43042;Castellvell del Camp;1;1;C;;469;128;248;321;148;1;6;314;320
43;Tarragona;8;Baix Camp;43042;Castellvell del Camp;1;1;D;;338;87;175;224;114;1;3;220;223
43;Tarragona;8;Baix Camp;43042;Castellvell del Camp;1;1;E;;379;101;225;285;94;1;7;277;284
8;Barcelona;3;Alt Penedès;08065;Castellví de la Marca;1;1;U;;1213;244;600;789;424;8;24;757;781
8;Barcelona;11;Baix Llobregat;08066;Castellví de Rosanes;1;1;A;;457;114;281;328;129;0;5;323;328
8;Barcelona;11;Baix Llobregat;08066;Castellví de Rosanes;1;1;B;;507;104;234;318;189;2;7;309;316
8;Barcelona;11;Baix Llobregat;08066;Castellví de Rosanes;1;1;C;;313;81;170;220;93;2;5;213;218
43;Tarragona;36;Tarragonès;43043;Catllar, el;1;1;A;;516;116;213;266;250;0;9;257;266
43;Tarragona;36;Tarragonès;43043;Catllar, el;1;1;B;;499;115;205;259;240;1;6;252;258
43;Tarragona;36;Tarragonès;43043;Catllar, el;1;1;C;;601;138;236;303;298;1;6;296;302
43;Tarragona;36;Tarragonès;43043;Catllar, el;1;2;A;;447;108;208;264;183;0;6;258;264
43;Tarragona;36;Tarragonès;43043;Catllar, el;1;2;B;;497;130;255;290;207;0;5;285;290
43;Tarragona;36;Tarragonès;43043;Catllar, el;1;2;C;;493;115;308;309;184;1;7;301;308
25;Lleida;4;Alt Urgell;25071;Cava;1;1;U;;56;20;23;35;21;0;1;34;35
17;Girona;34;Selva;17189;Cellera de Ter, la;1;1;U;;833;287;510;590;243;8;11;571;582
17;Girona;34;Selva;17189;Cellera de Ter, la;1;2;U;;725;210;419;487;238;5;10;472;482
17;Girona;20;Gironès;17049;Celrà;1;1;A;;567;175;335;397;170;7;11;379;390
17;Girona;20;Gironès;17049;Celrà;1;1;B;;577;153;306;373;204;4;9;360;369
17;Girona;20;Gironès;17049;Celrà;1;2;A;;666;189;351;407;259;6;16;385;401
17;Girona;20;Gironès;17049;Celrà;1;2;B;;578;139;270;333;245;6;14;313;327
17;Girona;20;Gironès;17049;Celrà;1;2;C;;652;186;346;422;230;4;9;409;418
8;Barcelona;24;Osona;08067;Centelles;1;1;A;;628;168;361;425;203;2;12;411;423
8;Barcelona;24;Osona;08067;Centelles;1;1;B;;675;177;350;425;250;1;18;406;424
8;Barcelona;24;Osona;08067;Centelles;1;2;A;;512;125;267;328;184;1;10;317;327
8;Barcelona;24;Osona;08067;Centelles;1;2;B;;531;160;296;345;186;2;10;333;343
8;Barcelona;24;Osona;08067;Centelles;1;3;A;;606;148;310;373;233;3;19;351;370
8;Barcelona;24;Osona;08067;Centelles;1;3;B;;731;212;402;508;223;8;18;482;500
8;Barcelona;24;Osona;08067;Centelles;1;4;A;;733;186;378;462;271;2;10;450;460
8;Barcelona;24;Osona;08067;Centelles;1;4;B;;675;183;346;430;245;3;12;415;427
8;Barcelona;24;Osona;08067;Centelles;1;4;C;;565;154;308;389;176;4;15;370;385
8;Barcelona;14;Berguedà;08268;Cercs;1;1;A;;272;76;164;194;78;1;8;185;193
8;Barcelona;14;Berguedà;08268;Cercs;1;1;B;;244;43;108;131;113;5;1;125;126
8;Barcelona;14;Berguedà;08268;Cercs;1;2;U;;590;179;369;417;173;4;24;389;413
8;Barcelona;40;Vallès Occidental;08266;Cerdanyola del Vallès;1;1;A;;815;178;372;475;340;4;22;449;471
8;Barcelona;40;Vallès Occidental;08266;Cerdanyola del Vallès;1;1;B;;941;210;406;526;415;28;2;496;498
8;Barcelona;40;Vallès Occidental;08266;Cerdanyola del Vallès;1;1;C;;943;200;421;513;430;1;20;492;512
8;Barcelona;40;Vallès Occidental;08266;Cerdanyola del Vallès;1;10;A;;724;162;360;446;278;1;20;425;445
8;Barcelona;40;Vallès Occidental;08266;Cerdanyola del Vallès;1;10;B;;823;179;387;493;330;2;15;476;491
8;Barcelona;40;Vallès Occidental;08266;Cerdanyola del Vallès;1;10;C;;780;170;362;460;320;0;19;441;460
8;Barcelona;40;Vallès Occidental;08266;Cerdanyola del Vallès;1;11;A;;520;106;203;260;260;0;11;249;260
8;Barcelona;40;Vallès Occidental;08266;Cerdanyola del Vallès;1;11;B;;595;107;233;295;300;2;11;282;293
8;Barcelona;40;Vallès Occidental;08266;Cerdanyola del Vallès;1;12;A;;521;128;239;303;218;1;10;292;302
8;Barcelona;40;Vallès Occidental;08266;Cerdanyola del Vallès;1;12;B;;695;172;325;403;292;4;14;385;399
8;Barcelona;40;Vallès Occidental;08266;Cerdanyola del Vallès;1;12;C;;574;136;270;336;238;2;15;319;334
8;Barcelona;40;Vallès Occidental;08266;Cerdanyola del Vallès;1;13;U;;864;214;424;549;315;1;15;533;548
8;Barcelona;40;Vallès Occidental;08266;Cerdanyola del Vallès;1;14;A;;787;178;383;510;277;4;20;486;506
8;Barcelona;40;Vallès Occidental;08266;Cerdanyola del Vallès;1;14;B;;832;213;433;536;296;5;20;511;531
8;Barcelona;40;Vallès Occidental;08266;Cerdanyola del Vallès;1;15;A;;478;132;245;294;184;1;10;283;293
8;Barcelona;40;Vallès Occidental;08266;Cerdanyola del Vallès;1;15;B;;613;139;269;348;265;4;12;332;344
8;Barcelona;40;Vallès Occidental;08266;Cerdanyola del Vallès;1;15;C;;545;112;220;282;263;3;5;274;279
8;Barcelona;40;Vallès Occidental;08266;Cerdanyola del Vallès;1;16;A;;640;154;314;376;264;2;12;362;374
8;Barcelona;40;Vallès Occidental;08266;Cerdanyola del Vallès;1;16;B;;664;174;333;394;270;5;13;376;389
8;Barcelona;40;Vallès Occidental;08266;Cerdanyola del Vallès;1;17;A;;484;109;210;257;227;1;9;247;256
8;Barcelona;40;Vallès Occidental;08266;Cerdanyola del Vallès;1;17;B;;584;138;242;296;288;2;7;287;294
8;Barcelona;40;Vallès Occidental;08266;Cerdanyola del Vallès;1;17;C;;589;126;259;315;274;0;9;306;315
8;Barcelona;40;Vallès Occidental;08266;Cerdanyola del Vallès;1;18;A;;613;148;290;382;231;3;19;360;379
8;Barcelona;40;Vallès Occidental;08266;Cerdanyola del Vallès;1;18;B;;730;169;357;439;291;3;12;424;436
8;Barcelona;40;Vallès Occidental;08266;Cerdanyola del Vallès;1;18;C;;630;153;295;366;264;3;14;349;363
8;Barcelona;40;Vallès Occidental;08266;Cerdanyola del Vallès;1;19;A;;561;139;259;336;225;2;10;324;334
8;Barcelona;40;Vallès Occidental;08266;Cerdanyola del Vallès;1;19;B;;624;139;275;354;270;1;13;340;353
8;Barcelona;40;Vallès Occidental;08266;Cerdanyola del Vallès;1;19;C;;577;152;281;356;221;6;0;350;350
8;Barcelona;40;Vallès Occidental;08266;Cerdanyola del Vallès;1;2;A;;675;8;342;410;265;7;13;390;403
8;Barcelona;40;Vallès Occidental;08266;Cerdanyola del Vallès;1;2;B;;880;201;430;548;332;6;20;522;542
8;Barcelona;40;Vallès Occidental;08266;Cerdanyola del Vallès;1;20;A;;697;224;470;559;138;0;16;543;559
8;Barcelona;40;Vallès Occidental;08266;Cerdanyola del Vallès;1;20;B;;569;156;312;410;159;0;11;399;410
8;Barcelona;40;Vallès Occidental;08266;Cerdanyola del Vallès;1;20;C;;810;203;481;619;191;0;19;600;619
8;Barcelona;40;Vallès Occidental;08266;Cerdanyola del Vallès;1;27;A;;610;134;241;280;330;2;5;273;278
8;Barcelona;40;Vallès Occidental;08266;Cerdanyola del Vallès;1;27;B;;662;146;266;336;326;0;16;320;336
8;Barcelona;40;Vallès Occidental;08266;Cerdanyola del Vallès;1;28;A;;610;142;313;414;196;2;14;398;412
8;Barcelona;40;Vallès Occidental;08266;Cerdanyola del Vallès;1;28;B;;747;179;383;487;260;4;17;466;483
8;Barcelona;40;Vallès Occidental;08266;Cerdanyola del Vallès;1;29;A;;672;155;334;425;247;0;11;414;425
8;Barcelona;40;Vallès Occidental;08266;Cerdanyola del Vallès;1;29;B;;767;176;385;495;272;0;19;476;495
8;Barcelona;40;Vallès Occidental;08266;Cerdanyola del Vallès;1;29;C;;688;161;339;444;244;6;22;416;438
8;Barcelona;40;Vallès Occidental;08266;Cerdanyola del Vallès;1;3;A;;582;137;272;340;242;5;17;318;335
8;Barcelona;40;Vallès Occidental;08266;Cerdanyola del Vallès;1;3;B;;644;151;293;367;277;1;9;357;366
8;Barcelona;40;Vallès Occidental;08266;Cerdanyola del Vallès;1;30;A;;454;109;232;286;168;2;11;273;284
8;Barcelona;40;Vallès Occidental;08266;Cerdanyola del Vallès;1;30;B;;644;148;318;397;247;5;8;384;392
8;Barcelona;40;Vallès Occidental;08266;Cerdanyola del Vallès;1;31;A;;435;112;201;254;181;5;2;247;249
8;Barcelona;40;Vallès Occidental;08266;Cerdanyola del Vallès;1;31;B;;503;135;233;302;201;3;6;293;299
8;Barcelona;40;Vallès Occidental;08266;Cerdanyola del Vallès;1;32;U;;639;160;350;436;203;6;7;423;430
8;Barcelona;40;Vallès Occidental;08266;Cerdanyola del Vallès;1;33;A;;554;124;235;287;267;2;13;272;285
8;Barcelona;40;Vallès Occidental;08266;Cerdanyola del Vallès;1;33;B;;650;130;278;345;305;1;15;329;344
8;Barcelona;40;Vallès Occidental;08266;Cerdanyola del Vallès;1;34;A;;622;148;256;335;287;3;15;317;332
8;Barcelona;40;Vallès Occidental;08266;Cerdanyola del Vallès;1;34;B;;690;177;320;402;288;2;12;388;400
8;Barcelona;40;Vallès Occidental;08266;Cerdanyola del Vallès;1;35;A;;790;163;396;506;284;2;21;483;504
8;Barcelona;40;Vallès Occidental;08266;Cerdanyola del Vallès;1;35;B;;867;165;424;534;333;2;23;509;532
8;Barcelona;40;Vallès Occidental;08266;Cerdanyola del Vallès;1;35;C;;899;199;419;547;352;0;23;524;547
8;Barcelona;40;Vallès Occidental;08266;Cerdanyola del Vallès;1;4;A;;602;171;290;343;259;5;10;328;338
8;Barcelona;40;Vallès Occidental;08266;Cerdanyola del Vallès;1;4;B;;673;171;317;359;314;1;10;348;358
8;Barcelona;40;Vallès Occidental;08266;Cerdanyola del Vallès;1;5;A;;387;106;181;224;163;0;5;219;224
8;Barcelona;40;Vallès Occidental;08266;Cerdanyola del Vallès;1;5;B;;423;121;215;260;163;3;6;251;257
8;Barcelona;40;Vallès Occidental;08266;Cerdanyola del Vallès;1;6;A;;697;185;335;430;267;1;18;411;429
8;Barcelona;40;Vallès Occidental;08266;Cerdanyola del Vallès;1;6;B;;754;223;399;500;254;4;11;485;496
8;Barcelona;40;Vallès Occidental;08266;Cerdanyola del Vallès;1;7;U;;644;150;325;409;235;5;18;386;404
8;Barcelona;40;Vallès Occidental;08266;Cerdanyola del Vallès;1;8;A;;566;159;262;330;236;1;10;319;329
8;Barcelona;40;Vallès Occidental;08266;Cerdanyola del Vallès;1;8;B;;750;189;353;436;314;6;14;416;430
8;Barcelona;40;Vallès Occidental;08266;Cerdanyola del Vallès;1;9;A;;605;153;288;363;242;3;5;355;360
8;Barcelona;40;Vallès Occidental;08266;Cerdanyola del Vallès;1;9;B;;725;165;317;390;335;1;11;378;389
8;Barcelona;11;Baix Llobregat;08068;Cervelló;1;1;A;;612;153;314;385;227;4;14;367;381
8;Barcelona;11;Baix Llobregat;08068;Cervelló;1;1;B;;598;144;309;381;217;0;15;366;381
8;Barcelona;11;Baix Llobregat;08068;Cervelló;1;1;C;;615;158;307;382;233;5;4;373;377
8;Barcelona;11;Baix Llobregat;08068;Cervelló;1;2;A;;720;152;319;408;312;1;7;400;407
8;Barcelona;11;Baix Llobregat;08068;Cervelló;1;2;B;;806;160;351;436;370;0;7;429;436
8;Barcelona;11;Baix Llobregat;08068;Cervelló;1;3;U;;731;210;376;457;274;2;19;436;455
8;Barcelona;11;Baix Llobregat;08068;Cervelló;1;4;A;;580;148;298;362;218;0;4;358;362
8;Barcelona;11;Baix Llobregat;08068;Cervelló;1;4;B;;652;155;322;385;267;0;9;376;385
8;Barcelona;11;Baix Llobregat;08068;Cervelló;1;4;C;;559;143;278;320;239;2;6;312;318
8;Barcelona;11;Baix Llobregat;08068;Cervelló;1;5;U;;594;142;267;323;271;0;7;316;323
25;Lleida;32;Segarra;25072;Cervera;1;1;A;;377;112;190;224;153;4;10;210;220
25;Lleida;32;Segarra;25072;Cervera;1;1;B;;545;165;275;317;228;9;7;301;308
25;Lleida;32;Segarra;25072;Cervera;2;1;A;;538;150;296;370;168;1;22;347;369
25;Lleida;32;Segarra;25072;Cervera;2;1;B;;603;156;326;412;191;0;12;400;412
25;Lleida;32;Segarra;25072;Cervera;2;2;A;;690;175;309;393;297;6;14;373;387
25;Lleida;32;Segarra;25072;Cervera;2;2;B;;690;173;337;417;273;2;11;404;415
25;Lleida;32;Segarra;25072;Cervera;2;3;A;;398;92;225;271;127;5;6;260;266
25;Lleida;32;Segarra;25072;Cervera;2;3;B;;474;103;249;300;174;1;14;285;299
25;Lleida;32;Segarra;25072;Cervera;3;1;A;;743;138;293;421;322;8;23;390;413
25;Lleida;32;Segarra;25072;Cervera;3;1;B;;865;189;361;486;379;16;18;452;470
25;Lleida;18;Garrigues;25073;Cervià de les Garrigues;1;1;U;;687;158;295;381;306;0;8;373;381
17;Girona;20;Gironès;17050;Cervià de Ter;1;1;U;;638;196;383;471;167;3;31;437;468
17;Girona;2;Alt Empordà;17051;Cistella;1;1;U;;198;53;120;143;55;6;4;133;137
25;Lleida;38;Urgell;25074;Ciutadilla;1;1;U;;183;44;104;133;50;2;2;129;131
25;Lleida;35;Solsonès;25075;Clariana de Cardener;1;1;U;;115;36;72;90;25;3;2;85;87
25;Lleida;18;Garrigues;25076;Cogul, el;1;1;U;;172;34;74;91;81;0;1;90;91
17;Girona;2;Alt Empordà;17054;Colera;1;1;U;;384;115;210;253;131;2;8;243;251
8;Barcelona;11;Baix Llobregat;08069;Collbató;1;1;A;;802;232;447;550;252;1;17;532;549
8;Barcelona;11;Baix Llobregat;08069;Collbató;1;1;B;;843;233;459;551;292;2;12;537;549
8;Barcelona;11;Baix Llobregat;08069;Collbató;1;3;A;;571;197;302;360;211;5;8;347;355
8;Barcelona;11;Baix Llobregat;08069;Collbató;1;3;B;;746;172;359;442;304;5;8;429;437
43;Tarragona;8;Baix Camp;43045;Colldejou;1;1;U;;161;37;93;122;39;0;2;120;122
25;Lleida;4;Alt Urgell;25077;Coll de Nargó;1;1;U;;483;107;241;314;169;4;6;304;310
8;Barcelona;;;08070;Collsuspina;1;1;U;;275;94;167;204;71;1;10;193;203
17;Girona;10;Baix Empordà;17055;Colomers;1;1;U;;156;62;99;122;34;12;4;106;110
25;Lleida;35;Solsonès;25163;Coma i la Pedra, la;1;1;U;;234;52;106;135;99;0;5;130;135
25;Lleida;25;Pallars Jussà;25161;Conca de Dalt;1;1;U;;358;89;167;232;126;2;9;221;230
43;Tarragona;16;Conca de Barberà;43046;Conesa;1;1;U;;102;33;61;50;52;0;8;42;50
43;Tarragona;36;Tarragonès;43047;Constantí;1;1;A;;628;140;280;339;289;0;7;332;339
43;Tarragona;36;Tarragonès;43047;Constantí;1;1;B;;664;140;301;348;316;5;3;340;343
43;Tarragona;36;Tarragonès;43047;Constantí;1;2;A;;456;72;118;144;312;1;1;142;143
43;Tarragona;36;Tarragonès;43047;Constantí;1;2;B;;443;82;127;153;290;2;0;151;151
43;Tarragona;36;Tarragonès;43047;Constantí;2;1;A;;540;104;238;284;256;3;8;273;281
43;Tarragona;36;Tarragonès;43047;Constantí;2;1;B;;567;112;265;321;246;1;12;308;320
43;Tarragona;36;Tarragonès;43047;Constantí;2;1;C;;685;147;306;364;321;3;7;354;361
8;Barcelona;6;Anoia;08071;Copons;1;1;U;;243;62;128;156;87;4;4;148;152
43;Tarragona;37;Terra Alta;43048;Corbera d'Ebre;1;1;U;;848;186;395;519;329;11;18;490;508
8;Barcelona;11;Baix Llobregat;08072;Corbera de Llobregat;1;1;U;;871;174;354;453;418;1;25;427;452
8;Barcelona;11;Baix Llobregat;08072;Corbera de Llobregat;1;10;A;;511;109;225;283;228;1;9;273;282
8;Barcelona;11;Baix Llobregat;08072;Corbera de Llobregat;1;10;B;;500;98;209;269;231;0;5;264;269
8;Barcelona;11;Baix Llobregat;08072;Corbera de Llobregat;1;11;U;;830;144;324;428;402;0;25;403;428
8;Barcelona;11;Baix Llobregat;08072;Corbera de Llobregat;1;2;A;;520;137;268;319;201;2;13;304;317
8;Barcelona;11;Baix Llobregat;08072;Corbera de Llobregat;1;2;B;;602;131;265;335;267;1;8;326;334
8;Barcelona;11;Baix Llobregat;08072;Corbera de Llobregat;1;2;C;;522;98;239;314;208;1;10;303;313
8;Barcelona;11;Baix Llobregat;08072;Corbera de Llobregat;1;3;A;;501;117;245;300;201;1;11;288;299
8;Barcelona;11;Baix Llobregat;08072;Corbera de Llobregat;1;3;B;;534;115;231;292;242;3;5;284;289
8;Barcelona;11;Baix Llobregat;08072;Corbera de Llobregat;1;4;U;;607;175;319;382;225;5;17;360;377
8;Barcelona;11;Baix Llobregat;08072;Corbera de Llobregat;1;5;U;;717;168;306;381;336;0;11;370;381
8;Barcelona;11;Baix Llobregat;08072;Corbera de Llobregat;1;6;U;;797;162;318;400;397;0;10;390;400
8;Barcelona;11;Baix Llobregat;08072;Corbera de Llobregat;1;7;U;;771;160;325;411;360;3;10;398;408
8;Barcelona;11;Baix Llobregat;08072;Corbera de Llobregat;1;8;U;;866;190;391;511;355;0;16;495;511
8;Barcelona;11;Baix Llobregat;08072;Corbera de Llobregat;1;9;U;;563;136;257;320;243;0;4;316;320
25;Lleida;33;Segrià;25078;Corbins;1;1;U;;1011;226;516;682;329;3;24;655;679
17;Girona;10;Baix Empordà;17057;Corçà;1;1;A;;518;131;258;319;199;1;18;300;318
17;Girona;10;Baix Empordà;17057;Corçà;1;1;B;;485;130;254;303;182;4;9;290;299
8;Barcelona;11;Baix Llobregat;08073;Cornellà de Llobregat;1;1;A;;759;183;390;487;272;3;15;469;484
8;Barcelona;11;Baix Llobregat;08073;Cornellà de Llobregat;1;1;B;;869;221;455;572;297;4;20;548;568
8;Barcelona;11;Baix Llobregat;08073;Cornellà de Llobregat;1;10;A;;459;113;221;285;174;2;12;271;283
8;Barcelona;11;Baix Llobregat;08073;Cornellà de Llobregat;1;10;B;;579;122;277;377;202;6;6;365;371
8;Barcelona;11;Baix Llobregat;08073;Cornellà de Llobregat;1;11;A;;411;79;192;238;173;0;2;236;238
8;Barcelona;11;Baix Llobregat;08073;Cornellà de Llobregat;1;11;B;;434;102;200;252;182;3;6;243;249
8;Barcelona;11;Baix Llobregat;08073;Cornellà de Llobregat;1;12;U;;712;141;311;385;327;2;10;373;383
8;Barcelona;11;Baix Llobregat;08073;Cornellà de Llobregat;1;13;A;;544;100;227;312;232;1;15;296;311
8;Barcelona;11;Baix Llobregat;08073;Cornellà de Llobregat;1;13;B;;543;99;228;310;233;0;15;295;310
8;Barcelona;11;Baix Llobregat;08073;Cornellà de Llobregat;1;14;U;;974;178;466;612;362;2;18;592;610
8;Barcelona;11;Baix Llobregat;08073;Cornellà de Llobregat;1;2;A;;673;143;344;438;235;0;18;420;438
8;Barcelona;11;Baix Llobregat;08073;Cornellà de Llobregat;1;2;B;;728;139;356;460;268;2;14;444;458
8;Barcelona;11;Baix Llobregat;08073;Cornellà de Llobregat;1;3;A;;498;106;203;269;229;0;13;256;269
8;Barcelona;11;Baix Llobregat;08073;Cornellà de Llobregat;1;3;B;;567;119;241;318;249;1;15;302;317
8;Barcelona;11;Baix Llobregat;08073;Cornellà de Llobregat;1;4;A;;713;134;322;412;301;3;13;396;409
8;Barcelona;11;Baix Llobregat;08073;Cornellà de Llobregat;1;4;B;;778;139;338;455;323;1;14;440;454
8;Barcelona;11;Baix Llobregat;08073;Cornellà de Llobregat;1;5;U;;877;162;365;501;376;2;12;487;499
8;Barcelona;11;Baix Llobregat;08073;Cornellà de Llobregat;1;6;U;;586;162;273;343;243;1;10;332;342
8;Barcelona;11;Baix Llobregat;08073;Cornellà de Llobregat;1;7;A;;629;132;302;423;206;1;12;410;422
8;Barcelona;11;Baix Llobregat;08073;Cornellà de Llobregat;1;7;B;;757;154;380;494;263;5;17;472;489
8;Barcelona;11;Baix Llobregat;08073;Cornellà de Llobregat;1;8;A;;652;132;288;373;279;1;11;361;372
8;Barcelona;11;Baix Llobregat;08073;Cornellà de Llobregat;1;8;B;;690;119;312;412;278;1;14;397;411
8;Barcelona;11;Baix Llobregat;08073;Cornellà de Llobregat;1;9;A;;352;80;176;226;126;0;3;223;226
8;Barcelona;11;Baix Llobregat;08073;Cornellà de Llobregat;1;9;B;;397;97;198;236;161;1;6;229;235
8;Barcelona;11;Baix Llobregat;08073;Cornellà de Llobregat;2;1;A;;656;121;289;390;266;1;14;375;389
8;Barcelona;11;Baix Llobregat;08073;Cornellà de Llobregat;2;1;B;;701;124;319;427;274;0;15;412;427
8;Barcelona;11;Baix Llobregat;08073;Cornellà de Llobregat;2;1;C;;721;131;306;417;304;2;18;397;415
8;Barcelona;11;Baix Llobregat;08073;Cornellà de Llobregat;2;2;A;;576;124;282;355;221;0;12;343;355
8;Barcelona;11;Baix Llobregat;08073;Cornellà de Llobregat;2;2;B;;553;111;270;343;210;0;6;337;343
8;Barcelona;11;Baix Llobregat;08073;Cornellà de Llobregat;2;2;C;;605;98;268;346;259;1;10;335;345
8;Barcelona;11;Baix Llobregat;08073;Cornellà de Llobregat;3;1;A;;386;106;205;241;145;1;10;230;240
8;Barcelona;11;Baix Llobregat;08073;Cornellà de Llobregat;3;1;B;;442;83;198;259;183;0;7;252;259
8;Barcelona;11;Baix Llobregat;08073;Cornellà de Llobregat;3;2;A;;371;78;162;196;175;0;10;186;196
8;Barcelona;11;Baix Llobregat;08073;Cornellà de Llobregat;3;2;B;;336;76;155;193;143;1;5;187;192
8;Barcelona;11;Baix Llobregat;08073;Cornellà de Llobregat;3;3;U;;654;144;256;386;268;0;9;377;386
8;Barcelona;11;Baix Llobregat;08073;Cornellà de Llobregat;3;4;A;;809;154;393;540;269;1;33;506;539
8;Barcelona;11;Baix Llobregat;08073;Cornellà de Llobregat;3;4;B;;918;174;446;572;346;2;17;553;570
8;Barcelona;11;Baix Llobregat;08073;Cornellà de Llobregat;3;4;C;;810;128;388;488;322;1;0;487;487
8;Barcelona;11;Baix Llobregat;08073;Cornellà de Llobregat;3;5;U;;970;165;405;523;447;1;28;494;522
8;Barcelona;11;Baix Llobregat;08073;Cornellà de Llobregat;3;6;U;;705;183;381;468;237;2;17;449;466
8;Barcelona;11;Baix Llobregat;08073;Cornellà de Llobregat;3;7;A;;410;100;185;226;184;1;3;222;225
8;Barcelona;11;Baix Llobregat;08073;Cornellà de Llobregat;3;7;B;;496;115;234;297;199;3;8;286;294
8;Barcelona;11;Baix Llobregat;08073;Cornellà de Llobregat;3;8;U;;1057;196;478;614;443;1;17;596;613
8;Barcelona;11;Baix Llobregat;08073;Cornellà de Llobregat;3;9;A;;338;62;129;172;166;2;2;168;170
8;Barcelona;11;Baix Llobregat;08073;Cornellà de Llobregat;3;9;B;;397;80;140;183;214;2;8;173;181
8;Barcelona;11;Baix Llobregat;08073;Cornellà de Llobregat;4;1;A;;488;91;224;290;198;0;12;278;290
8;Barcelona;11;Baix Llobregat;08073;Cornellà de Llobregat;4;1;B;;561;104;249;331;230;0;16;315;331
8;Barcelona;11;Baix Llobregat;08073;Cornellà de Llobregat;4;10;A;;396;99;183;229;167;1;1;227;228
8;Barcelona;11;Baix Llobregat;08073;Cornellà de Llobregat;4;10;B;;408;92;206;252;156;7;6;239;245
8;Barcelona;11;Baix Llobregat;08073;Cornellà de Llobregat;4;11;A;;367;79;166;202;165;3;4;195;199
8;Barcelona;11;Baix Llobregat;08073;Cornellà de Llobregat;4;11;B;;392;95;183;226;166;2;5;219;224
8;Barcelona;11;Baix Llobregat;08073;Cornellà de Llobregat;4;12;A;;464;120;223;271;193;1;4;266;270
8;Barcelona;11;Baix Llobregat;08073;Cornellà de Llobregat;4;12;B;;516;127;251;295;221;1;6;288;294
8;Barcelona;11;Baix Llobregat;08073;Cornellà de Llobregat;4;13;A;;552;148;267;362;190;0;9;353;362
8;Barcelona;11;Baix Llobregat;08073;Cornellà de Llobregat;4;13;B;;574;154;262;333;241;2;11;320;331
8;Barcelona;11;Baix Llobregat;08073;Cornellà de Llobregat;4;14;A;;405;77;158;227;178;4;7;216;223
8;Barcelona;11;Baix Llobregat;08073;Cornellà de Llobregat;4;14;B;;464;84;193;269;195;3;8;258;266
8;Barcelona;11;Baix Llobregat;08073;Cornellà de Llobregat;4;15;A;;306;59;116;166;140;1;2;163;165
8;Barcelona;11;Baix Llobregat;08073;Cornellà de Llobregat;4;15;B;;401;79;167;215;186;2;2;211;213
8;Barcelona;11;Baix Llobregat;08073;Cornellà de Llobregat;4;16;A;;428;87;192;259;169;1;9;249;258
8;Barcelona;11;Baix Llobregat;08073;Cornellà de Llobregat;4;16;B;;506;105;211;289;217;2;2;285;287
8;Barcelona;11;Baix Llobregat;08073;Cornellà de Llobregat;4;17;A;;425;105;199;249;176;0;7;242;249
8;Barcelona;11;Baix Llobregat;08073;Cornellà de Llobregat;4;17;B;;488;130;240;287;201;2;6;279;285
8;Barcelona;11;Baix Llobregat;08073;Cornellà de Llobregat;4;18;U;;628;163;289;371;257;2;14;355;369
8;Barcelona;11;Baix Llobregat;08073;Cornellà de Llobregat;4;19;U;;642;131;315;392;250;2;9;381;390
8;Barcelona;11;Baix Llobregat;08073;Cornellà de Llobregat;4;2;U;;533;110;229;299;234;0;3;296;299
8;Barcelona;11;Baix Llobregat;08073;Cornellà de Llobregat;4;3;A;;526;89;207;290;236;0;10;280;290
8;Barcelona;11;Baix Llobregat;08073;Cornellà de Llobregat;4;3;B;;599;124;267;358;241;0;8;350;358
8;Barcelona;11;Baix Llobregat;08073;Cornellà de Llobregat;4;4;A;;352;95;171;218;134;1;8;209;217
8;Barcelona;11;Baix Llobregat;08073;Cornellà de Llobregat;4;4;B;;389;83;186;236;153;0;6;230;236
8;Barcelona;11;Baix Llobregat;08073;Cornellà de Llobregat;4;5;A;;307;67;139;182;125;0;4;178;182
8;Barcelona;11;Baix Llobregat;08073;Cornellà de Llobregat;4;5;B;;358;88;181;217;141;0;4;213;217
8;Barcelona;11;Baix Llobregat;08073;Cornellà de Llobregat;4;6;A;;451;95;242;259;192;1;3;255;258
8;Barcelona;11;Baix Llobregat;08073;Cornellà de Llobregat;4;6;B;;528;129;203;301;227;2;9;290;299
8;Barcelona;11;Baix Llobregat;08073;Cornellà de Llobregat;4;7;A;;378;92;162;212;166;0;3;209;212
8;Barcelona;11;Baix Llobregat;08073;Cornellà de Llobregat;4;7;B;;443;117;210;255;188;0;6;249;255
8;Barcelona;11;Baix Llobregat;08073;Cornellà de Llobregat;4;8;A;;525;102;243;298;227;14;2;282;284
8;Barcelona;11;Baix Llobregat;08073;Cornellà de Llobregat;4;8;B;;586;129;273;337;249;7;13;317;330
8;Barcelona;11;Baix Llobregat;08073;Cornellà de Llobregat;4;9;U;;662;161;312;384;278;4;7;373;380
8;Barcelona;11;Baix Llobregat;08073;Cornellà de Llobregat;5;1;U;;535;109;222;259;276;3;2;254;256
8;Barcelona;11;Baix Llobregat;08073;Cornellà de Llobregat;5;10;A;;395;77;180;206;189;1;2;203;205
8;Barcelona;11;Baix Llobregat;08073;Cornellà de Llobregat;5;10;B;;407;83;182;227;180;2;3;222;225
8;Barcelona;11;Baix Llobregat;08073;Cornellà de Llobregat;5;2;U;;519;108;189;237;282;2;5;230;235
8;Barcelona;11;Baix Llobregat;08073;Cornellà de Llobregat;5;3;A;;333;70;155;176;157;0;2;174;176
8;Barcelona;11;Baix Llobregat;08073;Cornellà de Llobregat;5;3;B;;347;64;129;158;189;1;2;155;157
8;Barcelona;11;Baix Llobregat;08073;Cornellà de Llobregat;5;4;U;;514;105;211;250;264;1;11;238;249
8;Barcelona;11;Baix Llobregat;08073;Cornellà de Llobregat;5;5;U;;606;137;241;293;313;1;9;283;292
8;Barcelona;11;Baix Llobregat;08073;Cornellà de Llobregat;5;6;A;;343;70;131;165;178;0;4;161;165
8;Barcelona;11;Baix Llobregat;08073;Cornellà de Llobregat;5;6;B;;387;59;148;190;197;0;5;185;190
8;Barcelona;11;Baix Llobregat;08073;Cornellà de Llobregat;5;7;A;;308;59;122;157;151;1;4;152;156
8;Barcelona;11;Baix Llobregat;08073;Cornellà de Llobregat;5;7;B;;386;92;154;193;193;1;1;191;192
8;Barcelona;11;Baix Llobregat;08073;Cornellà de Llobregat;5;8;A;;306;80;132;157;149;2;4;151;155
8;Barcelona;11;Baix Llobregat;08073;Cornellà de Llobregat;5;8;B;;319;89;148;171;148;1;3;167;170
8;Barcelona;11;Baix Llobregat;08073;Cornellà de Llobregat;5;9;U;;619;144;309;401;218;2;13;386;399
8;Barcelona;11;Baix Llobregat;08073;Cornellà de Llobregat;6;1;U;;398;77;154;178;220;0;8;170;178
8;Barcelona;11;Baix Llobregat;08073;Cornellà de Llobregat;6;10;U;;578;120;248;314;264;4;6;304;310
8;Barcelona;11;Baix Llobregat;08073;Cornellà de Llobregat;6;11;U;;388;74;142;181;207;1;5;175;180
8;Barcelona;11;Baix Llobregat;08073;Cornellà de Llobregat;6;12;U;;579;110;235;283;296;1;7;275;282
8;Barcelona;11;Baix Llobregat;08073;Cornellà de Llobregat;6;13;U;;490;140;217;260;230;2;7;251;258
8;Barcelona;11;Baix Llobregat;08073;Cornellà de Llobregat;6;14;U;;575;108;239;312;263;1;15;296;311
8;Barcelona;11;Baix Llobregat;08073;Cornellà de Llobregat;6;15;U;;749;186;364;459;290;2;13;444;457
8;Barcelona;11;Baix Llobregat;08073;Cornellà de Llobregat;6;16;U;;452;93;187;224;228;4;5;215;220
8;Barcelona;11;Baix Llobregat;08073;Cornellà de Llobregat;6;2;A;;325;81;158;192;133;0;8;184;192
8;Barcelona;11;Baix Llobregat;08073;Cornellà de Llobregat;6;2;B;;364;87;176;200;164;0;9;191;200
8;Barcelona;11;Baix Llobregat;08073;Cornellà de Llobregat;6;3;U;;386;90;150;180;206;0;6;174;180
8;Barcelona;11;Baix Llobregat;08073;Cornellà de Llobregat;6;4;U;;408;94;149;189;219;1;2;186;188
8;Barcelona;11;Baix Llobregat;08073;Cornellà de Llobregat;6;5;U;;501;126;217;261;240;0;9;252;261
8;Barcelona;11;Baix Llobregat;08073;Cornellà de Llobregat;6;6;U;;410;108;187;224;186;1;6;217;223
8;Barcelona;11;Baix Llobregat;08073;Cornellà de Llobregat;6;7;A;;317;87;164;203;114;1;4;198;202
8;Barcelona;11;Baix Llobregat;08073;Cornellà de Llobregat;6;7;B;;356;82;153;188;168;1;2;185;187
8;Barcelona;11;Baix Llobregat;08073;Cornellà de Llobregat;6;8;U;;402;95;173;207;195;0;4;203;207
8;Barcelona;11;Baix Llobregat;08073;Cornellà de Llobregat;6;9;A;;450;89;192;250;200;0;8;242;250
8;Barcelona;11;Baix Llobregat;08073;Cornellà de Llobregat;6;9;B;;564;116;237;316;248;2;6;308;314
8;Barcelona;11;Baix Llobregat;08073;Cornellà de Llobregat;6;9;C;;546;116;245;309;237;0;6;303;309
17;Girona;28;Pla de l'Estany;17056;Cornellà del Terri;1;1;A;;826;270;493;588;238;5;20;563;583
17;Girona;28;Pla de l'Estany;17056;Cornellà del Terri;1;1;B;;868;241;523;603;265;4;14;585;599
43;Tarragona;29;Priorat;43049;Cornudella de Montsant;1;1;U;;810;195;450;546;264;3;17;526;543
43;Tarragona;36;Tarragonès;43050;Creixell;1;1;A;;617;187;287;348;269;3;7;338;345
43;Tarragona;36;Tarragonès;43050;Creixell;1;1;B;;532;163;261;309;223;6;2;301;303
43;Tarragona;36;Tarragonès;43050;Creixell;1;1;C;;637;190;315;366;271;1;6;359;365
43;Tarragona;36;Tarragonès;43050;Creixell;1;1;D;;573;143;266;305;268;0;10;295;305
17;Girona;28;Pla de l'Estany;17058;Crespià;1;1;U;;180;50;95;112;68;0;2;110;112
17;Girona;10;Baix Empordà;17901;Cruïlles, Monells i Sant Sadurní;1;1;A;;521;133;291;343;178;7;16;320;336
17;Girona;10;Baix Empordà;17901;Cruïlles, Monells i Sant Sadurní;1;1;B;;219;50;121;139;80;5;4;130;134
17;Girona;10;Baix Empordà;17901;Cruïlles, Monells i Sant Sadurní;1;1;C;;237;91;130;168;69;2;1;165;166
8;Barcelona;17;Garraf;08074;Cubelles;1;1;U;;689;166;316;383;306;4;18;361;379
8;Barcelona;17;Garraf;08074;Cubelles;1;2;A;;603;166;307;372;231;2;12;358;370
8;Barcelona;17;Garraf;08074;Cubelles;1;2;B;;724;190;349;403;321;3;16;384;400
8;Barcelona;17;Garraf;08074;Cubelles;1;2;C;;571;147;263;324;247;1;7;316;323
8;Barcelona;17;Garraf;08074;Cubelles;1;3;A;;542;161;247;291;251;1;6;284;290
8;Barcelona;17;Garraf;08074;Cubelles;1;3;B;;637;177;292;358;279;1;11;346;357
8;Barcelona;17;Garraf;08074;Cubelles;1;3;C;;548;140;260;319;229;2;11;306;317
8;Barcelona;17;Garraf;08074;Cubelles;1;4;A;;610;184;275;342;268;4;8;330;338
8;Barcelona;17;Garraf;08074;Cubelles;1;4;B;;745;179;325;407;338;5;11;391;402
8;Barcelona;17;Garraf;08074;Cubelles;1;5;A;;774;225;360;440;334;1;7;432;439
8;Barcelona;17;Garraf;08074;Cubelles;1;5;B;;896;239;388;471;425;4;11;456;467
8;Barcelona;17;Garraf;08074;Cubelles;1;6;A;;730;175;317;370;360;2;6;362;368
8;Barcelona;17;Garraf;08074;Cubelles;1;6;B;;873;205;365;424;449;1;11;412;423
8;Barcelona;17;Garraf;08074;Cubelles;1;7;A;;520;132;204;241;279;2;4;235;239
8;Barcelona;17;Garraf;08074;Cubelles;1;7;B;;657;169;257;296;361;0;3;293;296
25;Lleida;23;Noguera;25079;Cubells;1;1;U;;305;83;192;239;66;3;8;228;236
43;Tarragona;12;Baix Penedès;43051;Cunit;1;1;A;;503;149;236;284;219;3;7;274;281
43;Tarragona;12;Baix Penedès;43051;Cunit;1;1;B;;649;210;320;374;275;5;3;366;369
43;Tarragona;12;Baix Penedès;43051;Cunit;1;1;C;;645;190;293;334;311;6;5;323;328
43;Tarragona;12;Baix Penedès;43051;Cunit;1;2;A;;530;182;260;311;219;4;6;301;307
43;Tarragona;12;Baix Penedès;43051;Cunit;1;2;B;;554;151;259;325;229;4;5;316;321
43;Tarragona;12;Baix Penedès;43051;Cunit;1;2;C;;586;164;280;325;261;3;9;313;322
43;Tarragona;12;Baix Penedès;43051;Cunit;1;3;A;;571;168;278;320;251;12;4;304;308
43;Tarragona;12;Baix Penedès;43051;Cunit;1;3;B;;550;155;255;305;245;5;6;294;300
43;Tarragona;12;Baix Penedès;43051;Cunit;1;3;C;;631;168;279;319;312;3;4;312;316
43;Tarragona;12;Baix Penedès;43051;Cunit;1;4;A;;459;107;179;223;236;2;5;216;221
43;Tarragona;12;Baix Penedès;43051;Cunit;1;4;B;;519;126;196;238;281;3;3;232;235
43;Tarragona;12;Baix Penedès;43051;Cunit;1;4;C;;522;131;221;258;264;4;3;251;254
43;Tarragona;12;Baix Penedès;43051;Cunit;1;5;A;;637;160;272;321;316;6;8;307;315
43;Tarragona;12;Baix Penedès;43051;Cunit;1;5;B;;640;176;283;344;296;9;10;325;335
43;Tarragona;12;Baix Penedès;43051;Cunit;1;5;C;;645;185;293;346;299;3;8;335;343
17;Girona;2;Alt Empordà;17060;Darnius;1;1;U;;383;124;217;259;124;7;3;249;252
17;Girona;15;Cerdanya;17061;Das;1;1;U;;173;63;105;125;48;0;5;120;125
43;Tarragona;9;Baix Ebre;43901;Deltebre;1;1;A;;869;179;395;487;382;8;11;468;479
43;Tarragona;9;Baix Ebre;43901;Deltebre;1;1;B;;699;156;303;387;312;8;14;365;379
43;Tarragona;9;Baix Ebre;43901;Deltebre;1;2;A;;672;141;286;385;287;3;11;371;382
43;Tarragona;9;Baix Ebre;43901;Deltebre;1;2;B;;567;123;230;310;257;1;7;302;309
43;Tarragona;9;Baix Ebre;43901;Deltebre;1;2;C;;571;122;231;312;259;5;8;299;307
43;Tarragona;9;Baix Ebre;43901;Deltebre;1;3;A;;567;156;260;333;234;0;12;321;333
43;Tarragona;9;Baix Ebre;43901;Deltebre;1;3;B;;456;114;200;272;184;2;9;261;270
43;Tarragona;9;Baix Ebre;43901;Deltebre;1;4;A;;882;214;410;506;376;14;14;478;492
43;Tarragona;9;Baix Ebre;43901;Deltebre;1;4;B;;604;136;245;324;280;3;6;315;321
43;Tarragona;9;Baix Ebre;43901;Deltebre;1;5;A;;655;144;274;362;293;1;9;352;361
43;Tarragona;9;Baix Ebre;43901;Deltebre;1;5;B;;605;135;251;316;289;1;14;301;315
43;Tarragona;9;Baix Ebre;43901;Deltebre;1;6;A;;916;225;437;548;368;2;17;529;546
43;Tarragona;9;Baix Ebre;43901;Deltebre;1;6;B;;733;180;352;435;298;5;16;414;430
8;Barcelona;21;Maresme;08075;Dosrius;1;1;A;;478;131;245;297;181;1;6;290;296
8;Barcelona;21;Maresme;08075;Dosrius;1;1;B;;590;143;304;358;232;2;10;346;356
8;Barcelona;21;Maresme;08075;Dosrius;1;1;C;;908;242;476;550;358;7;8;535;543
8;Barcelona;21;Maresme;08075;Dosrius;1;2;A;;870;194;360;457;413;0;8;449;457
8;Barcelona;21;Maresme;08075;Dosrius;1;2;B;;977;227;421;518;459;3;21;494;515
43;Tarragona;8;Baix Camp;43053;Duesaigües;1;1;U;;198;50;115;147;51;1;1;145;146
17;Girona;2;Alt Empordà;17062;Escala, l';1;1;U;;807;207;403;483;324;2;14;467;481
17;Girona;2;Alt Empordà;17062;Escala, l';1;2;A;;895;215;416;498;397;6;13;479;492
17;Girona;2;Alt Empordà;17062;Escala, l';1;2;B;;827;213;358;438;389;2;5;431;436
17;Girona;2;Alt Empordà;17062;Escala, l';1;3;A;;621;197;321;393;228;1;12;380;392
17;Girona;2;Alt Empordà;17062;Escala, l';1;3;B;;597;174;314;374;223;2;17;355;372
17;Girona;2;Alt Empordà;17062;Escala, l';1;4;U;;1043;278;516;622;421;5;29;588;617
17;Girona;2;Alt Empordà;17062;Escala, l';1;5;A;;623;155;244;310;313;0;2;308;310
17;Girona;2;Alt Empordà;17062;Escala, l';1;5;B;;584;125;227;301;283;2;11;288;299
8;Barcelona;11;Baix Llobregat;08076;Esparreguera;1;1;A;;645;130;257;340;305;3;11;326;337
8;Barcelona;11;Baix Llobregat;08076;Esparreguera;1;1;B;;719;133;260;340;379;3;16;321;337
8;Barcelona;11;Baix Llobregat;08076;Esparreguera;1;1;C;;581;123;234;312;269;2;16;294;310
8;Barcelona;11;Baix Llobregat;08076;Esparreguera;1;2;A;;714;165;317;405;309;3;14;388;402
8;Barcelona;11;Baix Llobregat;08076;Esparreguera;1;2;B;;830;218;408;497;333;5;10;482;492
8;Barcelona;11;Baix Llobregat;08076;Esparreguera;1;3;A;;552;169;306;372;180;3;8;361;369
8;Barcelona;11;Baix Llobregat;08076;Esparreguera;1;3;B;;772;217;418;520;252;4;11;505;516
8;Barcelona;11;Baix Llobregat;08076;Esparreguera;1;4;A;;773;178;356;439;334;2;9;428;437
8;Barcelona;11;Baix Llobregat;08076;Esparreguera;1;4;B;;934;206;419;510;424;6;14;490;504
8;Barcelona;11;Baix Llobregat;08076;Esparreguera;1;5;U;;672;145;264;329;343;1;8;320;328
8;Barcelona;11;Baix Llobregat;08076;Esparreguera;1;6;A;;627;147;306;388;239;4;12;372;384
8;Barcelona;11;Baix Llobregat;08076;Esparreguera;1;6;B;;648;150;331;411;237;3;13;395;408
8;Barcelona;11;Baix Llobregat;08076;Esparreguera;2;1;A;;806;177;338;419;387;2;13;404;417
8;Barcelona;11;Baix Llobregat;08076;Esparreguera;2;1;B;;907;211;380;467;440;1;8;458;466
8;Barcelona;11;Baix Llobregat;08076;Esparreguera;2;2;A;;585;126;247;328;257;0;14;314;328
8;Barcelona;11;Baix Llobregat;08076;Esparreguera;2;2;B;;671;132;281;360;311;3;15;342;357
8;Barcelona;11;Baix Llobregat;08076;Esparreguera;2;3;A;;736;190;350;445;291;2;17;426;443
8;Barcelona;11;Baix Llobregat;08076;Esparreguera;2;3;B;;832;230;440;536;296;3;13;520;533
8;Barcelona;11;Baix Llobregat;08076;Esparreguera;2;4;A;;724;152;316;400;324;3;6;391;397
8;Barcelona;11;Baix Llobregat;08076;Esparreguera;2;4;B;;771;155;329;431;340;3;13;415;428
8;Barcelona;11;Baix Llobregat;08076;Esparreguera;2;5;A;;679;128;231;296;383;0;16;280;296
8;Barcelona;11;Baix Llobregat;08076;Esparreguera;2;5;B;;714;123;233;299;415;6;14;279;293
17;Girona;24;Osona;17063;Espinelves;1;1;U;;167;69;108;130;37;4;11;115;126
25;Lleida;18;Garrigues;25081;Espluga Calba, l';1;1;U;;335;73;170;211;124;1;17;193;210
43;Tarragona;16;Conca de Barberà;43054;Espluga de Francolí, l';1;1;A;;607;130;260;357;250;3;9;345;354
43;Tarragona;16;Conca de Barberà;43054;Espluga de Francolí, l';1;1;B;;432;69;149;222;210;1;5;216;221
43;Tarragona;16;Conca de Barberà;43054;Espluga de Francolí, l';1;1;C;;683;127;260;405;278;7;5;393;398
43;Tarragona;16;Conca de Barberà;43054;Espluga de Francolí, l';2;1;A;;523;85;211;302;221;7;13;282;295
43;Tarragona;16;Conca de Barberà;43054;Espluga de Francolí, l';2;1;B;;623;106;260;357;266;4;8;345;353
8;Barcelona;11;Baix Llobregat;08077;Esplugues de Llobregat;1;1;A;;728;196;415;541;187;3;10;528;538
8;Barcelona;11;Baix Llobregat;08077;Esplugues de Llobregat;1;1;B;;743;196;424;543;200;2;10;531;541
8;Barcelona;11;Baix Llobregat;08077;Esplugues de Llobregat;1;2;A;;454;111;237;300;154;1;8;291;299
8;Barcelona;11;Baix Llobregat;08077;Esplugues de Llobregat;1;2;B;;503;138;282;356;147;2;7;347;354
8;Barcelona;11;Baix Llobregat;08077;Esplugues de Llobregat;1;3;A;;636;156;327;423;213;5;18;400;418
8;Barcelona;11;Baix Llobregat;08077;Esplugues de Llobregat;1;3;B;;647;161;364;456;191;3;16;437;453
8;Barcelona;11;Baix Llobregat;08077;Esplugues de Llobregat;1;4;A;;500;118;250;308;192;5;4;299;303
8;Barcelona;11;Baix Llobregat;08077;Esplugues de Llobregat;1;4;B;;522;113;254;321;201;2;7;312;319
8;Barcelona;11;Baix Llobregat;08077;Esplugues de Llobregat;1;5;A;;633;167;323;407;226;0;12;395;407
8;Barcelona;11;Baix Llobregat;08077;Esplugues de Llobregat;1;5;B;;692;173;365;453;239;3;14;436;450
8;Barcelona;11;Baix Llobregat;08077;Esplugues de Llobregat;10;1;A;;451;131;214;284;167;2;5;277;282
8;Barcelona;11;Baix Llobregat;08077;Esplugues de Llobregat;10;1;B;;588;161;303;356;232;1;9;346;355
8;Barcelona;11;Baix Llobregat;08077;Esplugues de Llobregat;10;1;C;;602;147;293;359;243;2;7;350;357
8;Barcelona;11;Baix Llobregat;08077;Esplugues de Llobregat;10;2;A;;513;100;213;289;224;0;6;283;289
8;Barcelona;11;Baix Llobregat;08077;Esplugues de Llobregat;10;2;B;;650;161;309;391;259;1;16;374;390
8;Barcelona;11;Baix Llobregat;08077;Esplugues de Llobregat;10;3;A;;519;112;244;305;214;2;11;292;303
8;Barcelona;11;Baix Llobregat;08077;Esplugues de Llobregat;10;3;B;;568;147;264;318;250;2;9;307;316
8;Barcelona;11;Baix Llobregat;08077;Esplugues de Llobregat;10;3;C;;561;146;271;346;215;3;15;328;343
8;Barcelona;11;Baix Llobregat;08077;Esplugues de Llobregat;10;4;A;;369;82;157;198;171;0;8;190;198
8;Barcelona;11;Baix Llobregat;08077;Esplugues de Llobregat;10;4;B;;463;101;183;231;232;0;7;224;231
8;Barcelona;11;Baix Llobregat;08077;Esplugues de Llobregat;10;5;A;;351;83;152;182;169;1;1;180;181
8;Barcelona;11;Baix Llobregat;08077;Esplugues de Llobregat;10;5;B;;410;101;176;210;200;2;9;199;208
8;Barcelona;11;Baix Llobregat;08077;Esplugues de Llobregat;10;6;A;;574;158;271;346;228;0;12;334;346
8;Barcelona;11;Baix Llobregat;08077;Esplugues de Llobregat;10;6;B;;620;155;279;346;274;2;11;333;344
8;Barcelona;11;Baix Llobregat;08077;Esplugues de Llobregat;10;7;A;;618;148;312;382;236;5;11;366;377
8;Barcelona;11;Baix Llobregat;08077;Esplugues de Llobregat;10;7;B;;644;142;290;370;274;2;17;351;368
8;Barcelona;11;Baix Llobregat;08077;Esplugues de Llobregat;10;8;A;;593;110;248;307;286;4;6;297;303
8;Barcelona;11;Baix Llobregat;08077;Esplugues de Llobregat;10;8;B;;736;148;310;378;358;5;11;362;373
8;Barcelona;11;Baix Llobregat;08077;Esplugues de Llobregat;2;1;A;;538;122;251;350;188;3;12;335;347
8;Barcelona;11;Baix Llobregat;08077;Esplugues de Llobregat;2;1;B;;587;146;304;382;205;1;12;369;381
8;Barcelona;11;Baix Llobregat;08077;Esplugues de Llobregat;2;2;A;;475;95;200;264;211;2;6;256;262
8;Barcelona;11;Baix Llobregat;08077;Esplugues de Llobregat;2;2;B;;568;123;253;329;239;6;8;315;323
8;Barcelona;11;Baix Llobregat;08077;Esplugues de Llobregat;2;3;A;;632;125;282;376;256;3;10;363;373
8;Barcelona;11;Baix Llobregat;08077;Esplugues de Llobregat;2;3;B;;731;149;310;427;304;2;8;417;425
8;Barcelona;11;Baix Llobregat;08077;Esplugues de Llobregat;2;4;A;;537;121;267;330;207;3;12;315;327
8;Barcelona;11;Baix Llobregat;08077;Esplugues de Llobregat;2;4;B;;598;115;254;338;260;0;13;325;338
8;Barcelona;11;Baix Llobregat;08077;Esplugues de Llobregat;2;5;A;;587;120;264;354;233;2;6;346;352
8;Barcelona;11;Baix Llobregat;08077;Esplugues de Llobregat;2;5;B;;643;142;304;395;248;1;10;384;394
8;Barcelona;11;Baix Llobregat;08077;Esplugues de Llobregat;2;6;A;;563;117;280;376;187;3;15;358;373
8;Barcelona;11;Baix Llobregat;08077;Esplugues de Llobregat;2;6;B;;637;139;292;395;242;7;16;372;388
8;Barcelona;11;Baix Llobregat;08077;Esplugues de Llobregat;3;1;A;;497;121;248;324;173;0;10;314;324
8;Barcelona;11;Baix Llobregat;08077;Esplugues de Llobregat;3;1;B;;602;153;319;405;197;1;21;383;404
8;Barcelona;11;Baix Llobregat;08077;Esplugues de Llobregat;3;2;A;;538;129;265;327;211;1;15;311;326
8;Barcelona;11;Baix Llobregat;08077;Esplugues de Llobregat;3;2;B;;585;132;277;359;226;1;17;341;358
8;Barcelona;11;Baix Llobregat;08077;Esplugues de Llobregat;3;2;C;;565;137;268;353;212;2;3;348;351
8;Barcelona;11;Baix Llobregat;08077;Esplugues de Llobregat;4;1;U;;569;129;319;420;149;0;8;412;420
8;Barcelona;11;Baix Llobregat;08077;Esplugues de Llobregat;5;1;U;;540;96;282;345;195;1;6;338;344
8;Barcelona;11;Baix Llobregat;08077;Esplugues de Llobregat;6;1;U;;617;125;277;370;247;1;12;357;369
8;Barcelona;11;Baix Llobregat;08077;Esplugues de Llobregat;7;1;U;;873;191;452;636;237;1;9;626;635
8;Barcelona;11;Baix Llobregat;08077;Esplugues de Llobregat;8;1;A;;634;141;350;415;219;1;12;402;414
8;Barcelona;11;Baix Llobregat;08077;Esplugues de Llobregat;8;1;B;;811;201;435;532;279;1;17;514;531
8;Barcelona;11;Baix Llobregat;08077;Esplugues de Llobregat;8;2;A;;724;172;349;458;266;3;14;441;455
8;Barcelona;11;Baix Llobregat;08077;Esplugues de Llobregat;8;2;B;;896;225;452;568;328;4;18;546;564
8;Barcelona;11;Baix Llobregat;08077;Esplugues de Llobregat;9;1;A;;565;126;258;341;224;2;8;331;339
8;Barcelona;11;Baix Llobregat;08077;Esplugues de Llobregat;9;1;B;;591;120;240;320;271;1;11;308;319
8;Barcelona;11;Baix Llobregat;08077;Esplugues de Llobregat;9;2;A;;664;134;317;419;245;0;14;405;419
8;Barcelona;11;Baix Llobregat;08077;Esplugues de Llobregat;9;2;B;;724;159;356;460;264;1;11;448;459
17;Girona;2;Alt Empordà;17064;Espolla;1;1;U;;333;103;215;252;81;4;4;244;248
17;Girona;28;Pla de l'Estany;17065;Esponellà;1;1;U;;334;102;204;236;98;2;5;229;234
25;Lleida;26;Pallars Sobirà;25082;Espot;1;1;U;;267;60;115;170;97;0;9;161;170
8;Barcelona;14;Berguedà;08078;Espunyola, l';1;1;U;;222;71;132;168;54;0;4;164;168
8;Barcelona;24;Osona;08254;Esquirol, l';1;1;A;;631;177;381;462;169;4;16;442;458
8;Barcelona;24;Osona;08254;Esquirol, l';1;1;B;;685;189;410;487;198;3;21;463;484
8;Barcelona;24;Osona;08254;Esquirol, l';1;1;C;;142;57;97;115;27;0;2;113;115
8;Barcelona;24;Osona;08254;Esquirol, l';1;1;D;;271;91;162;194;77;0;8;186;194
25;Lleida;4;Alt Urgell;25088;Estamariu;1;1;U;;100;19;61;80;20;0;2;78;80
8;Barcelona;;;08079;Estany, l';1;1;U;;329;95;234;272;57;1;12;259;271
25;Lleida;32;Segarra;25085;Estaràs;1;1;U;;150;44;81;101;49;1;3;97;100
25;Lleida;26;Pallars Sobirà;25086;Esterri d'Àneu;1;1;U;;559;146;269;378;181;2;14;362;376
25;Lleida;26;Pallars Sobirà;25087;Esterri de Cardós;1;1;U;;69;15;30;48;21;0;0;48;48
43;Tarragona;29;Priorat;43055;Falset;1;1;A;;378;104;210;273;105;2;9;262;271
43;Tarragona;29;Priorat;43055;Falset;1;1;B;;464;125;261;313;151;10;13;290;303
43;Tarragona;29;Priorat;43055;Falset;2;1;A;;413;87;220;297;116;3;8;286;294
43;Tarragona;29;Priorat;43055;Falset;2;1;B;;306;68;166;223;83;6;12;205;217
43;Tarragona;29;Priorat;43055;Falset;2;1;C;;440;96;231;293;147;3;16;274;290
17;Girona;2;Alt Empordà;17005;Far d'Empordà, el;1;1;U;;404;110;205;251;153;2;6;243;249
25;Lleida;26;Pallars Sobirà;25089;Farrera;1;1;U;;106;16;40;57;49;0;2;55;57
43;Tarragona;37;Terra Alta;43056;Fatarella, la;1;1;U;;941;143;383;535;406;17;15;503;518
43;Tarragona;8;Baix Camp;43057;Febró, la;1;1;U;;46;9;24;32;14;0;4;28;32
8;Barcelona;41;Vallès Oriental;08134;Figaró-Montmany;1;1;U;;761;243;404;488;273;8;8;472;480
8;Barcelona;14;Berguedà;08080;Fígols;1;1;U;;45;26;32;37;8;0;0;37;37
25;Lleida;4;Alt Urgell;25908;Fígols i Alinyà;1;1;U;;250;80;138;174;76;2;3;169;172
43;Tarragona;29;Priorat;43058;Figuera, la;1;1;U;;104;16;46;81;23;0;5;76;81
17;Girona;2;Alt Empordà;17066;Figueres;1;1;U;;664;169;296;360;304;2;2;356;358
17;Girona;2;Alt Empordà;17066;Figueres;1;2;U;;833;241;439;513;320;1;15;497;512
17;Girona;2;Alt Empordà;17066;Figueres;1;3;A;;736;188;330;377;359;1;7;369;376
17;Girona;2;Alt Empordà;17066;Figueres;1;3;B;;825;235;403;456;369;5;5;446;451
17;Girona;2;Alt Empordà;17066;Figueres;1;4;U;;835;240;380;445;390;4;21;420;441
17;Girona;2;Alt Empordà;17066;Figueres;1;5;U;;888;107;204;246;642;3;6;237;243
17;Girona;2;Alt Empordà;17066;Figueres;1;6;A;;760;127;255;298;462;1;5;292;297
17;Girona;2;Alt Empordà;17066;Figueres;1;6;B;;682;150;262;307;375;14;9;284;293
17;Girona;2;Alt Empordà;17066;Figueres;1;7;U;;970;206;379;481;489;6;10;465;475
17;Girona;2;Alt Empordà;17066;Figueres;1;8;U;;598;145;256;311;287;1;7;303;310
17;Girona;2;Alt Empordà;17066;Figueres;2;1;U;;468;133;217;256;212;0;14;242;256
17;Girona;2;Alt Empordà;17066;Figueres;2;2;U;;928;270;448;536;392;12;7;517;524
17;Girona;2;Alt Empordà;17066;Figueres;2;3;U;;749;209;365;451;298;1;17;433;450
17;Girona;2;Alt Empordà;17066;Figueres;2;4;A;;754;168;335;411;343;0;6;405;411
17;Girona;2;Alt Empordà;17066;Figueres;2;4;B;;703;153;302;385;318;0;12;373;385
17;Girona;2;Alt Empordà;17066;Figueres;2;5;U;;528;139;259;312;216;0;13;299;312
17;Girona;2;Alt Empordà;17066;Figueres;3;1;U;;584;177;283;343;241;4;7;332;339
17;Girona;2;Alt Empordà;17066;Figueres;3;2;A;;712;168;315;365;347;6;22;337;359
17;Girona;2;Alt Empordà;17066;Figueres;3;2;B;;385;93;184;229;156;3;10;216;226
17;Girona;2;Alt Empordà;17066;Figueres;3;3;A;;664;166;321;380;284;4;7;369;376
17;Girona;2;Alt Empordà;17066;Figueres;3;3;B;;740;183;344;406;334;7;10;389;399
17;Girona;2;Alt Empordà;17066;Figueres;3;4;U;;757;138;268;310;447;2;5;303;308
17;Girona;2;Alt Empordà;17066;Figueres;3;5;A;;707;202;241;415;292;2;17;396;413
17;Girona;2;Alt Empordà;17066;Figueres;3;5;B;;811;216;390;457;354;3;15;439;454
17;Girona;2;Alt Empordà;17066;Figueres;4;1;U;;913;201;423;533;380;6;9;518;527
17;Girona;2;Alt Empordà;17066;Figueres;4;2;A;;573;179;306;369;204;3;15;351;366
17;Girona;2;Alt Empordà;17066;Figueres;4;2;B;;642;192;325;401;241;3;14;384;398
17;Girona;2;Alt Empordà;17066;Figueres;4;3;A;;657;167;292;353;304;5;11;337;348
17;Girona;2;Alt Empordà;17066;Figueres;4;3;B;;662;183;300;367;295;4;8;355;363
17;Girona;2;Alt Empordà;17066;Figueres;4;4;A;;816;220;419;483;333;6;10;467;477
17;Girona;2;Alt Empordà;17066;Figueres;4;4;B;;873;220;412;503;370;4;14;485;499
17;Girona;2;Alt Empordà;17066;Figueres;4;5;A;;931;254;461;534;397;2;14;518;532
17;Girona;2;Alt Empordà;17066;Figueres;4;5;B;;889;274;444;518;371;6;12;500;512
17;Girona;2;Alt Empordà;17066;Figueres;4;7;U;;721;204;376;451;270;1;15;435;450
17;Girona;2;Alt Empordà;17066;Figueres;4;8;U;;697;183;328;371;326;1;10;360;370
43;Tarragona;1;Alt Camp;43059;Figuerola del Camp;1;1;U;;261;83;161;191;70;2;2;187;189
17;Girona;20;Gironès;17067;Flaçà;1;1;U;;752;210;427;502;250;7;20;475;495
43;Tarragona;30;Ribera d'Ebre;43060;Flix;1;1;A;;449;116;230;302;147;4;9;289;298
43;Tarragona;30;Ribera d'Ebre;43060;Flix;1;1;B;;500;109;240;313;187;10;8;295;303
43;Tarragona;30;Ribera d'Ebre;43060;Flix;1;2;A;;565;126;259;344;221;8;14;322;336
43;Tarragona;30;Ribera d'Ebre;43060;Flix;1;2;B;;630;148;310;398;232;10;26;362;388
43;Tarragona;30;Ribera d'Ebre;43060;Flix;2;1;A;;428;93;220;268;160;4;12;252;264
43;Tarragona;30;Ribera d'Ebre;43060;Flix;2;1;B;;511;106;258;316;195;1;16;299;315
25;Lleida;18;Garrigues;25092;Floresta, la;1;1;U;;137;53;80;111;26;0;5;106;111
8;Barcelona;34;Selva;08082;Fogars de la Selva;1;1;A;;531;106;237;275;256;1;7;267;274
8;Barcelona;34;Selva;08082;Fogars de la Selva;1;1;B;;618;128;290;333;285;1;9;323;332
8;Barcelona;41;Vallès Oriental;08081;Fogars de Montclús;1;1;U;;331;98;210;244;87;4;8;232;240
17;Girona;10;Baix Empordà;17068;Foixà;1;1;U;;254;81;142;183;71;2;8;173;181
8;Barcelona;24;Osona;08083;Folgueroles;1;1;A;;783;221;504;620;163;8;25;587;612
8;Barcelona;24;Osona;08083;Folgueroles;1;1;B;;861;267;555;684;177;8;23;653;676
25;Lleida;27;Pla d'Urgell;25093;Fondarella;1;1;U;;646;174;359;446;200;8;10;428;438
8;Barcelona;7;Bages;08084;Fonollosa;1;1;A;;287;97;162;224;63;2;3;219;222
8;Barcelona;7;Bages;08084;Fonollosa;1;1;B;;260;86;146;205;55;0;5;200;205
8;Barcelona;7;Bages;08084;Fonollosa;1;1;C;;587;148;263;320;267;9;3;308;311
17;Girona;15;Cerdanya;17069;Fontanals de Cerdanya;1;1;U;;382;109;196;250;132;6;1;243;244
17;Girona;10;Baix Empordà;17070;Fontanilles;1;1;U;;118;33;64;79;39;0;4;75;79
17;Girona;28;Pla de l'Estany;17071;Fontcoberta;1;1;A;;496;133;280;353;143;7;12;334;346
17;Girona;28;Pla de l'Estany;17071;Fontcoberta;1;1;B;;539;147;317;395;144;7;12;376;388
8;Barcelona;3;Alt Penedès;08085;Font-rubí;1;1;U;;1058;241;559;729;329;14;11;704;715
25;Lleida;23;Noguera;25094;Foradada;1;1;U;;152;36;94;111;41;2;1;108;109
17;Girona;10;Baix Empordà;17902;Forallac;1;1;U;;782;205;443;553;229;5;9;539;548
17;Girona;10;Baix Empordà;17902;Forallac;1;2;A;;260;65;149;176;84;4;5;167;172
17;Girona;10;Baix Empordà;17902;Forallac;1;2;B;;323;83;176;220;103;3;3;214;217
43;Tarragona;16;Conca de Barberà;43061;Forès;1;1;U;;46;9;21;30;16;0;0;30;30
17;Girona;20;Gironès;17073;Fornells de la Selva;1;1;A;;844;270;535;654;190;2;19;633;652
17;Girona;20;Gironès;17073;Fornells de la Selva;1;1;B;;867;285;593;675;192;3;18;654;672
17;Girona;2;Alt Empordà;17074;Fortià;1;1;U;;481;144;260;291;190;3;15;273;288
8;Barcelona;41;Vallès Oriental;08086;Franqueses del Vallès, les;1;1;A;;979;233;508;630;349;3;19;608;627
8;Barcelona;41;Vallès Oriental;08086;Franqueses del Vallès, les;1;1;B;;938;229;503;615;323;5;17;593;610
8;Barcelona;41;Vallès Oriental;08086;Franqueses del Vallès, les;1;1;C;;1075;220;547;712;363;5;31;676;707
8;Barcelona;41;Vallès Oriental;08086;Franqueses del Vallès, les;1;1;D;;121;37;77;91;30;0;4;87;91
8;Barcelona;41;Vallès Oriental;08086;Franqueses del Vallès, les;1;2;A;;423;94;167;202;221;1;7;194;201
8;Barcelona;41;Vallès Oriental;08086;Franqueses del Vallès, les;1;2;B;;527;110;191;238;289;0;3;235;238
8;Barcelona;41;Vallès Oriental;08086;Franqueses del Vallès, les;1;2;C;;507;87;168;218;289;0;6;212;218
8;Barcelona;41;Vallès Oriental;08086;Franqueses del Vallès, les;1;3;A;;599;145;249;305;294;3;15;287;302
8;Barcelona;41;Vallès Oriental;08086;Franqueses del Vallès, les;1;3;B;;524;92;191;250;274;2;11;237;248
8;Barcelona;41;Vallès Oriental;08086;Franqueses del Vallès, les;1;3;C;;593;120;208;282;311;0;6;276;282
8;Barcelona;41;Vallès Oriental;08086;Franqueses del Vallès, les;1;4;A;;479;100;201;251;228;4;6;241;247
8;Barcelona;41;Vallès Oriental;08086;Franqueses del Vallès, les;1;4;B;;828;216;423;524;304;0;12;512;524
8;Barcelona;41;Vallès Oriental;08086;Franqueses del Vallès, les;1;4;C;;918;198;437;530;388;3;14;513;527
8;Barcelona;41;Vallès Oriental;08086;Franqueses del Vallès, les;1;4;D;;961;226;439;551;410;0;23;528;551
8;Barcelona;41;Vallès Oriental;08086;Franqueses del Vallès, les;1;5;A;;886;179;381;470;416;0;15;455;470
8;Barcelona;41;Vallès Oriental;08086;Franqueses del Vallès, les;1;5;B;;1168;200;480;579;589;4;16;559;575
8;Barcelona;41;Vallès Oriental;08086;Franqueses del Vallès, les;2;1;A;;975;224;492;640;335;6;23;611;634
8;Barcelona;41;Vallès Oriental;08086;Franqueses del Vallès, les;2;1;B;;463;140;292;353;110;0;11;342;353
43;Tarragona;22;Montsià;43062;Freginals;1;1;U;;285;108;180;222;63;3;7;212;219
25;Lleida;38;Urgell;25096;Fuliola, la;1;1;U;;974;204;492;618;356;3;23;592;615
25;Lleida;18;Garrigues;25097;Fulleda;1;1;U;;91;24;62;71;20;0;5;66;71
8;Barcelona;7;Bages;08090;Gaià;1;1;U;;132;35;54;91;41;1;1;89;90
43;Tarragona;22;Montsià;43063;Galera, la;1;1;U;;584;148;276;337;247;2;15;320;335
8;Barcelona;40;Vallès Occidental;08087;Gallifa;1;1;U;;156;54;97;120;36;0;2;118;120
43;Tarragona;37;Terra Alta;43064;Gandesa;1;1;A;;601;141;295;405;196;3;17;385;402
43;Tarragona;37;Terra Alta;43064;Gandesa;1;1;B;;622;157;341;437;185;3;10;424;434
43;Tarragona;37;Terra Alta;43064;Gandesa;2;1;A;;411;95;226;278;133;4;4;270;274
43;Tarragona;37;Terra Alta;43064;Gandesa;2;1;B;;443;92;234;290;153;2;9;279;288
43;Tarragona;30;Ribera d'Ebre;43065;Garcia;1;1;U;;458;108;220;298;160;7;13;278;291
43;Tarragona;1;Alt Camp;43066;Garidells, els;1;1;U;;165;40;83;98;67;2;2;94;96
8;Barcelona;41;Vallès Oriental;08088;Garriga, la;1;1;A;;795;197;435;536;259;2;13;521;534
8;Barcelona;41;Vallès Oriental;08088;Garriga, la;1;1;B;;859;255;510;595;264;7;29;559;588
8;Barcelona;41;Vallès Oriental;08088;Garriga, la;1;2;A;;692;159;371;448;244;3;13;432;445
8;Barcelona;41;Vallès Oriental;08088;Garriga, la;1;2;B;;642;142;335;410;232;2;12;396;408
8;Barcelona;41;Vallès Oriental;08088;Garriga, la;1;3;A;;883;220;460;612;271;10;17;585;602
8;Barcelona;41;Vallès Oriental;08088;Garriga, la;1;3;B;;981;220;499;622;359;7;18;597;615
8;Barcelona;41;Vallès Oriental;08088;Garriga, la;2;1;A;;707;191;415;513;194;3;13;497;510
8;Barcelona;41;Vallès Oriental;08088;Garriga, la;2;1;B;;596;172;366;440;156;0;10;430;440
8;Barcelona;41;Vallès Oriental;08088;Garriga, la;2;1;C;;656;182;368;470;186;2;17;451;468
8;Barcelona;41;Vallès Oriental;08088;Garriga, la;2;2;A;;883;243;489;604;279;5;25;574;599
8;Barcelona;41;Vallès Oriental;08088;Garriga, la;2;2;B;;970;272;521;640;330;9;18;613;631
8;Barcelona;41;Vallès Oriental;08088;Garriga, la;2;3;A;;639;157;342;434;205;3;13;418;431
8;Barcelona;41;Vallès Oriental;08088;Garriga, la;2;3;B;;645;142;330;420;225;1;16;403;419
8;Barcelona;41;Vallès Oriental;08088;Garriga, la;2;3;C;;614;148;331;415;199;3;16;396;412
8;Barcelona;41;Vallès Oriental;08088;Garriga, la;2;4;U;;599;154;331;423;176;1;24;398;422
17;Girona;2;Alt Empordà;17075;Garrigàs;1;1;U;;299;104;178;215;84;4;8;203;211
17;Girona;10;Baix Empordà;17076;Garrigoles;1;1;U;;120;35;60;73;47;1;6;66;72
17;Girona;2;Alt Empordà;17077;Garriguella;1;1;U;;583;170;307;367;216;1;3;363;366
8;Barcelona;11;Baix Llobregat;08089;Gavà;1;1;A;;623;172;298;376;247;1;7;368;375
8;Barcelona;11;Baix Llobregat;08089;Gavà;1;1;B;;711;177;352;445;266;0;10;435;445
8;Barcelona;11;Baix Llobregat;08089;Gavà;1;2;A;;537;150;264;348;189;1;12;335;347
8;Barcelona;11;Baix Llobregat;08089;Gavà;1;2;B;;697;189;378;464;233;1;11;452;463
8;Barcelona;11;Baix Llobregat;08089;Gavà;1;3;A;;455;148;258;298;157;0;9;289;298
8;Barcelona;11;Baix Llobregat;08089;Gavà;1;3;B;;502;148;253;324;178;1;12;311;323
8;Barcelona;11;Baix Llobregat;08089;Gavà;1;3;C;;427;123;212;269;158;3;7;259;266
8;Barcelona;11;Baix Llobregat;08089;Gavà;1;4;A;;724;211;339;441;283;4;9;428;437
8;Barcelona;11;Baix Llobregat;08089;Gavà;1;4;B;;868;232;455;551;317;0;23;528;551
8;Barcelona;11;Baix Llobregat;08089;Gavà;1;5;A;;445;91;197;243;202;0;13;230;243
8;Barcelona;11;Baix Llobregat;08089;Gavà;1;5;B;;501;122;228;272;229;0;8;264;272
8;Barcelona;11;Baix Llobregat;08089;Gavà;1;6;U;;477;122;191;222;255;5;7;210;217
8;Barcelona;11;Baix Llobregat;08089;Gavà;1;7;A;;686;146;318;390;296;0;14;376;390
8;Barcelona;11;Baix Llobregat;08089;Gavà;1;7;B;;763;180;347;438;325;0;4;434;438
8;Barcelona;11;Baix Llobregat;08089;Gavà;1;8;A;;683;179;391;487;196;1;15;471;486
8;Barcelona;11;Baix Llobregat;08089;Gavà;1;8;B;;833;187;482;587;246;0;19;568;587
8;Barcelona;11;Baix Llobregat;08089;Gavà;2;1;A;;521;123;261;319;202;4;11;304;315
8;Barcelona;11;Baix Llobregat;08089;Gavà;2;1;B;;601;154;294;372;229;4;8;360;368
8;Barcelona;11;Baix Llobregat;08089;Gavà;2;1;C;;515;146;256;325;190;1;6;318;324
8;Barcelona;11;Baix Llobregat;08089;Gavà;2;10;U;;572;118;216;280;292;3;5;272;277
8;Barcelona;11;Baix Llobregat;08089;Gavà;2;2;U;;851;232;436;544;307;2;16;526;542
8;Barcelona;11;Baix Llobregat;08089;Gavà;2;3;U;;730;187;372;453;277;1;15;437;452
8;Barcelona;11;Baix Llobregat;08089;Gavà;2;4;A;;625;136;258;316;309;3;8;305;313
8;Barcelona;11;Baix Llobregat;08089;Gavà;2;4;B;;758;155;286;362;396;1;15;346;361
8;Barcelona;11;Baix Llobregat;08089;Gavà;2;5;U;;736;133;247;315;421;0;3;312;315
8;Barcelona;11;Baix Llobregat;08089;Gavà;2;6;A;;606;150;254;302;304;5;10;287;297
8;Barcelona;11;Baix Llobregat;08089;Gavà;2;6;B;;758;143;286;350;408;1;14;335;349
8;Barcelona;11;Baix Llobregat;08089;Gavà;2;7;U;;716;155;298;373;343;4;15;354;369
8;Barcelona;11;Baix Llobregat;08089;Gavà;2;8;A;;612;128;277;341;271;3;7;331;338
8;Barcelona;11;Baix Llobregat;08089;Gavà;2;8;B;;705;180;320;393;312;4;18;371;389
8;Barcelona;11;Baix Llobregat;08089;Gavà;2;9;A;;624;121;260;335;289;2;16;317;333
8;Barcelona;11;Baix Llobregat;08089;Gavà;2;9;B;;699;140;319;392;307;2;11;379;390
8;Barcelona;11;Baix Llobregat;08089;Gavà;3;1;A;;447;107;209;254;193;3;10;241;251
8;Barcelona;11;Baix Llobregat;08089;Gavà;3;1;B;;515;123;232;273;242;1;15;257;272
8;Barcelona;11;Baix Llobregat;08089;Gavà;3;2;U;;855;259;416;499;356;1;9;489;498
8;Barcelona;11;Baix Llobregat;08089;Gavà;3;3;A;;499;98;214;281;218;1;11;269;280
8;Barcelona;11;Baix Llobregat;08089;Gavà;3;3;B;;596;119;238;317;279;0;15;302;317
8;Barcelona;11;Baix Llobregat;08089;Gavà;3;3;C;;498;100;220;286;212;1;9;276;285
8;Barcelona;11;Baix Llobregat;08089;Gavà;3;4;A;;545;118;206;247;298;1;9;237;246
8;Barcelona;11;Baix Llobregat;08089;Gavà;3;4;B;;614;129;247;295;319;1;11;283;294
8;Barcelona;11;Baix Llobregat;08089;Gavà;3;5;A;;769;134;243;301;468;1;6;294;300
8;Barcelona;11;Baix Llobregat;08089;Gavà;3;5;B;;702;163;277;342;360;2;13;327;340
8;Barcelona;11;Baix Llobregat;08089;Gavà;3;6;A;;420;94;204;247;173;0;8;239;247
8;Barcelona;11;Baix Llobregat;08089;Gavà;3;6;B;;493;113;227;265;228;0;6;259;265
8;Barcelona;11;Baix Llobregat;08089;Gavà;3;7;U;;733;158;399;490;243;0;20;470;490
8;Barcelona;11;Baix Llobregat;08089;Gavà;3;8;A;;591;114;255;359;232;0;17;342;359
8;Barcelona;11;Baix Llobregat;08089;Gavà;3;8;B;;737;173;342;473;264;1;12;460;472
8;Barcelona;11;Baix Llobregat;08089;Gavà;3;8;C;;566;124;256;335;231;1;14;320;334
8;Barcelona;11;Baix Llobregat;08089;Gavà;4;1;A;;494;140;262;328;166;4;9;315;324
8;Barcelona;11;Baix Llobregat;08089;Gavà;4;1;B;;663;151;330;402;261;2;8;392;400
8;Barcelona;11;Baix Llobregat;08089;Gavà;4;1;C;;543;142;277;338;205;2;12;324;336
8;Barcelona;11;Baix Llobregat;08089;Gavà;4;2;A;;619;141;268;318;301;0;17;301;318
8;Barcelona;11;Baix Llobregat;08089;Gavà;4;2;B;;653;142;283;341;312;6;12;323;335
25;Lleida;25;Pallars Jussà;25098;Gavet de la Conca;1;1;U;;262;65;131;165;97;3;5;157;162
8;Barcelona;3;Alt Penedès;08091;Gelida;1;1;A;;759;195;385;470;289;2;10;458;468
8;Barcelona;3;Alt Penedès;08091;Gelida;1;1;B;;846;191;361;493;353;8;15;470;485
8;Barcelona;3;Alt Penedès;08091;Gelida;1;2;A;;754;171;349;469;285;3;16;450;466
8;Barcelona;3;Alt Penedès;08091;Gelida;1;2;B;;892;231;408;516;376;6;19;491;510
8;Barcelona;3;Alt Penedès;08091;Gelida;2;1;A;;865;192;425;535;330;4;19;512;531
8;Barcelona;3;Alt Penedès;08091;Gelida;2;1;B;;995;269;522;637;358;3;21;613;634
17;Girona;15;Cerdanya;17078;Ger;1;1;U;;342;141;213;250;92;2;8;240;248
25;Lleida;33;Segrià;25912;Gimenells i el Pla de la Font;1;1;A;;625;159;307;390;235;7;4;379;383
25;Lleida;33;Segrià;25912;Gimenells i el Pla de la Font;1;1;B;;284;58;149;186;98;0;4;182;186
43;Tarragona;30;Ribera d'Ebre;43067;Ginestar;1;1;U;;634;143;328;426;208;7;23;396;419
17;Girona;20;Gironès;17079;Girona;1;1;U;;442;112;223;277;165;6;6;265;271
17;Girona;20;Gironès;17079;Girona;1;2;U;;621;164;301;366;255;1;11;354;365
17;Girona;20;Gironès;17079;Girona;1;3;U;;814;198;435;532;282;8;12;512;524
17;Girona;20;Gironès;17079;Girona;1;4;U;;782;192;350;452;330;7;17;428;445
17;Girona;20;Gironès;17079;Girona;1;5;U;;1051;97;203;283;768;1;0;282;282
17;Girona;20;Gironès;17079;Girona;1;6;A;;506;130;234;267;239;0;6;261;267
17;Girona;20;Gironès;17079;Girona;1;6;B;;480;133;216;250;230;1;3;246;249
17;Girona;20;Gironès;17079;Girona;2;1;U;;571;195;347;422;149;2;6;414;420
17;Girona;20;Gironès;17079;Girona;2;10;A;;518;137;287;344;174;4;15;325;340
17;Girona;20;Gironès;17079;Girona;2;10;B;;500;119;232;302;198;4;22;276;298
17;Girona;20;Gironès;17079;Girona;2;10;C;;553;169;325;384;169;1;14;369;383
17;Girona;20;Gironès;17079;Girona;2;11;A;;668;182;359;429;239;2;14;413;427
17;Girona;20;Gironès;17079;Girona;2;11;B;;672;160;326;389;283;3;9;377;386
17;Girona;20;Gironès;17079;Girona;2;11;C;;716;183;358;433;283;5;11;417;428
17;Girona;20;Gironès;17079;Girona;2;12;A;;539;158;318;386;153;2;11;373;384
17;Girona;20;Gironès;17079;Girona;2;12;B;;499;142;294;358;141;2;14;342;356
17;Girona;20;Gironès;17079;Girona;2;13;U;;772;237;431;540;232;7;15;518;533
17;Girona;20;Gironès;17079;Girona;2;14;U;;494;124;204;245;249;2;6;237;243
17;Girona;20;Gironès;17079;Girona;2;15;A;;571;143;331;405;166;4;10;391;401
17;Girona;20;Gironès;17079;Girona;2;15;B;;534;153;311;373;161;1;12;360;372
17;Girona;20;Gironès;17079;Girona;2;15;C;;580;155;344;425;155;3;11;411;422
17;Girona;20;Gironès;17079;Girona;2;16;A;;503;135;300;375;128;3;15;357;372
17;Girona;20;Gironès;17079;Girona;2;16;B;;420;121;270;323;97;1;10;312;322
17;Girona;20;Gironès;17079;Girona;2;17;A;;486;133;293;349;137;3;10;336;346
17;Girona;20;Gironès;17079;Girona;2;17;B;;462;122;269;344;118;0;9;335;344
17;Girona;20;Gironès;17079;Girona;2;18;A;;546;177;328;394;152;3;19;372;391
17;Girona;20;Gironès;17079;Girona;2;18;B;;574;173;342;409;165;3;13;393;406
17;Girona;20;Gironès;17079;Girona;2;19;A;;509;139;284;359;150;1;9;349;358
17;Girona;20;Gironès;17079;Girona;2;19;B;;479;152;273;343;136;3;12;328;340
17;Girona;20;Gironès;17079;Girona;2;19;C;;570;191;329;414;156;4;12;398;410
17;Girona;20;Gironès;17079;Girona;2;2;U;;609;180;321;417;192;0;9;408;417
17;Girona;20;Gironès;17079;Girona;2;20;A;;440;121;260;308;132;4;15;289;304
17;Girona;20;Gironès;17079;Girona;2;20;B;;466;122;274;336;130;1;10;325;335
17;Girona;20;Gironès;17079;Girona;2;21;A;;480;150;298;342;138;10;3;329;332
17;Girona;20;Gironès;17079;Girona;2;21;B;;455;135;279;317;138;0;10;307;317
17;Girona;20;Gironès;17079;Girona;2;3;A;;415;110;241;290;125;2;5;283;288
17;Girona;20;Gironès;17079;Girona;2;3;B;;498;142;287;364;134;1;5;358;363
17;Girona;20;Gironès;17079;Girona;2;4;A;;644;187;354;453;191;7;12;434;446
17;Girona;20;Gironès;17079;Girona;2;4;B;;576;159;337;408;168;4;17;387;404
17;Girona;20;Gironès;17079;Girona;2;5;U;;701;245;432;519;182;6;14;499;513
17;Girona;20;Gironès;17079;Girona;2;6;A;;730;210;396;506;224;3;4;499;503
17;Girona;20;Gironès;17079;Girona;2;6;B;;687;185;377;463;224;1;13;449;462
17;Girona;20;Gironès;17079;Girona;2;7;A;;638;168;397;467;171;2;8;457;465
17;Girona;20;Gironès;17079;Girona;2;7;B;;533;176;296;379;154;2;5;372;377
17;Girona;20;Gironès;17079;Girona;2;8;A;;480;152;305;370;110;1;10;359;369
17;Girona;20;Gironès;17079;Girona;2;8;B;;446;136;260;320;126;5;10;305;315
17;Girona;20;Gironès;17079;Girona;2;8;C;;543;172;314;379;164;1;17;361;378
17;Girona;20;Gironès;17079;Girona;2;9;A;;453;111;223;274;179;9;3;262;265
17;Girona;20;Gironès;17079;Girona;2;9;B;;484;136;258;310;174;0;14;296;310
17;Girona;20;Gironès;17079;Girona;3;1;U;;723;202;416;517;206;2;14;501;515
17;Girona;20;Gironès;17079;Girona;3;10;A;;554;137;262;324;230;1;6;317;323
17;Girona;20;Gironès;17079;Girona;3;10;B;;571;172;284;330;241;2;4;324;328
17;Girona;20;Gironès;17079;Girona;3;11;A;;587;173;284;331;256;6;13;312;325
17;Girona;20;Gironès;17079;Girona;3;11;B;;518;107;213;262;256;2;6;254;260
17;Girona;20;Gironès;17079;Girona;3;11;C;;543;147;253;301;242;5;9;287;296
17;Girona;20;Gironès;17079;Girona;3;12;A;;746;157;334;403;343;2;11;390;401
17;Girona;20;Gironès;17079;Girona;3;12;B;;735;171;335;402;333;2;11;389;400
17;Girona;20;Gironès;17079;Girona;3;13;A;;498;122;207;257;241;1;6;250;256
17;Girona;20;Gironès;17079;Girona;3;13;B;;459;105;187;233;226;1;2;230;232
17;Girona;20;Gironès;17079;Girona;3;14;A;;635;135;260;312;323;3;5;304;309
17;Girona;20;Gironès;17079;Girona;3;14;B;;579;124;235;296;283;5;5;286;291
17;Girona;20;Gironès;17079;Girona;3;15;A;;545;142;246;314;231;2;10;302;312
17;Girona;20;Gironès;17079;Girona;3;15;B;;584;146;279;332;252;6;6;320;326
17;Girona;20;Gironès;17079;Girona;3;16;A;;510;140;262;327;183;6;17;304;321
17;Girona;20;Gironès;17079;Girona;3;16;B;;574;138;281;362;212;3;11;348;359
17;Girona;20;Gironès;17079;Girona;3;17;A;;610;134;264;360;250;3;3;354;357
17;Girona;20;Gironès;17079;Girona;3;17;B;;548;126;233;311;237;0;18;293;311
17;Girona;20;Gironès;17079;Girona;3;18;A;;486;125;248;295;191;0;9;286;295
17;Girona;20;Gironès;17079;Girona;3;18;B;;433;125;217;261;172;0;12;249;261
17;Girona;20;Gironès;17079;Girona;3;2;U;;751;244;447;521;230;6;13;502;515
17;Girona;20;Gironès;17079;Girona;3;3;A;;633;189;359;440;193;5;13;422;435
17;Girona;20;Gironès;17079;Girona;3;3;B;;681;197;395;479;202;1;16;462;478
17;Girona;20;Gironès;17079;Girona;3;4;A;;590;226;373;454;136;7;12;435;447
17;Girona;20;Gironès;17079;Girona;3;4;B;;460;142;266;329;131;1;10;318;328
17;Girona;20;Gironès;17079;Girona;3;4;C;;604;199;366;442;162;1;14;427;441
17;Girona;20;Gironès;17079;Girona;3;5;A;;623;172;343;452;171;2;14;436;450
17;Girona;20;Gironès;17079;Girona;3;5;B;;524;159;292;355;169;3;16;336;352
17;Girona;20;Gironès;17079;Girona;3;5;C;;684;192;392;485;199;3;27;455;482
17;Girona;20;Gironès;17079;Girona;3;6;U;;684;236;393;474;210;10;6;458;464
17;Girona;20;Gironès;17079;Girona;3;7;A;;614;164;283;343;271;2;13;328;341
17;Girona;20;Gironès;17079;Girona;3;7;B;;644;175;298;359;285;5;12;342;354
17;Girona;20;Gironès;17079;Girona;3;8;A;;591;154;296;356;235;2;13;341;354
17;Girona;20;Gironès;17079;Girona;3;8;B;;572;124;254;325;247;4;13;308;321
17;Girona;20;Gironès;17079;Girona;3;8;C;;639;154;291;376;263;5;15;356;371
17;Girona;20;Gironès;17079;Girona;3;9;U;;760;167;320;383;377;5;12;366;378
17;Girona;20;Gironès;17079;Girona;4;1;U;;503;131;231;296;207;4;12;280;292
17;Girona;20;Gironès;17079;Girona;4;2;U;;606;188;295;352;254;2;17;333;350
17;Girona;20;Gironès;17079;Girona;4;3;U;;830;188;348;414;416;4;13;397;410
17;Girona;20;Gironès;17079;Girona;5;1;A;;551;185;359;436;115;1;18;417;435
17;Girona;20;Gironès;17079;Girona;5;1;B;;579;196;381;444;135;7;13;424;437
17;Girona;20;Gironès;17079;Girona;5;2;U;;436;105;200;230;206;0;6;224;230
17;Girona;20;Gironès;17079;Girona;5;3;A;;630;120;253;307;323;4;10;293;303
17;Girona;20;Gironès;17079;Girona;5;3;B;;545;133;238;272;273;3;6;263;269
17;Girona;20;Gironès;17079;Girona;5;4;U;;510;155;283;333;177;2;19;312;331
17;Girona;20;Gironès;17079;Girona;5;5;U;;766;195;337;403;363;4;6;393;399
17;Girona;20;Gironès;17079;Girona;5;6;U;;840;219;454;594;246;3;24;567;591
17;Girona;20;Gironès;17079;Girona;6;1;A;;755;186;399;480;275;6;18;456;474
17;Girona;20;Gironès;17079;Girona;6;1;B;;697;194;360;428;269;6;20;402;422
17;Girona;20;Gironès;17079;Girona;6;2;A;;468;126;217;264;204;1;13;250;263
17;Girona;20;Gironès;17079;Girona;6;2;B;;649;154;300;367;282;2;10;355;365
17;Girona;20;Gironès;17079;Girona;6;2;C;;558;142;264;306;252;1;10;295;305
17;Girona;20;Gironès;17079;Girona;6;3;A;;659;171;299;361;298;2;3;356;359
17;Girona;20;Gironès;17079;Girona;6;3;B;;733;197;370;415;318;16;0;399;399
17;Girona;20;Gironès;17079;Girona;6;4;A;;624;145;285;367;257;1;12;354;366
17;Girona;20;Gironès;17079;Girona;6;4;B;;557;134;281;322;235;5;6;311;317
17;Girona;20;Gironès;17079;Girona;6;5;U;;537;99;163;223;314;0;10;213;223
8;Barcelona;14;Berguedà;08092;Gironella;1;1;A;;615;150;304;378;237;3;8;367;375
8;Barcelona;14;Berguedà;08092;Gironella;1;1;B;;735;183;370;456;279;9;15;432;447
8;Barcelona;14;Berguedà;08092;Gironella;2;1;U;;379;96;187;235;144;8;4;223;227
8;Barcelona;14;Berguedà;08092;Gironella;2;2;A;;506;146;295;353;153;11;12;330;342
8;Barcelona;14;Berguedà;08092;Gironella;2;2;B;;599;148;318;382;217;4;12;366;378
8;Barcelona;14;Berguedà;08092;Gironella;2;3;A;;518;137;285;336;182;10;14;312;326
8;Barcelona;14;Berguedà;08092;Gironella;2;3;B;;601;163;332;397;204;9;7;381;388
8;Barcelona;14;Berguedà;08093;Gisclareny;1;1;U;;31;10;17;22;9;0;0;22;22
43;Tarragona;22;Montsià;43068;Godall;1;1;U;;573;169;332;393;180;6;17;370;387
25;Lleida;27;Pla d'Urgell;25099;Golmés;1;1;A;;589;118;291;350;239;4;7;339;346
25;Lleida;27;Pla d'Urgell;25099;Golmés;1;1;B;;585;156;315;375;210;7;6;362;368
17;Girona;31;Ripollès;17080;Gombrèn;1;1;U;;163;44;77;104;59;4;3;97;100
25;Lleida;14;Berguedà;25100;Gósol;1;1;U;;204;58;99;140;64;1;10;129;139
8;Barcelona;3;Alt Penedès;08094;Granada, la;1;1;A;;689;161;371;479;210;5;9;465;474
8;Barcelona;3;Alt Penedès;08094;Granada, la;1;1;B;;796;176;418;536;260;7;10;519;529
25;Lleida;18;Garrigues;25101;Granadella, la;1;1;U;;607;154;349;429;178;7;26;396;422
8;Barcelona;;;08095;Granera;1;1;U;;74;27;43;56;18;0;0;56;56
25;Lleida;33;Segrià;25102;Granja d'Escarp, la;1;1;U;;753;199;417;455;298;6;22;427;449
8;Barcelona;41;Vallès Oriental;08096;Granollers;1;1;U;;487;201;312;380;107;6;11;363;374
8;Barcelona;41;Vallès Oriental;08096;Granollers;1;10;A;;497;141;237;284;213;2;18;264;282
8;Barcelona;41;Vallès Oriental;08096;Granollers;1;10;B;;617;171;305;362;255;3;4;355;359
8;Barcelona;41;Vallès Oriental;08096;Granollers;1;11;A;;566;140;256;302;264;1;6;295;301
8;Barcelona;41;Vallès Oriental;08096;Granollers;1;11;B;;600;163;279;331;269;2;11;318;329
8;Barcelona;41;Vallès Oriental;08096;Granollers;1;2;A;;437;143;289;304;133;2;10;292;302
8;Barcelona;41;Vallès Oriental;08096;Granollers;1;2;B;;535;172;345;396;139;0;8;388;396
8;Barcelona;41;Vallès Oriental;08096;Granollers;1;3;A;;587;190;347;414;173;0;13;401;414
8;Barcelona;41;Vallès Oriental;08096;Granollers;1;3;B;;738;231;407;498;240;0;12;486;498
8;Barcelona;41;Vallès Oriental;08096;Granollers;1;4;U;;400;132;204;258;142;0;5;253;258
8;Barcelona;41;Vallès Oriental;08096;Granollers;1;5;A;;427;114;240;301;126;2;7;292;299
8;Barcelona;41;Vallès Oriental;08096;Granollers;1;5;B;;492;134;274;340;152;3;9;328;337
8;Barcelona;41;Vallès Oriental;08096;Granollers;1;5;C;;475;143;282;343;132;7;6;330;336
8;Barcelona;41;Vallès Oriental;08096;Granollers;1;6;U;;790;240;352;409;381;12;12;385;397
8;Barcelona;41;Vallès Oriental;08096;Granollers;1;7;A;;533;142;255;346;187;2;12;332;344
8;Barcelona;41;Vallès Oriental;08096;Granollers;1;7;B;;675;178;355;453;222;3;15;435;450
8;Barcelona;41;Vallès Oriental;08096;Granollers;1;8;U;;498;127;224;266;232;1;4;261;265
8;Barcelona;41;Vallès Oriental;08096;Granollers;1;9;U;;827;199;327;430;397;2;11;417;428
8;Barcelona;41;Vallès Oriental;08096;Granollers;2;1;A;;608;150;314;431;177;3;23;405;428
8;Barcelona;41;Vallès Oriental;08096;Granollers;2;1;B;;660;225;394;458;202;0;11;447;458
8;Barcelona;41;Vallès Oriental;08096;Granollers;2;2;U;;428;120;253;321;107;1;6;314;320
8;Barcelona;41;Vallès Oriental;08096;Granollers;2;3;U;;505;142;284;357;148;1;7;349;356
8;Barcelona;41;Vallès Oriental;08096;Granollers;2;4;A;;525;110;223;284;241;4;2;278;280
8;Barcelona;41;Vallès Oriental;08096;Granollers;2;4;B;;631;174;315;387;244;2;14;371;385
8;Barcelona;41;Vallès Oriental;08096;Granollers;2;4;C;;594;145;288;361;233;2;6;353;359
8;Barcelona;41;Vallès Oriental;08096;Granollers;2;5;A;;441;99;215;259;182;1;11;247;258
8;Barcelona;41;Vallès Oriental;08096;Granollers;2;5;B;;584;145;270;333;251;0;5;328;333
8;Barcelona;41;Vallès Oriental;08096;Granollers;2;6;A;;482;145;252;324;158;0;13;311;324
8;Barcelona;41;Vallès Oriental;08096;Granollers;2;6;B;;634;181;339;430;204;1;22;407;429
8;Barcelona;41;Vallès Oriental;08096;Granollers;2;7;A;;460;137;236;285;175;3;5;277;282
8;Barcelona;41;Vallès Oriental;08096;Granollers;2;7;B;;507;139;229;283;224;2;7;274;281
8;Barcelona;41;Vallès Oriental;08096;Granollers;3;1;A;;463;173;286;334;129;0;4;330;334
8;Barcelona;41;Vallès Oriental;08096;Granollers;3;1;B;;455;142;255;315;140;1;10;304;314
8;Barcelona;41;Vallès Oriental;08096;Granollers;3;1;C;;521;202;317;390;131;2;8;380;388
8;Barcelona;41;Vallès Oriental;08096;Granollers;3;2;A;;577;140;252;330;247;0;15;315;330
8;Barcelona;41;Vallès Oriental;08096;Granollers;3;2;B;;733;165;322;408;325;1;19;388;407
8;Barcelona;41;Vallès Oriental;08096;Granollers;3;3;A;;461;124;228;262;199;1;4;257;261
8;Barcelona;41;Vallès Oriental;08096;Granollers;3;3;B;;496;129;250;299;197;1;11;287;298
8;Barcelona;41;Vallès Oriental;08096;Granollers;3;4;A;;672;180;357;462;210;1;19;442;461
8;Barcelona;41;Vallès Oriental;08096;Granollers;3;4;B;;785;200;380;504;281;4;17;483;500
8;Barcelona;41;Vallès Oriental;08096;Granollers;3;5;A;;639;162;285;368;271;2;7;359;366
8;Barcelona;41;Vallès Oriental;08096;Granollers;3;5;B;;680;158;316;400;280;4;8;388;396
8;Barcelona;41;Vallès Oriental;08096;Granollers;3;6;A;;556;148;270;341;215;2;13;326;339
8;Barcelona;41;Vallès Oriental;08096;Granollers;3;6;B;;633;155;265;362;271;1;7;354;361
8;Barcelona;41;Vallès Oriental;08096;Granollers;3;6;C;;646;148;298;397;249;1;15;381;396
8;Barcelona;41;Vallès Oriental;08096;Granollers;3;7;U;;699;177;336;387;312;0;10;377;387
8;Barcelona;41;Vallès Oriental;08096;Granollers;3;8;A;;415;80;156;192;223;0;14;178;192
8;Barcelona;41;Vallès Oriental;08096;Granollers;3;8;B;;480;109;183;220;260;0;11;209;220
8;Barcelona;41;Vallès Oriental;08096;Granollers;3;9;U;;758;169;416;506;252;4;8;494;502
8;Barcelona;41;Vallès Oriental;08096;Granollers;4;1;A;;564;154;313;387;177;1;12;374;386
8;Barcelona;41;Vallès Oriental;08096;Granollers;4;1;B;;501;143;270;334;167;1;13;320;333
8;Barcelona;41;Vallès Oriental;08096;Granollers;4;1;C;;525;149;303;376;149;3;3;370;373
8;Barcelona;41;Vallès Oriental;08096;Granollers;4;10;A;;506;116;276;347;159;3;7;337;344
8;Barcelona;41;Vallès Oriental;08096;Granollers;4;10;B;;694;145;330;429;265;6;11;412;423
8;Barcelona;41;Vallès Oriental;08096;Granollers;4;10;C;;593;138;302;384;209;0;7;377;384
8;Barcelona;41;Vallès Oriental;08096;Granollers;4;11;A;;543;179;317;390;153;1;16;373;389
8;Barcelona;41;Vallès Oriental;08096;Granollers;4;11;B;;659;212;375;449;210;2;16;431;447
8;Barcelona;41;Vallès Oriental;08096;Granollers;4;12;U;;438;145;258;306;132;3;5;298;303
8;Barcelona;41;Vallès Oriental;08096;Granollers;4;2;A;;506;145;267;320;186;1;8;311;319
8;Barcelona;41;Vallès Oriental;08096;Granollers;4;2;B;;581;171;297;370;211;2;13;355;368
8;Barcelona;41;Vallès Oriental;08096;Granollers;4;2;C;;455;130;236;288;167;2;6;280;286
8;Barcelona;41;Vallès Oriental;08096;Granollers;4;3;U;;613;150;273;339;274;1;4;334;338
8;Barcelona;41;Vallès Oriental;08096;Granollers;4;4;U;;644;150;300;379;265;3;6;370;376
8;Barcelona;41;Vallès Oriental;08096;Granollers;4;5;U;;447;118;195;247;200;0;2;245;247
8;Barcelona;41;Vallès Oriental;08096;Granollers;4;6;U;;727;188;350;430;297;4;11;415;426
8;Barcelona;41;Vallès Oriental;08096;Granollers;4;7;A;;509;102;237;309;200;1;14;294;308
8;Barcelona;41;Vallès Oriental;08096;Granollers;4;7;B;;674;148;340;442;232;3;15;424;439
8;Barcelona;41;Vallès Oriental;08096;Granollers;4;7;C;;541;145;282;352;189;1;12;339;351
8;Barcelona;41;Vallès Oriental;08096;Granollers;4;8;U;;811;183;391;481;330;2;19;460;479
8;Barcelona;41;Vallès Oriental;08096;Granollers;4;9;U;;828;214;386;465;363;5;12;448;460
25;Lleida;32;Segarra;25103;Granyanella;1;1;U;;128;31;61;81;47;0;7;74;81
25;Lleida;18;Garrigues;25105;Granyena de les Garrigues;1;1;U;;143;40;74;91;52;1;1;89;90
25;Lleida;32;Segarra;25104;Granyena de Segarra;1;1;U;;131;38;77;92;39;0;5;87;92
43;Tarragona;29;Priorat;43069;Gratallops;1;1;U;;199;5;120;151;48;1;8;142;150
8;Barcelona;41;Vallès Oriental;08097;Gualba;1;1;U;;923;269;522;610;313;3;17;590;607
17;Girona;10;Baix Empordà;17081;Gualta;1;1;U;;235;70;139;164;71;2;5;157;162
8;Barcelona;14;Berguedà;08099;Guardiola de Berguedà;1;1;U;;825;220;442;527;298;7;10;510;520
43;Tarragona;29;Priorat;43070;Guiamets, els;1;1;U;;265;74;164;204;61;1;12;191;203
17;Girona;15;Cerdanya;17082;Guils de Cerdanya;1;1;U;;429;110;220;279;150;2;5;272;277
25;Lleida;38;Urgell;25109;Guimerà;1;1;U;;271;96;160;198;73;2;5;191;196
25;Lleida;26;Pallars Sobirà;25903;Guingueta d'Àneu, la;1;1;U;;262;57;119;168;94;0;3;165;168
25;Lleida;32;Segarra;25110;Guissona;1;1;U;;707;150;360;458;249;3;19;436;455
25;Lleida;32;Segarra;25110;Guissona;1;2;A;;533;100;225;293;240;2;9;282;291
25;Lleida;32;Segarra;25110;Guissona;1;2;B;;610;102;268;356;254;6;11;339;350
25;Lleida;32;Segarra;25110;Guissona;1;3;U;;787;121;365;476;311;4;24;448;472
25;Lleida;35;Solsonès;25111;Guixers;1;1;U;;113;22;61;77;36;0;1;76;77
8;Barcelona;24;Osona;08100;Gurb;1;1;A;;726;220;456;573;153;2;16;555;571
8;Barcelona;24;Osona;08100;Gurb;1;1;B;;612;181;378;479;133;3;12;464;476
8;Barcelona;24;Osona;08100;Gurb;1;1;C;;586;169;358;467;119;6;10;451;461
43;Tarragona;37;Terra Alta;43071;Horta de Sant Joan;1;1;U;;981;249;507;679;302;10;24;645;669
8;Barcelona;13;Barcelonès;08101;Hospitalet de Llobregat, l';1;1;A;;568;135;270;348;220;1;22;325;347
8;Barcelona;13;Barcelonès;08101;Hospitalet de Llobregat, l';1;1;B;;712;148;312;426;286;0;22;404;426
8;Barcelona;13;Barcelonès;08101;Hospitalet de Llobregat, l';1;10;U;;909;228;400;522;387;2;13;507;520
8;Barcelona;13;Barcelonès;08101;Hospitalet de Llobregat, l';1;11;U;;660;193;323;399;261;1;11;387;398
8;Barcelona;13;Barcelonès;08101;Hospitalet de Llobregat, l';1;12;A;;575;140;291;378;197;2;16;360;376
8;Barcelona;13;Barcelonès;08101;Hospitalet de Llobregat, l';1;12;B;;578;158;307;374;204;6;8;360;368
8;Barcelona;13;Barcelonès;08101;Hospitalet de Llobregat, l';1;13;A;;544;133;276;363;181;3;8;352;360
8;Barcelona;13;Barcelonès;08101;Hospitalet de Llobregat, l';1;13;B;;692;180;374;466;226;3;19;444;463
8;Barcelona;13;Barcelonès;08101;Hospitalet de Llobregat, l';1;14;A;;532;148;240;290;242;3;4;283;287
8;Barcelona;13;Barcelonès;08101;Hospitalet de Llobregat, l';1;14;B;;603;149;254;318;285;0;4;314;318
8;Barcelona;13;Barcelonès;08101;Hospitalet de Llobregat, l';1;15;U;;927;169;386;486;441;4;16;466;482
8;Barcelona;13;Barcelonès;08101;Hospitalet de Llobregat, l';1;16;A;;507;119;249;313;194;4;15;294;309
8;Barcelona;13;Barcelonès;08101;Hospitalet de Llobregat, l';1;16;B;;597;146;278;345;252;1;11;333;344
8;Barcelona;13;Barcelonès;08101;Hospitalet de Llobregat, l';1;17;A;;670;141;292;379;291;4;11;364;375
8;Barcelona;13;Barcelonès;08101;Hospitalet de Llobregat, l';1;17;B;;782;189;347;460;322;4;17;439;456
8;Barcelona;13;Barcelonès;08101;Hospitalet de Llobregat, l';1;18;A;;605;145;271;352;253;1;7;344;351
8;Barcelona;13;Barcelonès;08101;Hospitalet de Llobregat, l';1;18;B;;612;139;259;347;265;2;5;340;345
8;Barcelona;13;Barcelonès;08101;Hospitalet de Llobregat, l';1;19;A;;478;115;207;267;211;1;9;257;266
8;Barcelona;13;Barcelonès;08101;Hospitalet de Llobregat, l';1;19;B;;566;130;233;308;258;0;13;295;308
8;Barcelona;13;Barcelonès;08101;Hospitalet de Llobregat, l';1;2;A;;555;140;260;322;233;0;13;309;322
8;Barcelona;13;Barcelonès;08101;Hospitalet de Llobregat, l';1;2;B;;634;149;291;364;270;2;12;350;362
8;Barcelona;13;Barcelonès;08101;Hospitalet de Llobregat, l';1;20;A;;577;126;255;333;244;1;9;323;332
8;Barcelona;13;Barcelonès;08101;Hospitalet de Llobregat, l';1;20;B;;686;163;348;424;262;1;12;411;423
8;Barcelona;13;Barcelonès;08101;Hospitalet de Llobregat, l';1;21;U;;558;138;241;288;270;0;2;286;288
8;Barcelona;13;Barcelonès;08101;Hospitalet de Llobregat, l';1;22;U;;581;157;265;317;264;0;13;304;317
8;Barcelona;13;Barcelonès;08101;Hospitalet de Llobregat, l';1;23;U;;955;226;467;587;368;3;26;558;584
8;Barcelona;13;Barcelonès;08101;Hospitalet de Llobregat, l';1;24;U;;592;177;322;414;178;2;14;398;412
8;Barcelona;13;Barcelonès;08101;Hospitalet de Llobregat, l';1;25;A;;499;113;205;263;236;2;10;251;261
8;Barcelona;13;Barcelonès;08101;Hospitalet de Llobregat, l';1;25;B;;559;140;226;289;270;1;6;282;288
8;Barcelona;13;Barcelonès;08101;Hospitalet de Llobregat, l';1;26;U;;743;204;390;453;290;0;8;445;453
8;Barcelona;13;Barcelonès;08101;Hospitalet de Llobregat, l';1;27;U;;593;149;267;335;258;0;18;317;335
8;Barcelona;13;Barcelonès;08101;Hospitalet de Llobregat, l';1;28;U;;727;171;336;423;304;7;13;403;416
8;Barcelona;13;Barcelonès;08101;Hospitalet de Llobregat, l';1;29;U;;790;184;310;395;395;1;12;382;394
8;Barcelona;13;Barcelonès;08101;Hospitalet de Llobregat, l';1;3;U;;558;127;256;334;224;3;9;322;331
8;Barcelona;13;Barcelonès;08101;Hospitalet de Llobregat, l';1;30;U;;779;218;404;495;284;4;9;482;491
8;Barcelona;13;Barcelonès;08101;Hospitalet de Llobregat, l';1;31;A;;453;110;207;267;186;1;10;256;266
8;Barcelona;13;Barcelonès;08101;Hospitalet de Llobregat, l';1;31;B;;582;141;268;333;249;0;7;326;333
8;Barcelona;13;Barcelonès;08101;Hospitalet de Llobregat, l';1;32;A;;729;116;275;353;376;2;12;339;351
8;Barcelona;13;Barcelonès;08101;Hospitalet de Llobregat, l';1;32;B;;832;832;832;416;416;3;11;402;413
8;Barcelona;13;Barcelonès;08101;Hospitalet de Llobregat, l';1;33;U;;659;170;343;428;231;8;14;406;420
8;Barcelona;13;Barcelonès;08101;Hospitalet de Llobregat, l';1;34;U;;958;223;438;550;408;4;25;521;546
8;Barcelona;13;Barcelonès;08101;Hospitalet de Llobregat, l';1;35;A;;531;133;230;309;222;0;13;296;309
8;Barcelona;13;Barcelonès;08101;Hospitalet de Llobregat, l';1;35;B;;617;145;238;320;297;1;16;303;319
8;Barcelona;13;Barcelonès;08101;Hospitalet de Llobregat, l';1;36;U;;890;247;468;572;318;11;21;540;561
8;Barcelona;13;Barcelonès;08101;Hospitalet de Llobregat, l';1;37;A;;442;97;211;261;181;0;9;252;261
8;Barcelona;13;Barcelonès;08101;Hospitalet de Llobregat, l';1;37;B;;576;133;275;355;221;2;16;337;353
8;Barcelona;13;Barcelonès;08101;Hospitalet de Llobregat, l';1;38;U;;609;133;290;372;237;7;19;346;365
8;Barcelona;13;Barcelonès;08101;Hospitalet de Llobregat, l';1;39;U;;626;163;278;351;275;1;16;334;350
8;Barcelona;13;Barcelonès;08101;Hospitalet de Llobregat, l';1;4;U;;661;182;367;454;207;4;27;423;450
8;Barcelona;13;Barcelonès;08101;Hospitalet de Llobregat, l';1;40;U;;632;173;269;320;312;2;6;312;318
8;Barcelona;13;Barcelonès;08101;Hospitalet de Llobregat, l';1;5;U;;909;250;452;563;346;4;26;533;559
8;Barcelona;13;Barcelonès;08101;Hospitalet de Llobregat, l';1;6;A;;635;146;275;366;269;4;10;352;362
8;Barcelona;13;Barcelonès;08101;Hospitalet de Llobregat, l';1;6;B;;730;172;322;427;303;8;13;406;419
8;Barcelona;13;Barcelonès;08101;Hospitalet de Llobregat, l';1;7;A;;565;133;240;304;261;2;10;292;302
8;Barcelona;13;Barcelonès;08101;Hospitalet de Llobregat, l';1;7;B;;618;136;284;342;276;1;17;324;341
8;Barcelona;13;Barcelonès;08101;Hospitalet de Llobregat, l';1;8;A;;469;118;231;295;174;1;11;283;294
8;Barcelona;13;Barcelonès;08101;Hospitalet de Llobregat, l';1;8;B;;599;167;300;358;241;2;16;340;356
8;Barcelona;13;Barcelonès;08101;Hospitalet de Llobregat, l';1;9;U;;858;219;424;548;310;3;15;530;545
8;Barcelona;13;Barcelonès;08101;Hospitalet de Llobregat, l';2;1;U;;610;173;298;368;242;3;8;357;365
8;Barcelona;13;Barcelonès;08101;Hospitalet de Llobregat, l';2;10;U;;638;172;317;374;264;3;7;364;371
8;Barcelona;13;Barcelonès;08101;Hospitalet de Llobregat, l';2;11;U;;728;189;290;345;383;3;7;335;342
8;Barcelona;13;Barcelonès;08101;Hospitalet de Llobregat, l';2;12;U;;778;172;335;397;381;2;10;385;395
8;Barcelona;13;Barcelonès;08101;Hospitalet de Llobregat, l';2;13;U;;576;131;261;315;261;0;9;306;315
8;Barcelona;13;Barcelonès;08101;Hospitalet de Llobregat, l';2;14;U;;426;90;194;220;206;0;9;211;220
8;Barcelona;13;Barcelonès;08101;Hospitalet de Llobregat, l';2;15;U;;590;160;288;340;250;1;6;333;339
8;Barcelona;13;Barcelonès;08101;Hospitalet de Llobregat, l';2;16;U;;768;186;323;388;380;0;9;379;388
8;Barcelona;13;Barcelonès;08101;Hospitalet de Llobregat, l';2;17;U;;357;89;150;173;184;0;8;165;173
8;Barcelona;13;Barcelonès;08101;Hospitalet de Llobregat, l';2;18;U;;418;101;213;242;176;1;3;238;241
8;Barcelona;13;Barcelonès;08101;Hospitalet de Llobregat, l';2;19;U;;724;190;356;424;300;4;14;406;420
8;Barcelona;13;Barcelonès;08101;Hospitalet de Llobregat, l';2;2;U;;461;134;202;237;224;0;5;232;237
8;Barcelona;13;Barcelonès;08101;Hospitalet de Llobregat, l';2;20;U;;472;114;194;242;230;1;10;231;241
8;Barcelona;13;Barcelonès;08101;Hospitalet de Llobregat, l';2;21;U;;666;158;274;330;336;1;7;322;329
8;Barcelona;13;Barcelonès;08101;Hospitalet de Llobregat, l';2;22;U;;479;114;207;243;236;2;0;241;241
8;Barcelona;13;Barcelonès;08101;Hospitalet de Llobregat, l';2;23;U;;675;172;328;382;293;1;10;371;381
8;Barcelona;13;Barcelonès;08101;Hospitalet de Llobregat, l';2;24;U;;366;61;139;180;186;1;9;170;179
8;Barcelona;13;Barcelonès;08101;Hospitalet de Llobregat, l';2;25;U;;311;66;113;145;166;3;2;140;142
8;Barcelona;13;Barcelonès;08101;Hospitalet de Llobregat, l';2;26;U;;714;140;321;388;326;1;19;368;387
8;Barcelona;13;Barcelonès;08101;Hospitalet de Llobregat, l';2;27;U;;411;134;212;261;150;5;5;251;256
8;Barcelona;13;Barcelonès;08101;Hospitalet de Llobregat, l';2;28;U;;384;95;156;183;201;3;5;175;180
8;Barcelona;13;Barcelonès;08101;Hospitalet de Llobregat, l';2;29;U;;446;123;207;244;202;3;4;237;241
8;Barcelona;13;Barcelonès;08101;Hospitalet de Llobregat, l';2;3;U;;450;92;162;205;245;0;6;199;205
8;Barcelona;13;Barcelonès;08101;Hospitalet de Llobregat, l';2;30;U;;414;76;148;188;226;2;2;184;186
8;Barcelona;13;Barcelonès;08101;Hospitalet de Llobregat, l';2;31;U;;653;147;287;353;300;4;8;341;349
8;Barcelona;13;Barcelonès;08101;Hospitalet de Llobregat, l';2;32;U;;624;167;310;356;268;4;16;336;352
8;Barcelona;13;Barcelonès;08101;Hospitalet de Llobregat, l';2;33;U;;514;115;227;264;250;5;12;247;259
8;Barcelona;13;Barcelonès;08101;Hospitalet de Llobregat, l';2;34;U;;571;153;255;306;265;2;7;297;304
8;Barcelona;13;Barcelonès;08101;Hospitalet de Llobregat, l';2;35;U;;778;211;317;392;386;5;10;377;387
8;Barcelona;13;Barcelonès;08101;Hospitalet de Llobregat, l';2;36;U;;645;196;307;363;282;1;14;348;362
8;Barcelona;13;Barcelonès;08101;Hospitalet de Llobregat, l';2;37;U;;770;193;331;402;368;3;11;388;399
8;Barcelona;13;Barcelonès;08101;Hospitalet de Llobregat, l';2;38;U;;536;150;231;299;237;4;8;287;295
8;Barcelona;13;Barcelonès;08101;Hospitalet de Llobregat, l';2;39;U;;738;192;329;398;340;1;10;387;397
8;Barcelona;13;Barcelonès;08101;Hospitalet de Llobregat, l';2;4;U;;319;77;138;170;149;0;7;163;170
8;Barcelona;13;Barcelonès;08101;Hospitalet de Llobregat, l';2;40;U;;444;108;202;246;198;2;4;240;244
8;Barcelona;13;Barcelonès;08101;Hospitalet de Llobregat, l';2;41;U;;464;109;199;258;206;2;9;247;256
8;Barcelona;13;Barcelonès;08101;Hospitalet de Llobregat, l';2;42;U;;687;179;337;386;301;4;9;373;382
8;Barcelona;13;Barcelonès;08101;Hospitalet de Llobregat, l';2;43;A;;461;120;200;243;218;2;10;231;241
8;Barcelona;13;Barcelonès;08101;Hospitalet de Llobregat, l';2;43;B;;512;139;228;281;231;0;5;276;281
8;Barcelona;13;Barcelonès;08101;Hospitalet de Llobregat, l';2;44;U;;435;105;201;237;198;3;3;231;234
8;Barcelona;13;Barcelonès;08101;Hospitalet de Llobregat, l';2;45;U;;608;152;284;334;274;0;11;323;334
8;Barcelona;13;Barcelonès;08101;Hospitalet de Llobregat, l';2;46;U;;644;160;268;324;320;0;6;318;324
8;Barcelona;13;Barcelonès;08101;Hospitalet de Llobregat, l';2;47;U;;706;158;305;375;331;3;9;363;372
8;Barcelona;13;Barcelonès;08101;Hospitalet de Llobregat, l';2;48;U;;683;183;333;406;277;7;4;395;399
8;Barcelona;13;Barcelonès;08101;Hospitalet de Llobregat, l';2;49;U;;636;158;282;339;297;2;7;330;337
8;Barcelona;13;Barcelonès;08101;Hospitalet de Llobregat, l';2;5;U;;685;165;305;366;319;0;10;356;366
8;Barcelona;13;Barcelonès;08101;Hospitalet de Llobregat, l';2;6;U;;567;175;278;334;233;4;9;321;330
8;Barcelona;13;Barcelonès;08101;Hospitalet de Llobregat, l';2;7;U;;465;120;211;249;216;1;7;241;248
8;Barcelona;13;Barcelonès;08101;Hospitalet de Llobregat, l';2;8;A;;619;163;288;344;275;3;13;328;341
8;Barcelona;13;Barcelonès;08101;Hospitalet de Llobregat, l';2;8;B;;723;182;342;424;299;5;12;407;419
8;Barcelona;13;Barcelonès;08101;Hospitalet de Llobregat, l';2;9;U;;656;164;342;414;242;3;10;401;411
8;Barcelona;13;Barcelonès;08101;Hospitalet de Llobregat, l';3;1;A;;822;200;373;462;360;1;12;449;461
8;Barcelona;13;Barcelonès;08101;Hospitalet de Llobregat, l';3;1;B;;973;239;420;515;458;0;15;500;515
8;Barcelona;13;Barcelonès;08101;Hospitalet de Llobregat, l';3;10;U;;657;146;306;366;291;0;10;356;366
8;Barcelona;13;Barcelonès;08101;Hospitalet de Llobregat, l';3;11;U;;907;196;373;445;462;1;10;434;444
8;Barcelona;13;Barcelonès;08101;Hospitalet de Llobregat, l';3;12;A;;542;161;287;329;213;1;8;320;328
8;Barcelona;13;Barcelonès;08101;Hospitalet de Llobregat, l';3;12;B;;529;117;246;299;230;5;8;286;294
8;Barcelona;13;Barcelonès;08101;Hospitalet de Llobregat, l';3;13;A;;671;157;300;381;290;0;13;368;381
8;Barcelona;13;Barcelonès;08101;Hospitalet de Llobregat, l';3;13;B;;734;158;330;409;325;0;13;396;409
8;Barcelona;13;Barcelonès;08101;Hospitalet de Llobregat, l';3;14;A;;793;151;330;437;356;1;14;422;436
8;Barcelona;13;Barcelonès;08101;Hospitalet de Llobregat, l';3;14;B;;935;214;405;526;409;3;6;517;523
8;Barcelona;13;Barcelonès;08101;Hospitalet de Llobregat, l';3;15;A;;559;110;238;303;256;5;7;291;298
8;Barcelona;13;Barcelonès;08101;Hospitalet de Llobregat, l';3;15;B;;602;117;244;292;310;1;8;283;291
8;Barcelona;13;Barcelonès;08101;Hospitalet de Llobregat, l';3;16;A;;782;172;406;489;293;0;0;489;489
8;Barcelona;13;Barcelonès;08101;Hospitalet de Llobregat, l';3;16;B;;933;225;465;613;320;1;27;585;612
8;Barcelona;13;Barcelonès;08101;Hospitalet de Llobregat, l';3;17;U;;555;129;221;272;283;1;10;261;271
8;Barcelona;13;Barcelonès;08101;Hospitalet de Llobregat, l';3;18;U;;631;141;300;393;238;4;12;377;389
8;Barcelona;13;Barcelonès;08101;Hospitalet de Llobregat, l';3;19;A;;513;125;233;300;213;3;14;283;297
8;Barcelona;13;Barcelonès;08101;Hospitalet de Llobregat, l';3;19;B;;585;165;311;377;208;2;15;360;375
8;Barcelona;13;Barcelonès;08101;Hospitalet de Llobregat, l';3;2;A;;435;110;181;218;217;0;4;214;218
8;Barcelona;13;Barcelonès;08101;Hospitalet de Llobregat, l';3;2;B;;561;107;233;299;262;1;7;291;298
8;Barcelona;13;Barcelonès;08101;Hospitalet de Llobregat, l';3;20;U;;708;212;339;420;288;1;11;408;419
8;Barcelona;13;Barcelonès;08101;Hospitalet de Llobregat, l';3;21;A;;837;237;450;569;268;1;19;549;568
8;Barcelona;13;Barcelonès;08101;Hospitalet de Llobregat, l';3;21;B;;913;243;462;604;309;4;20;580;600
8;Barcelona;13;Barcelonès;08101;Hospitalet de Llobregat, l';3;22;U;;852;227;417;480;372;4;13;463;476
8;Barcelona;13;Barcelonès;08101;Hospitalet de Llobregat, l';3;23;A;;634;145;274;356;278;1;19;336;355
8;Barcelona;13;Barcelonès;08101;Hospitalet de Llobregat, l';3;23;B;;811;205;392;485;326;1;21;463;484
8;Barcelona;13;Barcelonès;08101;Hospitalet de Llobregat, l';3;23;C;;737;159;326;394;343;1;8;385;393
8;Barcelona;13;Barcelonès;08101;Hospitalet de Llobregat, l';3;24;U;;659;176;292;370;289;0;9;361;370
8;Barcelona;13;Barcelonès;08101;Hospitalet de Llobregat, l';3;25;A;;663;175;425;441;222;0;9;432;441
8;Barcelona;13;Barcelonès;08101;Hospitalet de Llobregat, l';3;25;B;;730;227;411;479;251;5;16;458;474
8;Barcelona;13;Barcelonès;08101;Hospitalet de Llobregat, l';3;3;A;;541;150;261;305;236;3;8;294;302
8;Barcelona;13;Barcelonès;08101;Hospitalet de Llobregat, l';3;3;B;;599;160;273;326;273;0;10;316;326
8;Barcelona;13;Barcelonès;08101;Hospitalet de Llobregat, l';3;4;A;;580;148;281;337;243;0;11;326;337
8;Barcelona;13;Barcelonès;08101;Hospitalet de Llobregat, l';3;4;B;;653;168;313;376;277;0;15;361;376
8;Barcelona;13;Barcelonès;08101;Hospitalet de Llobregat, l';3;5;A;;565;149;285;356;209;4;10;342;352
8;Barcelona;13;Barcelonès;08101;Hospitalet de Llobregat, l';3;5;B;;560;153;305;363;197;1;14;348;362
8;Barcelona;13;Barcelonès;08101;Hospitalet de Llobregat, l';3;6;A;;488;140;257;314;174;2;9;303;312
8;Barcelona;13;Barcelonès;08101;Hospitalet de Llobregat, l';3;6;B;;563;154;250;330;233;3;8;319;327
8;Barcelona;13;Barcelonès;08101;Hospitalet de Llobregat, l';3;7;A;;545;145;271;341;204;1;11;329;340
8;Barcelona;13;Barcelonès;08101;Hospitalet de Llobregat, l';3;7;B;;597;186;355;425;172;0;15;410;425
8;Barcelona;13;Barcelonès;08101;Hospitalet de Llobregat, l';3;8;A;;674;181;359;454;220;1;20;433;453
8;Barcelona;13;Barcelonès;08101;Hospitalet de Llobregat, l';3;8;B;;810;177;400;528;282;2;17;509;526
8;Barcelona;13;Barcelonès;08101;Hospitalet de Llobregat, l';3;9;U;;693;150;325;400;293;0;13;387;400
8;Barcelona;13;Barcelonès;08101;Hospitalet de Llobregat, l';4;1;U;;778;176;364;456;322;3;9;444;453
8;Barcelona;13;Barcelonès;08101;Hospitalet de Llobregat, l';4;10;A;;519;143;235;281;238;0;9;272;281
8;Barcelona;13;Barcelonès;08101;Hospitalet de Llobregat, l';4;10;B;;581;145;258;319;262;0;0;319;319
8;Barcelona;13;Barcelonès;08101;Hospitalet de Llobregat, l';4;11;U;;710;225;350;405;305;0;10;395;405
8;Barcelona;13;Barcelonès;08101;Hospitalet de Llobregat, l';4;12;A;;494;134;217;264;230;5;7;252;259
8;Barcelona;13;Barcelonès;08101;Hospitalet de Llobregat, l';4;12;B;;603;158;278;337;266;0;9;328;337
8;Barcelona;13;Barcelonès;08101;Hospitalet de Llobregat, l';4;13;U;;338;90;146;179;159;4;3;172;175
8;Barcelona;13;Barcelonès;08101;Hospitalet de Llobregat, l';4;14;U;;549;155;250;293;256;1;12;280;292
8;Barcelona;13;Barcelonès;08101;Hospitalet de Llobregat, l';4;15;U;;380;96;146;170;210;0;3;167;170
8;Barcelona;13;Barcelonès;08101;Hospitalet de Llobregat, l';4;16;U;;454;127;208;253;201;2;12;239;251
8;Barcelona;13;Barcelonès;08101;Hospitalet de Llobregat, l';4;17;U;;341;67;149;172;169;1;2;169;171
8;Barcelona;13;Barcelonès;08101;Hospitalet de Llobregat, l';4;18;U;;755;191;338;394;361;0;8;386;394
8;Barcelona;13;Barcelonès;08101;Hospitalet de Llobregat, l';4;19;U;;438;119;169;203;235;1;2;200;202
8;Barcelona;13;Barcelonès;08101;Hospitalet de Llobregat, l';4;2;U;;540;108;216;254;286;10;6;238;244
8;Barcelona;13;Barcelonès;08101;Hospitalet de Llobregat, l';4;20;U;;780;183;355;343;437;5;3;335;338
8;Barcelona;13;Barcelonès;08101;Hospitalet de Llobregat, l';4;21;U;;724;202;338;401;323;2;7;392;399
8;Barcelona;13;Barcelonès;08101;Hospitalet de Llobregat, l';4;22;U;;608;122;217;262;346;4;7;251;258
8;Barcelona;13;Barcelonès;08101;Hospitalet de Llobregat, l';4;23;U;;577;158;270;327;250;0;5;322;327
8;Barcelona;13;Barcelonès;08101;Hospitalet de Llobregat, l';4;24;U;;350;102;170;205;145;2;3;200;203
8;Barcelona;13;Barcelonès;08101;Hospitalet de Llobregat, l';4;25;U;;626;141;277;315;311;4;6;305;311
8;Barcelona;13;Barcelonès;08101;Hospitalet de Llobregat, l';4;26;U;;534;127;213;258;276;0;2;256;258
8;Barcelona;13;Barcelonès;08101;Hospitalet de Llobregat, l';4;27;U;;437;116;200;225;212;2;5;218;223
8;Barcelona;13;Barcelonès;08101;Hospitalet de Llobregat, l';4;28;U;;283;67;117;134;149;0;5;129;134
8;Barcelona;13;Barcelonès;08101;Hospitalet de Llobregat, l';4;29;U;;409;108;181;219;190;1;6;212;218
8;Barcelona;13;Barcelonès;08101;Hospitalet de Llobregat, l';4;3;U;;794;237;405;470;324;2;7;461;468
8;Barcelona;13;Barcelonès;08101;Hospitalet de Llobregat, l';4;30;U;;509;134;192;234;275;2;7;225;232
8;Barcelona;13;Barcelonès;08101;Hospitalet de Llobregat, l';4;31;U;;755;210;333;390;365;1;4;385;389
8;Barcelona;13;Barcelonès;08101;Hospitalet de Llobregat, l';4;32;U;;783;184;347;421;362;0;8;413;421
8;Barcelona;13;Barcelonès;08101;Hospitalet de Llobregat, l';4;33;U;;507;101;161;209;298;0;2;207;209
8;Barcelona;13;Barcelonès;08101;Hospitalet de Llobregat, l';4;34;U;;371;86;138;152;219;1;4;147;151
8;Barcelona;13;Barcelonès;08101;Hospitalet de Llobregat, l';4;35;U;;556;116;194;216;340;1;2;213;215
8;Barcelona;13;Barcelonès;08101;Hospitalet de Llobregat, l';4;36;U;;394;96;139;169;225;2;3;164;167
8;Barcelona;13;Barcelonès;08101;Hospitalet de Llobregat, l';4;37;U;;475;139;223;264;211;0;9;255;264
8;Barcelona;13;Barcelonès;08101;Hospitalet de Llobregat, l';4;38;U;;495;104;192;241;254;0;8;233;241
8;Barcelona;13;Barcelonès;08101;Hospitalet de Llobregat, l';4;39;U;;509;116;190;227;282;0;4;223;227
8;Barcelona;13;Barcelonès;08101;Hospitalet de Llobregat, l';4;4;U;;780;178;345;398;382;1;7;390;397
8;Barcelona;13;Barcelonès;08101;Hospitalet de Llobregat, l';4;40;U;;662;197;301;367;295;0;5;362;367
8;Barcelona;13;Barcelonès;08101;Hospitalet de Llobregat, l';4;41;A;;688;159;312;404;284;2;21;381;402
8;Barcelona;13;Barcelonès;08101;Hospitalet de Llobregat, l';4;41;B;;789;210;377;474;315;4;23;447;470
8;Barcelona;13;Barcelonès;08101;Hospitalet de Llobregat, l';4;42;U;;370;97;162;195;175;0;8;187;195
8;Barcelona;13;Barcelonès;08101;Hospitalet de Llobregat, l';4;5;U;;517;137;209;246;271;4;2;240;242
8;Barcelona;13;Barcelonès;08101;Hospitalet de Llobregat, l';4;6;U;;823;189;351;427;396;0;7;420;427
8;Barcelona;13;Barcelonès;08101;Hospitalet de Llobregat, l';4;7;U;;574;133;218;278;296;1;3;274;277
8;Barcelona;13;Barcelonès;08101;Hospitalet de Llobregat, l';4;8;U;;514;113;195;238;276;5;5;228;233
8;Barcelona;13;Barcelonès;08101;Hospitalet de Llobregat, l';4;9;U;;401;95;161;200;201;5;8;187;195
8;Barcelona;13;Barcelonès;08101;Hospitalet de Llobregat, l';5;1;U;;828;166;356;458;370;1;18;439;457
8;Barcelona;13;Barcelonès;08101;Hospitalet de Llobregat, l';5;10;U;;650;187;298;355;295;1;7;347;354
8;Barcelona;13;Barcelonès;08101;Hospitalet de Llobregat, l';5;11;U;;394;88;145;175;219;1;3;171;174
8;Barcelona;13;Barcelonès;08101;Hospitalet de Llobregat, l';5;12;U;;515;116;222;267;248;0;8;259;267
8;Barcelona;13;Barcelonès;08101;Hospitalet de Llobregat, l';5;13;U;;431;122;195;216;215;0;7;209;216
8;Barcelona;13;Barcelonès;08101;Hospitalet de Llobregat, l';5;14;U;;459;106;192;227;232;0;6;221;227
8;Barcelona;13;Barcelonès;08101;Hospitalet de Llobregat, l';5;15;U;;341;81;131;166;175;2;1;163;164
8;Barcelona;13;Barcelonès;08101;Hospitalet de Llobregat, l';5;16;U;;356;63;110;148;208;1;3;144;147
8;Barcelona;13;Barcelonès;08101;Hospitalet de Llobregat, l';5;17;U;;640;132;260;301;339;1;4;296;300
8;Barcelona;13;Barcelonès;08101;Hospitalet de Llobregat, l';5;18;U;;681;150;284;365;316;2;11;352;363
8;Barcelona;13;Barcelonès;08101;Hospitalet de Llobregat, l';5;19;U;;329;81;122;151;178;4;4;143;147
8;Barcelona;13;Barcelonès;08101;Hospitalet de Llobregat, l';5;2;A;;506;111;209;251;255;0;5;246;251
8;Barcelona;13;Barcelonès;08101;Hospitalet de Llobregat, l';5;2;B;;566;137;354;298;268;0;4;294;298
8;Barcelona;13;Barcelonès;08101;Hospitalet de Llobregat, l';5;20;U;;572;149;238;304;268;2;14;288;302
8;Barcelona;13;Barcelonès;08101;Hospitalet de Llobregat, l';5;21;U;;805;184;386;496;309;1;25;470;495
8;Barcelona;13;Barcelonès;08101;Hospitalet de Llobregat, l';5;22;U;;412;93;154;189;223;1;4;184;188
8;Barcelona;13;Barcelonès;08101;Hospitalet de Llobregat, l';5;23;U;;889;227;387;455;434;3;12;440;452
8;Barcelona;13;Barcelonès;08101;Hospitalet de Llobregat, l';5;24;U;;690;139;258;313;377;2;4;307;311
8;Barcelona;13;Barcelonès;08101;Hospitalet de Llobregat, l';5;25;U;;550;98;204;247;303;1;10;236;246
8;Barcelona;13;Barcelonès;08101;Hospitalet de Llobregat, l';5;26;U;;395;80;125;158;237;1;4;153;157
8;Barcelona;13;Barcelonès;08101;Hospitalet de Llobregat, l';5;27;U;;548;107;170;214;334;3;1;210;211
8;Barcelona;13;Barcelonès;08101;Hospitalet de Llobregat, l';5;28;U;;668;189;316;377;291;2;15;360;375
8;Barcelona;13;Barcelonès;08101;Hospitalet de Llobregat, l';5;29;U;;711;155;287;355;356;2;13;340;353
8;Barcelona;13;Barcelonès;08101;Hospitalet de Llobregat, l';5;3;U;;634;139;290;350;284;6;16;328;344
8;Barcelona;13;Barcelonès;08101;Hospitalet de Llobregat, l';5;30;U;;840;232;407;471;369;0;9;462;471
8;Barcelona;13;Barcelonès;08101;Hospitalet de Llobregat, l';5;31;U;;555;144;236;276;279;3;11;262;273
8;Barcelona;13;Barcelonès;08101;Hospitalet de Llobregat, l';5;32;U;;770;187;351;430;340;6;2;422;424
8;Barcelona;13;Barcelonès;08101;Hospitalet de Llobregat, l';5;33;U;;501;119;218;257;244;1;1;255;256
8;Barcelona;13;Barcelonès;08101;Hospitalet de Llobregat, l';5;34;U;;579;148;280;322;257;2;6;314;320
8;Barcelona;13;Barcelonès;08101;Hospitalet de Llobregat, l';5;35;U;;784;169;358;453;331;1;11;441;452
8;Barcelona;13;Barcelonès;08101;Hospitalet de Llobregat, l';5;36;U;;566;157;277;338;228;2;10;326;336
8;Barcelona;13;Barcelonès;08101;Hospitalet de Llobregat, l';5;37;U;;777;204;370;446;331;10;6;430;436
8;Barcelona;13;Barcelonès;08101;Hospitalet de Llobregat, l';5;38;U;;816;218;399;459;357;7;2;450;452
8;Barcelona;13;Barcelonès;08101;Hospitalet de Llobregat, l';5;4;U;;832;198;354;447;385;1;10;436;446
8;Barcelona;13;Barcelonès;08101;Hospitalet de Llobregat, l';5;5;A;;435;118;215;272;163;1;3;268;271
8;Barcelona;13;Barcelonès;08101;Hospitalet de Llobregat, l';5;5;B;;526;142;254;310;216;0;10;300;310
8;Barcelona;13;Barcelonès;08101;Hospitalet de Llobregat, l';5;6;A;;681;152;316;399;282;1;12;386;398
8;Barcelona;13;Barcelonès;08101;Hospitalet de Llobregat, l';5;6;B;;714;143;306;398;316;0;18;380;398
8;Barcelona;13;Barcelonès;08101;Hospitalet de Llobregat, l';5;7;U;;602;137;271;330;272;4;8;318;326
8;Barcelona;13;Barcelonès;08101;Hospitalet de Llobregat, l';5;8;U;;369;100;170;206;163;1;2;203;205
8;Barcelona;13;Barcelonès;08101;Hospitalet de Llobregat, l';5;9;U;;416;96;183;221;195;1;3;217;220
8;Barcelona;13;Barcelonès;08101;Hospitalet de Llobregat, l';6;1;U;;935;239;430;527;408;2;22;503;525
8;Barcelona;13;Barcelonès;08101;Hospitalet de Llobregat, l';6;10;A;;424;130;196;248;176;0;6;242;248
8;Barcelona;13;Barcelonès;08101;Hospitalet de Llobregat, l';6;10;B;;452;135;212;264;188;3;7;254;261
8;Barcelona;13;Barcelonès;08101;Hospitalet de Llobregat, l';6;11;A;;595;131;256;303;292;2;8;293;301
8;Barcelona;13;Barcelonès;08101;Hospitalet de Llobregat, l';6;11;B;;641;141;271;329;312;1;17;311;328
8;Barcelona;13;Barcelonès;08101;Hospitalet de Llobregat, l';6;12;U;;745;177;345;408;337;3;9;396;405
8;Barcelona;13;Barcelonès;08101;Hospitalet de Llobregat, l';6;13;A;;410;128;205;244;166;1;12;231;243
8;Barcelona;13;Barcelonès;08101;Hospitalet de Llobregat, l';6;13;B;;487;146;244;292;195;3;10;279;289
8;Barcelona;13;Barcelonès;08101;Hospitalet de Llobregat, l';6;14;U;;720;198;317;390;330;0;15;375;390
8;Barcelona;13;Barcelonès;08101;Hospitalet de Llobregat, l';6;15;U;;612;151;290;365;247;2;3;360;363
8;Barcelona;13;Barcelonès;08101;Hospitalet de Llobregat, l';6;16;A;;608;92;225;274;334;0;6;268;274
8;Barcelona;13;Barcelonès;08101;Hospitalet de Llobregat, l';6;16;B;;793;131;272;350;443;0;8;342;350
8;Barcelona;13;Barcelonès;08101;Hospitalet de Llobregat, l';6;16;C;;588;137;220;288;300;2;10;276;286
8;Barcelona;13;Barcelonès;08101;Hospitalet de Llobregat, l';6;17;U;;748;162;310;388;360;4;12;372;384
8;Barcelona;13;Barcelonès;08101;Hospitalet de Llobregat, l';6;18;U;;429;135;221;275;154;2;12;261;273
8;Barcelona;13;Barcelonès;08101;Hospitalet de Llobregat, l';6;19;A;;455;113;223;272;183;0;9;263;272
8;Barcelona;13;Barcelonès;08101;Hospitalet de Llobregat, l';6;19;B;;524;141;257;311;213;1;15;295;310
8;Barcelona;13;Barcelonès;08101;Hospitalet de Llobregat, l';6;2;U;;421;84;168;228;193;0;3;225;228
8;Barcelona;13;Barcelonès;08101;Hospitalet de Llobregat, l';6;20;U;;463;137;254;311;152;0;8;303;311
8;Barcelona;13;Barcelonès;08101;Hospitalet de Llobregat, l';6;21;A;;520;152;250;312;208;0;8;304;312
8;Barcelona;13;Barcelonès;08101;Hospitalet de Llobregat, l';6;21;B;;548;152;249;311;237;2;8;301;309
8;Barcelona;13;Barcelonès;08101;Hospitalet de Llobregat, l';6;22;U;;656;127;269;332;324;1;6;325;331
8;Barcelona;13;Barcelonès;08101;Hospitalet de Llobregat, l';6;23;A;;504;91;234;304;200;1;6;297;303
8;Barcelona;13;Barcelonès;08101;Hospitalet de Llobregat, l';6;23;B;;554;150;265;325;229;1;9;315;324
8;Barcelona;13;Barcelonès;08101;Hospitalet de Llobregat, l';6;24;U;;820;175;337;436;384;1;8;427;435
8;Barcelona;13;Barcelonès;08101;Hospitalet de Llobregat, l';6;25;A;;482;136;248;308;174;2;5;301;306
8;Barcelona;13;Barcelonès;08101;Hospitalet de Llobregat, l';6;25;B;;513;136;244;316;197;1;11;304;315
8;Barcelona;13;Barcelonès;08101;Hospitalet de Llobregat, l';6;26;U;;734;175;313;372;362;0;5;367;372
8;Barcelona;13;Barcelonès;08101;Hospitalet de Llobregat, l';6;27;U;;816;185;407;485;331;1;9;475;484
8;Barcelona;13;Barcelonès;08101;Hospitalet de Llobregat, l';6;28;U;;712;163;320;412;300;2;12;398;410
8;Barcelona;13;Barcelonès;08101;Hospitalet de Llobregat, l';6;29;U;;424;80;161;217;207;0;0;217;217
8;Barcelona;13;Barcelonès;08101;Hospitalet de Llobregat, l';6;3;U;;424;71;168;212;212;0;4;208;212
8;Barcelona;13;Barcelonès;08101;Hospitalet de Llobregat, l';6;30;U;;660;149;308;392;268;0;10;382;392
8;Barcelona;13;Barcelonès;08101;Hospitalet de Llobregat, l';6;31;U;;784;185;371;469;315;1;21;447;468
8;Barcelona;13;Barcelonès;08101;Hospitalet de Llobregat, l';6;32;U;;696;167;288;334;362;1;6;327;333
8;Barcelona;13;Barcelonès;08101;Hospitalet de Llobregat, l';6;4;U;;474;102;181;240;234;2;11;227;238
8;Barcelona;13;Barcelonès;08101;Hospitalet de Llobregat, l';6;5;U;;493;150;245;319;174;0;13;306;319
8;Barcelona;13;Barcelonès;08101;Hospitalet de Llobregat, l';6;6;U;;715;138;309;352;363;0;5;347;352
8;Barcelona;13;Barcelonès;08101;Hospitalet de Llobregat, l';6;7;U;;735;180;349;412;323;9;13;390;403
8;Barcelona;13;Barcelonès;08101;Hospitalet de Llobregat, l';6;8;U;;665;155;267;333;332;0;10;323;333
8;Barcelona;13;Barcelonès;08101;Hospitalet de Llobregat, l';6;9;U;;595;160;261;334;261;3;9;322;331
8;Barcelona;6;Anoia;08162;Hostalets de Pierola, els;1;1;A;;692;184;361;455;237;7;10;438;448
8;Barcelona;6;Anoia;08162;Hostalets de Pierola, els;1;1;B;;723;204;380;467;256;1;16;450;466
8;Barcelona;6;Anoia;08162;Hostalets de Pierola, els;1;1;C;;498;124;212;264;234;1;3;260;263
17;Girona;34;Selva;17083;Hostalric;1;1;U;;829;228;433;515;314;4;19;492;511
17;Girona;34;Selva;17083;Hostalric;1;2;A;;577;97;256;332;245;4;12;316;328
17;Girona;34;Selva;17083;Hostalric;1;2;B;;656;114;298;381;275;6;17;358;375
17;Girona;34;Selva;17083;Hostalric;1;3;U;;809;154;340;419;390;4;18;397;415
8;Barcelona;6;Anoia;08102;Igualada;1;1;A;;514;140;243;287;227;5;7;275;282
8;Barcelona;6;Anoia;08102;Igualada;1;1;B;;659;173;296;374;285;3;14;357;371
8;Barcelona;6;Anoia;08102;Igualada;2;1;U;;513;162;304;365;148;0;14;351;365
8;Barcelona;6;Anoia;08102;Igualada;2;2;U;;876;223;452;550;326;4;21;525;546
8;Barcelona;6;Anoia;08102;Igualada;2;3;A;;641;175;361;431;210;1;13;417;430
8;Barcelona;6;Anoia;08102;Igualada;2;3;B;;645;166;342;417;228;1;8;408;416
8;Barcelona;6;Anoia;08102;Igualada;3;1;U;;885;222;415;489;396;0;11;478;489
8;Barcelona;6;Anoia;08102;Igualada;3;10;A;;512;117;264;354;158;2;7;345;352
8;Barcelona;6;Anoia;08102;Igualada;3;10;B;;601;147;318;404;197;2;8;394;402
8;Barcelona;6;Anoia;08102;Igualada;3;2;A;;596;141;321;389;207;0;9;380;389
8;Barcelona;6;Anoia;08102;Igualada;3;2;B;;654;195;372;454;200;2;12;440;452
8;Barcelona;6;Anoia;08102;Igualada;3;3;A;;477;142;263;304;173;0;7;297;304
8;Barcelona;6;Anoia;08102;Igualada;3;3;B;;544;166;309;350;194;3;10;337;347
8;Barcelona;6;Anoia;08102;Igualada;3;4;A;;703;171;359;422;281;1;17;404;421
8;Barcelona;6;Anoia;08102;Igualada;3;4;B;;846;205;460;535;311;1;17;517;534
8;Barcelona;6;Anoia;08102;Igualada;3;5;A;;361;101;157;183;178;0;3;180;183
8;Barcelona;6;Anoia;08102;Igualada;3;5;B;;417;120;201;230;187;0;2;228;230
8;Barcelona;6;Anoia;08102;Igualada;3;6;A;;616;134;333;423;193;1;18;404;422
8;Barcelona;6;Anoia;08102;Igualada;3;6;B;;742;181;402;521;221;4;23;494;517
8;Barcelona;6;Anoia;08102;Igualada;3;7;A;;747;175;418;519;228;5;16;498;514
8;Barcelona;6;Anoia;08102;Igualada;3;7;B;;891;218;472;614;277;5;20;589;609
8;Barcelona;6;Anoia;08102;Igualada;3;8;A;;496;67;225;308;188;0;8;300;308
8;Barcelona;6;Anoia;08102;Igualada;3;8;B;;549;107;272;360;189;0;13;347;360
8;Barcelona;6;Anoia;08102;Igualada;3;9;A;;544;136;305;380;164;3;17;360;377
8;Barcelona;6;Anoia;08102;Igualada;3;9;B;;593;141;312;388;205;3;11;374;385
8;Barcelona;6;Anoia;08102;Igualada;4;1;U;;682;195;356;427;255;1;11;415;426
8;Barcelona;6;Anoia;08102;Igualada;4;2;U;;736;208;370;472;264;1;12;459;471
8;Barcelona;6;Anoia;08102;Igualada;4;3;U;;801;260;416;528;273;1;9;518;527
8;Barcelona;6;Anoia;08102;Igualada;4;4;A;;397;118;226;272;125;2;13;257;270
8;Barcelona;6;Anoia;08102;Igualada;4;4;B;;461;117;250;294;167;0;8;286;294
8;Barcelona;6;Anoia;08102;Igualada;4;5;A;;559;158;289;353;206;0;11;342;353
8;Barcelona;6;Anoia;08102;Igualada;4;5;B;;715;189;357;447;268;2;9;436;445
8;Barcelona;6;Anoia;08102;Igualada;5;1;A;;501;177;286;337;164;2;8;327;335
8;Barcelona;6;Anoia;08102;Igualada;5;1;B;;523;166;292;352;171;2;9;341;350
8;Barcelona;6;Anoia;08102;Igualada;5;2;A;;524;158;273;331;193;1;10;320;330
8;Barcelona;6;Anoia;08102;Igualada;5;2;B;;672;193;332;400;272;3;12;385;397
8;Barcelona;6;Anoia;08102;Igualada;5;3;A;;644;181;323;406;238;3;8;395;403
8;Barcelona;6;Anoia;08102;Igualada;5;3;B;;871;231;482;581;290;7;11;563;574
8;Barcelona;6;Anoia;08102;Igualada;5;4;A;;530;139;291;344;186;0;11;333;344
8;Barcelona;6;Anoia;08102;Igualada;5;4;B;;645;165;336;432;213;1;17;414;431
8;Barcelona;6;Anoia;08102;Igualada;5;5;U;;536;109;225;262;274;2;11;249;260
8;Barcelona;6;Anoia;08102;Igualada;5;6;A;;323;81;125;148;175;2;2;144;146
8;Barcelona;6;Anoia;08102;Igualada;5;6;B;;321;80;135;156;165;0;4;152;156
8;Barcelona;6;Anoia;08102;Igualada;5;7;A;;780;203;390;491;289;1;18;472;490
8;Barcelona;6;Anoia;08102;Igualada;5;7;B;;992;243;490;632;360;2;23;607;630
25;Lleida;25;Pallars Jussà;25115;Isona i Conca Dellà;1;1;A;;581;142;302;387;194;2;18;367;385
25;Lleida;25;Pallars Jussà;25115;Isona i Conca Dellà;1;1;B;;313;53;143;183;130;3;7;173;180
17;Girona;15;Cerdanya;17084;Isòvol;1;1;U;;256;75;131;188;68;2;5;181;186
25;Lleida;27;Pla d'Urgell;25113;Ivars d'Urgell;1;1;U;;565;163;322;426;139;3;24;399;423
25;Lleida;27;Pla d'Urgell;25113;Ivars d'Urgell;1;2;A;;483;133;291;334;149;3;11;320;331
25;Lleida;27;Pla d'Urgell;25113;Ivars d'Urgell;1;2;B;;196;55;122;152;44;2;12;138;150
25;Lleida;23;Noguera;25112;Ivars de Noguera;1;1;U;;295;80;167;211;84;2;5;204;209
25;Lleida;32;Segarra;25114;Ivorra;1;1;U;;102;45;64;84;18;0;4;80;84
17;Girona;10;Baix Empordà;17085;Jafre;1;1;U;;290;117;196;231;59;7;11;213;224
17;Girona;2;Alt Empordà;17086;Jonquera, la;1;1;A;;349;99;184;230;119;2;7;221;228
17;Girona;2;Alt Empordà;17086;Jonquera, la;1;1;B;;330;102;163;188;142;0;5;183;188
17;Girona;2;Alt Empordà;17086;Jonquera, la;1;1;C;;340;89;164;194;146;3;5;186;191
17;Girona;2;Alt Empordà;17086;Jonquera, la;1;2;A;;323;87;151;182;141;1;3;178;181
17;Girona;2;Alt Empordà;17086;Jonquera, la;1;2;B;;313;77;152;190;123;0;2;188;190
8;Barcelona;6;Anoia;08103;Jorba;1;1;U;;638;160;359;426;212;4;9;413;422
25;Lleida;4;Alt Urgell;25910;Josa i Tuixén;1;1;U;;119;26;48;84;35;0;2;82;84
17;Girona;20;Gironès;17087;Juià;1;1;U;;219;83;137;155;64;2;4;149;153
25;Lleida;18;Garrigues;25118;Juncosa;1;1;U;;388;149;216;247;141;5;6;236;242
25;Lleida;18;Garrigues;25119;Juneda;1;1;A;;670;133;321;440;230;7;11;422;433
25;Lleida;18;Garrigues;25119;Juneda;1;1;B;;676;127;323;461;215;5;22;434;456
25;Lleida;18;Garrigues;25119;Juneda;1;2;A;;506;101;269;366;140;3;12;351;363
25;Lleida;18;Garrigues;25119;Juneda;1;2;B;;479;83;264;346;133;2;8;336;344
25;Lleida;39;Consell General d'Aran;25121;Les;1;1;U;;616;130;281;387;229;0;17;370;387
25;Lleida;27;Pla d'Urgell;25122;Linyola;1;1;A;;425;97;205;259;166;1;10;248;258
25;Lleida;27;Pla d'Urgell;25122;Linyola;1;1;B;;495;102;247;318;177;3;16;299;315
25;Lleida;27;Pla d'Urgell;25122;Linyola;1;2;A;;440;91;223;279;161;2;20;257;277
25;Lleida;27;Pla d'Urgell;25122;Linyola;1;2;B;;610;127;303;411;199;3;22;386;408
8;Barcelona;6;Anoia;08104;Llacuna, la;1;1;U;;724;202;400;488;236;3;6;479;485
17;Girona;2;Alt Empordà;17088;Lladó;1;1;U;;539;144;309;355;184;1;10;344;354
25;Lleida;26;Pallars Sobirà;25123;Lladorre;1;1;U;;200;40;88;126;74;2;5;119;124
25;Lleida;35;Solsonès;25124;Lladurs;1;1;U;;170;34;79;126;44;2;3;121;124
8;Barcelona;41;Vallès Oriental;08105;Llagosta, la;1;1;A;;495;100;197;244;251;0;7;237;244
8;Barcelona;41;Vallès Oriental;08105;Llagosta, la;1;1;B;;659;152;280;341;318;1;5;335;340
8;Barcelona;41;Vallès Oriental;08105;Llagosta, la;1;2;A;;568;143;270;322;246;2;9;311;320
8;Barcelona;41;Vallès Oriental;08105;Llagosta, la;1;2;B;;729;165;321;391;338;3;13;375;388
8;Barcelona;41;Vallès Oriental;08105;Llagosta, la;1;3;A;;468;97;209;256;212;2;13;241;254
8;Barcelona;41;Vallès Oriental;08105;Llagosta, la;1;3;B;;594;132;286;334;260;5;10;319;329
8;Barcelona;41;Vallès Oriental;08105;Llagosta, la;1;4;A;;532;122;255;298;234;0;5;293;298
8;Barcelona;41;Vallès Oriental;08105;Llagosta, la;1;4;B;;576;146;282;342;234;1;8;333;341
8;Barcelona;41;Vallès Oriental;08105;Llagosta, la;1;5;A;;528;126;222;261;267;3;10;248;258
8;Barcelona;41;Vallès Oriental;08105;Llagosta, la;1;5;B;;572;120;224;278;294;4;9;265;274
8;Barcelona;41;Vallès Oriental;08105;Llagosta, la;1;6;A;;438;107;192;224;214;1;9;214;223
8;Barcelona;41;Vallès Oriental;08105;Llagosta, la;1;6;B;;493;137;229;269;224;0;8;261;269
8;Barcelona;41;Vallès Oriental;08105;Llagosta, la;1;7;A;;480;136;239;264;216;0;3;261;264
8;Barcelona;41;Vallès Oriental;08105;Llagosta, la;1;7;B;;521;143;225;257;264;1;9;247;256
8;Barcelona;41;Vallès Oriental;08105;Llagosta, la;1;8;A;;357;82;162;198;159;1;3;194;197
8;Barcelona;41;Vallès Oriental;08105;Llagosta, la;1;8;B;;504;123;241;298;206;3;11;284;295
8;Barcelona;41;Vallès Oriental;08105;Llagosta, la;1;9;A;;527;137;255;317;210;2;13;302;315
8;Barcelona;41;Vallès Oriental;08105;Llagosta, la;1;9;B;;616;150;297;359;257;1;16;342;358
17;Girona;20;Gironès;17089;Llagostera;1;1;A;;626;159;289;352;274;3;12;337;349
17;Girona;20;Gironès;17089;Llagostera;1;1;B;;643;132;271;351;292;4;10;337;347
17;Girona;20;Gironès;17089;Llagostera;1;2;A;;576;141;296;361;215;2;7;352;359
17;Girona;20;Gironès;17089;Llagostera;1;2;B;;650;180;314;385;265;2;2;381;383
17;Girona;20;Gironès;17089;Llagostera;1;3;A;;561;140;256;309;252;2;6;301;307
17;Girona;20;Gironès;17089;Llagostera;1;3;B;;539;137;253;300;239;3;6;291;297
17;Girona;20;Gironès;17089;Llagostera;1;3;C;;622;173;298;347;275;2;8;337;345
17;Girona;20;Gironès;17089;Llagostera;1;4;A;;698;182;343;416;282;4;19;393;412
17;Girona;20;Gironès;17089;Llagostera;1;4;B;;509;141;285;340;169;6;14;320;334
17;Girona;20;Gironès;17090;Llambilles;1;1;U;;536;141;343;394;142;4;11;379;390
17;Girona;31;Ripollès;17091;Llanars;1;1;U;;441;123;249;301;140;7;7;287;294
17;Girona;2;Alt Empordà;17092;Llançà;1;1;A;;540;164;283;324;216;7;4;313;317
17;Girona;2;Alt Empordà;17092;Llançà;1;1;B;;537;168;262;310;227;5;5;300;305
17;Girona;2;Alt Empordà;17092;Llançà;1;2;A;;382;102;194;240;142;5;6;229;235
17;Girona;2;Alt Empordà;17092;Llançà;1;2;B;;440;93;201;252;188;4;3;245;248
17;Girona;2;Alt Empordà;17092;Llançà;1;2;C;;453;131;227;275;178;3;10;262;272
17;Girona;2;Alt Empordà;17092;Llançà;1;2;D;;365;89;178;215;150;8;7;200;207
17;Girona;2;Alt Empordà;17092;Llançà;1;3;A;;411;101;199;237;174;5;4;228;232
17;Girona;2;Alt Empordà;17092;Llançà;1;3;B;;414;112;196;240;174;5;4;231;235
25;Lleida;33;Segrià;25125;Llardecans;1;1;U;;456;111;225;291;165;2;18;271;289
25;Lleida;26;Pallars Sobirà;25126;Llavorsí;1;1;U;;286;56;143;189;97;4;6;179;185
25;Lleida;33;Segrià;25120;Lleida;1;1;A;;634;177;310;402;232;5;25;372;397
25;Lleida;33;Segrià;25120;Lleida;1;1;B;;775;213;402;502;273;4;32;466;498
25;Lleida;33;Segrià;25120;Lleida;1;10;A;;544;119;223;263;281;1;7;255;262
25;Lleida;33;Segrià;25120;Lleida;1;10;B;;672;147;280;333;339;2;7;324;331
25;Lleida;33;Segrià;25120;Lleida;1;11;A;;513;130;223;288;225;2;8;278;286
25;Lleida;33;Segrià;25120;Lleida;1;11;B;;575;116;241;308;267;2;8;298;306
25;Lleida;33;Segrià;25120;Lleida;1;12;U;;703;154;288;352;351;5;9;338;347
25;Lleida;33;Segrià;25120;Lleida;1;13;A;;645;149;305;380;265;1;12;367;379
25;Lleida;33;Segrià;25120;Lleida;1;13;B;;679;156;322;397;282;2;19;376;395
25;Lleida;33;Segrià;25120;Lleida;1;14;A;;589;130;258;325;264;3;19;303;322
25;Lleida;33;Segrià;25120;Lleida;1;14;B;;620;143;262;338;282;0;19;319;338
25;Lleida;33;Segrià;25120;Lleida;1;3;A;;524;136;244;324;200;4;15;305;320
25;Lleida;33;Segrià;25120;Lleida;1;3;B;;564;133;253;339;225;3;10;326;336
25;Lleida;33;Segrià;25120;Lleida;1;4;A;;919;196;402;523;396;4;23;496;519
25;Lleida;33;Segrià;25120;Lleida;1;4;B;;1051;252;514;663;388;7;24;632;656
25;Lleida;33;Segrià;25120;Lleida;1;5;A;;585;117;227;291;294;3;7;281;288
25;Lleida;33;Segrià;25120;Lleida;1;5;B;;891;193;382;455;436;0;12;443;455
25;Lleida;33;Segrià;25120;Lleida;1;6;A;;480;105;215;256;224;2;13;241;254
25;Lleida;33;Segrià;25120;Lleida;1;6;B;;625;119;279;342;283;1;10;331;341
25;Lleida;33;Segrià;25120;Lleida;1;7;A;;896;195;394;504;392;4;18;482;500
25;Lleida;33;Segrià;25120;Lleida;1;7;B;;1011;223;419;545;466;5;23;517;540
25;Lleida;33;Segrià;25120;Lleida;1;8;A;;785;151;333;449;336;1;22;426;448
25;Lleida;33;Segrià;25120;Lleida;1;8;B;;902;204;397;543;359;3;21;519;540
25;Lleida;33;Segrià;25120;Lleida;1;9;A;;392;90;183;230;162;2;9;219;228
25;Lleida;33;Segrià;25120;Lleida;1;9;B;;427;111;204;252;175;1;7;244;251
25;Lleida;33;Segrià;25120;Lleida;2;2;A;;505;133;232;301;204;0;10;291;301
25;Lleida;33;Segrià;25120;Lleida;2;2;B;;611;155;286;350;261;2;18;330;348
25;Lleida;33;Segrià;25120;Lleida;2;3;U;;869;222;409;536;333;4;18;514;532
25;Lleida;33;Segrià;25120;Lleida;2;4;A;;835;189;377;480;355;3;35;442;477
25;Lleida;33;Segrià;25120;Lleida;2;4;B;;851;217;401;506;345;4;21;481;502
25;Lleida;33;Segrià;25120;Lleida;2;5;A;;644;159;302;410;234;4;20;386;406
25;Lleida;33;Segrià;25120;Lleida;2;5;B;;854;179;411;545;309;4;28;513;541
25;Lleida;33;Segrià;25120;Lleida;2;6;A;;416;101;192;240;176;6;12;222;234
25;Lleida;33;Segrià;25120;Lleida;2;6;B;;476;105;223;279;197;1;13;265;278
25;Lleida;33;Segrià;25120;Lleida;2;7;A;;754;174;328;431;323;3;15;413;428
25;Lleida;33;Segrià;25120;Lleida;2;7;B;;734;176;321;433;301;4;15;414;429
25;Lleida;33;Segrià;25120;Lleida;2;8;A;;445;122;205;257;188;0;9;248;257
25;Lleida;33;Segrià;25120;Lleida;2;8;B;;566;134;266;331;235;0;15;316;331
25;Lleida;33;Segrià;25120;Lleida;2;9;A;;491;113;243;317;174;3;12;302;314
25;Lleida;33;Segrià;25120;Lleida;2;9;B;;604;134;292;396;208;5;16;375;391
25;Lleida;33;Segrià;25120;Lleida;3;1;U;;648;155;277;348;300;3;9;336;345
25;Lleida;33;Segrià;25120;Lleida;3;3;A;;480;124;234;280;200;1;9;270;279
25;Lleida;33;Segrià;25120;Lleida;3;3;B;;515;159;263;324;191;2;6;316;322
25;Lleida;33;Segrià;25120;Lleida;3;4;A;;479;134;268;346;133;3;15;328;343
25;Lleida;33;Segrià;25120;Lleida;3;4;B;;557;180;329;413;144;4;18;391;409
25;Lleida;33;Segrià;25120;Lleida;3;5;U;;521;132;234;319;202;2;12;305;317
25;Lleida;33;Segrià;25120;Lleida;3;6;A;;510;144;262;328;182;2;19;307;326
25;Lleida;33;Segrià;25120;Lleida;3;6;B;;512;140;259;338;174;3;8;327;335
25;Lleida;33;Segrià;25120;Lleida;3;7;U;;519;120;247;311;208;7;17;287;304
25;Lleida;33;Segrià;25120;Lleida;3;8;U;;788;209;372;491;297;2;12;477;489
25;Lleida;33;Segrià;25120;Lleida;4;1;A;;496;110;174;207;289;2;1;204;205
25;Lleida;33;Segrià;25120;Lleida;4;1;B;;527;125;179;218;309;1;10;207;217
25;Lleida;33;Segrià;25120;Lleida;4;10;A;;757;87;195;242;515;1;4;237;241
25;Lleida;33;Segrià;25120;Lleida;4;10;B;;568;109;167;209;359;1;6;202;208
25;Lleida;33;Segrià;25120;Lleida;4;11;A;;474;70;137;171;303;2;0;169;169
25;Lleida;33;Segrià;25120;Lleida;4;11;B;;408;73;118;149;259;2;6;141;147
25;Lleida;33;Segrià;25120;Lleida;4;12;U;;544;74;128;145;399;1;0;144;144
25;Lleida;33;Segrià;25120;Lleida;4;13;A;;424;95;163;202;222;1;8;193;201
25;Lleida;33;Segrià;25120;Lleida;4;13;B;;472;110;187;226;246;0;10;216;226
25;Lleida;33;Segrià;25120;Lleida;4;14;U;;861;180;358;451;410;1;17;433;450
25;Lleida;33;Segrià;25120;Lleida;4;15;A;;483;103;218;270;213;0;11;259;270
25;Lleida;33;Segrià;25120;Lleida;4;15;B;;545;134;259;313;232;0;8;305;313
25;Lleida;33;Segrià;25120;Lleida;4;16;A;;495;133;246;302;193;7;3;292;295
25;Lleida;33;Segrià;25120;Lleida;4;16;B;;580;143;280;364;216;13;10;341;351
25;Lleida;33;Segrià;25120;Lleida;4;17;A;;638;152;287;362;276;4;15;343;358
25;Lleida;33;Segrià;25120;Lleida;4;17;B;;681;156;294;383;298;2;8;373;381
25;Lleida;33;Segrià;25120;Lleida;4;3;A;;679;204;362;462;217;5;23;434;457
25;Lleida;33;Segrià;25120;Lleida;4;3;B;;760;216;413;515;245;4;16;495;511
25;Lleida;33;Segrià;25120;Lleida;4;4;U;;635;176;297;372;263;6;9;357;366
25;Lleida;33;Segrià;25120;Lleida;4;5;U;;608;169;306;378;230;0;9;369;378
25;Lleida;33;Segrià;25120;Lleida;4;6;A;;520;128;263;326;194;1;14;311;325
25;Lleida;33;Segrià;25120;Lleida;4;6;B;;575;139;278;340;235;5;15;320;335
25;Lleida;33;Segrià;25120;Lleida;4;7;A;;415;100;179;236;179;1;9;226;235
25;Lleida;33;Segrià;25120;Lleida;4;7;B;;460;113;210;267;193;0;5;262;267
25;Lleida;33;Segrià;25120;Lleida;4;8;A;;384;98;167;197;187;4;10;183;193
25;Lleida;33;Segrià;25120;Lleida;4;8;B;;353;102;167;199;154;1;11;187;198
25;Lleida;33;Segrià;25120;Lleida;5;10;U;;789;231;433;556;233;2;24;530;554
25;Lleida;33;Segrià;25120;Lleida;5;11;A;;603;163;347;454;149;1;16;437;453
25;Lleida;33;Segrià;25120;Lleida;5;11;B;;641;176;364;482;159;1;25;456;481
25;Lleida;33;Segrià;25120;Lleida;5;12;U;;710;176;375;463;247;1;22;440;462
25;Lleida;33;Segrià;25120;Lleida;5;2;U;;780;129;385;483;297;8;15;460;475
25;Lleida;33;Segrià;25120;Lleida;5;3;A;;439;123;239;300;139;1;9;290;299
25;Lleida;33;Segrià;25120;Lleida;5;3;B;;469;135;219;277;192;0;8;269;277
25;Lleida;33;Segrià;25120;Lleida;5;4;A;;339;102;193;238;101;2;9;227;236
25;Lleida;33;Segrià;25120;Lleida;5;4;B;;431;135;228;294;137;0;8;286;294
25;Lleida;33;Segrià;25120;Lleida;5;5;A;;397;123;208;274;123;4;5;265;270
25;Lleida;33;Segrià;25120;Lleida;5;5;B;;481;147;273;338;143;3;12;323;335
25;Lleida;33;Segrià;25120;Lleida;5;6;A;;575;132;290;392;183;1;23;368;391
25;Lleida;33;Segrià;25120;Lleida;5;6;B;;728;191;485;501;227;8;13;480;493
25;Lleida;33;Segrià;25120;Lleida;5;7;U;;541;110;271;333;208;1;11;321;332
25;Lleida;33;Segrià;25120;Lleida;5;8;U;;916;222;448;568;348;6;12;550;562
25;Lleida;33;Segrià;25120;Lleida;5;9;U;;732;226;421;515;217;6;19;490;509
25;Lleida;33;Segrià;25120;Lleida;6;1;A;;352;65;94;119;233;0;6;113;119
25;Lleida;33;Segrià;25120;Lleida;6;1;B;;772;197;368;457;315;3;9;445;454
25;Lleida;33;Segrià;25120;Lleida;6;10;A;;489;127;246;303;186;2;7;294;301
25;Lleida;33;Segrià;25120;Lleida;6;10;B;;510;103;208;271;239;2;11;258;269
25;Lleida;33;Segrià;25120;Lleida;6;11;A;;539;147;265;324;215;2;11;311;322
25;Lleida;33;Segrià;25120;Lleida;6;11;B;;502;133;266;316;186;4;11;301;312
25;Lleida;33;Segrià;25120;Lleida;6;12;A;;535;159;283;357;178;0;15;342;357
25;Lleida;33;Segrià;25120;Lleida;6;12;B;;552;190;300;360;192;3;14;343;357
25;Lleida;33;Segrià;25120;Lleida;6;13;A;;438;113;242;313;125;0;12;301;313
25;Lleida;33;Segrià;25120;Lleida;6;13;B;;519;139;285;355;164;2;13;340;353
25;Lleida;33;Segrià;25120;Lleida;6;14;A;;886;206;457;554;332;4;21;529;550
25;Lleida;33;Segrià;25120;Lleida;6;14;B;;1038;234;465;618;420;1;27;590;617
25;Lleida;33;Segrià;25120;Lleida;6;16;U;;659;162;360;461;198;8;30;423;453
25;Lleida;33;Segrià;25120;Lleida;6;17;A;;593;130;221;291;302;1;12;278;290
25;Lleida;33;Segrià;25120;Lleida;6;17;B;;731;132;275;358;373;1;18;339;357
25;Lleida;33;Segrià;25120;Lleida;6;2;A;;583;177;290;360;223;1;9;350;359
25;Lleida;33;Segrià;25120;Lleida;6;2;B;;570;156;294;358;212;2;15;341;356
25;Lleida;33;Segrià;25120;Lleida;6;3;A;;644;167;304;380;264;0;17;363;380
25;Lleida;33;Segrià;25120;Lleida;6;3;B;;758;187;340;440;318;2;20;418;438
25;Lleida;33;Segrià;25120;Lleida;6;4;A;;688;166;344;428;260;5;20;403;423
25;Lleida;33;Segrià;25120;Lleida;6;4;B;;751;222;420;508;243;2;20;486;506
25;Lleida;33;Segrià;25120;Lleida;6;5;U;;615;189;353;398;217;3;5;390;395
25;Lleida;33;Segrià;25120;Lleida;6;6;U;;933;256;443;548;385;5;12;531;543
25;Lleida;33;Segrià;25120;Lleida;6;7;A;;602;128;267;346;256;0;9;337;346
25;Lleida;33;Segrià;25120;Lleida;6;7;B;;555;142;247;310;245;1;11;298;309
25;Lleida;33;Segrià;25120;Lleida;6;7;C;;585;146;255;330;255;2;7;321;328
25;Lleida;33;Segrià;25120;Lleida;6;9;A;;307;76;119;152;155;1;5;146;151
25;Lleida;33;Segrià;25120;Lleida;6;9;B;;360;96;165;202;158;0;5;197;202
25;Lleida;33;Segrià;25120;Lleida;7;1;A;;789;163;342;454;335;3;17;434;451
25;Lleida;33;Segrià;25120;Lleida;7;1;B;;992;209;416;553;439;2;25;526;551
25;Lleida;33;Segrià;25120;Lleida;7;2;U;;597;109;239;301;296;2;8;291;299
25;Lleida;33;Segrià;25120;Lleida;7;3;A;;615;139;289;358;257;3;12;343;355
25;Lleida;33;Segrià;25120;Lleida;7;3;B;;746;155;347;450;296;3;9;438;447
25;Lleida;33;Segrià;25120;Lleida;7;4;A;;550;107;216;263;287;0;8;255;263
25;Lleida;33;Segrià;25120;Lleida;7;4;B;;677;127;233;281;396;1;13;267;280
25;Lleida;33;Segrià;25120;Lleida;7;4;C;;592;95;212;261;331;1;7;253;260
25;Lleida;33;Segrià;25120;Lleida;7;5;A;;834;161;341;450;384;5;20;425;445
25;Lleida;33;Segrià;25120;Lleida;7;5;B;;986;192;374;519;467;5;15;499;514
25;Lleida;33;Segrià;25120;Lleida;7;6;A;;800;181;342;428;372;4;20;404;424
25;Lleida;33;Segrià;25120;Lleida;7;6;B;;809;156;356;444;365;6;21;417;438
25;Lleida;33;Segrià;25120;Lleida;7;7;A;;735;93;327;414;321;3;8;403;411
25;Lleida;33;Segrià;25120;Lleida;7;7;B;;858;162;338;428;430;2;18;408;426
25;Lleida;33;Segrià;25120;Lleida;8;1;A;;489;122;250;342;147;0;10;332;342
25;Lleida;33;Segrià;25120;Lleida;8;1;B;;793;155;364;435;358;3;11;421;432
25;Lleida;33;Segrià;25120;Lleida;8;2;A;;568;110;294;415;153;0;24;391;415
25;Lleida;33;Segrià;25120;Lleida;8;2;B;;695;164;393;499;196;0;20;479;499
25;Lleida;33;Segrià;25120;Lleida;8;2;C;;394;91;189;236;158;2;5;229;234
25;Lleida;33;Segrià;25120;Lleida;8;2;D;;272;91;177;220;52;6;8;206;214
25;Lleida;33;Segrià;25120;Lleida;8;3;A;;369;103;204;245;124;2;14;229;243
25;Lleida;33;Segrià;25120;Lleida;8;3;B;;464;95;264;318;146;6;3;309;312
25;Lleida;33;Segrià;25120;Lleida;9;1;A;;641;142;335;444;197;2;9;433;442
25;Lleida;33;Segrià;25120;Lleida;9;1;B;;864;168;189;550;314;2;23;525;548
25;Lleida;33;Segrià;25120;Lleida;9;2;A;;934;194;392;516;418;1;17;498;515
25;Lleida;33;Segrià;25120;Lleida;9;2;B;;311;104;147;180;131;3;1;176;177
17;Girona;2;Alt Empordà;17093;Llers;1;1;U;;858;219;418;536;322;1;23;512;535
25;Lleida;15;Cerdanya;25127;Lles de Cerdanya;1;1;U;;232;57;119;151;81;0;6;145;151
8;Barcelona;41;Vallès Oriental;08107;Lliçà d'Amunt;1;1;A;;644;148;304;393;251;2;19;372;391
8;Barcelona;41;Vallès Oriental;08107;Lliçà d'Amunt;1;1;B;;846;230;401;496;350;2;19;475;494
8;Barcelona;41;Vallès Oriental;08107;Lliçà d'Amunt;1;10;A;;446;107;193;240;206;0;14;226;240
8;Barcelona;41;Vallès Oriental;08107;Lliçà d'Amunt;1;10;B;;507;140;239;285;222;0;12;273;285
8;Barcelona;41;Vallès Oriental;08107;Lliçà d'Amunt;1;2;A;;430;93;186;252;178;0;7;245;252
8;Barcelona;41;Vallès Oriental;08107;Lliçà d'Amunt;1;2;B;;602;146;283;358;244;1;15;342;357
8;Barcelona;41;Vallès Oriental;08107;Lliçà d'Amunt;1;3;A;;388;76;154;209;179;1;7;201;208
8;Barcelona;41;Vallès Oriental;08107;Lliçà d'Amunt;1;3;B;;472;87;185;246;226;1;9;236;245
8;Barcelona;41;Vallès Oriental;08107;Lliçà d'Amunt;1;4;A;;649;127;237;291;358;0;3;288;291
8;Barcelona;41;Vallès Oriental;08107;Lliçà d'Amunt;1;4;B;;776;195;318;374;402;1;5;368;373
8;Barcelona;41;Vallès Oriental;08107;Lliçà d'Amunt;1;5;A;;577;130;238;293;284;0;10;283;293
8;Barcelona;41;Vallès Oriental;08107;Lliçà d'Amunt;1;5;B;;604;135;246;317;287;2;8;307;315
8;Barcelona;41;Vallès Oriental;08107;Lliçà d'Amunt;1;6;A;;409;107;175;214;195;0;5;209;214
8;Barcelona;41;Vallès Oriental;08107;Lliçà d'Amunt;1;6;B;;395;118;195;245;150;3;8;234;242
8;Barcelona;41;Vallès Oriental;08107;Lliçà d'Amunt;1;7;A;;507;125;246;309;198;0;4;305;309
8;Barcelona;41;Vallès Oriental;08107;Lliçà d'Amunt;1;7;B;;596;161;289;346;250;0;0;346;346
8;Barcelona;41;Vallès Oriental;08107;Lliçà d'Amunt;1;8;A;;462;462;462;262;200;0;2;260;262
8;Barcelona;41;Vallès Oriental;08107;Lliçà d'Amunt;1;8;B;;558;121;237;281;277;1;11;269;280
8;Barcelona;41;Vallès Oriental;08107;Lliçà d'Amunt;1;9;A;;439;100;190;232;207;2;8;222;230
8;Barcelona;41;Vallès Oriental;08107;Lliçà d'Amunt;1;9;B;;519;121;222;262;257;3;8;251;259
8;Barcelona;41;Vallès Oriental;08108;Lliçà de Vall;1;1;A;;646;153;310;382;264;1;8;373;381
8;Barcelona;41;Vallès Oriental;08108;Lliçà de Vall;1;1;B;;776;178;370;459;317;2;7;450;457
8;Barcelona;41;Vallès Oriental;08108;Lliçà de Vall;1;2;A;;663;200;361;434;229;2;4;428;432
8;Barcelona;41;Vallès Oriental;08108;Lliçà de Vall;1;2;B;;731;204;372;452;279;2;10;440;450
8;Barcelona;41;Vallès Oriental;08108;Lliçà de Vall;1;3;A;;607;171;296;369;238;4;7;358;365
8;Barcelona;41;Vallès Oriental;08108;Lliçà de Vall;1;3;B;;639;191;332;394;245;5;14;375;389
8;Barcelona;41;Vallès Oriental;08108;Lliçà de Vall;1;4;U;;853;214;442;515;338;0;9;506;515
25;Lleida;25;Pallars Jussà;25128;Llimiana;1;1;U;;152;38;58;85;67;0;3;82;85
8;Barcelona;41;Vallès Oriental;08106;Llinars del Vallès;1;1;A;;495;128;239;298;197;0;6;292;298
8;Barcelona;41;Vallès Oriental;08106;Llinars del Vallès;1;1;B;;491;127;226;271;220;0;7;264;271
8;Barcelona;41;Vallès Oriental;08106;Llinars del Vallès;1;2;A;;627;174;324;387;240;1;12;374;386
8;Barcelona;41;Vallès Oriental;08106;Llinars del Vallès;1;2;B;;716;191;347;404;312;0;9;395;404
8;Barcelona;41;Vallès Oriental;08106;Llinars del Vallès;2;1;A;;691;174;360;441;250;4;11;426;437
8;Barcelona;41;Vallès Oriental;08106;Llinars del Vallès;2;1;B;;721;182;375;458;263;2;10;446;456
8;Barcelona;41;Vallès Oriental;08106;Llinars del Vallès;2;2;A;;698;195;367;435;263;3;9;423;432
8;Barcelona;41;Vallès Oriental;08106;Llinars del Vallès;2;2;B;;636;176;308;370;266;1;13;356;369
8;Barcelona;41;Vallès Oriental;08106;Llinars del Vallès;2;2;C;;674;193;341;407;267;1;25;381;406
8;Barcelona;41;Vallès Oriental;08106;Llinars del Vallès;2;3;A;;427;111;226;275;152;1;6;268;274
8;Barcelona;41;Vallès Oriental;08106;Llinars del Vallès;2;3;B;;578;168;291;351;227;0;16;335;351
17;Girona;15;Cerdanya;17094;Llívia;1;1;U;;1149;292;491;658;491;2;10;646;656
43;Tarragona;29;Priorat;43072;Lloar, el;1;1;U;;99;16;55;72;27;0;0;72;72
25;Lleida;35;Solsonès;25129;Llobera;1;1;U;;178;46;92;121;57;0;2;119;121
43;Tarragona;16;Conca de Barberà;43073;Llorac;1;1;U;;87;18;39;58;29;0;0;58;58
43;Tarragona;12;Baix Penedès;43074;Llorenç del Penedès;1;1;A;;391;99;183;244;147;6;12;226;238
43;Tarragona;12;Baix Penedès;43074;Llorenç del Penedès;1;1;B;;344;83;155;201;143;2;9;190;199
43;Tarragona;12;Baix Penedès;43074;Llorenç del Penedès;1;1;C;;447;117;224;287;160;6;9;272;281
43;Tarragona;12;Baix Penedès;43074;Llorenç del Penedès;1;1;D;;493;127;256;327;166;1;13;313;326
17;Girona;34;Selva;17095;Lloret de Mar;1;1;A;;695;138;257;342;353;2;8;332;340
17;Girona;34;Selva;17095;Lloret de Mar;1;1;B;;729;140;270;352;377;3;4;345;349
17;Girona;34;Selva;17095;Lloret de Mar;1;2;A;;540;119;238;277;263;1;3;273;276
17;Girona;34;Selva;17095;Lloret de Mar;1;2;B;;555;133;238;284;271;0;9;275;284
17;Girona;34;Selva;17095;Lloret de Mar;1;3;A;;989;171;341;394;595;4;11;379;390
17;Girona;34;Selva;17095;Lloret de Mar;1;3;B;;894;161;316;366;528;3;3;360;363
17;Girona;34;Selva;17095;Lloret de Mar;2;1;A;;696;203;360;411;285;0;16;395;411
17;Girona;34;Selva;17095;Lloret de Mar;2;1;B;;639;167;330;399;240;1;12;386;398
17;Girona;34;Selva;17095;Lloret de Mar;2;2;A;;599;137;259;311;288;0;7;304;311
17;Girona;34;Selva;17095;Lloret de Mar;2;2;B;;640;155;302;344;296;0;10;334;344
17;Girona;34;Selva;17095;Lloret de Mar;2;3;A;;725;163;295;358;367;8;7;343;350
17;Girona;34;Selva;17095;Lloret de Mar;2;3;B;;771;199;343;405;366;2;8;395;403
17;Girona;34;Selva;17095;Lloret de Mar;3;1;A;;693;154;294;351;342;0;9;342;351
17;Girona;34;Selva;17095;Lloret de Mar;3;1;B;;677;141;295;343;334;2;7;334;341
17;Girona;34;Selva;17095;Lloret de Mar;3;2;A;;822;186;335;411;411;2;6;403;409
17;Girona;34;Selva;17095;Lloret de Mar;3;2;B;;964;239;410;484;480;4;12;468;480
17;Girona;34;Selva;17095;Lloret de Mar;3;3;A;;560;12;222;266;294;1;5;260;265
17;Girona;34;Selva;17095;Lloret de Mar;3;3;B;;593;111;211;266;327;2;3;261;264
17;Girona;34;Selva;17095;Lloret de Mar;3;3;C;;571;139;254;298;273;1;2;295;297
17;Girona;34;Selva;17095;Lloret de Mar;3;4;A;;698;118;236;288;410;3;9;276;285
17;Girona;34;Selva;17095;Lloret de Mar;3;4;B;;669;102;200;262;407;2;2;258;260
17;Girona;34;Selva;17095;Lloret de Mar;4;1;A;;642;114;254;321;321;0;12;309;321
17;Girona;34;Selva;17095;Lloret de Mar;4;1;B;;604;123;229;277;327;4;2;271;273
17;Girona;34;Selva;17095;Lloret de Mar;4;2;A;;720;135;283;333;387;4;9;320;329
17;Girona;34;Selva;17095;Lloret de Mar;4;2;B;;697;121;250;305;392;4;3;298;301
17;Girona;34;Selva;17095;Lloret de Mar;4;3;U;;1040;202;475;582;458;5;17;560;577
17;Girona;34;Selva;17095;Lloret de Mar;4;4;U;;649;108;266;332;317;3;11;318;329
17;Girona;31;Ripollès;17096;Llosses, les;1;1;U;;184;36;82;103;81;2;1;100;101
8;Barcelona;24;Osona;08109;Lluçà;1;1;U;;201;59;132;154;47;0;7;147;154
17;Girona;2;Alt Empordà;17102;Maçanet de Cabrenys;1;1;U;;573;173;323;384;189;2;10;372;382
17;Girona;34;Selva;17103;Maçanet de la Selva;1;1;A;;499;114;237;297;202;5;6;286;292
17;Girona;34;Selva;17103;Maçanet de la Selva;1;1;B;;557;138;288;347;210;4;7;336;343
17;Girona;34;Selva;17103;Maçanet de la Selva;1;2;A;;859;168;278;325;534;2;9;314;323
17;Girona;34;Selva;17103;Maçanet de la Selva;1;2;B;;821;162;264;310;511;0;8;302;310
17;Girona;34;Selva;17103;Maçanet de la Selva;1;3;A;;552;120;321;291;261;2;4;285;289
17;Girona;34;Selva;17103;Maçanet de la Selva;1;3;B;;577;148;284;340;237;0;5;335;340
17;Girona;34;Selva;17103;Maçanet de la Selva;1;4;A;;541;95;157;182;359;2;3;177;180
17;Girona;34;Selva;17103;Maçanet de la Selva;1;4;B;;534;95;170;189;345;3;4;182;186
17;Girona;20;Gironès;17097;Madremanya;1;1;U;;176;55;111;141;35;2;7;132;139
17;Girona;19;Garrotxa;17098;Maià de Montcal;1;1;U;;311;112;192;216;95;1;9;206;215
25;Lleida;33;Segrià;25133;Maials;1;1;U;;767;151;365;502;265;4;19;479;498
25;Lleida;38;Urgell;25130;Maldà;1;1;U;;218;45;106;143;75;1;3;139;142
8;Barcelona;21;Maresme;08110;Malgrat de Mar;1;1;A;;362;103;170;217;145;0;6;211;217
8;Barcelona;21;Maresme;08110;Malgrat de Mar;1;1;B;;428;103;187;239;189;4;5;230;235
8;Barcelona;21;Maresme;08110;Malgrat de Mar;1;1;C;;396;116;206;258;138;2;8;248;256
8;Barcelona;21;Maresme;08110;Malgrat de Mar;1;2;A;;428;102;207;257;171;1;5;251;256
8;Barcelona;21;Maresme;08110;Malgrat de Mar;1;2;B;;406;117;203;249;157;1;12;236;248
8;Barcelona;21;Maresme;08110;Malgrat de Mar;1;2;C;;624;156;298;350;274;0;7;343;350
8;Barcelona;21;Maresme;08110;Malgrat de Mar;1;2;D;;428;102;203;244;184;2;5;237;242
8;Barcelona;21;Maresme;08110;Malgrat de Mar;1;3;A;;458;95;185;241;217;2;5;234;239
8;Barcelona;21;Maresme;08110;Malgrat de Mar;1;3;B;;647;146;275;337;310;1;9;327;336
8;Barcelona;21;Maresme;08110;Malgrat de Mar;1;3;C;;500;122;216;265;235;2;9;254;263
8;Barcelona;21;Maresme;08110;Malgrat de Mar;1;4;A;;400;106;180;216;184;3;4;209;213
8;Barcelona;21;Maresme;08110;Malgrat de Mar;1;4;B;;519;128;235;285;234;1;10;274;284
8;Barcelona;21;Maresme;08110;Malgrat de Mar;1;4;C;;442;117;203;257;185;3;4;250;254
8;Barcelona;21;Maresme;08110;Malgrat de Mar;1;5;A;;393;100;185;219;174;1;11;207;218
8;Barcelona;21;Maresme;08110;Malgrat de Mar;1;5;B;;519;112;237;284;235;3;11;270;281
8;Barcelona;21;Maresme;08110;Malgrat de Mar;1;5;C;;407;109;204;241;166;1;4;236;240
8;Barcelona;21;Maresme;08110;Malgrat de Mar;1;6;A;;573;152;250;302;271;0;9;293;302
8;Barcelona;21;Maresme;08110;Malgrat de Mar;1;6;B;;722;168;270;354;368;1;4;349;353
8;Barcelona;21;Maresme;08110;Malgrat de Mar;1;6;C;;528;118;208;256;272;4;7;245;252
8;Barcelona;21;Maresme;08110;Malgrat de Mar;2;1;A;;395;117;210;259;136;0;11;248;259
8;Barcelona;21;Maresme;08110;Malgrat de Mar;2;1;B;;408;130;217;255;153;2;12;241;253
8;Barcelona;21;Maresme;08110;Malgrat de Mar;2;1;C;;455;151;271;310;145;2;7;301;308
8;Barcelona;21;Maresme;08110;Malgrat de Mar;2;2;A;;522;162;283;327;195;1;7;319;326
8;Barcelona;21;Maresme;08110;Malgrat de Mar;2;2;B;;579;158;277;330;249;1;18;311;329
8;Barcelona;21;Maresme;08110;Malgrat de Mar;2;2;C;;565;150;262;310;255;1;3;306;309
8;Barcelona;21;Maresme;08110;Malgrat de Mar;2;3;A;;353;86;146;169;184;4;4;161;165
8;Barcelona;21;Maresme;08110;Malgrat de Mar;2;3;B;;487;101;183;236;251;0;3;233;236
8;Barcelona;21;Maresme;08110;Malgrat de Mar;2;3;C;;415;101;171;205;210;2;6;197;203
8;Barcelona;24;Osona;08111;Malla;1;1;U;;214;53;154;190;24;6;2;182;184
8;Barcelona;24;Osona;08112;Manlleu;1;1;A;;622;161;343;434;188;1;22;411;433
8;Barcelona;24;Osona;08112;Manlleu;1;1;B;;714;213;421;501;213;1;17;483;500
8;Barcelona;24;Osona;08112;Manlleu;1;2;U;;580;202;333;404;176;1;15;388;403
8;Barcelona;24;Osona;08112;Manlleu;2;1;A;;597;174;334;392;205;1;16;375;391
8;Barcelona;24;Osona;08112;Manlleu;2;1;B;;695;218;390;474;221;0;20;454;474
8;Barcelona;24;Osona;08112;Manlleu;2;2;A;;574;128;294;373;201;4;9;360;369
8;Barcelona;24;Osona;08112;Manlleu;2;2;B;;667;164;346;419;248;3;12;404;416
8;Barcelona;24;Osona;08112;Manlleu;2;3;A;;392;122;231;282;110;2;6;274;280
8;Barcelona;24;Osona;08112;Manlleu;2;3;B;;423;129;244;295;128;3;6;286;292
8;Barcelona;24;Osona;08112;Manlleu;2;4;A;;495;127;249;293;202;2;8;283;291
8;Barcelona;24;Osona;08112;Manlleu;2;4;B;;500;121;270;318;182;4;18;296;314
8;Barcelona;24;Osona;08112;Manlleu;3;1;A;;507;106;243;323;184;0;9;314;323
8;Barcelona;24;Osona;08112;Manlleu;3;1;B;;483;93;211;290;193;0;16;274;290
8;Barcelona;24;Osona;08112;Manlleu;3;2;A;;650;158;340;419;231;0;9;410;419
8;Barcelona;24;Osona;08112;Manlleu;3;2;B;;710;207;368;467;243;2;18;447;465
8;Barcelona;24;Osona;08112;Manlleu;3;3;A;;549;115;243;296;253;1;6;289;295
8;Barcelona;24;Osona;08112;Manlleu;3;3;B;;555;122;252;299;256;1;4;294;298
8;Barcelona;24;Osona;08112;Manlleu;3;4;A;;583;114;301;351;232;1;11;339;350
8;Barcelona;24;Osona;08112;Manlleu;3;4;B;;620;104;286;359;261;1;7;351;358
8;Barcelona;24;Osona;08112;Manlleu;4;1;U;;624;151;333;392;232;0;5;387;392
8;Barcelona;24;Osona;08112;Manlleu;4;2;A;;623;171;343;424;199;3;9;412;421
8;Barcelona;24;Osona;08112;Manlleu;4;2;B;;761;214;427;528;233;6;12;510;522
8;Barcelona;7;Bages;08113;Manresa;1;1;U;;583;144;249;304;279;3;4;297;301
8;Barcelona;7;Bages;08113;Manresa;1;2;U;;520;116;229;275;245;1;9;265;274
8;Barcelona;7;Bages;08113;Manresa;2;1;U;;648;217;318;473;175;3;13;457;470
8;Barcelona;7;Bages;08113;Manresa;2;10;A;;582;197;327;407;175;2;13;392;405
8;Barcelona;7;Bages;08113;Manresa;2;10;B;;739;233;444;526;213;3;10;513;523
8;Barcelona;7;Bages;08113;Manresa;2;11;A;;582;152;316;399;183;2;13;384;397
8;Barcelona;7;Bages;08113;Manresa;2;11;B;;689;175;365;456;233;6;12;438;450
8;Barcelona;7;Bages;08113;Manresa;2;12;A;;455;123;251;326;129;4;10;312;322
8;Barcelona;7;Bages;08113;Manresa;2;12;B;;560;150;288;366;194;5;8;353;361
8;Barcelona;7;Bages;08113;Manresa;2;13;A;;459;119;221;281;178;0;9;272;281
8;Barcelona;7;Bages;08113;Manresa;2;13;B;;574;141;292;357;217;2;8;347;355
8;Barcelona;7;Bages;08113;Manresa;2;14;U;;477;115;218;270;207;3;8;259;267
8;Barcelona;7;Bages;08113;Manresa;2;2;A;;736;212;416;525;211;3;7;515;522
8;Barcelona;7;Bages;08113;Manresa;2;2;B;;872;246;480;634;238;3;13;618;631
8;Barcelona;7;Bages;08113;Manresa;2;3;A;;630;168;337;428;202;2;11;415;426
8;Barcelona;7;Bages;08113;Manresa;2;3;B;;826;219;463;573;253;4;26;543;569
8;Barcelona;7;Bages;08113;Manresa;2;4;A;;676;221;372;484;192;1;9;474;483
8;Barcelona;7;Bages;08113;Manresa;2;4;B;;845;231;368;569;276;9;23;537;560
8;Barcelona;7;Bages;08113;Manresa;2;5;A;;727;220;362;459;268;1;11;447;458
8;Barcelona;7;Bages;08113;Manresa;2;5;B;;859;222;425;555;304;1;18;536;554
8;Barcelona;7;Bages;08113;Manresa;2;6;U;;548;125;232;304;244;0;9;295;304
8;Barcelona;7;Bages;08113;Manresa;2;7;A;;449;126;217;267;182;3;12;252;264
8;Barcelona;7;Bages;08113;Manresa;2;7;B;;599;155;292;352;247;1;11;340;351
8;Barcelona;7;Bages;08113;Manresa;2;8;U;;625;152;285;353;272;3;11;339;350
8;Barcelona;7;Bages;08113;Manresa;2;9;A;;609;156;295;354;255;2;8;344;352
8;Barcelona;7;Bages;08113;Manresa;2;9;B;;686;183;318;405;281;2;18;385;403
8;Barcelona;7;Bages;08113;Manresa;3;1;U;;656;174;278;330;326;2;6;322;328
8;Barcelona;7;Bages;08113;Manresa;3;2;U;;572;160;272;329;243;7;2;320;322
8;Barcelona;7;Bages;08113;Manresa;3;4;A;;422;114;198;247;175;4;7;236;243
8;Barcelona;7;Bages;08113;Manresa;3;4;B;;527;122;249;298;229;2;5;291;296
8;Barcelona;7;Bages;08113;Manresa;3;5;A;;659;190;357;435;224;1;23;411;434
8;Barcelona;7;Bages;08113;Manresa;3;5;B;;761;188;368;483;278;3;12;468;480
8;Barcelona;7;Bages;08113;Manresa;3;6;U;;766;226;414;515;251;6;5;504;509
8;Barcelona;7;Bages;08113;Manresa;4;1;A;;656;158;404;389;267;2;9;378;387
8;Barcelona;7;Bages;08113;Manresa;4;1;B;;739;234;310;475;264;0;13;462;475
8;Barcelona;7;Bages;08113;Manresa;4;11;U;;647;172;327;385;262;0;4;381;385
8;Barcelona;7;Bages;08113;Manresa;4;12;U;;537;158;274;336;201;0;8;328;336
8;Barcelona;7;Bages;08113;Manresa;4;13;A;;492;149;254;317;175;0;20;297;317
8;Barcelona;7;Bages;08113;Manresa;4;13;B;;589;177;305;379;210;0;16;363;379
8;Barcelona;7;Bages;08113;Manresa;4;14;A;;583;154;283;363;220;2;14;347;361
8;Barcelona;7;Bages;08113;Manresa;4;14;B;;723;210;366;481;242;1;14;466;480
8;Barcelona;7;Bages;08113;Manresa;4;15;A;;680;177;355;459;221;0;14;445;459
8;Barcelona;7;Bages;08113;Manresa;4;15;B;;781;204;395;505;276;1;14;490;504
8;Barcelona;7;Bages;08113;Manresa;4;3;U;;634;187;335;407;227;0;6;401;407
8;Barcelona;7;Bages;08113;Manresa;4;4;A;;609;191;348;408;201;2;7;399;406
8;Barcelona;7;Bages;08113;Manresa;4;4;B;;797;227;459;559;238;5;17;537;554
8;Barcelona;7;Bages;08113;Manresa;4;5;A;;515;134;273;332;183;2;12;318;330
8;Barcelona;7;Bages;08113;Manresa;4;5;B;;604;172;310;376;228;3;7;366;373
8;Barcelona;7;Bages;08113;Manresa;4;6;A;;559;143;273;352;207;5;4;343;347
8;Barcelona;7;Bages;08113;Manresa;4;6;B;;680;162;360;431;249;2;9;420;429
8;Barcelona;7;Bages;08113;Manresa;4;7;A;;688;184;364;433;255;0;20;413;433
8;Barcelona;7;Bages;08113;Manresa;4;7;B;;855;215;426;528;327;6;11;511;522
8;Barcelona;7;Bages;08113;Manresa;4;8;A;;532;133;291;354;178;5;8;341;349
8;Barcelona;7;Bages;08113;Manresa;4;8;B;;643;163;303;385;258;1;9;375;384
8;Barcelona;7;Bages;08113;Manresa;4;9;A;;527;123;266;324;203;2;17;305;322
8;Barcelona;7;Bages;08113;Manresa;4;9;B;;633;154;308;388;245;1;23;364;387
8;Barcelona;7;Bages;08113;Manresa;5;1;U;;719;164;298;367;352;0;7;360;367
8;Barcelona;7;Bages;08113;Manresa;5;10;U;;787;241;404;450;337;3;4;443;447
8;Barcelona;7;Bages;08113;Manresa;5;11;A;;550;108;241;302;248;0;10;292;302
8;Barcelona;7;Bages;08113;Manresa;5;11;B;;681;146;292;370;311;1;6;363;369
8;Barcelona;7;Bages;08113;Manresa;5;12;U;;644;139;282;342;302;5;8;329;337
8;Barcelona;7;Bages;08113;Manresa;5;13;A;;492;126;255;304;188;1;8;295;303
8;Barcelona;7;Bages;08113;Manresa;5;13;B;;517;144;250;305;212;2;8;295;303
8;Barcelona;7;Bages;08113;Manresa;5;14;A;;605;150;293;368;237;2;11;355;366
8;Barcelona;7;Bages;08113;Manresa;5;14;B;;717;178;360;443;274;1;12;430;442
8;Barcelona;7;Bages;08113;Manresa;5;15;A;;463;100;188;226;237;1;0;225;225
8;Barcelona;7;Bages;08113;Manresa;5;15;B;;527;135;217;268;259;3;6;259;265
8;Barcelona;7;Bages;08113;Manresa;5;16;U;;381;112;173;199;182;0;1;198;199
8;Barcelona;7;Bages;08113;Manresa;5;17;A;;520;112;264;324;196;3;8;313;321
8;Barcelona;7;Bages;08113;Manresa;5;17;B;;772;150;377;483;289;3;18;462;480
8;Barcelona;7;Bages;08113;Manresa;5;18;U;;686;150;277;352;334;3;12;337;349
8;Barcelona;7;Bages;08113;Manresa;5;2;U;;807;158;315;407;400;2;10;395;405
8;Barcelona;7;Bages;08113;Manresa;5;3;A;;506;115;240;298;208;2;4;292;296
8;Barcelona;7;Bages;08113;Manresa;5;3;B;;580;142;279;346;234;2;12;332;344
8;Barcelona;7;Bages;08113;Manresa;5;4;U;;510;142;248;326;184;3;8;315;323
8;Barcelona;7;Bages;08113;Manresa;5;5;A;;688;197;324;390;298;0;9;381;390
8;Barcelona;7;Bages;08113;Manresa;5;5;B;;839;222;394;474;365;3;5;466;471
8;Barcelona;7;Bages;08113;Manresa;5;6;A;;556;139;266;321;235;1;7;313;320
8;Barcelona;7;Bages;08113;Manresa;5;6;B;;698;197;368;436;262;2;8;426;434
8;Barcelona;7;Bages;08113;Manresa;5;7;U;;365;87;153;183;182;0;7;176;183
8;Barcelona;7;Bages;08113;Manresa;5;8;U;;815;176;383;462;353;2;7;453;460
8;Barcelona;7;Bages;08113;Manresa;6;1;U;;735;170;315;353;382;1;2;350;352
8;Barcelona;7;Bages;08113;Manresa;6;2;U;;786;215;377;436;350;0;10;426;436
43;Tarragona;29;Priorat;43076;Marçà;1;1;U;;480;145;261;312;168;6;11;295;306
43;Tarragona;29;Priorat;43075;Margalef;1;1;U;;100;29;52;66;34;0;7;59;66
8;Barcelona;7;Bages;08242;Marganell;1;1;U;;247;83;126;159;88;0;6;153;159
8;Barcelona;11;Baix Llobregat;08114;Martorell;1;1;A;;483;100;233;289;194;4;6;279;285
8;Barcelona;11;Baix Llobregat;08114;Martorell;1;1;B;;492;94;222;286;206;0;5;281;286
8;Barcelona;11;Baix Llobregat;08114;Martorell;1;2;U;;555;127;240;315;240;1;3;311;314
8;Barcelona;11;Baix Llobregat;08114;Martorell;1;3;A;;401;93;194;236;165;2;5;229;234
8;Barcelona;11;Baix Llobregat;08114;Martorell;1;3;B;;417;117;212;262;155;4;2;256;258
8;Barcelona;11;Baix Llobregat;08114;Martorell;2;3;A;;576;142;255;318;258;1;6;311;317
8;Barcelona;11;Baix Llobregat;08114;Martorell;2;3;B;;526;138;247;308;218;2;9;297;306
8;Barcelona;11;Baix Llobregat;08114;Martorell;2;3;C;;546;122;211;291;255;2;10;279;289
8;Barcelona;11;Baix Llobregat;08114;Martorell;3;10;U;;549;140;280;354;195;5;16;333;349
8;Barcelona;11;Baix Llobregat;08114;Martorell;3;2;A;;522;146;245;286;236;1;5;280;285
8;Barcelona;11;Baix Llobregat;08114;Martorell;3;2;B;;568;154;274;312;256;1;4;307;311
8;Barcelona;11;Baix Llobregat;08114;Martorell;3;4;A;;394;99;179;212;182;3;7;202;209
8;Barcelona;11;Baix Llobregat;08114;Martorell;3;4;B;;436;98;183;207;229;1;9;197;206
8;Barcelona;11;Baix Llobregat;08114;Martorell;3;4;C;;441;96;190;233;208;2;7;224;231
8;Barcelona;11;Baix Llobregat;08114;Martorell;3;5;A;;465;131;218;247;218;5;6;236;242
8;Barcelona;11;Baix Llobregat;08114;Martorell;3;5;B;;460;139;224;276;184;2;10;264;274
8;Barcelona;11;Baix Llobregat;08114;Martorell;3;6;A;;424;130;222;257;167;1;12;244;256
8;Barcelona;11;Baix Llobregat;08114;Martorell;3;6;B;;425;126;203;256;169;2;6;248;254
8;Barcelona;11;Baix Llobregat;08114;Martorell;3;6;C;;419;118;196;244;175;0;4;240;244
8;Barcelona;11;Baix Llobregat;08114;Martorell;3;7;A;;555;167;300;380;175;4;10;366;376
8;Barcelona;11;Baix Llobregat;08114;Martorell;3;7;B;;564;159;291;359;205;1;15;343;358
8;Barcelona;11;Baix Llobregat;08114;Martorell;3;8;A;;465;115;227;287;178;4;8;275;283
8;Barcelona;11;Baix Llobregat;08114;Martorell;3;8;B;;649;153;315;409;240;10;13;386;399
8;Barcelona;11;Baix Llobregat;08114;Martorell;3;8;C;;480;126;223;286;194;2;10;274;284
8;Barcelona;11;Baix Llobregat;08114;Martorell;4;1;A;;565;125;255;327;238;4;6;317;323
8;Barcelona;11;Baix Llobregat;08114;Martorell;4;1;B;;653;155;308;392;261;5;13;374;387
8;Barcelona;11;Baix Llobregat;08114;Martorell;4;1;C;;538;119;240;308;230;2;9;297;306
8;Barcelona;11;Baix Llobregat;08114;Martorell;4;2;A;;453;112;203;277;176;0;11;266;277
8;Barcelona;11;Baix Llobregat;08114;Martorell;4;2;B;;586;124;263;361;225;4;12;345;357
8;Barcelona;11;Baix Llobregat;08114;Martorell;4;2;C;;508;120;225;304;204;4;8;292;300
8;Barcelona;11;Baix Llobregat;08114;Martorell;4;3;A;;278;55;129;166;112;0;8;158;166
8;Barcelona;11;Baix Llobregat;08114;Martorell;4;3;B;;423;96;194;257;166;0;8;249;257
8;Barcelona;11;Baix Llobregat;08114;Martorell;4;3;C;;290;70;149;178;112;0;8;170;178
8;Barcelona;11;Baix Llobregat;08114;Martorell;4;4;A;;418;95;208;259;159;0;3;256;259
8;Barcelona;11;Baix Llobregat;08114;Martorell;4;4;B;;540;142;248;318;222;1;10;307;317
8;Barcelona;11;Baix Llobregat;08114;Martorell;4;4;C;;403;91;182;248;155;2;4;242;246
8;Barcelona;41;Vallès Oriental;08115;Martorelles;1;1;A;;401;96;179;214;187;0;6;208;214
8;Barcelona;41;Vallès Oriental;08115;Martorelles;1;1;B;;499;117;241;280;219;1;8;271;279
8;Barcelona;41;Vallès Oriental;08115;Martorelles;1;1;C;;559;133;280;323;236;2;2;319;321
8;Barcelona;41;Vallès Oriental;08115;Martorelles;1;2;A;;513;135;247;303;210;4;9;290;299
8;Barcelona;41;Vallès Oriental;08115;Martorelles;1;2;B;;766;213;423;509;257;0;20;489;509
8;Barcelona;41;Vallès Oriental;08115;Martorelles;1;3;A;;549;126;246;291;258;1;9;281;290
8;Barcelona;41;Vallès Oriental;08115;Martorelles;1;3;B;;624;130;277;340;284;1;11;328;339
17;Girona;2;Alt Empordà;17100;Masarac;1;1;U;;199;54;128;146;53;1;7;138;145
43;Tarragona;22;Montsià;43077;Mas de Barberans;1;1;U;;493;128;260;340;153;6;13;321;334
43;Tarragona;22;Montsià;43078;Masdenverge;1;1;U;;848;203;463;556;292;11;23;522;545
8;Barcelona;24;Osona;08116;Masies de Roda, les;1;1;U;;590;155;358;424;166;4;19;401;420
8;Barcelona;24;Osona;08117;Masies de Voltregà, les;1;1;A;;745;190;423;491;254;2;26;463;489
8;Barcelona;24;Osona;08117;Masies de Voltregà, les;1;1;B;;518;156;312;381;137;0;16;365;381
8;Barcelona;24;Osona;08117;Masies de Voltregà, les;1;1;C;;527;163;321;398;129;2;9;387;396
8;Barcelona;24;Osona;08117;Masies de Voltregà, les;2;1;U;;637;177;310;389;248;1;15;373;388
43;Tarragona;12;Baix Penedès;43079;Masllorenç;1;1;U;;382;130;205;249;133;1;11;237;248
8;Barcelona;21;Maresme;08118;Masnou, el;1;1;A;;715;168;372;472;243;2;8;462;470
8;Barcelona;21;Maresme;08118;Masnou, el;1;1;B;;716;171;360;456;260;2;9;445;454
8;Barcelona;21;Maresme;08118;Masnou, el;1;10;A;;591;168;338;405;186;9;7;389;396
8;Barcelona;21;Maresme;08118;Masnou, el;1;10;B;;613;168;314;408;205;4;8;396;404
8;Barcelona;21;Maresme;08118;Masnou, el;1;2;A;;696;202;374;441;255;1;15;425;440
8;Barcelona;21;Maresme;08118;Masnou, el;1;2;B;;836;235;450;550;286;5;17;528;545
8;Barcelona;21;Maresme;08118;Masnou, el;1;3;A;;429;148;254;304;125;3;6;295;301
8;Barcelona;21;Maresme;08118;Masnou, el;1;3;B;;468;152;247;300;168;1;15;284;299
8;Barcelona;21;Maresme;08118;Masnou, el;1;4;A;;628;191;356;438;190;2;23;413;436
8;Barcelona;21;Maresme;08118;Masnou, el;1;4;B;;743;207;404;517;226;5;16;496;512
8;Barcelona;21;Maresme;08118;Masnou, el;1;5;A;;689;188;355;446;243;13;2;431;433
8;Barcelona;21;Maresme;08118;Masnou, el;1;5;B;;768;206;392;490;278;2;11;477;488
8;Barcelona;21;Maresme;08118;Masnou, el;1;6;A;;646;184;349;392;254;1;16;375;391
8;Barcelona;21;Maresme;08118;Masnou, el;1;6;B;;763;183;357;438;325;0;12;426;438
8;Barcelona;21;Maresme;08118;Masnou, el;1;7;A;;563;160;293;361;202;5;14;342;356
8;Barcelona;21;Maresme;08118;Masnou, el;1;7;B;;632;166;323;400;232;5;11;384;395
8;Barcelona;21;Maresme;08118;Masnou, el;1;8;A;;481;112;218;254;227;1;8;245;253
8;Barcelona;21;Maresme;08118;Masnou, el;1;8;B;;599;152;271;318;281;4;6;308;314
8;Barcelona;21;Maresme;08118;Masnou, el;1;9;U;;623;204;349;430;193;1;12;417;429
8;Barcelona;21;Maresme;08118;Masnou, el;2;1;A;;674;190;404;469;205;1;11;457;468
8;Barcelona;21;Maresme;08118;Masnou, el;2;1;B;;690;230;428;504;186;3;16;485;501
8;Barcelona;21;Maresme;08118;Masnou, el;2;2;U;;865;239;480;606;259;2;19;585;604
8;Barcelona;21;Maresme;08118;Masnou, el;2;3;A;;546;183;320;383;163;3;18;362;380
8;Barcelona;21;Maresme;08118;Masnou, el;2;3;B;;511;178;299;348;163;3;11;334;345
8;Barcelona;21;Maresme;08118;Masnou, el;2;4;A;;720;197;397;474;246;3;16;455;471
8;Barcelona;21;Maresme;08118;Masnou, el;2;4;B;;814;232;415;518;296;1;12;505;517
43;Tarragona;1;Alt Camp;43080;Masó, la;1;1;U;;255;88;138;181;74;2;8;171;179
43;Tarragona;8;Baix Camp;43081;Maspujols;1;1;U;;549;177;333;392;157;5;10;377;387
8;Barcelona;6;Anoia;08119;Masquefa;1;1;A;;445;109;196;255;190;1;12;242;254
8;Barcelona;6;Anoia;08119;Masquefa;1;1;B;;691;164;338;408;283;8;18;382;400
8;Barcelona;6;Anoia;08119;Masquefa;1;1;C;;735;166;358;442;293;3;16;423;439
8;Barcelona;6;Anoia;08119;Masquefa;1;1;D;;641;152;309;387;254;1;13;373;386
8;Barcelona;6;Anoia;08119;Masquefa;1;1;E;;558;133;252;316;242;4;11;301;312
8;Barcelona;6;Anoia;08119;Masquefa;1;1;F;;513;134;250;318;195;0;12;306;318
8;Barcelona;6;Anoia;08119;Masquefa;1;2;A;;770;155;295;375;395;5;7;363;370
8;Barcelona;6;Anoia;08119;Masquefa;1;2;B;;842;171;295;375;467;2;15;358;373
8;Barcelona;6;Anoia;08119;Masquefa;1;2;C;;808;166;313;395;413;0;11;384;395
43;Tarragona;29;Priorat;43082;Masroig, el;1;1;U;;387;92;201;281;106;12;5;264;269
25;Lleida;33;Segrià;25131;Massalcoreig;1;1;U;;452;120;245;308;144;4;9;295;304
17;Girona;34;Selva;17101;Massanes;1;1;U;;557;110;243;282;275;10;5;267;272
25;Lleida;32;Segarra;25132;Massoteres;1;1;U;;134;36;61;88;46;0;0;88;88
8;Barcelona;40;Vallès Occidental;08120;Matadepera;1;1;A;;829;230;498;655;174;1;14;640;654
8;Barcelona;40;Vallès Occidental;08120;Matadepera;1;1;B;;820;197;486;619;201;1;7;611;618
8;Barcelona;40;Vallès Occidental;08120;Matadepera;1;2;A;;832;209;518;650;182;2;17;631;648
8;Barcelona;40;Vallès Occidental;08120;Matadepera;1;2;B;;887;188;510;654;233;1;11;642;653
8;Barcelona;40;Vallès Occidental;08120;Matadepera;1;3;A;;779;190;446;577;202;1;6;570;576
8;Barcelona;40;Vallès Occidental;08120;Matadepera;1;3;B;;944;247;540;689;255;2;14;673;687
8;Barcelona;40;Vallès Occidental;08120;Matadepera;1;4;A;;603;161;378;462;141;4;2;456;458
8;Barcelona;40;Vallès Occidental;08120;Matadepera;1;4;B;;664;170;394;505;159;1;7;497;504
8;Barcelona;21;Maresme;08121;Mataró;1;1;U;;707;228;408;485;222;2;10;473;483
8;Barcelona;21;Maresme;08121;Mataró;1;2;A;;556;173;301;380;176;3;11;366;377
8;Barcelona;21;Maresme;08121;Mataró;1;2;B;;605;188;314;405;200;4;13;388;401
8;Barcelona;21;Maresme;08121;Mataró;1;3;A;;526;176;325;387;139;1;12;374;386
8;Barcelona;21;Maresme;08121;Mataró;1;3;B;;512;192;305;358;154;0;11;347;358
8;Barcelona;21;Maresme;08121;Mataró;1;4;U;;1001;285;615;756;245;8;15;733;748
8;Barcelona;21;Maresme;08121;Mataró;1;5;A;;606;215;404;462;144;2;14;446;460
8;Barcelona;21;Maresme;08121;Mataró;1;5;B;;638;200;391;459;179;3;16;440;456
8;Barcelona;21;Maresme;08121;Mataró;1;6;A;;748;171;448;543;205;0;10;533;543
8;Barcelona;21;Maresme;08121;Mataró;1;6;B;;603;130;335;406;197;2;10;394;404
8;Barcelona;21;Maresme;08121;Mataró;1;6;C;;745;236;419;529;216;4;7;518;525
8;Barcelona;21;Maresme;08121;Mataró;1;7;A;;597;192;330;435;162;1;15;419;434
8;Barcelona;21;Maresme;08121;Mataró;1;7;B;;671;218;408;513;158;1;17;495;512
8;Barcelona;21;Maresme;08121;Mataró;1;8;U;;488;167;292;350;138;1;9;340;349
8;Barcelona;21;Maresme;08121;Mataró;2;1;A;;756;181;418;529;227;0;18;511;529
8;Barcelona;21;Maresme;08121;Mataró;2;1;B;;871;255;476;592;279;2;16;574;590
8;Barcelona;21;Maresme;08121;Mataró;2;10;U;;1059;251;558;687;372;3;31;653;684
8;Barcelona;21;Maresme;08121;Mataró;2;11;A;;587;167;344;414;173;1;9;404;413
8;Barcelona;21;Maresme;08121;Mataró;2;11;B;;568;148;318;405;163;2;10;393;403
8;Barcelona;21;Maresme;08121;Mataró;2;12;U;;916;254;443;624;292;3;24;597;621
8;Barcelona;21;Maresme;08121;Mataró;2;2;U;;731;212;380;511;220;0;12;499;511
8;Barcelona;21;Maresme;08121;Mataró;2;3;U;;788;208;390;469;319;1;24;444;468
8;Barcelona;21;Maresme;08121;Mataró;2;4;U;;431;118;189;225;206;0;7;218;225
8;Barcelona;21;Maresme;08121;Mataró;2;5;A;;700;198;330;412;288;4;16;392;408
8;Barcelona;21;Maresme;08121;Mataró;2;5;B;;780;248;399;500;280;7;15;478;493
8;Barcelona;21;Maresme;08121;Mataró;2;6;A;;456;140;218;251;205;0;3;248;251
8;Barcelona;21;Maresme;08121;Mataró;2;6;B;;535;130;231;275;260;1;13;261;274
8;Barcelona;21;Maresme;08121;Mataró;2;7;U;;982;260;508;658;324;0;40;618;658
8;Barcelona;21;Maresme;08121;Mataró;2;8;A;;541;167;304;365;176;5;10;350;360
8;Barcelona;21;Maresme;08121;Mataró;2;8;B;;561;192;335;439;122;0;19;420;439
8;Barcelona;21;Maresme;08121;Mataró;2;9;A;;493;148;262;325;168;2;10;313;323
8;Barcelona;21;Maresme;08121;Mataró;2;9;B;;580;190;334;418;162;3;13;402;415
8;Barcelona;21;Maresme;08121;Mataró;3;1;U;;924;274;486;564;360;3;9;552;561
8;Barcelona;21;Maresme;08121;Mataró;3;10;U;;560;197;363;417;143;0;9;408;417
8;Barcelona;21;Maresme;08121;Mataró;3;11;A;;510;168;285;337;173;4;10;323;333
8;Barcelona;21;Maresme;08121;Mataró;3;11;B;;612;168;318;381;231;3;12;366;378
8;Barcelona;21;Maresme;08121;Mataró;3;12;A;;562;145;276;363;199;2;7;354;361
8;Barcelona;21;Maresme;08121;Mataró;3;12;B;;679;175;319;429;250;4;1;424;425
8;Barcelona;21;Maresme;08121;Mataró;3;13;A;;625;165;310;388;237;5;13;370;383
8;Barcelona;21;Maresme;08121;Mataró;3;13;B;;713;183;370;448;265;1;11;436;447
8;Barcelona;21;Maresme;08121;Mataró;3;13;C;;736;194;369;457;279;0;19;438;457
8;Barcelona;21;Maresme;08121;Mataró;3;14;U;;959;218;448;586;373;3;14;569;583
8;Barcelona;21;Maresme;08121;Mataró;3;2;U;;825;235;382;434;391;6;6;422;428
8;Barcelona;21;Maresme;08121;Mataró;3;3;U;;885;259;410;477;408;4;3;470;473
8;Barcelona;21;Maresme;08121;Mataró;3;4;A;;536;145;232;280;256;3;5;272;277
8;Barcelona;21;Maresme;08121;Mataró;3;4;B;;687;165;305;377;310;5;15;357;372
8;Barcelona;21;Maresme;08121;Mataró;3;5;A;;445;101;189;227;218;0;7;220;227
8;Barcelona;21;Maresme;08121;Mataró;3;5;B;;560;149;226;264;296;1;5;258;263
8;Barcelona;21;Maresme;08121;Mataró;3;6;A;;532;141;247;304;228;2;12;290;302
8;Barcelona;21;Maresme;08121;Mataró;3;6;B;;651;147;302;376;275;2;18;356;374
8;Barcelona;21;Maresme;08121;Mataró;3;7;A;;436;99;198;235;201;0;5;230;235
8;Barcelona;21;Maresme;08121;Mataró;3;7;B;;568;134;266;312;256;0;8;304;312
8;Barcelona;21;Maresme;08121;Mataró;3;8;U;;916;226;381;474;442;2;18;454;472
8;Barcelona;21;Maresme;08121;Mataró;3;9;A;;511;104;228;285;226;4;3;278;281
8;Barcelona;21;Maresme;08121;Mataró;3;9;B;;581;133;274;327;254;1;8;318;326
8;Barcelona;21;Maresme;08121;Mataró;3;9;C;;618;151;290;346;272;2;11;333;344
8;Barcelona;21;Maresme;08121;Mataró;4;1;U;;894;272;472;592;302;5;22;565;587
8;Barcelona;21;Maresme;08121;Mataró;4;2;A;;457;102;194;235;222;3;6;226;232
8;Barcelona;21;Maresme;08121;Mataró;4;2;B;;585;131;236;298;287;2;13;283;296
8;Barcelona;21;Maresme;08121;Mataró;4;3;U;;708;180;312;378;330;3;12;363;375
8;Barcelona;21;Maresme;08121;Mataró;4;4;A;;608;142;267;317;291;1;7;309;316
8;Barcelona;21;Maresme;08121;Mataró;4;4;B;;672;4;286;354;318;0;3;351;354
8;Barcelona;21;Maresme;08121;Mataró;4;4;C;;714;5;316;384;330;2;6;376;382
8;Barcelona;21;Maresme;08121;Mataró;4;5;A;;529;135;259;305;224;1;11;293;304
8;Barcelona;21;Maresme;08121;Mataró;4;5;B;;727;166;311;367;360;3;10;354;364
8;Barcelona;21;Maresme;08121;Mataró;4;5;C;;709;161;316;395;314;0;18;377;395
8;Barcelona;21;Maresme;08121;Mataró;4;6;A;;533;154;261;344;189;2;8;334;342
8;Barcelona;21;Maresme;08121;Mataró;4;6;B;;640;160;307;406;234;2;11;393;404
8;Barcelona;21;Maresme;08121;Mataró;4;7;U;;947;191;365;463;484;2;17;444;461
8;Barcelona;21;Maresme;08121;Mataró;4;8;U;;979;285;534;638;341;3;16;619;635
8;Barcelona;21;Maresme;08121;Mataró;4;9;A;;721;166;318;401;320;1;12;388;400
8;Barcelona;21;Maresme;08121;Mataró;4;9;B;;806;189;349;460;346;1;11;448;459
8;Barcelona;21;Maresme;08121;Mataró;5;1;A;;588;152;286;330;258;3;13;314;327
8;Barcelona;21;Maresme;08121;Mataró;5;1;B;;647;174;309;369;278;1;13;355;368
8;Barcelona;21;Maresme;08121;Mataró;5;1;C;;645;185;303;385;260;0;10;375;385
8;Barcelona;21;Maresme;08121;Mataró;5;10;U;;348;105;161;188;160;0;7;181;188
8;Barcelona;21;Maresme;08121;Mataró;5;11;A;;487;126;208;252;235;0;7;245;252
8;Barcelona;21;Maresme;08121;Mataró;5;11;B;;585;136;230;277;308;0;8;269;277
8;Barcelona;21;Maresme;08121;Mataró;5;12;U;;922;225;434;535;387;6;14;515;529
8;Barcelona;21;Maresme;08121;Mataró;5;13;A;;643;170;274;335;308;5;6;324;330
8;Barcelona;21;Maresme;08121;Mataró;5;13;B;;695;177;291;356;339;0;8;348;356
8;Barcelona;21;Maresme;08121;Mataró;5;14;U;;432;87;149;188;244;0;1;187;188
8;Barcelona;21;Maresme;08121;Mataró;5;15;U;;786;196;345;419;367;4;13;402;415
8;Barcelona;21;Maresme;08121;Mataró;5;16;U;;906;211;372;448;458;0;4;444;448
8;Barcelona;21;Maresme;08121;Mataró;5;17;U;;753;149;322;409;344;0;18;391;409
8;Barcelona;21;Maresme;08121;Mataró;5;18;U;;319;84;133;168;151;2;1;165;166
8;Barcelona;21;Maresme;08121;Mataró;5;19;U;;628;155;279;330;298;2;6;322;328
8;Barcelona;21;Maresme;08121;Mataró;5;2;A;;647;141;255;303;344;1;6;296;302
8;Barcelona;21;Maresme;08121;Mataró;5;2;B;;689;145;294;349;340;5;10;334;344
8;Barcelona;21;Maresme;08121;Mataró;5;20;A;;456;103;172;216;240;0;2;214;216
8;Barcelona;21;Maresme;08121;Mataró;5;20;B;;560;123;227;274;286;2;2;270;272
8;Barcelona;21;Maresme;08121;Mataró;5;21;U;;686;154;311;411;275;1;15;395;410
8;Barcelona;21;Maresme;08121;Mataró;5;3;A;;577;121;216;271;306;0;10;261;271
8;Barcelona;21;Maresme;08121;Mataró;5;3;B;;704;144;258;341;363;0;14;327;341
8;Barcelona;21;Maresme;08121;Mataró;5;4;A;;468;134;220;264;204;2;5;257;262
8;Barcelona;21;Maresme;08121;Mataró;5;4;B;;530;113;245;296;234;1;7;288;295
8;Barcelona;21;Maresme;08121;Mataró;5;5;U;;656;160;276;339;317;2;8;329;337
8;Barcelona;21;Maresme;08121;Mataró;5;6;A;;500;97;159;202;298;0;6;196;202
8;Barcelona;21;Maresme;08121;Mataró;5;6;B;;579;120;208;227;352;0;3;224;227
8;Barcelona;21;Maresme;08121;Mataró;5;7;A;;555;138;238;283;272;0;8;275;283
8;Barcelona;21;Maresme;08121;Mataró;5;7;B;;644;164;262;320;324;1;15;304;319
8;Barcelona;21;Maresme;08121;Mataró;5;8;U;;869;210;321;391;478;1;8;382;390
8;Barcelona;21;Maresme;08121;Mataró;5;9;U;;796;178;347;400;396;2;4;394;398
8;Barcelona;21;Maresme;08121;Mataró;6;1;A;;721;228;393;471;250;2;14;455;469
8;Barcelona;21;Maresme;08121;Mataró;6;1;B;;900;304;512;619;281;3;19;597;616
8;Barcelona;21;Maresme;08121;Mataró;6;10;A;;595;145;252;327;268;1;11;315;326
8;Barcelona;21;Maresme;08121;Mataró;6;10;B;;591;134;246;331;260;3;13;315;328
8;Barcelona;21;Maresme;08121;Mataró;6;10;C;;641;141;276;368;273;6;8;354;362
8;Barcelona;21;Maresme;08121;Mataró;6;11;A;;698;219;362;466;232;3;16;447;463
8;Barcelona;21;Maresme;08121;Mataró;6;11;B;;753;207;376;467;286;4;17;446;463
8;Barcelona;21;Maresme;08121;Mataró;6;11;C;;865;260;459;563;302;1;22;540;562
8;Barcelona;21;Maresme;08121;Mataró;6;12;A;;641;169;310;366;275;0;12;354;366
8;Barcelona;21;Maresme;08121;Mataró;6;12;B;;727;175;293;374;353;0;3;371;374
8;Barcelona;21;Maresme;08121;Mataró;6;13;U;;767;218;378;434;333;1;5;428;433
8;Barcelona;21;Maresme;08121;Mataró;6;2;U;;624;180;321;404;220;0;16;388;404
8;Barcelona;21;Maresme;08121;Mataró;6;3;A;;689;201;389;486;203;3;11;472;483
8;Barcelona;21;Maresme;08121;Mataró;6;3;B;;728;254;443;522;206;2;12;508;520
8;Barcelona;21;Maresme;08121;Mataró;6;4;A;;549;190;316;369;180;2;18;349;367
8;Barcelona;21;Maresme;08121;Mataró;6;4;B;;608;206;344;409;199;0;8;401;409
8;Barcelona;21;Maresme;08121;Mataró;6;5;A;;674;195;328;419;255;9;0;410;410
8;Barcelona;21;Maresme;08121;Mataró;6;5;B;;722;206;363;451;271;2;12;437;449
8;Barcelona;21;Maresme;08121;Mataró;6;6;A;;636;168;369;448;188;1;14;433;447
8;Barcelona;21;Maresme;08121;Mataró;6;6;B;;637;212;371;437;200;1;12;424;436
8;Barcelona;21;Maresme;08121;Mataró;6;7;A;;557;170;302;361;196;0;8;353;361
8;Barcelona;21;Maresme;08121;Mataró;6;7;B;;640;206;357;416;224;7;13;396;409
8;Barcelona;21;Maresme;08121;Mataró;6;8;A;;662;176;325;395;267;5;12;378;390
8;Barcelona;21;Maresme;08121;Mataró;6;8;B;;745;178;363;453;292;2;14;437;451
8;Barcelona;21;Maresme;08121;Mataró;6;9;U;;742;166;283;328;414;3;8;317;325
8;Barcelona;3;Alt Penedès;08122;Mediona;1;1;A;;881;224;414;499;382;4;14;481;495
8;Barcelona;3;Alt Penedès;08122;Mediona;1;1;B;;887;208;381;468;419;2;9;457;466
25;Lleida;23;Noguera;25134;Menàrguens;1;1;U;;654;139;326;408;246;3;19;386;405
17;Girona;15;Cerdanya;17099;Meranges;1;1;U;;82;16;42;57;25;2;4;51;55
17;Girona;19;Garrotxa;17105;Mieres;1;1;U;;255;78;132;160;95;1;8;151;159
43;Tarragona;1;Alt Camp;43083;Milà, el;1;1;U;;149;25;75;95;54;0;2;93;95
25;Lleida;27;Pla d'Urgell;25135;Miralcamp;1;1;A;;533;132;281;378;155;3;6;369;375
25;Lleida;27;Pla d'Urgell;25135;Miralcamp;1;1;B;;551;137;298;358;193;6;15;337;352
43;Tarragona;30;Ribera d'Ebre;43084;Miravet;1;1;U;;576;124;297;379;197;15;17;347;364
8;Barcelona;;;08138;Moià;1;1;A;;766;224;444;527;239;10;15;502;517
8;Barcelona;;;08138;Moià;1;1;B;;779;209;420;514;265;10;15;489;504
8;Barcelona;;;08138;Moià;1;2;A;;802;233;389;492;310;6;25;461;486
8;Barcelona;;;08138;Moià;1;2;B;;849;260;450;561;288;5;17;539;556
8;Barcelona;;;08138;Moià;1;3;U;;793;181;390;493;300;7;13;473;486
43;Tarragona;29;Priorat;43085;Molar, el;1;1;U;;232;64;150;186;46;3;15;168;183
8;Barcelona;11;Baix Llobregat;08123;Molins de Rei;1;1;A;;396;135;199;255;141;4;12;239;251
8;Barcelona;11;Baix Llobregat;08123;Molins de Rei;1;1;B;;508;141;243;305;203;1;9;295;304
8;Barcelona;11;Baix Llobregat;08123;Molins de Rei;1;2;A;;636;160;332;416;220;2;16;398;414
8;Barcelona;11;Baix Llobregat;08123;Molins de Rei;1;2;B;;731;192;369;471;260;0;16;455;471
8;Barcelona;11;Baix Llobregat;08123;Molins de Rei;1;3;A;;583;156;307;394;189;5;6;383;389
8;Barcelona;11;Baix Llobregat;08123;Molins de Rei;1;3;B;;677;191;360;456;221;2;13;441;454
8;Barcelona;11;Baix Llobregat;08123;Molins de Rei;2;1;A;;676;155;342;431;245;3;17;411;428
8;Barcelona;11;Baix Llobregat;08123;Molins de Rei;2;1;B;;665;192;338;427;238;1;12;414;426
8;Barcelona;11;Baix Llobregat;08123;Molins de Rei;2;1;C;;765;202;391;493;272;1;16;476;492
8;Barcelona;11;Baix Llobregat;08123;Molins de Rei;2;2;A;;558;148;295;368;190;0;4;364;368
8;Barcelona;11;Baix Llobregat;08123;Molins de Rei;2;2;B;;626;139;293;396;230;6;8;382;390
8;Barcelona;11;Baix Llobregat;08123;Molins de Rei;2;3;A;;482;135;258;313;169;2;10;301;311
8;Barcelona;11;Baix Llobregat;08123;Molins de Rei;2;3;B;;517;135;249;312;205;4;9;299;308
8;Barcelona;11;Baix Llobregat;08123;Molins de Rei;2;3;C;;570;153;287;338;232;1;7;330;337
8;Barcelona;11;Baix Llobregat;08123;Molins de Rei;2;4;A;;621;144;298;373;248;0;14;359;373
8;Barcelona;11;Baix Llobregat;08123;Molins de Rei;2;4;B;;724;181;347;429;295;0;19;410;429
8;Barcelona;11;Baix Llobregat;08123;Molins de Rei;3;1;A;;613;150;325;400;213;3;17;380;397
8;Barcelona;11;Baix Llobregat;08123;Molins de Rei;3;1;B;;489;132;263;326;163;9;1;316;317
8;Barcelona;11;Baix Llobregat;08123;Molins de Rei;3;1;C;;782;202;420;525;257;8;18;499;517
8;Barcelona;11;Baix Llobregat;08123;Molins de Rei;3;1;D;;595;139;306;405;190;6;12;387;399
8;Barcelona;11;Baix Llobregat;08123;Molins de Rei;3;2;A;;824;231;494;610;214;2;29;579;608
8;Barcelona;11;Baix Llobregat;08123;Molins de Rei;3;2;B;;763;183;418;522;241;2;16;504;520
8;Barcelona;11;Baix Llobregat;08123;Molins de Rei;3;2;C;;874;230;486;625;249;3;14;608;622
8;Barcelona;11;Baix Llobregat;08123;Molins de Rei;3;3;A;;649;176;344;431;218;3;12;416;428
8;Barcelona;11;Baix Llobregat;08123;Molins de Rei;3;3;B;;771;176;399;493;278;2;15;476;491
8;Barcelona;11;Baix Llobregat;08123;Molins de Rei;3;4;A;;514;123;247;328;186;2;10;316;326
8;Barcelona;11;Baix Llobregat;08123;Molins de Rei;3;4;B;;553;126;262;331;222;2;10;319;329
8;Barcelona;11;Baix Llobregat;08123;Molins de Rei;3;4;C;;613;148;279;364;249;5;8;351;359
8;Barcelona;11;Baix Llobregat;08123;Molins de Rei;4;1;A;;368;76;160;198;170;0;5;193;198
8;Barcelona;11;Baix Llobregat;08123;Molins de Rei;4;1;B;;435;104;187;230;205;1;10;219;229
25;Lleida;27;Pla d'Urgell;25137;Mollerussa;1;1;A;;801;180;400;499;302;2;17;480;497
25;Lleida;27;Pla d'Urgell;25137;Mollerussa;1;1;B;;764;183;376;472;292;4;13;455;468
25;Lleida;27;Pla d'Urgell;25137;Mollerussa;1;2;A;;798;152;388;481;317;1;14;466;480
25;Lleida;27;Pla d'Urgell;25137;Mollerussa;1;2;B;;966;215;503;601;365;2;13;586;599
25;Lleida;27;Pla d'Urgell;25137;Mollerussa;1;3;U;;788;170;347;419;369;7;9;403;412
25;Lleida;27;Pla d'Urgell;25137;Mollerussa;1;4;A;;631;139;298;385;246;4;14;367;381
25;Lleida;27;Pla d'Urgell;25137;Mollerussa;1;4;B;;821;186;432;555;266;3;11;541;552
25;Lleida;27;Pla d'Urgell;25137;Mollerussa;1;5;A;;603;118;277;366;237;7;12;347;359
25;Lleida;27;Pla d'Urgell;25137;Mollerussa;1;5;B;;796;159;337;468;328;9;26;433;459
25;Lleida;27;Pla d'Urgell;25137;Mollerussa;1;6;A;;618;128;278;371;247;0;13;358;371
25;Lleida;27;Pla d'Urgell;25137;Mollerussa;1;6;B;;787;161;354;455;332;0;18;437;455
8;Barcelona;41;Vallès Oriental;08124;Mollet del Vallès;1;1;U;;614;111;231;339;275;1;16;322;338
8;Barcelona;41;Vallès Oriental;08124;Mollet del Vallès;1;2;A;;593;151;278;338;255;1;9;328;337
8;Barcelona;41;Vallès Oriental;08124;Mollet del Vallès;1;2;B;;679;151;285;377;302;1;8;368;376
8;Barcelona;41;Vallès Oriental;08124;Mollet del Vallès;1;3;A;;387;90;164;216;171;2;2;212;214
8;Barcelona;41;Vallès Oriental;08124;Mollet del Vallès;1;3;B;;415;110;181;225;190;1;7;217;224
8;Barcelona;41;Vallès Oriental;08124;Mollet del Vallès;1;3;C;;484;113;212;258;226;3;10;245;255
8;Barcelona;41;Vallès Oriental;08124;Mollet del Vallès;1;4;A;;711;194;363;445;266;4;18;423;441
8;Barcelona;41;Vallès Oriental;08124;Mollet del Vallès;1;4;B;;809;207;428;546;263;4;15;527;542
8;Barcelona;41;Vallès Oriental;08124;Mollet del Vallès;1;5;A;;573;135;240;312;261;1;2;309;311
8;Barcelona;41;Vallès Oriental;08124;Mollet del Vallès;1;5;B;;726;160;275;376;350;6;11;359;370
8;Barcelona;41;Vallès Oriental;08124;Mollet del Vallès;1;6;A;;516;163;259;302;214;2;7;293;300
8;Barcelona;41;Vallès Oriental;08124;Mollet del Vallès;1;6;B;;477;113;227;284;193;4;5;275;280
8;Barcelona;41;Vallès Oriental;08124;Mollet del Vallès;1;6;C;;480;125;224;281;199;1;3;277;280
8;Barcelona;41;Vallès Oriental;08124;Mollet del Vallès;1;7;A;;529;110;194;260;269;2;10;248;258
8;Barcelona;41;Vallès Oriental;08124;Mollet del Vallès;1;7;B;;653;131;250;321;332;3;6;312;318
8;Barcelona;41;Vallès Oriental;08124;Mollet del Vallès;2;1;A;;454;105;212;266;188;1;8;257;265
8;Barcelona;41;Vallès Oriental;08124;Mollet del Vallès;2;1;B;;440;124;225;269;171;1;6;262;268
8;Barcelona;41;Vallès Oriental;08124;Mollet del Vallès;2;1;C;;531;139;262;337;194;1;9;327;336
8;Barcelona;41;Vallès Oriental;08124;Mollet del Vallès;2;2;A;;562;157;293;375;187;4;22;349;371
8;Barcelona;41;Vallès Oriental;08124;Mollet del Vallès;2;2;B;;662;177;297;390;272;2;14;374;388
8;Barcelona;41;Vallès Oriental;08124;Mollet del Vallès;2;3;A;;709;169;310;368;341;3;10;355;365
8;Barcelona;41;Vallès Oriental;08124;Mollet del Vallès;2;3;B;;831;204;362;440;391;2;8;430;438
8;Barcelona;41;Vallès Oriental;08124;Mollet del Vallès;2;4;A;;492;85;204;275;217;0;9;266;275
8;Barcelona;41;Vallès Oriental;08124;Mollet del Vallès;2;4;B;;540;128;235;308;232;0;6;302;308
8;Barcelona;41;Vallès Oriental;08124;Mollet del Vallès;2;5;A;;486;97;202;283;203;1;8;274;282
8;Barcelona;41;Vallès Oriental;08124;Mollet del Vallès;2;5;B;;628;138;282;348;280;2;4;342;346
8;Barcelona;41;Vallès Oriental;08124;Mollet del Vallès;2;6;A;;404;81;147;197;207;1;8;188;196
8;Barcelona;41;Vallès Oriental;08124;Mollet del Vallès;2;6;B;;486;112;199;251;235;1;6;244;250
8;Barcelona;41;Vallès Oriental;08124;Mollet del Vallès;2;7;A;;670;125;282;350;320;1;10;339;349
8;Barcelona;41;Vallès Oriental;08124;Mollet del Vallès;2;7;B;;822;295;466;428;394;8;20;400;420
8;Barcelona;41;Vallès Oriental;08124;Mollet del Vallès;2;8;U;;1066;233;559;696;370;5;23;668;691
8;Barcelona;41;Vallès Oriental;08124;Mollet del Vallès;2;9;U;;778;176;387;510;268;2;22;486;508
8;Barcelona;41;Vallès Oriental;08124;Mollet del Vallès;3;1;A;;510;120;240;281;229;0;8;273;281
8;Barcelona;41;Vallès Oriental;08124;Mollet del Vallès;3;1;B;;523;124;240;287;236;1;13;273;286
8;Barcelona;41;Vallès Oriental;08124;Mollet del Vallès;3;1;C;;522;139;241;285;237;1;10;274;284
8;Barcelona;41;Vallès Oriental;08124;Mollet del Vallès;3;10;U;;981;196;373;489;492;3;18;468;486
8;Barcelona;41;Vallès Oriental;08124;Mollet del Vallès;3;11;A;;588;112;213;291;297;0;12;279;291
8;Barcelona;41;Vallès Oriental;08124;Mollet del Vallès;3;11;B;;662;143;269;339;323;0;16;323;339
8;Barcelona;41;Vallès Oriental;08124;Mollet del Vallès;3;12;A;;602;140;260;325;277;1;9;315;324
8;Barcelona;41;Vallès Oriental;08124;Mollet del Vallès;3;12;B;;686;150;305;397;289;3;13;381;394
8;Barcelona;41;Vallès Oriental;08124;Mollet del Vallès;3;13;A;;343;58;124;172;171;0;11;161;172
8;Barcelona;41;Vallès Oriental;08124;Mollet del Vallès;3;13;B;;396;87;157;207;189;0;11;196;207
8;Barcelona;41;Vallès Oriental;08124;Mollet del Vallès;3;13;C;;367;87;162;207;160;0;5;202;207
8;Barcelona;41;Vallès Oriental;08124;Mollet del Vallès;3;14;A;;492;101;195;250;242;4;8;238;246
8;Barcelona;41;Vallès Oriental;08124;Mollet del Vallès;3;14;B;;586;119;228;292;294;1;8;283;291
8;Barcelona;41;Vallès Oriental;08124;Mollet del Vallès;3;15;A;;440;83;159;203;237;2;4;197;201
8;Barcelona;41;Vallès Oriental;08124;Mollet del Vallès;3;15;B;;525;75;170;238;287;2;7;229;236
8;Barcelona;41;Vallès Oriental;08124;Mollet del Vallès;3;2;A;;583;154;286;349;234;1;14;334;348
8;Barcelona;41;Vallès Oriental;08124;Mollet del Vallès;3;2;B;;681;170;311;375;306;4;13;358;371
8;Barcelona;41;Vallès Oriental;08124;Mollet del Vallès;3;3;A;;428;110;203;252;176;2;14;236;250
8;Barcelona;41;Vallès Oriental;08124;Mollet del Vallès;3;3;B;;447;129;230;281;166;1;7;273;280
8;Barcelona;41;Vallès Oriental;08124;Mollet del Vallès;3;4;A;;683;195;320;397;286;0;8;389;397
8;Barcelona;41;Vallès Oriental;08124;Mollet del Vallès;3;4;B;;731;161;321;407;324;1;21;385;406
8;Barcelona;41;Vallès Oriental;08124;Mollet del Vallès;3;5;A;;685;170;296;395;290;0;21;374;395
8;Barcelona;41;Vallès Oriental;08124;Mollet del Vallès;3;5;B;;866;138;404;549;317;0;24;525;549
8;Barcelona;41;Vallès Oriental;08124;Mollet del Vallès;3;6;A;;360;81;141;168;192;4;2;162;164
8;Barcelona;41;Vallès Oriental;08124;Mollet del Vallès;3;6;B;;429;92;139;167;262;0;4;163;167
8;Barcelona;41;Vallès Oriental;08124;Mollet del Vallès;3;7;A;;398;75;128;170;228;0;6;164;170
8;Barcelona;41;Vallès Oriental;08124;Mollet del Vallès;3;7;B;;477;94;179;229;248;1;4;224;228
8;Barcelona;41;Vallès Oriental;08124;Mollet del Vallès;3;7;C;;534;120;234;273;261;2;6;265;271
8;Barcelona;41;Vallès Oriental;08124;Mollet del Vallès;3;8;U;;651;129;305;368;283;2;15;351;366
8;Barcelona;41;Vallès Oriental;08124;Mollet del Vallès;3;9;A;;337;87;146;176;161;0;5;171;176
8;Barcelona;41;Vallès Oriental;08124;Mollet del Vallès;3;9;B;;403;123;186;226;177;0;6;220;226
17;Girona;2;Alt Empordà;17106;Mollet de Peralada;1;1;U;;130;48;88;98;32;1;1;96;97
17;Girona;31;Ripollès;17107;Molló;1;1;U;;306;80;155;203;103;1;12;190;202
25;Lleida;35;Solsonès;25136;Molsosa, la;1;1;U;;106;37;69;93;13;4;2;87;89
8;Barcelona;;;08128;Monistrol de Calders;1;1;U;;553;143;323;397;156;2;11;384;395
8;Barcelona;7;Bages;08127;Monistrol de Montserrat;1;1;U;;665;161;308;403;262;4;14;385;399
8;Barcelona;7;Bages;08127;Monistrol de Montserrat;1;2;A;;747;162;317;402;345;0;11;391;402
8;Barcelona;7;Bages;08127;Monistrol de Montserrat;1;2;B;;896;181;342;443;453;2;13;428;441
17;Girona;19;Garrotxa;17109;Montagut i Oix;1;1;U;;735;192;366;421;314;3;20;398;418
43;Tarragona;16;Conca de Barberà;43086;Montblanc;1;1;U;;550;128;237;295;255;5;10;280;290
43;Tarragona;16;Conca de Barberà;43086;Montblanc;1;2;U;;566;117;247;332;234;1;17;314;331
43;Tarragona;16;Conca de Barberà;43086;Montblanc;2;1;A;;506;104;237;301;205;3;8;290;298
43;Tarragona;16;Conca de Barberà;43086;Montblanc;2;1;B;;376;70;155;210;166;2;11;197;208
43;Tarragona;16;Conca de Barberà;43086;Montblanc;2;1;C;;529;124;256;333;196;9;13;311;324
43;Tarragona;16;Conca de Barberà;43086;Montblanc;2;2;A;;553;133;255;348;205;5;16;327;343
43;Tarragona;16;Conca de Barberà;43086;Montblanc;2;2;B;;470;102;196;270;200;2;13;255;268
43;Tarragona;16;Conca de Barberà;43086;Montblanc;2;2;C;;655;121;279;369;286;4;14;351;365
43;Tarragona;16;Conca de Barberà;43086;Montblanc;2;3;A;;458;111;230;281;177;0;10;271;281
43;Tarragona;16;Conca de Barberà;43086;Montblanc;2;3;B;;593;125;283;364;229;4;12;348;360
43;Tarragona;8;Baix Camp;43088;Montbrió del Camp;1;1;A;;843;200;433;512;331;5;11;496;507
43;Tarragona;8;Baix Camp;43088;Montbrió del Camp;1;1;B;;880;182;428;556;324;0;8;548;556
8;Barcelona;40;Vallès Occidental;08125;Montcada i Reixac;1;1;U;;856;245;433;526;330;4;8;514;522
8;Barcelona;40;Vallès Occidental;08125;Montcada i Reixac;1;2;U;;1101;296;590;733;368;5;12;716;728
8;Barcelona;40;Vallès Occidental;08125;Montcada i Reixac;1;4;U;;1299;305;598;676;623;3;17;656;673
8;Barcelona;40;Vallès Occidental;08125;Montcada i Reixac;1;5;U;;1127;256;552;685;442;2;23;660;683
8;Barcelona;40;Vallès Occidental;08125;Montcada i Reixac;2;1;U;;967;212;338;403;564;9;8;386;394
8;Barcelona;40;Vallès Occidental;08125;Montcada i Reixac;2;2;A;;804;215;397;465;339;4;11;450;461
8;Barcelona;40;Vallès Occidental;08125;Montcada i Reixac;2;2;B;;971;246;457;542;429;5;20;517;537
8;Barcelona;40;Vallès Occidental;08125;Montcada i Reixac;2;3;A;;789;201;400;490;299;2;12;476;488
8;Barcelona;40;Vallès Occidental;08125;Montcada i Reixac;2;3;B;;921;225;425;566;355;5;20;541;561
8;Barcelona;40;Vallès Occidental;08125;Montcada i Reixac;3;1;A;;745;167;317;410;335;3;7;400;407
8;Barcelona;40;Vallès Occidental;08125;Montcada i Reixac;3;1;B;;869;167;377;468;401;7;11;450;461
8;Barcelona;40;Vallès Occidental;08125;Montcada i Reixac;3;2;A;;1178;251;481;645;533;2;24;619;643
8;Barcelona;40;Vallès Occidental;08125;Montcada i Reixac;3;2;B;;1382;282;566;747;635;3;31;713;744
8;Barcelona;40;Vallès Occidental;08125;Montcada i Reixac;3;3;A;;829;216;366;454;375;2;18;434;452
8;Barcelona;40;Vallès Occidental;08125;Montcada i Reixac;3;3;B;;918;239;416;522;396;0;16;506;522
8;Barcelona;40;Vallès Occidental;08125;Montcada i Reixac;3;4;A;;668;176;305;399;269;4;18;377;395
8;Barcelona;40;Vallès Occidental;08125;Montcada i Reixac;3;4;B;;687;171;315;411;276;3;17;391;408
8;Barcelona;40;Vallès Occidental;08125;Montcada i Reixac;4;1;A;;1083;263;521;643;440;0;17;626;643
8;Barcelona;40;Vallès Occidental;08125;Montcada i Reixac;4;1;B;;1258;307;595;727;531;4;24;699;723
8;Barcelona;40;Vallès Occidental;08125;Montcada i Reixac;5;1;A;;746;172;304;359;387;2;14;343;357
8;Barcelona;40;Vallès Occidental;08125;Montcada i Reixac;5;1;B;;828;170;336;410;418;3;15;392;407
8;Barcelona;40;Vallès Occidental;08125;Montcada i Reixac;5;2;U;;996;205;417;503;493;4;22;477;499
8;Barcelona;40;Vallès Occidental;08125;Montcada i Reixac;5;3;U;;973;173;304;355;618;2;8;345;353
8;Barcelona;40;Vallès Occidental;08125;Montcada i Reixac;6;1;A;;1053;198;468;598;455;2;17;579;596
8;Barcelona;40;Vallès Occidental;08125;Montcada i Reixac;6;1;B;;1194;229;541;635;559;1;22;612;634
8;Barcelona;14;Berguedà;08130;Montclar;1;1;U;;93;25;43;53;40;0;1;52;53
25;Lleida;15;Cerdanya;25139;Montellà i Martinet;1;1;U;;541;152;279;355;186;6;7;342;349
8;Barcelona;24;Osona;08131;Montesquiu;1;1;U;;692;236;405;462;230;9;12;441;453
25;Lleida;4;Alt Urgell;25140;Montferrer i Castellbò;1;1;U;;772;179;374;468;304;1;16;451;467
43;Tarragona;1;Alt Camp;43089;Montferri;1;1;U;;273;65;111;126;147;4;6;116;122
25;Lleida;23;Noguera;25138;Montgai;1;1;A;;403;98;243;287;116;6;7;274;281
25;Lleida;23;Noguera;25138;Montgai;1;1;B;;213;53;106;133;80;1;4;128;132
8;Barcelona;21;Maresme;08126;Montgat;1;1;A;;782;197;413;464;318;2;16;446;462
8;Barcelona;21;Maresme;08126;Montgat;1;1;B;;783;170;385;464;319;2;16;446;462
8;Barcelona;21;Maresme;08126;Montgat;1;1;C;;858;175;414;515;343;0;16;499;515
8;Barcelona;21;Maresme;08126;Montgat;1;2;A;;626;152;303;355;271;2;14;339;353
8;Barcelona;21;Maresme;08126;Montgat;1;2;B;;719;184;339;412;307;1;10;401;411
8;Barcelona;21;Maresme;08126;Montgat;1;2;C;;800;200;338;410;390;0;12;398;410
8;Barcelona;21;Maresme;08126;Montgat;1;3;A;;532;165;282;350;182;1;6;343;349
8;Barcelona;21;Maresme;08126;Montgat;1;3;B;;462;133;233;276;186;1;8;267;275
8;Barcelona;21;Maresme;08126;Montgat;1;3;C;;733;157;385;448;285;2;15;431;446
8;Barcelona;21;Maresme;08126;Montgat;1;3;D;;504;203;255;306;198;1;4;301;305
8;Barcelona;21;Maresme;08126;Montgat;1;4;A;;641;176;343;408;233;0;10;398;408
8;Barcelona;21;Maresme;08126;Montgat;1;4;B;;748;185;403;492;256;5;15;472;487
8;Barcelona;14;Berguedà;08132;Montmajor;1;1;U;;390;103;215;272;118;0;10;262;272
8;Barcelona;6;Anoia;08133;Montmaneu;1;1;U;;160;42;102;115;45;0;3;112;115
43;Tarragona;12;Baix Penedès;43090;Montmell, el;1;1;A;;495;107;181;222;273;2;5;215;220
43;Tarragona;12;Baix Penedès;43090;Montmell, el;1;1;B;;628;130;207;268;360;1;9;258;267
8;Barcelona;41;Vallès Oriental;08135;Montmeló;1;1;A;;608;141;301;377;231;3;9;365;374
8;Barcelona;41;Vallès Oriental;08135;Montmeló;1;1;B;;764;143;347;443;321;2;27;414;441
8;Barcelona;41;Vallès Oriental;08135;Montmeló;1;1;C;;618;127;247;361;257;2;13;346;359
8;Barcelona;41;Vallès Oriental;08135;Montmeló;1;2;A;;512;147;270;323;189;3;7;313;320
8;Barcelona;41;Vallès Oriental;08135;Montmeló;1;2;B;;642;191;342;398;244;2;14;382;396
8;Barcelona;41;Vallès Oriental;08135;Montmeló;1;3;A;;755;208;384;477;278;8;11;458;469
8;Barcelona;41;Vallès Oriental;08135;Montmeló;1;3;B;;939;260;496;618;321;5;14;599;613
8;Barcelona;41;Vallès Oriental;08135;Montmeló;1;4;U;;872;209;427;519;353;2;11;506;517
8;Barcelona;41;Vallès Oriental;08135;Montmeló;1;5;U;;958;225;458;597;361;7;16;574;590
25;Lleida;33;Segrià;25142;Montoliu de Lleida;1;1;U;;391;95;200;245;146;2;10;233;243
25;Lleida;32;Segarra;25141;Montoliu de Segarra;1;1;U;;172;44;76;106;66;0;3;103;106
8;Barcelona;41;Vallès Oriental;08136;Montornès del Vallès;1;1;A;;571;125;281;348;223;0;13;335;348
8;Barcelona;41;Vallès Oriental;08136;Montornès del Vallès;1;1;B;;661;144;286;356;305;0;13;343;356
8;Barcelona;41;Vallès Oriental;08136;Montornès del Vallès;1;2;A;;364;112;180;224;140;2;3;219;222
8;Barcelona;41;Vallès Oriental;08136;Montornès del Vallès;1;2;B;;483;109;203;258;225;2;7;249;256
8;Barcelona;41;Vallès Oriental;08136;Montornès del Vallès;1;2;C;;374;73;158;196;178;1;7;188;195
8;Barcelona;41;Vallès Oriental;08136;Montornès del Vallès;1;3;A;;553;145;250;303;250;2;11;290;301
8;Barcelona;41;Vallès Oriental;08136;Montornès del Vallès;1;3;B;;688;150;300;375;313;4;10;361;371
8;Barcelona;41;Vallès Oriental;08136;Montornès del Vallès;1;3;C;;523;123;230;300;223;2;3;295;298
8;Barcelona;41;Vallès Oriental;08136;Montornès del Vallès;1;4;A;;396;100;199;236;160;1;9;226;235
8;Barcelona;41;Vallès Oriental;08136;Montornès del Vallès;1;4;B;;566;128;265;336;230;2;6;328;334
8;Barcelona;41;Vallès Oriental;08136;Montornès del Vallès;1;4;C;;425;110;210;261;164;1;11;249;260
8;Barcelona;41;Vallès Oriental;08136;Montornès del Vallès;1;5;A;;539;148;259;326;213;1;12;313;325
8;Barcelona;41;Vallès Oriental;08136;Montornès del Vallès;1;5;B;;628;158;287;349;279;2;15;332;347
8;Barcelona;41;Vallès Oriental;08136;Montornès del Vallès;1;5;C;;533;144;263;324;209;2;16;306;322
8;Barcelona;41;Vallès Oriental;08136;Montornès del Vallès;1;6;A;;513;124;256;310;203;2;9;299;308
8;Barcelona;41;Vallès Oriental;08136;Montornès del Vallès;1;6;B;;586;145;289;347;239;4;10;333;343
8;Barcelona;41;Vallès Oriental;08136;Montornès del Vallès;1;7;U;;754;174;355;436;318;2;14;420;434
8;Barcelona;41;Vallès Oriental;08136;Montornès del Vallès;2;1;U;;469;119;188;226;243;1;10;215;225
8;Barcelona;41;Vallès Oriental;08136;Montornès del Vallès;2;2;U;;650;162;301;365;285;3;2;360;362
8;Barcelona;41;Vallès Oriental;08136;Montornès del Vallès;2;3;U;;731;160;296;342;389;6;6;330;336
25;Lleida;32;Segarra;25143;Montornès de Segarra;1;1;U;;92;24;46;60;32;2;1;57;58
43;Tarragona;1;Alt Camp;43091;Mont-ral;1;1;U;;149;37;73;95;54;0;0;95;95
17;Girona;10;Baix Empordà;17110;Mont-ras;1;1;A;;685;197;360;426;259;2;12;412;424
17;Girona;10;Baix Empordà;17110;Mont-ras;1;1;B;;677;172;358;428;249;0;14;414;428
43;Tarragona;8;Baix Camp;43092;Mont-roig del Camp;1;1;A;;596;143;301;352;244;6;9;337;346
43;Tarragona;8;Baix Camp;43092;Mont-roig del Camp;1;1;B;;577;145;290;352;225;6;9;337;346
43;Tarragona;8;Baix Camp;43092;Mont-roig del Camp;1;2;U;;544;120;217;274;270;1;7;266;273
43;Tarragona;8;Baix Camp;43092;Mont-roig del Camp;1;3;U;;896;209;433;573;323;6;10;557;567
43;Tarragona;8;Baix Camp;43092;Mont-roig del Camp;1;4;U;;554;96;160;200;354;0;0;200;200
43;Tarragona;8;Baix Camp;43092;Mont-roig del Camp;1;5;A;;502;109;204;255;247;1;3;251;254
43;Tarragona;8;Baix Camp;43092;Mont-roig del Camp;1;5;B;;624;113;222;289;335;1;7;281;288
43;Tarragona;8;Baix Camp;43092;Mont-roig del Camp;1;6;U;;844;161;226;414;430;1;6;407;413
43;Tarragona;8;Baix Camp;43092;Mont-roig del Camp;1;7;U;;870;171;310;377;493;2;3;372;375
43;Tarragona;8;Baix Camp;43092;Mont-roig del Camp;1;8;U;;959;180;286;360;599;3;6;351;357
8;Barcelona;41;Vallès Oriental;08137;Montseny;1;1;U;;261;74;140;202;59;2;7;193;200
43;Tarragona;30;Ribera d'Ebre;43093;Móra d'Ebre;1;1;A;;619;143;287;399;220;4;13;382;395
43;Tarragona;30;Ribera d'Ebre;43093;Móra d'Ebre;1;1;B;;671;139;294;407;264;7;15;385;400
43;Tarragona;30;Ribera d'Ebre;43093;Móra d'Ebre;1;2;A;;754;153;326;472;282;3;17;452;469
43;Tarragona;30;Ribera d'Ebre;43093;Móra d'Ebre;1;2;B;;772;161;326;473;299;8;17;448;465
43;Tarragona;30;Ribera d'Ebre;43093;Móra d'Ebre;2;1;A;;506;102;225;304;202;1;13;290;303
43;Tarragona;30;Ribera d'Ebre;43093;Móra d'Ebre;2;1;B;;582;112;250;342;240;4;5;333;338
43;Tarragona;30;Ribera d'Ebre;43094;Móra la Nova;1;1;A;;588;151;302;385;203;8;8;369;377
43;Tarragona;30;Ribera d'Ebre;43094;Móra la Nova;1;1;B;;690;177;384;472;218;14;7;451;458
43;Tarragona;30;Ribera d'Ebre;43094;Móra la Nova;2;1;A;;398;105;221;270;128;5;3;262;265
43;Tarragona;30;Ribera d'Ebre;43094;Móra la Nova;2;1;B;;534;130;301;378;156;5;7;366;373
43;Tarragona;36;Tarragonès;43095;Morell, el;1;1;A;;441;107;222;269;172;1;5;263;268
43;Tarragona;36;Tarragonès;43095;Morell, el;1;1;B;;504;121;243;304;200;6;8;290;298
43;Tarragona;36;Tarragonès;43095;Morell, el;1;1;C;;489;104;213;265;224;2;4;259;263
43;Tarragona;36;Tarragonès;43095;Morell, el;1;2;A;;429;96;203;265;164;0;11;254;265
43;Tarragona;36;Tarragonès;43095;Morell, el;1;2;B;;519;136;258;322;197;2;4;316;320
43;Tarragona;29;Priorat;43096;Morera de Montsant, la;1;1;U;;112;44;63;80;32;0;4;76;80
8;Barcelona;24;Osona;08129;Muntanyola;1;1;U;;429;132;230;291;138;0;15;276;291
8;Barcelona;7;Bages;08139;Mura;1;1;U;;187;51;93;146;41;1;5;140;145
25;Lleida;38;Urgell;25145;Nalec;1;1;U;;89;31;53;69;20;0;1;68;69
25;Lleida;39;Consell General d'Aran;25025;Naut Aran;1;1;A;;809;130;323;453;356;0;15;438;453
25;Lleida;39;Consell General d'Aran;25025;Naut Aran;1;1;B;;477;87;232;300;177;4;9;287;296
8;Barcelona;7;Bages;08140;Navarcles;1;1;A;;658;160;349;406;252;1;8;397;405
8;Barcelona;7;Bages;08140;Navarcles;1;1;B;;754;193;387;454;300;3;11;440;451
8;Barcelona;7;Bages;08140;Navarcles;1;2;A;;751;165;381;485;266;5;8;472;480
8;Barcelona;7;Bages;08140;Navarcles;1;2;B;;870;194;431;545;325;6;15;524;539
8;Barcelona;7;Bages;08140;Navarcles;1;3;A;;734;205;392;470;264;5;18;447;465
8;Barcelona;7;Bages;08140;Navarcles;1;3;B;;909;228;465;575;334;4;17;554;571
8;Barcelona;7;Bages;08141;Navàs;1;1;A;;427;130;240;293;134;4;11;278;289
8;Barcelona;7;Bages;08141;Navàs;1;1;B;;529;158;308;375;154;5;7;363;370
8;Barcelona;7;Bages;08141;Navàs;1;2;U;;582;168;321;411;171;0;7;404;411
8;Barcelona;7;Bages;08141;Navàs;1;3;A;;595;165;292;354;241;1;10;343;353
8;Barcelona;7;Bages;08141;Navàs;1;3;B;;523;120;237;300;223;8;8;284;292
8;Barcelona;7;Bages;08141;Navàs;1;3;C;;682;143;319;394;288;5;8;381;389
8;Barcelona;7;Bages;08141;Navàs;1;4;A;;503;152;305;343;160;3;10;330;340
8;Barcelona;7;Bages;08141;Navàs;1;4;B;;622;172;348;437;185;15;9;413;422
8;Barcelona;7;Bages;08141;Navàs;2;1;U;;210;79;128;148;62;7;1;140;141
17;Girona;2;Alt Empordà;17111;Navata;1;1;U;;782;188;457;557;225;2;24;531;555
25;Lleida;35;Solsonès;25146;Navès;1;1;U;;216;57;116;155;61;2;7;146;153
8;Barcelona;14;Berguedà;08142;Nou de Berguedà, la;1;1;U;;124;39;76;95;29;0;7;88;95
43;Tarragona;36;Tarragonès;43097;Nou de Gaià, la;1;1;U;;373;107;232;277;96;2;3;272;275
43;Tarragona;1;Alt Camp;43098;Nulles;1;1;U;;368;100;191;251;117;0;5;246;251
25;Lleida;35;Solsonès;25148;Odèn;1;1;U;;228;40;113;160;68;0;3;157;160
8;Barcelona;6;Anoia;08143;Òdena;1;1;A;;260;62;160;198;62;0;5;193;198
8;Barcelona;6;Anoia;08143;Òdena;1;1;B;;454;110;233;294;160;1;5;288;293
8;Barcelona;6;Anoia;08143;Òdena;1;1;C;;485;95;246;293;192;1;6;286;292
8;Barcelona;6;Anoia;08143;Òdena;1;1;D;;487;113;253;324;163;1;16;307;323
8;Barcelona;6;Anoia;08143;Òdena;1;2;A;;429;87;204;247;182;1;6;240;246
8;Barcelona;6;Anoia;08143;Òdena;1;2;B;;497;102;213;272;225;3;13;256;269
17;Girona;31;Ripollès;17112;Ogassa;1;1;U;;217;68;115;153;64;0;1;152;153
8;Barcelona;3;Alt Penedès;08145;Olèrdola;1;1;A;;749;186;339;433;316;1;6;426;432
8;Barcelona;3;Alt Penedès;08145;Olèrdola;1;1;B;;770;168;366;471;299;4;10;457;467
8;Barcelona;3;Alt Penedès;08145;Olèrdola;1;2;A;;508;120;300;367;141;6;7;354;361
8;Barcelona;3;Alt Penedès;08145;Olèrdola;1;2;B;;540;154;332;416;124;8;14;394;408
8;Barcelona;3;Alt Penedès;08146;Olesa de Bonesvalls;1;1;A;;624;193;287;332;292;2;10;320;330
8;Barcelona;3;Alt Penedès;08146;Olesa de Bonesvalls;1;1;B;;694;197;317;375;319;1;10;364;374
8;Barcelona;11;Baix Llobregat;08147;Olesa de Montserrat;1;1;A;;711;159;281;363;348;1;6;356;362
8;Barcelona;11;Baix Llobregat;08147;Olesa de Montserrat;1;1;B;;724;140;269;344;380;5;9;330;339
8;Barcelona;11;Baix Llobregat;08147;Olesa de Montserrat;1;1;C;;897;184;375;473;424;1;13;459;472
8;Barcelona;11;Baix Llobregat;08147;Olesa de Montserrat;1;1;D;;763;155;296;386;377;4;12;370;382
8;Barcelona;11;Baix Llobregat;08147;Olesa de Montserrat;1;2;A;;491;147;228;293;198;5;7;281;288
8;Barcelona;11;Baix Llobregat;08147;Olesa de Montserrat;1;2;B;;592;138;253;336;256;4;10;322;332
8;Barcelona;11;Baix Llobregat;08147;Olesa de Montserrat;1;2;C;;489;109;212;282;207;3;5;274;279
8;Barcelona;11;Baix Llobregat;08147;Olesa de Montserrat;1;3;A;;479;137;257;312;167;1;6;305;311
8;Barcelona;11;Baix Llobregat;08147;Olesa de Montserrat;1;3;B;;465;156;275;308;157;0;14;294;308
8;Barcelona;11;Baix Llobregat;08147;Olesa de Montserrat;1;4;A;;566;136;300;397;169;12;9;376;385
8;Barcelona;11;Baix Llobregat;08147;Olesa de Montserrat;1;4;B;;569;149;280;355;214;0;12;343;355
8;Barcelona;11;Baix Llobregat;08147;Olesa de Montserrat;1;4;C;;538;141;274;358;180;4;11;343;354
8;Barcelona;11;Baix Llobregat;08147;Olesa de Montserrat;1;5;A;;641;158;288;372;269;3;8;361;369
8;Barcelona;11;Baix Llobregat;08147;Olesa de Montserrat;1;5;B;;591;139;262;339;252;2;7;330;337
8;Barcelona;11;Baix Llobregat;08147;Olesa de Montserrat;1;5;C;;758;152;311;422;336;4;16;402;418
8;Barcelona;11;Baix Llobregat;08147;Olesa de Montserrat;1;5;D;;599;119;235;340;259;3;18;319;337
8;Barcelona;11;Baix Llobregat;08147;Olesa de Montserrat;1;6;A;;632;138;250;345;287;2;9;334;343
8;Barcelona;11;Baix Llobregat;08147;Olesa de Montserrat;1;6;B;;610;123;283;314;296;4;9;301;310
8;Barcelona;11;Baix Llobregat;08147;Olesa de Montserrat;1;6;C;;789;178;326;439;350;2;22;415;437
8;Barcelona;11;Baix Llobregat;08147;Olesa de Montserrat;1;6;D;;641;150;283;368;273;1;15;352;367
8;Barcelona;11;Baix Llobregat;08147;Olesa de Montserrat;1;7;A;;635;150;287;340;295;3;7;330;337
8;Barcelona;11;Baix Llobregat;08147;Olesa de Montserrat;1;7;B;;758;121;285;374;384;6;6;362;368
8;Barcelona;11;Baix Llobregat;08147;Olesa de Montserrat;1;8;A;;517;139;283;342;175;4;9;329;338
8;Barcelona;11;Baix Llobregat;08147;Olesa de Montserrat;1;8;B;;623;159;297;362;261;0;4;358;362
8;Barcelona;11;Baix Llobregat;08147;Olesa de Montserrat;1;8;C;;570;148;283;342;228;3;13;326;339
8;Barcelona;11;Baix Llobregat;08147;Olesa de Montserrat;1;9;A;;660;154;298;400;260;2;12;386;398
8;Barcelona;11;Baix Llobregat;08147;Olesa de Montserrat;1;9;B;;677;141;304;401;276;4;18;379;397
25;Lleida;4;Alt Urgell;25149;Oliana;1;1;A;;643;182;398;468;175;3;9;456;465
25;Lleida;4;Alt Urgell;25149;Oliana;1;1;B;;787;187;477;584;203;8;6;570;576
25;Lleida;23;Noguera;25150;Oliola;1;1;U;;190;68;117;139;51;0;6;133;139
25;Lleida;35;Solsonès;25151;Olius;1;1;U;;647;165;358;451;196;12;12;427;439
8;Barcelona;17;Garraf;08148;Olivella;1;1;A;;1015;237;411;495;520;2;2;491;493
8;Barcelona;17;Garraf;08148;Olivella;1;1;B;;925;225;398;463;462;4;16;443;459
8;Barcelona;17;Garraf;08148;Olivella;1;1;C;;223;37;85;106;117;0;3;103;106
8;Barcelona;24;Osona;08149;Olost;1;1;A;;430;86;263;321;109;2;11;308;319
8;Barcelona;24;Osona;08149;Olost;1;1;B;;563;136;363;420;143;2;10;408;418
17;Girona;19;Garrotxa;17114;Olot;1;1;A;;576;142;260;307;269;1;4;302;306
17;Girona;19;Garrotxa;17114;Olot;1;1;B;;503;122;221;262;241;2;3;257;260
17;Girona;19;Garrotxa;17114;Olot;1;2;U;;683;208;362;413;270;3;20;390;410
17;Girona;19;Garrotxa;17114;Olot;1;3;U;;766;6;451;513;253;4;13;496;509
17;Girona;19;Garrotxa;17114;Olot;1;4;U;;639;199;388;476;163;2;10;464;474
17;Girona;19;Garrotxa;17114;Olot;1;5;U;;549;211;330;385;164;3;19;363;382
17;Girona;19;Garrotxa;17114;Olot;1;6;U;;546;203;294;352;194;1;17;334;351
17;Girona;19;Garrotxa;17114;Olot;1;7;A;;542;186;309;351;191;1;10;340;350
17;Girona;19;Garrotxa;17114;Olot;1;7;B;;540;194;293;335;205;2;8;325;333
17;Girona;19;Garrotxa;17114;Olot;2;1;A;;866;240;486;553;313;1;18;534;552
17;Girona;19;Garrotxa;17114;Olot;2;1;B;;818;247;484;551;267;2;23;526;549
17;Girona;19;Garrotxa;17114;Olot;2;2;A;;787;198;411;478;309;7;16;455;471
17;Girona;19;Garrotxa;17114;Olot;2;2;B;;734;216;411;495;239;4;13;478;491
17;Girona;19;Garrotxa;17114;Olot;2;3;A;;541;142;258;306;235;4;8;294;302
17;Girona;19;Garrotxa;17114;Olot;2;3;B;;538;136;248;296;242;4;8;284;292
17;Girona;19;Garrotxa;17114;Olot;2;4;U;;925;218;413;493;432;5;18;470;488
17;Girona;19;Garrotxa;17114;Olot;2;5;U;;1004;237;484;562;442;10;12;540;552
17;Girona;19;Garrotxa;17114;Olot;3;1;U;;615;131;295;346;269;6;12;328;340
17;Girona;19;Garrotxa;17114;Olot;3;2;A;;666;204;389;448;218;3;9;436;445
17;Girona;19;Garrotxa;17114;Olot;3;2;B;;665;210;386;442;223;4;8;430;438
17;Girona;19;Garrotxa;17114;Olot;3;3;A;;873;250;461;567;306;3;16;548;564
17;Girona;19;Garrotxa;17114;Olot;3;3;B;;859;259;430;522;337;6;8;508;516
17;Girona;19;Garrotxa;17114;Olot;4;1;U;;992;198;451;556;436;4;23;529;552
17;Girona;19;Garrotxa;17114;Olot;4;2;A;;739;208;357;424;315;6;6;412;418
17;Girona;19;Garrotxa;17114;Olot;4;2;B;;675;193;333;384;291;3;14;367;381
17;Girona;19;Garrotxa;17114;Olot;5;1;U;;955;275;484;572;383;8;18;546;564
17;Girona;19;Garrotxa;17114;Olot;5;2;A;;537;165;330;390;147;4;17;369;386
17;Girona;19;Garrotxa;17114;Olot;5;2;B;;522;174;328;368;154;2;23;343;366
17;Girona;19;Garrotxa;17114;Olot;5;3;A;;807;238;427;490;317;2;18;470;488
17;Girona;19;Garrotxa;17114;Olot;5;3;B;;855;241;463;538;317;10;17;511;528
17;Girona;19;Garrotxa;17114;Olot;5;4;A;;592;160;359;411;181;2;18;391;409
17;Girona;19;Garrotxa;17114;Olot;5;4;B;;626;150;332;409;217;1;22;386;408
25;Lleida;32;Segarra;25152;Oluges, les;1;1;U;;163;34;76;91;72;1;5;85;90
8;Barcelona;14;Berguedà;08144;Olvan;1;1;A;;392;79;205;261;131;7;6;248;254
8;Barcelona;14;Berguedà;08144;Olvan;1;1;B;;364;114;210;244;120;3;8;233;241
25;Lleida;18;Garrigues;25153;Omellons, els;1;1;U;;216;69;114;137;79;4;1;132;133
25;Lleida;38;Urgell;25154;Omells de na Gaia, els;1;1;U;;122;32;61;74;48;0;3;71;74
17;Girona;2;Alt Empordà;17115;Ordis;1;1;U;;268;94;168;197;71;2;9;186;195
25;Lleida;4;Alt Urgell;25155;Organyà;1;1;U;;727;243;433;491;236;5;16;470;486
8;Barcelona;24;Osona;08150;Orís;1;1;U;;236;78;142;179;57;3;9;167;176
8;Barcelona;24;Osona;08151;Oristà;1;1;U;;509;128;312;375;134;1;4;370;374
8;Barcelona;6;Anoia;08152;Orpí;1;1;U;;133;29;70;86;47;1;4;81;85
8;Barcelona;21;Maresme;08153;Òrrius;1;1;U;;499;153;312;365;134;4;8;353;361
25;Lleida;23;Noguera;25156;Os de Balaguer;1;1;A;;376;88;198;261;115;0;10;251;261
25;Lleida;23;Noguera;25156;Os de Balaguer;1;1;B;;385;127;215;256;129;5;12;239;251
17;Girona;34;Selva;17116;Osor;1;1;U;;362;101;208;238;124;1;3;234;237
25;Lleida;38;Urgell;25157;Ossó de Sió;1;1;U;;189;62;100;126;63;0;2;124;126
8;Barcelona;3;Alt Penedès;08154;Pacs del Penedès;1;1;U;;684;178;370;485;199;1;13;471;484
8;Barcelona;21;Maresme;08155;Palafolls;1;1;A;;795;190;373;463;332;3;8;452;460
8;Barcelona;21;Maresme;08155;Palafolls;1;1;B;;1133;262;603;734;399;7;21;706;727
8;Barcelona;21;Maresme;08155;Palafolls;1;2;U;;961;240;482;566;395;0;22;544;566
8;Barcelona;21;Maresme;08155;Palafolls;1;3;A;;742;156;452;394;348;3;12;379;391
8;Barcelona;21;Maresme;08155;Palafolls;1;3;B;;804;146;375;443;361;2;9;432;441
8;Barcelona;21;Maresme;08155;Palafolls;1;4;A;;528;120;228;301;227;4;8;289;297
8;Barcelona;21;Maresme;08155;Palafolls;1;4;B;;678;161;309;392;286;11;3;378;381
8;Barcelona;21;Maresme;08155;Palafolls;1;5;U;;867;176;353;437;430;7;7;423;430
17;Girona;10;Baix Empordà;17117;Palafrugell;1;1;A;;764;208;347;414;350;16;5;393;398
17;Girona;10;Baix Empordà;17117;Palafrugell;1;1;B;;689;216;327;384;305;9;8;367;375
17;Girona;10;Baix Empordà;17117;Palafrugell;1;2;A;;651;149;293;334;317;1;16;317;333
17;Girona;10;Baix Empordà;17117;Palafrugell;1;2;B;;643;165;318;366;277;1;15;350;365
17;Girona;10;Baix Empordà;17117;Palafrugell;1;3;A;;542;138;351;304;238;3;12;289;301
17;Girona;10;Baix Empordà;17117;Palafrugell;1;3;B;;503;112;224;272;231;4;4;264;268
17;Girona;10;Baix Empordà;17117;Palafrugell;1;4;A;;649;178;321;396;253;4;8;384;392
17;Girona;10;Baix Empordà;17117;Palafrugell;1;4;B;;634;168;320;371;263;3;4;364;368
17;Girona;10;Baix Empordà;17117;Palafrugell;1;5;U;;774;230;375;449;325;2;13;434;447
17;Girona;10;Baix Empordà;17117;Palafrugell;2;1;A;;800;186;385;466;334;2;20;444;464
17;Girona;10;Baix Empordà;17117;Palafrugell;2;1;B;;765;225;352;421;344;5;17;399;416
17;Girona;10;Baix Empordà;17117;Palafrugell;2;2;A;;724;168;323;376;348;5;14;357;371
17;Girona;10;Baix Empordà;17117;Palafrugell;2;2;B;;682;174;316;364;318;3;8;353;361
17;Girona;10;Baix Empordà;17117;Palafrugell;2;3;A;;887;183;346;412;475;1;11;400;411
17;Girona;10;Baix Empordà;17117;Palafrugell;2;3;B;;776;215;438;504;272;1;17;486;503
17;Girona;10;Baix Empordà;17117;Palafrugell;3;1;U;;978;268;456;548;430;11;13;524;537
17;Girona;10;Baix Empordà;17117;Palafrugell;3;2;A;;659;176;340;396;263;3;19;374;393
17;Girona;10;Baix Empordà;17117;Palafrugell;3;2;B;;625;141;315;369;256;1;8;360;368
17;Girona;10;Baix Empordà;17117;Palafrugell;3;2;C;;237;55;124;149;88;1;7;141;148
17;Girona;10;Baix Empordà;17117;Palafrugell;3;3;U;;904;184;422;463;441;2;20;441;461
17;Girona;10;Baix Empordà;17118;Palamós;1;1;A;;636;188;326;367;269;1;8;358;366
17;Girona;10;Baix Empordà;17118;Palamós;1;1;B;;612;190;326;387;225;3;12;372;384
17;Girona;10;Baix Empordà;17118;Palamós;1;2;A;;659;193;338;398;261;2;9;387;396
17;Girona;10;Baix Empordà;17118;Palamós;1;2;B;;625;173;320;386;239;1;14;371;385
17;Girona;10;Baix Empordà;17118;Palamós;1;3;A;;548;150;269;311;237;1;7;303;310
17;Girona;10;Baix Empordà;17118;Palamós;1;3;B;;550;152;274;330;220;2;12;316;328
17;Girona;10;Baix Empordà;17118;Palamós;1;4;U;;669;190;347;400;269;1;8;391;399
17;Girona;10;Baix Empordà;17118;Palamós;2;1;U;;895;256;473;559;336;8;15;536;551
17;Girona;10;Baix Empordà;17118;Palamós;2;2;A;;556;169;295;337;219;1;9;327;336
17;Girona;10;Baix Empordà;17118;Palamós;2;2;B;;603;171;311;367;236;1;14;352;366
17;Girona;10;Baix Empordà;17118;Palamós;3;1;A;;411;113;198;236;175;1;8;227;235
17;Girona;10;Baix Empordà;17118;Palamós;3;1;B;;763;218;368;444;319;1;22;421;443
17;Girona;10;Baix Empordà;17118;Palamós;3;2;A;;563;119;240;287;276;5;5;277;282
17;Girona;10;Baix Empordà;17118;Palamós;3;2;B;;583;145;271;318;265;5;11;302;313
17;Girona;10;Baix Empordà;17118;Palamós;3;3;A;;775;211;381;462;313;3;10;449;459
17;Girona;10;Baix Empordà;17118;Palamós;3;3;B;;754;203;353;436;318;2;17;417;434
17;Girona;10;Baix Empordà;17118;Palamós;4;1;A;;632;151;277;337;295;3;6;328;334
17;Girona;10;Baix Empordà;17118;Palamós;4;1;B;;633;140;271;325;308;1;13;311;324
17;Girona;10;Baix Empordà;17118;Palamós;4;2;U;;974;230;481;557;417;2;18;537;555
25;Lleida;27;Pla d'Urgell;25158;Palau d'Anglesola, el;1;1;A;;746;144;357;479;267;4;19;456;475
25;Lleida;27;Pla d'Urgell;25158;Palau d'Anglesola, el;1;1;B;;888;206;465;614;274;8;16;590;606
17;Girona;2;Alt Empordà;17119;Palau de Santa Eulàlia;1;1;U;;86;28;46;56;30;0;2;54;56
17;Girona;10;Baix Empordà;17121;Palau-sator;1;1;U;;234;68;123;152;82;0;9;143;152
17;Girona;2;Alt Empordà;17120;Palau-saverdera;1;1;U;;779;238;461;527;252;6;7;514;521
8;Barcelona;40;Vallès Occidental;08156;Palau-solità i Plegamans;1;1;A;;334;89;157;182;152;0;0;182;182
8;Barcelona;40;Vallès Occidental;08156;Palau-solità i Plegamans;1;1;B;;429;103;190;226;203;1;6;219;225
8;Barcelona;40;Vallès Occidental;08156;Palau-solità i Plegamans;1;1;C;;371;107;178;213;158;9;0;204;204
8;Barcelona;40;Vallès Occidental;08156;Palau-solità i Plegamans;1;2;A;;582;140;243;324;258;1;12;311;323
8;Barcelona;40;Vallès Occidental;08156;Palau-solità i Plegamans;1;2;B;;666;167;306;375;291;2;6;367;373
8;Barcelona;40;Vallès Occidental;08156;Palau-solità i Plegamans;1;2;C;;511;123;238;302;209;4;7;291;298
8;Barcelona;40;Vallès Occidental;08156;Palau-solità i Plegamans;1;3;A;;596;164;286;353;243;0;20;333;353
8;Barcelona;40;Vallès Occidental;08156;Palau-solità i Plegamans;1;3;B;;690;188;311;416;274;3;17;396;413
8;Barcelona;40;Vallès Occidental;08156;Palau-solità i Plegamans;1;4;A;;541;112;254;327;214;3;8;316;324
8;Barcelona;40;Vallès Occidental;08156;Palau-solità i Plegamans;1;4;B;;655;160;329;416;239;4;15;397;412
8;Barcelona;40;Vallès Occidental;08156;Palau-solità i Plegamans;1;4;C;;600;145;301;387;213;7;13;367;380
8;Barcelona;40;Vallès Occidental;08156;Palau-solità i Plegamans;1;5;U;;849;274;447;559;290;8;23;528;551
8;Barcelona;40;Vallès Occidental;08156;Palau-solità i Plegamans;1;6;A;;718;147;306;403;315;2;14;387;401
8;Barcelona;40;Vallès Occidental;08156;Palau-solità i Plegamans;1;6;B;;730;185;335;426;304;8;12;406;418
8;Barcelona;40;Vallès Occidental;08156;Palau-solità i Plegamans;1;7;A;;493;170;283;326;167;1;14;311;325
8;Barcelona;40;Vallès Occidental;08156;Palau-solità i Plegamans;1;7;B;;600;185;313;381;219;5;8;368;376
8;Barcelona;40;Vallès Occidental;08156;Palau-solità i Plegamans;1;8;A;;542;127;237;297;245;4;0;293;293
8;Barcelona;40;Vallès Occidental;08156;Palau-solità i Plegamans;1;8;B;;598;159;313;364;234;8;3;353;356
43;Tarragona;36;Tarragonès;43100;Pallaresos, els;1;1;A;;489;107;224;306;183;4;9;293;302
43;Tarragona;36;Tarragonès;43100;Pallaresos, els;1;1;B;;592;152;287;371;221;3;8;360;368
43;Tarragona;36;Tarragonès;43100;Pallaresos, els;1;2;A;;549;134;267;326;223;4;8;314;322
43;Tarragona;36;Tarragonès;43100;Pallaresos, els;1;2;B;;679;115;281;351;328;7;18;326;344
43;Tarragona;36;Tarragonès;43100;Pallaresos, els;1;2;C;;647;136;289;370;277;2;15;353;368
8;Barcelona;11;Baix Llobregat;08157;Pallejà;1;1;A;;559;117;266;339;220;8;3;328;331
8;Barcelona;11;Baix Llobregat;08157;Pallejà;1;1;B;;685;158;317;401;284;6;7;388;395
8;Barcelona;11;Baix Llobregat;08157;Pallejà;1;1;C;;574;131;268;349;225;3;8;338;346
8;Barcelona;11;Baix Llobregat;08157;Pallejà;1;2;A;;494;115;217;283;211;3;7;273;280
8;Barcelona;11;Baix Llobregat;08157;Pallejà;1;2;B;;688;148;264;377;311;5;5;367;372
8;Barcelona;11;Baix Llobregat;08157;Pallejà;1;2;C;;574;127;316;316;258;3;15;298;313
8;Barcelona;11;Baix Llobregat;08157;Pallejà;1;3;A;;748;183;339;441;307;2;8;431;439
8;Barcelona;11;Baix Llobregat;08157;Pallejà;1;3;B;;796;188;392;481;315;5;6;470;476
8;Barcelona;11;Baix Llobregat;08157;Pallejà;1;4;A;;633;151;347;426;207;1;18;407;425
8;Barcelona;11;Baix Llobregat;08157;Pallejà;1;4;B;;682;173;392;473;209;1;16;456;472
8;Barcelona;11;Baix Llobregat;08157;Pallejà;1;5;A;;566;128;285;368;198;3;17;348;365
8;Barcelona;11;Baix Llobregat;08157;Pallejà;1;5;B;;649;159;304;390;259;4;11;375;386
8;Barcelona;11;Baix Llobregat;08157;Pallejà;1;5;C;;557;147;267;325;232;1;4;320;324
43;Tarragona;30;Ribera d'Ebre;43099;Palma d'Ebre, la;1;1;U;;344;79;185;250;94;2;5;243;248
8;Barcelona;11;Baix Llobregat;08905;Palma de Cervelló, la;1;1;A;;584;165;343;424;160;3;23;398;421
8;Barcelona;11;Baix Llobregat;08905;Palma de Cervelló, la;1;1;B;;619;155;337;420;199;5;14;401;415
8;Barcelona;11;Baix Llobregat;08905;Palma de Cervelló, la;1;2;A;;453;112;225;299;154;1;6;292;298
8;Barcelona;11;Baix Llobregat;08905;Palma de Cervelló, la;1;2;B;;589;146;331;417;172;1;9;407;416
17;Girona;28;Pla de l'Estany;17123;Palol de Revardit;1;1;U;;368;110;232;284;84;8;4;272;276
17;Girona;10;Baix Empordà;17124;Pals;1;1;A;;855;237;482;557;298;2;17;538;555
17;Girona;10;Baix Empordà;17124;Pals;1;1;B;;806;216;438;518;288;1;18;499;517
8;Barcelona;11;Baix Llobregat;08158;Papiol, el;1;1;A;;794;148;388;502;292;4;11;487;498
8;Barcelona;11;Baix Llobregat;08158;Papiol, el;1;1;B;;848;131;384;503;345;2;17;484;501
8;Barcelona;11;Baix Llobregat;08158;Papiol, el;1;2;A;;618;83;296;371;247;2;9;360;369
8;Barcelona;11;Baix Llobregat;08158;Papiol, el;1;2;B;;690;114;354;425;265;6;12;407;419
17;Girona;31;Ripollès;17125;Pardines;1;1;U;;126;23;69;85;41;0;1;84;85
8;Barcelona;41;Vallès Oriental;08159;Parets del Vallès;1;1;A;;563;122;262;313;250;1;10;302;312
8;Barcelona;41;Vallès Oriental;08159;Parets del Vallès;1;1;B;;622;157;307;364;258;2;10;352;362
8;Barcelona;41;Vallès Oriental;08159;Parets del Vallès;1;2;A;;630;138;281;349;281;4;10;335;345
8;Barcelona;41;Vallès Oriental;08159;Parets del Vallès;1;2;B;;834;212;420;511;323;7;10;494;504
8;Barcelona;41;Vallès Oriental;08159;Parets del Vallès;1;3;A;;442;108;216;262;180;2;10;250;260
8;Barcelona;41;Vallès Oriental;08159;Parets del Vallès;1;3;B;;515;128;247;309;206;0;15;294;309
8;Barcelona;41;Vallès Oriental;08159;Parets del Vallès;1;4;A;;368;83;181;229;139;4;8;217;225
8;Barcelona;41;Vallès Oriental;08159;Parets del Vallès;1;4;B;;429;95;188;249;180;0;11;238;249
8;Barcelona;41;Vallès Oriental;08159;Parets del Vallès;2;1;A;;441;103;203;249;192;2;15;232;247
8;Barcelona;41;Vallès Oriental;08159;Parets del Vallès;2;1;B;;536;105;252;307;229;4;12;291;303
8;Barcelona;41;Vallès Oriental;08159;Parets del Vallès;2;2;A;;426;77;187;236;190;0;6;230;236
8;Barcelona;41;Vallès Oriental;08159;Parets del Vallès;2;2;B;;434;89;210;258;176;1;11;246;257
8;Barcelona;41;Vallès Oriental;08159;Parets del Vallès;2;3;A;;799;183;340;435;364;2;10;423;433
8;Barcelona;41;Vallès Oriental;08159;Parets del Vallès;2;3;B;;907;202;384;507;400;6;10;491;501
8;Barcelona;41;Vallès Oriental;08159;Parets del Vallès;2;4;A;;534;128;253;312;222;2;14;296;310
8;Barcelona;41;Vallès Oriental;08159;Parets del Vallès;2;4;B;;679;139;294;370;309;1;12;357;369
8;Barcelona;41;Vallès Oriental;08159;Parets del Vallès;2;5;A;;445;93;195;268;177;1;13;254;267
8;Barcelona;41;Vallès Oriental;08159;Parets del Vallès;2;5;B;;502;115;257;314;188;1;26;287;313
8;Barcelona;41;Vallès Oriental;08159;Parets del Vallès;2;6;A;;797;183;357;447;350;5;21;421;442
8;Barcelona;41;Vallès Oriental;08159;Parets del Vallès;2;6;B;;949;212;418;529;420;2;11;516;527
8;Barcelona;41;Vallès Oriental;08159;Parets del Vallès;2;7;A;;611;127;255;347;264;1;12;334;346
8;Barcelona;41;Vallès Oriental;08159;Parets del Vallès;2;7;B;;776;200;373;461;315;2;11;448;459
17;Girona;10;Baix Empordà;17126;Parlavà;1;1;U;;311;107;203;234;77;3;14;217;231
43;Tarragona;16;Conca de Barberà;43101;Passanant i Belltall;1;1;U;;138;47;70;85;53;0;1;84;85
17;Girona;2;Alt Empordà;17128;Pau;1;1;U;;303;96;182;216;87;0;4;212;216
43;Tarragona;9;Baix Ebre;43102;Paüls;1;1;U;;504;119;316;391;113;10;2;379;381
17;Girona;2;Alt Empordà;17129;Pedret i Marzà;1;1;U;;124;49;80;90;34;0;2;88;90
25;Lleida;23;Noguera;25164;Penelles;1;1;U;;402;81;207;254;148;0;11;243;254
17;Girona;10;Baix Empordà;17130;Pera, la;1;1;U;;339;90;186;247;92;2;9;236;245
8;Barcelona;24;Osona;08160;Perafita;1;1;U;;314;127;204;230;84;0;9;221;230
43;Tarragona;36;Tarragonès;43103;Perafort;1;1;U;;889;220;406;522;367;2;16;504;520
17;Girona;2;Alt Empordà;17132;Peralada;1;1;A;;1070;323;646;735;335;4;24;707;731
17;Girona;2;Alt Empordà;17132;Peralada;1;1;B;;209;63;123;141;68;3;4;134;138
25;Lleida;4;Alt Urgell;25165;Peramola;1;1;U;;312;92;193;222;90;7;9;206;215
43;Tarragona;9;Baix Ebre;43104;Perelló, el;1;1;U;;599;177;291;380;219;5;8;367;375
43;Tarragona;9;Baix Ebre;43104;Perelló, el;1;2;A;;535;146;261;366;169;12;9;345;354
43;Tarragona;9;Baix Ebre;43104;Perelló, el;1;2;B;;667;181;322;451;216;1;17;433;450
8;Barcelona;6;Anoia;08161;Piera;1;1;U;;846;185;361;442;404;3;23;416;439
8;Barcelona;6;Anoia;08161;Piera;1;2;A;;1016;229;420;537;479;4;12;521;533
8;Barcelona;6;Anoia;08161;Piera;1;2;B;;1057;245;457;578;479;9;18;551;569
8;Barcelona;6;Anoia;08161;Piera;1;3;A;;786;203;375;461;325;0;13;448;461
8;Barcelona;6;Anoia;08161;Piera;1;3;B;;929;200;401;513;416;5;14;494;508
8;Barcelona;6;Anoia;08161;Piera;1;4;A;;223;75;138;171;52;1;6;164;170
8;Barcelona;6;Anoia;08161;Piera;1;4;B;;1094;233;457;536;558;1;9;526;535
8;Barcelona;6;Anoia;08161;Piera;1;5;A;;924;271;491;441;483;2;9;430;439
8;Barcelona;6;Anoia;08161;Piera;1;5;B;;1197;193;352;600;597;4;22;574;596
8;Barcelona;6;Anoia;08161;Piera;1;6;U;;1012;240;401;483;529;1;11;471;482
8;Barcelona;6;Anoia;08161;Piera;1;7;U;;621;142;272;330;291;2;2;326;328
8;Barcelona;6;Anoia;08161;Piera;1;8;U;;1107;213;422;542;565;1;9;532;541
43;Tarragona;16;Conca de Barberà;43105;Piles, les;1;1;U;;179;40;100;115;64;5;8;102;110
8;Barcelona;21;Maresme;08163;Pineda de Mar;1;1;A;;718;203;344;420;298;2;12;406;418
8;Barcelona;21;Maresme;08163;Pineda de Mar;1;1;B;;827;257;397;483;344;3;17;463;480
8;Barcelona;21;Maresme;08163;Pineda de Mar;1;10;A;;464;115;210;253;211;0;5;248;253
8;Barcelona;21;Maresme;08163;Pineda de Mar;1;10;B;;555;152;254;300;255;1;11;288;299
8;Barcelona;21;Maresme;08163;Pineda de Mar;1;11;A;;448;140;225;274;174;0;8;266;274
8;Barcelona;21;Maresme;08163;Pineda de Mar;1;11;B;;580;195;290;361;219;7;2;352;354
8;Barcelona;21;Maresme;08163;Pineda de Mar;1;12;A;;488;135;231;267;221;0;3;264;267
8;Barcelona;21;Maresme;08163;Pineda de Mar;1;12;B;;564;147;263;306;258;4;8;294;302
8;Barcelona;21;Maresme;08163;Pineda de Mar;1;13;A;;572;153;282;344;228;0;4;340;344
8;Barcelona;21;Maresme;08163;Pineda de Mar;1;13;B;;755;221;394;465;290;3;7;455;462
8;Barcelona;21;Maresme;08163;Pineda de Mar;1;2;A;;676;220;380;437;239;2;15;420;435
8;Barcelona;21;Maresme;08163;Pineda de Mar;1;2;B;;721;231;389;452;269;0;15;437;452
8;Barcelona;21;Maresme;08163;Pineda de Mar;1;3;A;;560;155;291;345;215;1;6;338;344
8;Barcelona;21;Maresme;08163;Pineda de Mar;1;3;B;;688;210;356;422;266;1;3;418;421
8;Barcelona;21;Maresme;08163;Pineda de Mar;1;4;A;;609;147;270;335;274;2;7;326;333
8;Barcelona;21;Maresme;08163;Pineda de Mar;1;4;B;;743;171;324;393;350;2;10;381;391
8;Barcelona;21;Maresme;08163;Pineda de Mar;1;4;C;;668;162;292;337;331;1;8;328;336
8;Barcelona;21;Maresme;08163;Pineda de Mar;1;5;A;;684;174;316;374;310;1;6;367;373
8;Barcelona;21;Maresme;08163;Pineda de Mar;1;5;B;;921;193;366;464;457;1;9;454;463
8;Barcelona;21;Maresme;08163;Pineda de Mar;1;5;C;;806;200;341;431;375;3;11;417;428
8;Barcelona;21;Maresme;08163;Pineda de Mar;1;6;A;;487;155;244;281;206;3;5;273;278
8;Barcelona;21;Maresme;08163;Pineda de Mar;1;6;B;;556;168;284;319;237;1;7;311;318
8;Barcelona;21;Maresme;08163;Pineda de Mar;1;7;A;;671;197;347;414;257;7;15;392;407
8;Barcelona;21;Maresme;08163;Pineda de Mar;1;7;B;;834;261;438;532;302;4;9;519;528
8;Barcelona;21;Maresme;08163;Pineda de Mar;1;8;A;;405;107;181;225;180;0;8;217;225
8;Barcelona;21;Maresme;08163;Pineda de Mar;1;8;B;;520;139;227;291;229;2;4;285;289
8;Barcelona;21;Maresme;08163;Pineda de Mar;1;9;A;;706;195;326;395;311;7;13;375;388
8;Barcelona;21;Maresme;08163;Pineda de Mar;1;9;B;;692;179;326;384;308;3;8;373;381
43;Tarragona;37;Terra Alta;43106;Pinell de Brai, el;1;1;U;;877;238;492;630;247;3;8;619;627
25;Lleida;35;Solsonès;25166;Pinell de Solsonès;1;1;U;;179;58;109;149;30;1;3;145;148
25;Lleida;35;Solsonès;25167;Pinós;1;1;U;;263;90;138;186;77;2;6;178;184
43;Tarragona;16;Conca de Barberà;43107;Pira;1;1;U;;384;90;200;251;133;4;12;235;247
8;Barcelona;3;Alt Penedès;08164;Pla del Penedès, el;1;1;U;;835;194;429;565;270;9;17;539;556
43;Tarragona;1;Alt Camp;43108;Pla de Santa Maria, el;1;1;A;;656;142;317;400;256;4;2;394;396
43;Tarragona;1;Alt Camp;43108;Pla de Santa Maria, el;1;1;B;;519;106;227;289;230;2;7;280;287
43;Tarragona;1;Alt Camp;43108;Pla de Santa Maria, el;1;1;C;;634;125;288;366;268;3;5;358;363
17;Girona;19;Garrotxa;17133;Planes d'Hostoles, les;1;1;A;;677;198;383;446;231;6;11;429;440
17;Girona;19;Garrotxa;17133;Planes d'Hostoles, les;1;1;B;;686;173;371;451;235;12;9;430;439
17;Girona;31;Ripollès;17134;Planoles;1;1;U;;228;83;141;164;64;3;7;154;161
25;Lleida;32;Segarra;25911;Plans de Sió, els;1;1;U;;468;87;242;328;140;9;13;306;319
25;Lleida;27;Pla d'Urgell;25168;Poal, el;1;1;U;;514;163;322;400;114;2;18;380;398
25;Lleida;18;Garrigues;25169;Pobla de Cérvoles, la;1;1;U;;194;60;113;141;53;0;8;133;141
8;Barcelona;6;Anoia;08165;Pobla de Claramunt, la;1;1;A;;788;206;410;482;306;17;3;462;465
8;Barcelona;6;Anoia;08165;Pobla de Claramunt, la;1;1;B;;906;259;447;541;365;12;15;514;529
8;Barcelona;14;Berguedà;08166;Pobla de Lillet, la;1;1;U;;351;108;202;245;106;3;12;230;242
8;Barcelona;14;Berguedà;08166;Pobla de Lillet, la;1;2;A;;431;97;236;290;141;4;4;282;286
8;Barcelona;14;Berguedà;08166;Pobla de Lillet, la;1;2;B;;383;103;215;251;132;6;7;238;245
43;Tarragona;36;Tarragonès;43109;Pobla de Mafumet, la;1;1;A;;575;130;250;340;235;1;4;335;339
43;Tarragona;36;Tarragonès;43109;Pobla de Mafumet, la;1;1;B;;690;143;292;365;325;1;3;361;364
43;Tarragona;36;Tarragonès;43109;Pobla de Mafumet, la;1;1;C;;682;141;275;362;320;1;7;354;361
43;Tarragona;37;Terra Alta;43110;Pobla de Massaluca, la;1;1;U;;322;73;176;218;104;1;3;214;217
43;Tarragona;36;Tarragonès;43111;Pobla de Montornès, la;1;1;A;;633;163;294;341;292;3;8;330;338
43;Tarragona;36;Tarragonès;43111;Pobla de Montornès, la;1;1;B;;689;180;299;361;328;7;5;349;354
43;Tarragona;36;Tarragonès;43111;Pobla de Montornès, la;1;1;C;;758;186;326;383;375;5;7;371;378
25;Lleida;25;Pallars Jussà;25171;Pobla de Segur, la;1;1;A;;502;142;263;329;173;1;5;323;328
25;Lleida;25;Pallars Jussà;25171;Pobla de Segur, la;1;1;B;;586;169;310;375;211;1;16;358;374
25;Lleida;25;Pallars Jussà;25171;Pobla de Segur, la;1;2;A;;612;142;305;384;228;3;24;357;381
25;Lleida;25;Pallars Jussà;25171;Pobla de Segur, la;1;2;B;;627;165;317;409;218;0;30;379;409
43;Tarragona;29;Priorat;43112;Poboleda;1;1;U;;295;76;158;203;92;4;3;196;199
8;Barcelona;40;Vallès Occidental;08167;Polinyà;1;1;A;;545;118;230;295;250;0;9;286;295
8;Barcelona;40;Vallès Occidental;08167;Polinyà;1;1;B;;691;134;290;376;315;1;11;364;375
8;Barcelona;40;Vallès Occidental;08167;Polinyà;1;1;C;;721;188;348;428;293;3;11;414;425
8;Barcelona;40;Vallès Occidental;08167;Polinyà;1;2;A;;494;94;195;227;267;3;7;217;224
8;Barcelona;40;Vallès Occidental;08167;Polinyà;1;2;B;;656;143;262;321;335;1;8;312;320
8;Barcelona;40;Vallès Occidental;08167;Polinyà;1;3;A;;570;105;246;320;250;1;9;310;319
8;Barcelona;40;Vallès Occidental;08167;Polinyà;1;3;B;;664;171;298;388;276;1;5;382;387
8;Barcelona;40;Vallès Occidental;08167;Polinyà;1;4;A;;567;141;258;317;250;4;8;305;313
8;Barcelona;40;Vallès Occidental;08167;Polinyà;1;4;B;;711;186;330;417;294;3;12;402;414
43;Tarragona;1;Alt Camp;43113;Pont d'Armentera, el;1;1;U;;462;105;240;314;148;4;5;305;310
25;Lleida;4;Alt Urgell;25030;Pont de Bar, el;1;1;U;;155;41;82;105;50;0;3;102;105
17;Girona;2;Alt Empordà;17135;Pont de Molins;1;1;U;;377;117;216;240;137;3;7;230;237
25;Lleida;5;Alta Ribagorça;25173;Pont de Suert, el;1;1;A;;563;124;242;336;227;2;13;321;334
25;Lleida;5;Alta Ribagorça;25173;Pont de Suert, el;1;1;B;;598;166;278;370;228;7;8;355;363
25;Lleida;5;Alta Ribagorça;25173;Pont de Suert, el;1;2;U;;610;155;274;335;275;2;6;327;333
8;Barcelona;7;Bages;08182;Pont de Vilomara i Rocafort, el;1;1;A;;773;182;371;458;315;2;17;439;456
8;Barcelona;7;Bages;08182;Pont de Vilomara i Rocafort, el;1;1;B;;1059;219;480;602;457;2;11;589;600
8;Barcelona;7;Bages;08182;Pont de Vilomara i Rocafort, el;1;1;C;;982;212;454;563;419;3;11;549;560
43;Tarragona;16;Conca de Barberà;43141;Pontils;1;1;U;;126;22;48;68;58;2;0;66;66
8;Barcelona;3;Alt Penedès;08168;Pontons;1;1;U;;408;105;202;248;160;3;4;241;245
17;Girona;2;Alt Empordà;17136;Pontós;1;1;U;;174;67;98;122;52;0;1;121;122
25;Lleida;23;Noguera;25172;Ponts;1;1;U;;728;256;415;514;214;7;11;496;507
25;Lleida;23;Noguera;25172;Ponts;1;2;A;;559;137;313;391;168;6;13;372;385
25;Lleida;23;Noguera;25172;Ponts;1;2;B;;574;137;308;396;178;3;13;380;393
17;Girona;28;Pla de l'Estany;17137;Porqueres;1;1;U;;570;167;333;388;182;14;6;368;374
17;Girona;28;Pla de l'Estany;17137;Porqueres;1;2;A;;774;229;422;533;241;6;10;517;527
17;Girona;28;Pla de l'Estany;17137;Porqueres;1;2;B;;863;249;461;560;303;5;22;533;555
17;Girona;28;Pla de l'Estany;17137;Porqueres;1;3;A;;564;160;316;393;171;8;11;374;385
17;Girona;28;Pla de l'Estany;17137;Porqueres;1;3;B;;554;137;300;360;194;2;13;345;358
43;Tarragona;29;Priorat;43114;Porrera;1;1;U;;387;80;207;241;146;10;10;221;231
17;Girona;2;Alt Empordà;17138;Portbou;1;1;A;;514;185;289;332;182;2;5;325;330
17;Girona;2;Alt Empordà;17138;Portbou;1;1;B;;506;169;282;316;190;4;2;310;312
17;Girona;2;Alt Empordà;17140;Port de la Selva, el;1;1;U;;672;243;403;473;199;3;16;454;470
25;Lleida;33;Segrià;25174;Portella, la;1;1;U;;455;126;243;294;161;5;4;285;289
43;Tarragona;29;Priorat;43115;Pradell de la Teixeta;1;1;U;;162;50;90;117;45;1;3;113;116
43;Tarragona;8;Baix Camp;43116;Prades;1;1;U;;484;141;270;340;144;7;5;328;333
43;Tarragona;37;Terra Alta;43117;Prat de Comte;1;1;U;;153;46;104;121;32;3;1;117;118
8;Barcelona;11;Baix Llobregat;08169;Prat de Llobregat, el;1;1;A;;568;128;275;348;220;4;13;331;344
8;Barcelona;11;Baix Llobregat;08169;Prat de Llobregat, el;1;1;B;;736;190;376;460;276;3;14;443;457
8;Barcelona;11;Baix Llobregat;08169;Prat de Llobregat, el;1;2;A;;628;188;348;424;204;6;12;406;418
8;Barcelona;11;Baix Llobregat;08169;Prat de Llobregat, el;1;2;B;;713;226;391;474;239;3;13;458;471
8;Barcelona;11;Baix Llobregat;08169;Prat de Llobregat, el;1;3;A;;417;123;210;265;152;0;7;258;265
8;Barcelona;11;Baix Llobregat;08169;Prat de Llobregat, el;1;3;B;;548;129;253;323;225;1;6;316;322
8;Barcelona;11;Baix Llobregat;08169;Prat de Llobregat, el;1;4;A;;636;186;328;385;251;2;8;375;383
8;Barcelona;11;Baix Llobregat;08169;Prat de Llobregat, el;1;4;B;;704;195;351;410;294;5;11;394;405
8;Barcelona;11;Baix Llobregat;08169;Prat de Llobregat, el;1;5;A;;501;142;238;287;214;4;7;276;283
8;Barcelona;11;Baix Llobregat;08169;Prat de Llobregat, el;1;5;B;;609;119;265;328;281;1;17;310;327
8;Barcelona;11;Baix Llobregat;08169;Prat de Llobregat, el;2;1;A;;589;169;288;355;234;0;8;347;355
8;Barcelona;11;Baix Llobregat;08169;Prat de Llobregat, el;2;1;B;;705;174;345;415;290;2;15;398;413
8;Barcelona;11;Baix Llobregat;08169;Prat de Llobregat, el;2;2;A;;685;166;316;407;278;0;16;391;407
8;Barcelona;11;Baix Llobregat;08169;Prat de Llobregat, el;2;2;B;;819;208;400;503;316;3;12;488;500
8;Barcelona;11;Baix Llobregat;08169;Prat de Llobregat, el;2;3;A;;419;113;181;209;210;1;5;203;208
8;Barcelona;11;Baix Llobregat;08169;Prat de Llobregat, el;2;3;B;;479;123;208;244;235;1;6;237;243
8;Barcelona;11;Baix Llobregat;08169;Prat de Llobregat, el;2;4;A;;638;145;278;364;274;0;14;350;364
8;Barcelona;11;Baix Llobregat;08169;Prat de Llobregat, el;2;4;B;;734;167;331;412;322;1;14;397;411
8;Barcelona;11;Baix Llobregat;08169;Prat de Llobregat, el;2;5;A;;643;146;262;330;313;1;13;316;329
8;Barcelona;11;Baix Llobregat;08169;Prat de Llobregat, el;2;5;B;;673;141;281;351;322;4;11;336;347
8;Barcelona;11;Baix Llobregat;08169;Prat de Llobregat, el;2;6;A;;833;206;402;506;327;2;18;486;504
8;Barcelona;11;Baix Llobregat;08169;Prat de Llobregat, el;2;6;B;;863;199;402;520;343;2;21;497;518
8;Barcelona;11;Baix Llobregat;08169;Prat de Llobregat, el;2;7;A;;705;170;333;413;292;4;12;397;409
8;Barcelona;11;Baix Llobregat;08169;Prat de Llobregat, el;2;7;B;;736;183;330;422;314;7;14;401;415
8;Barcelona;11;Baix Llobregat;08169;Prat de Llobregat, el;3;1;A;;518;119;263;330;188;1;11;318;329
8;Barcelona;11;Baix Llobregat;08169;Prat de Llobregat, el;3;1;B;;583;168;307;369;214;4;11;354;365
8;Barcelona;11;Baix Llobregat;08169;Prat de Llobregat, el;3;10;A;;695;126;270;346;349;3;15;328;343
8;Barcelona;11;Baix Llobregat;08169;Prat de Llobregat, el;3;10;B;;670;120;263;340;330;5;11;324;335
8;Barcelona;11;Baix Llobregat;08169;Prat de Llobregat, el;3;11;U;;922;177;391;496;426;3;14;479;493
8;Barcelona;11;Baix Llobregat;08169;Prat de Llobregat, el;3;12;U;;503;113;228;279;224;2;11;266;277
8;Barcelona;11;Baix Llobregat;08169;Prat de Llobregat, el;3;13;U;;553;115;233;306;247;1;14;291;305
8;Barcelona;11;Baix Llobregat;08169;Prat de Llobregat, el;3;2;U;;782;161;305;416;366;0;14;402;416
8;Barcelona;11;Baix Llobregat;08169;Prat de Llobregat, el;3;3;A;;620;150;244;317;303;1;12;304;316
8;Barcelona;11;Baix Llobregat;08169;Prat de Llobregat, el;3;3;B;;629;135;257;333;296;1;15;317;332
8;Barcelona;11;Baix Llobregat;08169;Prat de Llobregat, el;3;4;A;;475;110;192;237;238;2;7;228;235
8;Barcelona;11;Baix Llobregat;08169;Prat de Llobregat, el;3;4;B;;620;129;243;312;308;1;8;303;311
8;Barcelona;11;Baix Llobregat;08169;Prat de Llobregat, el;3;5;A;;781;176;377;465;316;2;18;445;463
8;Barcelona;11;Baix Llobregat;08169;Prat de Llobregat, el;3;5;B;;800;194;399;477;323;1;10;466;476
8;Barcelona;11;Baix Llobregat;08169;Prat de Llobregat, el;3;6;A;;502;89;187;257;245;2;5;250;255
8;Barcelona;11;Baix Llobregat;08169;Prat de Llobregat, el;3;6;B;;597;136;256;338;259;1;17;320;337
8;Barcelona;11;Baix Llobregat;08169;Prat de Llobregat, el;3;7;A;;702;187;325;428;274;4;15;409;424
8;Barcelona;11;Baix Llobregat;08169;Prat de Llobregat, el;3;7;B;;828;189;345;464;364;1;12;451;463
8;Barcelona;11;Baix Llobregat;08169;Prat de Llobregat, el;3;8;A;;760;135;274;359;401;2;17;340;357
8;Barcelona;11;Baix Llobregat;08169;Prat de Llobregat, el;3;8;B;;900;159;324;416;484;1;10;405;415
8;Barcelona;11;Baix Llobregat;08169;Prat de Llobregat, el;3;9;A;;827;170;352;429;398;0;23;406;429
8;Barcelona;11;Baix Llobregat;08169;Prat de Llobregat, el;3;9;B;;869;181;348;432;437;5;15;412;427
8;Barcelona;11;Baix Llobregat;08169;Prat de Llobregat, el;4;1;U;;800;185;322;391;409;2;6;383;389
8;Barcelona;11;Baix Llobregat;08169;Prat de Llobregat, el;4;2;A;;708;130;231;285;423;0;7;278;285
8;Barcelona;11;Baix Llobregat;08169;Prat de Llobregat, el;4;2;B;;814;130;277;331;483;1;10;320;330
8;Barcelona;11;Baix Llobregat;08169;Prat de Llobregat, el;4;3;A;;460;88;145;181;279;1;7;173;180
8;Barcelona;11;Baix Llobregat;08169;Prat de Llobregat, el;4;3;B;;574;120;210;247;327;0;7;240;247
8;Barcelona;11;Baix Llobregat;08169;Prat de Llobregat, el;4;4;U;;947;167;304;343;604;2;4;337;341
8;Barcelona;11;Baix Llobregat;08169;Prat de Llobregat, el;4;5;A;;461;75;130;158;303;0;2;156;158
8;Barcelona;11;Baix Llobregat;08169;Prat de Llobregat, el;4;5;B;;495;83;162;207;288;0;1;206;207
8;Barcelona;11;Baix Llobregat;08169;Prat de Llobregat, el;4;6;U;;843;32;74;110;733;1;5;104;109
8;Barcelona;11;Baix Llobregat;08169;Prat de Llobregat, el;5;1;A;;460;123;229;272;188;0;12;260;272
8;Barcelona;11;Baix Llobregat;08169;Prat de Llobregat, el;5;1;B;;486;145;238;287;199;1;17;269;286
8;Barcelona;11;Baix Llobregat;08169;Prat de Llobregat, el;5;2;A;;493;108;205;260;233;4;9;247;256
8;Barcelona;11;Baix Llobregat;08169;Prat de Llobregat, el;5;2;B;;519;102;207;271;248;2;6;263;269
8;Barcelona;11;Baix Llobregat;08169;Prat de Llobregat, el;5;3;A;;435;82;146;200;235;1;6;193;199
8;Barcelona;11;Baix Llobregat;08169;Prat de Llobregat, el;5;3;B;;482;99;179;238;244;3;5;230;235
8;Barcelona;11;Baix Llobregat;08169;Prat de Llobregat, el;5;4;A;;645;144;315;412;233;1;12;399;411
8;Barcelona;11;Baix Llobregat;08169;Prat de Llobregat, el;5;4;B;;726;153;335;435;291;1;23;411;434
8;Barcelona;11;Baix Llobregat;08169;Prat de Llobregat, el;5;5;A;;649;149;294;354;295;4;16;334;350
8;Barcelona;11;Baix Llobregat;08169;Prat de Llobregat, el;5;5;B;;733;158;327;394;339;1;16;377;393
8;Barcelona;11;Baix Llobregat;08169;Prat de Llobregat, el;5;6;A;;708;171;298;376;332;0;9;367;376
8;Barcelona;11;Baix Llobregat;08169;Prat de Llobregat, el;5;6;B;;807;187;360;441;366;4;11;426;437
8;Barcelona;11;Baix Llobregat;08169;Prat de Llobregat, el;5;7;A;;741;156;297;387;354;5;10;372;382
8;Barcelona;11;Baix Llobregat;08169;Prat de Llobregat, el;5;7;B;;820;164;335;412;408;5;13;394;407
8;Barcelona;11;Baix Llobregat;08169;Prat de Llobregat, el;5;8;A;;610;129;258;339;271;1;13;325;338
8;Barcelona;11;Baix Llobregat;08169;Prat de Llobregat, el;5;8;B;;737;145;316;426;311;4;17;405;422
8;Barcelona;11;Baix Llobregat;08169;Prat de Llobregat, el;5;8;C;;695;147;302;400;295;1;15;384;399
43;Tarragona;8;Baix Camp;43118;Pratdip;1;1;U;;439;130;254;305;134;1;0;304;304
8;Barcelona;24;Osona;08171;Prats de Lluçanès;1;1;A;;508;145;303;364;144;3;10;351;361
8;Barcelona;24;Osona;08171;Prats de Lluçanès;1;1;B;;525;148;288;346;179;6;11;329;340
8;Barcelona;24;Osona;08171;Prats de Lluçanès;1;2;A;;517;138;293;357;160;3;5;349;354
8;Barcelona;24;Osona;08171;Prats de Lluçanès;1;2;B;;607;211;348;418;189;1;15;402;417
8;Barcelona;6;Anoia;08170;Prats de Rei, els;1;1;U;;466;127;278;317;149;3;17;297;314
25;Lleida;15;Cerdanya;25175;Prats i Sansor;1;1;U;;198;55;119;151;47;1;2;148;150
25;Lleida;38;Urgell;25176;Preixana;1;1;U;;349;107;197;248;101;2;12;234;246
25;Lleida;23;Noguera;25177;Preixens;1;1;U;;393;98;201;246;147;1;2;243;245
8;Barcelona;21;Maresme;08230;Premià de Dalt;1;1;A;;790;191;443;571;219;4;18;549;567
8;Barcelona;21;Maresme;08230;Premià de Dalt;1;1;B;;862;236;539;661;201;12;16;633;649
8;Barcelona;21;Maresme;08230;Premià de Dalt;1;2;A;;659;193;362;436;223;1;11;424;435
8;Barcelona;21;Maresme;08230;Premià de Dalt;1;2;B;;832;245;476;575;257;0;9;566;575
8;Barcelona;21;Maresme;08230;Premià de Dalt;1;3;A;;478;112;204;248;230;1;2;245;247
8;Barcelona;21;Maresme;08230;Premià de Dalt;1;3;B;;572;134;252;303;269;2;6;295;301
8;Barcelona;21;Maresme;08230;Premià de Dalt;1;4;A;;657;174;352;450;207;6;15;429;444
8;Barcelona;21;Maresme;08230;Premià de Dalt;1;4;B;;656;163;365;455;201;2;11;442;453
8;Barcelona;21;Maresme;08230;Premià de Dalt;1;5;U;;682;156;307;376;306;0;13;363;376
8;Barcelona;21;Maresme;08230;Premià de Dalt;1;6;A;;533;132;299;380;153;6;7;367;374
8;Barcelona;21;Maresme;08230;Premià de Dalt;1;6;B;;686;176;381;497;189;2;14;481;495
8;Barcelona;21;Maresme;08172;Premià de Mar;1;1;A;;899;255;465;580;319;3;21;556;577
8;Barcelona;21;Maresme;08172;Premià de Mar;1;1;B;;908;248;456;585;323;4;15;566;581
8;Barcelona;21;Maresme;08172;Premià de Mar;1;2;A;;772;255;457;549;223;3;14;532;546
8;Barcelona;21;Maresme;08172;Premià de Mar;1;2;B;;842;263;510;596;246;2;12;582;594
8;Barcelona;21;Maresme;08172;Premià de Mar;1;3;A;;866;251;465;564;302;2;23;539;562
8;Barcelona;21;Maresme;08172;Premià de Mar;1;3;B;;929;243;487;568;361;7;16;545;561
8;Barcelona;21;Maresme;08172;Premià de Mar;2;1;A;;659;176;361;425;234;6;13;406;419
8;Barcelona;21;Maresme;08172;Premià de Mar;2;1;B;;810;244;478;571;239;4;12;555;567
8;Barcelona;21;Maresme;08172;Premià de Mar;2;2;A;;441;109;214;255;186;2;3;250;253
8;Barcelona;21;Maresme;08172;Premià de Mar;2;2;B;;527;160;256;303;224;2;10;291;301
8;Barcelona;21;Maresme;08172;Premià de Mar;2;2;C;;542;167;271;311;231;2;9;300;309
8;Barcelona;21;Maresme;08172;Premià de Mar;2;3;A;;591;162;292;349;242;3;9;337;346
8;Barcelona;21;Maresme;08172;Premià de Mar;2;3;B;;712;183;358;408;304;4;9;395;404
8;Barcelona;21;Maresme;08172;Premià de Mar;2;4;A;;524;124;241;304;220;3;11;290;301
8;Barcelona;21;Maresme;08172;Premià de Mar;2;4;B;;589;167;266;331;258;6;11;314;325
8;Barcelona;21;Maresme;08172;Premià de Mar;3;1;A;;534;129;285;352;182;3;18;331;349
8;Barcelona;21;Maresme;08172;Premià de Mar;3;1;B;;635;175;320;388;247;4;4;380;384
8;Barcelona;21;Maresme;08172;Premià de Mar;3;2;A;;475;125;233;278;197;4;8;266;274
8;Barcelona;21;Maresme;08172;Premià de Mar;3;2;B;;524;129;242;304;220;2;9;293;302
8;Barcelona;21;Maresme;08172;Premià de Mar;3;3;A;;459;133;230;278;181;0;12;266;278
8;Barcelona;21;Maresme;08172;Premià de Mar;3;3;B;;484;137;243;290;194;2;10;278;288
8;Barcelona;21;Maresme;08172;Premià de Mar;3;4;A;;578;168;306;365;213;3;7;355;362
8;Barcelona;21;Maresme;08172;Premià de Mar;3;4;B;;656;189;332;400;256;1;13;386;399
8;Barcelona;21;Maresme;08172;Premià de Mar;3;5;A;;460;103;199;233;227;0;7;226;233
8;Barcelona;21;Maresme;08172;Premià de Mar;3;5;B;;502;124;221;267;235;2;1;264;265
8;Barcelona;21;Maresme;08172;Premià de Mar;3;6;A;;432;108;236;292;140;0;16;276;292
8;Barcelona;21;Maresme;08172;Premià de Mar;3;6;B;;579;173;330;415;164;5;20;390;410
8;Barcelona;21;Maresme;08172;Premià de Mar;3;7;A;;479;133;246;306;173;0;9;297;306
8;Barcelona;21;Maresme;08172;Premià de Mar;3;7;B;;537;139;257;328;209;2;11;315;326
8;Barcelona;21;Maresme;08172;Premià de Mar;3;8;U;;846;229;449;552;294;1;16;535;551
8;Barcelona;21;Maresme;08172;Premià de Mar;3;9;A;;497;126;251;309;188;2;10;297;307
8;Barcelona;21;Maresme;08172;Premià de Mar;3;9;B;;574;147;298;364;210;1;6;357;363
17;Girona;19;Garrotxa;17139;Preses, les;1;1;A;;883;260;522;628;255;9;17;602;619
17;Girona;19;Garrotxa;17139;Preses, les;1;1;B;;439;109;233;273;166;2;13;258;271
25;Lleida;15;Cerdanya;25179;Prullans;1;1;U;;197;72;126;140;57;3;2;135;137
17;Girona;15;Cerdanya;17141;Puigcerdà;1;1;U;;591;125;249;326;265;0;2;324;326
17;Girona;15;Cerdanya;17141;Puigcerdà;1;2;A;;682;181;368;425;257;0;13;412;425
17;Girona;15;Cerdanya;17141;Puigcerdà;1;2;B;;668;175;323;411;257;4;13;394;407
17;Girona;15;Cerdanya;17141;Puigcerdà;1;3;A;;610;146;290;381;229;3;13;365;378
17;Girona;15;Cerdanya;17141;Puigcerdà;1;3;B;;725;192;332;419;306;1;7;411;418
17;Girona;15;Cerdanya;17141;Puigcerdà;1;4;A;;773;179;341;418;355;6;8;404;412
17;Girona;15;Cerdanya;17141;Puigcerdà;1;4;B;;822;164;348;449;373;3;16;430;446
17;Girona;15;Cerdanya;17141;Puigcerdà;1;5;U;;784;173;345;433;351;14;4;415;419
8;Barcelona;3;Alt Penedès;08174;Puigdàlber;1;1;U;;409;114;234;292;117;2;7;283;290
25;Lleida;18;Garrigues;25180;Puiggròs;1;1;U;;250;64;133;163;87;5;6;152;158
43;Tarragona;1;Alt Camp;43119;Puigpelat;1;1;U;;730;135;311;397;333;0;11;386;397
8;Barcelona;14;Berguedà;08175;Puig-reig;1;1;A;;830;200;414;527;303;1;9;517;526
8;Barcelona;14;Berguedà;08175;Puig-reig;1;1;B;;925;170;462;584;341;12;13;559;572
8;Barcelona;14;Berguedà;08175;Puig-reig;1;2;A;;575;113;275;373;202;1;9;363;372
8;Barcelona;14;Berguedà;08175;Puig-reig;1;2;B;;684;145;353;438;246;1;4;433;437
8;Barcelona;14;Berguedà;08175;Puig-reig;2;1;A;;179;44;102;142;37;0;3;139;142
8;Barcelona;14;Berguedà;08175;Puig-reig;2;1;B;;115;16;47;63;52;0;1;62;63
8;Barcelona;14;Berguedà;08175;Puig-reig;2;1;C;;190;59;117;137;53;3;6;128;134
25;Lleida;38;Urgell;25181;Puigverd d'Agramunt;1;1;U;;192;43;95;136;56;3;4;129;133
25;Lleida;33;Segrià;25182;Puigverd de Lleida;1;1;A;;527;95;254;317;210;2;13;302;315
25;Lleida;33;Segrià;25182;Puigverd de Lleida;1;1;B;;551;120;292;370;181;5;19;346;365
8;Barcelona;6;Anoia;08176;Pujalt;1;1;U;;167;44;95;115;52;0;0;115;115
8;Barcelona;14;Berguedà;08177;Quar, la;1;1;U;;55;21;41;42;13;0;4;38;42
17;Girona;20;Gironès;17142;Quart;1;1;A;;620;137;298;403;217;0;16;387;403
17;Girona;20;Gironès;17142;Quart;1;1;B;;544;141;275;351;193;4;6;341;347
17;Girona;20;Gironès;17142;Quart;1;2;A;;639;187;366;467;172;5;12;450;462
17;Girona;20;Gironès;17142;Quart;1;2;B;;541;134;306;355;186;12;5;338;343
17;Girona;31;Ripollès;17043;Queralbs;1;1;U;;160;58;88;118;42;1;0;117;117
43;Tarragona;1;Alt Camp;43120;Querol;1;1;U;;430;118;198;228;202;6;4;218;222
17;Girona;2;Alt Empordà;17143;Rabós;1;1;U;;127;41;67;88;39;2;2;84;86
8;Barcelona;7;Bages;08178;Rajadell;1;1;U;;432;120;240;295;137;2;3;290;293
43;Tarragona;30;Ribera d'Ebre;43121;Rasquera;1;1;U;;665;124;287;373;292;7;13;353;366
17;Girona;10;Baix Empordà;17144;Regencós;1;1;U;;217;46;127;147;70;0;3;144;147
8;Barcelona;40;Vallès Occidental;08179;Rellinars;1;1;U;;587;188;343;384;203;1;15;368;383
43;Tarragona;36;Tarragonès;43122;Renau;1;1;U;;87;22;52;65;22;2;1;62;63
43;Tarragona;8;Baix Camp;43123;Reus;1;1;U;;724;180;313;388;336;1;8;379;387
43;Tarragona;8;Baix Camp;43123;Reus;1;2;A;;613;177;322;375;238;0;8;367;375
43;Tarragona;8;Baix Camp;43123;Reus;1;2;B;;684;224;400;468;216;0;9;459;468
43;Tarragona;8;Baix Camp;43123;Reus;1;3;A;;429;121;225;279;150;1;8;270;278
43;Tarragona;8;Baix Camp;43123;Reus;1;3;B;;525;136;270;336;189;1;10;325;335
43;Tarragona;8;Baix Camp;43123;Reus;10;1;A;;743;150;308;407;336;1;13;393;406
43;Tarragona;8;Baix Camp;43123;Reus;10;1;B;;883;199;372;486;397;3;10;473;483
43;Tarragona;8;Baix Camp;43123;Reus;2;1;U;;515;143;232;278;237;2;11;265;276
43;Tarragona;8;Baix Camp;43123;Reus;2;10;A;;513;134;247;312;201;3;9;300;309
43;Tarragona;8;Baix Camp;43123;Reus;2;10;B;;475;111;202;271;204;3;3;265;268
43;Tarragona;8;Baix Camp;43123;Reus;2;10;C;;543;123;257;324;219;1;8;315;323
43;Tarragona;8;Baix Camp;43123;Reus;2;11;A;;329;77;136;164;165;3;4;157;161
43;Tarragona;8;Baix Camp;43123;Reus;2;11;B;;392;100;161;200;192;0;4;196;200
43;Tarragona;8;Baix Camp;43123;Reus;2;12;A;;451;96;201;270;181;3;4;263;267
43;Tarragona;8;Baix Camp;43123;Reus;2;12;B;;526;113;224;304;222;1;8;295;303
43;Tarragona;8;Baix Camp;43123;Reus;2;13;A;;367;99;154;197;170;3;3;191;194
43;Tarragona;8;Baix Camp;43123;Reus;2;13;B;;460;135;210;264;196;5;3;256;259
43;Tarragona;8;Baix Camp;43123;Reus;2;14;U;;597;170;307;376;221;5;12;359;371
43;Tarragona;8;Baix Camp;43123;Reus;2;15;A;;329;85;171;232;97;0;4;228;232
43;Tarragona;8;Baix Camp;43123;Reus;2;15;B;;345;106;184;236;109;3;5;228;233
43;Tarragona;8;Baix Camp;43123;Reus;2;2;A;;489;142;258;313;176;2;7;304;311
43;Tarragona;8;Baix Camp;43123;Reus;2;2;B;;414;118;198;253;161;2;4;247;251
43;Tarragona;8;Baix Camp;43123;Reus;2;2;C;;491;136;216;278;213;7;3;268;271
43;Tarragona;8;Baix Camp;43123;Reus;2;3;A;;364;107;190;242;122;2;7;233;240
43;Tarragona;8;Baix Camp;43123;Reus;2;3;B;;422;131;215;281;141;2;4;275;279
43;Tarragona;8;Baix Camp;43123;Reus;2;4;A;;520;122;214;273;247;3;6;264;270
43;Tarragona;8;Baix Camp;43123;Reus;2;4;B;;628;164;266;339;289;6;6;327;333
43;Tarragona;8;Baix Camp;43123;Reus;2;6;A;;495;107;220;284;211;0;4;280;284
43;Tarragona;8;Baix Camp;43123;Reus;2;6;B;;534;127;233;295;239;1;9;285;294
43;Tarragona;8;Baix Camp;43123;Reus;2;6;C;;552;122;226;303;249;3;10;290;300
43;Tarragona;8;Baix Camp;43123;Reus;2;7;A;;503;137;242;288;215;1;7;280;287
43;Tarragona;8;Baix Camp;43123;Reus;2;7;B;;564;156;277;351;213;2;3;346;349
43;Tarragona;8;Baix Camp;43123;Reus;2;8;U;;700;176;291;374;326;10;4;360;364
43;Tarragona;8;Baix Camp;43123;Reus;2;9;A;;355;134;235;273;82;1;4;268;272
43;Tarragona;8;Baix Camp;43123;Reus;2;9;B;;396;115;230;284;112;6;9;269;278
43;Tarragona;8;Baix Camp;43123;Reus;3;1;U;;775;229;373;448;327;4;6;438;444
43;Tarragona;8;Baix Camp;43123;Reus;3;10;A;;342;82;130;163;179;0;6;157;163
43;Tarragona;8;Baix Camp;43123;Reus;3;10;B;;422;90;148;174;248;0;2;172;174
43;Tarragona;8;Baix Camp;43123;Reus;3;10;C;;391;94;148;197;194;1;5;191;196
43;Tarragona;8;Baix Camp;43123;Reus;3;11;A;;466;111;170;221;245;0;3;218;221
43;Tarragona;8;Baix Camp;43123;Reus;3;11;B;;556;106;300;254;302;3;0;251;251
43;Tarragona;8;Baix Camp;43123;Reus;3;11;C;;567;145;240;298;269;6;2;290;292
43;Tarragona;8;Baix Camp;43123;Reus;3;12;A;;256;73;113;141;115;1;4;136;140
43;Tarragona;8;Baix Camp;43123;Reus;3;12;B;;337;81;137;170;167;1;6;163;169
43;Tarragona;8;Baix Camp;43123;Reus;3;12;C;;329;66;119;150;179;0;0;150;150
43;Tarragona;8;Baix Camp;43123;Reus;3;13;A;;442;94;185;230;212;4;9;217;226
43;Tarragona;8;Baix Camp;43123;Reus;3;13;B;;502;108;219;292;210;3;10;279;289
43;Tarragona;8;Baix Camp;43123;Reus;3;3;A;;385;108;171;209;176;0;7;202;209
43;Tarragona;8;Baix Camp;43123;Reus;3;3;B;;420;116;173;220;200;5;2;213;215
43;Tarragona;8;Baix Camp;43123;Reus;3;4;A;;475;121;198;263;212;3;4;256;260
43;Tarragona;8;Baix Camp;43123;Reus;3;4;B;;519;123;211;266;253;2;6;258;264
43;Tarragona;8;Baix Camp;43123;Reus;3;5;A;;451;120;206;251;200;3;6;242;248
43;Tarragona;8;Baix Camp;43123;Reus;3;5;B;;537;126;240;298;239;3;6;289;295
43;Tarragona;8;Baix Camp;43123;Reus;3;7;A;;537;128;227;274;263;1;9;264;273
43;Tarragona;8;Baix Camp;43123;Reus;3;7;B;;568;137;270;325;243;4;8;313;321
43;Tarragona;8;Baix Camp;43123;Reus;3;8;A;;381;115;185;234;147;2;5;227;232
43;Tarragona;8;Baix Camp;43123;Reus;3;8;B;;407;96;185;222;185;1;5;216;221
43;Tarragona;8;Baix Camp;43123;Reus;3;8;C;;437;118;206;260;177;1;6;253;259
43;Tarragona;8;Baix Camp;43123;Reus;3;9;A;;367;105;141;183;184;6;2;175;177
43;Tarragona;8;Baix Camp;43123;Reus;3;9;B;;435;117;186;218;217;1;3;214;217
43;Tarragona;8;Baix Camp;43123;Reus;4;2;A;;359;93;162;210;149;2;2;206;208
43;Tarragona;8;Baix Camp;43123;Reus;4;2;B;;334;79;127;167;167;1;4;162;166
43;Tarragona;8;Baix Camp;43123;Reus;4;2;C;;366;95;147;190;176;2;3;185;188
43;Tarragona;8;Baix Camp;43123;Reus;4;3;A;;620;150;257;333;287;2;12;319;331
43;Tarragona;8;Baix Camp;43123;Reus;4;3;B;;627;130;250;325;302;3;3;319;322
43;Tarragona;8;Baix Camp;43123;Reus;4;4;A;;461;103;177;226;235;2;4;220;224
43;Tarragona;8;Baix Camp;43123;Reus;4;4;B;;563;123;225;295;268;4;7;284;291
43;Tarragona;8;Baix Camp;43123;Reus;4;5;A;;319;59;131;181;138;0;7;174;181
43;Tarragona;8;Baix Camp;43123;Reus;4;5;B;;299;58;126;173;126;0;3;170;173
43;Tarragona;8;Baix Camp;43123;Reus;4;7;A;;313;66;117;147;166;0;4;143;147
43;Tarragona;8;Baix Camp;43123;Reus;4;7;B;;331;81;123;160;171;1;2;157;159
43;Tarragona;8;Baix Camp;43123;Reus;4;7;C;;354;84;130;170;184;1;2;167;169
43;Tarragona;8;Baix Camp;43123;Reus;4;8;A;;407;74;144;193;214;2;2;189;191
43;Tarragona;8;Baix Camp;43123;Reus;4;8;B;;334;49;112;151;183;1;2;148;150
43;Tarragona;8;Baix Camp;43123;Reus;4;8;C;;359;88;150;198;161;1;4;193;197
43;Tarragona;8;Baix Camp;43123;Reus;5;1;A;;389;99;187;233;156;2;3;228;231
43;Tarragona;8;Baix Camp;43123;Reus;5;1;B;;416;97;165;206;210;1;5;200;205
43;Tarragona;8;Baix Camp;43123;Reus;5;1;C;;407;106;173;218;189;4;11;203;214
43;Tarragona;8;Baix Camp;43123;Reus;5;2;A;;437;116;206;258;179;0;7;251;258
43;Tarragona;8;Baix Camp;43123;Reus;5;2;B;;499;130;232;299;200;0;2;297;299
43;Tarragona;8;Baix Camp;43123;Reus;5;2;C;;537;129;235;314;223;3;3;308;311
43;Tarragona;8;Baix Camp;43123;Reus;5;3;A;;307;81;130;163;144;1;1;161;162
43;Tarragona;8;Baix Camp;43123;Reus;5;3;B;;336;82;133;166;170;1;2;163;165
43;Tarragona;8;Baix Camp;43123;Reus;5;4;A;;422;109;195;251;171;1;5;245;250
43;Tarragona;8;Baix Camp;43123;Reus;5;4;B;;417;98;176;229;188;0;3;226;229
43;Tarragona;8;Baix Camp;43123;Reus;5;4;C;;456;112;190;246;210;2;6;238;244
43;Tarragona;8;Baix Camp;43123;Reus;5;5;A;;335;90;138;172;163;2;10;160;170
43;Tarragona;8;Baix Camp;43123;Reus;5;5;B;;368;89;152;180;188;1;10;169;179
43;Tarragona;8;Baix Camp;43123;Reus;5;5;C;;422;129;191;229;193;0;14;215;229
43;Tarragona;8;Baix Camp;43123;Reus;5;7;A;;442;116;214;270;172;0;10;260;270
43;Tarragona;8;Baix Camp;43123;Reus;5;7;B;;514;144;247;316;198;0;8;308;316
43;Tarragona;8;Baix Camp;43123;Reus;6;1;A;;324;89;151;188;136;0;3;185;188
43;Tarragona;8;Baix Camp;43123;Reus;6;1;B;;368;102;174;211;157;0;3;208;211
43;Tarragona;8;Baix Camp;43123;Reus;6;11;A;;494;152;272;347;147;1;12;334;346
43;Tarragona;8;Baix Camp;43123;Reus;6;11;B;;400;104;203;267;133;2;10;255;265
43;Tarragona;8;Baix Camp;43123;Reus;6;11;C;;499;122;247;339;160;1;12;326;338
43;Tarragona;8;Baix Camp;43123;Reus;6;12;A;;388;100;185;253;135;1;12;240;252
43;Tarragona;8;Baix Camp;43123;Reus;6;12;B;;497;149;257;342;155;2;14;326;340
43;Tarragona;8;Baix Camp;43123;Reus;6;13;A;;337;107;190;220;117;0;6;214;220
43;Tarragona;8;Baix Camp;43123;Reus;6;13;B;;318;110;186;210;108;2;0;208;208
43;Tarragona;8;Baix Camp;43123;Reus;6;2;A;;367;90;220;277;90;1;8;268;276
43;Tarragona;8;Baix Camp;43123;Reus;6;2;B;;312;85;174;220;92;1;4;215;219
43;Tarragona;8;Baix Camp;43123;Reus;6;2;C;;414;110;247;310;104;2;12;296;308
43;Tarragona;8;Baix Camp;43123;Reus;6;3;A;;482;135;264;334;148;4;3;327;330
43;Tarragona;8;Baix Camp;43123;Reus;6;3;B;;439;98;220;289;150;1;10;278;288
43;Tarragona;8;Baix Camp;43123;Reus;6;3;C;;509;129;270;354;155;1;5;348;353
43;Tarragona;8;Baix Camp;43123;Reus;6;4;A;;423;139;269;328;95;1;9;318;327
43;Tarragona;8;Baix Camp;43123;Reus;6;4;B;;415;137;252;303;112;4;17;282;299
43;Tarragona;8;Baix Camp;43123;Reus;6;4;C;;473;125;277;364;109;0;14;350;364
43;Tarragona;8;Baix Camp;43123;Reus;6;5;A;;559;103;193;257;302;0;5;252;257
43;Tarragona;8;Baix Camp;43123;Reus;6;5;B;;671;153;263;328;343;0;9;319;328
43;Tarragona;8;Baix Camp;43123;Reus;6;6;A;;643;182;353;447;196;4;15;428;443
43;Tarragona;8;Baix Camp;43123;Reus;6;6;B;;537;153;359;363;174;3;13;347;360
43;Tarragona;8;Baix Camp;43123;Reus;6;6;C;;609;164;305;398;211;0;12;386;398
43;Tarragona;8;Baix Camp;43123;Reus;6;7;A;;429;143;226;282;147;0;7;275;282
43;Tarragona;8;Baix Camp;43123;Reus;6;7;B;;443;135;227;287;156;1;4;282;286
43;Tarragona;8;Baix Camp;43123;Reus;6;8;A;;427;106;202;251;176;2;9;240;249
43;Tarragona;8;Baix Camp;43123;Reus;6;8;B;;450;140;221;245;205;1;11;233;244
43;Tarragona;8;Baix Camp;43123;Reus;6;9;A;;503;104;190;230;273;0;8;222;230
43;Tarragona;8;Baix Camp;43123;Reus;6;9;B;;558;133;212;264;294;3;5;256;261
43;Tarragona;8;Baix Camp;43123;Reus;7;1;A;;370;47;82;117;253;0;2;115;117
43;Tarragona;8;Baix Camp;43123;Reus;7;1;B;;397;76;111;129;268;0;1;128;129
43;Tarragona;8;Baix Camp;43123;Reus;7;1;C;;379;67;113;140;239;0;0;140;140
43;Tarragona;8;Baix Camp;43123;Reus;7;2;A;;644;133;247;296;348;2;6;288;294
43;Tarragona;8;Baix Camp;43123;Reus;7;2;B;;777;150;268;341;436;0;9;332;341
43;Tarragona;8;Baix Camp;43123;Reus;7;2;C;;845;162;306;389;456;3;10;376;386
43;Tarragona;8;Baix Camp;43123;Reus;7;3;A;;487;93;189;238;249;2;6;230;236
43;Tarragona;8;Baix Camp;43123;Reus;7;3;B;;581;125;210;281;300;8;4;269;273
43;Tarragona;8;Baix Camp;43123;Reus;7;3;C;;517;105;192;249;268;0;4;245;249
43;Tarragona;8;Baix Camp;43123;Reus;8;1;A;;215;43;72;88;127;0;0;88;88
43;Tarragona;8;Baix Camp;43123;Reus;8;1;B;;281;55;102;125;156;4;2;119;121
43;Tarragona;8;Baix Camp;43123;Reus;8;1;C;;240;50;80;103;137;1;2;100;102
43;Tarragona;8;Baix Camp;43123;Reus;8;2;A;;482;93;167;206;276;0;6;200;206
43;Tarragona;8;Baix Camp;43123;Reus;8;2;B;;469;96;193;236;233;0;5;231;236
43;Tarragona;8;Baix Camp;43123;Reus;8;3;A;;458;122;208;272;186;2;0;270;270
43;Tarragona;8;Baix Camp;43123;Reus;8;3;B;;577;144;277;340;237;3;7;330;337
43;Tarragona;8;Baix Camp;43123;Reus;8;4;A;;401;90;180;224;177;0;3;221;224
43;Tarragona;8;Baix Camp;43123;Reus;8;4;B;;452;104;204;253;199;1;4;248;252
43;Tarragona;8;Baix Camp;43123;Reus;8;5;U;;823;217;387;477;346;7;10;460;470
43;Tarragona;8;Baix Camp;43123;Reus;8;6;A;;630;152;293;364;266;0;5;359;364
43;Tarragona;8;Baix Camp;43123;Reus;8;6;B;;763;172;356;450;313;1;7;442;449
43;Tarragona;8;Baix Camp;43123;Reus;8;7;A;;569;116;252;337;232;3;7;327;334
43;Tarragona;8;Baix Camp;43123;Reus;8;7;B;;613;138;262;339;274;2;4;333;337
43;Tarragona;8;Baix Camp;43123;Reus;8;7;C;;593;131;280;351;242;0;5;346;351
43;Tarragona;8;Baix Camp;43123;Reus;9;1;A;;540;140;288;377;163;3;5;369;374
43;Tarragona;8;Baix Camp;43123;Reus;9;1;B;;640;175;365;452;188;1;9;442;451
43;Tarragona;8;Baix Camp;43123;Reus;9;2;A;;341;49;101;138;203;0;0;138;138
43;Tarragona;8;Baix Camp;43123;Reus;9;2;B;;317;68;118;151;166;0;0;151;151
25;Lleida;26;Pallars Sobirà;25183;Rialp;1;1;U;;488;202;262;356;132;4;15;337;352
43;Tarragona;1;Alt Camp;43124;Riba, la;1;1;U;;527;137;265;340;187;7;2;331;333
43;Tarragona;30;Ribera d'Ebre;43125;Riba-roja d'Ebre;1;1;A;;550;132;287;361;189;4;1;356;357
43;Tarragona;30;Ribera d'Ebre;43125;Riba-roja d'Ebre;1;1;B;;450;111;207;284;166;6;6;272;278
25;Lleida;32;Segarra;25905;Ribera d'Ondara;1;1;U;;390;131;242;275;115;2;12;261;273
25;Lleida;4;Alt Urgell;25185;Ribera d'Urgellet;1;1;U;;699;160;339;424;275;2;5;417;422
17;Girona;31;Ripollès;17145;Ribes de Freser;1;1;U;;759;216;433;529;230;5;14;510;524
17;Girona;31;Ripollès;17145;Ribes de Freser;1;2;U;;836;237;446;566;270;10;25;531;556
17;Girona;34;Selva;17146;Riells i Viabrea;1;1;A;;661;152;324;403;258;5;14;384;398
17;Girona;34;Selva;17146;Riells i Viabrea;1;1;B;;720;180;362;442;278;3;14;425;439
17;Girona;34;Selva;17146;Riells i Viabrea;1;2;A;;723;156;327;398;325;1;11;386;397
17;Girona;34;Selva;17146;Riells i Viabrea;1;2;B;;769;264;429;412;357;0;8;404;412
43;Tarragona;36;Tarragonès;43126;Riera de Gaià, la;1;1;U;;1163;331;643;778;385;10;13;755;768
25;Lleida;35;Solsonès;25186;Riner;1;1;U;;226;71;150;181;45;2;3;176;179
17;Girona;31;Ripollès;17147;Ripoll;1;1;A;;606;167;297;343;263;3;8;332;340
17;Girona;31;Ripollès;17147;Ripoll;1;1;B;;578;157;293;345;233;1;15;329;344
17;Girona;31;Ripollès;17147;Ripoll;2;1;U;;650;228;370;443;207;1;8;434;442
17;Girona;31;Ripollès;17147;Ripoll;2;2;U;;657;189;330;380;277;8;8;364;372
17;Girona;31;Ripollès;17147;Ripoll;3;1;A;;500;131;252;298;202;2;9;287;296
17;Girona;31;Ripollès;17147;Ripoll;3;1;B;;543;140;275;330;213;3;15;312;327
17;Girona;31;Ripollès;17147;Ripoll;3;2;U;;671;160;352;436;235;1;16;419;435
17;Girona;31;Ripollès;17147;Ripoll;3;3;A;;802;257;447;541;261;2;29;510;539
17;Girona;31;Ripollès;17147;Ripoll;3;3;B;;859;238;487;592;267;6;15;571;586
17;Girona;31;Ripollès;17147;Ripoll;3;4;A;;784;216;397;499;285;6;9;484;493
17;Girona;31;Ripollès;17147;Ripoll;3;4;B;;811;189;419;512;299;3;12;497;509
17;Girona;31;Ripollès;17147;Ripoll;4;1;U;;1012;248;549;682;330;1;13;668;681
8;Barcelona;40;Vallès Occidental;08180;Ripollet;1;1;A;;659;134;252;313;346;4;8;301;309
8;Barcelona;40;Vallès Occidental;08180;Ripollet;1;1;B;;774;173;314;391;383;0;0;391;391
8;Barcelona;40;Vallès Occidental;08180;Ripollet;1;10;A;;444;95;202;237;207;0;5;232;237
8;Barcelona;40;Vallès Occidental;08180;Ripollet;1;10;B;;505;93;192;250;255;2;14;234;248
8;Barcelona;40;Vallès Occidental;08180;Ripollet;1;11;A;;646;119;271;338;308;0;8;330;338
8;Barcelona;40;Vallès Occidental;08180;Ripollet;1;11;B;;826;128;350;459;367;0;17;442;459
8;Barcelona;40;Vallès Occidental;08180;Ripollet;1;12;U;;898;153;331;501;397;1;24;476;500
8;Barcelona;40;Vallès Occidental;08180;Ripollet;1;13;A;;677;151;318;423;254;2;14;407;421
8;Barcelona;40;Vallès Occidental;08180;Ripollet;1;13;B;;788;150;336;450;338;2;16;432;448
8;Barcelona;40;Vallès Occidental;08180;Ripollet;1;2;A;;650;175;326;399;251;0;10;389;399
8;Barcelona;40;Vallès Occidental;08180;Ripollet;1;2;B;;765;180;364;470;295;3;10;457;467
8;Barcelona;40;Vallès Occidental;08180;Ripollet;1;3;A;;592;146;266;329;263;1;13;315;328
8;Barcelona;40;Vallès Occidental;08180;Ripollet;1;3;B;;737;193;320;402;335;0;15;387;402
8;Barcelona;40;Vallès Occidental;08180;Ripollet;1;4;A;;621;160;292;356;265;1;12;343;355
8;Barcelona;40;Vallès Occidental;08180;Ripollet;1;4;B;;802;193;373;463;339;4;21;438;459
8;Barcelona;40;Vallès Occidental;08180;Ripollet;1;5;A;;698;168;284;368;330;1;13;354;367
8;Barcelona;40;Vallès Occidental;08180;Ripollet;1;5;B;;861;192;320;422;439;0;13;409;422
8;Barcelona;40;Vallès Occidental;08180;Ripollet;1;6;A;;527;127;239;284;243;2;4;278;282
8;Barcelona;40;Vallès Occidental;08180;Ripollet;1;6;B;;661;152;274;337;324;1;10;326;336
8;Barcelona;40;Vallès Occidental;08180;Ripollet;1;7;A;;769;168;309;381;388;2;12;367;379
8;Barcelona;40;Vallès Occidental;08180;Ripollet;1;7;B;;878;181;335;438;440;3;9;426;435
8;Barcelona;40;Vallès Occidental;08180;Ripollet;1;8;A;;525;88;198;265;260;0;6;259;265
8;Barcelona;40;Vallès Occidental;08180;Ripollet;1;8;B;;679;137;271;338;341;1;11;326;337
8;Barcelona;40;Vallès Occidental;08180;Ripollet;1;8;C;;592;128;254;305;287;2;5;298;303
8;Barcelona;40;Vallès Occidental;08180;Ripollet;1;9;A;;556;104;253;332;224;0;7;325;332
8;Barcelona;40;Vallès Occidental;08180;Ripollet;1;9;B;;662;153;317;417;245;0;9;408;417
8;Barcelona;40;Vallès Occidental;08180;Ripollet;2;1;A;;542;129;247;282;260;1;12;269;281
8;Barcelona;40;Vallès Occidental;08180;Ripollet;2;1;B;;665;165;305;357;308;5;12;340;352
8;Barcelona;40;Vallès Occidental;08180;Ripollet;2;2;A;;628;150;254;326;302;0;8;318;326
8;Barcelona;40;Vallès Occidental;08180;Ripollet;2;2;B;;695;160;268;333;362;2;16;315;331
8;Barcelona;40;Vallès Occidental;08180;Ripollet;2;3;A;;576;119;217;283;293;3;10;270;280
8;Barcelona;40;Vallès Occidental;08180;Ripollet;2;3;B;;565;116;207;265;300;0;7;258;265
8;Barcelona;40;Vallès Occidental;08180;Ripollet;2;3;C;;434;84;148;196;238;0;7;189;196
8;Barcelona;40;Vallès Occidental;08180;Ripollet;2;4;A;;618;126;259;314;304;3;14;297;311
8;Barcelona;40;Vallès Occidental;08180;Ripollet;2;4;B;;688;147;297;359;329;7;1;351;352
8;Barcelona;40;Vallès Occidental;08180;Ripollet;2;5;A;;429;97;172;200;229;0;7;193;200
8;Barcelona;40;Vallès Occidental;08180;Ripollet;2;5;B;;473;87;167;201;272;0;6;195;201
8;Barcelona;40;Vallès Occidental;08180;Ripollet;2;6;A;;513;109;216;264;249;2;7;255;262
8;Barcelona;40;Vallès Occidental;08180;Ripollet;2;6;B;;681;137;263;333;348;1;7;325;332
8;Barcelona;40;Vallès Occidental;08180;Ripollet;2;7;A;;382;91;152;181;201;1;1;179;180
8;Barcelona;40;Vallès Occidental;08180;Ripollet;2;7;B;;490;84;167;209;281;1;5;203;208
17;Girona;34;Selva;17148;Riudarenes;1;1;A;;802;222;391;459;343;1;19;439;458
17;Girona;34;Selva;17148;Riudarenes;1;1;B;;750;214;395;429;321;7;6;416;422
17;Girona;19;Garrotxa;17149;Riudaura;1;1;U;;362;108;209;263;99;3;5;255;260
43;Tarragona;8;Baix Camp;43127;Riudecanyes;1;1;U;;773;169;407;507;266;4;6;497;503
25;Lleida;15;Cerdanya;25913;Riu de Cerdanya;1;1;U;;95;28;54;76;19;0;1;75;76
43;Tarragona;8;Baix Camp;43128;Riudecols;1;1;U;;925;205;477;616;309;6;5;605;610
17;Girona;34;Selva;17150;Riudellots de la Selva;1;1;A;;734;212;428;516;218;6;18;492;510
17;Girona;34;Selva;17150;Riudellots de la Selva;1;1;B;;709;205;407;512;197;8;15;489;504
43;Tarragona;8;Baix Camp;43129;Riudoms;1;1;A;;497;103;233;306;191;6;9;291;300
43;Tarragona;8;Baix Camp;43129;Riudoms;1;1;B;;462;106;211;272;190;4;5;263;268
43;Tarragona;8;Baix Camp;43129;Riudoms;2;1;A;;298;82;153;201;97;4;2;195;197
43;Tarragona;8;Baix Camp;43129;Riudoms;2;1;B;;310;76;149;198;112;2;3;193;196
43;Tarragona;8;Baix Camp;43129;Riudoms;2;2;A;;391;91;211;278;113;3;5;270;275
43;Tarragona;8;Baix Camp;43129;Riudoms;2;2;B;;430;104;217;292;138;1;5;286;291
43;Tarragona;8;Baix Camp;43129;Riudoms;2;2;C;;407;99;196;251;156;0;5;246;251
43;Tarragona;8;Baix Camp;43129;Riudoms;2;2;D;;491;114;238;309;182;3;4;302;306
43;Tarragona;8;Baix Camp;43129;Riudoms;2;3;A;;415;78;183;266;149;2;3;261;264
43;Tarragona;8;Baix Camp;43129;Riudoms;2;3;B;;413;84;191;246;167;1;6;239;245
43;Tarragona;8;Baix Camp;43129;Riudoms;2;3;C;;428;101;194;261;167;3;10;248;258
17;Girona;2;Alt Empordà;17151;Riumors;1;1;U;;171;66;104;122;49;0;1;121;122
8;Barcelona;41;Vallès Oriental;08181;Roca del Vallès, la;1;1;U;;987;310;567;708;279;8;15;685;700
8;Barcelona;41;Vallès Oriental;08181;Roca del Vallès, la;1;2;U;;772;199;384;453;319;3;12;438;450
8;Barcelona;41;Vallès Oriental;08181;Roca del Vallès, la;1;3;A;;614;148;273;361;253;0;11;350;361
8;Barcelona;41;Vallès Oriental;08181;Roca del Vallès, la;1;3;B;;783;138;320;437;346;2;8;427;435
8;Barcelona;41;Vallès Oriental;08181;Roca del Vallès, la;1;3;C;;668;137;317;406;262;1;13;392;405
8;Barcelona;41;Vallès Oriental;08181;Roca del Vallès, la;1;4;A;;779;195;404;488;291;5;9;474;483
8;Barcelona;41;Vallès Oriental;08181;Roca del Vallès, la;1;4;B;;792;202;377;479;313;2;13;464;477
8;Barcelona;41;Vallès Oriental;08181;Roca del Vallès, la;1;5;A;;779;188;403;480;299;17;4;459;463
8;Barcelona;41;Vallès Oriental;08181;Roca del Vallès, la;1;5;B;;803;196;365;458;345;2;14;442;456
8;Barcelona;41;Vallès Oriental;08181;Roca del Vallès, la;1;5;C;;737;188;376;458;279;2;11;445;456
43;Tarragona;16;Conca de Barberà;43130;Rocafort de Queralt;1;1;U;;200;41;104;128;72;0;0;128;128
43;Tarragona;36;Tarragonès;43131;Roda de Berà;1;1;A;;549;159;276;322;227;0;15;307;322
43;Tarragona;36;Tarragonès;43131;Roda de Berà;1;1;B;;726;178;327;399;327;3;7;389;396
43;Tarragona;36;Tarragonès;43131;Roda de Berà;1;1;C;;587;160;273;310;277;0;11;299;310
43;Tarragona;36;Tarragonès;43131;Roda de Berà;1;2;A;;534;141;211;260;274;0;5;255;260
43;Tarragona;36;Tarragonès;43131;Roda de Berà;1;2;B;;683;187;266;334;349;0;7;327;334
43;Tarragona;36;Tarragonès;43131;Roda de Berà;1;3;A;;598;158;296;360;238;2;5;353;358
43;Tarragona;36;Tarragonès;43131;Roda de Berà;1;3;B;;726;198;341;402;324;2;7;393;400
8;Barcelona;24;Osona;08183;Roda de Ter;1;1;A;;659;192;349;415;244;2;10;403;413
8;Barcelona;24;Osona;08183;Roda de Ter;1;1;B;;769;214;384;463;306;0;16;447;463
8;Barcelona;24;Osona;08183;Roda de Ter;1;2;A;;544;172;345;415;129;3;15;397;412
8;Barcelona;24;Osona;08183;Roda de Ter;1;2;B;;653;194;387;454;199;4;16;434;450
8;Barcelona;24;Osona;08183;Roda de Ter;1;3;A;;495;147;279;326;169;1;9;316;325
8;Barcelona;24;Osona;08183;Roda de Ter;1;3;B;;535;168;305;354;181;1;7;346;353
8;Barcelona;24;Osona;08183;Roda de Ter;2;1;U;;847;271;493;577;270;1;14;562;576
43;Tarragona;1;Alt Camp;43132;Rodonyà;1;1;U;;370;86;198;232;138;2;12;218;230
43;Tarragona;9;Baix Ebre;43133;Roquetes;1;1;A;;570;125;270;342;228;4;13;325;338
43;Tarragona;9;Baix Ebre;43133;Roquetes;1;1;B;;462;85;193;256;206;0;9;247;256
43;Tarragona;9;Baix Ebre;43133;Roquetes;1;2;A;;660;151;297;378;282;8;20;350;370
43;Tarragona;9;Baix Ebre;43133;Roquetes;1;2;B;;565;134;247;312;253;4;17;291;308
43;Tarragona;9;Baix Ebre;43133;Roquetes;2;1;A;;607;139;278;368;239;0;23;345;368
43;Tarragona;9;Baix Ebre;43133;Roquetes;2;1;B;;637;150;311;398;239;2;23;373;396
43;Tarragona;9;Baix Ebre;43133;Roquetes;2;1;C;;599;160;281;369;230;5;15;349;364
43;Tarragona;9;Baix Ebre;43133;Roquetes;2;2;A;;779;163;343;423;356;6;15;402;417
43;Tarragona;9;Baix Ebre;43133;Roquetes;2;2;B;;776;166;316;400;376;9;11;380;391
17;Girona;2;Alt Empordà;17152;Roses;1;1;A;;532;169;260;295;237;2;6;287;293
17;Girona;2;Alt Empordà;17152;Roses;1;1;B;;493;141;239;268;225;2;4;262;266
17;Girona;2;Alt Empordà;17152;Roses;1;2;A;;433;121;205;233;200;4;5;224;229
17;Girona;2;Alt Empordà;17152;Roses;1;2;B;;518;149;270;312;206;1;9;302;311
17;Girona;2;Alt Empordà;17152;Roses;1;3;A;;503;90;152;186;317;2;6;178;184
17;Girona;2;Alt Empordà;17152;Roses;1;3;B;;414;72;120;148;266;2;2;144;146
17;Girona;2;Alt Empordà;17152;Roses;1;4;A;;521;121;220;247;274;6;5;236;241
17;Girona;2;Alt Empordà;17152;Roses;1;4;B;;499;98;220;249;250;1;5;243;248
17;Girona;2;Alt Empordà;17152;Roses;1;5;U;;679;145;289;344;335;0;7;337;344
17;Girona;2;Alt Empordà;17152;Roses;1;6;A;;578;154;268;313;265;2;5;306;311
17;Girona;2;Alt Empordà;17152;Roses;1;6;B;;565;143;257;313;252;0;10;303;313
17;Girona;2;Alt Empordà;17152;Roses;2;1;A;;484;135;239;270;214;5;4;261;265
17;Girona;2;Alt Empordà;17152;Roses;2;1;B;;486;138;231;258;228;1;4;253;257
17;Girona;2;Alt Empordà;17152;Roses;2;2;A;;583;166;288;339;244;2;3;334;337
17;Girona;2;Alt Empordà;17152;Roses;2;2;B;;629;175;291;334;295;5;5;324;329
17;Girona;2;Alt Empordà;17152;Roses;2;3;U;;739;191;355;426;313;3;14;409;423
17;Girona;2;Alt Empordà;17152;Roses;2;4;U;;679;185;376;432;247;3;8;421;429
17;Girona;2;Alt Empordà;17152;Roses;2;5;A;;473;117;204;234;239;4;8;222;230
17;Girona;2;Alt Empordà;17152;Roses;2;5;B;;475;138;231;266;209;1;11;254;265
25;Lleida;33;Segrià;25189;Rosselló;1;1;A;;643;144;287;374;269;4;15;355;370
25;Lleida;33;Segrià;25189;Rosselló;1;1;B;;781;156;364;449;332;5;17;427;444
25;Lleida;33;Segrià;25189;Rosselló;1;1;C;;630;112;257;334;296;3;16;315;331
43;Tarragona;1;Alt Camp;43134;Rourell, el;1;1;U;;278;87;161;189;89;0;2;187;189
8;Barcelona;40;Vallès Occidental;08184;Rubí;1;1;A;;682;145;294;377;305;0;12;365;377
8;Barcelona;40;Vallès Occidental;08184;Rubí;1;1;B;;871;159;352;444;427;5;15;424;439
8;Barcelona;40;Vallès Occidental;08184;Rubí;1;1;C;;835;180;383;465;370;2;11;452;463
8;Barcelona;40;Vallès Occidental;08184;Rubí;1;2;A;;654;132;232;289;365;1;15;273;288
8;Barcelona;40;Vallès Occidental;08184;Rubí;1;2;B;;689;129;227;296;393;2;8;286;294
8;Barcelona;40;Vallès Occidental;08184;Rubí;1;3;A;;487;107;207;263;224;2;7;254;261
8;Barcelona;40;Vallès Occidental;08184;Rubí;1;3;B;;641;136;279;359;282;1;6;352;358
8;Barcelona;40;Vallès Occidental;08184;Rubí;2;1;A;;771;151;305;377;394;0;7;370;377
8;Barcelona;40;Vallès Occidental;08184;Rubí;2;1;B;;648;121;230;309;339;2;13;294;307
8;Barcelona;40;Vallès Occidental;08184;Rubí;2;1;C;;907;159;361;439;468;0;14;425;439
8;Barcelona;40;Vallès Occidental;08184;Rubí;2;1;D;;724;134;290;364;360;0;20;344;364
8;Barcelona;40;Vallès Occidental;08184;Rubí;2;3;A;;938;169;356;438;500;2;11;425;436
8;Barcelona;40;Vallès Occidental;08184;Rubí;2;3;B;;813;149;281;358;455;5;12;341;353
8;Barcelona;40;Vallès Occidental;08184;Rubí;2;3;C;;1121;214;415;516;605;3;15;498;513
8;Barcelona;40;Vallès Occidental;08184;Rubí;2;3;D;;904;146;302;395;509;0;11;384;395
8;Barcelona;40;Vallès Occidental;08184;Rubí;3;1;A;;665;171;343;421;244;2;11;408;419
8;Barcelona;40;Vallès Occidental;08184;Rubí;3;1;B;;656;132;304;384;272;3;14;367;381
8;Barcelona;40;Vallès Occidental;08184;Rubí;3;1;C;;849;187;392;496;353;3;19;474;493
8;Barcelona;40;Vallès Occidental;08184;Rubí;3;1;D;;690;162;331;400;290;2;12;386;398
8;Barcelona;40;Vallès Occidental;08184;Rubí;3;2;U;;462;87;164;210;252;3;7;200;207
8;Barcelona;40;Vallès Occidental;08184;Rubí;3;3;U;;751;194;320;370;381;2;4;364;368
8;Barcelona;40;Vallès Occidental;08184;Rubí;3;4;A;;622;130;246;311;311;2;5;304;309
8;Barcelona;40;Vallès Occidental;08184;Rubí;3;4;B;;635;134;285;348;287;2;13;333;346
8;Barcelona;40;Vallès Occidental;08184;Rubí;3;5;A;;652;152;278;341;311;1;10;330;340
8;Barcelona;40;Vallès Occidental;08184;Rubí;3;5;B;;806;196;353;425;381;1;7;417;424
8;Barcelona;40;Vallès Occidental;08184;Rubí;3;6;A;;578;132;264;313;265;1;8;304;312
8;Barcelona;40;Vallès Occidental;08184;Rubí;3;6;B;;662;175;298;372;290;1;1;370;371
8;Barcelona;40;Vallès Occidental;08184;Rubí;3;7;A;;562;130;248;313;249;1;14;298;312
8;Barcelona;40;Vallès Occidental;08184;Rubí;3;7;B;;662;175;294;374;288;1;18;355;373
8;Barcelona;40;Vallès Occidental;08184;Rubí;3;8;A;;423;82;166;187;236;1;6;180;186
8;Barcelona;40;Vallès Occidental;08184;Rubí;3;8;B;;478;114;196;223;255;0;4;219;223
8;Barcelona;40;Vallès Occidental;08184;Rubí;4;1;A;;446;150;248;283;163;0;7;276;283
8;Barcelona;40;Vallès Occidental;08184;Rubí;4;1;B;;617;155;304;361;256;1;8;352;360
8;Barcelona;40;Vallès Occidental;08184;Rubí;4;10;A;;761;149;294;366;395;1;10;355;365
8;Barcelona;40;Vallès Occidental;08184;Rubí;4;10;B;;898;131;339;420;478;0;6;414;420
8;Barcelona;40;Vallès Occidental;08184;Rubí;4;10;C;;898;158;317;410;488;4;7;399;406
8;Barcelona;40;Vallès Occidental;08184;Rubí;4;11;A;;469;99;180;234;235;0;13;221;234
8;Barcelona;40;Vallès Occidental;08184;Rubí;4;11;B;;594;152;272;330;264;2;10;318;328
8;Barcelona;40;Vallès Occidental;08184;Rubí;4;11;C;;598;126;235;298;300;0;9;289;298
8;Barcelona;40;Vallès Occidental;08184;Rubí;4;12;A;;518;121;204;263;255;0;10;253;263
8;Barcelona;40;Vallès Occidental;08184;Rubí;4;12;B;;693;138;258;337;356;1;9;327;336
8;Barcelona;40;Vallès Occidental;08184;Rubí;4;13;A;;729;170;319;413;316;1;9;403;412
8;Barcelona;40;Vallès Occidental;08184;Rubí;4;13;B;;728;185;325;389;339;1;13;375;388
8;Barcelona;40;Vallès Occidental;08184;Rubí;4;13;C;;732;166;301;374;358;3;7;364;371
8;Barcelona;40;Vallès Occidental;08184;Rubí;4;14;A;;605;131;241;308;297;2;10;296;306
8;Barcelona;40;Vallès Occidental;08184;Rubí;4;14;B;;722;129;266;327;395;0;8;319;327
8;Barcelona;40;Vallès Occidental;08184;Rubí;4;14;C;;710;152;290;345;365;0;13;332;345
8;Barcelona;40;Vallès Occidental;08184;Rubí;4;15;A;;480;86;181;240;240;2;10;228;238
8;Barcelona;40;Vallès Occidental;08184;Rubí;4;15;B;;595;97;207;270;325;0;6;264;270
8;Barcelona;40;Vallès Occidental;08184;Rubí;4;16;A;;647;136;284;357;290;1;5;351;356
8;Barcelona;40;Vallès Occidental;08184;Rubí;4;16;B;;710;152;291;356;354;2;7;347;354
8;Barcelona;40;Vallès Occidental;08184;Rubí;4;16;C;;860;159;325;418;442;3;17;398;415
8;Barcelona;40;Vallès Occidental;08184;Rubí;4;16;D;;685;113;263;340;345;1;15;324;339
8;Barcelona;40;Vallès Occidental;08184;Rubí;4;16;E;;290;71;98;107;183;1;0;106;106
8;Barcelona;40;Vallès Occidental;08184;Rubí;4;18;A;;417;100;183;241;176;3;10;228;238
8;Barcelona;40;Vallès Occidental;08184;Rubí;4;18;B;;450;101;186;250;200;0;9;241;250
8;Barcelona;40;Vallès Occidental;08184;Rubí;4;19;A;;440;72;162;210;230;3;5;202;207
8;Barcelona;40;Vallès Occidental;08184;Rubí;4;19;B;;482;83;180;217;265;1;7;209;216
8;Barcelona;40;Vallès Occidental;08184;Rubí;4;2;U;;889;235;442;529;360;1;26;502;528
8;Barcelona;40;Vallès Occidental;08184;Rubí;4;20;A;;451;85;175;211;240;0;11;200;211
8;Barcelona;40;Vallès Occidental;08184;Rubí;4;20;B;;517;99;187;245;272;1;9;235;244
8;Barcelona;40;Vallès Occidental;08184;Rubí;4;21;A;;656;118;263;348;308;0;12;336;348
8;Barcelona;40;Vallès Occidental;08184;Rubí;4;21;B;;743;143;317;408;335;2;7;399;406
8;Barcelona;40;Vallès Occidental;08184;Rubí;4;22;A;;611;157;291;371;240;1;15;355;370
8;Barcelona;40;Vallès Occidental;08184;Rubí;4;22;B;;714;151;311;390;324;2;17;371;388
8;Barcelona;40;Vallès Occidental;08184;Rubí;4;3;A;;495;125;227;278;217;2;14;262;276
8;Barcelona;40;Vallès Occidental;08184;Rubí;4;3;B;;600;163;279;346;254;4;9;333;342
8;Barcelona;40;Vallès Occidental;08184;Rubí;4;4;A;;699;131;273;329;370;10;1;318;319
8;Barcelona;40;Vallès Occidental;08184;Rubí;4;4;B;;816;140;313;373;443;0;13;360;373
8;Barcelona;40;Vallès Occidental;08184;Rubí;4;5;A;;538;154;287;346;192;2;6;338;344
8;Barcelona;40;Vallès Occidental;08184;Rubí;4;5;B;;605;156;297;364;241;1;9;354;363
8;Barcelona;40;Vallès Occidental;08184;Rubí;4;6;A;;537;131;254;303;234;1;6;296;302
8;Barcelona;40;Vallès Occidental;08184;Rubí;4;6;B;;592;166;280;345;247;0;6;339;345
8;Barcelona;40;Vallès Occidental;08184;Rubí;4;7;A;;528;140;254;314;214;6;8;300;308
8;Barcelona;40;Vallès Occidental;08184;Rubí;4;7;B;;641;172;302;373;268;1;14;358;372
8;Barcelona;40;Vallès Occidental;08184;Rubí;4;8;U;;862;180;336;412;450;1;8;403;411
8;Barcelona;40;Vallès Occidental;08184;Rubí;4;9;A;;577;120;227;290;287;1;13;276;289
8;Barcelona;40;Vallès Occidental;08184;Rubí;4;9;B;;737;158;275;353;384;2;8;343;351
8;Barcelona;6;Anoia;08185;Rubió;1;1;U;;176;50;88;111;65;1;0;110;110
17;Girona;10;Baix Empordà;17153;Rupià;1;1;U;;168;56;100;121;47;0;4;117;121
8;Barcelona;24;Osona;08901;Rupit i Pruit;1;1;U;;253;81;162;202;51;3;6;193;199
8;Barcelona;40;Vallès Occidental;08187;Sabadell;1;1;U;;525;167;329;396;129;0;10;386;396
8;Barcelona;40;Vallès Occidental;08187;Sabadell;1;10;U;;851;235;476;588;263;0;20;568;588
8;Barcelona;40;Vallès Occidental;08187;Sabadell;1;11;U;;919;276;549;689;230;3;15;671;686
8;Barcelona;40;Vallès Occidental;08187;Sabadell;1;12;U;;797;234;479;580;217;3;9;568;577
8;Barcelona;40;Vallès Occidental;08187;Sabadell;1;13;U;;750;224;413;518;232;1;8;509;517
8;Barcelona;40;Vallès Occidental;08187;Sabadell;1;14;A;;570;176;337;434;136;4;11;419;430
8;Barcelona;40;Vallès Occidental;08187;Sabadell;1;14;B;;721;223;412;536;185;2;7;527;534
8;Barcelona;40;Vallès Occidental;08187;Sabadell;1;15;A;;498;171;319;393;105;1;10;382;392
8;Barcelona;40;Vallès Occidental;08187;Sabadell;1;15;B;;638;205;377;489;149;5;8;476;484
8;Barcelona;40;Vallès Occidental;08187;Sabadell;1;16;A;;703;191;419;525;178;5;9;511;520
8;Barcelona;40;Vallès Occidental;08187;Sabadell;1;16;B;;822;231;496;610;212;2;11;597;608
8;Barcelona;40;Vallès Occidental;08187;Sabadell;1;17;A;;724;175;368;472;252;1;14;457;471
8;Barcelona;40;Vallès Occidental;08187;Sabadell;1;17;B;;916;207;474;578;338;3;12;563;575
8;Barcelona;40;Vallès Occidental;08187;Sabadell;1;18;A;;672;160;327;414;258;0;9;405;414
8;Barcelona;40;Vallès Occidental;08187;Sabadell;1;18;B;;781;177;366;485;296;2;17;466;483
8;Barcelona;40;Vallès Occidental;08187;Sabadell;1;19;A;;621;177;364;454;167;0;12;442;454
8;Barcelona;40;Vallès Occidental;08187;Sabadell;1;19;B;;723;207;399;505;218;0;14;491;505
8;Barcelona;40;Vallès Occidental;08187;Sabadell;1;2;U;;868;307;582;693;175;2;9;682;691
8;Barcelona;40;Vallès Occidental;08187;Sabadell;1;20;A;;549;124;265;366;183;1;6;359;365
8;Barcelona;40;Vallès Occidental;08187;Sabadell;1;20;B;;609;174;320;406;203;1;14;391;405
8;Barcelona;40;Vallès Occidental;08187;Sabadell;1;21;U;;859;250;458;573;286;3;12;558;570
8;Barcelona;40;Vallès Occidental;08187;Sabadell;1;22;U;;725;274;454;473;252;8;13;452;465
8;Barcelona;40;Vallès Occidental;08187;Sabadell;1;23;A;;609;157;302;392;217;1;9;382;391
8;Barcelona;40;Vallès Occidental;08187;Sabadell;1;23;B;;762;206;378;476;286;0;19;457;476
8;Barcelona;40;Vallès Occidental;08187;Sabadell;1;24;A;;547;140;269;339;208;6;3;330;333
8;Barcelona;40;Vallès Occidental;08187;Sabadell;1;24;B;;648;164;305;369;279;5;6;358;364
8;Barcelona;40;Vallès Occidental;08187;Sabadell;1;25;A;;502;153;278;325;177;0;16;309;325
8;Barcelona;40;Vallès Occidental;08187;Sabadell;1;25;B;;598;167;303;378;220;1;10;367;377
8;Barcelona;40;Vallès Occidental;08187;Sabadell;1;26;U;;656;216;352;429;227;0;6;423;429
8;Barcelona;40;Vallès Occidental;08187;Sabadell;1;27;U;;778;200;401;508;270;0;10;498;508
8;Barcelona;40;Vallès Occidental;08187;Sabadell;1;28;U;;1038;260;539;702;336;4;19;679;698
8;Barcelona;40;Vallès Occidental;08187;Sabadell;1;29;U;;992;241;520;645;347;0;21;624;645
8;Barcelona;40;Vallès Occidental;08187;Sabadell;1;3;U;;749;184;435;562;187;0;12;550;562
8;Barcelona;40;Vallès Occidental;08187;Sabadell;1;30;U;;822;246;556;635;187;0;13;622;635
8;Barcelona;40;Vallès Occidental;08187;Sabadell;1;31;U;;804;206;492;621;183;4;21;596;617
8;Barcelona;40;Vallès Occidental;08187;Sabadell;1;32;U;;907;209;526;642;265;3;22;617;639
8;Barcelona;40;Vallès Occidental;08187;Sabadell;1;33;U;;913;230;518;577;336;6;20;551;571
8;Barcelona;40;Vallès Occidental;08187;Sabadell;1;34;U;;1033;265;551;730;303;4;30;696;726
8;Barcelona;40;Vallès Occidental;08187;Sabadell;1;35;U;;762;258;452;546;216;3;9;534;543
8;Barcelona;40;Vallès Occidental;08187;Sabadell;1;4;A;;799;238;458;624;175;3;16;605;621
8;Barcelona;40;Vallès Occidental;08187;Sabadell;1;4;B;;912;271;542;692;220;6;22;664;686
8;Barcelona;40;Vallès Occidental;08187;Sabadell;1;5;A;;572;156;338;404;168;0;6;398;404
8;Barcelona;40;Vallès Occidental;08187;Sabadell;1;5;B;;604;183;365;442;162;1;8;433;441
8;Barcelona;40;Vallès Occidental;08187;Sabadell;1;6;A;;868;260;531;674;194;0;18;656;674
8;Barcelona;40;Vallès Occidental;08187;Sabadell;1;6;B;;992;260;603;779;213;1;9;769;778
8;Barcelona;40;Vallès Occidental;08187;Sabadell;1;7;A;;729;156;477;566;163;4;12;550;562
8;Barcelona;40;Vallès Occidental;08187;Sabadell;1;7;B;;773;141;493;588;185;2;16;570;586
8;Barcelona;40;Vallès Occidental;08187;Sabadell;1;8;A;;741;203;447;555;186;2;20;533;553
8;Barcelona;40;Vallès Occidental;08187;Sabadell;1;8;B;;863;286;549;667;196;4;28;635;663
8;Barcelona;40;Vallès Occidental;08187;Sabadell;1;9;A;;892;280;574;700;192;0;25;675;700
8;Barcelona;40;Vallès Occidental;08187;Sabadell;1;9;B;;942;298;571;723;219;0;13;710;723
8;Barcelona;40;Vallès Occidental;08187;Sabadell;2;1;A;;564;186;374;467;97;1;12;454;466
8;Barcelona;40;Vallès Occidental;08187;Sabadell;2;1;B;;720;236;458;577;143;3;7;567;574
8;Barcelona;40;Vallès Occidental;08187;Sabadell;2;10;U;;655;198;393;448;207;0;15;433;448
8;Barcelona;40;Vallès Occidental;08187;Sabadell;2;11;U;;638;131;239;275;363;0;5;270;275
8;Barcelona;40;Vallès Occidental;08187;Sabadell;2;12;A;;573;102;232;267;306;1;7;259;266
8;Barcelona;40;Vallès Occidental;08187;Sabadell;2;12;B;;676;142;287;331;345;2;11;318;329
8;Barcelona;40;Vallès Occidental;08187;Sabadell;2;13;U;;845;170;293;359;486;4;5;350;355
8;Barcelona;40;Vallès Occidental;08187;Sabadell;2;14;U;;843;167;283;369;474;2;8;359;367
8;Barcelona;40;Vallès Occidental;08187;Sabadell;2;15;A;;474;121;216;280;194;0;7;273;280
8;Barcelona;40;Vallès Occidental;08187;Sabadell;2;15;B;;600;188;300;367;233;0;8;359;367
8;Barcelona;40;Vallès Occidental;08187;Sabadell;2;16;A;;577;166;362;415;162;1;11;403;414
8;Barcelona;40;Vallès Occidental;08187;Sabadell;2;16;B;;645;175;320;460;185;7;13;440;453
8;Barcelona;40;Vallès Occidental;08187;Sabadell;2;17;U;;719;188;392;501;218;7;17;477;494
8;Barcelona;40;Vallès Occidental;08187;Sabadell;2;2;A;;499;141;320;378;121;2;14;362;376
8;Barcelona;40;Vallès Occidental;08187;Sabadell;2;2;B;;547;159;334;392;155;2;11;379;390
8;Barcelona;40;Vallès Occidental;08187;Sabadell;2;3;A;;476;149;248;302;174;1;10;291;301
8;Barcelona;40;Vallès Occidental;08187;Sabadell;2;3;B;;584;127;290;360;224;2;16;342;358
8;Barcelona;40;Vallès Occidental;08187;Sabadell;2;4;A;;637;188;385;457;180;2;9;446;455
8;Barcelona;40;Vallès Occidental;08187;Sabadell;2;4;B;;808;205;496;597;211;4;12;581;593
8;Barcelona;40;Vallès Occidental;08187;Sabadell;2;5;A;;575;160;320;412;163;2;12;398;410
8;Barcelona;40;Vallès Occidental;08187;Sabadell;2;5;B;;738;218;411;524;214;3;10;511;521
8;Barcelona;40;Vallès Occidental;08187;Sabadell;2;6;A;;509;141;281;345;164;3;2;340;342
8;Barcelona;40;Vallès Occidental;08187;Sabadell;2;6;B;;700;192;362;441;259;0;19;422;441
8;Barcelona;40;Vallès Occidental;08187;Sabadell;2;7;A;;568;167;322;401;167;1;13;387;400
8;Barcelona;40;Vallès Occidental;08187;Sabadell;2;7;B;;661;220;394;467;194;1;15;451;466
8;Barcelona;40;Vallès Occidental;08187;Sabadell;2;8;U;;662;189;372;457;205;1;18;438;456
8;Barcelona;40;Vallès Occidental;08187;Sabadell;2;9;U;;936;271;560;678;258;5;23;650;673
8;Barcelona;40;Vallès Occidental;08187;Sabadell;3;1;A;;477;95;204;246;231;1;3;242;245
8;Barcelona;40;Vallès Occidental;08187;Sabadell;3;1;B;;607;141;263;302;305;0;8;294;302
8;Barcelona;40;Vallès Occidental;08187;Sabadell;3;10;U;;692;144;302;364;328;0;16;348;364
8;Barcelona;40;Vallès Occidental;08187;Sabadell;3;11;U;;901;230;392;465;436;2;8;455;463
8;Barcelona;40;Vallès Occidental;08187;Sabadell;3;12;U;;947;200;382;480;467;5;10;465;475
8;Barcelona;40;Vallès Occidental;08187;Sabadell;3;13;U;;865;188;350;430;435;19;0;411;411
8;Barcelona;40;Vallès Occidental;08187;Sabadell;3;14;A;;515;130;212;250;265;1;5;244;249
8;Barcelona;40;Vallès Occidental;08187;Sabadell;3;14;B;;671;178;293;356;315;1;11;344;355
8;Barcelona;40;Vallès Occidental;08187;Sabadell;3;15;A;;484;82;169;219;265;0;10;209;219
8;Barcelona;40;Vallès Occidental;08187;Sabadell;3;15;B;;656;150;234;278;378;1;6;271;277
8;Barcelona;40;Vallès Occidental;08187;Sabadell;3;16;U;;993;210;349;408;585;4;1;403;404
8;Barcelona;40;Vallès Occidental;08187;Sabadell;3;17;U;;778;195;292;344;434;8;0;336;336
8;Barcelona;40;Vallès Occidental;08187;Sabadell;3;18;A;;996;243;431;529;467;3;12;514;526
8;Barcelona;40;Vallès Occidental;08187;Sabadell;3;18;B;;845;220;430;547;298;5;15;527;542
8;Barcelona;40;Vallès Occidental;08187;Sabadell;3;19;U;;740;180;338;416;324;4;11;401;412
8;Barcelona;40;Vallès Occidental;08187;Sabadell;3;2;A;;459;93;184;217;242;0;3;214;217
8;Barcelona;40;Vallès Occidental;08187;Sabadell;3;2;B;;596;96;202;244;352;0;8;236;244
8;Barcelona;40;Vallès Occidental;08187;Sabadell;3;20;U;;996;215;396;506;490;2;17;487;504
8;Barcelona;40;Vallès Occidental;08187;Sabadell;3;21;U;;997;246;446;510;487;0;11;499;510
8;Barcelona;40;Vallès Occidental;08187;Sabadell;3;22;U;;603;139;240;280;323;2;8;270;278
8;Barcelona;40;Vallès Occidental;08187;Sabadell;3;23;U;;535;125;231;268;267;1;4;263;267
8;Barcelona;40;Vallès Occidental;08187;Sabadell;3;24;A;;496;103;205;277;219;0;10;267;277
8;Barcelona;40;Vallès Occidental;08187;Sabadell;3;24;B;;587;117;259;330;257;0;7;323;330
8;Barcelona;40;Vallès Occidental;08187;Sabadell;3;25;U;;968;184;429;568;400;6;16;546;562
8;Barcelona;40;Vallès Occidental;08187;Sabadell;3;26;A;;514;100;245;294;220;0;5;289;294
8;Barcelona;40;Vallès Occidental;08187;Sabadell;3;26;B;;620;127;273;355;265;2;10;343;353
8;Barcelona;40;Vallès Occidental;08187;Sabadell;3;27;U;;584;126;215;262;322;1;12;249;261
8;Barcelona;40;Vallès Occidental;08187;Sabadell;3;3;A;;525;129;218;264;261;7;4;253;257
8;Barcelona;40;Vallès Occidental;08187;Sabadell;3;3;B;;653;143;264;331;322;2;12;317;329
8;Barcelona;40;Vallès Occidental;08187;Sabadell;3;4;A;;509;115;223;263;246;0;6;257;263
8;Barcelona;40;Vallès Occidental;08187;Sabadell;3;4;B;;703;175;312;363;340;3;12;348;360
8;Barcelona;40;Vallès Occidental;08187;Sabadell;3;5;U;;708;183;324;386;322;1;11;374;385
8;Barcelona;40;Vallès Occidental;08187;Sabadell;3;6;A;;496;136;233;286;210;1;8;277;285
8;Barcelona;40;Vallès Occidental;08187;Sabadell;3;6;B;;630;171;319;381;249;6;6;369;375
8;Barcelona;40;Vallès Occidental;08187;Sabadell;3;7;U;;638;163;311;374;264;1;5;368;373
8;Barcelona;40;Vallès Occidental;08187;Sabadell;3;8;U;;930;175;336;443;487;3;9;431;440
8;Barcelona;40;Vallès Occidental;08187;Sabadell;3;9;U;;682;155;251;294;388;1;1;292;293
8;Barcelona;40;Vallès Occidental;08187;Sabadell;4;1;A;;588;131;261;337;251;4;13;320;333
8;Barcelona;40;Vallès Occidental;08187;Sabadell;4;1;B;;747;172;319;411;336;0;11;400;411
8;Barcelona;40;Vallès Occidental;08187;Sabadell;4;10;A;;538;123;230;278;260;0;12;266;278
8;Barcelona;40;Vallès Occidental;08187;Sabadell;4;10;B;;608;131;244;299;309;1;9;289;298
8;Barcelona;40;Vallès Occidental;08187;Sabadell;4;11;U;;725;151;287;352;373;0;0;352;352
8;Barcelona;40;Vallès Occidental;08187;Sabadell;4;12;U;;746;161;281;368;378;0;7;361;368
8;Barcelona;40;Vallès Occidental;08187;Sabadell;4;13;A;;497;107;210;254;243;3;10;241;251
8;Barcelona;40;Vallès Occidental;08187;Sabadell;4;13;B;;583;132;245;300;283;1;14;285;299
8;Barcelona;40;Vallès Occidental;08187;Sabadell;4;14;A;;476;130;240;302;174;1;5;296;301
8;Barcelona;40;Vallès Occidental;08187;Sabadell;4;14;B;;542;133;266;332;210;0;13;319;332
8;Barcelona;40;Vallès Occidental;08187;Sabadell;4;15;U;;677;132;240;302;375;3;6;293;299
8;Barcelona;40;Vallès Occidental;08187;Sabadell;4;16;A;;625;152;285;339;286;4;10;325;335
8;Barcelona;40;Vallès Occidental;08187;Sabadell;4;16;B;;826;178;363;442;384;1;16;425;441
8;Barcelona;40;Vallès Occidental;08187;Sabadell;4;17;A;;613;136;244;315;298;5;11;299;310
8;Barcelona;40;Vallès Occidental;08187;Sabadell;4;17;B;;764;174;346;416;348;5;11;400;411
8;Barcelona;40;Vallès Occidental;08187;Sabadell;4;18;U;;563;185;285;301;262;2;10;289;299
8;Barcelona;40;Vallès Occidental;08187;Sabadell;4;19;U;;950;158;356;447;503;1;13;433;446
8;Barcelona;40;Vallès Occidental;08187;Sabadell;4;2;U;;819;241;385;458;361;1;8;449;457
8;Barcelona;40;Vallès Occidental;08187;Sabadell;4;20;A;;929;203;357;443;486;0;7;436;443
8;Barcelona;40;Vallès Occidental;08187;Sabadell;4;20;B;;845;211;447;556;289;3;20;533;553
8;Barcelona;40;Vallès Occidental;08187;Sabadell;4;20;C;;941;213;472;609;332;3;24;582;606
8;Barcelona;40;Vallès Occidental;08187;Sabadell;4;20;D;;756;192;353;454;302;2;14;438;452
8;Barcelona;40;Vallès Occidental;08187;Sabadell;4;20;E;;863;215;427;521;342;19;2;500;502
8;Barcelona;40;Vallès Occidental;08187;Sabadell;4;20;F;;682;146;310;409;273;0;16;393;409
8;Barcelona;40;Vallès Occidental;08187;Sabadell;4;20;G;;756;171;339;428;328;1;15;412;427
8;Barcelona;40;Vallès Occidental;08187;Sabadell;4;20;H;;731;142;340;448;283;4;6;438;444
8;Barcelona;40;Vallès Occidental;08187;Sabadell;4;21;U;;843;166;365;484;359;2;14;468;482
8;Barcelona;40;Vallès Occidental;08187;Sabadell;4;22;U;;749;134;328;416;333;0;13;403;416
8;Barcelona;40;Vallès Occidental;08187;Sabadell;4;3;U;;741;206;357;446;295;0;7;439;446
8;Barcelona;40;Vallès Occidental;08187;Sabadell;4;4;A;;600;144;277;345;255;1;18;326;344
8;Barcelona;40;Vallès Occidental;08187;Sabadell;4;4;B;;703;171;342;398;305;0;13;385;398
8;Barcelona;40;Vallès Occidental;08187;Sabadell;4;5;A;;506;130;254;311;195;0;11;300;311
8;Barcelona;40;Vallès Occidental;08187;Sabadell;4;5;B;;663;195;352;410;253;3;13;394;407
8;Barcelona;40;Vallès Occidental;08187;Sabadell;4;6;A;;596;172;304;376;220;4;16;356;372
8;Barcelona;40;Vallès Occidental;08187;Sabadell;4;6;B;;732;177;361;453;279;1;11;441;452
8;Barcelona;40;Vallès Occidental;08187;Sabadell;4;7;U;;891;210;414;515;376;2;16;497;513
8;Barcelona;40;Vallès Occidental;08187;Sabadell;4;8;A;;546;153;286;362;184;3;17;342;359
8;Barcelona;40;Vallès Occidental;08187;Sabadell;4;8;B;;637;156;328;403;234;0;7;396;403
8;Barcelona;40;Vallès Occidental;08187;Sabadell;4;9;U;;941;233;481;635;306;1;15;619;634
8;Barcelona;40;Vallès Occidental;08187;Sabadell;5;1;A;;517;130;260;319;198;0;12;307;319
8;Barcelona;40;Vallès Occidental;08187;Sabadell;5;1;B;;598;151;288;356;242;4;7;345;352
8;Barcelona;40;Vallès Occidental;08187;Sabadell;5;10;U;;435;92;152;191;244;2;9;180;189
8;Barcelona;40;Vallès Occidental;08187;Sabadell;5;11;U;;976;205;353;420;556;0;10;410;420
8;Barcelona;40;Vallès Occidental;08187;Sabadell;5;12;U;;870;207;405;494;376;2;12;480;492
8;Barcelona;40;Vallès Occidental;08187;Sabadell;5;13;A;;586;111;236;314;272;1;8;305;313
8;Barcelona;40;Vallès Occidental;08187;Sabadell;5;13;B;;762;137;304;397;365;1;9;387;396
8;Barcelona;40;Vallès Occidental;08187;Sabadell;5;14;U;;805;190;408;521;284;1;17;503;520
8;Barcelona;40;Vallès Occidental;08187;Sabadell;5;15;U;;1075;267;644;777;298;7;20;750;770
8;Barcelona;40;Vallès Occidental;08187;Sabadell;5;2;A;;549;125;286;392;157;1;18;373;391
8;Barcelona;40;Vallès Occidental;08187;Sabadell;5;2;B;;696;158;356;467;229;2;11;454;465
8;Barcelona;40;Vallès Occidental;08187;Sabadell;5;3;U;;1037;283;598;779;258;9;20;750;770
8;Barcelona;40;Vallès Occidental;08187;Sabadell;5;4;U;;678;158;337;442;236;10;12;420;432
8;Barcelona;40;Vallès Occidental;08187;Sabadell;5;5;U;;945;264;478;589;356;3;20;566;586
8;Barcelona;40;Vallès Occidental;08187;Sabadell;5;6;U;;839;212;507;581;258;5;5;571;576
8;Barcelona;40;Vallès Occidental;08187;Sabadell;5;7;U;;822;201;350;443;379;0;14;429;443
8;Barcelona;40;Vallès Occidental;08187;Sabadell;5;8;U;;380;86;162;199;181;0;3;196;199
8;Barcelona;40;Vallès Occidental;08187;Sabadell;5;9;A;;544;134;263;316;228;0;10;306;316
8;Barcelona;40;Vallès Occidental;08187;Sabadell;5;9;B;;642;160;331;393;249;0;7;386;393
8;Barcelona;40;Vallès Occidental;08187;Sabadell;6;1;U;;589;112;222;266;323;0;6;260;266
8;Barcelona;40;Vallès Occidental;08187;Sabadell;6;10;U;;612;160;260;299;313;1;8;290;298
8;Barcelona;40;Vallès Occidental;08187;Sabadell;6;11;U;;583;118;208;258;325;0;7;251;258
8;Barcelona;40;Vallès Occidental;08187;Sabadell;6;12;U;;749;205;338;389;360;8;7;374;381
8;Barcelona;40;Vallès Occidental;08187;Sabadell;6;13;U;;705;169;290;330;375;5;8;317;325
8;Barcelona;40;Vallès Occidental;08187;Sabadell;6;14;U;;404;126;200;244;160;3;10;231;241
8;Barcelona;40;Vallès Occidental;08187;Sabadell;6;15;A;;438;121;181;216;222;1;9;206;215
8;Barcelona;40;Vallès Occidental;08187;Sabadell;6;15;B;;597;147;235;299;298;3;7;289;296
8;Barcelona;40;Vallès Occidental;08187;Sabadell;6;16;A;;564;137;263;332;232;3;12;317;329
8;Barcelona;40;Vallès Occidental;08187;Sabadell;6;16;B;;642;176;318;383;259;2;9;372;381
8;Barcelona;40;Vallès Occidental;08187;Sabadell;6;17;A;;469;121;217;277;192;0;6;271;277
8;Barcelona;40;Vallès Occidental;08187;Sabadell;6;17;B;;647;166;334;393;254;1;9;383;392
8;Barcelona;40;Vallès Occidental;08187;Sabadell;6;18;U;;673;182;316;380;293;0;9;371;380
8;Barcelona;40;Vallès Occidental;08187;Sabadell;6;19;U;;494;135;211;240;254;1;7;232;239
8;Barcelona;40;Vallès Occidental;08187;Sabadell;6;2;U;;653;185;321;371;282;2;8;361;369
8;Barcelona;40;Vallès Occidental;08187;Sabadell;6;20;U;;980;244;424;525;455;3;12;510;522
8;Barcelona;40;Vallès Occidental;08187;Sabadell;6;21;U;;818;150;333;420;398;1;11;408;419
8;Barcelona;40;Vallès Occidental;08187;Sabadell;6;22;A;;569;118;228;275;294;2;5;268;273
8;Barcelona;40;Vallès Occidental;08187;Sabadell;6;22;B;;709;143;290;363;346;0;6;357;363
8;Barcelona;40;Vallès Occidental;08187;Sabadell;6;23;A;;600;150;280;337;263;3;12;322;334
8;Barcelona;40;Vallès Occidental;08187;Sabadell;6;23;B;;767;212;428;466;301;2;14;450;464
8;Barcelona;40;Vallès Occidental;08187;Sabadell;6;24;U;;810;188;391;460;350;1;5;454;459
8;Barcelona;40;Vallès Occidental;08187;Sabadell;6;3;U;;714;148;269;333;381;0;9;324;333
8;Barcelona;40;Vallès Occidental;08187;Sabadell;6;4;U;;991;202;379;464;527;13;1;450;451
8;Barcelona;40;Vallès Occidental;08187;Sabadell;6;5;U;;800;7;307;371;429;3;10;358;368
8;Barcelona;40;Vallès Occidental;08187;Sabadell;6;6;U;;822;176;318;385;437;2;8;375;383
8;Barcelona;40;Vallès Occidental;08187;Sabadell;6;7;U;;606;156;255;291;315;2;9;280;289
8;Barcelona;40;Vallès Occidental;08187;Sabadell;6;8;A;;534;137;267;311;223;1;6;304;310
8;Barcelona;40;Vallès Occidental;08187;Sabadell;6;8;B;;534;134;272;339;195;0;9;330;339
8;Barcelona;40;Vallès Occidental;08187;Sabadell;6;9;A;;600;137;257;300;300;1;5;294;299
8;Barcelona;40;Vallès Occidental;08187;Sabadell;6;9;B;;676;156;277;308;368;5;5;298;303
8;Barcelona;40;Vallès Occidental;08187;Sabadell;7;1;U;;707;147;292;366;341;2;6;358;364
8;Barcelona;40;Vallès Occidental;08187;Sabadell;7;2;U;;973;178;380;463;510;1;5;457;462
8;Barcelona;40;Vallès Occidental;08187;Sabadell;7;3;U;;662;139;257;303;359;0;4;299;303
8;Barcelona;40;Vallès Occidental;08187;Sabadell;7;4;U;;584;132;234;281;303;3;4;274;278
8;Barcelona;40;Vallès Occidental;08187;Sabadell;7;5;U;;756;138;293;371;385;1;19;351;370
8;Barcelona;40;Vallès Occidental;08187;Sabadell;7;6;U;;583;128;255;311;272;4;3;304;307
8;Barcelona;40;Vallès Occidental;08187;Sabadell;7;7;U;;773;146;221;427;346;1;19;407;426
8;Barcelona;40;Vallès Occidental;08187;Sabadell;7;8;U;;693;111;333;258;435;1;9;248;257
8;Barcelona;14;Berguedà;08188;Sagàs;1;1;U;;107;28;67;88;19;1;4;83;87
25;Lleida;25;Pallars Jussà;25190;Salàs de Pallars;1;1;U;;275;71;135;183;92;3;11;169;180
8;Barcelona;14;Berguedà;08190;Saldes;1;1;U;;293;75;160;197;96;3;9;185;194
17;Girona;19;Garrotxa;17154;Sales de Llierca;1;1;U;;87;19;39;50;37;2;3;45;48
8;Barcelona;7;Bages;08191;Sallent;1;1;U;;533;151;243;306;227;4;13;289;302
8;Barcelona;7;Bages;08191;Sallent;1;2;U;;535;116;252;318;217;4;4;310;314
8;Barcelona;7;Bages;08191;Sallent;1;3;A;;560;130;269;340;220;9;1;330;331
8;Barcelona;7;Bages;08191;Sallent;1;3;B;;561;140;285;326;235;0;11;315;326
8;Barcelona;7;Bages;08191;Sallent;1;4;A;;516;112;232;275;241;1;6;268;274
8;Barcelona;7;Bages;08191;Sallent;1;4;B;;528;125;246;307;221;1;20;286;306
8;Barcelona;7;Bages;08191;Sallent;1;5;A;;430;113;212;270;160;0;9;261;270
8;Barcelona;7;Bages;08191;Sallent;1;5;B;;567;185;314;451;116;0;13;438;451
8;Barcelona;7;Bages;08191;Sallent;1;6;U;;654;156;317;383;271;2;8;373;381
8;Barcelona;7;Bages;08191;Sallent;1;7;U;;241;60;122;142;99;1;3;138;141
8;Barcelona;7;Bages;08191;Sallent;2;1;A;;152;37;75;84;68;1;5;78;83
8;Barcelona;7;Bages;08191;Sallent;2;1;B;;267;103;174;190;77;3;9;178;187
43;Tarragona;36;Tarragonès;43135;Salomó;1;1;U;;328;99;206;243;85;0;6;237;243
43;Tarragona;36;Tarragonès;43905;Salou;1;1;A;;736;134;259;346;390;5;1;340;341
43;Tarragona;36;Tarragonès;43905;Salou;1;1;B;;938;176;376;461;477;2;9;450;459
43;Tarragona;36;Tarragonès;43905;Salou;1;10;A;;974;179;361;455;519;8;7;440;447
43;Tarragona;36;Tarragonès;43905;Salou;1;10;B;;1020;193;394;500;520;2;6;492;498
43;Tarragona;36;Tarragonès;43905;Salou;1;11;U;;818;191;374;471;347;4;6;461;467
43;Tarragona;36;Tarragonès;43905;Salou;1;2;A;;588;105;213;268;320;0;3;265;268
43;Tarragona;36;Tarragonès;43905;Salou;1;2;B;;638;105;106;253;385;3;10;240;250
43;Tarragona;36;Tarragonès;43905;Salou;1;3;U;;743;188;310;391;352;1;2;388;390
43;Tarragona;36;Tarragonès;43905;Salou;1;4;U;;880;201;355;414;466;5;10;399;409
43;Tarragona;36;Tarragonès;43905;Salou;1;5;U;;816;184;316;368;448;3;9;356;365
43;Tarragona;36;Tarragonès;43905;Salou;1;6;A;;826;135;253;342;484;5;3;334;337
43;Tarragona;36;Tarragonès;43905;Salou;1;6;B;;892;164;309;398;494;3;6;389;395
43;Tarragona;36;Tarragonès;43905;Salou;1;7;A;;674;154;291;348;326;6;7;335;342
43;Tarragona;36;Tarragonès;43905;Salou;1;7;B;;743;165;294;359;384;10;2;347;349
43;Tarragona;36;Tarragonès;43905;Salou;1;8;A;;506;97;197;260;246;5;1;254;255
43;Tarragona;36;Tarragonès;43905;Salou;1;8;B;;628;142;261;347;281;5;4;338;342
43;Tarragona;36;Tarragonès;43905;Salou;1;9;U;;839;197;370;447;392;5;7;435;442
17;Girona;20;Gironès;17155;Salt;1;1;A;;485;152;285;335;150;3;12;320;332
17;Girona;20;Gironès;17155;Salt;1;1;B;;517;131;298;353;164;1;11;341;352
17;Girona;20;Gironès;17155;Salt;1;2;U;;737;196;464;461;276;3;8;450;458
17;Girona;20;Gironès;17155;Salt;1;3;A;;327;75;135;167;160;3;0;164;164
17;Girona;20;Gironès;17155;Salt;1;3;B;;351;83;171;198;153;1;5;192;197
17;Girona;20;Gironès;17155;Salt;1;4;A;;823;205;417;473;350;3;13;457;470
17;Girona;20;Gironès;17155;Salt;1;4;B;;812;187;383;454;358;3;20;431;451
17;Girona;20;Gironès;17155;Salt;1;5;A;;557;136;236;269;288;8;10;251;261
17;Girona;20;Gironès;17155;Salt;1;5;B;;622;134;229;282;340;4;5;273;278
17;Girona;20;Gironès;17155;Salt;1;6;A;;414;98;167;202;212;1;3;198;201
17;Girona;20;Gironès;17155;Salt;1;6;B;;398;96;160;179;219;1;5;173;178
17;Girona;20;Gironès;17155;Salt;1;7;U;;423;117;185;206;217;2;3;201;204
17;Girona;20;Gironès;17155;Salt;1;8;U;;912;243;440;540;372;3;11;526;537
17;Girona;20;Gironès;17155;Salt;1;9;U;;712;164;375;471;241;1;11;459;470
17;Girona;20;Gironès;17155;Salt;2;1;A;;468;120;233;248;220;2;2;244;246
17;Girona;20;Gironès;17155;Salt;2;1;B;;474;112;215;283;191;3;7;273;280
17;Girona;20;Gironès;17155;Salt;2;2;U;;779;212;361;404;375;5;8;391;399
17;Girona;20;Gironès;17155;Salt;2;3;A;;495;123;206;237;258;3;2;232;234
17;Girona;20;Gironès;17155;Salt;2;3;B;;468;133;224;262;206;4;5;253;258
17;Girona;20;Gironès;17155;Salt;2;4;A;;717;171;288;331;386;3;7;321;328
17;Girona;20;Gironès;17155;Salt;2;4;B;;784;185;318;386;398;2;10;374;384
17;Girona;20;Gironès;17155;Salt;2;5;U;;724;183;385;483;241;8;16;459;475
17;Girona;20;Gironès;17155;Salt;2;6;U;;640;145;289;333;307;2;9;322;331
17;Girona;20;Gironès;17155;Salt;2;7;U;;722;139;247;318;404;2;7;309;316
25;Lleida;32;Segarra;25191;Sanaüja;1;1;U;;360;88;180;243;117;4;6;233;239
43;Tarragona;22;Montsià;43138;Santa Bàrbara;1;1;A;;269;59;133;169;100;0;9;160;169
43;Tarragona;22;Montsià;43138;Santa Bàrbara;1;1;B;;233;51;118;144;89;2;8;134;142
43;Tarragona;22;Montsià;43138;Santa Bàrbara;1;1;C;;306;78;156;198;108;1;8;189;197
43;Tarragona;22;Montsià;43138;Santa Bàrbara;1;1;D;;320;74;164;204;116;0;10;194;204
43;Tarragona;22;Montsià;43138;Santa Bàrbara;1;1;E;;365;78;196;234;131;0;14;220;234
43;Tarragona;22;Montsià;43138;Santa Bàrbara;2;1;A;;432;84;178;263;169;1;13;249;262
43;Tarragona;22;Montsià;43138;Santa Bàrbara;2;1;B;;439;110;196;259;180;10;6;243;249
43;Tarragona;22;Montsià;43138;Santa Bàrbara;2;1;C;;372;63;142;200;172;1;11;188;199
8;Barcelona;24;Osona;08243;Santa Cecília de Voltregà;1;1;U;;158;53;100;122;36;0;4;118;122
8;Barcelona;11;Baix Llobregat;08244;Santa Coloma de Cervelló;1;1;A;;498;121;236;297;201;1;11;285;296
8;Barcelona;11;Baix Llobregat;08244;Santa Coloma de Cervelló;1;1;B;;536;127;259;306;230;0;11;295;306
8;Barcelona;11;Baix Llobregat;08244;Santa Coloma de Cervelló;1;1;C;;597;143;279;365;232;1;11;353;364
8;Barcelona;11;Baix Llobregat;08244;Santa Coloma de Cervelló;1;2;U;;584;200;341;398;186;11;19;368;387
8;Barcelona;11;Baix Llobregat;08244;Santa Coloma de Cervelló;1;3;A;;493;142;250;318;175;1;16;301;317
8;Barcelona;11;Baix Llobregat;08244;Santa Coloma de Cervelló;1;3;B;;647;168;318;418;229;0;17;401;418
8;Barcelona;11;Baix Llobregat;08244;Santa Coloma de Cervelló;1;3;C;;525;149;293;374;151;0;20;354;374
8;Barcelona;11;Baix Llobregat;08244;Santa Coloma de Cervelló;1;4;A;;609;137;281;353;256;3;9;341;350
8;Barcelona;11;Baix Llobregat;08244;Santa Coloma de Cervelló;1;4;B;;667;159;298;365;302;2;10;353;363
8;Barcelona;11;Baix Llobregat;08244;Santa Coloma de Cervelló;1;5;U;;536;121;240;303;233;0;9;294;303
17;Girona;34;Selva;17180;Santa Coloma de Farners;1;1;A;;736;166;346;427;309;4;11;412;423
17;Girona;34;Selva;17180;Santa Coloma de Farners;1;1;B;;741;178;343;419;322;4;15;400;415
17;Girona;34;Selva;17180;Santa Coloma de Farners;1;2;A;;500;154;271;353;147;3;9;341;350
17;Girona;34;Selva;17180;Santa Coloma de Farners;1;2;B;;499;148;267;342;157;5;16;321;337
17;Girona;34;Selva;17180;Santa Coloma de Farners;1;3;A;;746;189;372;450;296;5;13;432;445
17;Girona;34;Selva;17180;Santa Coloma de Farners;1;3;B;;687;170;300;382;305;1;12;369;381
17;Girona;34;Selva;17180;Santa Coloma de Farners;1;4;A;;808;157;409;533;275;1;19;513;532
17;Girona;34;Selva;17180;Santa Coloma de Farners;1;4;B;;858;176;429;555;303;3;20;532;552
17;Girona;34;Selva;17180;Santa Coloma de Farners;1;5;A;;657;148;314;390;267;5;8;377;385
17;Girona;34;Selva;17180;Santa Coloma de Farners;1;5;B;;599;151;285;341;258;6;5;330;335
17;Girona;34;Selva;17180;Santa Coloma de Farners;1;6;A;;543;112;201;272;271;4;8;260;268
17;Girona;34;Selva;17180;Santa Coloma de Farners;1;6;B;;624;144;250;322;302;5;9;308;317
8;Barcelona;13;Barcelonès;08245;Santa Coloma de Gramenet;1;1;U;;827;247;453;556;271;13;17;526;543
8;Barcelona;13;Barcelonès;08245;Santa Coloma de Gramenet;1;10;A;;470;82;167;215;255;0;10;205;215
8;Barcelona;13;Barcelonès;08245;Santa Coloma de Gramenet;1;10;B;;507;104;196;252;255;0;12;240;252
8;Barcelona;13;Barcelonès;08245;Santa Coloma de Gramenet;1;11;A;;393;98;174;217;176;1;8;208;216
8;Barcelona;13;Barcelonès;08245;Santa Coloma de Gramenet;1;11;B;;410;93;172;219;191;0;6;213;219
8;Barcelona;13;Barcelonès;08245;Santa Coloma de Gramenet;1;12;U;;646;164;289;374;272;1;15;358;373
8;Barcelona;13;Barcelonès;08245;Santa Coloma de Gramenet;1;13;A;;434;117;203;267;167;0;7;260;267
8;Barcelona;13;Barcelonès;08245;Santa Coloma de Gramenet;1;13;B;;527;106;235;307;220;0;13;294;307
8;Barcelona;13;Barcelonès;08245;Santa Coloma de Gramenet;1;13;C;;504;105;250;318;186;0;9;309;318
8;Barcelona;13;Barcelonès;08245;Santa Coloma de Gramenet;1;14;U;;847;183;385;526;321;2;21;503;524
8;Barcelona;13;Barcelonès;08245;Santa Coloma de Gramenet;1;15;U;;582;105;229;315;267;0;7;308;315
8;Barcelona;13;Barcelonès;08245;Santa Coloma de Gramenet;1;16;U;;667;201;333;428;239;5;12;411;423
8;Barcelona;13;Barcelonès;08245;Santa Coloma de Gramenet;1;17;A;;567;120;215;280;287;1;8;271;279
8;Barcelona;13;Barcelonès;08245;Santa Coloma de Gramenet;1;17;B;;653;148;267;342;311;3;10;329;339
8;Barcelona;13;Barcelonès;08245;Santa Coloma de Gramenet;1;18;A;;496;125;222;282;214;5;7;270;277
8;Barcelona;13;Barcelonès;08245;Santa Coloma de Gramenet;1;18;B;;518;114;226;282;236;4;10;268;278
8;Barcelona;13;Barcelonès;08245;Santa Coloma de Gramenet;1;19;A;;526;108;196;260;266;3;11;246;257
8;Barcelona;13;Barcelonès;08245;Santa Coloma de Gramenet;1;19;B;;581;121;232;299;282;2;10;287;297
8;Barcelona;13;Barcelonès;08245;Santa Coloma de Gramenet;1;2;U;;674;167;315;400;274;3;10;387;397
8;Barcelona;13;Barcelonès;08245;Santa Coloma de Gramenet;1;3;A;;414;100;173;206;208;1;9;196;205
8;Barcelona;13;Barcelonès;08245;Santa Coloma de Gramenet;1;3;B;;504;119;209;270;234;4;11;255;266
8;Barcelona;13;Barcelonès;08245;Santa Coloma de Gramenet;1;4;U;;558;145;248;304;254;6;10;288;298
8;Barcelona;13;Barcelonès;08245;Santa Coloma de Gramenet;1;5;U;;642;148;245;305;337;6;12;287;299
8;Barcelona;13;Barcelonès;08245;Santa Coloma de Gramenet;1;6;U;;594;126;221;288;306;2;4;282;286
8;Barcelona;13;Barcelonès;08245;Santa Coloma de Gramenet;1;7;U;;447;100;177;209;238;1;3;205;208
8;Barcelona;13;Barcelonès;08245;Santa Coloma de Gramenet;1;8;U;;442;119;179;221;221;1;10;210;220
8;Barcelona;13;Barcelonès;08245;Santa Coloma de Gramenet;1;9;A;;403;102;154;197;206;1;1;195;196
8;Barcelona;13;Barcelonès;08245;Santa Coloma de Gramenet;1;9;B;;492;118;195;255;237;3;12;240;252
8;Barcelona;13;Barcelonès;08245;Santa Coloma de Gramenet;2;1;U;;732;153;278;376;356;4;14;358;372
8;Barcelona;13;Barcelonès;08245;Santa Coloma de Gramenet;2;10;U;;557;112;219;273;284;4;1;268;269
8;Barcelona;13;Barcelonès;08245;Santa Coloma de Gramenet;2;11;A;;443;107;176;208;235;1;7;200;207
8;Barcelona;13;Barcelonès;08245;Santa Coloma de Gramenet;2;11;B;;507;100;204;255;252;1;6;248;254
8;Barcelona;13;Barcelonès;08245;Santa Coloma de Gramenet;2;2;A;;353;85;167;207;146;0;3;204;207
8;Barcelona;13;Barcelonès;08245;Santa Coloma de Gramenet;2;2;B;;397;90;172;220;177;12;0;208;208
8;Barcelona;13;Barcelonès;08245;Santa Coloma de Gramenet;2;2;C;;406;83;168;228;178;0;6;222;228
8;Barcelona;13;Barcelonès;08245;Santa Coloma de Gramenet;2;3;A;;577;116;221;258;319;3;10;245;255
8;Barcelona;13;Barcelonès;08245;Santa Coloma de Gramenet;2;3;B;;691;126;224;266;425;1;8;257;265
8;Barcelona;13;Barcelonès;08245;Santa Coloma de Gramenet;2;4;A;;377;68;132;173;204;4;3;166;169
8;Barcelona;13;Barcelonès;08245;Santa Coloma de Gramenet;2;4;B;;442;102;178;224;218;0;5;219;224
8;Barcelona;13;Barcelonès;08245;Santa Coloma de Gramenet;2;5;A;;433;115;194;237;196;1;1;235;236
8;Barcelona;13;Barcelonès;08245;Santa Coloma de Gramenet;2;5;B;;443;112;200;225;218;0;4;221;225
8;Barcelona;13;Barcelonès;08245;Santa Coloma de Gramenet;2;6;A;;410;99;176;244;166;0;9;235;244
8;Barcelona;13;Barcelonès;08245;Santa Coloma de Gramenet;2;6;B;;480;108;216;262;218;0;10;252;262
8;Barcelona;13;Barcelonès;08245;Santa Coloma de Gramenet;2;7;A;;495;106;187;229;266;5;13;211;224
8;Barcelona;13;Barcelonès;08245;Santa Coloma de Gramenet;2;7;B;;532;81;165;227;305;3;12;212;224
8;Barcelona;13;Barcelonès;08245;Santa Coloma de Gramenet;2;7;C;;537;104;198;253;284;2;11;240;251
8;Barcelona;13;Barcelonès;08245;Santa Coloma de Gramenet;2;8;A;;467;106;193;248;219;0;12;236;248
8;Barcelona;13;Barcelonès;08245;Santa Coloma de Gramenet;2;8;B;;558;115;223;288;270;0;11;277;288
8;Barcelona;13;Barcelonès;08245;Santa Coloma de Gramenet;2;9;A;;414;86;153;212;202;0;3;209;212
8;Barcelona;13;Barcelonès;08245;Santa Coloma de Gramenet;2;9;B;;450;91;186;237;213;2;13;222;235
8;Barcelona;13;Barcelonès;08245;Santa Coloma de Gramenet;3;1;U;;625;108;211;295;330;3;19;273;292
8;Barcelona;13;Barcelonès;08245;Santa Coloma de Gramenet;3;10;U;;544;128;228;301;243;2;9;290;299
8;Barcelona;13;Barcelonès;08245;Santa Coloma de Gramenet;3;11;U;;825;196;386;465;360;0;11;454;465
8;Barcelona;13;Barcelonès;08245;Santa Coloma de Gramenet;3;12;A;;526;114;237;306;220;8;3;295;298
8;Barcelona;13;Barcelonès;08245;Santa Coloma de Gramenet;3;12;B;;651;132;256;340;311;1;13;326;339
8;Barcelona;13;Barcelonès;08245;Santa Coloma de Gramenet;3;13;A;;372;79;145;193;179;1;7;185;192
8;Barcelona;13;Barcelonès;08245;Santa Coloma de Gramenet;3;13;B;;466;111;201;246;220;6;12;228;240
8;Barcelona;13;Barcelonès;08245;Santa Coloma de Gramenet;3;13;C;;477;123;210;249;228;2;8;239;247
8;Barcelona;13;Barcelonès;08245;Santa Coloma de Gramenet;3;14;A;;440;88;155;189;251;5;4;180;184
8;Barcelona;13;Barcelonès;08245;Santa Coloma de Gramenet;3;14;B;;501;100;169;196;305;3;7;186;193
8;Barcelona;13;Barcelonès;08245;Santa Coloma de Gramenet;3;15;A;;470;100;228;266;204;2;10;254;264
8;Barcelona;13;Barcelonès;08245;Santa Coloma de Gramenet;3;15;B;;540;104;229;300;240;2;8;290;298
8;Barcelona;13;Barcelonès;08245;Santa Coloma de Gramenet;3;16;U;;704;177;293;375;329;1;12;362;374
8;Barcelona;13;Barcelonès;08245;Santa Coloma de Gramenet;3;17;U;;559;128;219;271;288;0;8;263;271
8;Barcelona;13;Barcelonès;08245;Santa Coloma de Gramenet;3;2;U;;560;112;204;269;291;0;11;258;269
8;Barcelona;13;Barcelonès;08245;Santa Coloma de Gramenet;3;3;U;;682;171;319;371;311;5;7;359;366
8;Barcelona;13;Barcelonès;08245;Santa Coloma de Gramenet;3;4;A;;390;81;145;175;215;0;9;166;175
8;Barcelona;13;Barcelonès;08245;Santa Coloma de Gramenet;3;4;B;;433;106;177;207;226;0;5;202;207
8;Barcelona;13;Barcelonès;08245;Santa Coloma de Gramenet;3;5;A;;362;68;120;143;219;0;1;142;143
8;Barcelona;13;Barcelonès;08245;Santa Coloma de Gramenet;3;5;B;;485;79;149;171;314;4;0;167;167
8;Barcelona;13;Barcelonès;08245;Santa Coloma de Gramenet;3;6;A;;376;79;147;184;192;1;10;173;183
8;Barcelona;13;Barcelonès;08245;Santa Coloma de Gramenet;3;6;B;;507;97;202;253;254;3;12;238;250
8;Barcelona;13;Barcelonès;08245;Santa Coloma de Gramenet;3;7;A;;417;108;188;229;188;1;9;219;228
8;Barcelona;13;Barcelonès;08245;Santa Coloma de Gramenet;3;7;B;;535;117;218;302;233;2;15;285;300
8;Barcelona;13;Barcelonès;08245;Santa Coloma de Gramenet;3;7;C;;467;108;210;266;201;0;12;254;266
8;Barcelona;13;Barcelonès;08245;Santa Coloma de Gramenet;3;8;U;;623;148;283;352;271;0;12;340;352
8;Barcelona;13;Barcelonès;08245;Santa Coloma de Gramenet;3;9;U;;946;226;419;513;433;3;22;488;510
8;Barcelona;13;Barcelonès;08245;Santa Coloma de Gramenet;4;1;U;;846;203;359;443;403;0;22;421;443
8;Barcelona;13;Barcelonès;08245;Santa Coloma de Gramenet;4;10;A;;429;84;178;216;213;2;4;210;214
8;Barcelona;13;Barcelonès;08245;Santa Coloma de Gramenet;4;10;B;;493;102;206;265;228;2;7;256;263
8;Barcelona;13;Barcelonès;08245;Santa Coloma de Gramenet;4;11;A;;355;88;169;202;153;0;5;197;202
8;Barcelona;13;Barcelonès;08245;Santa Coloma de Gramenet;4;11;B;;435;106;211;251;184;1;11;239;250
8;Barcelona;13;Barcelonès;08245;Santa Coloma de Gramenet;4;12;A;;331;70;132;167;164;4;8;155;163
8;Barcelona;13;Barcelonès;08245;Santa Coloma de Gramenet;4;12;B;;434;107;202;241;193;2;5;234;239
8;Barcelona;13;Barcelonès;08245;Santa Coloma de Gramenet;4;13;A;;523;121;225;274;249;3;8;263;271
8;Barcelona;13;Barcelonès;08245;Santa Coloma de Gramenet;4;13;B;;684;171;286;362;322;2;10;350;360
8;Barcelona;13;Barcelonès;08245;Santa Coloma de Gramenet;4;14;A;;395;100;175;211;184;2;5;204;209
8;Barcelona;13;Barcelonès;08245;Santa Coloma de Gramenet;4;14;B;;468;105;187;219;249;1;5;213;218
8;Barcelona;13;Barcelonès;08245;Santa Coloma de Gramenet;4;14;C;;476;130;241;281;195;1;12;268;280
8;Barcelona;13;Barcelonès;08245;Santa Coloma de Gramenet;4;15;A;;427;97;172;221;206;2;5;214;219
8;Barcelona;13;Barcelonès;08245;Santa Coloma de Gramenet;4;15;B;;556;110;229;283;273;2;8;273;281
8;Barcelona;13;Barcelonès;08245;Santa Coloma de Gramenet;4;16;A;;333;95;139;174;159;1;3;170;173
8;Barcelona;13;Barcelonès;08245;Santa Coloma de Gramenet;4;16;B;;439;128;184;232;207;3;5;224;229
8;Barcelona;13;Barcelonès;08245;Santa Coloma de Gramenet;4;2;A;;468;135;247;384;84;3;86;295;381
8;Barcelona;13;Barcelonès;08245;Santa Coloma de Gramenet;4;2;B;;471;125;234;293;178;4;5;284;289
8;Barcelona;13;Barcelonès;08245;Santa Coloma de Gramenet;4;3;A;;564;107;243;322;242;1;7;314;321
8;Barcelona;13;Barcelonès;08245;Santa Coloma de Gramenet;4;3;B;;668;138;285;367;301;4;4;359;363
8;Barcelona;13;Barcelonès;08245;Santa Coloma de Gramenet;4;4;A;;565;124;243;312;253;11;1;300;301
8;Barcelona;13;Barcelonès;08245;Santa Coloma de Gramenet;4;4;B;;676;137;281;365;311;3;15;347;362
8;Barcelona;13;Barcelonès;08245;Santa Coloma de Gramenet;4;5;U;;819;185;338;442;377;2;11;429;440
8;Barcelona;13;Barcelonès;08245;Santa Coloma de Gramenet;4;6;A;;499;117;219;279;220;0;7;272;279
8;Barcelona;13;Barcelonès;08245;Santa Coloma de Gramenet;4;6;B;;547;123;227;296;251;1;13;282;295
8;Barcelona;13;Barcelonès;08245;Santa Coloma de Gramenet;4;7;A;;516;111;230;288;228;5;12;271;283
8;Barcelona;13;Barcelonès;08245;Santa Coloma de Gramenet;4;7;B;;617;137;255;330;287;1;11;318;329
8;Barcelona;13;Barcelonès;08245;Santa Coloma de Gramenet;4;8;A;;355;79;164;197;158;1;6;190;196
8;Barcelona;13;Barcelonès;08245;Santa Coloma de Gramenet;4;8;B;;441;93;184;238;203;3;11;224;235
8;Barcelona;13;Barcelonès;08245;Santa Coloma de Gramenet;4;8;C;;506;127;226;279;227;2;7;270;277
8;Barcelona;13;Barcelonès;08245;Santa Coloma de Gramenet;4;9;A;;595;157;275;346;249;2;17;327;344
8;Barcelona;13;Barcelonès;08245;Santa Coloma de Gramenet;4;9;B;;610;170;280;348;262;1;5;342;347
8;Barcelona;13;Barcelonès;08245;Santa Coloma de Gramenet;5;1;U;;601;146;239;292;309;2;7;283;290
8;Barcelona;13;Barcelonès;08245;Santa Coloma de Gramenet;5;10;U;;464;104;191;223;241;2;6;215;221
8;Barcelona;13;Barcelonès;08245;Santa Coloma de Gramenet;5;11;A;;439;86;135;170;269;0;2;168;170
8;Barcelona;13;Barcelonès;08245;Santa Coloma de Gramenet;5;11;B;;457;74;143;179;278;2;3;174;177
8;Barcelona;13;Barcelonès;08245;Santa Coloma de Gramenet;5;12;U;;695;117;250;297;398;0;11;286;297
8;Barcelona;13;Barcelonès;08245;Santa Coloma de Gramenet;5;13;A;;405;85;141;165;240;1;8;156;164
8;Barcelona;13;Barcelonès;08245;Santa Coloma de Gramenet;5;13;B;;422;86;151;194;228;4;7;183;190
8;Barcelona;13;Barcelonès;08245;Santa Coloma de Gramenet;5;14;A;;439;117;170;211;228;2;6;203;209
8;Barcelona;13;Barcelonès;08245;Santa Coloma de Gramenet;5;14;B;;531;116;217;277;254;1;9;267;276
8;Barcelona;13;Barcelonès;08245;Santa Coloma de Gramenet;5;15;A;;410;77;131;176;234;0;2;174;176
8;Barcelona;13;Barcelonès;08245;Santa Coloma de Gramenet;5;15;B;;506;112;182;226;280;3;1;222;223
8;Barcelona;13;Barcelonès;08245;Santa Coloma de Gramenet;5;16;U;;659;114;237;292;367;5;0;287;287
8;Barcelona;13;Barcelonès;08245;Santa Coloma de Gramenet;5;17;U;;499;84;157;192;307;2;4;186;190
8;Barcelona;13;Barcelonès;08245;Santa Coloma de Gramenet;5;18;A;;325;35;70;96;229;0;2;94;96
8;Barcelona;13;Barcelonès;08245;Santa Coloma de Gramenet;5;18;B;;279;43;75;95;184;1;2;92;94
8;Barcelona;13;Barcelonès;08245;Santa Coloma de Gramenet;5;19;U;;841;195;353;447;394;4;13;430;443
8;Barcelona;13;Barcelonès;08245;Santa Coloma de Gramenet;5;2;A;;416;89;166;198;218;0;6;192;198
8;Barcelona;13;Barcelonès;08245;Santa Coloma de Gramenet;5;2;B;;513;118;204;258;255;1;8;249;257
8;Barcelona;13;Barcelonès;08245;Santa Coloma de Gramenet;5;3;U;;681;151;278;348;333;2;2;344;346
8;Barcelona;13;Barcelonès;08245;Santa Coloma de Gramenet;5;4;U;;594;129;229;299;295;0;8;291;299
8;Barcelona;13;Barcelonès;08245;Santa Coloma de Gramenet;5;5;A;;395;65;120;150;245;3;2;145;147
8;Barcelona;13;Barcelonès;08245;Santa Coloma de Gramenet;5;5;B;;409;82;135;156;253;0;2;154;156
8;Barcelona;13;Barcelonès;08245;Santa Coloma de Gramenet;5;6;U;;651;145;240;294;357;8;5;281;286
8;Barcelona;13;Barcelonès;08245;Santa Coloma de Gramenet;5;7;A;;346;70;136;171;175;3;4;164;168
8;Barcelona;13;Barcelonès;08245;Santa Coloma de Gramenet;5;7;B;;361;95;157;193;168;1;3;189;192
8;Barcelona;13;Barcelonès;08245;Santa Coloma de Gramenet;5;8;U;;577;102;197;215;362;0;10;205;215
8;Barcelona;13;Barcelonès;08245;Santa Coloma de Gramenet;5;9;U;;775;124;267;328;447;0;10;318;328
8;Barcelona;13;Barcelonès;08245;Santa Coloma de Gramenet;6;1;U;;474;120;230;280;194;4;6;270;276
8;Barcelona;13;Barcelonès;08245;Santa Coloma de Gramenet;6;10;U;;473;78;161;183;290;4;2;177;179
8;Barcelona;13;Barcelonès;08245;Santa Coloma de Gramenet;6;11;U;;475;79;142;177;298;4;7;166;173
8;Barcelona;13;Barcelonès;08245;Santa Coloma de Gramenet;6;12;U;;491;118;204;246;245;4;6;236;242
8;Barcelona;13;Barcelonès;08245;Santa Coloma de Gramenet;6;13;U;;272;58;102;138;134;1;5;132;137
8;Barcelona;13;Barcelonès;08245;Santa Coloma de Gramenet;6;14;A;;293;73;126;138;155;1;0;137;137
8;Barcelona;13;Barcelonès;08245;Santa Coloma de Gramenet;6;14;B;;379;108;166;193;186;0;10;183;193
8;Barcelona;13;Barcelonès;08245;Santa Coloma de Gramenet;6;15;U;;295;49;88;110;185;0;3;107;110
8;Barcelona;13;Barcelonès;08245;Santa Coloma de Gramenet;6;16;U;;295;48;82;102;193;1;3;98;101
8;Barcelona;13;Barcelonès;08245;Santa Coloma de Gramenet;6;17;U;;424;83;134;156;268;0;9;147;156
8;Barcelona;13;Barcelonès;08245;Santa Coloma de Gramenet;6;2;U;;612;143;244;313;299;0;12;301;313
8;Barcelona;13;Barcelonès;08245;Santa Coloma de Gramenet;6;3;A;;298;78;113;139;159;1;1;137;138
8;Barcelona;13;Barcelonès;08245;Santa Coloma de Gramenet;6;3;B;;339;81;123;144;195;4;0;140;140
8;Barcelona;13;Barcelonès;08245;Santa Coloma de Gramenet;6;4;A;;280;62;118;142;138;1;4;137;141
8;Barcelona;13;Barcelonès;08245;Santa Coloma de Gramenet;6;4;B;;363;84;148;184;179;2;2;180;182
8;Barcelona;13;Barcelonès;08245;Santa Coloma de Gramenet;6;5;U;;604;154;280;337;267;8;6;323;329
8;Barcelona;13;Barcelonès;08245;Santa Coloma de Gramenet;6;6;U;;470;117;185;232;238;4;10;218;228
8;Barcelona;13;Barcelonès;08245;Santa Coloma de Gramenet;6;7;U;;296;63;123;148;148;0;4;144;148
8;Barcelona;13;Barcelonès;08245;Santa Coloma de Gramenet;6;8;A;;346;74;136;164;182;0;4;160;164
8;Barcelona;13;Barcelonès;08245;Santa Coloma de Gramenet;6;8;B;;326;51;117;155;171;2;4;149;153
8;Barcelona;13;Barcelonès;08245;Santa Coloma de Gramenet;6;9;U;;366;84;148;179;187;4;5;170;175
43;Tarragona;16;Conca de Barberà;43139;Santa Coloma de Queralt;1;1;A;;641;135;280;370;271;5;5;360;365
43;Tarragona;16;Conca de Barberà;43139;Santa Coloma de Queralt;1;1;B;;726;146;351;458;268;8;10;440;450
43;Tarragona;16;Conca de Barberà;43139;Santa Coloma de Queralt;2;1;U;;815;153;386;493;322;5;17;471;488
17;Girona;10;Baix Empordà;17181;Santa Cristina d'Aro;1;1;A;;761;181;386;475;286;6;11;458;469
17;Girona;10;Baix Empordà;17181;Santa Cristina d'Aro;1;1;B;;802;187;417;476;326;10;3;463;466
17;Girona;10;Baix Empordà;17181;Santa Cristina d'Aro;1;2;A;;751;209;407;477;274;8;2;467;469
17;Girona;10;Baix Empordà;17181;Santa Cristina d'Aro;1;2;B;;848;229;430;504;344;7;5;492;497
8;Barcelona;13;Barcelonès;08194;Sant Adrià de Besòs;1;1;A;;520;148;148;330;190;1;9;320;329
8;Barcelona;13;Barcelonès;08194;Sant Adrià de Besòs;1;1;B;;622;171;291;360;262;3;15;342;357
8;Barcelona;13;Barcelonès;08194;Sant Adrià de Besòs;1;2;A;;503;149;264;319;184;1;5;313;318
8;Barcelona;13;Barcelonès;08194;Sant Adrià de Besòs;1;2;B;;602;144;257;359;243;0;9;350;359
8;Barcelona;13;Barcelonès;08194;Sant Adrià de Besòs;1;3;A;;623;146;275;357;266;1;11;345;356
8;Barcelona;13;Barcelonès;08194;Sant Adrià de Besòs;1;3;B;;727;144;299;374;353;4;6;364;370
8;Barcelona;13;Barcelonès;08194;Sant Adrià de Besòs;1;4;A;;645;122;287;358;287;6;12;340;352
8;Barcelona;13;Barcelonès;08194;Sant Adrià de Besòs;1;4;B;;696;157;340;400;296;4;13;383;396
8;Barcelona;13;Barcelonès;08194;Sant Adrià de Besòs;1;5;A;;745;174;329;414;331;12;3;399;402
8;Barcelona;13;Barcelonès;08194;Sant Adrià de Besòs;1;5;B;;752;193;391;466;286;4;14;448;462
8;Barcelona;13;Barcelonès;08194;Sant Adrià de Besòs;1;6;A;;469;98;226;276;193;2;9;265;274
8;Barcelona;13;Barcelonès;08194;Sant Adrià de Besòs;1;6;B;;561;127;278;333;228;0;16;317;333
8;Barcelona;13;Barcelonès;08194;Sant Adrià de Besòs;2;1;A;;551;136;220;286;265;0;9;277;286
8;Barcelona;13;Barcelonès;08194;Sant Adrià de Besòs;2;1;B;;610;130;243;305;305;1;10;294;304
8;Barcelona;13;Barcelonès;08194;Sant Adrià de Besòs;2;2;A;;534;98;196;245;289;7;1;237;238
8;Barcelona;13;Barcelonès;08194;Sant Adrià de Besòs;2;2;B;;688;136;239;304;384;4;6;294;300
8;Barcelona;13;Barcelonès;08194;Sant Adrià de Besòs;2;3;A;;513;95;196;253;260;0;4;249;253
8;Barcelona;13;Barcelonès;08194;Sant Adrià de Besòs;2;3;B;;727;103;258;336;391;7;9;320;329
8;Barcelona;13;Barcelonès;08194;Sant Adrià de Besòs;2;4;A;;608;177;282;348;260;1;7;340;347
8;Barcelona;13;Barcelonès;08194;Sant Adrià de Besòs;2;4;B;;750;129;367;430;320;3;14;413;427
8;Barcelona;13;Barcelonès;08194;Sant Adrià de Besòs;2;5;A;;649;159;317;396;253;0;9;387;396
8;Barcelona;13;Barcelonès;08194;Sant Adrià de Besòs;2;5;B;;670;166;315;396;274;0;17;379;396
8;Barcelona;13;Barcelonès;08194;Sant Adrià de Besòs;3;1;U;;423;101;185;220;203;0;6;214;220
8;Barcelona;13;Barcelonès;08194;Sant Adrià de Besòs;4;1;U;;230;46;88;114;116;0;1;113;114
8;Barcelona;13;Barcelonès;08194;Sant Adrià de Besòs;5;1;A;;564;137;264;303;261;7;7;289;296
8;Barcelona;13;Barcelonès;08194;Sant Adrià de Besòs;5;1;B;;629;143;264;336;293;3;4;329;333
8;Barcelona;13;Barcelonès;08194;Sant Adrià de Besòs;5;2;A;;543;114;229;269;274;0;10;259;269
8;Barcelona;13;Barcelonès;08194;Sant Adrià de Besòs;5;2;B;;598;139;247;282;316;2;13;267;280
8;Barcelona;13;Barcelonès;08194;Sant Adrià de Besòs;5;3;U;;650;161;306;366;284;4;9;353;362
8;Barcelona;13;Barcelonès;08194;Sant Adrià de Besòs;5;4;A;;460;109;206;239;221;0;6;233;239
8;Barcelona;13;Barcelonès;08194;Sant Adrià de Besòs;5;4;B;;493;132;237;284;209;5;3;276;279
8;Barcelona;13;Barcelonès;08194;Sant Adrià de Besòs;6;1;U;;350;48;83;101;249;1;0;100;100
8;Barcelona;13;Barcelonès;08194;Sant Adrià de Besòs;6;2;A;;551;69;106;138;413;2;3;133;136
8;Barcelona;13;Barcelonès;08194;Sant Adrià de Besòs;6;2;B;;488;77;133;180;308;4;2;174;176
8;Barcelona;13;Barcelonès;08194;Sant Adrià de Besòs;6;3;U;;480;72;108;121;359;0;1;120;121
8;Barcelona;13;Barcelonès;08194;Sant Adrià de Besòs;6;4;A;;878;65;114;143;735;0;5;138;143
8;Barcelona;13;Barcelonès;08194;Sant Adrià de Besòs;6;4;B;;501;61;96;129;372;0;4;125;129
8;Barcelona;13;Barcelonès;08194;Sant Adrià de Besòs;6;5;A;;450;96;166;201;249;0;5;196;201
8;Barcelona;13;Barcelonès;08194;Sant Adrià de Besòs;6;5;B;;484;102;190;215;269;2;4;209;213
8;Barcelona;13;Barcelonès;08194;Sant Adrià de Besòs;6;6;A;;611;44;95;124;487;0;2;122;124
8;Barcelona;13;Barcelonès;08194;Sant Adrià de Besòs;6;6;B;;499;48;94;118;381;0;0;118;118
8;Barcelona;13;Barcelonès;08194;Sant Adrià de Besòs;6;7;A;;457;68;154;191;266;0;1;190;191
8;Barcelona;13;Barcelonès;08194;Sant Adrià de Besòs;6;7;B;;435;80;158;199;236;5;1;193;194
8;Barcelona;24;Osona;08246;Santa Eugènia de Berga;1;1;A;;801;192;452;577;224;4;20;553;573
8;Barcelona;24;Osona;08246;Santa Eugènia de Berga;1;1;B;;882;223;531;662;220;7;22;633;655
8;Barcelona;24;Osona;08247;Santa Eulàlia de Riuprimer;1;1;U;;860;265;496;629;231;3;17;609;626
8;Barcelona;41;Vallès Oriental;08248;Santa Eulàlia de Ronçana;1;1;A;;833;211;418;540;293;4;19;517;536
8;Barcelona;41;Vallès Oriental;08248;Santa Eulàlia de Ronçana;1;1;B;;979;233;508;591;388;8;13;570;583
8;Barcelona;41;Vallès Oriental;08248;Santa Eulàlia de Ronçana;1;1;C;;821;224;446;504;317;4;0;500;500
8;Barcelona;41;Vallès Oriental;08248;Santa Eulàlia de Ronçana;1;2;A;;851;191;430;526;325;2;15;509;524
8;Barcelona;41;Vallès Oriental;08248;Santa Eulàlia de Ronçana;1;2;B;;907;216;449;533;374;1;10;522;532
8;Barcelona;41;Vallès Oriental;08248;Santa Eulàlia de Ronçana;1;2;C;;800;202;414;499;301;4;14;481;495
8;Barcelona;3;Alt Penedès;08249;Santa Fe del Penedès;1;1;U;;270;88;175;213;57;3;7;203;210
8;Barcelona;24;Osona;08195;Sant Agustí de Lluçanès;1;1;U;;87;23;43;63;24;2;4;57;61
17;Girona;2;Alt Empordà;17182;Santa Llogaia d'Àlguema;1;1;U;;253;54;108;140;113;1;4;135;139
8;Barcelona;6;Anoia;08250;Santa Margarida de Montbui;1;1;U;;692;180;422;503;189;3;21;479;500
8;Barcelona;6;Anoia;08250;Santa Margarida de Montbui;1;2;A;;806;169;314;373;433;1;14;358;372
8;Barcelona;6;Anoia;08250;Santa Margarida de Montbui;1;2;B;;804;160;293;367;437;3;15;349;364
8;Barcelona;6;Anoia;08250;Santa Margarida de Montbui;1;3;U;;875;180;361;457;418;0;10;447;457
8;Barcelona;6;Anoia;08250;Santa Margarida de Montbui;1;4;U;;710;168;329;416;294;7;12;397;409
8;Barcelona;6;Anoia;08250;Santa Margarida de Montbui;1;5;A;;597;105;219;288;309;1;5;282;287
8;Barcelona;6;Anoia;08250;Santa Margarida de Montbui;1;5;B;;648;113;240;314;334;2;10;302;312
8;Barcelona;6;Anoia;08250;Santa Margarida de Montbui;1;5;C;;588;118;231;300;288;0;9;291;300
8;Barcelona;6;Anoia;08250;Santa Margarida de Montbui;1;6;U;;778;153;296;373;405;1;4;368;372
8;Barcelona;6;Anoia;08250;Santa Margarida de Montbui;1;7;U;;588;136;252;316;272;2;10;304;314
8;Barcelona;3;Alt Penedès;08251;Santa Margarida i els Monjos;1;1;U;;891;245;467;584;307;4;10;570;580
8;Barcelona;3;Alt Penedès;08251;Santa Margarida i els Monjos;1;2;U;;1095;297;513;653;442;7;24;622;646
8;Barcelona;3;Alt Penedès;08251;Santa Margarida i els Monjos;1;3;A;;726;178;302;368;358;4;4;360;364
8;Barcelona;3;Alt Penedès;08251;Santa Margarida i els Monjos;1;3;B;;913;238;399;510;403;0;9;501;510
8;Barcelona;3;Alt Penedès;08251;Santa Margarida i els Monjos;1;4;A;;498;98;192;258;240;3;6;249;255
8;Barcelona;3;Alt Penedès;08251;Santa Margarida i els Monjos;1;4;B;;590;132;244;301;289;2;9;290;299
8;Barcelona;;;08258;Santa Maria d'Oló;1;1;U;;850;213;514;620;230;9;19;592;611
8;Barcelona;24;Osona;08253;Santa Maria de Besora;1;1;U;;139;46;76;97;42;1;5;91;96
8;Barcelona;41;Vallès Oriental;08256;Santa Maria de Martorelles;1;1;U;;638;180;368;461;177;1;14;446;460
8;Barcelona;14;Berguedà;08255;Santa Maria de Merlès;1;1;U;;129;30;63;87;42;0;3;84;87
8;Barcelona;6;Anoia;08257;Santa Maria de Miralles;1;1;U;;115;35;61;81;34;0;5;76;81
8;Barcelona;41;Vallès Oriental;08259;Santa Maria de Palautordera;1;1;A;;651;230;362;434;217;1;13;420;433
8;Barcelona;41;Vallès Oriental;08259;Santa Maria de Palautordera;1;1;B;;662;198;357;416;246;1;16;399;415
8;Barcelona;41;Vallès Oriental;08259;Santa Maria de Palautordera;1;1;C;;670;184;352;432;238;2;14;416;430
8;Barcelona;41;Vallès Oriental;08259;Santa Maria de Palautordera;1;2;A;;693;188;396;482;211;1;17;464;481
8;Barcelona;41;Vallès Oriental;08259;Santa Maria de Palautordera;1;2;B;;739;211;415;488;251;2;17;469;486
8;Barcelona;41;Vallès Oriental;08259;Santa Maria de Palautordera;1;2;C;;766;230;454;545;221;15;4;526;530
8;Barcelona;41;Vallès Oriental;08259;Santa Maria de Palautordera;1;2;D;;437;88;183;221;216;2;4;215;219
8;Barcelona;41;Vallès Oriental;08259;Santa Maria de Palautordera;1;3;A;;339;87;176;230;109;7;2;221;223
8;Barcelona;41;Vallès Oriental;08259;Santa Maria de Palautordera;1;3;B;;374;91;204;259;115;3;8;248;256
8;Barcelona;41;Vallès Oriental;08259;Santa Maria de Palautordera;1;3;C;;437;115;232;304;133;3;14;287;301
8;Barcelona;41;Vallès Oriental;08259;Santa Maria de Palautordera;1;3;D;;506;114;238;318;188;3;13;302;315
8;Barcelona;11;Baix Llobregat;08196;Sant Andreu de la Barca;1;1;A;;649;137;254;340;309;2;11;327;338
8;Barcelona;11;Baix Llobregat;08196;Sant Andreu de la Barca;1;1;B;;730;153;291;391;339;1;7;383;390
8;Barcelona;11;Baix Llobregat;08196;Sant Andreu de la Barca;1;10;A;;488;114;187;237;251;2;4;231;235
8;Barcelona;11;Baix Llobregat;08196;Sant Andreu de la Barca;1;10;B;;625;105;214;284;341;1;13;270;283
8;Barcelona;11;Baix Llobregat;08196;Sant Andreu de la Barca;1;10;C;;513;97;168;240;273;1;8;231;239
8;Barcelona;11;Baix Llobregat;08196;Sant Andreu de la Barca;1;11;A;;441;111;182;237;204;0;10;227;237
8;Barcelona;11;Baix Llobregat;08196;Sant Andreu de la Barca;1;11;B;;610;140;257;329;281;2;15;312;327
8;Barcelona;11;Baix Llobregat;08196;Sant Andreu de la Barca;1;11;C;;434;114;181;236;198;0;4;232;236
8;Barcelona;11;Baix Llobregat;08196;Sant Andreu de la Barca;1;12;A;;465;102;188;266;199;0;4;262;266
8;Barcelona;11;Baix Llobregat;08196;Sant Andreu de la Barca;1;12;B;;602;123;257;330;272;0;13;317;330
8;Barcelona;11;Baix Llobregat;08196;Sant Andreu de la Barca;1;12;C;;461;100;191;245;216;0;10;235;245
8;Barcelona;11;Baix Llobregat;08196;Sant Andreu de la Barca;1;13;A;;416;89;180;233;183;1;4;228;232
8;Barcelona;11;Baix Llobregat;08196;Sant Andreu de la Barca;1;13;B;;500;122;232;299;201;3;5;291;296
8;Barcelona;11;Baix Llobregat;08196;Sant Andreu de la Barca;1;14;A;;597;128;246;326;271;3;9;314;323
8;Barcelona;11;Baix Llobregat;08196;Sant Andreu de la Barca;1;14;B;;722;128;277;392;330;12;4;376;380
8;Barcelona;11;Baix Llobregat;08196;Sant Andreu de la Barca;1;14;C;;556;128;256;311;245;1;13;297;310
8;Barcelona;11;Baix Llobregat;08196;Sant Andreu de la Barca;1;2;A;;619;134;255;300;319;2;8;290;298
8;Barcelona;11;Baix Llobregat;08196;Sant Andreu de la Barca;1;2;B;;752;144;258;328;424;0;16;312;328
8;Barcelona;11;Baix Llobregat;08196;Sant Andreu de la Barca;1;3;A;;475;97;190;251;224;0;4;247;251
8;Barcelona;11;Baix Llobregat;08196;Sant Andreu de la Barca;1;3;B;;539;125;220;270;269;2;2;266;268
8;Barcelona;11;Baix Llobregat;08196;Sant Andreu de la Barca;1;4;A;;563;109;257;305;258;0;10;295;305
8;Barcelona;11;Baix Llobregat;08196;Sant Andreu de la Barca;1;4;B;;668;145;301;365;303;2;10;353;363
8;Barcelona;11;Baix Llobregat;08196;Sant Andreu de la Barca;1;5;A;;511;112;213;274;237;0;8;266;274
8;Barcelona;11;Baix Llobregat;08196;Sant Andreu de la Barca;1;5;B;;666;141;256;341;325;6;1;334;335
8;Barcelona;11;Baix Llobregat;08196;Sant Andreu de la Barca;1;6;A;;524;117;225;269;255;2;5;262;267
8;Barcelona;11;Baix Llobregat;08196;Sant Andreu de la Barca;1;6;B;;620;145;264;339;281;2;17;320;337
8;Barcelona;11;Baix Llobregat;08196;Sant Andreu de la Barca;1;7;A;;670;149;303;369;301;1;16;352;368
8;Barcelona;11;Baix Llobregat;08196;Sant Andreu de la Barca;1;7;B;;697;172;315;389;308;1;11;377;388
8;Barcelona;11;Baix Llobregat;08196;Sant Andreu de la Barca;1;8;A;;478;115;235;305;173;0;13;292;305
8;Barcelona;11;Baix Llobregat;08196;Sant Andreu de la Barca;1;8;B;;506;116;231;295;211;0;3;292;295
8;Barcelona;11;Baix Llobregat;08196;Sant Andreu de la Barca;1;9;A;;483;91;183;233;250;0;10;223;233
8;Barcelona;11;Baix Llobregat;08196;Sant Andreu de la Barca;1;9;B;;632;128;272;335;297;2;11;322;333
8;Barcelona;11;Baix Llobregat;08196;Sant Andreu de la Barca;1;9;C;;562;105;206;263;299;0;6;257;263
8;Barcelona;21;Maresme;08197;Sant Andreu de Llavaneres;1;1;A;;789;228;423;507;282;3;12;492;504
8;Barcelona;21;Maresme;08197;Sant Andreu de Llavaneres;1;1;B;;641;158;311;400;241;4;15;381;396
8;Barcelona;21;Maresme;08197;Sant Andreu de Llavaneres;1;2;A;;775;201;411;518;257;1;11;506;517
8;Barcelona;21;Maresme;08197;Sant Andreu de Llavaneres;1;2;B;;739;196;403;490;249;3;12;475;487
8;Barcelona;21;Maresme;08197;Sant Andreu de Llavaneres;1;3;A;;635;138;328;394;241;0;8;386;394
8;Barcelona;21;Maresme;08197;Sant Andreu de Llavaneres;1;3;B;;592;160;302;366;226;4;8;354;362
8;Barcelona;21;Maresme;08197;Sant Andreu de Llavaneres;2;1;A;;567;136;323;380;187;0;6;374;380
8;Barcelona;21;Maresme;08197;Sant Andreu de Llavaneres;2;1;B;;640;190;351;424;216;1;14;409;423
8;Barcelona;21;Maresme;08197;Sant Andreu de Llavaneres;2;2;A;;479;137;244;297;182;1;8;288;296
8;Barcelona;21;Maresme;08197;Sant Andreu de Llavaneres;2;2;B;;599;149;284;363;236;0;9;354;363
8;Barcelona;21;Maresme;08197;Sant Andreu de Llavaneres;2;3;U;;772;251;443;531;241;1;14;516;530
17;Girona;20;Gironès;17157;Sant Andreu Salou;1;1;U;;122;41;72;86;36;1;3;82;85
17;Girona;19;Garrotxa;17183;Sant Aniol de Finestres;1;1;U;;258;81;150;185;73;0;5;180;185
8;Barcelona;41;Vallès Oriental;08198;Sant Antoni de Vilamajor;1;1;A;;536;143;280;349;187;2;12;335;347
8;Barcelona;41;Vallès Oriental;08198;Sant Antoni de Vilamajor;1;1;B;;468;109;241;317;151;1;11;305;316
8;Barcelona;41;Vallès Oriental;08198;Sant Antoni de Vilamajor;1;1;C;;595;118;305;381;214;5;13;363;376
8;Barcelona;41;Vallès Oriental;08198;Sant Antoni de Vilamajor;1;1;D;;501;109;233;304;197;1;13;290;303
8;Barcelona;41;Vallès Oriental;08198;Sant Antoni de Vilamajor;1;2;A;;467;136;229;284;183;1;6;277;283
8;Barcelona;41;Vallès Oriental;08198;Sant Antoni de Vilamajor;1;2;B;;546;151;264;336;210;1;4;331;335
8;Barcelona;41;Vallès Oriental;08198;Sant Antoni de Vilamajor;1;3;A;;466;129;264;322;144;0;10;312;322
8;Barcelona;41;Vallès Oriental;08198;Sant Antoni de Vilamajor;1;3;B;;489;145;275;332;157;1;10;321;331
43;Tarragona;12;Baix Penedès;43140;Santa Oliva;1;1;A;;774;222;420;504;270;5;17;482;499
43;Tarragona;12;Baix Penedès;43140;Santa Oliva;1;1;B;;576;153;276;326;250;2;6;318;324
43;Tarragona;12;Baix Penedès;43140;Santa Oliva;1;1;C;;679;187;332;384;295;3;4;377;381
43;Tarragona;12;Baix Penedès;43140;Santa Oliva;1;1;D;;298;80;134;173;125;1;2;170;172
17;Girona;19;Garrotxa;17184;Santa Pau;1;1;A;;439;106;257;296;143;4;11;281;292
17;Girona;19;Garrotxa;17184;Santa Pau;1;1;B;;470;108;235;294;176;15;1;278;279
17;Girona;19;Garrotxa;17184;Santa Pau;1;1;C;;394;114;238;288;106;9;8;271;279
8;Barcelona;40;Vallès Occidental;08260;Santa Perpètua de Mogoda;1;1;A;;585;144;248;322;263;0;8;314;322
8;Barcelona;40;Vallès Occidental;08260;Santa Perpètua de Mogoda;1;1;B;;606;141;262;329;277;1;10;318;328
8;Barcelona;40;Vallès Occidental;08260;Santa Perpètua de Mogoda;1;10;U;;740;215;396;480;260;7;7;466;473
8;Barcelona;40;Vallès Occidental;08260;Santa Perpètua de Mogoda;1;11;U;;891;244;392;464;427;4;10;450;460
8;Barcelona;40;Vallès Occidental;08260;Santa Perpètua de Mogoda;1;12;A;;452;110;200;248;204;1;14;233;247
8;Barcelona;40;Vallès Occidental;08260;Santa Perpètua de Mogoda;1;12;B;;617;143;276;331;286;1;17;313;330
8;Barcelona;40;Vallès Occidental;08260;Santa Perpètua de Mogoda;1;12;C;;419;95;188;231;188;3;13;215;228
8;Barcelona;40;Vallès Occidental;08260;Santa Perpètua de Mogoda;1;13;A;;610;125;275;355;255;3;5;347;352
8;Barcelona;40;Vallès Occidental;08260;Santa Perpètua de Mogoda;1;13;B;;778;163;370;469;309;0;18;451;469
8;Barcelona;40;Vallès Occidental;08260;Santa Perpètua de Mogoda;1;13;C;;614;114;279;374;240;0;24;350;374
8;Barcelona;40;Vallès Occidental;08260;Santa Perpètua de Mogoda;1;14;U;;715;190;325;413;302;1;12;400;412
8;Barcelona;40;Vallès Occidental;08260;Santa Perpètua de Mogoda;1;2;A;;644;172;312;366;278;1;11;354;365
8;Barcelona;40;Vallès Occidental;08260;Santa Perpètua de Mogoda;1;2;B;;723;144;301;367;356;4;10;353;363
8;Barcelona;40;Vallès Occidental;08260;Santa Perpètua de Mogoda;1;2;C;;603;124;238;315;288;2;8;305;313
8;Barcelona;40;Vallès Occidental;08260;Santa Perpètua de Mogoda;1;3;A;;752;190;371;457;295;4;12;441;453
8;Barcelona;40;Vallès Occidental;08260;Santa Perpètua de Mogoda;1;3;B;;859;234;436;522;337;2;17;503;520
8;Barcelona;40;Vallès Occidental;08260;Santa Perpètua de Mogoda;1;4;A;;584;126;201;237;347;2;4;231;235
8;Barcelona;40;Vallès Occidental;08260;Santa Perpètua de Mogoda;1;4;B;;538;105;187;220;318;3;3;214;217
8;Barcelona;40;Vallès Occidental;08260;Santa Perpètua de Mogoda;1;5;A;;472;109;197;237;235;0;8;229;237
8;Barcelona;40;Vallès Occidental;08260;Santa Perpètua de Mogoda;1;5;B;;511;119;205;257;254;1;5;251;256
8;Barcelona;40;Vallès Occidental;08260;Santa Perpètua de Mogoda;1;6;U;;780;180;317;392;388;3;8;381;389
8;Barcelona;40;Vallès Occidental;08260;Santa Perpètua de Mogoda;1;7;A;;445;85;182;227;218;1;3;223;226
8;Barcelona;40;Vallès Occidental;08260;Santa Perpètua de Mogoda;1;7;B;;548;124;251;311;237;1;7;303;310
8;Barcelona;40;Vallès Occidental;08260;Santa Perpètua de Mogoda;1;8;A;;635;123;246;309;326;0;7;302;309
8;Barcelona;40;Vallès Occidental;08260;Santa Perpètua de Mogoda;1;8;B;;739;162;300;373;366;3;10;360;370
8;Barcelona;40;Vallès Occidental;08260;Santa Perpètua de Mogoda;1;9;A;;564;148;267;339;225;3;9;327;336
8;Barcelona;40;Vallès Occidental;08260;Santa Perpètua de Mogoda;1;9;B;;713;163;297;400;313;5;15;380;395
8;Barcelona;40;Vallès Occidental;08260;Santa Perpètua de Mogoda;1;9;C;;587;138;259;356;231;2;19;335;354
8;Barcelona;21;Maresme;08261;Santa Susanna;1;1;A;;533;143;283;337;196;1;7;329;336
8;Barcelona;21;Maresme;08261;Santa Susanna;1;1;B;;680;181;378;468;212;4;9;455;464
8;Barcelona;21;Maresme;08261;Santa Susanna;1;2;A;;474;127;224;270;204;0;4;266;270
8;Barcelona;21;Maresme;08261;Santa Susanna;1;2;B;;551;124;255;309;242;0;6;303;309
8;Barcelona;24;Osona;08199;Sant Bartomeu del Grau;1;1;U;;724;209;444;523;201;0;16;507;523
8;Barcelona;11;Baix Llobregat;08200;Sant Boi de Llobregat;1;1;U;;743;167;300;353;390;0;6;347;353
8;Barcelona;11;Baix Llobregat;08200;Sant Boi de Llobregat;1;2;A;;541;157;267;305;236;3;12;290;302
8;Barcelona;11;Baix Llobregat;08200;Sant Boi de Llobregat;1;2;B;;591;157;281;328;263;11;2;315;317
8;Barcelona;11;Baix Llobregat;08200;Sant Boi de Llobregat;1;3;A;;405;119;208;242;163;3;4;235;239
8;Barcelona;11;Baix Llobregat;08200;Sant Boi de Llobregat;1;3;B;;429;112;209;231;198;0;7;224;231
8;Barcelona;11;Baix Llobregat;08200;Sant Boi de Llobregat;1;4;A;;600;119;252;324;276;1;7;316;323
8;Barcelona;11;Baix Llobregat;08200;Sant Boi de Llobregat;1;4;B;;707;145;297;367;340;1;16;350;366
8;Barcelona;11;Baix Llobregat;08200;Sant Boi de Llobregat;1;5;A;;622;123;218;274;348;4;3;267;270
8;Barcelona;11;Baix Llobregat;08200;Sant Boi de Llobregat;1;5;B;;740;121;239;309;431;3;13;293;306
8;Barcelona;11;Baix Llobregat;08200;Sant Boi de Llobregat;1;6;U;;726;164;308;366;360;4;3;359;362
8;Barcelona;11;Baix Llobregat;08200;Sant Boi de Llobregat;1;7;A;;392;84;171;213;179;0;3;210;213
8;Barcelona;11;Baix Llobregat;08200;Sant Boi de Llobregat;1;7;B;;457;126;232;272;185;3;3;266;269
8;Barcelona;11;Baix Llobregat;08200;Sant Boi de Llobregat;2;1;A;;579;135;267;349;230;1;21;327;348
8;Barcelona;11;Baix Llobregat;08200;Sant Boi de Llobregat;2;1;B;;720;158;338;453;267;10;21;422;443
8;Barcelona;11;Baix Llobregat;08200;Sant Boi de Llobregat;2;1;C;;611;115;268;342;269;0;9;333;342
8;Barcelona;11;Baix Llobregat;08200;Sant Boi de Llobregat;2;10;A;;510;123;210;275;235;3;3;269;272
8;Barcelona;11;Baix Llobregat;08200;Sant Boi de Llobregat;2;10;B;;593;141;249;310;283;0;5;305;310
8;Barcelona;11;Baix Llobregat;08200;Sant Boi de Llobregat;2;10;C;;582;135;243;307;275;2;9;296;305
8;Barcelona;11;Baix Llobregat;08200;Sant Boi de Llobregat;2;11;A;;605;137;297;367;238;3;9;355;364
8;Barcelona;11;Baix Llobregat;08200;Sant Boi de Llobregat;2;11;B;;752;173;366;471;281;1;16;454;470
8;Barcelona;11;Baix Llobregat;08200;Sant Boi de Llobregat;2;12;A;;559;113;226;301;258;2;12;287;299
8;Barcelona;11;Baix Llobregat;08200;Sant Boi de Llobregat;2;12;B;;687;158;299;382;305;1;16;365;381
8;Barcelona;11;Baix Llobregat;08200;Sant Boi de Llobregat;2;12;C;;582;123;224;304;278;1;4;299;303
8;Barcelona;11;Baix Llobregat;08200;Sant Boi de Llobregat;2;13;A;;387;107;208;260;127;0;5;255;260
8;Barcelona;11;Baix Llobregat;08200;Sant Boi de Llobregat;2;13;B;;375;101;209;253;122;1;9;243;252
8;Barcelona;11;Baix Llobregat;08200;Sant Boi de Llobregat;2;13;C;;415;94;243;301;114;3;7;291;298
8;Barcelona;11;Baix Llobregat;08200;Sant Boi de Llobregat;2;14;A;;633;141;274;344;289;4;10;330;340
8;Barcelona;11;Baix Llobregat;08200;Sant Boi de Llobregat;2;14;B;;760;127;304;398;362;1;11;386;397
8;Barcelona;11;Baix Llobregat;08200;Sant Boi de Llobregat;2;15;A;;461;87;158;209;252;1;10;198;208
8;Barcelona;11;Baix Llobregat;08200;Sant Boi de Llobregat;2;15;B;;504;87;167;229;275;0;13;216;229
8;Barcelona;11;Baix Llobregat;08200;Sant Boi de Llobregat;2;15;C;;509;117;180;241;268;2;7;232;239
8;Barcelona;11;Baix Llobregat;08200;Sant Boi de Llobregat;2;16;A;;485;112;240;306;179;0;16;290;306
8;Barcelona;11;Baix Llobregat;08200;Sant Boi de Llobregat;2;16;B;;651;150;323;386;265;0;11;375;386
8;Barcelona;11;Baix Llobregat;08200;Sant Boi de Llobregat;2;17;A;;544;124;257;336;208;2;12;322;334
8;Barcelona;11;Baix Llobregat;08200;Sant Boi de Llobregat;2;17;B;;569;139;265;336;233;0;13;323;336
8;Barcelona;11;Baix Llobregat;08200;Sant Boi de Llobregat;2;18;A;;510;98;246;310;200;1;14;295;309
8;Barcelona;11;Baix Llobregat;08200;Sant Boi de Llobregat;2;18;B;;573;97;240;323;250;0;20;303;323
8;Barcelona;11;Baix Llobregat;08200;Sant Boi de Llobregat;2;19;U;;619;162;202;377;242;11;15;351;366
8;Barcelona;11;Baix Llobregat;08200;Sant Boi de Llobregat;2;2;A;;638;107;243;300;338;0;10;290;300
8;Barcelona;11;Baix Llobregat;08200;Sant Boi de Llobregat;2;2;B;;750;125;242;317;433;1;6;310;316
8;Barcelona;11;Baix Llobregat;08200;Sant Boi de Llobregat;2;3;A;;362;77;148;193;169;0;5;188;193
8;Barcelona;11;Baix Llobregat;08200;Sant Boi de Llobregat;2;3;B;;501;99;191;250;251;0;10;240;250
8;Barcelona;11;Baix Llobregat;08200;Sant Boi de Llobregat;2;3;C;;524;95;182;236;288;0;6;230;236
8;Barcelona;11;Baix Llobregat;08200;Sant Boi de Llobregat;2;4;A;;467;106;186;241;226;1;6;234;240
8;Barcelona;11;Baix Llobregat;08200;Sant Boi de Llobregat;2;4;B;;476;123;193;252;224;3;3;246;249
8;Barcelona;11;Baix Llobregat;08200;Sant Boi de Llobregat;2;5;A;;449;84;174;218;231;2;9;207;216
8;Barcelona;11;Baix Llobregat;08200;Sant Boi de Llobregat;2;5;B;;567;120;249;326;241;0;16;310;326
8;Barcelona;11;Baix Llobregat;08200;Sant Boi de Llobregat;2;6;A;;342;77;156;191;151;1;4;186;190
8;Barcelona;11;Baix Llobregat;08200;Sant Boi de Llobregat;2;6;B;;394;87;168;213;181;1;4;208;212
8;Barcelona;11;Baix Llobregat;08200;Sant Boi de Llobregat;2;6;C;;457;103;192;249;208;1;13;235;248
8;Barcelona;11;Baix Llobregat;08200;Sant Boi de Llobregat;2;7;A;;374;80;140;173;201;1;4;168;172
8;Barcelona;11;Baix Llobregat;08200;Sant Boi de Llobregat;2;7;B;;464;104;201;245;219;5;10;230;240
8;Barcelona;11;Baix Llobregat;08200;Sant Boi de Llobregat;2;8;A;;508;120;230;308;200;3;13;292;305
8;Barcelona;11;Baix Llobregat;08200;Sant Boi de Llobregat;2;8;B;;622;150;290;370;252;3;15;352;367
8;Barcelona;11;Baix Llobregat;08200;Sant Boi de Llobregat;2;9;A;;562;136;259;313;249;0;11;302;313
8;Barcelona;11;Baix Llobregat;08200;Sant Boi de Llobregat;2;9;B;;600;127;253;304;296;4;5;295;300
8;Barcelona;11;Baix Llobregat;08200;Sant Boi de Llobregat;3;1;A;;573;161;304;383;190;1;8;374;382
8;Barcelona;11;Baix Llobregat;08200;Sant Boi de Llobregat;3;1;B;;619;157;304;392;227;3;8;381;389
8;Barcelona;11;Baix Llobregat;08200;Sant Boi de Llobregat;3;2;A;;653;150;342;406;247;3;12;391;403
8;Barcelona;11;Baix Llobregat;08200;Sant Boi de Llobregat;3;2;B;;771;144;373;446;325;1;9;436;445
8;Barcelona;11;Baix Llobregat;08200;Sant Boi de Llobregat;3;3;A;;459;120;216;262;197;0;10;252;262
8;Barcelona;11;Baix Llobregat;08200;Sant Boi de Llobregat;3;3;B;;490;114;217;267;223;1;7;259;266
8;Barcelona;11;Baix Llobregat;08200;Sant Boi de Llobregat;3;3;C;;572;151;267;328;244;0;17;311;328
8;Barcelona;11;Baix Llobregat;08200;Sant Boi de Llobregat;3;4;U;;682;150;298;400;282;2;12;386;398
8;Barcelona;11;Baix Llobregat;08200;Sant Boi de Llobregat;3;5;A;;487;127;234;301;186;0;7;294;301
8;Barcelona;11;Baix Llobregat;08200;Sant Boi de Llobregat;3;5;B;;554;124;238;320;234;9;1;310;311
8;Barcelona;11;Baix Llobregat;08200;Sant Boi de Llobregat;3;5;C;;608;135;288;352;256;3;3;346;349
8;Barcelona;11;Baix Llobregat;08200;Sant Boi de Llobregat;3;6;A;;489;133;246;312;177;10;3;299;302
8;Barcelona;11;Baix Llobregat;08200;Sant Boi de Llobregat;3;6;B;;565;160;281;357;208;3;10;344;354
8;Barcelona;11;Baix Llobregat;08200;Sant Boi de Llobregat;3;7;A;;513;120;236;298;215;4;9;285;294
8;Barcelona;11;Baix Llobregat;08200;Sant Boi de Llobregat;3;7;B;;519;109;224;284;235;3;5;276;281
8;Barcelona;11;Baix Llobregat;08200;Sant Boi de Llobregat;3;7;C;;559;154;279;341;218;2;6;333;339
8;Barcelona;11;Baix Llobregat;08200;Sant Boi de Llobregat;3;8;U;;569;148;278;330;239;10;3;317;320
8;Barcelona;11;Baix Llobregat;08200;Sant Boi de Llobregat;3;9;A;;397;113;181;217;180;4;5;208;213
8;Barcelona;11;Baix Llobregat;08200;Sant Boi de Llobregat;3;9;B;;522;138;216;273;249;3;6;264;270
8;Barcelona;11;Baix Llobregat;08200;Sant Boi de Llobregat;4;1;A;;523;101;227;290;233;0;6;284;290
8;Barcelona;11;Baix Llobregat;08200;Sant Boi de Llobregat;4;1;B;;561;131;250;323;238;0;10;313;323
8;Barcelona;11;Baix Llobregat;08200;Sant Boi de Llobregat;4;1;C;;600;124;256;336;264;0;15;321;336
8;Barcelona;11;Baix Llobregat;08200;Sant Boi de Llobregat;4;2;A;;481;117;232;307;174;0;8;299;307
8;Barcelona;11;Baix Llobregat;08200;Sant Boi de Llobregat;4;2;B;;563;138;264;338;225;2;7;329;336
8;Barcelona;11;Baix Llobregat;08200;Sant Boi de Llobregat;4;2;C;;537;144;261;335;202;3;9;323;332
8;Barcelona;11;Baix Llobregat;08200;Sant Boi de Llobregat;4;3;A;;466;109;197;253;213;2;2;249;251
8;Barcelona;11;Baix Llobregat;08200;Sant Boi de Llobregat;4;3;B;;556;109;211;295;261;7;0;288;288
8;Barcelona;11;Baix Llobregat;08200;Sant Boi de Llobregat;4;4;A;;455;109;234;258;197;2;4;252;256
8;Barcelona;11;Baix Llobregat;08200;Sant Boi de Llobregat;4;4;B;;594;148;270;329;265;2;8;319;327
8;Barcelona;11;Baix Llobregat;08200;Sant Boi de Llobregat;4;5;A;;592;144;276;360;232;4;13;343;356
8;Barcelona;11;Baix Llobregat;08200;Sant Boi de Llobregat;4;5;B;;714;157;317;392;322;0;12;380;392
8;Barcelona;11;Baix Llobregat;08200;Sant Boi de Llobregat;4;6;A;;478;119;196;252;226;1;6;245;251
8;Barcelona;11;Baix Llobregat;08200;Sant Boi de Llobregat;4;6;B;;611;124;239;315;296;2;14;299;313
8;Barcelona;11;Baix Llobregat;08200;Sant Boi de Llobregat;4;6;C;;504;117;208;267;237;2;8;257;265
8;Barcelona;11;Baix Llobregat;08200;Sant Boi de Llobregat;4;7;A;;674;154;308;372;302;2;9;361;370
8;Barcelona;11;Baix Llobregat;08200;Sant Boi de Llobregat;4;7;B;;771;147;315;420;351;0;10;410;420
8;Barcelona;11;Baix Llobregat;08200;Sant Boi de Llobregat;4;8;A;;664;127;278;361;303;7;12;342;354
8;Barcelona;11;Baix Llobregat;08200;Sant Boi de Llobregat;4;8;B;;768;150;307;406;362;4;19;383;402
8;Barcelona;11;Baix Llobregat;08200;Sant Boi de Llobregat;4;9;A;;431;104;197;254;177;3;7;244;251
8;Barcelona;11;Baix Llobregat;08200;Sant Boi de Llobregat;4;9;B;;491;103;211;284;207;0;6;278;284
8;Barcelona;11;Baix Llobregat;08200;Sant Boi de Llobregat;5;1;A;;484;84;160;206;278;3;5;198;203
8;Barcelona;11;Baix Llobregat;08200;Sant Boi de Llobregat;5;1;B;;588;115;206;259;329;3;3;253;256
8;Barcelona;11;Baix Llobregat;08200;Sant Boi de Llobregat;5;1;C;;604;111;200;248;356;1;10;237;247
8;Barcelona;11;Baix Llobregat;08200;Sant Boi de Llobregat;5;2;U;;789;157;264;319;470;3;8;308;316
8;Barcelona;11;Baix Llobregat;08200;Sant Boi de Llobregat;5;3;U;;496;86;157;188;308;4;2;182;184
8;Barcelona;11;Baix Llobregat;08200;Sant Boi de Llobregat;5;4;U;;708;171;273;338;370;4;7;327;334
8;Barcelona;11;Baix Llobregat;08200;Sant Boi de Llobregat;6;1;A;;434;75;192;236;198;3;10;223;233
8;Barcelona;11;Baix Llobregat;08200;Sant Boi de Llobregat;6;1;B;;598;100;221;287;311;2;12;273;285
8;Barcelona;11;Baix Llobregat;08200;Sant Boi de Llobregat;6;1;C;;605;114;252;323;282;2;13;308;321
8;Barcelona;11;Baix Llobregat;08200;Sant Boi de Llobregat;6;2;A;;429;97;188;231;198;3;9;219;228
8;Barcelona;11;Baix Llobregat;08200;Sant Boi de Llobregat;6;2;B;;501;118;212;254;247;1;10;243;253
8;Barcelona;11;Baix Llobregat;08200;Sant Boi de Llobregat;6;2;C;;524;106;207;260;264;2;6;252;258
8;Barcelona;11;Baix Llobregat;08200;Sant Boi de Llobregat;6;3;A;;412;81;164;205;207;1;5;199;204
8;Barcelona;11;Baix Llobregat;08200;Sant Boi de Llobregat;6;3;B;;450;104;187;233;217;2;7;224;231
8;Barcelona;24;Osona;08201;Sant Boi de Lluçanès;1;1;U;;440;90;231;303;137;11;4;288;292
43;Tarragona;22;Montsià;43136;Sant Carles de la Ràpita;1;1;A;;858;204;385;466;392;3;19;444;463
43;Tarragona;22;Montsià;43136;Sant Carles de la Ràpita;1;1;B;;965;244;425;511;454;5;24;482;506
43;Tarragona;22;Montsià;43136;Sant Carles de la Ràpita;1;2;A;;492;130;213;272;220;2;14;256;270
43;Tarragona;22;Montsià;43136;Sant Carles de la Ràpita;1;2;B;;562;126;246;311;251;3;9;299;308
43;Tarragona;22;Montsià;43136;Sant Carles de la Ràpita;1;3;A;;447;128;235;276;171;2;5;269;274
43;Tarragona;22;Montsià;43136;Sant Carles de la Ràpita;1;3;B;;475;134;213;261;214;1;5;255;260
43;Tarragona;22;Montsià;43136;Sant Carles de la Ràpita;1;4;A;;716;186;307;372;344;8;9;355;364
43;Tarragona;22;Montsià;43136;Sant Carles de la Ràpita;1;4;B;;754;175;309;385;369;15;8;362;370
43;Tarragona;22;Montsià;43136;Sant Carles de la Ràpita;1;5;U;;924;180;343;420;504;2;8;410;418
43;Tarragona;22;Montsià;43136;Sant Carles de la Ràpita;2;1;U;;609;177;303;359;250;4;15;340;355
43;Tarragona;22;Montsià;43136;Sant Carles de la Ràpita;2;2;U;;584;176;300;351;233;3;10;338;348
43;Tarragona;22;Montsià;43136;Sant Carles de la Ràpita;2;3;U;;898;233;409;473;425;4;23;446;469
43;Tarragona;22;Montsià;43136;Sant Carles de la Ràpita;2;4;A;;380;97;197;231;149;5;12;214;226
43;Tarragona;22;Montsià;43136;Sant Carles de la Ràpita;2;4;B;;385;94;181;220;165;6;11;203;214
43;Tarragona;22;Montsià;43136;Sant Carles de la Ràpita;2;5;A;;583;143;261;317;266;1;18;298;316
43;Tarragona;22;Montsià;43136;Sant Carles de la Ràpita;2;5;B;;573;162;264;320;253;2;17;301;318
8;Barcelona;21;Maresme;08203;Sant Cebrià de Vallalta;1;1;A;;607;169;300;370;237;3;9;358;367
8;Barcelona;21;Maresme;08203;Sant Cebrià de Vallalta;1;1;B;;737;207;350;427;310;2;9;416;425
8;Barcelona;21;Maresme;08203;Sant Cebrià de Vallalta;1;2;A;;495;122;223;273;222;1;16;256;272
8;Barcelona;21;Maresme;08203;Sant Cebrià de Vallalta;1;2;B;;633;156;249;323;310;1;0;322;322
8;Barcelona;41;Vallès Oriental;08202;Sant Celoni;1;1;A;;628;203;354;444;184;17;1;426;427
8;Barcelona;41;Vallès Oriental;08202;Sant Celoni;1;1;B;;801;210;434;530;271;4;17;509;526
8;Barcelona;41;Vallès Oriental;08202;Sant Celoni;1;2;A;;653;199;369;471;182;1;15;455;470
8;Barcelona;41;Vallès Oriental;08202;Sant Celoni;1;2;B;;576;155;299;380;196;3;12;365;377
8;Barcelona;41;Vallès Oriental;08202;Sant Celoni;1;2;C;;646;202;376;450;196;4;9;437;446
8;Barcelona;41;Vallès Oriental;08202;Sant Celoni;1;3;A;;559;157;290;356;203;7;4;345;349
8;Barcelona;41;Vallès Oriental;08202;Sant Celoni;1;3;B;;721;180;344;428;293;3;11;414;425
8;Barcelona;41;Vallès Oriental;08202;Sant Celoni;1;3;C;;649;174;305;386;263;1;8;377;385
8;Barcelona;41;Vallès Oriental;08202;Sant Celoni;1;4;A;;239;73;126;148;91;1;8;139;147
8;Barcelona;41;Vallès Oriental;08202;Sant Celoni;1;4;B;;318;71;130;164;154;2;9;153;162
8;Barcelona;41;Vallès Oriental;08202;Sant Celoni;1;5;A;;849;223;442;556;293;1;20;535;555
8;Barcelona;41;Vallès Oriental;08202;Sant Celoni;1;5;B;;955;233;461;585;370;1;17;567;584
8;Barcelona;41;Vallès Oriental;08202;Sant Celoni;1;6;A;;582;145;300;373;209;20;3;350;353
8;Barcelona;41;Vallès Oriental;08202;Sant Celoni;1;6;B;;719;206;370;453;266;4;8;441;449
8;Barcelona;41;Vallès Oriental;08202;Sant Celoni;1;7;A;;507;103;222;281;226;1;7;273;280
8;Barcelona;41;Vallès Oriental;08202;Sant Celoni;1;7;B;;606;152;282;336;270;4;14;318;332
8;Barcelona;41;Vallès Oriental;08202;Sant Celoni;1;8;A;;334;95;173;224;110;0;11;213;224
8;Barcelona;41;Vallès Oriental;08202;Sant Celoni;1;8;B;;417;120;235;296;121;5;12;279;291
8;Barcelona;41;Vallès Oriental;08202;Sant Celoni;2;1;A;;791;219;386;472;319;3;18;451;469
8;Barcelona;41;Vallès Oriental;08202;Sant Celoni;2;1;B;;565;130;228;306;259;3;10;293;303
8;Barcelona;11;Baix Llobregat;08204;Sant Climent de Llobregat;1;1;A;;666;161;340;428;238;8;8;412;420
8;Barcelona;11;Baix Llobregat;08204;Sant Climent de Llobregat;1;1;B;;831;210;474;589;242;8;20;561;581
8;Barcelona;11;Baix Llobregat;08204;Sant Climent de Llobregat;1;2;A;;616;130;287;359;257;1;8;350;358
8;Barcelona;11;Baix Llobregat;08204;Sant Climent de Llobregat;1;2;B;;835;187;417;503;332;10;9;484;493
17;Girona;2;Alt Empordà;17158;Sant Climent Sescebes;1;1;U;;379;117;231;249;130;2;10;237;247
8;Barcelona;40;Vallès Occidental;08205;Sant Cugat del Vallès;1;1;A;;668;163;346;418;250;1;19;398;417
8;Barcelona;40;Vallès Occidental;08205;Sant Cugat del Vallès;1;1;B;;617;164;343;401;216;2;17;382;399
8;Barcelona;40;Vallès Occidental;08205;Sant Cugat del Vallès;1;10;U;;940;233;455;577;363;3;31;543;574
8;Barcelona;40;Vallès Occidental;08205;Sant Cugat del Vallès;1;11;A;;547;138;290;371;176;1;11;359;370
8;Barcelona;40;Vallès Occidental;08205;Sant Cugat del Vallès;1;11;B;;712;160;360;470;242;3;18;449;467
8;Barcelona;40;Vallès Occidental;08205;Sant Cugat del Vallès;1;12;A;;822;217;502;611;211;3;20;588;608
8;Barcelona;40;Vallès Occidental;08205;Sant Cugat del Vallès;1;12;B;;783;192;477;593;190;1;19;573;592
8;Barcelona;40;Vallès Occidental;08205;Sant Cugat del Vallès;1;13;A;;753;240;468;592;161;3;16;573;589
8;Barcelona;40;Vallès Occidental;08205;Sant Cugat del Vallès;1;13;B;;862;242;523;662;200;2;14;646;660
8;Barcelona;40;Vallès Occidental;08205;Sant Cugat del Vallès;1;14;A;;749;216;463;572;177;2;14;556;570
8;Barcelona;40;Vallès Occidental;08205;Sant Cugat del Vallès;1;14;B;;792;216;473;578;214;2;16;560;576
8;Barcelona;40;Vallès Occidental;08205;Sant Cugat del Vallès;1;15;A;;726;249;450;553;173;19;3;531;534
8;Barcelona;40;Vallès Occidental;08205;Sant Cugat del Vallès;1;15;B;;752;254;467;573;179;1;17;555;572
8;Barcelona;40;Vallès Occidental;08205;Sant Cugat del Vallès;1;16;A;;771;239;462;589;182;4;22;563;585
8;Barcelona;40;Vallès Occidental;08205;Sant Cugat del Vallès;1;16;B;;833;264;505;619;214;0;24;595;619
8;Barcelona;40;Vallès Occidental;08205;Sant Cugat del Vallès;1;2;A;;520;181;312;365;155;0;12;353;365
8;Barcelona;40;Vallès Occidental;08205;Sant Cugat del Vallès;1;2;B;;502;159;300;352;150;1;10;341;351
8;Barcelona;40;Vallès Occidental;08205;Sant Cugat del Vallès;1;3;A;;816;265;462;591;225;2;15;574;589
8;Barcelona;40;Vallès Occidental;08205;Sant Cugat del Vallès;1;3;B;;831;257;471;588;243;3;12;573;585
8;Barcelona;40;Vallès Occidental;08205;Sant Cugat del Vallès;1;4;A;;664;149;343;467;197;1;19;447;466
8;Barcelona;40;Vallès Occidental;08205;Sant Cugat del Vallès;1;4;B;;690;199;381;495;195;2;15;478;493
8;Barcelona;40;Vallès Occidental;08205;Sant Cugat del Vallès;1;5;A;;814;252;489;603;211;4;11;588;599
8;Barcelona;40;Vallès Occidental;08205;Sant Cugat del Vallès;1;5;B;;861;226;486;587;274;18;1;568;569
8;Barcelona;40;Vallès Occidental;08205;Sant Cugat del Vallès;1;5;C;;790;244;480;598;192;1;24;573;597
8;Barcelona;40;Vallès Occidental;08205;Sant Cugat del Vallès;1;6;A;;525;136;260;312;213;5;6;301;307
8;Barcelona;40;Vallès Occidental;08205;Sant Cugat del Vallès;1;6;B;;683;157;326;407;276;2;11;394;405
8;Barcelona;40;Vallès Occidental;08205;Sant Cugat del Vallès;1;6;C;;499;120;230;298;201;2;13;283;296
8;Barcelona;40;Vallès Occidental;08205;Sant Cugat del Vallès;1;7;A;;681;205;404;474;207;1;14;459;473
8;Barcelona;40;Vallès Occidental;08205;Sant Cugat del Vallès;1;7;B;;828;234;428;492;336;0;15;477;492
8;Barcelona;40;Vallès Occidental;08205;Sant Cugat del Vallès;1;8;A;;691;214;372;462;229;1;19;442;461
8;Barcelona;40;Vallès Occidental;08205;Sant Cugat del Vallès;1;8;B;;881;254;474;574;307;7;16;551;567
8;Barcelona;40;Vallès Occidental;08205;Sant Cugat del Vallès;1;9;A;;573;174;336;449;124;2;17;430;447
8;Barcelona;40;Vallès Occidental;08205;Sant Cugat del Vallès;1;9;B;;591;184;338;463;128;5;18;440;458
8;Barcelona;40;Vallès Occidental;08205;Sant Cugat del Vallès;2;1;A;;708;146;405;575;133;2;10;563;573
8;Barcelona;40;Vallès Occidental;08205;Sant Cugat del Vallès;2;1;B;;587;166;361;460;127;1;10;449;459
8;Barcelona;40;Vallès Occidental;08205;Sant Cugat del Vallès;2;1;C;;673;174;400;539;134;3;15;521;536
8;Barcelona;40;Vallès Occidental;08205;Sant Cugat del Vallès;2;10;A;;492;147;327;405;87;3;8;394;402
8;Barcelona;40;Vallès Occidental;08205;Sant Cugat del Vallès;2;10;B;;648;178;400;506;142;5;13;488;501
8;Barcelona;40;Vallès Occidental;08205;Sant Cugat del Vallès;2;2;A;;596;185;330;420;176;1;12;407;419
8;Barcelona;40;Vallès Occidental;08205;Sant Cugat del Vallès;2;2;B;;680;220;400;487;193;3;19;465;484
8;Barcelona;40;Vallès Occidental;08205;Sant Cugat del Vallès;2;3;U;;844;219;444;554;290;6;21;527;548
8;Barcelona;40;Vallès Occidental;08205;Sant Cugat del Vallès;2;4;U;;913;228;516;691;222;4;27;660;687
8;Barcelona;40;Vallès Occidental;08205;Sant Cugat del Vallès;2;5;U;;901;221;430;554;347;2;18;534;552
8;Barcelona;40;Vallès Occidental;08205;Sant Cugat del Vallès;2;6;A;;559;152;346;449;110;0;15;434;449
8;Barcelona;40;Vallès Occidental;08205;Sant Cugat del Vallès;2;6;B;;592;180;415;471;121;1;11;459;470
8;Barcelona;40;Vallès Occidental;08205;Sant Cugat del Vallès;2;6;C;;905;240;564;700;205;2;24;674;698
8;Barcelona;40;Vallès Occidental;08205;Sant Cugat del Vallès;2;7;A;;500;160;290;352;148;20;4;328;332
8;Barcelona;40;Vallès Occidental;08205;Sant Cugat del Vallès;2;7;B;;553;168;307;398;155;0;13;385;398
8;Barcelona;40;Vallès Occidental;08205;Sant Cugat del Vallès;2;8;A;;615;153;382;482;133;2;12;468;480
8;Barcelona;40;Vallès Occidental;08205;Sant Cugat del Vallès;2;8;B;;639;154;410;508;131;2;16;490;506
8;Barcelona;40;Vallès Occidental;08205;Sant Cugat del Vallès;2;9;A;;562;164;361;458;104;0;13;445;458
8;Barcelona;40;Vallès Occidental;08205;Sant Cugat del Vallès;2;9;B;;677;203;435;532;145;14;4;514;518
8;Barcelona;40;Vallès Occidental;08205;Sant Cugat del Vallès;3;1;A;;538;152;305;377;161;4;7;366;373
8;Barcelona;40;Vallès Occidental;08205;Sant Cugat del Vallès;3;1;B;;593;127;316;418;175;4;10;404;414
8;Barcelona;40;Vallès Occidental;08205;Sant Cugat del Vallès;3;2;A;;679;218;415;508;171;4;18;486;504
8;Barcelona;40;Vallès Occidental;08205;Sant Cugat del Vallès;3;2;B;;758;254;469;586;172;2;28;556;584
8;Barcelona;40;Vallès Occidental;08205;Sant Cugat del Vallès;3;3;A;;563;155;327;413;150;3;10;400;410
8;Barcelona;40;Vallès Occidental;08205;Sant Cugat del Vallès;3;3;B;;610;140;312;416;194;2;11;403;414
8;Barcelona;40;Vallès Occidental;08205;Sant Cugat del Vallès;3;4;A;;607;158;338;426;181;10;5;411;416
8;Barcelona;40;Vallès Occidental;08205;Sant Cugat del Vallès;3;4;B;;659;170;370;471;188;11;2;458;460
8;Barcelona;40;Vallès Occidental;08205;Sant Cugat del Vallès;4;1;U;;933;250;470;599;334;0;18;581;599
8;Barcelona;40;Vallès Occidental;08205;Sant Cugat del Vallès;4;2;U;;917;240;474;572;345;4;19;549;568
8;Barcelona;40;Vallès Occidental;08205;Sant Cugat del Vallès;4;3;A;;563;144;273;329;234;6;13;310;323
8;Barcelona;40;Vallès Occidental;08205;Sant Cugat del Vallès;4;3;B;;599;143;292;451;148;112;12;327;339
8;Barcelona;40;Vallès Occidental;08205;Sant Cugat del Vallès;5;1;A;;990;275;620;768;222;3;16;749;765
8;Barcelona;40;Vallès Occidental;08205;Sant Cugat del Vallès;5;1;B;;933;244;579;705;228;0;19;686;705
8;Barcelona;40;Vallès Occidental;08205;Sant Cugat del Vallès;5;1;C;;873;235;532;676;197;2;22;652;674
8;Barcelona;40;Vallès Occidental;08205;Sant Cugat del Vallès;5;2;A;;753;218;412;511;242;1;11;499;510
8;Barcelona;40;Vallès Occidental;08205;Sant Cugat del Vallès;5;2;B;;908;218;487;574;334;2;14;558;572
8;Barcelona;40;Vallès Occidental;08205;Sant Cugat del Vallès;5;3;A;;615;167;360;440;175;5;5;430;435
8;Barcelona;40;Vallès Occidental;08205;Sant Cugat del Vallès;5;3;B;;737;201;502;569;168;3;10;556;566
8;Barcelona;40;Vallès Occidental;08205;Sant Cugat del Vallès;5;4;A;;619;166;395;500;119;2;12;486;498
8;Barcelona;40;Vallès Occidental;08205;Sant Cugat del Vallès;5;4;B;;658;166;427;537;121;11;2;524;526
8;Barcelona;40;Vallès Occidental;08205;Sant Cugat del Vallès;5;5;A;;493;128;277;344;149;3;6;335;341
8;Barcelona;40;Vallès Occidental;08205;Sant Cugat del Vallès;5;5;B;;556;143;308;375;181;3;15;357;372
8;Barcelona;40;Vallès Occidental;08205;Sant Cugat del Vallès;6;1;U;;833;162;334;412;421;2;11;399;410
8;Barcelona;3;Alt Penedès;08206;Sant Cugat Sesgarrigues;1;1;U;;712;196;451;541;171;5;21;515;536
25;Lleida;25;Pallars Jussà;25196;Sant Esteve de la Sarga;1;1;U;;131;43;63;85;46;0;0;85;85
8;Barcelona;41;Vallès Oriental;08207;Sant Esteve de Palautordera;1;1;A;;578;240;317;448;130;5;7;436;443
8;Barcelona;41;Vallès Oriental;08207;Sant Esteve de Palautordera;1;1;B;;535;206;341;404;131;1;14;389;403
8;Barcelona;41;Vallès Oriental;08207;Sant Esteve de Palautordera;1;1;C;;607;216;400;485;122;4;10;471;481
8;Barcelona;11;Baix Llobregat;08208;Sant Esteve Sesrovires;1;1;A;;493;134;241;293;200;3;6;284;290
8;Barcelona;11;Baix Llobregat;08208;Sant Esteve Sesrovires;1;1;B;;424;109;209;244;180;1;10;233;243
8;Barcelona;11;Baix Llobregat;08208;Sant Esteve Sesrovires;1;1;C;;523;148;267;334;189;1;10;323;333
8;Barcelona;11;Baix Llobregat;08208;Sant Esteve Sesrovires;1;1;D;;421;112;214;259;162;3;8;248;256
8;Barcelona;11;Baix Llobregat;08208;Sant Esteve Sesrovires;1;2;A;;439;114;230;289;150;2;9;278;287
8;Barcelona;11;Baix Llobregat;08208;Sant Esteve Sesrovires;1;2;B;;433;125;228;299;134;1;14;284;298
8;Barcelona;11;Baix Llobregat;08208;Sant Esteve Sesrovires;1;2;C;;555;155;289;371;184;4;11;356;367
8;Barcelona;11;Baix Llobregat;08208;Sant Esteve Sesrovires;1;2;D;;423;115;226;289;134;2;10;277;287
8;Barcelona;11;Baix Llobregat;08208;Sant Esteve Sesrovires;1;3;A;;369;127;233;233;136;2;5;226;231
8;Barcelona;11;Baix Llobregat;08208;Sant Esteve Sesrovires;1;3;B;;458;104;175;292;166;0;1;291;292
8;Barcelona;11;Baix Llobregat;08208;Sant Esteve Sesrovires;1;4;A;;412;95;205;249;163;1;5;243;248
8;Barcelona;11;Baix Llobregat;08208;Sant Esteve Sesrovires;1;4;B;;423;100;194;249;174;1;5;243;248
17;Girona;34;Selva;17159;Sant Feliu de Buixalleu;1;1;U;;638;166;348;446;192;0;12;434;446
8;Barcelona;41;Vallès Oriental;08210;Sant Feliu de Codines;1;1;A;;473;131;246;288;185;2;11;275;286
8;Barcelona;41;Vallès Oriental;08210;Sant Feliu de Codines;1;1;B;;544;132;256;321;223;1;7;313;320
8;Barcelona;41;Vallès Oriental;08210;Sant Feliu de Codines;1;2;A;;553;138;267;340;213;1;15;324;339
8;Barcelona;41;Vallès Oriental;08210;Sant Feliu de Codines;1;2;B;;682;190;345;423;259;4;16;403;419
8;Barcelona;41;Vallès Oriental;08210;Sant Feliu de Codines;2;1;A;;490;117;231;282;208;2;3;277;280
8;Barcelona;41;Vallès Oriental;08210;Sant Feliu de Codines;2;1;B;;563;155;277;329;234;3;18;308;326
8;Barcelona;41;Vallès Oriental;08210;Sant Feliu de Codines;2;2;A;;350;102;181;213;137;3;4;206;210
8;Barcelona;41;Vallès Oriental;08210;Sant Feliu de Codines;2;2;B;;399;113;199;260;139;4;10;246;256
17;Girona;10;Baix Empordà;17160;Sant Feliu de Guíxols;1;1;A;;540;131;265;317;223;0;8;309;317
17;Girona;10;Baix Empordà;17160;Sant Feliu de Guíxols;1;1;B;;505;136;278;330;175;4;6;320;326
17;Girona;10;Baix Empordà;17160;Sant Feliu de Guíxols;1;2;A;;668;220;360;430;238;0;12;418;430
17;Girona;10;Baix Empordà;17160;Sant Feliu de Guíxols;1;2;B;;713;207;390;448;265;3;15;430;445
17;Girona;10;Baix Empordà;17160;Sant Feliu de Guíxols;2;1;A;;485;176;266;285;200;1;14;270;284
17;Girona;10;Baix Empordà;17160;Sant Feliu de Guíxols;2;1;B;;521;176;263;305;216;0;9;296;305
17;Girona;10;Baix Empordà;17160;Sant Feliu de Guíxols;2;2;A;;759;195;353;422;337;0;15;407;422
17;Girona;10;Baix Empordà;17160;Sant Feliu de Guíxols;2;2;B;;824;244;413;488;336;0;10;478;488
17;Girona;10;Baix Empordà;17160;Sant Feliu de Guíxols;2;3;A;;873;193;394;456;417;5;5;446;451
17;Girona;10;Baix Empordà;17160;Sant Feliu de Guíxols;2;3;B;;886;212;404;465;421;1;10;454;464
17;Girona;10;Baix Empordà;17160;Sant Feliu de Guíxols;2;4;U;;862;176;379;460;402;5;13;442;455
17;Girona;10;Baix Empordà;17160;Sant Feliu de Guíxols;2;5;A;;656;121;236;298;358;1;4;293;297
17;Girona;10;Baix Empordà;17160;Sant Feliu de Guíxols;2;5;B;;699;141;267;339;360;0;2;337;339
17;Girona;10;Baix Empordà;17160;Sant Feliu de Guíxols;3;1;A;;867;261;430;505;362;7;1;497;498
17;Girona;10;Baix Empordà;17160;Sant Feliu de Guíxols;3;1;B;;846;269;435;515;331;1;15;499;514
17;Girona;10;Baix Empordà;17160;Sant Feliu de Guíxols;3;2;A;;556;132;175;326;230;0;5;321;326
17;Girona;10;Baix Empordà;17160;Sant Feliu de Guíxols;3;2;B;;558;112;250;311;247;1;8;302;310
17;Girona;10;Baix Empordà;17160;Sant Feliu de Guíxols;3;3;A;;482;110;199;248;234;2;6;240;246
17;Girona;10;Baix Empordà;17160;Sant Feliu de Guíxols;3;3;B;;486;110;212;255;231;1;5;249;254
17;Girona;10;Baix Empordà;17160;Sant Feliu de Guíxols;4;1;A;;664;177;324;392;272;1;18;373;391
17;Girona;10;Baix Empordà;17160;Sant Feliu de Guíxols;4;1;B;;629;173;333;385;244;0;18;367;385
17;Girona;10;Baix Empordà;17160;Sant Feliu de Guíxols;4;2;U;;735;188;423;469;266;2;5;462;467
8;Barcelona;11;Baix Llobregat;08211;Sant Feliu de Llobregat;1;1;A;;618;152;370;456;162;4;15;437;452
8;Barcelona;11;Baix Llobregat;08211;Sant Feliu de Llobregat;1;1;B;;629;186;366;449;180;3;19;427;446
8;Barcelona;11;Baix Llobregat;08211;Sant Feliu de Llobregat;1;2;A;;471;142;270;350;121;4;21;325;346
8;Barcelona;11;Baix Llobregat;08211;Sant Feliu de Llobregat;1;2;B;;510;131;289;363;147;0;9;354;363
8;Barcelona;11;Baix Llobregat;08211;Sant Feliu de Llobregat;1;3;A;;436;108;227;304;132;5;8;291;299
8;Barcelona;11;Baix Llobregat;08211;Sant Feliu de Llobregat;1;3;B;;594;139;298;401;193;6;23;372;395
8;Barcelona;11;Baix Llobregat;08211;Sant Feliu de Llobregat;1;4;A;;730;155;372;490;240;2;15;473;488
8;Barcelona;11;Baix Llobregat;08211;Sant Feliu de Llobregat;1;4;B;;833;180;415;539;294;0;14;525;539
8;Barcelona;11;Baix Llobregat;08211;Sant Feliu de Llobregat;2;1;A;;549;135;270;334;215;2;16;316;332
8;Barcelona;11;Baix Llobregat;08211;Sant Feliu de Llobregat;2;1;B;;626;170;325;408;218;18;2;388;390
8;Barcelona;11;Baix Llobregat;08211;Sant Feliu de Llobregat;2;2;U;;512;133;282;344;168;0;13;331;344
8;Barcelona;11;Baix Llobregat;08211;Sant Feliu de Llobregat;2;3;A;;499;111;209;239;260;0;0;239;239
8;Barcelona;11;Baix Llobregat;08211;Sant Feliu de Llobregat;2;3;B;;526;117;212;264;262;0;4;260;264
8;Barcelona;11;Baix Llobregat;08211;Sant Feliu de Llobregat;2;4;U;;552;139;272;329;223;7;5;317;322
8;Barcelona;11;Baix Llobregat;08211;Sant Feliu de Llobregat;2;5;U;;820;215;431;536;284;4;22;510;532
8;Barcelona;11;Baix Llobregat;08211;Sant Feliu de Llobregat;2;6;A;;624;126;283;353;271;1;11;341;352
8;Barcelona;11;Baix Llobregat;08211;Sant Feliu de Llobregat;2;6;B;;694;161;323;409;285;1;17;391;408
8;Barcelona;11;Baix Llobregat;08211;Sant Feliu de Llobregat;2;7;A;;575;161;291;370;205;5;11;354;365
8;Barcelona;11;Baix Llobregat;08211;Sant Feliu de Llobregat;2;7;B;;658;162;325;409;249;3;14;392;406
8;Barcelona;11;Baix Llobregat;08211;Sant Feliu de Llobregat;2;8;A;;645;125;271;359;286;2;13;344;357
8;Barcelona;11;Baix Llobregat;08211;Sant Feliu de Llobregat;2;8;B;;681;138;295;368;313;2;12;354;366
8;Barcelona;11;Baix Llobregat;08211;Sant Feliu de Llobregat;3;1;A;;369;100;185;227;142;0;7;220;227
8;Barcelona;11;Baix Llobregat;08211;Sant Feliu de Llobregat;3;1;B;;444;123;224;271;173;3;5;263;268
8;Barcelona;11;Baix Llobregat;08211;Sant Feliu de Llobregat;3;1;C;;471;124;214;262;209;0;8;254;262
8;Barcelona;11;Baix Llobregat;08211;Sant Feliu de Llobregat;3;2;A;;373;95;168;211;162;1;8;202;210
8;Barcelona;11;Baix Llobregat;08211;Sant Feliu de Llobregat;3;2;B;;457;123;222;266;191;3;10;253;263
8;Barcelona;11;Baix Llobregat;08211;Sant Feliu de Llobregat;3;3;A;;619;176;326;407;212;1;10;396;406
8;Barcelona;11;Baix Llobregat;08211;Sant Feliu de Llobregat;3;3;B;;688;190;351;450;238;0;15;435;450
8;Barcelona;11;Baix Llobregat;08211;Sant Feliu de Llobregat;3;4;A;;659;171;383;471;188;6;11;454;465
8;Barcelona;11;Baix Llobregat;08211;Sant Feliu de Llobregat;3;4;B;;750;2;450;531;219;2;21;508;529
8;Barcelona;11;Baix Llobregat;08211;Sant Feliu de Llobregat;3;5;A;;592;162;320;395;197;2;13;380;393
8;Barcelona;11;Baix Llobregat;08211;Sant Feliu de Llobregat;3;5;B;;716;198;392;463;253;2;15;446;461
8;Barcelona;11;Baix Llobregat;08211;Sant Feliu de Llobregat;4;1;U;;743;152;322;402;341;12;0;390;390
8;Barcelona;11;Baix Llobregat;08211;Sant Feliu de Llobregat;4;2;A;;342;83;137;181;161;0;4;177;181
8;Barcelona;11;Baix Llobregat;08211;Sant Feliu de Llobregat;4;2;B;;511;117;220;270;241;10;12;248;260
8;Barcelona;11;Baix Llobregat;08211;Sant Feliu de Llobregat;4;3;U;;806;172;321;393;413;6;15;372;387
8;Barcelona;11;Baix Llobregat;08211;Sant Feliu de Llobregat;4;4;A;;592;134;270;340;252;3;10;327;337
8;Barcelona;11;Baix Llobregat;08211;Sant Feliu de Llobregat;4;4;B;;664;127;259;346;318;10;3;333;336
8;Barcelona;11;Baix Llobregat;08211;Sant Feliu de Llobregat;4;5;U;;398;93;225;206;192;0;6;200;206
8;Barcelona;11;Baix Llobregat;08211;Sant Feliu de Llobregat;5;1;A;;390;89;148;191;199;2;4;185;189
8;Barcelona;11;Baix Llobregat;08211;Sant Feliu de Llobregat;5;1;B;;462;86;163;220;242;2;4;214;218
8;Barcelona;11;Baix Llobregat;08211;Sant Feliu de Llobregat;5;2;U;;702;115;260;320;382;7;12;301;313
8;Barcelona;11;Baix Llobregat;08211;Sant Feliu de Llobregat;6;1;A;;375;69;150;195;180;0;9;186;195
8;Barcelona;11;Baix Llobregat;08211;Sant Feliu de Llobregat;6;1;B;;531;107;227;281;250;2;7;272;279
8;Barcelona;11;Baix Llobregat;08211;Sant Feliu de Llobregat;6;1;C;;489;90;205;240;249;0;4;236;240
8;Barcelona;11;Baix Llobregat;08211;Sant Feliu de Llobregat;6;2;U;;643;148;265;342;301;2;7;333;340
8;Barcelona;11;Baix Llobregat;08211;Sant Feliu de Llobregat;6;3;U;;688;124;257;348;340;6;17;325;342
8;Barcelona;11;Baix Llobregat;08211;Sant Feliu de Llobregat;6;4;A;;442;87;228;276;166;0;12;264;276
8;Barcelona;11;Baix Llobregat;08211;Sant Feliu de Llobregat;6;4;B;;538;104;274;348;190;0;14;334;348
8;Barcelona;11;Baix Llobregat;08211;Sant Feliu de Llobregat;7;1;A;;641;176;348;439;202;1;12;426;438
8;Barcelona;11;Baix Llobregat;08211;Sant Feliu de Llobregat;7;1;B;;763;190;396;498;265;0;20;478;498
8;Barcelona;11;Baix Llobregat;08211;Sant Feliu de Llobregat;7;2;A;;700;148;402;503;197;1;24;478;502
8;Barcelona;11;Baix Llobregat;08211;Sant Feliu de Llobregat;7;2;B;;790;176;434;565;225;1;12;552;564
8;Barcelona;11;Baix Llobregat;08211;Sant Feliu de Llobregat;7;3;U;;805;194;409;538;267;1;26;511;537
17;Girona;19;Garrotxa;17161;Sant Feliu de Pallerols;1;1;A;;487;180;294;349;138;4;11;334;345
17;Girona;19;Garrotxa;17161;Sant Feliu de Pallerols;1;1;B;;482;173;301;356;126;6;15;335;350
8;Barcelona;7;Bages;08212;Sant Feliu Sasserra;1;1;U;;512;120;300;371;141;2;12;357;369
17;Girona;19;Garrotxa;17162;Sant Ferriol;1;1;U;;136;26;49;67;69;0;2;65;67
8;Barcelona;41;Vallès Oriental;08209;Sant Fost de Campsentelles;1;1;A;;468;118;215;285;183;1;8;276;284
8;Barcelona;41;Vallès Oriental;08209;Sant Fost de Campsentelles;1;1;B;;517;121;237;295;222;0;8;287;295
8;Barcelona;41;Vallès Oriental;08209;Sant Fost de Campsentelles;1;1;C;;578;147;276;342;236;1;3;338;341
8;Barcelona;41;Vallès Oriental;08209;Sant Fost de Campsentelles;1;2;A;;557;124;245;309;248;0;6;303;309
8;Barcelona;41;Vallès Oriental;08209;Sant Fost de Campsentelles;1;2;B;;715;161;331;402;313;13;3;386;389
8;Barcelona;41;Vallès Oriental;08209;Sant Fost de Campsentelles;1;3;A;;636;155;328;399;237;1;7;391;398
8;Barcelona;41;Vallès Oriental;08209;Sant Fost de Campsentelles;1;3;B;;658;176;311;377;281;1;9;367;376
8;Barcelona;41;Vallès Oriental;08209;Sant Fost de Campsentelles;1;3;C;;674;190;326;409;265;2;9;398;407
8;Barcelona;41;Vallès Oriental;08209;Sant Fost de Campsentelles;1;4;A;;516;118;213;266;250;0;6;260;266
8;Barcelona;41;Vallès Oriental;08209;Sant Fost de Campsentelles;1;4;B;;622;152;264;343;279;1;14;328;342
8;Barcelona;41;Vallès Oriental;08209;Sant Fost de Campsentelles;1;4;C;;622;128;249;325;297;1;10;314;324
8;Barcelona;7;Bages;08213;Sant Fruitós de Bages;1;1;A;;495;143;255;306;189;1;8;297;305
8;Barcelona;7;Bages;08213;Sant Fruitós de Bages;1;1;B;;391;103;192;230;161;3;12;215;227
8;Barcelona;7;Bages;08213;Sant Fruitós de Bages;1;1;C;;541;151;267;318;223;0;10;308;318
8;Barcelona;7;Bages;08213;Sant Fruitós de Bages;1;1;D;;477;145;261;308;169;1;8;299;307
8;Barcelona;7;Bages;08213;Sant Fruitós de Bages;1;2;A;;637;170;308;368;269;4;17;347;364
8;Barcelona;7;Bages;08213;Sant Fruitós de Bages;1;2;B;;737;158;319;395;342;3;11;381;392
8;Barcelona;7;Bages;08213;Sant Fruitós de Bages;1;2;C;;554;162;298;374;180;1;14;359;373
8;Barcelona;7;Bages;08213;Sant Fruitós de Bages;1;3;A;;669;159;353;426;243;0;11;415;426
8;Barcelona;7;Bages;08213;Sant Fruitós de Bages;1;3;B;;793;194;404;479;314;1;12;466;478
8;Barcelona;7;Bages;08213;Sant Fruitós de Bages;1;4;U;;737;200;463;575;162;2;10;563;573
17;Girona;20;Gironès;17163;Sant Gregori;1;1;A;;769;223;442;561;208;5;23;533;556
17;Girona;20;Gironès;17163;Sant Gregori;1;1;B;;761;238;458;553;208;2;19;532;551
17;Girona;20;Gironès;17163;Sant Gregori;1;2;A;;660;179;312;389;271;0;11;378;389
17;Girona;20;Gironès;17163;Sant Gregori;1;2;B;;285;70;175;216;69;2;6;208;214
25;Lleida;32;Segarra;25192;Sant Guim de Freixenet;1;1;U;;797;225;443;558;239;14;28;516;544
25;Lleida;32;Segarra;25197;Sant Guim de la Plana;1;1;U;;144;38;86;112;32;0;6;106;112
17;Girona;34;Selva;17164;Sant Hilari Sacalm;1;1;A;;535;182;277;332;203;0;5;327;332
17;Girona;34;Selva;17164;Sant Hilari Sacalm;1;1;B;;671;236;360;445;226;3;12;430;442
17;Girona;34;Selva;17164;Sant Hilari Sacalm;1;2;A;;518;152;254;322;196;1;8;313;321
17;Girona;34;Selva;17164;Sant Hilari Sacalm;1;2;B;;564;196;303;367;197;2;7;358;365
17;Girona;34;Selva;17164;Sant Hilari Sacalm;1;3;A;;930;275;456;553;377;7;13;533;546
17;Girona;34;Selva;17164;Sant Hilari Sacalm;1;3;B;;894;259;445;555;339;5;13;537;550
8;Barcelona;24;Osona;08215;Sant Hipòlit de Voltregà;1;1;U;;833;240;438;534;299;7;12;515;527
8;Barcelona;24;Osona;08215;Sant Hipòlit de Voltregà;1;2;U;;861;265;505;630;231;8;25;597;622
8;Barcelona;24;Osona;08215;Sant Hipòlit de Voltregà;1;3;A;;377;101;213;246;131;3;11;232;243
8;Barcelona;24;Osona;08215;Sant Hipòlit de Voltregà;1;3;B;;529;142;286;346;183;2;12;332;344
8;Barcelona;21;Maresme;08193;Sant Iscle de Vallalta;1;1;U;;927;255;453;543;384;1;18;524;542
43;Tarragona;22;Montsià;43902;Sant Jaume d'Enveja;1;1;A;;805;228;394;474;331;18;9;447;456
43;Tarragona;22;Montsià;43902;Sant Jaume d'Enveja;1;1;B;;410;180;283;318;92;9;10;299;309
43;Tarragona;22;Montsià;43902;Sant Jaume d'Enveja;1;2;A;;809;194;365;454;355;7;9;438;447
43;Tarragona;22;Montsià;43902;Sant Jaume d'Enveja;1;2;B;;740;189;350;426;314;5;12;409;421
8;Barcelona;14;Berguedà;08216;Sant Jaume de Frontanyà;1;1;U;;21;4;8;12;9;0;0;12;12
17;Girona;19;Garrotxa;17165;Sant Jaume de Llierca;1;1;U;;622;206;377;430;192;6;14;410;424
43;Tarragona;12;Baix Penedès;43137;Sant Jaume dels Domenys;1;1;A;;572;143;280;352;220;2;7;343;350
43;Tarragona;12;Baix Penedès;43137;Sant Jaume dels Domenys;1;1;B;;594;147;306;362;232;3;14;345;359
43;Tarragona;12;Baix Penedès;43137;Sant Jaume dels Domenys;1;1;C;;704;188;364;428;276;12;13;403;416
17;Girona;31;Ripollès;17167;Sant Joan de les Abadesses;1;1;U;;547;170;319;373;174;6;13;354;367
17;Girona;31;Ripollès;17167;Sant Joan de les Abadesses;1;2;A;;551;193;294;366;185;3;8;355;363
17;Girona;31;Ripollès;17167;Sant Joan de les Abadesses;1;2;B;;478;157;266;331;147;1;13;317;330
17;Girona;31;Ripollès;17167;Sant Joan de les Abadesses;1;2;C;;552;203;329;386;166;4;14;368;382
17;Girona;31;Ripollès;17167;Sant Joan de les Abadesses;1;3;A;;364;111;204;247;117;4;15;228;243
17;Girona;31;Ripollès;17167;Sant Joan de les Abadesses;1;3;B;;346;122;215;248;98;1;10;237;247
17;Girona;20;Gironès;17168;Sant Joan de Mollet;1;1;U;;388;112;229;279;109;0;4;275;279
8;Barcelona;11;Baix Llobregat;08217;Sant Joan Despí;1;1;U;;834;171;390;531;303;2;25;504;529
8;Barcelona;11;Baix Llobregat;08217;Sant Joan Despí;1;10;A;;630;154;349;437;193;1;16;420;436
8;Barcelona;11;Baix Llobregat;08217;Sant Joan Despí;1;10;B;;716;174;382;499;217;1;8;490;498
8;Barcelona;11;Baix Llobregat;08217;Sant Joan Despí;1;2;A;;428;94;196;262;166;1;10;251;261
8;Barcelona;11;Baix Llobregat;08217;Sant Joan Despí;1;2;B;;458;112;221;283;175;2;16;265;281
8;Barcelona;11;Baix Llobregat;08217;Sant Joan Despí;1;3;A;;661;152;340;435;226;4;14;417;431
8;Barcelona;11;Baix Llobregat;08217;Sant Joan Despí;1;3;B;;785;179;372;468;317;0;0;468;468
8;Barcelona;11;Baix Llobregat;08217;Sant Joan Despí;1;4;A;;853;186;412;521;332;5;25;491;516
8;Barcelona;11;Baix Llobregat;08217;Sant Joan Despí;1;4;B;;952;218;478;604;348;3;15;586;601
8;Barcelona;11;Baix Llobregat;08217;Sant Joan Despí;1;5;A;;434;116;224;284;150;0;6;278;284
8;Barcelona;11;Baix Llobregat;08217;Sant Joan Despí;1;5;B;;446;135;230;299;147;0;16;283;299
8;Barcelona;11;Baix Llobregat;08217;Sant Joan Despí;1;5;C;;503;122;240;312;191;1;13;298;311
8;Barcelona;11;Baix Llobregat;08217;Sant Joan Despí;1;6;A;;384;71;165;218;166;1;3;214;217
8;Barcelona;11;Baix Llobregat;08217;Sant Joan Despí;1;6;B;;426;110;212;256;170;1;5;250;255
8;Barcelona;11;Baix Llobregat;08217;Sant Joan Despí;1;7;A;;507;108;227;286;221;2;12;272;284
8;Barcelona;11;Baix Llobregat;08217;Sant Joan Despí;1;7;B;;522;133;251;299;223;0;10;289;299
8;Barcelona;11;Baix Llobregat;08217;Sant Joan Despí;1;8;A;;538;124;256;339;199;3;12;324;336
8;Barcelona;11;Baix Llobregat;08217;Sant Joan Despí;1;8;B;;634;143;307;382;252;2;20;360;380
8;Barcelona;11;Baix Llobregat;08217;Sant Joan Despí;1;9;U;;953;219;513;649;304;1;23;625;648
8;Barcelona;11;Baix Llobregat;08217;Sant Joan Despí;2;2;A;;594;132;282;346;248;0;9;337;346
8;Barcelona;11;Baix Llobregat;08217;Sant Joan Despí;2;2;B;;564;106;252;315;249;0;15;300;315
8;Barcelona;11;Baix Llobregat;08217;Sant Joan Despí;2;3;U;;541;118;211;259;282;2;14;243;257
8;Barcelona;11;Baix Llobregat;08217;Sant Joan Despí;2;4;A;;388;87;174;212;176;0;5;207;212
8;Barcelona;11;Baix Llobregat;08217;Sant Joan Despí;2;4;B;;508;137;235;290;218;5;5;280;285
8;Barcelona;11;Baix Llobregat;08217;Sant Joan Despí;3;1;A;;305;81;160;196;109;1;4;191;195
8;Barcelona;11;Baix Llobregat;08217;Sant Joan Despí;3;1;B;;367;68;147;199;168;3;2;194;196
8;Barcelona;11;Baix Llobregat;08217;Sant Joan Despí;3;1;C;;327;70;153;197;130;1;5;191;196
8;Barcelona;11;Baix Llobregat;08217;Sant Joan Despí;3;2;A;;528;115;243;315;213;0;11;304;315
8;Barcelona;11;Baix Llobregat;08217;Sant Joan Despí;3;2;B;;562;110;243;313;249;3;14;296;310
8;Barcelona;11;Baix Llobregat;08217;Sant Joan Despí;3;3;A;;360;85;159;192;168;2;4;186;190
8;Barcelona;11;Baix Llobregat;08217;Sant Joan Despí;3;3;B;;327;81;148;186;141;0;7;179;186
8;Barcelona;11;Baix Llobregat;08217;Sant Joan Despí;3;4;A;;609;139;301;370;239;2;9;359;368
8;Barcelona;11;Baix Llobregat;08217;Sant Joan Despí;3;4;B;;683;154;306;390;293;1;14;375;389
8;Barcelona;11;Baix Llobregat;08217;Sant Joan Despí;3;5;A;;406;107;219;269;137;0;9;260;269
8;Barcelona;11;Baix Llobregat;08217;Sant Joan Despí;3;5;B;;478;112;227;271;207;1;9;261;270
8;Barcelona;11;Baix Llobregat;08217;Sant Joan Despí;4;1;A;;849;190;454;601;248;4;14;583;597
8;Barcelona;11;Baix Llobregat;08217;Sant Joan Despí;4;1;B;;961;230;538;680;281;5;12;663;675
8;Barcelona;11;Baix Llobregat;08217;Sant Joan Despí;5;1;A;;597;127;319;414;183;5;16;393;409
8;Barcelona;11;Baix Llobregat;08217;Sant Joan Despí;5;1;B;;683;143;308;428;255;2;13;413;426
8;Barcelona;11;Baix Llobregat;08217;Sant Joan Despí;5;1;C;;668;135;330;445;223;0;14;431;445
8;Barcelona;11;Baix Llobregat;08217;Sant Joan Despí;5;2;U;;847;180;460;597;250;2;16;579;595
8;Barcelona;7;Bages;08218;Sant Joan de Vilatorrada;1;1;A;;521;139;266;330;191;4;17;309;326
8;Barcelona;7;Bages;08218;Sant Joan de Vilatorrada;1;1;B;;544;128;262;319;225;0;14;305;319
8;Barcelona;7;Bages;08218;Sant Joan de Vilatorrada;1;1;C;;628;170;315;379;249;3;11;365;376
8;Barcelona;7;Bages;08218;Sant Joan de Vilatorrada;1;2;A;;488;108;219;275;213;0;12;263;275
8;Barcelona;7;Bages;08218;Sant Joan de Vilatorrada;1;2;B;;581;122;267;305;276;1;8;296;304
8;Barcelona;7;Bages;08218;Sant Joan de Vilatorrada;1;2;C;;545;100;234;279;266;1;11;267;278
8;Barcelona;7;Bages;08218;Sant Joan de Vilatorrada;1;3;A;;619;161;312;369;250;1;4;364;368
8;Barcelona;7;Bages;08218;Sant Joan de Vilatorrada;1;3;B;;762;206;374;450;312;1;12;437;449
8;Barcelona;7;Bages;08218;Sant Joan de Vilatorrada;1;3;C;;186;38;98;128;58;2;5;121;126
8;Barcelona;7;Bages;08218;Sant Joan de Vilatorrada;1;5;A;;614;174;317;364;250;5;12;347;359
8;Barcelona;7;Bages;08218;Sant Joan de Vilatorrada;1;5;B;;705;183;355;418;287;0;16;402;418
8;Barcelona;7;Bages;08218;Sant Joan de Vilatorrada;1;6;A;;508;101;220;267;241;2;10;255;265
8;Barcelona;7;Bages;08218;Sant Joan de Vilatorrada;1;6;B;;650;133;273;344;306;5;9;330;339
8;Barcelona;7;Bages;08218;Sant Joan de Vilatorrada;1;6;C;;635;114;259;326;309;5;17;304;321
17;Girona;19;Garrotxa;17185;Sant Joan les Fonts;1;1;A;;484;134;271;322;162;9;11;302;313
17;Girona;19;Garrotxa;17185;Sant Joan les Fonts;1;1;B;;476;145;245;301;175;5;11;285;296
17;Girona;19;Garrotxa;17185;Sant Joan les Fonts;1;2;U;;482;125;259;304;178;3;11;290;301
17;Girona;19;Garrotxa;17185;Sant Joan les Fonts;1;3;A;;620;164;348;409;211;2;27;380;407
17;Girona;19;Garrotxa;17185;Sant Joan les Fonts;1;3;B;;203;44;98;122;81;0;4;118;122
17;Girona;20;Gironès;17166;Sant Jordi Desvalls;1;1;U;;485;166;292;359;126;8;22;329;351
8;Barcelona;14;Berguedà;08903;Sant Julià de Cerdanyola;1;1;U;;211;97;153;171;40;0;4;167;171
17;Girona;34;Selva;17903;Sant Julià del Llor i Bonmatí;1;1;A;;428;110;204;258;170;5;9;244;253
17;Girona;34;Selva;17903;Sant Julià del Llor i Bonmatí;1;1;B;;477;126;274;329;148;4;10;315;325
17;Girona;20;Gironès;17169;Sant Julià de Ramis;1;1;A;;872;178;460;552;320;12;17;523;540
17;Girona;20;Gironès;17169;Sant Julià de Ramis;1;1;B;;892;207;498;602;290;11;20;571;591
17;Girona;20;Gironès;17169;Sant Julià de Ramis;1;2;U;;629;188;380;437;192;2;9;426;435
8;Barcelona;24;Osona;08220;Sant Julià de Vilatorta;1;1;A;;572;167;342;424;148;6;21;397;418
8;Barcelona;24;Osona;08220;Sant Julià de Vilatorta;1;1;B;;595;179;365;458;137;1;11;446;457
8;Barcelona;24;Osona;08220;Sant Julià de Vilatorta;1;2;A;;532;157;326;421;111;6;12;403;415
8;Barcelona;24;Osona;08220;Sant Julià de Vilatorta;1;2;B;;550;158;327;430;120;1;15;414;429
8;Barcelona;11;Baix Llobregat;08221;Sant Just Desvern;1;1;A;;690;187;396;503;187;9;13;481;494
8;Barcelona;11;Baix Llobregat;08221;Sant Just Desvern;1;1;B;;798;224;486;583;215;1;13;569;582
8;Barcelona;11;Baix Llobregat;08221;Sant Just Desvern;1;2;U;;634;189;343;402;232;4;9;389;398
8;Barcelona;11;Baix Llobregat;08221;Sant Just Desvern;1;3;A;;782;233;467;569;213;2;18;549;567
8;Barcelona;11;Baix Llobregat;08221;Sant Just Desvern;1;3;B;;938;289;523;656;282;3;13;640;653
8;Barcelona;11;Baix Llobregat;08221;Sant Just Desvern;1;4;A;;595;178;318;400;195;1;18;381;399
8;Barcelona;11;Baix Llobregat;08221;Sant Just Desvern;1;4;B;;721;177;404;520;201;2;18;500;518
8;Barcelona;11;Baix Llobregat;08221;Sant Just Desvern;1;5;A;;684;167;382;471;213;0;7;464;471
8;Barcelona;11;Baix Llobregat;08221;Sant Just Desvern;1;5;B;;818;203;443;557;261;3;15;539;554
8;Barcelona;11;Baix Llobregat;08221;Sant Just Desvern;1;6;A;;770;232;464;571;199;7;21;543;564
8;Barcelona;11;Baix Llobregat;08221;Sant Just Desvern;1;6;B;;875;263;518;638;237;2;27;609;636
8;Barcelona;11;Baix Llobregat;08221;Sant Just Desvern;1;7;A;;575;5;348;456;119;1;14;441;455
8;Barcelona;11;Baix Llobregat;08221;Sant Just Desvern;1;7;B;;715;186;403;498;217;2;19;477;496
8;Barcelona;11;Baix Llobregat;08221;Sant Just Desvern;1;8;A;;420;113;213;278;142;6;9;263;272
8;Barcelona;11;Baix Llobregat;08221;Sant Just Desvern;1;8;B;;536;133;272;371;165;3;14;354;368
8;Barcelona;11;Baix Llobregat;08221;Sant Just Desvern;1;9;A;;368;119;222;283;85;1;5;277;282
8;Barcelona;11;Baix Llobregat;08221;Sant Just Desvern;1;9;B;;396;135;243;290;106;1;5;284;289
8;Barcelona;3;Alt Penedès;08222;Sant Llorenç d'Hortons;1;1;A;;682;187;407;494;188;4;26;464;490
8;Barcelona;3;Alt Penedès;08222;Sant Llorenç d'Hortons;1;1;B;;669;175;366;470;199;5;33;432;465
8;Barcelona;3;Alt Penedès;08222;Sant Llorenç d'Hortons;1;1;C;;440;140;217;278;162;0;2;276;278
17;Girona;2;Alt Empordà;17171;Sant Llorenç de la Muga;1;1;U;;147;57;95;114;33;1;4;109;113
25;Lleida;35;Solsonès;25193;Sant Llorenç de Morunys;1;1;U;;782;268;482;560;222;0;14;546;560
8;Barcelona;40;Vallès Occidental;08223;Sant Llorenç Savall;1;1;A;;906;200;465;557;349;4;23;530;553
8;Barcelona;40;Vallès Occidental;08223;Sant Llorenç Savall;1;1;B;;951;215;472;568;383;3;16;549;565
8;Barcelona;24;Osona;08225;Sant Martí d'Albars;1;1;U;;96;34;61;76;20;0;6;70;76
8;Barcelona;24;Osona;08224;Sant Martí de Centelles;1;1;U;;767;244;425;505;262;2;14;489;503
17;Girona;20;Gironès;17172;Sant Martí de Llémena;1;1;U;;421;120;228;282;139;1;7;274;281
25;Lleida;38;Urgell;25902;Sant Martí de Riucorb;1;1;U;;578;133;317;407;171;9;10;388;398
8;Barcelona;6;Anoia;08226;Sant Martí de Tous;1;1;U;;885;215;550;675;210;3;16;656;672
8;Barcelona;3;Alt Penedès;08227;Sant Martí Sarroca;1;1;A;;650;168;337;411;239;2;15;394;409
8;Barcelona;3;Alt Penedès;08227;Sant Martí Sarroca;1;1;B;;526;124;256;334;192;0;7;327;334
8;Barcelona;3;Alt Penedès;08227;Sant Martí Sarroca;1;1;C;;671;170;360;428;243;2;14;412;426
8;Barcelona;3;Alt Penedès;08227;Sant Martí Sarroca;1;2;U;;514;93;235;308;206;1;9;298;307
8;Barcelona;6;Anoia;08228;Sant Martí Sesgueioles;1;1;U;;299;83;159;218;81;3;8;207;215
17;Girona;20;Gironès;17173;Sant Martí Vell;1;1;U;;167;46;91;110;57;0;5;105;110
8;Barcelona;7;Bages;08229;Sant Mateu de Bages;1;1;A;;141;45;81;104;37;0;4;100;104
8;Barcelona;7;Bages;08229;Sant Mateu de Bages;1;1;B;;414;133;246;305;109;7;15;283;298
17;Girona;28;Pla de l'Estany;17174;Sant Miquel de Campmajor;1;1;U;;176;48;97;119;57;2;7;110;117
17;Girona;2;Alt Empordà;17175;Sant Miquel de Fluvià;1;1;U;;554;137;267;314;240;1;6;307;313
17;Girona;2;Alt Empordà;17176;Sant Mori;1;1;U;;134;43;83;91;43;3;5;83;88
17;Girona;31;Ripollès;17177;Sant Pau de Segúries;1;1;U;;567;204;351;389;178;6;21;362;383
8;Barcelona;7;Bages;08192;Santpedor;1;1;A;;641;177;363;438;203;10;11;417;428
8;Barcelona;7;Bages;08192;Santpedor;1;1;B;;457;134;259;310;147;5;8;297;305
8;Barcelona;7;Bages;08192;Santpedor;1;2;A;;1099;270;546;459;640;0;13;446;459
8;Barcelona;7;Bages;08192;Santpedor;1;2;B;;1099;182;369;697;402;4;17;676;693
8;Barcelona;7;Bages;08192;Santpedor;1;3;A;;1194;294;659;822;372;6;21;795;816
8;Barcelona;7;Bages;08192;Santpedor;1;3;B;;676;187;347;448;228;1;8;439;447
8;Barcelona;7;Bages;08192;Santpedor;1;4;U;;675;178;358;464;211;1;16;447;463
8;Barcelona;17;Garraf;08231;Sant Pere de Ribes;1;1;A;;552;175;294;341;211;0;14;327;341
8;Barcelona;17;Garraf;08231;Sant Pere de Ribes;1;1;B;;544;148;280;332;212;6;11;315;326
8;Barcelona;17;Garraf;08231;Sant Pere de Ribes;1;10;A;;497;127;185;221;276;2;6;213;219
8;Barcelona;17;Garraf;08231;Sant Pere de Ribes;1;10;B;;645;133;239;281;364;2;3;276;279
8;Barcelona;17;Garraf;08231;Sant Pere de Ribes;1;11;A;;462;103;182;209;253;0;9;200;209
8;Barcelona;17;Garraf;08231;Sant Pere de Ribes;1;11;B;;407;97;160;194;213;3;8;183;191
8;Barcelona;17;Garraf;08231;Sant Pere de Ribes;1;12;A;;367;79;178;215;152;6;7;202;209
8;Barcelona;17;Garraf;08231;Sant Pere de Ribes;1;12;B;;380;71;137;164;216;0;7;157;164
8;Barcelona;17;Garraf;08231;Sant Pere de Ribes;1;13;A;;495;91;183;230;265;4;5;221;226
8;Barcelona;17;Garraf;08231;Sant Pere de Ribes;1;13;B;;548;116;206;266;282;0;5;261;266
8;Barcelona;17;Garraf;08231;Sant Pere de Ribes;1;14;U;;678;152;307;377;301;0;2;375;377
8;Barcelona;17;Garraf;08231;Sant Pere de Ribes;1;15;A;;518;140;238;297;221;1;8;288;296
8;Barcelona;17;Garraf;08231;Sant Pere de Ribes;1;15;B;;618;140;281;356;262;0;7;349;356
8;Barcelona;17;Garraf;08231;Sant Pere de Ribes;1;15;C;;273;89;150;175;98;1;2;172;174
8;Barcelona;17;Garraf;08231;Sant Pere de Ribes;1;16;A;;512;121;248;304;208;4;12;288;300
8;Barcelona;17;Garraf;08231;Sant Pere de Ribes;1;16;B;;582;136;281;342;240;1;5;336;341
8;Barcelona;17;Garraf;08231;Sant Pere de Ribes;1;17;A;;458;96;215;268;190;1;12;255;267
8;Barcelona;17;Garraf;08231;Sant Pere de Ribes;1;17;B;;607;130;292;369;238;2;11;356;367
8;Barcelona;17;Garraf;08231;Sant Pere de Ribes;1;2;A;;484;122;242;290;194;1;4;285;289
8;Barcelona;17;Garraf;08231;Sant Pere de Ribes;1;2;B;;519;141;252;298;221;2;6;290;296
8;Barcelona;17;Garraf;08231;Sant Pere de Ribes;1;3;A;;618;151;306;379;239;0;8;371;379
8;Barcelona;17;Garraf;08231;Sant Pere de Ribes;1;3;B;;743;184;348;422;321;3;13;406;419
8;Barcelona;17;Garraf;08231;Sant Pere de Ribes;1;4;A;;605;110;197;257;348;1;10;246;256
8;Barcelona;17;Garraf;08231;Sant Pere de Ribes;1;4;B;;791;169;292;354;437;3;6;345;351
8;Barcelona;17;Garraf;08231;Sant Pere de Ribes;1;5;A;;709;134;285;345;364;1;10;334;344
8;Barcelona;17;Garraf;08231;Sant Pere de Ribes;1;5;B;;878;202;355;445;433;1;8;436;444
8;Barcelona;17;Garraf;08231;Sant Pere de Ribes;1;6;A;;539;126;203;238;301;1;2;235;237
8;Barcelona;17;Garraf;08231;Sant Pere de Ribes;1;6;B;;667;156;259;288;379;2;7;279;286
8;Barcelona;17;Garraf;08231;Sant Pere de Ribes;1;7;A;;646;121;225;284;362;7;9;268;277
8;Barcelona;17;Garraf;08231;Sant Pere de Ribes;1;7;B;;791;161;296;368;423;4;7;357;364
8;Barcelona;17;Garraf;08231;Sant Pere de Ribes;1;8;A;;402;102;193;246;156;1;8;237;245
8;Barcelona;17;Garraf;08231;Sant Pere de Ribes;1;8;B;;532;153;247;340;192;1;8;331;339
8;Barcelona;17;Garraf;08231;Sant Pere de Ribes;1;9;A;;745;21;383;453;292;7;9;437;446
8;Barcelona;17;Garraf;08231;Sant Pere de Ribes;1;9;B;;746;206;383;446;300;8;10;428;438
8;Barcelona;3;Alt Penedès;08232;Sant Pere de Riudebitlles;1;1;A;;624;143;329;419;205;3;14;402;416
8;Barcelona;3;Alt Penedès;08232;Sant Pere de Riudebitlles;1;1;B;;585;148;311;384;201;2;5;377;382
8;Barcelona;3;Alt Penedès;08232;Sant Pere de Riudebitlles;1;1;C;;609;141;309;397;212;1;13;383;396
8;Barcelona;24;Osona;08233;Sant Pere de Torelló;1;1;U;;714;233;419;511;203;3;19;489;508
8;Barcelona;24;Osona;08233;Sant Pere de Torelló;1;2;A;;493;122;244;302;191;1;8;293;301
8;Barcelona;24;Osona;08233;Sant Pere de Torelló;1;2;B;;635;153;339;421;214;4;9;408;417
8;Barcelona;41;Vallès Oriental;08234;Sant Pere de Vilamajor;1;1;A;;797;204;412;490;307;1;20;469;489
8;Barcelona;41;Vallès Oriental;08234;Sant Pere de Vilamajor;1;1;B;;644;152;319;388;256;2;8;378;386
8;Barcelona;41;Vallès Oriental;08234;Sant Pere de Vilamajor;1;1;C;;958;240;474;576;382;2;15;559;574
8;Barcelona;41;Vallès Oriental;08234;Sant Pere de Vilamajor;1;1;D;;703;183;355;428;275;2;18;408;426
17;Girona;2;Alt Empordà;17178;Sant Pere Pescador;1;1;U;;1086;320;592;712;374;4;29;679;708
8;Barcelona;6;Anoia;08189;Sant Pere Sallavinera;1;1;U;;145;42;89;119;26;0;1;118;119
8;Barcelona;21;Maresme;08235;Sant Pol de Mar;1;1;A;;610;211;366;442;168;2;12;428;440
8;Barcelona;21;Maresme;08235;Sant Pol de Mar;1;1;B;;649;181;337;410;239;1;12;397;409
8;Barcelona;21;Maresme;08235;Sant Pol de Mar;1;1;C;;821;269;458;548;273;5;16;527;543
8;Barcelona;21;Maresme;08235;Sant Pol de Mar;1;2;A;;668;212;379;463;205;2;3;458;461
8;Barcelona;21;Maresme;08235;Sant Pol de Mar;1;2;B;;873;246;513;637;236;6;13;618;631
8;Barcelona;3;Alt Penedès;08236;Sant Quintí de Mediona;1;1;A;;715;170;355;434;281;12;12;410;422
8;Barcelona;3;Alt Penedès;08236;Sant Quintí de Mediona;1;1;B;;817;217;438;543;274;4;22;517;539
8;Barcelona;24;Osona;08237;Sant Quirze de Besora;1;1;A;;477;162;292;324;153;4;6;314;320
8;Barcelona;24;Osona;08237;Sant Quirze de Besora;1;1;B;;561;173;323;372;189;1;10;361;371
8;Barcelona;24;Osona;08237;Sant Quirze de Besora;1;2;U;;666;236;330;485;181;0;15;470;485
8;Barcelona;40;Vallès Occidental;08238;Sant Quirze del Vallès;1;1;A;;537;168;290;360;177;1;15;344;359
8;Barcelona;40;Vallès Occidental;08238;Sant Quirze del Vallès;1;1;B;;628;176;370;444;184;3;11;430;441
8;Barcelona;40;Vallès Occidental;08238;Sant Quirze del Vallès;1;10;A;;459;131;235;300;159;5;8;287;295
8;Barcelona;40;Vallès Occidental;08238;Sant Quirze del Vallès;1;10;B;;495;122;290;321;174;4;9;308;317
8;Barcelona;40;Vallès Occidental;08238;Sant Quirze del Vallès;1;11;A;;512;120;248;311;201;0;12;299;311
8;Barcelona;40;Vallès Occidental;08238;Sant Quirze del Vallès;1;11;B;;574;146;271;352;222;2;6;344;350
8;Barcelona;40;Vallès Occidental;08238;Sant Quirze del Vallès;1;12;A;;387;101;224;274;113;2;9;263;272
8;Barcelona;40;Vallès Occidental;08238;Sant Quirze del Vallès;1;12;B;;420;92;218;275;145;1;9;265;274
8;Barcelona;40;Vallès Occidental;08238;Sant Quirze del Vallès;1;2;A;;506;144;317;403;103;0;6;397;403
8;Barcelona;40;Vallès Occidental;08238;Sant Quirze del Vallès;1;2;B;;521;155;327;420;101;1;7;412;419
8;Barcelona;40;Vallès Occidental;08238;Sant Quirze del Vallès;1;3;A;;448;109;213;262;186;0;11;251;262
8;Barcelona;40;Vallès Occidental;08238;Sant Quirze del Vallès;1;3;B;;677;135;276;358;319;3;9;346;355
8;Barcelona;40;Vallès Occidental;08238;Sant Quirze del Vallès;1;3;C;;438;107;221;260;178;0;11;249;260
8;Barcelona;40;Vallès Occidental;08238;Sant Quirze del Vallès;1;4;A;;445;139;274;334;111;1;10;323;333
8;Barcelona;40;Vallès Occidental;08238;Sant Quirze del Vallès;1;4;B;;427;125;249;303;124;1;16;286;302
8;Barcelona;40;Vallès Occidental;08238;Sant Quirze del Vallès;1;4;C;;420;131;257;321;99;1;11;309;320
8;Barcelona;40;Vallès Occidental;08238;Sant Quirze del Vallès;1;5;A;;512;147;281;347;165;1;12;334;346
8;Barcelona;40;Vallès Occidental;08238;Sant Quirze del Vallès;1;5;B;;538;138;293;361;177;1;10;350;360
8;Barcelona;40;Vallès Occidental;08238;Sant Quirze del Vallès;1;5;C;;519;128;273;338;181;0;7;331;338
8;Barcelona;40;Vallès Occidental;08238;Sant Quirze del Vallès;1;6;A;;359;110;212;279;80;1;13;265;278
8;Barcelona;40;Vallès Occidental;08238;Sant Quirze del Vallès;1;6;B;;447;107;226;304;143;2;6;296;302
8;Barcelona;40;Vallès Occidental;08238;Sant Quirze del Vallès;1;6;C;;379;108;200;278;101;0;6;272;278
8;Barcelona;40;Vallès Occidental;08238;Sant Quirze del Vallès;1;7;A;;445;132;257;326;119;1;5;320;325
8;Barcelona;40;Vallès Occidental;08238;Sant Quirze del Vallès;1;7;B;;422;114;248;313;109;3;7;303;310
8;Barcelona;40;Vallès Occidental;08238;Sant Quirze del Vallès;1;7;C;;446;118;266;328;118;1;14;313;327
8;Barcelona;40;Vallès Occidental;08238;Sant Quirze del Vallès;1;8;A;;576;169;348;443;133;1;18;424;442
8;Barcelona;40;Vallès Occidental;08238;Sant Quirze del Vallès;1;8;B;;702;202;400;536;166;2;16;518;534
8;Barcelona;40;Vallès Occidental;08238;Sant Quirze del Vallès;1;9;A;;260;60;115;149;111;4;2;143;145
8;Barcelona;40;Vallès Occidental;08238;Sant Quirze del Vallès;1;9;B;;307;61;134;170;137;3;6;161;167
8;Barcelona;;;08239;Sant Quirze Safaja;1;1;U;;457;164;254;301;156;0;8;293;301
25;Lleida;32;Segarra;25194;Sant Ramon;1;1;U;;455;124;235;311;144;2;22;287;309
8;Barcelona;3;Alt Penedès;08240;Sant Sadurní d'Anoia;1;1;A;;418;125;244;297;121;1;10;286;296
8;Barcelona;3;Alt Penedès;08240;Sant Sadurní d'Anoia;1;1;B;;484;156;287;353;131;1;19;333;352
8;Barcelona;3;Alt Penedès;08240;Sant Sadurní d'Anoia;1;2;A;;527;127;238;320;207;0;12;308;320
8;Barcelona;3;Alt Penedès;08240;Sant Sadurní d'Anoia;1;2;B;;482;117;233;289;193;5;9;275;284
8;Barcelona;3;Alt Penedès;08240;Sant Sadurní d'Anoia;1;2;C;;490;102;220;297;193;2;12;283;295
8;Barcelona;3;Alt Penedès;08240;Sant Sadurní d'Anoia;1;3;A;;451;110;210;255;196;2;14;239;253
8;Barcelona;3;Alt Penedès;08240;Sant Sadurní d'Anoia;1;3;B;;423;105;186;238;185;1;8;229;237
8;Barcelona;3;Alt Penedès;08240;Sant Sadurní d'Anoia;1;4;A;;330;77;159;202;128;0;6;196;202
8;Barcelona;3;Alt Penedès;08240;Sant Sadurní d'Anoia;1;4;B;;395;103;179;240;155;2;9;229;238
8;Barcelona;3;Alt Penedès;08240;Sant Sadurní d'Anoia;2;1;A;;386;86;182;257;129;2;5;250;255
8;Barcelona;3;Alt Penedès;08240;Sant Sadurní d'Anoia;2;1;B;;448;124;232;307;141;0;8;299;307
8;Barcelona;3;Alt Penedès;08240;Sant Sadurní d'Anoia;2;2;A;;476;110;227;303;173;1;15;287;302
8;Barcelona;3;Alt Penedès;08240;Sant Sadurní d'Anoia;2;2;B;;481;130;232;283;198;4;11;268;279
8;Barcelona;3;Alt Penedès;08240;Sant Sadurní d'Anoia;2;2;C;;531;133;265;340;191;1;14;325;339
8;Barcelona;3;Alt Penedès;08240;Sant Sadurní d'Anoia;2;3;A;;466;131;242;300;166;4;5;291;296
8;Barcelona;3;Alt Penedès;08240;Sant Sadurní d'Anoia;2;3;B;;598;1;315;396;202;4;11;381;392
8;Barcelona;3;Alt Penedès;08240;Sant Sadurní d'Anoia;2;4;A;;554;127;288;378;176;2;12;364;376
8;Barcelona;3;Alt Penedès;08240;Sant Sadurní d'Anoia;2;4;B;;568;124;291;388;180;5;14;369;383
8;Barcelona;3;Alt Penedès;08240;Sant Sadurní d'Anoia;2;4;C;;529;119;258;348;181;3;6;339;345
8;Barcelona;24;Osona;08241;Sant Sadurní d'Osormort;1;1;U;;87;19;35;61;26;0;1;60;61
8;Barcelona;7;Bages;08098;Sant Salvador de Guardiola;1;1;A;;654;148;330;412;242;4;15;393;408
8;Barcelona;7;Bages;08098;Sant Salvador de Guardiola;1;1;B;;642;166;334;408;234;4;5;399;404
8;Barcelona;7;Bages;08098;Sant Salvador de Guardiola;1;2;A;;526;110;231;285;241;4;7;274;281
8;Barcelona;7;Bages;08098;Sant Salvador de Guardiola;1;2;B;;545;142;258;300;245;2;6;292;298
8;Barcelona;7;Bages;08262;Sant Vicenç de Castellet;1;1;A;;555;145;256;315;240;4;9;302;311
8;Barcelona;7;Bages;08262;Sant Vicenç de Castellet;1;1;B;;783;165;338;421;362;5;12;404;416
8;Barcelona;7;Bages;08262;Sant Vicenç de Castellet;1;2;A;;539;132;277;342;197;4;11;327;338
8;Barcelona;7;Bages;08262;Sant Vicenç de Castellet;1;2;B;;627;145;311;389;238;10;5;374;379
8;Barcelona;7;Bages;08262;Sant Vicenç de Castellet;1;3;A;;627;157;292;358;269;7;10;341;351
8;Barcelona;7;Bages;08262;Sant Vicenç de Castellet;1;3;B;;797;169;340;432;365;3;12;417;429
8;Barcelona;7;Bages;08262;Sant Vicenç de Castellet;2;1;A;;545;89;224;290;255;7;18;265;283
8;Barcelona;7;Bages;08262;Sant Vicenç de Castellet;2;1;B;;585;99;240;300;285;1;13;286;299
8;Barcelona;7;Bages;08262;Sant Vicenç de Castellet;2;1;C;;601;99;242;329;272;3;14;312;326
8;Barcelona;7;Bages;08262;Sant Vicenç de Castellet;2;2;A;;457;82;221;263;194;1;8;254;262
8;Barcelona;7;Bages;08262;Sant Vicenç de Castellet;2;2;B;;524;107;242;310;214;3;9;298;307
8;Barcelona;11;Baix Llobregat;08263;Sant Vicenç dels Horts;1;1;U;;649;173;363;451;198;5;16;430;446
8;Barcelona;11;Baix Llobregat;08263;Sant Vicenç dels Horts;1;10;A;;424;142;235;278;146;1;3;274;277
8;Barcelona;11;Baix Llobregat;08263;Sant Vicenç dels Horts;1;10;B;;514;127;255;299;215;2;10;287;297
8;Barcelona;11;Baix Llobregat;08263;Sant Vicenç dels Horts;1;11;A;;447;139;238;278;169;1;10;267;277
8;Barcelona;11;Baix Llobregat;08263;Sant Vicenç dels Horts;1;11;B;;540;136;250;304;236;2;14;288;302
8;Barcelona;11;Baix Llobregat;08263;Sant Vicenç dels Horts;1;12;U;;633;148;275;323;310;3;12;308;320
8;Barcelona;11;Baix Llobregat;08263;Sant Vicenç dels Horts;1;2;A;;638;172;319;429;209;0;18;411;429
8;Barcelona;11;Baix Llobregat;08263;Sant Vicenç dels Horts;1;2;B;;727;195;352;467;260;3;11;453;464
8;Barcelona;11;Baix Llobregat;08263;Sant Vicenç dels Horts;1;3;A;;439;137;248;300;139;0;2;298;300
8;Barcelona;11;Baix Llobregat;08263;Sant Vicenç dels Horts;1;3;B;;553;139;278;346;207;2;7;337;344
8;Barcelona;11;Baix Llobregat;08263;Sant Vicenç dels Horts;1;4;A;;638;157;292;366;272;4;8;354;362
8;Barcelona;11;Baix Llobregat;08263;Sant Vicenç dels Horts;1;4;B;;732;205;348;422;310;1;10;411;421
8;Barcelona;11;Baix Llobregat;08263;Sant Vicenç dels Horts;1;5;A;;550;132;254;316;234;0;7;309;316
8;Barcelona;11;Baix Llobregat;08263;Sant Vicenç dels Horts;1;5;B;;555;140;272;317;238;7;4;306;310
8;Barcelona;11;Baix Llobregat;08263;Sant Vicenç dels Horts;1;6;A;;292;60;141;168;124;0;6;162;168
8;Barcelona;11;Baix Llobregat;08263;Sant Vicenç dels Horts;1;6;B;;367;85;161;187;180;6;8;173;181
8;Barcelona;11;Baix Llobregat;08263;Sant Vicenç dels Horts;1;7;A;;647;125;264;336;311;1;4;331;335
8;Barcelona;11;Baix Llobregat;08263;Sant Vicenç dels Horts;1;7;B;;691;145;307;390;301;1;8;381;389
8;Barcelona;11;Baix Llobregat;08263;Sant Vicenç dels Horts;1;8;U;;824;194;394;465;359;6;20;439;459
8;Barcelona;11;Baix Llobregat;08263;Sant Vicenç dels Horts;1;9;U;;585;126;259;321;264;3;1;317;318
8;Barcelona;11;Baix Llobregat;08263;Sant Vicenç dels Horts;2;1;A;;265;46;75;92;173;0;1;91;92
8;Barcelona;11;Baix Llobregat;08263;Sant Vicenç dels Horts;2;1;B;;246;39;74;84;162;0;1;83;84
8;Barcelona;11;Baix Llobregat;08263;Sant Vicenç dels Horts;2;2;A;;700;140;263;346;354;3;8;335;343
8;Barcelona;11;Baix Llobregat;08263;Sant Vicenç dels Horts;2;2;B;;859;146;298;382;477;0;9;373;382
8;Barcelona;11;Baix Llobregat;08263;Sant Vicenç dels Horts;2;3;A;;452;103;153;194;258;0;4;190;194
8;Barcelona;11;Baix Llobregat;08263;Sant Vicenç dels Horts;2;3;B;;503;80;165;213;290;1;10;202;212
8;Barcelona;11;Baix Llobregat;08263;Sant Vicenç dels Horts;3;1;A;;665;117;245;303;362;0;2;301;303
8;Barcelona;11;Baix Llobregat;08263;Sant Vicenç dels Horts;3;1;B;;744;146;273;330;414;1;5;324;329
8;Barcelona;11;Baix Llobregat;08263;Sant Vicenç dels Horts;3;2;A;;643;135;259;336;307;0;8;328;336
8;Barcelona;11;Baix Llobregat;08263;Sant Vicenç dels Horts;3;2;B;;684;146;247;321;363;1;8;312;320
8;Barcelona;11;Baix Llobregat;08263;Sant Vicenç dels Horts;4;1;A;;580;120;262;316;264;2;16;298;314
8;Barcelona;11;Baix Llobregat;08263;Sant Vicenç dels Horts;4;1;B;;659;140;293;348;311;1;15;332;347
8;Barcelona;11;Baix Llobregat;08263;Sant Vicenç dels Horts;4;2;A;;439;104;200;237;202;3;6;228;234
8;Barcelona;11;Baix Llobregat;08263;Sant Vicenç dels Horts;4;2;B;;851;207;400;475;376;4;11;460;471
8;Barcelona;11;Baix Llobregat;08263;Sant Vicenç dels Horts;4;3;U;;840;213;395;505;335;1;9;495;504
8;Barcelona;21;Maresme;08264;Sant Vicenç de Montalt;1;1;A;;695;203;422;504;191;4;9;491;500
8;Barcelona;21;Maresme;08264;Sant Vicenç de Montalt;1;1;B;;722;221;417;510;212;2;15;493;508
8;Barcelona;21;Maresme;08264;Sant Vicenç de Montalt;1;2;A;;794;190;421;493;301;3;16;474;490
8;Barcelona;21;Maresme;08264;Sant Vicenç de Montalt;1;2;B;;1013;265;549;647;366;8;22;617;639
8;Barcelona;21;Maresme;08264;Sant Vicenç de Montalt;1;3;A;;350;110;224;255;95;5;5;245;250
8;Barcelona;21;Maresme;08264;Sant Vicenç de Montalt;1;3;B;;376;116;214;260;116;2;5;253;258
8;Barcelona;24;Osona;08265;Sant Vicenç de Torelló;1;1;A;;573;145;334;402;171;5;15;382;397
8;Barcelona;24;Osona;08265;Sant Vicenç de Torelló;1;1;B;;700;183;396;486;214;5;13;468;481
8;Barcelona;24;Osona;08265;Sant Vicenç de Torelló;1;2;U;;309;106;200;233;76;3;6;224;230
43;Tarragona;16;Conca de Barberà;43142;Sarral;1;1;A;;478;104;248;301;177;0;11;290;301
43;Tarragona;16;Conca de Barberà;43142;Sarral;1;1;B;;676;132;337;411;265;6;8;397;405
17;Girona;20;Gironès;17186;Sarrià de Ter;1;1;A;;518;176;305;348;170;7;13;328;341
17;Girona;20;Gironès;17186;Sarrià de Ter;1;1;B;;564;181;315;376;188;2;10;364;374
17;Girona;20;Gironès;17186;Sarrià de Ter;1;2;A;;727;218;401;461;266;15;16;430;446
17;Girona;20;Gironès;17186;Sarrià de Ter;1;2;B;;778;223;418;483;295;9;19;455;474
17;Girona;20;Gironès;17186;Sarrià de Ter;1;3;U;;947;267;487;560;387;6;13;541;554
25;Lleida;25;Pallars Jussà;25201;Sarroca de Bellera;1;1;U;;123;33;53;86;37;0;1;85;86
25;Lleida;33;Segrià;25200;Sarroca de Lleida;1;1;U;;366;100;186;234;132;2;5;227;232
17;Girona;2;Alt Empordà;17187;Saus, Camallera i Llampaies;1;1;U;;559;151;340;401;158;5;15;381;396
43;Tarragona;16;Conca de Barberà;43143;Savallà del Comtat;1;1;U;;62;24;42;52;10;1;3;48;51
43;Tarragona;36;Tarragonès;43144;Secuita, la;1;1;A;;493;130;231;304;189;1;13;290;303
43;Tarragona;36;Tarragonès;43144;Secuita, la;1;1;B;;702;185;351;446;256;7;15;424;439
43;Tarragona;8;Baix Camp;43145;Selva del Camp, la;1;1;A;;837;185;418;532;305;6;16;510;526
43;Tarragona;8;Baix Camp;43145;Selva del Camp, la;1;1;B;;903;215;448;590;313;8;13;569;582
43;Tarragona;8;Baix Camp;43145;Selva del Camp, la;2;1;A;;536;121;269;345;191;2;10;333;343
43;Tarragona;8;Baix Camp;43145;Selva del Camp, la;2;1;B;;606;168;312;395;211;1;11;383;394
43;Tarragona;8;Baix Camp;43145;Selva del Camp, la;2;2;A;;503;139;236;339;164;1;8;330;338
43;Tarragona;8;Baix Camp;43145;Selva del Camp, la;2;2;B;;541;131;299;379;162;4;6;369;375
17;Girona;2;Alt Empordà;17188;Selva de Mar, la;1;1;U;;173;67;110;136;37;0;10;126;136
43;Tarragona;16;Conca de Barberà;43146;Senan;1;1;U;;45;17;27;35;10;4;2;29;31
43;Tarragona;22;Montsià;43044;Sénia, la;1;1;A;;720;162;336;414;306;6;22;386;408
43;Tarragona;22;Montsià;43044;Sénia, la;1;1;B;;830;194;394;509;321;5;20;484;504
43;Tarragona;22;Montsià;43044;Sénia, la;2;1;A;;734;150;359;438;296;7;23;408;431
43;Tarragona;22;Montsià;43044;Sénia, la;2;1;B;;836;185;411;504;332;8;23;473;496
43;Tarragona;22;Montsià;43044;Sénia, la;2;2;U;;891;186;445;528;363;6;23;499;522
25;Lleida;25;Pallars Jussà;25202;Senterada;1;1;U;;112;25;45;73;39;0;1;72;73
25;Lleida;23;Noguera;25035;Sentiu de Sió, la;1;1;U;;440;122;247;302;138;5;7;290;297
8;Barcelona;40;Vallès Occidental;08267;Sentmenat;1;1;A;;542;101;231;295;247;3;6;286;292
8;Barcelona;40;Vallès Occidental;08267;Sentmenat;1;1;B;;545;113;264;319;226;1;8;310;318
8;Barcelona;40;Vallès Occidental;08267;Sentmenat;1;2;A;;631;147;297;364;267;2;7;355;362
8;Barcelona;40;Vallès Occidental;08267;Sentmenat;1;2;B;;767;164;347;452;315;0;8;444;452
8;Barcelona;40;Vallès Occidental;08267;Sentmenat;1;3;A;;528;120;244;313;215;3;4;306;310
8;Barcelona;40;Vallès Occidental;08267;Sentmenat;1;3;B;;643;147;294;388;255;0;15;373;388
8;Barcelona;40;Vallès Occidental;08267;Sentmenat;1;4;A;;632;164;271;405;227;3;10;392;402
8;Barcelona;40;Vallès Occidental;08267;Sentmenat;1;4;B;;791;208;399;501;290;5;17;479;496
8;Barcelona;40;Vallès Occidental;08267;Sentmenat;1;5;A;;425;87;184;246;179;0;3;243;246
8;Barcelona;40;Vallès Occidental;08267;Sentmenat;1;5;B;;593;124;250;332;261;2;11;319;330
17;Girona;28;Pla de l'Estany;17190;Serinyà;1;1;U;;805;243;466;569;236;11;16;542;558
25;Lleida;33;Segrià;25204;Seròs;1;1;U;;583;124;294;398;185;6;14;378;392
25;Lleida;33;Segrià;25204;Seròs;1;2;U;;752;134;375;481;271;5;20;456;476
17;Girona;10;Baix Empordà;17191;Serra de Daró;1;1;U;;157;52;96;116;41;1;0;115;115
17;Girona;31;Ripollès;17192;Setcases;1;1;U;;143;45;92;105;38;0;6;99;105
25;Lleida;4;Alt Urgell;25203;Seu d'Urgell, la;1;1;U;;591;124;233;297;294;0;11;286;297
25;Lleida;4;Alt Urgell;25203;Seu d'Urgell, la;1;2;A;;563;110;242;296;267;4;18;274;292
25;Lleida;4;Alt Urgell;25203;Seu d'Urgell, la;1;2;B;;589;129;269;327;262;1;7;319;326
25;Lleida;4;Alt Urgell;25203;Seu d'Urgell, la;1;3;A;;670;158;291;343;327;1;18;324;342
25;Lleida;4;Alt Urgell;25203;Seu d'Urgell, la;1;3;B;;663;149;298;363;300;3;25;335;360
25;Lleida;4;Alt Urgell;25203;Seu d'Urgell, la;1;4;A;;639;145;318;395;244;1;12;382;394
25;Lleida;4;Alt Urgell;25203;Seu d'Urgell, la;1;4;B;;592;135;249;351;241;2;14;335;349
25;Lleida;4;Alt Urgell;25203;Seu d'Urgell, la;1;4;C;;699;197;335;415;284;8;19;388;407
25;Lleida;4;Alt Urgell;25203;Seu d'Urgell, la;1;5;A;;611;132;262;333;278;8;16;309;325
25;Lleida;4;Alt Urgell;25203;Seu d'Urgell, la;1;5;B;;661;166;288;363;298;2;10;351;361
25;Lleida;4;Alt Urgell;25203;Seu d'Urgell, la;1;6;A;;370;86;172;214;156;0;9;205;214
25;Lleida;4;Alt Urgell;25203;Seu d'Urgell, la;1;6;B;;418;103;197;251;167;1;12;238;250
25;Lleida;4;Alt Urgell;25203;Seu d'Urgell, la;1;6;C;;331;75;159;192;139;1;8;183;191
25;Lleida;4;Alt Urgell;25203;Seu d'Urgell, la;1;7;A;;778;173;354;451;327;7;19;425;444
25;Lleida;4;Alt Urgell;25203;Seu d'Urgell, la;1;7;B;;831;202;360;459;372;3;17;439;456
8;Barcelona;24;Osona;08269;Seva;1;1;A;;680;209;424;511;169;4;14;493;507
8;Barcelona;24;Osona;08269;Seva;1;1;B;;909;242;539;655;254;9;22;624;646
8;Barcelona;24;Osona;08269;Seva;1;2;A;;443;134;249;293;150;0;10;283;293
8;Barcelona;24;Osona;08269;Seva;1;2;B;;545;174;332;392;153;8;18;366;384
25;Lleida;27;Pla d'Urgell;25205;Sidamon;1;1;U;;568;168;315;388;180;12;21;355;376
17;Girona;34;Selva;17193;Sils;1;1;A;;807;193;397;482;325;6;15;461;476
17;Girona;34;Selva;17193;Sils;1;1;B;;828;207;412;498;330;5;9;484;493
17;Girona;34;Selva;17193;Sils;1;2;A;;499;104;225;282;217;2;11;269;280
17;Girona;34;Selva;17193;Sils;1;2;B;;520;131;255;301;219;0;9;292;301
17;Girona;34;Selva;17193;Sils;1;3;A;;612;127;203;254;358;1;6;247;253
17;Girona;34;Selva;17193;Sils;1;3;B;;561;119;188;231;330;3;8;220;228
8;Barcelona;17;Garraf;08270;Sitges;1;1;A;;448;150;242;287;161;0;10;277;287
8;Barcelona;17;Garraf;08270;Sitges;1;1;B;;522;164;268;325;197;7;7;311;318
8;Barcelona;17;Garraf;08270;Sitges;1;2;A;;468;172;267;310;158;0;8;302;310
8;Barcelona;17;Garraf;08270;Sitges;1;2;B;;683;208;367;439;244;3;10;426;436
8;Barcelona;17;Garraf;08270;Sitges;1;3;A;;745;210;390;490;255;2;3;485;488
8;Barcelona;17;Garraf;08270;Sitges;1;3;B;;969;285;510;633;336;4;11;618;629
8;Barcelona;17;Garraf;08270;Sitges;1;4;A;;666;192;328;401;265;2;12;387;399
8;Barcelona;17;Garraf;08270;Sitges;1;4;B;;722;231;382;460;262;1;14;445;459
8;Barcelona;17;Garraf;08270;Sitges;2;1;A;;656;184;343;419;237;6;15;398;413
8;Barcelona;17;Garraf;08270;Sitges;2;1;B;;815;262;460;530;285;1;17;512;529
8;Barcelona;17;Garraf;08270;Sitges;2;10;A;;533;159;288;348;185;0;10;338;348
8;Barcelona;17;Garraf;08270;Sitges;2;10;B;;629;188;322;392;237;2;12;378;390
8;Barcelona;17;Garraf;08270;Sitges;2;2;A;;652;185;358;431;221;5;14;412;426
8;Barcelona;17;Garraf;08270;Sitges;2;2;B;;683;183;339;412;271;2;14;396;410
8;Barcelona;17;Garraf;08270;Sitges;2;2;C;;633;176;337;409;224;5;16;388;404
8;Barcelona;17;Garraf;08270;Sitges;2;3;A;;561;167;278;349;212;2;6;341;347
8;Barcelona;17;Garraf;08270;Sitges;2;3;B;;744;217;400;469;275;8;17;444;461
8;Barcelona;17;Garraf;08270;Sitges;2;4;A;;623;184;286;342;281;5;14;323;337
8;Barcelona;17;Garraf;08270;Sitges;2;4;B;;764;214;345;418;346;2;11;405;416
8;Barcelona;17;Garraf;08270;Sitges;2;5;A;;392;111;192;235;157;2;7;226;233
8;Barcelona;17;Garraf;08270;Sitges;2;5;B;;525;142;244;317;208;2;9;306;315
8;Barcelona;17;Garraf;08270;Sitges;2;6;A;;550;138;356;362;188;12;5;345;350
8;Barcelona;17;Garraf;08270;Sitges;2;6;B;;633;164;325;403;230;4;13;386;399
8;Barcelona;17;Garraf;08270;Sitges;2;7;U;;605;177;290;351;254;3;6;342;348
8;Barcelona;17;Garraf;08270;Sitges;2;8;U;;559;147;296;356;203;1;3;352;355
8;Barcelona;17;Garraf;08270;Sitges;2;9;A;;218;62;115;154;64;1;5;148;153
8;Barcelona;17;Garraf;08270;Sitges;2;9;B;;554;145;289;338;216;0;11;327;338
8;Barcelona;17;Garraf;08270;Sitges;2;9;C;;618;172;332;387;231;0;10;377;387
17;Girona;2;Alt Empordà;17052;Siurana;1;1;U;;140;27;69;86;54;0;6;80;86
8;Barcelona;24;Osona;08271;Sobremunt;1;1;U;;73;14;35;49;24;0;0;49;49
25;Lleida;18;Garrigues;25206;Soleràs, el;1;1;U;;295;58;164;210;85;6;5;199;204
43;Tarragona;16;Conca de Barberà;43147;Solivella;1;1;U;;531;142;287;366;165;6;6;354;360
25;Lleida;35;Solsonès;25207;Solsona;1;1;A;;695;152;340;439;256;1;17;421;438
25;Lleida;35;Solsonès;25207;Solsona;1;1;B;;794;195;413;523;271;9;17;497;514
25;Lleida;35;Solsonès;25207;Solsona;1;2;A;;646;149;306;364;282;6;5;353;358
25;Lleida;35;Solsonès;25207;Solsona;1;2;B;;749;169;366;445;304;4;17;424;441
25;Lleida;35;Solsonès;25207;Solsona;1;3;A;;465;129;239;281;184;0;8;273;281
25;Lleida;35;Solsonès;25207;Solsona;1;3;B;;559;144;259;329;230;5;5;319;324
25;Lleida;35;Solsonès;25207;Solsona;2;1;A;;555;150;305;365;190;3;16;346;362
25;Lleida;35;Solsonès;25207;Solsona;2;1;B;;694;189;379;477;217;2;13;462;475
25;Lleida;35;Solsonès;25207;Solsona;2;2;A;;448;117;248;287;161;4;13;270;283
25;Lleida;35;Solsonès;25207;Solsona;2;2;B;;640;162;333;406;234;3;11;392;403
8;Barcelona;24;Osona;08272;Sora;1;1;U;;155;31;94;113;42;0;2;111;113
25;Lleida;26;Pallars Sobirà;25208;Soriguera;1;1;U;;294;61;137;174;120;1;1;172;173
25;Lleida;26;Pallars Sobirà;25209;Sort;1;1;A;;712;208;374;481;231;2;18;461;479
25;Lleida;26;Pallars Sobirà;25209;Sort;1;1;B;;848;254;477;589;259;6;20;563;583
25;Lleida;33;Segrià;25210;Soses;1;1;U;;1180;277;591;734;446;12;12;710;722
8;Barcelona;3;Alt Penedès;08273;Subirats;1;1;U;;639;176;351;439;200;12;22;405;427
8;Barcelona;3;Alt Penedès;08273;Subirats;1;2;A;;483;137;260;342;141;8;3;331;334
8;Barcelona;3;Alt Penedès;08273;Subirats;1;2;B;;559;118;227;277;282;8;4;265;269
8;Barcelona;3;Alt Penedès;08273;Subirats;1;3;U;;634;175;357;466;168;14;4;448;452
25;Lleida;33;Segrià;25211;Sudanell;1;1;U;;697;139;290;383;314;5;24;354;378
25;Lleida;33;Segrià;25212;Sunyer;1;1;U;;239;69;133;169;70;0;8;161;169
8;Barcelona;7;Bages;08274;Súria;1;1;A;;762;197;414;494;268;6;9;479;488
8;Barcelona;7;Bages;08274;Súria;1;1;B;;766;163;396;479;287;4;12;463;475
8;Barcelona;7;Bages;08274;Súria;1;2;U;;561;142;279;325;236;4;14;307;321
8;Barcelona;7;Bages;08274;Súria;1;3;U;;298;51;116;157;141;3;4;150;154
8;Barcelona;7;Bages;08274;Súria;1;4;A;;705;142;370;397;308;2;7;388;395
8;Barcelona;7;Bages;08274;Súria;1;4;B;;791;174;330;443;348;2;11;430;441
8;Barcelona;7;Bages;08274;Súria;1;5;A;;501;120;280;337;164;1;9;327;336
8;Barcelona;7;Bages;08274;Súria;1;5;B;;521;144;276;346;175;1;12;333;345
17;Girona;34;Selva;17194;Susqueda;1;1;U;;94;30;43;61;33;2;1;58;59
8;Barcelona;41;Vallès Oriental;08276;Tagamanent;1;1;U;;241;74;155;172;69;0;0;172;172
8;Barcelona;7;Bages;08277;Talamanca;1;1;U;;117;30;66;80;37;3;1;76;77
25;Lleida;25;Pallars Jussà;25215;Talarn;1;1;U;;313;80;153;214;99;1;8;205;213
25;Lleida;32;Segarra;25216;Talavera;1;1;U;;253;64;151;185;68;0;5;180;185
17;Girona;10;Baix Empordà;17195;Tallada d'Empordà, la;1;1;U;;322;112;203;227;95;5;9;213;222
8;Barcelona;24;Osona;08278;Taradell;1;1;A;;715;199;421;512;203;4;10;498;508
8;Barcelona;24;Osona;08278;Taradell;1;1;B;;439;107;227;301;138;0;14;287;301
8;Barcelona;24;Osona;08278;Taradell;1;1;C;;605;153;343;409;196;5;10;394;404
8;Barcelona;24;Osona;08278;Taradell;1;1;D;;779;232;469;565;214;3;14;548;562
8;Barcelona;24;Osona;08278;Taradell;1;2;A;;642;196;405;477;165;2;16;459;475
8;Barcelona;24;Osona;08278;Taradell;1;2;B;;604;175;353;413;191;4;15;394;409
8;Barcelona;24;Osona;08278;Taradell;1;2;C;;856;241;493;584;272;4;13;567;580
43;Tarragona;36;Tarragonès;43148;Tarragona;1;1;A;;539;135;251;318;221;2;20;296;316
43;Tarragona;36;Tarragonès;43148;Tarragona;1;1;B;;587;151;280;338;249;4;10;324;334
43;Tarragona;36;Tarragonès;43148;Tarragona;2;1;U;;887;172;357;466;421;10;18;438;456
43;Tarragona;36;Tarragonès;43148;Tarragona;3;1;U;;865;216;414;489;376;3;18;468;486
43;Tarragona;36;Tarragonès;43148;Tarragona;3;2;A;;627;180;366;447;180;4;13;430;443
43;Tarragona;36;Tarragonès;43148;Tarragona;3;2;B;;621;177;357;443;178;2;11;430;441
43;Tarragona;36;Tarragonès;43148;Tarragona;3;3;A;;710;177;413;532;178;3;22;507;529
43;Tarragona;36;Tarragonès;43148;Tarragona;3;3;B;;853;194;449;578;275;4;17;557;574
43;Tarragona;36;Tarragonès;43148;Tarragona;4;1;A;;480;130;233;292;188;4;3;285;288
43;Tarragona;36;Tarragonès;43148;Tarragona;4;1;B;;549;167;287;340;209;1;9;330;339
43;Tarragona;36;Tarragonès;43148;Tarragona;4;10;U;;915;288;489;571;344;6;8;557;565
43;Tarragona;36;Tarragonès;43148;Tarragona;4;12;U;;564;178;306;368;196;1;6;361;367
43;Tarragona;36;Tarragonès;43148;Tarragona;4;13;U;;599;147;256;338;261;4;8;326;334
43;Tarragona;36;Tarragonès;43148;Tarragona;4;14;A;;606;174;318;388;218;2;8;378;386
43;Tarragona;36;Tarragonès;43148;Tarragona;4;14;B;;685;178;350;424;261;1;14;409;423
43;Tarragona;36;Tarragonès;43148;Tarragona;4;15;U;;644;186;357;428;216;1;12;415;427
43;Tarragona;36;Tarragonès;43148;Tarragona;4;16;A;;562;144;310;408;154;4;17;387;404
43;Tarragona;36;Tarragonès;43148;Tarragona;4;16;B;;629;180;360;458;171;7;11;440;451
43;Tarragona;36;Tarragonès;43148;Tarragona;4;2;U;;553;150;288;365;188;4;6;355;361
43;Tarragona;36;Tarragonès;43148;Tarragona;4;3;U;;581;139;267;330;251;2;6;322;328
43;Tarragona;36;Tarragonès;43148;Tarragona;4;4;U;;837;237;430;509;328;5;12;492;504
43;Tarragona;36;Tarragonès;43148;Tarragona;4;5;U;;844;262;419;569;275;5;13;551;564
43;Tarragona;36;Tarragonès;43148;Tarragona;4;6;A;;480;146;249;385;95;2;10;373;383
43;Tarragona;36;Tarragonès;43148;Tarragona;4;6;B;;576;165;270;385;191;2;10;373;383
43;Tarragona;36;Tarragonès;43148;Tarragona;4;7;U;;643;204;359;434;209;2;15;417;432
43;Tarragona;36;Tarragonès;43148;Tarragona;4;8;A;;564;177;308;374;190;0;12;362;374
43;Tarragona;36;Tarragonès;43148;Tarragona;4;8;B;;636;194;349;427;209;5;5;417;422
43;Tarragona;36;Tarragonès;43148;Tarragona;4;9;A;;447;105;228;322;125;0;15;307;322
43;Tarragona;36;Tarragonès;43148;Tarragona;4;9;B;;561;143;303;399;162;1;19;379;398
43;Tarragona;36;Tarragonès;43148;Tarragona;5;1;U;;771;236;429;544;227;6;13;525;538
43;Tarragona;36;Tarragonès;43148;Tarragona;5;2;U;;816;220;428;513;303;3;17;493;510
43;Tarragona;36;Tarragonès;43148;Tarragona;5;3;U;;808;214;383;463;345;2;12;449;461
43;Tarragona;36;Tarragonès;43148;Tarragona;5;4;U;;924;285;455;555;369;5;8;542;550
43;Tarragona;36;Tarragonès;43148;Tarragona;5;5;A;;538;129;240;303;235;1;12;290;302
43;Tarragona;36;Tarragonès;43148;Tarragona;5;5;B;;589;142;281;366;223;4;15;347;362
43;Tarragona;36;Tarragonès;43148;Tarragona;5;6;U;;785;170;300;380;405;1;15;364;379
43;Tarragona;36;Tarragonès;43148;Tarragona;5;7;U;;710;198;343;403;307;2;8;393;401
43;Tarragona;36;Tarragonès;43148;Tarragona;5;8;A;;565;169;284;372;193;2;7;363;370
43;Tarragona;36;Tarragonès;43148;Tarragona;5;8;B;;667;205;334;424;243;0;9;415;424
43;Tarragona;36;Tarragonès;43148;Tarragona;5;9;U;;506;153;297;356;150;1;19;336;355
43;Tarragona;36;Tarragonès;43148;Tarragona;6;1;A;;585;177;317;394;191;2;13;379;392
43;Tarragona;36;Tarragonès;43148;Tarragona;6;1;B;;667;200;360;453;214;6;13;434;447
43;Tarragona;36;Tarragonès;43148;Tarragona;6;10;A;;527;168;258;328;199;0;6;322;328
43;Tarragona;36;Tarragonès;43148;Tarragona;6;10;B;;582;178;292;375;207;0;1;374;375
43;Tarragona;36;Tarragonès;43148;Tarragona;6;11;A;;522;158;268;321;201;0;6;315;321
43;Tarragona;36;Tarragonès;43148;Tarragona;6;11;B;;614;200;341;409;205;4;14;391;405
43;Tarragona;36;Tarragonès;43148;Tarragona;6;12;A;;555;170;321;406;149;7;6;393;399
43;Tarragona;36;Tarragonès;43148;Tarragona;6;12;B;;598;188;332;434;164;6;12;416;428
43;Tarragona;36;Tarragonès;43148;Tarragona;6;13;U;;736;197;377;460;276;9;9;442;451
43;Tarragona;36;Tarragonès;43148;Tarragona;6;14;U;;501;138;255;296;205;0;8;288;296
43;Tarragona;36;Tarragonès;43148;Tarragona;6;15;A;;645;172;275;332;313;1;1;330;331
43;Tarragona;36;Tarragonès;43148;Tarragona;6;15;B;;329;94;167;199;130;0;3;196;199
43;Tarragona;36;Tarragonès;43148;Tarragona;6;16;A;;796;200;419;525;271;0;14;511;525
43;Tarragona;36;Tarragonès;43148;Tarragona;6;16;B;;928;263;509;622;306;0;25;597;622
43;Tarragona;36;Tarragonès;43148;Tarragona;6;2;A;;823;192;396;517;306;2;12;503;515
43;Tarragona;36;Tarragonès;43148;Tarragona;6;2;B;;992;219;487;640;352;1;20;619;639
43;Tarragona;36;Tarragonès;43148;Tarragona;6;3;A;;676;168;298;372;304;4;7;361;368
43;Tarragona;36;Tarragonès;43148;Tarragona;6;3;B;;717;172;305;384;333;2;11;371;382
43;Tarragona;36;Tarragonès;43148;Tarragona;6;4;U;;682;153;297;355;327;3;9;343;352
43;Tarragona;36;Tarragonès;43148;Tarragona;6;5;A;;296;55;105;131;165;4;0;127;127
43;Tarragona;36;Tarragonès;43148;Tarragona;6;5;B;;526;127;240;301;225;1;5;295;300
43;Tarragona;36;Tarragonès;43148;Tarragona;6;6;U;;580;116;219;251;329;0;2;249;251
43;Tarragona;36;Tarragonès;43148;Tarragona;6;8;U;;792;233;463;549;243;0;4;545;549
43;Tarragona;36;Tarragonès;43148;Tarragona;6;9;A;;770;228;399;499;271;2;6;491;497
43;Tarragona;36;Tarragonès;43148;Tarragona;6;9;B;;783;219;392;494;289;2;15;477;492
43;Tarragona;36;Tarragonès;43148;Tarragona;7;1;U;;518;122;211;271;247;4;6;261;267
43;Tarragona;36;Tarragonès;43148;Tarragona;7;10;U;;978;207;347;424;554;1;6;417;423
43;Tarragona;36;Tarragonès;43148;Tarragona;7;11;A;;734;177;308;370;364;1;5;364;369
43;Tarragona;36;Tarragonès;43148;Tarragona;7;11;B;;755;192;335;391;364;9;0;382;382
43;Tarragona;36;Tarragonès;43148;Tarragona;7;12;A;;563;141;263;282;281;1;5;276;281
43;Tarragona;36;Tarragonès;43148;Tarragona;7;12;B;;567;147;232;294;273;1;11;282;293
43;Tarragona;36;Tarragonès;43148;Tarragona;7;13;A;;918;188;453;589;329;3;21;565;586
43;Tarragona;36;Tarragonès;43148;Tarragona;7;13;B;;1017;251;544;684;333;0;26;658;684
43;Tarragona;36;Tarragonès;43148;Tarragona;7;14;U;;760;224;452;538;222;3;22;513;535
43;Tarragona;36;Tarragonès;43148;Tarragona;7;15;A;;513;123;227;289;224;5;3;281;284
43;Tarragona;36;Tarragonès;43148;Tarragona;7;15;B;;608;150;251;320;288;7;7;306;313
43;Tarragona;36;Tarragonès;43148;Tarragona;7;16;A;;569;154;310;385;184;3;11;371;382
43;Tarragona;36;Tarragonès;43148;Tarragona;7;16;B;;567;177;329;404;163;15;2;387;389
43;Tarragona;36;Tarragonès;43148;Tarragona;7;16;C;;600;185;348;422;178;1;16;405;421
43;Tarragona;36;Tarragonès;43148;Tarragona;7;17;A;;652;159;314;404;248;21;3;380;383
43;Tarragona;36;Tarragonès;43148;Tarragona;7;17;B;;657;173;303;409;248;3;16;390;406
43;Tarragona;36;Tarragonès;43148;Tarragona;7;18;A;;606;124;248;318;288;0;10;308;318
43;Tarragona;36;Tarragonès;43148;Tarragona;7;18;B;;718;160;316;393;325;3;10;380;390
43;Tarragona;36;Tarragonès;43148;Tarragona;7;19;A;;492;126;233;302;190;0;5;297;302
43;Tarragona;36;Tarragonès;43148;Tarragona;7;19;B;;594;152;282;359;235;18;1;340;341
43;Tarragona;36;Tarragonès;43148;Tarragona;7;2;A;;639;128;264;343;296;3;14;326;340
43;Tarragona;36;Tarragonès;43148;Tarragona;7;2;B;;736;148;316;413;323;7;17;389;406
43;Tarragona;36;Tarragonès;43148;Tarragona;7;20;A;;765;226;432;534;231;5;18;511;529
43;Tarragona;36;Tarragonès;43148;Tarragona;7;20;B;;917;255;501;632;285;4;26;602;628
43;Tarragona;36;Tarragonès;43148;Tarragona;7;21;A;;648;127;260;348;300;0;10;338;348
43;Tarragona;36;Tarragonès;43148;Tarragona;7;21;B;;720;115;280;361;359;0;14;347;361
43;Tarragona;36;Tarragonès;43148;Tarragona;7;22;A;;452;93;186;222;230;2;8;212;220
43;Tarragona;36;Tarragonès;43148;Tarragona;7;22;B;;586;128;252;316;270;0;8;308;316
43;Tarragona;36;Tarragonès;43148;Tarragona;7;3;A;;608;130;223;264;344;2;3;259;262
43;Tarragona;36;Tarragonès;43148;Tarragona;7;3;B;;675;152;257;301;374;1;8;292;300
43;Tarragona;36;Tarragonès;43148;Tarragona;7;4;A;;709;137;308;391;318;3;11;377;388
43;Tarragona;36;Tarragonès;43148;Tarragona;7;4;B;;719;161;297;395;324;3;16;376;392
43;Tarragona;36;Tarragonès;43148;Tarragona;7;4;C;;720;151;334;417;303;2;15;400;415
43;Tarragona;36;Tarragonès;43148;Tarragona;7;5;U;;653;132;195;227;426;4;6;217;223
43;Tarragona;36;Tarragonès;43148;Tarragona;7;6;U;;845;197;379;456;389;4;15;437;452
43;Tarragona;36;Tarragonès;43148;Tarragona;7;7;A;;937;225;504;602;335;3;22;577;599
43;Tarragona;36;Tarragonès;43148;Tarragona;7;7;B;;266;61;101;134;132;2;0;132;132
43;Tarragona;36;Tarragonès;43148;Tarragona;7;8;A;;791;211;433;533;258;2;21;510;531
43;Tarragona;36;Tarragonès;43148;Tarragona;7;8;B;;997;232;500;644;353;3;31;610;641
43;Tarragona;36;Tarragonès;43148;Tarragona;7;9;U;;514;106;167;196;318;3;5;188;193
43;Tarragona;36;Tarragonès;43148;Tarragona;8;1;A;;564;119;313;255;309;0;3;252;255
43;Tarragona;36;Tarragonès;43148;Tarragona;8;1;B;;588;130;212;253;335;0;7;246;253
43;Tarragona;36;Tarragonès;43148;Tarragona;8;10;U;;790;106;193;243;547;0;3;240;243
43;Tarragona;36;Tarragonès;43148;Tarragona;8;11;U;;945;172;403;508;437;6;9;493;502
43;Tarragona;36;Tarragonès;43148;Tarragona;8;12;U;;551;57;109;144;407;3;4;137;141
43;Tarragona;36;Tarragonès;43148;Tarragona;8;13;U;;707;152;277;342;365;0;4;338;342
43;Tarragona;36;Tarragonès;43148;Tarragona;8;14;U;;528;119;180;224;304;1;1;222;223
43;Tarragona;36;Tarragonès;43148;Tarragona;8;2;U;;888;187;365;414;474;1;12;401;413
43;Tarragona;36;Tarragonès;43148;Tarragona;8;3;A;;604;117;235;280;324;4;6;270;276
43;Tarragona;36;Tarragonès;43148;Tarragona;8;3;B;;660;146;265;319;341;5;6;308;314
43;Tarragona;36;Tarragonès;43148;Tarragona;8;4;U;;859;200;356;436;423;0;5;431;436
43;Tarragona;36;Tarragonès;43148;Tarragona;8;5;U;;925;179;335;417;508;3;15;399;414
43;Tarragona;36;Tarragonès;43148;Tarragona;8;6;A;;609;132;271;327;282;3;9;315;324
43;Tarragona;36;Tarragonès;43148;Tarragona;8;6;B;;703;150;313;381;322;0;8;373;381
43;Tarragona;36;Tarragonès;43148;Tarragona;8;7;A;;575;128;232;277;298;1;5;271;276
43;Tarragona;36;Tarragonès;43148;Tarragona;8;7;B;;629;137;279;324;305;0;10;314;324
43;Tarragona;36;Tarragonès;43148;Tarragona;8;8;U;;894;162;300;373;521;0;8;365;373
43;Tarragona;36;Tarragonès;43148;Tarragona;8;9;A;;875;169;327;434;441;0;14;420;434
43;Tarragona;36;Tarragonès;43148;Tarragona;8;9;B;;1000;201;381;492;508;1;18;473;491
43;Tarragona;36;Tarragonès;43148;Tarragona;9;1;U;;989;182;348;425;564;5;9;411;420
43;Tarragona;36;Tarragonès;43148;Tarragona;9;10;U;;962;167;281;369;593;0;5;364;369
43;Tarragona;36;Tarragonès;43148;Tarragona;9;2;U;;734;141;245;285;449;3;4;278;282
43;Tarragona;36;Tarragonès;43148;Tarragona;9;3;U;;703;135;244;296;407;0;3;293;296
43;Tarragona;36;Tarragonès;43148;Tarragona;9;4;U;;948;176;287;374;574;7;0;367;367
43;Tarragona;36;Tarragonès;43148;Tarragona;9;5;A;;554;133;250;297;257;1;2;294;296
43;Tarragona;36;Tarragonès;43148;Tarragona;9;5;B;;622;130;256;326;296;0;8;318;326
43;Tarragona;36;Tarragonès;43148;Tarragona;9;6;A;;827;177;336;420;407;2;6;412;418
43;Tarragona;36;Tarragonès;43148;Tarragona;9;6;B;;1006;239;401;498;508;5;12;481;493
43;Tarragona;36;Tarragonès;43148;Tarragona;9;7;U;;861;216;405;503;358;3;12;488;500
43;Tarragona;36;Tarragonès;43148;Tarragona;9;8;U;;736;122;224;290;446;0;5;285;290
43;Tarragona;36;Tarragonès;43148;Tarragona;9;9;U;;663;125;224;284;379;3;5;276;281
25;Lleida;38;Urgell;25217;Tàrrega;1;1;A;;562;145;266;326;236;1;13;312;325
25;Lleida;38;Urgell;25217;Tàrrega;1;1;B;;466;99;198;258;208;1;8;249;257
25;Lleida;38;Urgell;25217;Tàrrega;1;1;C;;578;127;238;311;267;4;12;295;307
25;Lleida;38;Urgell;25217;Tàrrega;1;2;U;;552;146;274;327;225;1;19;307;326
25;Lleida;38;Urgell;25217;Tàrrega;2;1;A;;518;120;253;307;211;2;19;286;305
25;Lleida;38;Urgell;25217;Tàrrega;2;1;B;;610;150;311;391;219;5;21;365;386
25;Lleida;38;Urgell;25217;Tàrrega;2;2;A;;662;162;333;428;234;2;22;404;426
25;Lleida;38;Urgell;25217;Tàrrega;2;2;B;;814;182;393;521;293;5;27;489;516
25;Lleida;38;Urgell;25217;Tàrrega;2;3;A;;515;123;236;305;210;3;13;289;302
25;Lleida;38;Urgell;25217;Tàrrega;2;3;B;;581;127;292;367;214;17;4;346;350
25;Lleida;38;Urgell;25217;Tàrrega;3;1;A;;464;114;221;274;190;4;20;250;270
25;Lleida;38;Urgell;25217;Tàrrega;3;1;B;;613;133;283;359;254;0;18;341;359
25;Lleida;38;Urgell;25217;Tàrrega;3;2;U;;656;131;304;403;253;2;30;371;401
25;Lleida;38;Urgell;25217;Tàrrega;3;3;A;;474;104;231;298;176;1;15;282;297
25;Lleida;38;Urgell;25217;Tàrrega;3;3;B;;507;107;252;328;179;1;11;316;327
25;Lleida;38;Urgell;25217;Tàrrega;4;1;U;;561;150;258;334;227;2;18;314;332
25;Lleida;38;Urgell;25217;Tàrrega;4;2;A;;504;139;238;318;186;10;13;295;308
25;Lleida;38;Urgell;25217;Tàrrega;4;2;B;;575;124;263;361;214;2;22;337;359
25;Lleida;38;Urgell;25217;Tàrrega;5;1;U;;345;73;167;205;140;3;7;195;202
25;Lleida;18;Garrigues;25218;Tarrés;1;1;U;;97;28;58;68;29;0;0;68;68
25;Lleida;32;Segarra;25219;Tarroja de Segarra;1;1;U;;141;23;69;96;45;0;7;89;96
8;Barcelona;24;Osona;08275;Tavèrnoles;1;1;U;;237;86;156;196;41;1;9;186;195
8;Barcelona;24;Osona;08280;Tavertet;1;1;U;;121;30;60;74;47;0;0;74;74
8;Barcelona;21;Maresme;08281;Teià;1;1;A;;794;206;437;544;250;3;19;522;541
8;Barcelona;21;Maresme;08281;Teià;1;1;B;;882;251;495;625;257;1;23;601;624
8;Barcelona;21;Maresme;08281;Teià;1;2;A;;723;222;404;445;278;1;11;433;444
8;Barcelona;21;Maresme;08281;Teià;1;2;B;;865;217;470;583;282;5;12;566;578
8;Barcelona;21;Maresme;08281;Teià;1;3;A;;671;169;392;479;192;5;18;456;474
8;Barcelona;21;Maresme;08281;Teià;1;3;B;;726;172;400;512;214;1;18;493;511
25;Lleida;23;Noguera;25220;Térmens;1;1;A;;472;101;242;302;170;8;4;290;294
25;Lleida;23;Noguera;25220;Térmens;1;1;B;;592;145;313;399;193;9;4;386;390
17;Girona;2;Alt Empordà;17196;Terrades;1;1;U;;204;53;107;133;71;0;6;127;133
8;Barcelona;40;Vallès Occidental;08279;Terrassa;1;1;A;;477;154;317;391;86;2;8;381;389
8;Barcelona;40;Vallès Occidental;08279;Terrassa;1;1;B;;535;160;343;416;119;1;12;403;415
8;Barcelona;40;Vallès Occidental;08279;Terrassa;1;10;U;;918;240;512;664;254;1;19;644;663
8;Barcelona;40;Vallès Occidental;08279;Terrassa;1;11;U;;926;212;439;557;369;3;27;527;554
8;Barcelona;40;Vallès Occidental;08279;Terrassa;1;12;A;;486;103;236;292;194;2;7;283;290
8;Barcelona;40;Vallès Occidental;08279;Terrassa;1;12;B;;576;130;279;351;225;3;12;336;348
8;Barcelona;40;Vallès Occidental;08279;Terrassa;1;13;U;;624;159;291;369;255;0;12;357;369
8;Barcelona;40;Vallès Occidental;08279;Terrassa;1;14;A;;436;108;202;261;175;0;9;252;261
8;Barcelona;40;Vallès Occidental;08279;Terrassa;1;14;B;;651;176;306;373;278;11;1;361;362
8;Barcelona;40;Vallès Occidental;08279;Terrassa;1;14;C;;502;132;224;272;230;1;5;266;271
8;Barcelona;40;Vallès Occidental;08279;Terrassa;1;15;U;;911;230;478;589;322;4;21;564;585
8;Barcelona;40;Vallès Occidental;08279;Terrassa;1;16;A;;582;129;299;393;189;1;10;382;392
8;Barcelona;40;Vallès Occidental;08279;Terrassa;1;16;B;;586;131;284;380;206;0;12;368;380
8;Barcelona;40;Vallès Occidental;08279;Terrassa;1;16;C;;584;139;323;405;179;4;10;391;401
8;Barcelona;40;Vallès Occidental;08279;Terrassa;1;17;A;;745;200;390;528;217;9;13;506;519
8;Barcelona;40;Vallès Occidental;08279;Terrassa;1;17;B;;897;252;532;664;233;1;21;642;663
8;Barcelona;40;Vallès Occidental;08279;Terrassa;1;18;U;;423;140;242;302;121;3;9;290;299
8;Barcelona;40;Vallès Occidental;08279;Terrassa;1;19;U;;1018;253;564;643;375;10;17;616;633
8;Barcelona;40;Vallès Occidental;08279;Terrassa;1;2;A;;483;133;251;335;148;1;6;328;334
8;Barcelona;40;Vallès Occidental;08279;Terrassa;1;2;B;;621;160;338;434;187;1;10;423;433
8;Barcelona;40;Vallès Occidental;08279;Terrassa;1;20;U;;919;234;537;679;240;0;20;659;679
8;Barcelona;40;Vallès Occidental;08279;Terrassa;1;21;A;;437;112;246;292;145;1;13;278;291
8;Barcelona;40;Vallès Occidental;08279;Terrassa;1;21;B;;591;164;325;389;202;0;12;377;389
8;Barcelona;40;Vallès Occidental;08279;Terrassa;1;22;A;;609;167;319;413;196;2;8;403;411
8;Barcelona;40;Vallès Occidental;08279;Terrassa;1;22;B;;664;184;361;453;211;0;15;438;453
8;Barcelona;40;Vallès Occidental;08279;Terrassa;1;23;U;;910;235;523;672;238;4;27;641;668
8;Barcelona;40;Vallès Occidental;08279;Terrassa;1;24;U;;611;167;344;478;133;2;10;466;476
8;Barcelona;40;Vallès Occidental;08279;Terrassa;1;4;A;;606;150;352;442;164;1;10;431;441
8;Barcelona;40;Vallès Occidental;08279;Terrassa;1;4;B;;685;185;409;507;178;1;18;488;506
8;Barcelona;40;Vallès Occidental;08279;Terrassa;1;5;U;;917;259;546;695;222;4;12;679;691
8;Barcelona;40;Vallès Occidental;08279;Terrassa;1;6;A;;568;154;329;440;128;1;5;434;439
8;Barcelona;40;Vallès Occidental;08279;Terrassa;1;6;B;;613;170;351;448;165;3;8;437;445
8;Barcelona;40;Vallès Occidental;08279;Terrassa;1;7;A;;563;142;325;402;161;2;12;388;400
8;Barcelona;40;Vallès Occidental;08279;Terrassa;1;7;B;;651;165;364;459;192;2;10;447;457
8;Barcelona;40;Vallès Occidental;08279;Terrassa;1;8;A;;795;218;473;590;205;6;7;577;584
8;Barcelona;40;Vallès Occidental;08279;Terrassa;1;8;B;;857;247;543;640;217;4;11;625;636
8;Barcelona;40;Vallès Occidental;08279;Terrassa;1;9;U;;849;219;491;613;236;2;15;596;611
8;Barcelona;40;Vallès Occidental;08279;Terrassa;2;1;A;;463;119;198;257;206;0;11;246;257
8;Barcelona;40;Vallès Occidental;08279;Terrassa;2;1;B;;579;130;251;337;242;3;11;323;334
8;Barcelona;40;Vallès Occidental;08279;Terrassa;2;10;U;;454;103;201;260;194;2;4;254;258
8;Barcelona;40;Vallès Occidental;08279;Terrassa;2;11;U;;853;179;318;422;431;2;7;413;420
8;Barcelona;40;Vallès Occidental;08279;Terrassa;2;12;U;;631;115;240;298;333;2;12;284;296
8;Barcelona;40;Vallès Occidental;08279;Terrassa;2;14;A;;561;100;235;303;258;2;0;301;301
8;Barcelona;40;Vallès Occidental;08279;Terrassa;2;14;B;;801;137;295;386;415;3;14;369;383
8;Barcelona;40;Vallès Occidental;08279;Terrassa;2;15;U;;642;108;216;280;362;3;2;275;277
8;Barcelona;40;Vallès Occidental;08279;Terrassa;2;16;A;;493;96;200;263;230;0;8;255;263
8;Barcelona;40;Vallès Occidental;08279;Terrassa;2;16;B;;623;100;241;316;307;0;10;306;316
8;Barcelona;40;Vallès Occidental;08279;Terrassa;2;17;U;;813;117;300;374;439;1;2;371;373
8;Barcelona;40;Vallès Occidental;08279;Terrassa;2;2;U;;506;117;195;244;262;0;11;233;244
8;Barcelona;40;Vallès Occidental;08279;Terrassa;2;3;U;;501;140;207;247;254;3;5;239;244
8;Barcelona;40;Vallès Occidental;08279;Terrassa;2;4;U;;734;204;345;388;346;3;12;373;385
8;Barcelona;40;Vallès Occidental;08279;Terrassa;2;5;U;;762;172;336;408;354;7;6;395;401
8;Barcelona;40;Vallès Occidental;08279;Terrassa;2;6;U;;691;174;324;406;285;5;13;388;401
8;Barcelona;40;Vallès Occidental;08279;Terrassa;2;7;U;;308;78;129;153;155;0;10;143;153
8;Barcelona;40;Vallès Occidental;08279;Terrassa;2;8;U;;723;153;292;377;346;1;13;363;376
8;Barcelona;40;Vallès Occidental;08279;Terrassa;2;9;U;;560;119;250;290;270;0;5;285;290
8;Barcelona;40;Vallès Occidental;08279;Terrassa;3;1;A;;608;140;293;360;248;3;8;349;357
8;Barcelona;40;Vallès Occidental;08279;Terrassa;3;1;B;;716;151;333;431;285;1;6;424;430
8;Barcelona;40;Vallès Occidental;08279;Terrassa;3;10;A;;684;116;247;365;319;1;7;357;364
8;Barcelona;40;Vallès Occidental;08279;Terrassa;3;10;B;;861;132;277;300;561;1;6;293;299
8;Barcelona;40;Vallès Occidental;08279;Terrassa;3;11;A;;455;46;147;188;267;2;2;184;186
8;Barcelona;40;Vallès Occidental;08279;Terrassa;3;11;B;;649;82;181;245;404;0;8;237;245
8;Barcelona;40;Vallès Occidental;08279;Terrassa;3;12;A;;743;164;312;394;349;3;11;380;391
8;Barcelona;40;Vallès Occidental;08279;Terrassa;3;12;B;;958;191;406;521;437;2;13;506;519
8;Barcelona;40;Vallès Occidental;08279;Terrassa;3;13;U;;401;98;173;203;198;0;6;197;203
8;Barcelona;40;Vallès Occidental;08279;Terrassa;3;14;A;;493;110;196;255;238;2;11;242;253
8;Barcelona;40;Vallès Occidental;08279;Terrassa;3;14;B;;606;110;238;309;297;2;14;293;307
8;Barcelona;40;Vallès Occidental;08279;Terrassa;3;15;U;;844;183;386;491;353;1;12;478;490
8;Barcelona;40;Vallès Occidental;08279;Terrassa;3;16;U;;596;142;284;344;252;1;11;332;343
8;Barcelona;40;Vallès Occidental;08279;Terrassa;3;17;A;;379;94;160;204;175;4;6;194;200
8;Barcelona;40;Vallès Occidental;08279;Terrassa;3;17;B;;478;86;180;227;251;1;5;221;226
8;Barcelona;40;Vallès Occidental;08279;Terrassa;3;18;A;;371;85;156;201;170;0;6;195;201
8;Barcelona;40;Vallès Occidental;08279;Terrassa;3;18;B;;395;91;146;217;178;2;6;209;215
8;Barcelona;40;Vallès Occidental;08279;Terrassa;3;19;A;;414;100;173;219;195;1;5;213;218
8;Barcelona;40;Vallès Occidental;08279;Terrassa;3;19;B;;518;142;238;280;238;0;8;272;280
8;Barcelona;40;Vallès Occidental;08279;Terrassa;3;2;A;;433;146;209;269;164;0;6;263;269
8;Barcelona;40;Vallès Occidental;08279;Terrassa;3;2;B;;540;146;282;356;184;1;12;343;355
8;Barcelona;40;Vallès Occidental;08279;Terrassa;3;20;A;;532;127;227;288;244;0;10;278;288
8;Barcelona;40;Vallès Occidental;08279;Terrassa;3;20;B;;662;153;289;371;291;1;22;348;370
8;Barcelona;40;Vallès Occidental;08279;Terrassa;3;3;A;;541;106;216;289;252;0;7;282;289
8;Barcelona;40;Vallès Occidental;08279;Terrassa;3;3;B;;614;129;251;313;301;8;2;303;305
8;Barcelona;40;Vallès Occidental;08279;Terrassa;3;4;U;;911;181;358;447;464;3;13;431;444
8;Barcelona;40;Vallès Occidental;08279;Terrassa;3;5;A;;618;144;280;370;248;0;13;357;370
8;Barcelona;40;Vallès Occidental;08279;Terrassa;3;5;B;;745;180;359;437;308;0;16;421;437
8;Barcelona;40;Vallès Occidental;08279;Terrassa;3;6;A;;638;137;322;405;233;2;18;385;403
8;Barcelona;40;Vallès Occidental;08279;Terrassa;3;6;B;;749;165;386;479;270;2;17;460;477
8;Barcelona;40;Vallès Occidental;08279;Terrassa;3;7;A;;676;170;349;452;224;5;10;437;447
8;Barcelona;40;Vallès Occidental;08279;Terrassa;3;7;B;;819;200;380;500;319;2;11;487;498
8;Barcelona;40;Vallès Occidental;08279;Terrassa;3;8;A;;513;100;202;231;282;1;3;227;230
8;Barcelona;40;Vallès Occidental;08279;Terrassa;3;8;B;;697;151;265;316;381;3;2;311;313
8;Barcelona;40;Vallès Occidental;08279;Terrassa;3;9;A;;814;181;358;479;335;1;23;455;478
8;Barcelona;40;Vallès Occidental;08279;Terrassa;3;9;B;;968;236;468;586;382;2;20;564;584
8;Barcelona;40;Vallès Occidental;08279;Terrassa;4;1;A;;496;143;291;360;136;1;15;344;359
8;Barcelona;40;Vallès Occidental;08279;Terrassa;4;1;B;;529;160;311;367;162;2;8;357;365
8;Barcelona;40;Vallès Occidental;08279;Terrassa;4;10;U;;456;181;203;237;219;3;3;231;234
8;Barcelona;40;Vallès Occidental;08279;Terrassa;4;11;U;;569;139;240;289;280;1;12;276;288
8;Barcelona;40;Vallès Occidental;08279;Terrassa;4;12;A;;451;101;212;275;176;2;7;266;273
8;Barcelona;40;Vallès Occidental;08279;Terrassa;4;12;B;;512;113;244;317;195;4;9;304;313
8;Barcelona;40;Vallès Occidental;08279;Terrassa;4;13;A;;574;158;295;378;196;2;13;363;376
8;Barcelona;40;Vallès Occidental;08279;Terrassa;4;13;B;;623;156;314;402;221;0;8;394;402
8;Barcelona;40;Vallès Occidental;08279;Terrassa;4;14;A;;451;139;263;336;115;1;8;327;335
8;Barcelona;40;Vallès Occidental;08279;Terrassa;4;14;B;;501;163;300;375;126;1;9;365;374
8;Barcelona;40;Vallès Occidental;08279;Terrassa;4;15;U;;824;204;466;596;228;0;13;583;596
8;Barcelona;40;Vallès Occidental;08279;Terrassa;4;16;A;;417;134;247;315;102;2;8;305;313
8;Barcelona;40;Vallès Occidental;08279;Terrassa;4;16;B;;497;147;279;372;125;3;6;363;369
8;Barcelona;40;Vallès Occidental;08279;Terrassa;4;17;A;;504;153;296;382;122;4;10;368;378
8;Barcelona;40;Vallès Occidental;08279;Terrassa;4;17;B;;528;169;310;384;144;1;15;368;383
8;Barcelona;40;Vallès Occidental;08279;Terrassa;4;18;A;;713;206;379;486;227;4;24;458;482
8;Barcelona;40;Vallès Occidental;08279;Terrassa;4;18;B;;850;250;461;563;287;2;18;543;561
8;Barcelona;40;Vallès Occidental;08279;Terrassa;4;19;A;;428;108;205;248;180;0;10;238;248
8;Barcelona;40;Vallès Occidental;08279;Terrassa;4;19;B;;479;131;208;268;211;4;15;249;264
8;Barcelona;40;Vallès Occidental;08279;Terrassa;4;2;A;;523;141;287;359;164;1;5;353;358
8;Barcelona;40;Vallès Occidental;08279;Terrassa;4;2;B;;592;141;302;388;204;1;9;378;387
8;Barcelona;40;Vallès Occidental;08279;Terrassa;4;20;U;;527;117;191;249;278;6;4;239;243
8;Barcelona;40;Vallès Occidental;08279;Terrassa;4;21;U;;780;186;330;426;354;9;2;415;417
8;Barcelona;40;Vallès Occidental;08279;Terrassa;4;22;A;;725;120;274;390;335;1;9;380;389
8;Barcelona;40;Vallès Occidental;08279;Terrassa;4;22;B;;863;166;342;468;395;2;4;462;466
8;Barcelona;40;Vallès Occidental;08279;Terrassa;4;23;A;;658;141;293;389;269;0;15;374;389
8;Barcelona;40;Vallès Occidental;08279;Terrassa;4;23;B;;868;189;393;491;377;5;13;473;486
8;Barcelona;40;Vallès Occidental;08279;Terrassa;4;24;A;;631;121;265;331;300;0;9;322;331
8;Barcelona;40;Vallès Occidental;08279;Terrassa;4;24;B;;779;165;306;374;405;0;0;374;374
8;Barcelona;40;Vallès Occidental;08279;Terrassa;4;25;A;;418;100;193;251;167;1;15;235;250
8;Barcelona;40;Vallès Occidental;08279;Terrassa;4;25;B;;502;128;221;301;201;2;7;292;299
8;Barcelona;40;Vallès Occidental;08279;Terrassa;4;26;A;;499;155;277;347;152;0;5;342;347
8;Barcelona;40;Vallès Occidental;08279;Terrassa;4;26;B;;514;176;308;377;137;1;6;370;376
8;Barcelona;40;Vallès Occidental;08279;Terrassa;4;3;A;;520;149;285;357;163;2;4;351;355
8;Barcelona;40;Vallès Occidental;08279;Terrassa;4;3;B;;684;178;361;452;232;1;15;436;451
8;Barcelona;40;Vallès Occidental;08279;Terrassa;4;4;A;;546;126;281;352;194;13;10;329;339
8;Barcelona;40;Vallès Occidental;08279;Terrassa;4;4;B;;551;132;274;359;192;3;12;344;356
8;Barcelona;40;Vallès Occidental;08279;Terrassa;4;5;A;;550;133;239;313;237;0;12;301;313
8;Barcelona;40;Vallès Occidental;08279;Terrassa;4;5;B;;596;131;265;333;263;2;15;316;331
8;Barcelona;40;Vallès Occidental;08279;Terrassa;4;6;A;;550;125;260;325;225;2;11;312;323
8;Barcelona;40;Vallès Occidental;08279;Terrassa;4;6;B;;801;195;371;479;322;3;16;460;476
8;Barcelona;40;Vallès Occidental;08279;Terrassa;4;7;A;;807;141;322;412;395;5;10;397;407
8;Barcelona;40;Vallès Occidental;08279;Terrassa;4;7;B;;926;188;374;481;445;2;16;463;479
8;Barcelona;40;Vallès Occidental;08279;Terrassa;4;8;U;;837;193;373;492;345;9;15;468;483
8;Barcelona;40;Vallès Occidental;08279;Terrassa;4;9;U;;757;116;293;372;385;1;7;364;371
8;Barcelona;40;Vallès Occidental;08279;Terrassa;5;1;A;;635;147;304;384;251;2;15;367;382
8;Barcelona;40;Vallès Occidental;08279;Terrassa;5;1;B;;789;163;369;474;315;0;21;453;474
8;Barcelona;40;Vallès Occidental;08279;Terrassa;5;10;A;;682;169;298;369;313;9;2;358;360
8;Barcelona;40;Vallès Occidental;08279;Terrassa;5;10;B;;779;175;323;415;364;0;10;405;415
8;Barcelona;40;Vallès Occidental;08279;Terrassa;5;11;A;;651;128;315;412;239;1;15;396;411
8;Barcelona;40;Vallès Occidental;08279;Terrassa;5;11;B;;756;174;377;482;274;0;17;465;482
8;Barcelona;40;Vallès Occidental;08279;Terrassa;5;12;U;;592;110;269;330;262;0;8;322;330
8;Barcelona;40;Vallès Occidental;08279;Terrassa;5;13;A;;441;80;155;214;227;0;4;210;214
8;Barcelona;40;Vallès Occidental;08279;Terrassa;5;13;B;;567;102;204;279;288;1;11;267;278
8;Barcelona;40;Vallès Occidental;08279;Terrassa;5;14;A;;438;82;186;241;197;2;5;234;239
8;Barcelona;40;Vallès Occidental;08279;Terrassa;5;14;B;;619;147;311;390;229;3;15;372;387
8;Barcelona;40;Vallès Occidental;08279;Terrassa;5;14;C;;516;116;254;316;200;1;16;299;315
8;Barcelona;40;Vallès Occidental;08279;Terrassa;5;15;A;;687;116;249;329;358;0;8;321;329
8;Barcelona;40;Vallès Occidental;08279;Terrassa;5;15;B;;833;140;285;378;455;1;10;367;377
8;Barcelona;40;Vallès Occidental;08279;Terrassa;5;16;A;;524;113;214;259;265;1;5;253;258
8;Barcelona;40;Vallès Occidental;08279;Terrassa;5;16;B;;662;144;253;326;336;2;9;315;324
8;Barcelona;40;Vallès Occidental;08279;Terrassa;5;16;C;;532;92;188;255;277;4;8;243;251
8;Barcelona;40;Vallès Occidental;08279;Terrassa;5;17;A;;544;123;255;326;218;2;9;315;324
8;Barcelona;40;Vallès Occidental;08279;Terrassa;5;17;B;;717;159;341;427;290;0;18;409;427
8;Barcelona;40;Vallès Occidental;08279;Terrassa;5;18;A;;444;130;230;275;169;1;6;268;274
8;Barcelona;40;Vallès Occidental;08279;Terrassa;5;18;B;;564;172;282;348;216;5;14;329;343
8;Barcelona;40;Vallès Occidental;08279;Terrassa;5;19;U;;765;106;298;407;358;2;15;390;405
8;Barcelona;40;Vallès Occidental;08279;Terrassa;5;2;A;;479;97;185;242;237;0;5;237;242
8;Barcelona;40;Vallès Occidental;08279;Terrassa;5;2;B;;649;111;252;324;325;5;5;314;319
8;Barcelona;40;Vallès Occidental;08279;Terrassa;5;20;A;;546;123;254;332;214;0;11;321;332
8;Barcelona;40;Vallès Occidental;08279;Terrassa;5;20;B;;623;148;280;368;255;2;11;355;366
8;Barcelona;40;Vallès Occidental;08279;Terrassa;5;21;A;;594;125;267;349;245;1;9;339;348
8;Barcelona;40;Vallès Occidental;08279;Terrassa;5;21;B;;764;166;361;453;311;1;15;437;452
8;Barcelona;40;Vallès Occidental;08279;Terrassa;5;22;U;;531;129;235;306;225;2;8;296;304
8;Barcelona;40;Vallès Occidental;08279;Terrassa;5;23;A;;573;118;278;382;191;3;5;374;379
8;Barcelona;40;Vallès Occidental;08279;Terrassa;5;23;B;;597;157;324;382;215;3;23;356;379
8;Barcelona;40;Vallès Occidental;08279;Terrassa;5;24;A;;476;151;236;308;168;0;10;298;308
8;Barcelona;40;Vallès Occidental;08279;Terrassa;5;24;B;;611;149;271;355;256;0;9;346;355
8;Barcelona;40;Vallès Occidental;08279;Terrassa;5;25;U;;856;194;393;508;348;4;12;492;504
8;Barcelona;40;Vallès Occidental;08279;Terrassa;5;26;A;;475;119;269;342;133;5;12;325;337
8;Barcelona;40;Vallès Occidental;08279;Terrassa;5;26;B;;526;119;274;373;153;1;20;352;372
8;Barcelona;40;Vallès Occidental;08279;Terrassa;5;27;U;;923;265;509;636;287;2;28;606;634
8;Barcelona;40;Vallès Occidental;08279;Terrassa;5;28;U;;872;233;465;567;305;4;21;542;563
8;Barcelona;40;Vallès Occidental;08279;Terrassa;5;29;U;;849;194;416;539;310;4;9;526;535
8;Barcelona;40;Vallès Occidental;08279;Terrassa;5;3;A;;609;150;290;367;242;3;9;355;364
8;Barcelona;40;Vallès Occidental;08279;Terrassa;5;3;B;;772;207;396;482;290;3;12;467;479
8;Barcelona;40;Vallès Occidental;08279;Terrassa;5;4;A;;501;120;246;309;192;2;10;297;307
8;Barcelona;40;Vallès Occidental;08279;Terrassa;5;4;B;;602;175;332;414;188;1;14;399;413
8;Barcelona;40;Vallès Occidental;08279;Terrassa;5;5;U;;766;204;419;492;274;2;15;475;490
8;Barcelona;40;Vallès Occidental;08279;Terrassa;5;6;A;;744;188;392;523;221;3;21;499;520
8;Barcelona;40;Vallès Occidental;08279;Terrassa;5;6;B;;827;208;452;555;272;4;16;535;551
8;Barcelona;40;Vallès Occidental;08279;Terrassa;5;7;U;;848;222;470;600;248;1;20;579;599
8;Barcelona;40;Vallès Occidental;08279;Terrassa;5;8;A;;655;148;330;421;234;6;15;400;415
8;Barcelona;40;Vallès Occidental;08279;Terrassa;5;8;B;;728;153;345;438;290;1;18;419;437
8;Barcelona;40;Vallès Occidental;08279;Terrassa;5;9;A;;624;171;330;406;218;1;16;389;405
8;Barcelona;40;Vallès Occidental;08279;Terrassa;5;9;B;;692;162;354;443;249;1;8;434;442
8;Barcelona;40;Vallès Occidental;08279;Terrassa;6;1;U;;843;222;418;481;362;1;8;472;480
8;Barcelona;40;Vallès Occidental;08279;Terrassa;6;10;A;;647;134;288;378;269;2;5;371;376
8;Barcelona;40;Vallès Occidental;08279;Terrassa;6;10;B;;876;207;412;540;336;3;17;520;537
8;Barcelona;40;Vallès Occidental;08279;Terrassa;6;11;A;;596;104;208;260;336;7;2;251;253
8;Barcelona;40;Vallès Occidental;08279;Terrassa;6;11;B;;732;152;260;340;392;4;4;332;336
8;Barcelona;40;Vallès Occidental;08279;Terrassa;6;12;A;;421;81;156;201;220;0;7;194;201
8;Barcelona;40;Vallès Occidental;08279;Terrassa;6;12;B;;564;127;232;289;275;2;15;272;287
8;Barcelona;40;Vallès Occidental;08279;Terrassa;6;13;U;;675;155;330;389;286;1;20;368;388
8;Barcelona;40;Vallès Occidental;08279;Terrassa;6;14;U;;685;154;281;331;354;1;9;321;330
8;Barcelona;40;Vallès Occidental;08279;Terrassa;6;16;A;;496;96;185;227;269;0;7;220;227
8;Barcelona;40;Vallès Occidental;08279;Terrassa;6;16;B;;649;107;219;273;376;0;12;261;273
8;Barcelona;40;Vallès Occidental;08279;Terrassa;6;18;U;;491;123;228;260;231;0;0;260;260
8;Barcelona;40;Vallès Occidental;08279;Terrassa;6;19;U;;452;110;198;240;212;0;9;231;240
8;Barcelona;40;Vallès Occidental;08279;Terrassa;6;2;A;;451;105;202;258;193;2;6;250;256
8;Barcelona;40;Vallès Occidental;08279;Terrassa;6;2;B;;641;158;280;348;293;1;5;342;347
8;Barcelona;40;Vallès Occidental;08279;Terrassa;6;20;U;;454;84;172;208;246;0;4;204;208
8;Barcelona;40;Vallès Occidental;08279;Terrassa;6;21;U;;690;150;247;303;387;1;5;297;302
8;Barcelona;40;Vallès Occidental;08279;Terrassa;6;23;A;;407;85;143;198;209;0;7;191;198
8;Barcelona;40;Vallès Occidental;08279;Terrassa;6;23;B;;525;110;208;262;263;0;10;252;262
8;Barcelona;40;Vallès Occidental;08279;Terrassa;6;24;A;;498;96;201;255;243;0;10;245;255
8;Barcelona;40;Vallès Occidental;08279;Terrassa;6;24;B;;747;121;283;366;381;1;10;355;365
8;Barcelona;40;Vallès Occidental;08279;Terrassa;6;24;C;;559;91;201;249;310;0;1;248;249
8;Barcelona;40;Vallès Occidental;08279;Terrassa;6;25;A;;598;121;263;311;287;4;1;306;307
8;Barcelona;40;Vallès Occidental;08279;Terrassa;6;25;B;;793;157;318;399;394;8;7;384;391
8;Barcelona;40;Vallès Occidental;08279;Terrassa;6;26;A;;549;107;196;250;299;0;8;242;250
8;Barcelona;40;Vallès Occidental;08279;Terrassa;6;26;B;;695;135;271;333;362;1;6;326;332
8;Barcelona;40;Vallès Occidental;08279;Terrassa;6;27;A;;455;8;180;226;229;0;3;223;226
8;Barcelona;40;Vallès Occidental;08279;Terrassa;6;27;B;;526;6;149;204;322;1;2;201;203
8;Barcelona;40;Vallès Occidental;08279;Terrassa;6;28;A;;501;97;210;278;223;0;7;271;278
8;Barcelona;40;Vallès Occidental;08279;Terrassa;6;28;B;;661;112;264;344;317;0;1;343;344
8;Barcelona;40;Vallès Occidental;08279;Terrassa;6;29;U;;769;127;279;346;423;1;26;319;345
8;Barcelona;40;Vallès Occidental;08279;Terrassa;6;3;A;;616;145;283;341;275;3;6;332;338
8;Barcelona;40;Vallès Occidental;08279;Terrassa;6;3;B;;822;176;340;414;408;8;3;403;406
8;Barcelona;40;Vallès Occidental;08279;Terrassa;6;30;U;;551;95;193;259;292;0;10;249;259
8;Barcelona;40;Vallès Occidental;08279;Terrassa;6;31;U;;774;102;226;319;455;2;5;312;317
8;Barcelona;40;Vallès Occidental;08279;Terrassa;6;32;U;;533;88;188;235;298;0;6;229;235
8;Barcelona;40;Vallès Occidental;08279;Terrassa;6;33;A;;406;93;175;234;172;0;12;222;234
8;Barcelona;40;Vallès Occidental;08279;Terrassa;6;33;B;;555;138;248;320;235;0;14;306;320
8;Barcelona;40;Vallès Occidental;08279;Terrassa;6;4;A;;406;103;186;227;179;0;6;221;227
8;Barcelona;40;Vallès Occidental;08279;Terrassa;6;4;B;;471;98;190;233;238;0;4;229;233
8;Barcelona;40;Vallès Occidental;08279;Terrassa;6;5;A;;437;96;168;213;224;0;8;205;213
8;Barcelona;40;Vallès Occidental;08279;Terrassa;6;5;B;;602;125;247;310;292;1;7;302;309
8;Barcelona;40;Vallès Occidental;08279;Terrassa;6;6;A;;449;89;170;216;233;1;5;210;215
8;Barcelona;40;Vallès Occidental;08279;Terrassa;6;6;B;;664;116;246;339;325;7;8;324;332
8;Barcelona;40;Vallès Occidental;08279;Terrassa;6;8;A;;674;143;294;388;286;17;0;371;371
8;Barcelona;40;Vallès Occidental;08279;Terrassa;6;8;B;;883;221;414;531;352;6;21;504;525
8;Barcelona;40;Vallès Occidental;08279;Terrassa;6;9;A;;372;75;166;204;168;0;6;198;204
8;Barcelona;40;Vallès Occidental;08279;Terrassa;6;9;B;;470;102;206;251;219;0;8;243;251
8;Barcelona;21;Maresme;08282;Tiana;1;1;A;;761;189;438;537;224;1;17;519;536
8;Barcelona;21;Maresme;08282;Tiana;1;1;B;;781;74;431;539;242;2;17;520;537
8;Barcelona;21;Maresme;08282;Tiana;1;2;A;;370;105;212;247;123;0;7;240;247
8;Barcelona;21;Maresme;08282;Tiana;1;2;B;;305;85;174;216;89;2;7;207;214
8;Barcelona;21;Maresme;08282;Tiana;1;2;C;;467;135;278;336;131;3;12;321;333
8;Barcelona;21;Maresme;08282;Tiana;1;2;D;;412;122;238;286;126;1;12;273;285
8;Barcelona;21;Maresme;08282;Tiana;1;3;A;;430;125;255;299;131;2;11;286;297
8;Barcelona;21;Maresme;08282;Tiana;1;3;B;;538;160;313;367;171;4;12;351;363
8;Barcelona;21;Maresme;08282;Tiana;1;4;A;;595;175;342;432;163;3;17;412;429
8;Barcelona;21;Maresme;08282;Tiana;1;4;B;;670;162;371;472;198;0;26;446;472
8;Barcelona;21;Maresme;08282;Tiana;1;5;U;;651;186;376;459;192;1;14;444;458
25;Lleida;26;Pallars Sobirà;25221;Tírvia;1;1;U;;133;20;54;75;58;0;1;74;75
25;Lleida;23;Noguera;25222;Tiurana;1;1;U;;70;30;48;59;11;0;3;56;59
43;Tarragona;9;Baix Ebre;43149;Tivenys;1;1;U;;716;256;438;546;170;11;11;524;535
43;Tarragona;30;Ribera d'Ebre;43150;Tivissa;1;1;A;;552;174;334;420;132;5;5;410;415
43;Tarragona;30;Ribera d'Ebre;43150;Tivissa;1;1;B;;566;186;350;425;141;2;5;418;423
43;Tarragona;30;Ribera d'Ebre;43150;Tivissa;1;1;C;;222;55;117;151;71;6;4;141;145
8;Barcelona;24;Osona;08283;Tona;1;1;A;;661;172;343;427;234;1;20;406;426
8;Barcelona;24;Osona;08283;Tona;1;1;B;;804;185;380;488;316;7;12;469;481
8;Barcelona;24;Osona;08283;Tona;1;1;C;;529;109;250;335;194;1;5;329;334
8;Barcelona;24;Osona;08283;Tona;1;2;A;;679;161;368;468;211;2;12;454;466
8;Barcelona;24;Osona;08283;Tona;1;2;B;;679;153;361;447;232;6;13;428;441
8;Barcelona;24;Osona;08283;Tona;1;2;C;;509;134;290;350;159;2;12;336;348
8;Barcelona;24;Osona;08283;Tona;1;3;A;;729;166;369;465;264;3;18;444;462
8;Barcelona;24;Osona;08283;Tona;1;3;B;;785;169;365;455;330;0;16;439;455
8;Barcelona;24;Osona;08283;Tona;1;3;C;;485;110;242;303;182;1;13;289;302
25;Lleida;32;Segarra;25223;Torà;1;1;U;;950;218;477;600;350;9;31;560;591
8;Barcelona;21;Maresme;08284;Tordera;1;1;A;;435;119;224;265;170;2;6;257;263
8;Barcelona;21;Maresme;08284;Tordera;1;1;B;;514;113;264;313;201;0;9;304;313
8;Barcelona;21;Maresme;08284;Tordera;1;1;C;;545;134;280;328;217;1;4;323;327
8;Barcelona;21;Maresme;08284;Tordera;1;2;A;;538;106;245;290;248;3;5;282;287
8;Barcelona;21;Maresme;08284;Tordera;1;2;B;;600;116;260;335;265;3;12;320;332
8;Barcelona;21;Maresme;08284;Tordera;1;3;A;;646;90;270;336;310;3;10;323;333
8;Barcelona;21;Maresme;08284;Tordera;1;3;B;;793;134;327;430;363;11;11;408;419
8;Barcelona;21;Maresme;08284;Tordera;1;4;A;;455;75;203;247;208;8;6;233;239
8;Barcelona;21;Maresme;08284;Tordera;1;4;B;;568;104;246;305;263;4;10;291;301
8;Barcelona;21;Maresme;08284;Tordera;1;4;C;;557;117;261;315;242;4;7;304;311
8;Barcelona;21;Maresme;08284;Tordera;2;1;A;;631;129;312;335;296;1;12;322;334
8;Barcelona;21;Maresme;08284;Tordera;2;1;B;;759;144;288;387;372;3;18;366;384
8;Barcelona;21;Maresme;08284;Tordera;2;1;C;;616;127;282;333;283;3;9;321;330
8;Barcelona;21;Maresme;08284;Tordera;2;2;A;;508;94;182;230;278;2;6;222;228
8;Barcelona;21;Maresme;08284;Tordera;2;2;B;;472;81;158;201;271;4;4;193;197
8;Barcelona;21;Maresme;08284;Tordera;2;2;C;;633;120;212;256;377;5;7;244;251
8;Barcelona;21;Maresme;08284;Tordera;2;2;D;;576;128;230;275;301;4;4;267;271
8;Barcelona;21;Maresme;08284;Tordera;2;3;A;;594;121;221;276;318;2;4;270;274
8;Barcelona;21;Maresme;08284;Tordera;2;3;B;;684;153;270;339;345;1;7;331;338
8;Barcelona;21;Maresme;08284;Tordera;2;3;C;;620;158;263;312;308;2;7;303;310
8;Barcelona;24;Osona;08285;Torelló;1;1;A;;339;87;175;211;128;7;5;199;204
8;Barcelona;24;Osona;08285;Torelló;1;1;B;;352;95;172;225;127;3;3;219;222
8;Barcelona;24;Osona;08285;Torelló;1;2;A;;592;180;337;425;167;3;9;413;422
8;Barcelona;24;Osona;08285;Torelló;1;2;B;;577;136;295;371;206;3;3;365;368
8;Barcelona;24;Osona;08285;Torelló;1;2;C;;458;140;253;315;143;1;6;308;314
8;Barcelona;24;Osona;08285;Torelló;1;4;A;;554;148;286;356;198;5;11;340;351
8;Barcelona;24;Osona;08285;Torelló;1;4;B;;572;124;269;335;237;2;14;319;333
8;Barcelona;24;Osona;08285;Torelló;1;4;C;;420;96;211;269;151;1;10;258;268
8;Barcelona;24;Osona;08285;Torelló;2;1;A;;599;168;320;413;186;4;12;397;409
8;Barcelona;24;Osona;08285;Torelló;2;1;B;;606;150;325;414;192;5;9;400;409
8;Barcelona;24;Osona;08285;Torelló;2;2;A;;484;132;265;324;160;0;13;311;324
8;Barcelona;24;Osona;08285;Torelló;2;2;B;;516;154;284;336;180;1;10;325;335
8;Barcelona;24;Osona;08285;Torelló;3;1;A;;607;182;301;368;239;4;13;351;364
8;Barcelona;24;Osona;08285;Torelló;3;1;B;;769;215;411;497;272;4;16;477;493
8;Barcelona;24;Osona;08285;Torelló;3;2;A;;554;155;274;344;210;5;10;329;339
8;Barcelona;24;Osona;08285;Torelló;3;2;B;;636;177;338;403;233;8;8;387;395
8;Barcelona;24;Osona;08285;Torelló;3;3;A;;515;119;260;329;186;6;13;310;323
8;Barcelona;24;Osona;08285;Torelló;3;3;B;;589;157;312;386;203;6;17;363;380
8;Barcelona;24;Osona;08285;Torelló;3;3;C;;441;112;226;291;150;3;6;282;288
25;Lleida;18;Garrigues;25224;Torms, els;1;1;U;;146;22;70;98;48;1;5;92;97
25;Lleida;38;Urgell;25225;Tornabous;1;1;U;;602;152;328;410;192;4;12;394;406
25;Lleida;33;Segrià;25226;Torrebesses;1;1;U;;260;56;120;163;97;1;10;152;162
25;Lleida;25;Pallars Jussà;25227;Torre de Cabdella, la;1;1;U;;688;127;260;404;284;1;13;390;403
8;Barcelona;6;Anoia;08286;Torre de Claramunt, la;1;1;A;;795;204;426;503;292;1;15;487;502
8;Barcelona;6;Anoia;08286;Torre de Claramunt, la;1;1;B;;906;186;424;499;407;5;14;480;494
8;Barcelona;6;Anoia;08286;Torre de Claramunt, la;1;2;A;;525;132;200;243;282;1;9;233;242
8;Barcelona;6;Anoia;08286;Torre de Claramunt, la;1;2;B;;613;162;259;298;315;2;3;293;296
43;Tarragona;29;Priorat;43151;Torre de Fontaubella, la;1;1;U;;118;41;79;92;26;0;1;91;92
43;Tarragona;30;Ribera d'Ebre;43152;Torre de l'Espanyol, la;1;1;U;;471;143;309;365;106;16;12;337;349
43;Tarragona;36;Tarragonès;43153;Torredembarra;1;1;A;;652;151;302;365;287;5;7;353;360
43;Tarragona;36;Tarragonès;43153;Torredembarra;1;1;B;;787;202;371;449;338;4;6;439;445
43;Tarragona;36;Tarragonès;43153;Torredembarra;1;2;U;;849;230;429;476;373;4;7;465;472
43;Tarragona;36;Tarragonès;43153;Torredembarra;1;3;A;;624;152;283;347;277;4;1;342;343
43;Tarragona;36;Tarragonès;43153;Torredembarra;1;3;B;;673;133;256;316;357;1;8;307;315
43;Tarragona;36;Tarragonès;43153;Torredembarra;1;3;C;;775;191;363;439;336;4;8;427;435
43;Tarragona;36;Tarragonès;43153;Torredembarra;1;4;A;;686;206;350;426;260;5;10;411;421
43;Tarragona;36;Tarragonès;43153;Torredembarra;1;4;B;;875;243;448;551;324;6;16;529;545
43;Tarragona;36;Tarragonès;43153;Torredembarra;1;5;A;;499;130;227;275;224;3;5;267;272
43;Tarragona;36;Tarragonès;43153;Torredembarra;1;5;B;;647;145;275;348;299;2;5;341;346
43;Tarragona;36;Tarragonès;43153;Torredembarra;1;6;A;;556;145;245;284;272;2;4;278;282
43;Tarragona;36;Tarragonès;43153;Torredembarra;1;6;B;;645;136;241;303;342;3;9;291;300
43;Tarragona;36;Tarragonès;43153;Torredembarra;1;6;C;;666;160;272;339;327;2;10;327;337
43;Tarragona;36;Tarragonès;43153;Torredembarra;1;7;A;;567;168;268;310;257;3;7;300;307
43;Tarragona;36;Tarragonès;43153;Torredembarra;1;7;B;;723;201;358;431;292;6;10;415;425
25;Lleida;33;Segrià;25228;Torrefarrera;1;1;U;;1205;255;586;750;455;2;32;716;748
25;Lleida;33;Segrià;25228;Torrefarrera;1;2;A;;807;218;453;576;231;3;18;555;573
25;Lleida;33;Segrià;25228;Torrefarrera;1;2;B;;845;229;423;577;268;24;5;548;553
25;Lleida;32;Segarra;25907;Torrefeta i Florejacs;1;1;U;;503;92;255;316;187;0;18;298;316
25;Lleida;27;Pla d'Urgell;25230;Torregrossa;1;1;U;;508;150;317;371;137;2;14;355;369
25;Lleida;27;Pla d'Urgell;25230;Torregrossa;1;2;A;;567;118;288;380;187;1;12;367;379
25;Lleida;27;Pla d'Urgell;25230;Torregrossa;1;2;B;;591;143;300;407;184;5;11;391;402
25;Lleida;23;Noguera;25231;Torrelameu;1;1;U;;523;96;327;411;112;2;4;405;409
8;Barcelona;3;Alt Penedès;08287;Torrelavit;1;1;U;;1062;242;583;735;327;3;20;712;732
8;Barcelona;3;Alt Penedès;08288;Torrelles de Foix;1;1;A;;787;184;335;399;388;2;7;390;397
8;Barcelona;3;Alt Penedès;08288;Torrelles de Foix;1;1;B;;976;228;414;496;480;6;13;477;490
8;Barcelona;11;Baix Llobregat;08289;Torrelles de Llobregat;1;1;A;;418;110;216;278;140;1;10;267;277
8;Barcelona;11;Baix Llobregat;08289;Torrelles de Llobregat;1;1;B;;546;124;275;368;178;5;7;356;363
8;Barcelona;11;Baix Llobregat;08289;Torrelles de Llobregat;1;2;A;;502;118;234;287;215;1;3;283;286
8;Barcelona;11;Baix Llobregat;08289;Torrelles de Llobregat;1;2;B;;512;101;247;314;198;0;6;308;314
8;Barcelona;11;Baix Llobregat;08289;Torrelles de Llobregat;1;3;A;;648;150;314;372;276;1;12;359;371
8;Barcelona;11;Baix Llobregat;08289;Torrelles de Llobregat;1;3;B;;622;139;302;364;258;0;11;353;364
8;Barcelona;11;Baix Llobregat;08289;Torrelles de Llobregat;1;4;A;;333;81;184;227;106;0;4;223;227
8;Barcelona;11;Baix Llobregat;08289;Torrelles de Llobregat;1;4;B;;455;95;245;311;144;2;14;295;309
17;Girona;10;Baix Empordà;17197;Torrent;1;1;U;;146;46;85;100;46;0;3;97;100
25;Lleida;33;Segrià;25232;Torres de Segre;1;1;A;;718;154;342;439;279;2;8;429;437
25;Lleida;33;Segrià;25232;Torres de Segre;1;1;B;;760;151;363;466;294;0;21;445;466
25;Lleida;33;Segrià;25233;Torre-serona;1;1;U;;280;90;174;206;74;1;4;201;205
17;Girona;2;Alt Empordà;17198;Torroella de Fluvià;1;1;U;;400;135;201;243;157;1;9;233;242
17;Girona;10;Baix Empordà;17199;Torroella de Montgrí;1;1;A;;484;124;242;315;169;0;9;306;315
17;Girona;10;Baix Empordà;17199;Torroella de Montgrí;1;1;B;;457;156;237;319;138;3;10;306;316
17;Girona;10;Baix Empordà;17199;Torroella de Montgrí;1;2;A;;619;169;304;381;238;2;13;366;379
17;Girona;10;Baix Empordà;17199;Torroella de Montgrí;1;2;B;;551;136;242;323;228;1;9;313;322
17;Girona;10;Baix Empordà;17199;Torroella de Montgrí;1;3;A;;754;163;325;412;342;2;6;404;410
17;Girona;10;Baix Empordà;17199;Torroella de Montgrí;1;3;B;;686;172;295;372;314;1;8;363;371
17;Girona;10;Baix Empordà;17199;Torroella de Montgrí;1;4;A;;733;195;373;467;266;3;19;445;464
17;Girona;10;Baix Empordà;17199;Torroella de Montgrí;1;4;B;;638;174;317;397;241;2;21;374;395
17;Girona;10;Baix Empordà;17199;Torroella de Montgrí;1;5;U;;704;205;349;432;272;1;13;418;431
17;Girona;10;Baix Empordà;17199;Torroella de Montgrí;1;6;A;;479;124;219;281;198;2;7;272;279
17;Girona;10;Baix Empordà;17199;Torroella de Montgrí;1;6;B;;485;132;225;299;186;4;11;284;295
43;Tarragona;29;Priorat;43154;Torroja del Priorat;1;1;U;;135;37;72;102;33;1;4;97;101
17;Girona;19;Garrotxa;17200;Tortellà;1;1;U;;619;224;370;421;198;5;18;398;416
43;Tarragona;9;Baix Ebre;43155;Tortosa;1;1;U;;749;203;342;415;334;6;15;394;409
43;Tarragona;9;Baix Ebre;43155;Tortosa;1;2;U;;523;150;260;322;201;4;12;306;318
43;Tarragona;9;Baix Ebre;43155;Tortosa;1;3;A;;497;151;257;323;174;2;5;316;321
43;Tarragona;9;Baix Ebre;43155;Tortosa;1;3;B;;414;102;213;265;149;4;4;257;261
43;Tarragona;9;Baix Ebre;43155;Tortosa;1;4;A;;725;237;401;508;217;10;15;483;498
43;Tarragona;9;Baix Ebre;43155;Tortosa;1;4;B;;661;196;354;446;215;4;11;431;442
43;Tarragona;9;Baix Ebre;43155;Tortosa;1;5;U;;654;131;197;238;416;3;3;232;235
43;Tarragona;9;Baix Ebre;43155;Tortosa;1;6;A;;411;105;198;254;157;2;9;243;252
43;Tarragona;9;Baix Ebre;43155;Tortosa;1;6;B;;363;106;197;242;121;6;2;234;236
43;Tarragona;9;Baix Ebre;43155;Tortosa;1;7;A;;777;217;401;518;259;7;21;490;511
43;Tarragona;9;Baix Ebre;43155;Tortosa;1;7;B;;504;138;251;319;185;3;15;301;316
43;Tarragona;9;Baix Ebre;43155;Tortosa;1;7;C;;650;200;346;427;223;2;15;410;425
43;Tarragona;9;Baix Ebre;43155;Tortosa;2;2;A;;723;154;363;470;253;7;18;445;463
43;Tarragona;9;Baix Ebre;43155;Tortosa;2;2;B;;695;148;335;433;262;5;20;408;428
43;Tarragona;9;Baix Ebre;43155;Tortosa;2;3;A;;429;101;214;268;161;8;8;252;260
43;Tarragona;9;Baix Ebre;43155;Tortosa;2;3;B;;295;63;120;161;134;3;2;156;158
43;Tarragona;9;Baix Ebre;43155;Tortosa;2;3;C;;376;83;162;212;164;4;11;197;208
43;Tarragona;9;Baix Ebre;43155;Tortosa;2;4;U;;692;148;282;370;322;5;21;344;365
43;Tarragona;9;Baix Ebre;43155;Tortosa;2;5;A;;469;132;237;313;156;5;13;295;308
43;Tarragona;9;Baix Ebre;43155;Tortosa;2;5;B;;451;131;232;298;153;1;15;282;297
43;Tarragona;9;Baix Ebre;43155;Tortosa;3;1;A;;287;69;113;138;149;1;6;131;137
43;Tarragona;9;Baix Ebre;43155;Tortosa;3;1;B;;249;63;94;106;143;1;4;101;105
43;Tarragona;9;Baix Ebre;43155;Tortosa;3;2;A;;547;166;286;385;162;6;10;369;379
43;Tarragona;9;Baix Ebre;43155;Tortosa;3;2;B;;391;105;198;260;131;2;8;250;258
43;Tarragona;9;Baix Ebre;43155;Tortosa;3;3;A;;485;114;183;246;239;0;9;237;246
43;Tarragona;9;Baix Ebre;43155;Tortosa;3;3;B;;406;90;162;214;192;2;9;203;212
43;Tarragona;9;Baix Ebre;43155;Tortosa;3;4;A;;697;137;299;384;313;8;19;357;376
43;Tarragona;9;Baix Ebre;43155;Tortosa;3;4;B;;604;131;245;320;284;5;7;308;315
43;Tarragona;9;Baix Ebre;43155;Tortosa;4;1;U;;1012;250;471;605;407;7;22;576;598
43;Tarragona;9;Baix Ebre;43155;Tortosa;4;2;A;;374;90;175;214;160;1;4;209;213
43;Tarragona;9;Baix Ebre;43155;Tortosa;4;2;B;;264;61;121;154;110;0;5;149;154
43;Tarragona;9;Baix Ebre;43155;Tortosa;4;2;C;;322;77;151;181;141;0;4;177;181
43;Tarragona;9;Baix Ebre;43155;Tortosa;4;3;A;;553;124;212;259;294;5;14;240;254
43;Tarragona;9;Baix Ebre;43155;Tortosa;4;3;B;;530;109;194;254;276;6;14;234;248
43;Tarragona;9;Baix Ebre;43155;Tortosa;4;4;A;;457;106;197;259;198;0;7;252;259
43;Tarragona;9;Baix Ebre;43155;Tortosa;4;4;B;;416;107;191;233;183;2;5;226;231
43;Tarragona;9;Baix Ebre;43155;Tortosa;4;5;A;;637;148;312;394;243;8;9;377;386
43;Tarragona;9;Baix Ebre;43155;Tortosa;4;5;B;;513;119;263;317;196;5;9;303;312
43;Tarragona;9;Baix Ebre;43155;Tortosa;4;6;U;;731;177;356;433;298;12;12;409;421
43;Tarragona;9;Baix Ebre;43155;Tortosa;4;7;A;;523;146;288;365;158;6;12;347;359
43;Tarragona;9;Baix Ebre;43155;Tortosa;4;7;B;;258;45;112;154;104;5;8;141;149
43;Tarragona;9;Baix Ebre;43155;Tortosa;4;8;U;;630;170;311;399;231;7;8;384;392
43;Tarragona;9;Baix Ebre;43155;Tortosa;4;9;A;;571;148;258;335;236;4;15;316;331
43;Tarragona;9;Baix Ebre;43155;Tortosa;4;9;B;;465;140;239;279;186;3;11;265;276
17;Girona;31;Ripollès;17201;Toses;1;1;U;;132;35;57;87;45;2;2;83;85
17;Girona;34;Selva;17202;Tossa de Mar;1;1;U;;921;255;466;531;390;2;6;523;529
17;Girona;34;Selva;17202;Tossa de Mar;1;2;A;;534;120;266;330;204;2;4;324;328
17;Girona;34;Selva;17202;Tossa de Mar;1;2;B;;567;130;304;329;238;5;1;323;324
17;Girona;34;Selva;17202;Tossa de Mar;1;3;A;;902;238;444;537;365;0;21;516;537
17;Girona;34;Selva;17202;Tossa de Mar;1;3;B;;886;239;468;546;340;8;10;528;538
25;Lleida;25;Pallars Jussà;25234;Tremp;1;1;U;;668;120;328;410;258;2;13;395;408
25;Lleida;25;Pallars Jussà;25234;Tremp;1;2;A;;440;102;202;257;183;2;13;242;255
25;Lleida;25;Pallars Jussà;25234;Tremp;1;2;B;;445;94;222;281;164;2;11;268;279
25;Lleida;25;Pallars Jussà;25234;Tremp;2;1;A;;523;122;251;333;190;4;11;318;329
25;Lleida;25;Pallars Jussà;25234;Tremp;2;1;B;;596;125;301;380;216;5;19;356;375
25;Lleida;25;Pallars Jussà;25234;Tremp;2;2;A;;580;134;286;362;218;6;7;349;356
25;Lleida;25;Pallars Jussà;25234;Tremp;2;2;B;;581;117;274;353;228;3;8;342;350
25;Lleida;25;Pallars Jussà;25234;Tremp;3;1;U;;524;102;200;283;241;5;6;272;278
17;Girona;10;Baix Empordà;17204;Ullà;1;1;U;;549;130;260;324;225;5;10;309;319
8;Barcelona;40;Vallès Occidental;08290;Ullastrell;1;1;A;;642;165;333;429;213;3;8;418;426
8;Barcelona;40;Vallès Occidental;08290;Ullastrell;1;1;B;;759;226;448;554;205;2;7;545;552
17;Girona;10;Baix Empordà;17205;Ullastret;1;1;U;;182;62;123;146;36;4;6;136;142
43;Tarragona;22;Montsià;43156;Ulldecona;1;1;A;;430;125;234;285;145;4;9;272;281
43;Tarragona;22;Montsià;43156;Ulldecona;1;1;B;;485;133;261;334;151;8;8;318;326
43;Tarragona;22;Montsià;43156;Ulldecona;1;2;A;;616;192;325;387;229;7;19;361;380
43;Tarragona;22;Montsià;43156;Ulldecona;1;2;B;;460;126;221;279;181;3;7;269;276
43;Tarragona;22;Montsià;43156;Ulldecona;1;2;C;;639;188;350;415;224;6;16;393;409
43;Tarragona;22;Montsià;43156;Ulldecona;2;1;U;;427;120;227;270;157;0;13;257;270
43;Tarragona;22;Montsià;43156;Ulldecona;2;2;U;;631;146;324;405;226;2;13;390;403
43;Tarragona;22;Montsià;43156;Ulldecona;3;1;U;;496;130;234;286;210;0;9;277;286
43;Tarragona;29;Priorat;43157;Ulldemolins;1;1;U;;401;90;205;294;107;0;6;288;294
17;Girona;10;Baix Empordà;17203;Ultramort;1;1;U;;173;40;81;102;71;2;6;94;100
17;Girona;15;Cerdanya;17206;Urús;1;1;U;;172;46;89;116;56;0;5;111;116
8;Barcelona;40;Vallès Occidental;08291;Vacarisses;1;1;A;;500;146;278;332;168;0;8;324;332
8;Barcelona;40;Vallès Occidental;08291;Vacarisses;1;1;B;;539;157;300;358;181;3;6;349;355
8;Barcelona;40;Vallès Occidental;08291;Vacarisses;1;2;A;;638;165;312;397;241;3;14;380;394
8;Barcelona;40;Vallès Occidental;08291;Vacarisses;1;2;B;;774;193;356;445;329;2;6;437;443
8;Barcelona;40;Vallès Occidental;08291;Vacarisses;1;3;A;;559;157;273;326;233;0;17;309;326
8;Barcelona;40;Vallès Occidental;08291;Vacarisses;1;3;B;;667;160;302;377;290;0;15;362;377
8;Barcelona;40;Vallès Occidental;08291;Vacarisses;1;4;U;;756;163;287;344;412;0;7;337;344
17;Girona;2;Alt Empordà;17014;Vajol, la;1;1;U;;67;21;33;44;23;0;1;43;44
8;Barcelona;6;Anoia;08292;Vallbona d'Anoia;1;1;U;;1070;316;626;730;340;4;16;710;726
25;Lleida;38;Urgell;25238;Vallbona de les Monges;1;1;U;;232;63;132;163;69;1;6;156;162
8;Barcelona;14;Berguedà;08293;Vallcebre;1;1;U;;241;70;123;141;100;2;3;136;139
43;Tarragona;16;Conca de Barberà;43158;Vallclara;1;1;U;;101;24;40;64;37;0;1;63;64
17;Girona;19;Garrotxa;17207;Vall d'en Bas, la;1;1;A;;914;322;631;677;237;2;33;642;675
17;Girona;19;Garrotxa;17207;Vall d'en Bas, la;1;1;B;;230;90;155;188;42;4;2;182;184
17;Girona;19;Garrotxa;17207;Vall d'en Bas, la;1;2;A;;944;300;559;658;286;4;15;639;654
17;Girona;19;Garrotxa;17207;Vall d'en Bas, la;1;2;B;;243;69;138;175;68;2;3;170;173
17;Girona;19;Garrotxa;17208;Vall de Bianya, la;1;1;A;;445;126;245;299;146;5;11;283;294
17;Girona;19;Garrotxa;17208;Vall de Bianya, la;1;1;B;;548;170;298;356;192;9;9;338;347
25;Lleida;5;Alta Ribagorça;25043;Vall de Boí, la;1;1;U;;834;188;368;470;364;4;20;446;466
25;Lleida;26;Pallars Sobirà;25901;Vall de Cardós;1;1;U;;303;51;128;177;126;1;6;170;176
25;Lleida;23;Noguera;25240;Vallfogona de Balaguer;1;1;A;;796;144;491;527;269;3;37;487;524
25;Lleida;23;Noguera;25240;Vallfogona de Balaguer;1;1;B;;219;45;98;130;89;0;7;123;130
25;Lleida;23;Noguera;25240;Vallfogona de Balaguer;1;1;C;;364;81;203;269;95;1;7;261;268
17;Girona;31;Ripollès;17170;Vallfogona de Ripollès;1;1;U;;191;52;113;136;55;2;2;132;134
43;Tarragona;16;Conca de Barberà;43159;Vallfogona de Riucorb;1;1;U;;92;30;50;59;33;2;0;57;57
8;Barcelona;41;Vallès Oriental;08294;Vallgorguina;1;1;A;;1084;321;604;717;367;7;30;680;710
8;Barcelona;41;Vallès Oriental;08294;Vallgorguina;1;1;B;;773;200;341;412;361;1;6;405;411
8;Barcelona;11;Baix Llobregat;08295;Vallirana;1;1;A;;506;141;233;287;219;1;9;277;286
8;Barcelona;11;Baix Llobregat;08295;Vallirana;1;1;B;;498;138;224;275;223;0;8;267;275
8;Barcelona;11;Baix Llobregat;08295;Vallirana;1;1;C;;532;141;260;322;210;2;5;315;320
8;Barcelona;11;Baix Llobregat;08295;Vallirana;1;2;A;;533;170;276;337;196;1;9;327;336
8;Barcelona;11;Baix Llobregat;08295;Vallirana;1;2;B;;566;140;255;327;239;0;9;318;327
8;Barcelona;11;Baix Llobregat;08295;Vallirana;1;2;C;;547;141;263;331;216;2;13;316;329
8;Barcelona;11;Baix Llobregat;08295;Vallirana;1;3;A;;473;112;225;284;189;3;11;270;281
8;Barcelona;11;Baix Llobregat;08295;Vallirana;1;3;B;;424;114;206;254;170;2;5;247;252
8;Barcelona;11;Baix Llobregat;08295;Vallirana;1;3;C;;401;122;211;269;132;0;11;258;269
8;Barcelona;11;Baix Llobregat;08295;Vallirana;1;4;A;;409;100;195;246;163;1;5;240;245
8;Barcelona;11;Baix Llobregat;08295;Vallirana;1;4;B;;336;83;163;201;135;2;4;195;199
8;Barcelona;11;Baix Llobregat;08295;Vallirana;1;5;A;;611;151;250;307;304;1;8;298;306
8;Barcelona;11;Baix Llobregat;08295;Vallirana;1;5;B;;774;171;302;359;415;1;7;351;358
8;Barcelona;11;Baix Llobregat;08295;Vallirana;1;5;C;;639;121;240;293;346;0;9;284;293
8;Barcelona;11;Baix Llobregat;08295;Vallirana;1;6;A;;426;117;181;227;199;2;12;213;225
8;Barcelona;11;Baix Llobregat;08295;Vallirana;1;6;B;;548;118;211;280;268;4;6;270;276
8;Barcelona;11;Baix Llobregat;08295;Vallirana;1;6;C;;449;113;194;247;202;0;12;235;247
8;Barcelona;11;Baix Llobregat;08295;Vallirana;1;7;A;;546;105;208;271;275;1;4;266;270
8;Barcelona;11;Baix Llobregat;08295;Vallirana;1;7;B;;635;133;242;309;326;0;7;302;309
8;Barcelona;11;Baix Llobregat;08295;Vallirana;1;7;C;;584;125;240;306;278;0;8;298;306
17;Girona;10;Baix Empordà;17209;Vall-llobrega;1;1;U;;588;180;353;404;184;1;15;388;403
43;Tarragona;1;Alt Camp;43160;Vallmoll;1;1;A;;554;132;257;319;235;3;12;304;316
43;Tarragona;1;Alt Camp;43160;Vallmoll;1;1;B;;700;175;341;407;293;8;17;382;399
8;Barcelona;41;Vallès Oriental;08296;Vallromanes;1;1;A;;776;227;440;533;243;2;11;520;531
8;Barcelona;41;Vallès Oriental;08296;Vallromanes;1;1;B;;862;342;474;590;272;1;13;576;589
43;Tarragona;1;Alt Camp;43161;Valls;1;1;U;;508;118;218;268;240;2;7;259;266
43;Tarragona;1;Alt Camp;43161;Valls;2;1;U;;591;141;209;264;327;5;2;257;259
43;Tarragona;1;Alt Camp;43161;Valls;3;1;A;;590;141;278;361;229;6;16;339;355
43;Tarragona;1;Alt Camp;43161;Valls;3;1;B;;683;132;253;336;347;3;4;329;333
43;Tarragona;1;Alt Camp;43161;Valls;4;1;A;;397;125;202;257;140;0;7;250;257
43;Tarragona;1;Alt Camp;43161;Valls;4;1;B;;514;139;274;333;181;1;7;325;332
43;Tarragona;1;Alt Camp;43161;Valls;4;2;A;;399;73;152;197;202;3;5;189;194
43;Tarragona;1;Alt Camp;43161;Valls;4;2;B;;569;105;219;279;290;3;15;261;276
43;Tarragona;1;Alt Camp;43161;Valls;4;2;C;;354;90;181;238;116;3;11;224;235
43;Tarragona;1;Alt Camp;43161;Valls;4;3;A;;556;112;230;298;258;1;11;286;297
43;Tarragona;1;Alt Camp;43161;Valls;4;3;B;;620;102;228;304;316;1;17;286;303
43;Tarragona;1;Alt Camp;43161;Valls;5;1;A;;431;139;230;288;143;0;7;281;288
43;Tarragona;1;Alt Camp;43161;Valls;5;1;B;;390;89;159;219;171;0;2;217;219
43;Tarragona;1;Alt Camp;43161;Valls;5;1;C;;505;133;239;311;194;3;7;301;308
43;Tarragona;1;Alt Camp;43161;Valls;5;2;A;;527;126;268;335;192;1;12;322;334
43;Tarragona;1;Alt Camp;43161;Valls;5;2;B;;589;153;279;352;237;3;6;343;349
43;Tarragona;1;Alt Camp;43161;Valls;5;2;C;;639;180;311;400;239;6;14;380;394
43;Tarragona;1;Alt Camp;43161;Valls;5;3;A;;386;69;128;177;209;2;2;173;175
43;Tarragona;1;Alt Camp;43161;Valls;5;3;B;;502;93;176;238;264;0;4;234;238
43;Tarragona;1;Alt Camp;43161;Valls;6;1;A;;534;140;226;298;236;2;7;289;296
43;Tarragona;1;Alt Camp;43161;Valls;6;1;B;;529;123;231;289;240;3;10;276;286
43;Tarragona;1;Alt Camp;43161;Valls;6;1;C;;617;139;274;354;263;4;6;344;350
43;Tarragona;1;Alt Camp;43161;Valls;6;2;A;;751;165;368;468;283;1;16;451;467
43;Tarragona;1;Alt Camp;43161;Valls;6;2;B;;851;169;390;511;340;1;7;503;510
43;Tarragona;1;Alt Camp;43161;Valls;6;3;A;;521;160;309;348;173;3;7;338;345
43;Tarragona;1;Alt Camp;43161;Valls;6;3;B;;614;150;271;387;227;2;9;376;385
43;Tarragona;1;Alt Camp;43161;Valls;6;4;U;;881;205;389;486;395;5;12;469;481
43;Tarragona;1;Alt Camp;43161;Valls;6;5;A;;593;122;238;322;271;4;9;309;318
43;Tarragona;1;Alt Camp;43161;Valls;6;5;B;;676;150;289;366;310;3;8;355;363
43;Tarragona;1;Alt Camp;43161;Valls;6;6;U;;865;148;366;455;410;18;0;437;437
25;Lleida;4;Alt Urgell;25906;Valls d'Aguilar, les;1;1;U;;236;61;120;158;78;1;2;155;157
25;Lleida;4;Alt Urgell;25239;Valls de Valira, les;1;1;U;;563;98;210;279;284;0;9;270;279
43;Tarragona;8;Baix Camp;43162;Vandellòs i l'Hospitalet de l'Infant;1;1;A;;486;32;286;350;136;5;8;337;345
43;Tarragona;8;Baix Camp;43162;Vandellòs i l'Hospitalet de l'Infant;1;1;B;;382;99;215;257;125;1;4;252;256
43;Tarragona;8;Baix Camp;43162;Vandellòs i l'Hospitalet de l'Infant;1;2;A;;442;115;223;266;176;3;9;254;263
43;Tarragona;8;Baix Camp;43162;Vandellòs i l'Hospitalet de l'Infant;1;2;B;;464;117;218;269;195;1;10;258;268
43;Tarragona;8;Baix Camp;43162;Vandellòs i l'Hospitalet de l'Infant;1;2;C;;444;97;189;240;204;3;9;228;237
43;Tarragona;8;Baix Camp;43162;Vandellòs i l'Hospitalet de l'Infant;1;3;A;;670;140;308;388;282;3;17;368;385
43;Tarragona;8;Baix Camp;43162;Vandellòs i l'Hospitalet de l'Infant;1;3;B;;687;129;304;379;308;3;7;369;376
43;Tarragona;8;Baix Camp;43162;Vandellòs i l'Hospitalet de l'Infant;1;4;U;;505;106;220;273;232;1;6;266;272
25;Lleida;4;Alt Urgell;25909;Vansa i Fórnols, la;1;1;U;;149;24;64;92;57;0;1;91;92
8;Barcelona;6;Anoia;08297;Veciana;1;1;U;;142;42;77;99;43;0;1;98;99
43;Tarragona;12;Baix Penedès;43163;Vendrell, el;1;1;U;;940;256;484;568;372;2;23;543;566
43;Tarragona;12;Baix Penedès;43163;Vendrell, el;1;2;U;;888;224;404;502;386;1;11;490;501
43;Tarragona;12;Baix Penedès;43163;Vendrell, el;1;3;A;;571;160;250;316;255;0;0;316;316
43;Tarragona;12;Baix Penedès;43163;Vendrell, el;1;3;B;;608;147;277;338;270;0;13;325;338
43;Tarragona;12;Baix Penedès;43163;Vendrell, el;2;1;U;;748;198;356;409;339;3;11;395;406
43;Tarragona;12;Baix Penedès;43163;Vendrell, el;2;2;A;;602;146;257;298;304;2;10;286;296
43;Tarragona;12;Baix Penedès;43163;Vendrell, el;2;2;B;;766;192;332;397;369;2;10;385;395
43;Tarragona;12;Baix Penedès;43163;Vendrell, el;2;3;A;;795;188;323;394;401;0;4;390;394
43;Tarragona;12;Baix Penedès;43163;Vendrell, el;2;3;B;;910;197;357;427;483;1;2;424;426
43;Tarragona;12;Baix Penedès;43163;Vendrell, el;2;4;A;;701;152;250;310;391;0;6;304;310
43;Tarragona;12;Baix Penedès;43163;Vendrell, el;2;4;B;;842;168;323;400;442;2;12;386;398
43;Tarragona;12;Baix Penedès;43163;Vendrell, el;2;5;A;;860;214;339;417;443;5;5;407;412
43;Tarragona;12;Baix Penedès;43163;Vendrell, el;2;5;B;;1020;253;411;474;546;3;12;459;471
43;Tarragona;12;Baix Penedès;43163;Vendrell, el;3;1;A;;512;109;221;287;225;5;13;269;282
43;Tarragona;12;Baix Penedès;43163;Vendrell, el;3;1;B;;624;181;311;373;251;6;10;357;367
43;Tarragona;12;Baix Penedès;43163;Vendrell, el;3;10;U;;630;153;308;393;237;0;6;387;393
43;Tarragona;12;Baix Penedès;43163;Vendrell, el;3;2;A;;617;120;228;297;320;0;6;291;297
43;Tarragona;12;Baix Penedès;43163;Vendrell, el;3;2;B;;678;153;271;350;328;5;5;340;345
43;Tarragona;12;Baix Penedès;43163;Vendrell, el;3;3;A;;653;168;273;324;329;4;8;312;320
43;Tarragona;12;Baix Penedès;43163;Vendrell, el;3;3;B;;639;170;245;307;332;0;11;296;307
43;Tarragona;12;Baix Penedès;43163;Vendrell, el;3;3;C;;754;188;323;390;364;4;9;377;386
43;Tarragona;12;Baix Penedès;43163;Vendrell, el;3;4;A;;612;144;263;339;273;4;12;323;335
43;Tarragona;12;Baix Penedès;43163;Vendrell, el;3;4;B;;686;183;314;391;295;2;4;385;389
43;Tarragona;12;Baix Penedès;43163;Vendrell, el;3;4;C;;763;194;336;428;335;5;9;414;423
43;Tarragona;12;Baix Penedès;43163;Vendrell, el;3;5;U;;906;207;381;496;410;7;18;471;489
43;Tarragona;12;Baix Penedès;43163;Vendrell, el;3;6;A;;666;173;333;386;280;6;6;374;380
43;Tarragona;12;Baix Penedès;43163;Vendrell, el;3;6;B;;787;174;360;432;355;4;16;412;428
43;Tarragona;12;Baix Penedès;43163;Vendrell, el;3;7;A;;655;172;285;327;328;2;7;318;325
43;Tarragona;12;Baix Penedès;43163;Vendrell, el;3;7;B;;768;195;300;356;412;6;14;336;350
43;Tarragona;12;Baix Penedès;43163;Vendrell, el;3;7;C;;743;192;314;359;384;1;6;352;358
43;Tarragona;12;Baix Penedès;43163;Vendrell, el;3;8;A;;666;150;256;327;339;8;0;319;319
43;Tarragona;12;Baix Penedès;43163;Vendrell, el;3;8;B;;881;207;370;439;442;9;7;423;430
43;Tarragona;12;Baix Penedès;43163;Vendrell, el;3;9;A;;587;140;244;295;292;0;7;288;295
43;Tarragona;12;Baix Penedès;43163;Vendrell, el;3;9;B;;640;163;288;345;295;3;6;336;342
17;Girona;2;Alt Empordà;17210;Ventalló;1;1;U;;530;157;299;348;182;2;9;337;346
25;Lleida;38;Urgell;25242;Verdú;1;1;U;;786;191;391;505;281;2;13;490;503
17;Girona;10;Baix Empordà;17211;Verges;1;1;U;;874;262;562;586;288;17;18;551;569
43;Tarragona;36;Tarragonès;43164;Vespella de Gaià;1;1;U;;299;85;136;182;117;2;1;179;180
8;Barcelona;24;Osona;08298;Vic;1;1;U;;377;135;223;270;107;3;8;259;267
8;Barcelona;24;Osona;08298;Vic;1;2;U;;481;125;255;315;166;5;6;304;310
8;Barcelona;24;Osona;08298;Vic;1;3;U;;487;171;297;366;121;2;11;353;364
8;Barcelona;24;Osona;08298;Vic;2;1;U;;573;180;334;403;170;3;10;390;400
8;Barcelona;24;Osona;08298;Vic;2;2;A;;535;150;308;378;157;3;11;364;375
8;Barcelona;24;Osona;08298;Vic;2;2;B;;401;111;215;281;120;2;8;271;279
8;Barcelona;24;Osona;08298;Vic;2;2;C;;522;147;310;389;133;0;9;380;389
8;Barcelona;24;Osona;08298;Vic;2;3;A;;638;215;395;465;173;3;14;448;462
8;Barcelona;24;Osona;08298;Vic;2;3;B;;717;259;470;536;181;2;17;517;534
8;Barcelona;24;Osona;08298;Vic;2;4;A;;551;153;311;369;182;4;7;358;365
8;Barcelona;24;Osona;08298;Vic;2;4;B;;598;201;369;422;176;3;9;410;419
8;Barcelona;24;Osona;08298;Vic;2;5;A;;614;174;336;419;195;3;17;399;416
8;Barcelona;24;Osona;08298;Vic;2;5;B;;749;222;446;554;195;6;10;538;548
8;Barcelona;24;Osona;08298;Vic;2;6;A;;583;178;312;366;217;1;14;351;365
8;Barcelona;24;Osona;08298;Vic;2;6;B;;706;208;378;454;252;6;11;437;448
8;Barcelona;24;Osona;08298;Vic;3;1;U;;856;276;571;680;176;4;19;657;676
8;Barcelona;24;Osona;08298;Vic;3;10;U;;644;199;409;490;154;2;16;472;488
8;Barcelona;24;Osona;08298;Vic;3;11;U;;711;247;383;446;265;5;10;431;441
8;Barcelona;24;Osona;08298;Vic;3;12;A;;635;223;413;508;127;3;14;491;505
8;Barcelona;24;Osona;08298;Vic;3;12;B;;777;234;469;581;196;3;23;555;578
8;Barcelona;24;Osona;08298;Vic;3;2;U;;357;120;190;203;154;0;2;201;203
8;Barcelona;24;Osona;08298;Vic;3;3;A;;450;131;248;312;138;5;7;300;307
8;Barcelona;24;Osona;08298;Vic;3;3;B;;372;99;204;252;120;4;7;241;248
8;Barcelona;24;Osona;08298;Vic;3;3;C;;480;153;286;341;139;5;18;318;336
8;Barcelona;24;Osona;08298;Vic;3;4;U;;630;198;353;410;220;2;5;403;408
8;Barcelona;24;Osona;08298;Vic;3;5;A;;467;125;252;286;181;3;9;274;283
8;Barcelona;24;Osona;08298;Vic;3;5;B;;561;155;306;369;192;2;10;357;367
8;Barcelona;24;Osona;08298;Vic;3;6;U;;765;194;404;468;297;4;9;455;464
8;Barcelona;24;Osona;08298;Vic;3;7;A;;800;265;495;582;218;3;19;560;579
8;Barcelona;24;Osona;08298;Vic;3;7;B;;940;309;582;699;241;6;25;668;693
8;Barcelona;24;Osona;08298;Vic;3;8;A;;593;146;274;350;243;0;5;345;350
8;Barcelona;24;Osona;08298;Vic;3;8;B;;584;138;284;338;246;6;9;323;332
8;Barcelona;24;Osona;08298;Vic;3;9;U;;594;206;377;444;150;3;7;434;441
8;Barcelona;24;Osona;08298;Vic;4;1;A;;623;208;360;432;191;1;8;423;431
8;Barcelona;24;Osona;08298;Vic;4;1;B;;680;215;373;458;222;3;16;439;455
8;Barcelona;24;Osona;08298;Vic;4;2;A;;733;182;384;475;258;2;9;464;473
8;Barcelona;24;Osona;08298;Vic;4;2;B;;862;230;464;554;308;8;10;536;546
8;Barcelona;24;Osona;08298;Vic;4;3;U;;899;292;491;617;282;3;18;596;614
8;Barcelona;24;Osona;08298;Vic;4;4;A;;471;141;263;321;150;2;12;307;319
8;Barcelona;24;Osona;08298;Vic;4;4;B;;584;151;308;380;204;6;18;356;374
8;Barcelona;24;Osona;08298;Vic;5;1;U;;555;172;349;429;126;4;10;415;425
17;Girona;24;Osona;17212;Vidrà;1;1;U;;129;41;80;105;24;1;3;101;104
17;Girona;34;Selva;17213;Vidreres;1;1;A;;739;171;361;459;280;1;15;443;458
17;Girona;34;Selva;17213;Vidreres;1;1;B;;755;214;404;466;289;6;18;442;460
17;Girona;34;Selva;17213;Vidreres;1;2;U;;902;188;417;514;388;0;12;502;514
17;Girona;34;Selva;17213;Vidreres;1;3;A;;720;160;329;406;314;8;2;396;398
17;Girona;34;Selva;17213;Vidreres;1;3;B;;758;187;339;435;323;5;9;421;430
17;Girona;34;Selva;17213;Vidreres;1;4;A;;684;109;196;241;443;0;4;237;241
17;Girona;34;Selva;17213;Vidreres;1;4;B;;677;106;197;253;424;1;4;248;252
25;Lleida;39;Consell General d'Aran;25243;Vielha e Mijaran;1;1;A;;529;121;235;282;247;2;15;265;280
25;Lleida;39;Consell General d'Aran;25243;Vielha e Mijaran;1;1;B;;593;114;217;310;283;2;10;298;308
25;Lleida;39;Consell General d'Aran;25243;Vielha e Mijaran;1;2;A;;479;68;210;285;194;1;9;275;284
25;Lleida;39;Consell General d'Aran;25243;Vielha e Mijaran;1;2;B;;419;75;173;225;194;3;7;215;222
25;Lleida;39;Consell General d'Aran;25243;Vielha e Mijaran;1;2;C;;441;69;163;216;225;2;7;207;214
25;Lleida;39;Consell General d'Aran;25243;Vielha e Mijaran;1;3;U;;926;150;347;500;426;7;21;472;493
43;Tarragona;1;Alt Camp;43165;Vilabella;1;1;U;;614;168;370;458;156;4;5;449;454
17;Girona;2;Alt Empordà;17214;Vilabertran;1;1;U;;687;178;359;429;258;5;16;408;424
17;Girona;20;Gironès;17215;Vilablareix;1;1;A;;649;194;374;447;202;3;14;430;444
17;Girona;20;Gironès;17215;Vilablareix;1;1;B;;700;184;391;464;236;8;15;441;456
17;Girona;20;Gironès;17215;Vilablareix;1;1;C;;519;154;314;371;148;2;12;357;369
8;Barcelona;14;Berguedà;08299;Vilada;1;1;U;;454;152;269;314;140;2;11;301;312
17;Girona;2;Alt Empordà;17217;Viladamat;1;1;U;;347;131;210;258;89;4;9;245;254
17;Girona;20;Gironès;17216;Viladasens;1;1;U;;156;56;99;117;39;3;1;113;114
8;Barcelona;11;Baix Llobregat;08301;Viladecans;1;1;U;;967;240;421;519;448;1;29;489;518
8;Barcelona;11;Baix Llobregat;08301;Viladecans;1;10;A;;418;103;198;239;179;0;3;236;239
8;Barcelona;11;Baix Llobregat;08301;Viladecans;1;10;B;;535;137;237;284;251;1;8;275;283
8;Barcelona;11;Baix Llobregat;08301;Viladecans;1;11;A;;570;157;292;360;210;0;11;349;360
8;Barcelona;11;Baix Llobregat;08301;Viladecans;1;11;B;;616;188;355;419;197;1;17;401;418
8;Barcelona;11;Baix Llobregat;08301;Viladecans;1;12;U;;793;184;358;463;330;4;24;435;459
8;Barcelona;11;Baix Llobregat;08301;Viladecans;1;13;U;;913;170;369;495;418;4;13;478;491
8;Barcelona;11;Baix Llobregat;08301;Viladecans;1;14;A;;642;129;264;344;298;1;13;330;343
8;Barcelona;11;Baix Llobregat;08301;Viladecans;1;14;B;;774;178;318;417;357;3;16;398;414
8;Barcelona;11;Baix Llobregat;08301;Viladecans;1;15;U;;545;128;225;278;267;1;8;269;277
8;Barcelona;11;Baix Llobregat;08301;Viladecans;1;2;A;;752;158;310;392;360;1;11;380;391
8;Barcelona;11;Baix Llobregat;08301;Viladecans;1;2;B;;833;167;320;408;425;1;9;398;407
8;Barcelona;11;Baix Llobregat;08301;Viladecans;1;3;A;;870;181;409;513;357;2;16;495;511
8;Barcelona;11;Baix Llobregat;08301;Viladecans;1;3;B;;1010;234;466;568;442;3;21;544;565
8;Barcelona;11;Baix Llobregat;08301;Viladecans;1;4;A;;1051;233;497;627;424;3;19;605;624
8;Barcelona;11;Baix Llobregat;08301;Viladecans;1;4;B;;1111;234;552;705;406;6;18;681;699
8;Barcelona;11;Baix Llobregat;08301;Viladecans;1;5;U;;616;179;293;395;221;2;12;381;393
8;Barcelona;11;Baix Llobregat;08301;Viladecans;1;6;A;;574;156;253;312;262;3;12;297;309
8;Barcelona;11;Baix Llobregat;08301;Viladecans;1;6;B;;701;166;298;393;308;8;9;376;385
8;Barcelona;11;Baix Llobregat;08301;Viladecans;1;7;A;;464;143;236;280;184;0;10;270;280
8;Barcelona;11;Baix Llobregat;08301;Viladecans;1;7;B;;464;141;229;267;197;2;13;252;265
8;Barcelona;11;Baix Llobregat;08301;Viladecans;1;8;U;;911;273;456;534;377;2;13;519;532
8;Barcelona;11;Baix Llobregat;08301;Viladecans;1;9;U;;877;184;392;499;378;7;5;487;492
8;Barcelona;11;Baix Llobregat;08301;Viladecans;2;1;A;;428;109;187;211;217;0;6;205;211
8;Barcelona;11;Baix Llobregat;08301;Viladecans;2;1;B;;573;128;209;251;322;1;4;246;250
8;Barcelona;11;Baix Llobregat;08301;Viladecans;2;10;A;;508;125;229;261;247;0;0;261;261
8;Barcelona;11;Baix Llobregat;08301;Viladecans;2;10;B;;631;155;253;302;329;0;6;296;302
8;Barcelona;11;Baix Llobregat;08301;Viladecans;2;11;U;;818;173;345;422;396;4;12;406;418
8;Barcelona;11;Baix Llobregat;08301;Viladecans;2;12;A;;506;130;203;240;266;3;13;224;237
8;Barcelona;11;Baix Llobregat;08301;Viladecans;2;12;B;;568;130;209;256;312;2;3;251;254
8;Barcelona;11;Baix Llobregat;08301;Viladecans;2;13;A;;487;111;200;246;241;0;11;235;246
8;Barcelona;11;Baix Llobregat;08301;Viladecans;2;13;B;;629;158;267;332;297;3;9;320;329
8;Barcelona;11;Baix Llobregat;08301;Viladecans;2;14;U;;823;168;286;372;451;0;6;366;372
8;Barcelona;11;Baix Llobregat;08301;Viladecans;2;15;A;;697;144;277;354;343;1;14;339;353
8;Barcelona;11;Baix Llobregat;08301;Viladecans;2;15;B;;745;151;302;382;363;6;15;361;376
8;Barcelona;11;Baix Llobregat;08301;Viladecans;2;16;A;;557;110;242;308;249;5;8;295;303
8;Barcelona;11;Baix Llobregat;08301;Viladecans;2;16;B;;728;150;314;385;343;4;13;368;381
8;Barcelona;11;Baix Llobregat;08301;Viladecans;2;17;A;;609;131;252;308;301;2;8;298;306
8;Barcelona;11;Baix Llobregat;08301;Viladecans;2;17;B;;673;140;263;343;330;5;11;327;338
8;Barcelona;11;Baix Llobregat;08301;Viladecans;2;18;U;;727;148;243;313;414;8;11;294;305
8;Barcelona;11;Baix Llobregat;08301;Viladecans;2;19;U;;537;144;254;304;233;1;4;299;303
8;Barcelona;11;Baix Llobregat;08301;Viladecans;2;2;A;;510;109;195;244;266;3;6;235;241
8;Barcelona;11;Baix Llobregat;08301;Viladecans;2;2;B;;534;112;197;250;284;0;9;241;250
8;Barcelona;11;Baix Llobregat;08301;Viladecans;2;20;A;;513;103;228;278;235;2;9;267;276
8;Barcelona;11;Baix Llobregat;08301;Viladecans;2;20;B;;638;158;306;392;246;1;11;380;391
8;Barcelona;11;Baix Llobregat;08301;Viladecans;2;21;U;;880;176;336;422;458;1;5;416;421
8;Barcelona;11;Baix Llobregat;08301;Viladecans;2;22;A;;555;169;264;322;233;2;10;310;320
8;Barcelona;11;Baix Llobregat;08301;Viladecans;2;22;B;;646;177;294;353;293;3;18;332;350
8;Barcelona;11;Baix Llobregat;08301;Viladecans;2;23;A;;417;113;215;263;154;0;5;258;263
8;Barcelona;11;Baix Llobregat;08301;Viladecans;2;23;B;;452;108;218;271;181;0;6;265;271
8;Barcelona;11;Baix Llobregat;08301;Viladecans;2;24;U;;740;149;309;397;343;0;24;373;397
8;Barcelona;11;Baix Llobregat;08301;Viladecans;2;25;A;;596;135;241;298;298;1;9;288;297
8;Barcelona;11;Baix Llobregat;08301;Viladecans;2;25;B;;703;137;279;348;355;2;14;332;346
8;Barcelona;11;Baix Llobregat;08301;Viladecans;2;26;A;;518;121;256;312;206;1;14;297;311
8;Barcelona;11;Baix Llobregat;08301;Viladecans;2;26;B;;603;149;298;373;230;4;13;356;369
8;Barcelona;11;Baix Llobregat;08301;Viladecans;2;27;U;;766;140;310;432;334;0;3;429;432
8;Barcelona;11;Baix Llobregat;08301;Viladecans;2;28;U;;826;176;387;503;323;1;24;478;502
8;Barcelona;11;Baix Llobregat;08301;Viladecans;2;29;A;;686;187;342;430;256;0;12;418;430
8;Barcelona;11;Baix Llobregat;08301;Viladecans;2;29;B;;777;205;410;511;266;1;13;497;510
8;Barcelona;11;Baix Llobregat;08301;Viladecans;2;3;A;;733;189;358;439;294;3;15;421;436
8;Barcelona;11;Baix Llobregat;08301;Viladecans;2;3;B;;794;166;372;479;315;2;21;456;477
8;Barcelona;11;Baix Llobregat;08301;Viladecans;2;4;U;;845;192;358;445;400;0;17;428;445
8;Barcelona;11;Baix Llobregat;08301;Viladecans;2;5;U;;824;214;410;483;341;10;14;459;473
8;Barcelona;11;Baix Llobregat;08301;Viladecans;2;6;A;;473;114;198;231;242;2;8;221;229
8;Barcelona;11;Baix Llobregat;08301;Viladecans;2;6;B;;586;157;244;284;302;4;10;270;280
8;Barcelona;11;Baix Llobregat;08301;Viladecans;2;7;A;;439;116;193;216;223;4;7;205;212
8;Barcelona;11;Baix Llobregat;08301;Viladecans;2;7;B;;533;128;194;232;301;2;8;222;230
8;Barcelona;11;Baix Llobregat;08301;Viladecans;2;8;A;;461;76;178;242;219;3;12;227;239
8;Barcelona;11;Baix Llobregat;08301;Viladecans;2;8;B;;618;120;261;329;289;3;19;307;326
8;Barcelona;11;Baix Llobregat;08301;Viladecans;2;9;A;;520;128;221;260;260;3;9;248;257
8;Barcelona;11;Baix Llobregat;08301;Viladecans;2;9;B;;573;148;259;300;273;2;13;285;298
8;Barcelona;40;Vallès Occidental;08300;Viladecavalls;1;1;A;;489;143;291;355;134;2;16;337;353
8;Barcelona;40;Vallès Occidental;08300;Viladecavalls;1;1;B;;427;126;248;298;129;0;3;295;298
8;Barcelona;40;Vallès Occidental;08300;Viladecavalls;1;1;C;;438;132;252;317;121;3;7;307;314
8;Barcelona;40;Vallès Occidental;08300;Viladecavalls;1;2;A;;346;81;158;189;157;1;11;177;188
8;Barcelona;40;Vallès Occidental;08300;Viladecavalls;1;2;B;;315;67;129;167;148;1;4;162;166
8;Barcelona;40;Vallès Occidental;08300;Viladecavalls;1;2;C;;610;130;259;319;291;1;7;311;318
8;Barcelona;40;Vallès Occidental;08300;Viladecavalls;1;2;D;;401;79;150;196;205;0;6;190;196
8;Barcelona;40;Vallès Occidental;08300;Viladecavalls;1;3;A;;419;96;185;234;185;0;3;231;234
8;Barcelona;40;Vallès Occidental;08300;Viladecavalls;1;3;B;;544;131;257;308;236;0;8;300;308
8;Barcelona;40;Vallès Occidental;08300;Viladecavalls;1;4;U;;704;178;415;476;228;4;21;451;472
8;Barcelona;40;Vallès Occidental;08300;Viladecavalls;1;5;U;;335;88;163;200;135;0;4;196;200
8;Barcelona;40;Vallès Occidental;08300;Viladecavalls;1;6;U;;534;160;281;346;188;0;14;332;346
17;Girona;28;Pla de l'Estany;17218;Vilademuls;1;1;A;;250;80;163;187;63;0;2;185;187
17;Girona;28;Pla de l'Estany;17218;Vilademuls;1;1;B;;309;93;165;203;106;4;4;195;199
17;Girona;24;Osona;17220;Viladrau;1;1;U;;777;302;502;575;202;5;13;557;570
17;Girona;2;Alt Empordà;17221;Vilafant;1;1;A;;454;112;208;247;207;2;10;235;245
17;Girona;2;Alt Empordà;17221;Vilafant;1;1;B;;452;118;227;269;183;7;7;255;262
17;Girona;2;Alt Empordà;17221;Vilafant;1;2;A;;370;102;205;244;126;1;6;237;243
17;Girona;2;Alt Empordà;17221;Vilafant;1;2;B;;367;95;187;223;144;2;1;220;221
17;Girona;2;Alt Empordà;17221;Vilafant;1;3;A;;637;146;307;385;252;2;5;378;383
17;Girona;2;Alt Empordà;17221;Vilafant;1;3;B;;606;123;282;335;271;3;5;327;332
17;Girona;2;Alt Empordà;17221;Vilafant;1;4;A;;573;148;281;359;214;3;13;343;356
17;Girona;2;Alt Empordà;17221;Vilafant;1;4;B;;632;156;320;417;215;2;16;399;415
8;Barcelona;3;Alt Penedès;08305;Vilafranca del Penedès;1;1;A;;524;152;263;325;199;2;15;308;323
8;Barcelona;3;Alt Penedès;08305;Vilafranca del Penedès;1;1;B;;604;176;316;396;208;6;6;384;390
8;Barcelona;3;Alt Penedès;08305;Vilafranca del Penedès;1;2;A;;569;163;310;358;211;2;8;348;356
8;Barcelona;3;Alt Penedès;08305;Vilafranca del Penedès;1;2;B;;567;161;272;338;229;4;15;319;334
8;Barcelona;3;Alt Penedès;08305;Vilafranca del Penedès;1;2;C;;556;140;260;324;232;1;10;313;323
8;Barcelona;3;Alt Penedès;08305;Vilafranca del Penedès;1;3;U;;650;180;316;396;254;3;7;386;393
8;Barcelona;3;Alt Penedès;08305;Vilafranca del Penedès;2;1;A;;426;99;172;219;207;4;3;212;215
8;Barcelona;3;Alt Penedès;08305;Vilafranca del Penedès;2;1;B;;540;133;232;290;250;1;11;278;289
8;Barcelona;3;Alt Penedès;08305;Vilafranca del Penedès;2;1;C;;512;127;211;258;254;3;3;252;255
8;Barcelona;3;Alt Penedès;08305;Vilafranca del Penedès;2;2;U;;921;218;421;519;402;2;13;504;517
8;Barcelona;3;Alt Penedès;08305;Vilafranca del Penedès;2;3;A;;472;151;234;283;189;3;5;275;280
8;Barcelona;3;Alt Penedès;08305;Vilafranca del Penedès;2;3;B;;532;155;265;303;229;4;3;296;299
8;Barcelona;3;Alt Penedès;08305;Vilafranca del Penedès;2;4;A;;525;123;239;289;236;5;4;280;284
8;Barcelona;3;Alt Penedès;08305;Vilafranca del Penedès;2;4;B;;604;162;298;364;240;2;13;349;362
8;Barcelona;3;Alt Penedès;08305;Vilafranca del Penedès;2;5;A;;472;132;252;323;149;3;10;310;320
8;Barcelona;3;Alt Penedès;08305;Vilafranca del Penedès;2;5;B;;490;126;265;334;156;1;4;329;333
8;Barcelona;3;Alt Penedès;08305;Vilafranca del Penedès;2;5;C;;554;167;304;386;168;2;8;376;384
8;Barcelona;3;Alt Penedès;08305;Vilafranca del Penedès;2;6;A;;475;107;214;259;216;5;7;247;254
8;Barcelona;3;Alt Penedès;08305;Vilafranca del Penedès;2;6;B;;599;129;244;311;288;6;11;294;305
8;Barcelona;3;Alt Penedès;08305;Vilafranca del Penedès;2;6;C;;518;121;238;297;221;4;11;282;293
8;Barcelona;3;Alt Penedès;08305;Vilafranca del Penedès;3;1;A;;492;119;224;292;200;2;8;282;290
8;Barcelona;3;Alt Penedès;08305;Vilafranca del Penedès;3;1;B;;605;153;286;371;234;2;10;359;369
8;Barcelona;3;Alt Penedès;08305;Vilafranca del Penedès;3;2;A;;384;111;210;276;108;4;7;265;272
8;Barcelona;3;Alt Penedès;08305;Vilafranca del Penedès;3;2;B;;400;132;224;284;116;1;12;271;283
8;Barcelona;3;Alt Penedès;08305;Vilafranca del Penedès;3;3;A;;753;202;365;467;286;1;16;450;466
8;Barcelona;3;Alt Penedès;08305;Vilafranca del Penedès;3;3;B;;618;184;308;371;247;5;12;354;366
8;Barcelona;3;Alt Penedès;08305;Vilafranca del Penedès;3;3;C;;477;132;235;295;182;3;12;280;292
8;Barcelona;3;Alt Penedès;08305;Vilafranca del Penedès;3;4;A;;511;156;293;355;156;6;10;339;349
8;Barcelona;3;Alt Penedès;08305;Vilafranca del Penedès;3;4;B;;562;166;308;387;175;3;10;374;384
8;Barcelona;3;Alt Penedès;08305;Vilafranca del Penedès;4;1;A;;608;174;336;436;172;0;14;422;436
8;Barcelona;3;Alt Penedès;08305;Vilafranca del Penedès;4;1;B;;711;225;420;507;204;1;13;493;506
8;Barcelona;3;Alt Penedès;08305;Vilafranca del Penedès;4;2;A;;670;188;384;475;195;3;10;462;472
8;Barcelona;3;Alt Penedès;08305;Vilafranca del Penedès;4;2;B;;774;223;429;525;249;7;13;505;518
8;Barcelona;3;Alt Penedès;08305;Vilafranca del Penedès;4;3;A;;561;160;305;377;184;7;6;364;370
8;Barcelona;3;Alt Penedès;08305;Vilafranca del Penedès;4;3;B;;619;202;331;424;195;0;10;414;424
8;Barcelona;3;Alt Penedès;08305;Vilafranca del Penedès;4;4;A;;490;152;264;332;158;3;3;326;329
8;Barcelona;3;Alt Penedès;08305;Vilafranca del Penedès;4;4;B;;626;175;320;409;217;2;11;396;407
8;Barcelona;3;Alt Penedès;08305;Vilafranca del Penedès;4;5;A;;465;149;251;312;153;0;7;305;312
8;Barcelona;3;Alt Penedès;08305;Vilafranca del Penedès;4;5;B;;530;131;292;371;159;1;16;354;370
8;Barcelona;3;Alt Penedès;08305;Vilafranca del Penedès;4;6;A;;415;133;234;289;126;1;4;284;288
8;Barcelona;3;Alt Penedès;08305;Vilafranca del Penedès;4;6;B;;521;162;315;367;154;2;14;351;365
8;Barcelona;3;Alt Penedès;08305;Vilafranca del Penedès;4;7;A;;382;98;202;279;103;2;7;270;277
8;Barcelona;3;Alt Penedès;08305;Vilafranca del Penedès;4;7;B;;479;132;268;345;134;3;17;325;342
8;Barcelona;3;Alt Penedès;08305;Vilafranca del Penedès;4;8;A;;714;184;350;441;273;7;25;409;434
8;Barcelona;3;Alt Penedès;08305;Vilafranca del Penedès;4;8;B;;848;228;420;532;316;5;21;506;527
8;Barcelona;3;Alt Penedès;08305;Vilafranca del Penedès;4;8;C;;681;187;357;448;233;1;19;428;447
25;Lleida;38;Urgell;25244;Vilagrassa;1;1;U;;364;108;220;276;88;0;10;266;276
17;Girona;2;Alt Empordà;17223;Vilajuïga;1;1;A;;402;120;218;268;134;0;9;259;268
17;Girona;2;Alt Empordà;17223;Vilajuïga;1;1;B;;386;94;190;239;147;2;8;229;237
43;Tarragona;37;Terra Alta;43175;Vilalba dels Arcs;1;1;U;;597;120;351;439;158;7;6;426;432
8;Barcelona;41;Vallès Oriental;08306;Vilalba Sasserra;1;1;U;;493;136;255;302;191;0;10;292;302
25;Lleida;5;Alta Ribagorça;25245;Vilaller;1;1;U;;441;105;152;254;187;0;11;243;254
43;Tarragona;36;Tarragonès;43166;Vilallonga del Camp;1;1;A;;444;98;204;262;182;1;6;255;261
43;Tarragona;36;Tarragonès;43166;Vilallonga del Camp;1;1;B;;453;97;190;253;200;2;4;247;251
43;Tarragona;36;Tarragonès;43166;Vilallonga del Camp;1;1;C;;571;121;264;335;236;5;12;318;330
17;Girona;31;Ripollès;17224;Vilallonga de Ter;1;1;U;;359;101;194;247;112;3;9;235;244
17;Girona;2;Alt Empordà;17225;Vilamacolum;1;1;U;;218;61;112;137;81;4;9;124;133
17;Girona;2;Alt Empordà;17226;Vilamalla;1;1;A;;399;91;187;221;178;0;5;216;221
17;Girona;2;Alt Empordà;17226;Vilamalla;1;1;B;;427;96;211;242;185;2;6;234;240
17;Girona;2;Alt Empordà;17227;Vilamaniscle;1;1;U;;107;44;73;85;22;0;3;82;85
25;Lleida;39;Consell General d'Aran;25247;Vilamòs;1;1;U;;148;18;46;66;82;0;2;64;66
17;Girona;2;Alt Empordà;17228;Vilanant;1;1;U;;273;76;162;177;96;0;6;171;177
43;Tarragona;8;Baix Camp;43167;Vilanova d'Escornalbou;1;1;U;;388;106;222;276;112;1;8;267;275
25;Lleida;27;Pla d'Urgell;25248;Vilanova de Bellpuig;1;1;U;;935;196;521;659;276;13;19;627;646
25;Lleida;23;Noguera;25249;Vilanova de l'Aguda;1;1;U;;200;48;122;145;55;2;3;140;143
25;Lleida;33;Segrià;25254;Vilanova de la Barca;1;1;U;;784;175;429;545;239;4;12;529;541
8;Barcelona;6;Anoia;08302;Vilanova del Camí;1;1;A;;418;101;188;231;187;2;3;226;229
8;Barcelona;6;Anoia;08302;Vilanova del Camí;1;1;B;;491;103;200;248;243;1;7;240;247
8;Barcelona;6;Anoia;08302;Vilanova del Camí;1;1;C;;417;110;182;208;209;0;9;199;208
8;Barcelona;6;Anoia;08302;Vilanova del Camí;1;2;A;;602;131;229;289;313;1;8;280;288
8;Barcelona;6;Anoia;08302;Vilanova del Camí;1;2;B;;712;153;277;355;357;5;5;345;350
8;Barcelona;6;Anoia;08302;Vilanova del Camí;1;2;C;;600;126;231;294;306;1;10;283;293
8;Barcelona;6;Anoia;08302;Vilanova del Camí;1;3;A;;699;130;283;357;342;2;16;339;355
8;Barcelona;6;Anoia;08302;Vilanova del Camí;1;3;B;;758;133;339;414;344;3;9;402;411
8;Barcelona;6;Anoia;08302;Vilanova del Camí;1;3;C;;687;145;295;367;320;4;12;351;363
8;Barcelona;6;Anoia;08302;Vilanova del Camí;1;4;A;;627;146;276;334;293;3;13;318;331
8;Barcelona;6;Anoia;08302;Vilanova del Camí;1;4;B;;697;160;313;387;310;2;10;375;385
8;Barcelona;6;Anoia;08302;Vilanova del Camí;1;4;C;;599;128;260;334;265;0;11;323;334
8;Barcelona;6;Anoia;08302;Vilanova del Camí;1;5;A;;596;133;266;339;257;3;13;323;336
8;Barcelona;6;Anoia;08302;Vilanova del Camí;1;5;B;;725;159;318;382;343;2;11;369;380
8;Barcelona;6;Anoia;08302;Vilanova del Camí;1;5;C;;532;121;244;290;242;2;0;288;288
8;Barcelona;41;Vallès Oriental;08902;Vilanova del Vallès;1;1;A;;789;205;384;515;274;3;21;491;512
8;Barcelona;41;Vallès Oriental;08902;Vilanova del Vallès;1;1;B;;848;235;437;560;288;2;15;543;558
8;Barcelona;41;Vallès Oriental;08902;Vilanova del Vallès;1;2;A;;845;261;421;513;332;3;16;494;510
8;Barcelona;41;Vallès Oriental;08902;Vilanova del Vallès;1;2;B;;1042;275;511;628;414;3;21;604;625
25;Lleida;23;Noguera;25250;Vilanova de Meià;1;1;U;;353;88;198;232;121;2;3;227;230
43;Tarragona;16;Conca de Barberà;43168;Vilanova de Prades;1;1;U;;106;32;52;65;41;0;2;63;65
8;Barcelona;24;Osona;08303;Vilanova de Sau;1;1;U;;288;99;177;217;71;1;6;210;216
25;Lleida;33;Segrià;25251;Vilanova de Segrià;1;1;U;;658;167;319;406;252;2;4;400;404
8;Barcelona;17;Garraf;08307;Vilanova i la Geltrú;1;1;A;;849;233;436;537;312;1;11;525;536
8;Barcelona;17;Garraf;08307;Vilanova i la Geltrú;1;1;B;;937;272;469;555;382;7;14;534;548
8;Barcelona;17;Garraf;08307;Vilanova i la Geltrú;1;10;A;;553;171;307;384;169;4;10;370;380
8;Barcelona;17;Garraf;08307;Vilanova i la Geltrú;1;10;B;;533;171;299;362;171;2;8;352;360
8;Barcelona;17;Garraf;08307;Vilanova i la Geltrú;1;11;A;;532;141;254;309;223;2;10;297;307
8;Barcelona;17;Garraf;08307;Vilanova i la Geltrú;1;11;B;;602;153;267;333;269;0;11;322;333
8;Barcelona;17;Garraf;08307;Vilanova i la Geltrú;1;2;U;;905;252;478;597;308;7;10;580;590
8;Barcelona;17;Garraf;08307;Vilanova i la Geltrú;1;3;A;;719;220;396;463;256;0;11;452;463
8;Barcelona;17;Garraf;08307;Vilanova i la Geltrú;1;3;B;;846;257;456;532;314;0;13;519;532
8;Barcelona;17;Garraf;08307;Vilanova i la Geltrú;1;4;U;;721;210;388;462;259;6;7;449;456
8;Barcelona;17;Garraf;08307;Vilanova i la Geltrú;1;5;U;;696;251;404;478;218;5;11;462;473
8;Barcelona;17;Garraf;08307;Vilanova i la Geltrú;1;6;A;;585;165;293;367;218;1;14;352;366
8;Barcelona;17;Garraf;08307;Vilanova i la Geltrú;1;6;B;;633;189;339;395;238;2;9;384;393
8;Barcelona;17;Garraf;08307;Vilanova i la Geltrú;1;7;A;;626;178;295;363;263;1;11;351;362
8;Barcelona;17;Garraf;08307;Vilanova i la Geltrú;1;7;B;;689;171;307;385;304;0;18;367;385
8;Barcelona;17;Garraf;08307;Vilanova i la Geltrú;1;8;A;;838;210;381;488;350;7;9;472;481
8;Barcelona;17;Garraf;08307;Vilanova i la Geltrú;1;8;B;;988;279;474;593;395;2;12;579;591
8;Barcelona;17;Garraf;08307;Vilanova i la Geltrú;1;9;A;;599;169;326;397;202;4;6;387;393
8;Barcelona;17;Garraf;08307;Vilanova i la Geltrú;1;9;B;;704;194;390;487;217;6;19;462;481
8;Barcelona;17;Garraf;08307;Vilanova i la Geltrú;2;1;A;;991;244;498;597;394;4;16;577;593
8;Barcelona;17;Garraf;08307;Vilanova i la Geltrú;2;1;B;;1175;315;668;724;451;4;17;703;720
8;Barcelona;17;Garraf;08307;Vilanova i la Geltrú;2;2;A;;793;216;406;502;291;1;14;487;501
8;Barcelona;17;Garraf;08307;Vilanova i la Geltrú;2;2;B;;861;245;446;549;312;3;16;530;546
8;Barcelona;17;Garraf;08307;Vilanova i la Geltrú;2;3;U;;1058;299;561;684;374;4;20;660;680
8;Barcelona;17;Garraf;08307;Vilanova i la Geltrú;2;4;A;;700;201;366;430;270;4;18;408;426
8;Barcelona;17;Garraf;08307;Vilanova i la Geltrú;2;4;B;;758;209;378;449;309;0;11;438;449
8;Barcelona;17;Garraf;08307;Vilanova i la Geltrú;2;5;U;;458;106;187;226;232;1;10;215;225
8;Barcelona;17;Garraf;08307;Vilanova i la Geltrú;2;6;A;;568;130;256;317;251;4;10;303;313
8;Barcelona;17;Garraf;08307;Vilanova i la Geltrú;2;6;B;;635;163;293;378;257;2;9;367;376
8;Barcelona;17;Garraf;08307;Vilanova i la Geltrú;2;7;A;;794;181;358;436;358;3;8;425;433
8;Barcelona;17;Garraf;08307;Vilanova i la Geltrú;2;7;B;;867;210;391;454;413;0;11;443;454
8;Barcelona;17;Garraf;08307;Vilanova i la Geltrú;3;1;U;;529;148;266;310;219;5;7;298;305
8;Barcelona;17;Garraf;08307;Vilanova i la Geltrú;3;2;U;;938;226;455;553;385;7;22;524;546
8;Barcelona;17;Garraf;08307;Vilanova i la Geltrú;3;3;U;;885;226;429;523;362;6;9;508;517
8;Barcelona;17;Garraf;08307;Vilanova i la Geltrú;3;4;A;;821;228;377;436;385;3;11;422;433
8;Barcelona;17;Garraf;08307;Vilanova i la Geltrú;3;4;B;;978;244;431;504;474;6;10;488;498
8;Barcelona;17;Garraf;08307;Vilanova i la Geltrú;3;5;U;;1049;245;418;510;539;7;13;490;503
8;Barcelona;17;Garraf;08307;Vilanova i la Geltrú;4;1;U;;861;237;470;573;288;8;24;541;565
8;Barcelona;17;Garraf;08307;Vilanova i la Geltrú;4;10;A;;686;144;321;405;281;1;22;382;404
8;Barcelona;17;Garraf;08307;Vilanova i la Geltrú;4;10;B;;830;197;373;479;351;4;16;459;475
8;Barcelona;17;Garraf;08307;Vilanova i la Geltrú;4;11;A;;599;142;238;292;307;1;8;283;291
8;Barcelona;17;Garraf;08307;Vilanova i la Geltrú;4;11;B;;747;189;332;399;348;0;8;391;399
8;Barcelona;17;Garraf;08307;Vilanova i la Geltrú;4;12;A;;505;132;247;333;172;2;13;318;331
8;Barcelona;17;Garraf;08307;Vilanova i la Geltrú;4;12;B;;625;136;293;394;231;2;17;375;392
8;Barcelona;17;Garraf;08307;Vilanova i la Geltrú;4;13;U;;1025;262;502;644;381;3;30;611;641
8;Barcelona;17;Garraf;08307;Vilanova i la Geltrú;4;14;A;;592;162;304;369;223;2;12;355;367
8;Barcelona;17;Garraf;08307;Vilanova i la Geltrú;4;14;B;;764;168;355;451;313;4;11;436;447
8;Barcelona;17;Garraf;08307;Vilanova i la Geltrú;4;15;A;;565;161;283;362;203;1;18;343;361
8;Barcelona;17;Garraf;08307;Vilanova i la Geltrú;4;15;B;;704;172;360;447;257;0;16;431;447
8;Barcelona;17;Garraf;08307;Vilanova i la Geltrú;4;16;U;;900;111;235;282;618;1;6;275;281
8;Barcelona;17;Garraf;08307;Vilanova i la Geltrú;4;2;U;;568;147;285;362;206;1;10;351;361
8;Barcelona;17;Garraf;08307;Vilanova i la Geltrú;4;3;U;;598;111;212;305;293;4;5;296;301
8;Barcelona;17;Garraf;08307;Vilanova i la Geltrú;4;4;A;;560;164;269;321;239;0;11;310;321
8;Barcelona;17;Garraf;08307;Vilanova i la Geltrú;4;4;B;;705;200;331;404;301;3;18;383;401
8;Barcelona;17;Garraf;08307;Vilanova i la Geltrú;4;5;A;;634;184;322;391;243;3;19;369;388
8;Barcelona;17;Garraf;08307;Vilanova i la Geltrú;4;5;B;;731;207;395;468;263;3;14;451;465
8;Barcelona;17;Garraf;08307;Vilanova i la Geltrú;4;6;A;;569;163;282;342;227;4;14;324;338
8;Barcelona;17;Garraf;08307;Vilanova i la Geltrú;4;6;B;;750;217;356;420;330;2;6;412;418
8;Barcelona;17;Garraf;08307;Vilanova i la Geltrú;4;7;A;;762;180;336;425;337;0;17;408;425
8;Barcelona;17;Garraf;08307;Vilanova i la Geltrú;4;7;B;;985;231;394;528;457;3;22;503;525
8;Barcelona;17;Garraf;08307;Vilanova i la Geltrú;4;7;C;;795;174;342;406;389;1;6;399;405
8;Barcelona;17;Garraf;08307;Vilanova i la Geltrú;4;8;U;;699;196;326;366;333;5;9;352;361
8;Barcelona;17;Garraf;08307;Vilanova i la Geltrú;4;9;U;;834;237;418;497;337;4;14;479;493
43;Tarragona;8;Baix Camp;43169;Vilaplana;1;1;U;;481;117;312;377;104;7;10;360;370
43;Tarragona;1;Alt Camp;43170;Vila-rodona;1;1;U;;883;237;470;583;300;2;19;562;581
17;Girona;2;Alt Empordà;17230;Vila-sacra;1;1;U;;445;148;281;315;130;2;9;304;313
25;Lleida;27;Pla d'Urgell;25252;Vila-sana;1;1;U;;532;116;283;360;172;2;11;347;358
43;Tarragona;36;Tarragonès;43171;Vila-seca;1;1;A;;667;147;288;378;289;5;6;367;373
43;Tarragona;36;Tarragonès;43171;Vila-seca;1;1;B;;836;175;363;500;336;2;15;483;498
43;Tarragona;36;Tarragonès;43171;Vila-seca;1;1;C;;485;105;239;282;203;0;3;279;282
43;Tarragona;36;Tarragonès;43171;Vila-seca;1;10;A;;481;80;176;229;252;1;4;224;228
43;Tarragona;36;Tarragonès;43171;Vila-seca;1;10;B;;583;115;233;297;286;2;8;287;295
43;Tarragona;36;Tarragonès;43171;Vila-seca;1;11;A;;608;118;235;319;289;1;12;306;318
43;Tarragona;36;Tarragonès;43171;Vila-seca;1;11;B;;700;135;272;375;325;0;17;358;375
43;Tarragona;36;Tarragonès;43171;Vila-seca;1;2;A;;738;124;272;364;374;0;4;360;364
43;Tarragona;36;Tarragonès;43171;Vila-seca;1;2;B;;940;175;398;523;417;3;8;512;520
43;Tarragona;36;Tarragonès;43171;Vila-seca;1;3;A;;363;72;142;175;188;0;12;163;175
43;Tarragona;36;Tarragonès;43171;Vila-seca;1;3;B;;478;104;190;241;237;1;5;235;240
43;Tarragona;36;Tarragonès;43171;Vila-seca;1;4;A;;303;89;156;205;98;2;2;201;203
43;Tarragona;36;Tarragonès;43171;Vila-seca;1;4;B;;340;93;183;225;115;2;5;218;223
43;Tarragona;36;Tarragonès;43171;Vila-seca;1;5;A;;491;134;231;282;209;0;7;275;282
43;Tarragona;36;Tarragonès;43171;Vila-seca;1;5;B;;538;144;243;301;237;2;6;293;299
43;Tarragona;36;Tarragonès;43171;Vila-seca;1;6;A;;522;138;239;300;222;1;8;291;299
43;Tarragona;36;Tarragonès;43171;Vila-seca;1;6;B;;601;146;240;318;283;1;4;313;317
43;Tarragona;36;Tarragonès;43171;Vila-seca;1;7;A;;606;110;220;296;310;1;7;288;295
43;Tarragona;36;Tarragonès;43171;Vila-seca;1;7;B;;674;137;238;320;354;0;12;308;320
43;Tarragona;36;Tarragonès;43171;Vila-seca;1;8;A;;795;144;263;319;476;0;7;312;319
43;Tarragona;36;Tarragonès;43171;Vila-seca;1;8;B;;834;148;243;282;552;1;3;278;281
43;Tarragona;36;Tarragonès;43171;Vila-seca;1;9;A;;468;84;182;247;221;0;5;242;247
43;Tarragona;36;Tarragonès;43171;Vila-seca;1;9;B;;653;148;278;352;301;1;12;339;351
8;Barcelona;21;Maresme;08214;Vilassar de Dalt;1;1;A;;512;142;270;350;162;2;8;340;348
8;Barcelona;21;Maresme;08214;Vilassar de Dalt;1;1;B;;545;160;290;377;168;0;7;370;377
8;Barcelona;21;Maresme;08214;Vilassar de Dalt;1;2;U;;755;202;355;427;328;3;9;415;424
8;Barcelona;21;Maresme;08214;Vilassar de Dalt;1;3;A;;529;137;259;324;205;3;10;311;321
8;Barcelona;21;Maresme;08214;Vilassar de Dalt;1;3;B;;600;173;316;370;230;1;7;362;369
8;Barcelona;21;Maresme;08214;Vilassar de Dalt;1;4;A;;479;131;276;335;144;1;11;323;334
8;Barcelona;21;Maresme;08214;Vilassar de Dalt;1;4;B;;571;131;310;377;194;1;16;360;376
8;Barcelona;21;Maresme;08214;Vilassar de Dalt;2;1;A;;721;185;395;495;226;0;10;485;495
8;Barcelona;21;Maresme;08214;Vilassar de Dalt;2;1;B;;930;271;501;623;307;0;12;611;623
8;Barcelona;21;Maresme;08214;Vilassar de Dalt;2;2;A;;533;131;290;350;183;6;9;335;344
8;Barcelona;21;Maresme;08214;Vilassar de Dalt;2;2;B;;564;162;304;378;186;2;8;368;376
8;Barcelona;21;Maresme;08219;Vilassar de Mar;1;1;U;;709;193;400;492;217;2;18;472;490
8;Barcelona;21;Maresme;08219;Vilassar de Mar;1;2;A;;582;176;328;404;178;3;11;390;401
8;Barcelona;21;Maresme;08219;Vilassar de Mar;1;2;B;;775;249;469;543;232;2;18;523;541
8;Barcelona;21;Maresme;08219;Vilassar de Mar;1;3;A;;604;210;342;405;199;2;8;395;403
8;Barcelona;21;Maresme;08219;Vilassar de Mar;1;3;B;;778;236;432;518;260;2;12;504;516
8;Barcelona;21;Maresme;08219;Vilassar de Mar;1;4;A;;575;146;298;378;197;2;24;352;376
8;Barcelona;21;Maresme;08219;Vilassar de Mar;1;4;B;;661;201;366;465;196;5;18;442;460
8;Barcelona;21;Maresme;08219;Vilassar de Mar;1;5;A;;468;121;253;313;155;0;14;299;313
8;Barcelona;21;Maresme;08219;Vilassar de Mar;1;5;B;;501;129;249;316;185;3;10;303;313
8;Barcelona;21;Maresme;08219;Vilassar de Mar;1;6;A;;459;158;271;324;135;4;9;311;320
8;Barcelona;21;Maresme;08219;Vilassar de Mar;1;6;B;;498;160;301;358;140;1;11;346;357
8;Barcelona;21;Maresme;08219;Vilassar de Mar;2;1;U;;878;231;471;606;272;7;19;580;599
8;Barcelona;21;Maresme;08219;Vilassar de Mar;2;2;U;;910;270;553;660;250;4;23;633;656
8;Barcelona;21;Maresme;08219;Vilassar de Mar;2;3;U;;869;257;477;582;287;4;17;561;578
8;Barcelona;21;Maresme;08219;Vilassar de Mar;2;4;U;;897;231;485;628;269;2;28;598;626
8;Barcelona;21;Maresme;08219;Vilassar de Mar;2;5;U;;947;270;560;688;259;3;19;666;685
8;Barcelona;21;Maresme;08219;Vilassar de Mar;3;1;A;;470;143;254;312;158;0;10;302;312
8;Barcelona;21;Maresme;08219;Vilassar de Mar;3;1;B;;547;149;293;354;193;1;7;346;353
8;Barcelona;21;Maresme;08219;Vilassar de Mar;3;2;U;;852;234;462;579;273;2;22;555;577
8;Barcelona;21;Maresme;08219;Vilassar de Mar;3;3;U;;764;184;353;443;321;1;13;429;442
8;Barcelona;21;Maresme;08219;Vilassar de Mar;3;4;U;;737;182;322;405;332;1;5;399;404
17;Girona;2;Alt Empordà;17222;Vilaür;1;1;U;;111;36;64;79;32;1;2;76;78
43;Tarragona;16;Conca de Barberà;43172;Vilaverd;1;1;U;;366;126;225;276;90;3;6;267;273
43;Tarragona;29;Priorat;43173;Vilella Alta, la;1;1;U;;109;23;52;73;36;0;1;72;73
43;Tarragona;29;Priorat;43174;Vilella Baixa, la;1;1;U;;147;43;82;113;34;0;6;107;113
17;Girona;34;Selva;17233;Vilobí d'Onyar;1;1;U;;675;216;386;467;208;5;11;451;462
17;Girona;34;Selva;17233;Vilobí d'Onyar;1;2;A;;792;259;430;527;265;7;14;506;520
17;Girona;34;Selva;17233;Vilobí d'Onyar;1;2;B;;719;207;403;491;228;6;15;470;485
8;Barcelona;3;Alt Penedès;08304;Vilobí del Penedès;1;1;U;;823;205;454;550;273;1;20;529;549
17;Girona;10;Baix Empordà;17232;Vilopriu;1;1;U;;153;45;77;103;50;1;4;98;102
25;Lleida;18;Garrigues;25253;Vilosell, el;1;1;U;;170;50;99;123;47;0;0;123;123
43;Tarragona;16;Conca de Barberà;43176;Vimbodí i Poblet;1;1;U;;851;220;446;561;290;6;8;547;555
25;Lleida;18;Garrigues;25255;Vinaixa;1;1;U;;487;96;235;322;165;7;3;312;315
43;Tarragona;30;Ribera d'Ebre;43177;Vinebre;1;1;U;;326;72;189;235;91;6;2;227;229
43;Tarragona;8;Baix Camp;43178;Vinyols i els Arcs;1;1;A;;918;251;510;644;274;5;13;626;639
43;Tarragona;8;Baix Camp;43178;Vinyols i els Arcs;1;1;B;;348;121;179;216;132;4;6;206;212
8;Barcelona;14;Berguedà;08308;Viver i Serrateix;1;1;U;;155;52;88;120;35;0;0;120;120
43;Tarragona;9;Baix Ebre;43052;Xerta;1;1;A;;508;107;267;355;153;8;12;335;347
43;Tarragona;9;Baix Ebre;43052;Xerta;1;1;B;;498;126;253;336;162;7;10;319;329
8;Barcelona;98;Residents Absents;08998;Residents Absents;1;1;U;;102655; ; ;14503;88152;80;129;14294;14423
17;Girona;98;Residents Absents;17998;Residents Absents;1;1;U;;9742; ; ;948;8794;2;11;935;946
25;Lleida;98;Residents Absents;25998;Residents Absents;1;1;U;;11415; ; ;1097;10318;4;6;1087;1093
43;Tarragona;98;Residents Absents;43998;Residents Absents;1;1;U;;10003; ; ;887;9116;8;10;869;879
