CODIGO;MUNICIPIO;CENSO;ABSTENCIONES;VOTOS;NULOS;VALIDOS;BLANCOS;A_CANDID;PSOE;UPN;AP-PDP-UL;HB;PNV;AUZOLAN;P_CARL;EE;PCE;LC
000;Total Navarra;379692;110650;269042;3135;265907;1826;264081;94737;62072;37554;28055;18161;8356;6733;6292;1712;409
001;Abáigar;91;19;72;0;72;1;71;21;30;4;1;7;4;1;3;0;0
002;Abárzuza;433;123;310;3;307;10;297;36;93;63;45;39;6;10;5;0;0
003;Abaurregaina/Abaurrea Alta;182;65;117;0;117;0;117;70;6;8;18;4;8;0;2;0;1
004;Abaurrepea/Abaurrea Baja;55;27;28;0;28;0;28;10;1;10;0;2;2;2;1;0;0
005;Aberin;307;57;250;2;248;3;245;61;74;54;35;9;1;9;2;0;0
006;Ablitas;1804;423;1381;36;1345;21;1324;611;432;142;24;12;14;65;12;9;3
007;Adiós;123;49;74;1;73;0;73;19;36;7;5;2;0;4;0;0;0
008;Aguilar de Codés;162;20;142;0;142;2;140;32;34;62;3;0;1;4;3;1;0
009;Aibar <> Oibar;811;229;582;4;578;11;567;200;165;57;79;16;27;8;8;3;4
010;Altsasu/Alsasua;5385;1792;3593;41;3552;33;3519;1701;336;203;566;384;231;11;62;21;4
011;Allín;723;391;332;2;330;0;330;86;103;92;21;5;8;7;2;2;4
012;Allo;1034;502;532;15;517;6;511;295;89;72;8;12;8;6;17;3;1
013;Améscoa Baja;901;338;563;0;563;12;551;130;262;61;38;10;18;15;13;4;0
014;Ancín;246;90;156;0;156;3;153;29;50;55;2;11;0;4;2;0;0
015;Andosilla;1925;535;1390;19;1371;11;1360;680;411;84;96;19;14;12;36;6;2
016;Ansoáin;6682;2258;4424;52;4372;16;4356;2513;341;225;632;148;254;62;79;93;9
017;Anue;371;130;241;5;236;2;234;35;78;34;34;45;3;2;3;0;0
018;Añorbe;387;99;288;3;285;2;283;105;79;33;21;4;10;14;13;3;1
019;Aoiz <> Agoitz;1347;304;1043;21;1022;5;1017;181;293;63;178;240;32;12;18;0;0
020;Araitz;688;315;373;2;371;2;369;18;150;27;105;57;4;0;7;1;0
021;Aranarache;91;30;61;0;61;0;61;19;21;6;9;2;2;1;1;0;0
022;Arantza;566;43;523;3;520;3;517;11;11;29;277;189;0;0;0;0;0
023;Aranguren;850;166;684;5;679;6;673;244;190;78;76;26;25;10;20;4;0
024;Arano;157;61;96;0;96;0;96;4;3;10;14;59;0;0;4;1;1
025;Arakil;2132;630;1502;16;1486;6;1480;381;333;268;305;88;61;17;21;1;5
026;Aras;236;32;204;0;204;0;204;39;74;26;4;1;0;58;2;0;0
027;Arbizu;645;121;524;8;516;0;516;10;45;38;137;201;79;3;3;0;0
028;Arce <> Artzi;221;133;88;0;88;1;87;12;36;11;8;9;10;1;0;0;0
029;Los Arcos;1279;290;989;20;969;8;961;388;255;157;67;25;9;36;14;6;4
030;Arellano;212;33;179;1;178;0;178;77;15;12;34;17;4;11;5;3;0
031;Areso;257;85;172;6;166;0;166;7;73;15;29;35;2;1;4;0;0
032;Arguedas;2013;597;1416;20;1396;7;1389;866;309;89;51;9;34;19;8;4;0
033;Aria;72;39;33;0;33;1;32;7;7;11;3;3;1;0;0;0;0
034;Aribe;60;7;53;0;53;1;52;22;13;4;5;7;0;0;1;0;0
035;Armañanzas;136;23;113;5;108;0;108;36;55;7;6;0;1;3;0;0;0
036;Arróniz;1141;202;939;33;906;8;898;354;282;86;94;17;14;29;16;3;3
037;Arruazu;114;26;88;3;85;0;85;6;24;11;12;28;1;2;1;0;0
038;Artajona;1370;264;1106;19;1087;8;1079;356;323;122;89;16;10;143;15;2;3
039;Artazu;103;31;72;1;71;2;69;18;24;12;9;2;2;2;0;0;0
040;Atez;175;81;94;10;84;0;84;16;19;23;12;8;5;0;0;1;0
041;Ayegui;521;112;409;1;408;2;406;77;124;42;75;52;7;19;9;1;0
042;Azagra;2511;303;2208;25;2183;7;2176;973;986;57;36;10;6;19;9;80;0
043;Azuelo;93;34;59;0;59;1;58;12;40;5;1;0;0;0;0;0;0
044;Bakaiku;281;97;184;1;183;1;182;17;28;20;71;35;0;5;6;0;0
045;Barásoain;383;58;325;2;323;0;323;99;105;35;21;6;14;29;14;0;0
046;Barbarin;117;13;104;4;100;2;98;14;44;13;2;8;2;12;2;1;0
047;Bargota;397;69;328;6;322;4;318;46;52;46;38;31;5;96;4;0;0
048;Barillas;159;24;135;3;132;0;132;34;43;42;4;2;3;3;1;0;0
049;Basaburua;732;133;599;3;596;6;590;49;155;54;197;111;5;6;13;0;0
050;Baztan;6419;1830;4589;69;4520;44;4476;487;1620;501;477;1106;82;29;168;5;1
051;Beire;325;110;215;0;215;0;215;69;42;50;19;7;3;17;8;0;0
052;Belascoáin;63;3;60;1;59;0;59;10;20;21;1;0;0;1;5;0;1
053;Berbinzana;629;140;489;2;487;0;487;188;159;28;60;8;12;3;11;5;13
054;Bertizarana;477;139;338;1;337;0;337;77;46;34;20;127;6;11;15;1;0
055;Betelu;289;116;173;3;170;2;168;16;30;20;18;77;2;1;3;0;1
056;Biurrun-Olcoz;163;63;100;1;99;0;99;14;25;22;10;7;4;15;2;0;0
057;Buñuel;1971;410;1561;14;1547;14;1533;690;350;425;23;10;12;13;8;1;1
058;Auritz/Burguete;272;70;202;3;199;3;196;28;54;37;13;45;12;3;3;1;0
059;Burgui <> Burgi;258;123;135;0;135;0;135;59;26;17;25;2;3;0;3;0;0
060;Burlada <> Burlata;9655;3631;6024;113;5911;35;5876;2714;1099;533;717;306;250;78;116;54;9
061;El Busto;124;21;103;0;103;0;103;34;49;9;6;3;0;2;0;0;0
062;Cabanillas;1123;308;815;6;809;10;799;398;114;196;17;15;27;21;7;4;0
063;Cabredo;160;45;115;3;112;1;111;25;22;48;1;7;2;2;4;0;0
064;Cadreita;1470;229;1241;7;1234;10;1224;517;77;520;36;22;22;5;23;2;0
065;Caparroso;1911;406;1505;26;1479;31;1448;466;444;378;29;12;27;8;73;9;2
066;Cárcar;1048;155;893;8;885;3;882;386;429;43;8;1;3;6;3;2;1
067;Carcastillo;2068;434;1634;15;1619;12;1607;400;314;455;29;347;15;33;10;2;2
068;Cascante;2721;658;2063;11;2052;20;2032;880;466;356;82;9;48;157;15;19;0
069;Cáseda;960;128;832;8;824;4;820;253;336;91;41;10;63;11;14;0;1
070;Castejón;2591;657;1934;24;1910;13;1897;1285;144;208;25;6;18;11;11;184;5
071;Castillo-Nuevo;24;8;16;0;16;0;16;9;4;3;0;0;0;0;0;0;0
072;Cintruénigo;3878;796;3082;37;3045;13;3032;1053;1686;125;75;34;22;14;11;7;5
073;Ziordia;337;149;188;3;185;1;184;53;8;27;46;32;9;4;4;1;0
074;Cirauqui;463;91;372;8;364;3;361;74;72;17;62;11;7;91;25;1;1
075;Ciriza;52;15;37;0;37;0;37;6;15;12;0;0;1;1;2;0;0
076;Cizur;8477;2912;5565;64;5501;23;5478;2324;999;568;605;298;374;94;179;29;8
077;Corella;4805;1206;3599;15;3584;22;3562;1525;665;1207;68;36;18;17;22;3;1
078;Cortes;2482;596;1886;17;1869;31;1838;932;350;374;89;9;29;21;19;14;1
079;Desojo;168;50;118;0;118;1;117;22;47;26;3;7;1;10;1;0;0
080;Dicastillo;695;184;511;4;507;8;499;188;124;96;27;8;1;24;28;3;0
081;Donamaria;311;74;237;5;232;4;228;21;22;20;74;72;9;2;7;1;0
082;Etxalar;694;243;451;7;444;0;444;54;54;89;97;127;6;2;15;0;0
083;Echarri;25;1;24;0;24;0;24;0;1;10;2;0;0;11;0;0;0
084;Etxarri-Aranatz;1679;438;1241;2;1239;6;1233;84;196;64;443;375;17;33;21;0;0
085;Etxauri;299;49;250;1;249;2;247;26;56;34;70;22;20;17;1;1;0
086;Egüés;731;270;461;6;455;2;453;115;117;120;31;19;10;19;22;0;0
087;Elgorriaga;153;27;126;7;119;1;118;14;26;8;28;40;0;0;2;0;0
088;Noáin (Valle de Elorz) <> Noain (Elortzibar);2045;618;1427;11;1416;8;1408;699;305;158;121;18;39;31;23;10;4
089;Enériz;151;32;119;0;119;0;119;39;45;17;4;2;7;5;0;0;0
090;Eratsun;181;68;113;0;113;0;113;5;11;10;16;62;4;3;1;1;0
091;Ergoiena;504;122;382;2;380;6;374;63;25;4;153;67;14;38;8;2;0
092;Erro;782;418;364;7;357;3;354;65;103;84;39;38;10;7;8;0;0
093;Ezcároz <> Ezkaroze;335;78;257;1;256;0;256;187;38;14;8;1;3;5;0;0;0
094;Eslava;211;58;153;3;150;1;149;39;67;26;4;1;5;1;4;2;0
095;Esparza de Salazar <> Espartza Zaraitzu;155;53;102;3;99;0;99;46;13;3;12;7;8;2;6;2;0
096;Espronceda;211;26;185;1;184;0;184;53;106;11;10;2;1;0;1;0;0
097;Estella <> Lizarra;9026;2874;6152;79;6073;24;6049;1946;1492;627;792;588;150;288;157;8;1
098;Esteribar;1199;385;814;5;809;10;799;198;183;164;128;54;21;33;16;2;0
099;Etayo;104;20;84;1;83;0;83;22;13;16;6;16;2;5;3;0;0
100;Eulate;352;126;226;2;224;0;224;52;95;50;3;4;13;2;4;0;1
101;Ezcabarte;662;256;406;6;400;5;395;125;103;56;55;24;4;20;5;2;1
102;Ezkurra;227;47;180;2;178;3;175;30;25;38;49;22;3;6;2;0;0
103;Ezprogui;69;9;60;0;60;1;59;14;29;13;0;1;1;0;0;1;0
104;Falces;2429;856;1573;25;1548;16;1532;589;440;237;112;30;38;51;21;12;2
105;Fitero;1830;302;1528;16;1512;13;1499;552;229;661;18;6;4;17;6;6;0
106;Fontellas;367;24;343;5;338;0;338;212;41;75;4;0;3;3;0;0;0
107;Funes;1596;374;1222;0;1222;15;1207;410;423;308;10;16;7;22;7;4;0
108;Fustiñana;1824;523;1301;19;1282;9;1273;442;383;303;41;1;19;61;12;5;6
109;Galar;2582;806;1776;28;1748;12;1736;835;338;199;134;30;78;58;46;12;6
110;Gallipienzo;124;27;97;1;96;0;96;32;46;2;9;0;6;0;0;1;0
111;Gallués <> Galoze;124;34;90;0;90;0;90;26;33;10;6;6;0;5;4;0;0
112;Garaioa;144;31;113;0;113;0;113;18;34;20;12;24;3;1;0;0;1
113;Garde;199;31;168;1;167;5;162;53;62;16;11;3;5;2;10;0;0
114;Garínoain;236;30;206;4;202;1;201;53;79;24;4;7;16;12;3;3;0
115;Garralda;226;32;194;5;189;1;188;15;80;31;34;16;11;0;1;0;0
116;Genevilla;136;31;105;0;105;1;104;18;24;30;15;15;0;1;1;0;0
117;Goizueta;874;407;467;3;464;0;464;14;20;4;326;78;12;2;8;0;0
118;Goñi;182;78;104;0;104;0;104;30;23;28;13;2;2;4;2;0;0
119;Güesa <> Gorza;103;34;69;1;68;0;68;20;36;3;1;1;3;1;3;0;0
120;Guesálaz;459;156;303;2;301;5;296;67;93;59;35;16;5;16;5;0;0
121;Guirguillano;68;17;51;3;48;2;46;13;20;4;2;0;1;6;0;0;0
122;Huarte <> Uharte;2085;484;1601;19;1582;7;1575;439;343;182;310;136;87;37;33;5;3
123;Uharte-Arakil;661;247;414;2;412;10;402;81;80;46;46;119;8;17;3;2;0
124;Ibargoiti;137;48;89;1;88;0;88;11;41;19;3;2;5;4;3;0;0
125;Igúzquiza;276;106;170;0;170;1;169;46;71;18;2;9;1;20;2;0;0
126;Imotz;392;134;258;1;257;1;256;17;38;19;66;107;4;1;4;0;0
127;Irañeta;133;42;91;2;89;0;89;18;29;19;10;4;1;4;4;0;0
128;Isaba <> Izaba;554;83;471;0;471;4;467;141;143;43;54;24;24;1;14;21;2
129;Ituren;355;81;274;1;273;2;271;4;25;7;71;158;6;0;0;0;0
130;Iturmendi;327;87;240;2;238;7;231;56;60;33;40;22;4;6;10;0;0
131;Iza;437;134;303;8;295;4;291;65;75;52;50;22;6;15;5;1;0
132;Izagaondoa;132;44;88;0;88;0;88;16;49;13;3;2;2;1;1;1;0
133;Izalzu <> Itzaltzu;49;19;30;0;30;0;30;23;2;1;3;0;1;0;0;0;0
134;Jaurrieta;305;83;222;0;222;1;221;101;62;22;16;3;13;1;3;0;0
135;Javier;169;34;135;0;135;2;133;12;91;19;0;7;0;2;2;0;0
136;Juslapeña;335;158;177;2;175;3;172;52;42;30;24;9;7;4;3;1;0
137;Labaien;277;130;147;3;144;0;144;17;33;43;19;20;3;4;4;0;1
138;Lakuntza;759;159;600;17;583;6;577;90;75;24;185;159;35;0;8;0;1
139;Lana;233;135;98;3;95;0;95;31;20;30;3;3;2;0;4;2;0
140;Lantz;125;45;80;0;80;0;80;7;9;23;7;27;2;3;2;0;0
141;Lapoblación;173;45;128;3;125;0;125;6;47;67;0;4;1;0;0;0;0
142;Larraga;1499;511;988;18;970;7;963;247;171;180;247;6;8;88;11;1;4
143;Larraona;173;59;114;1;113;0;113;27;48;23;1;10;2;2;0;0;0
144;Larraun;1651;528;1123;13;1110;7;1103;59;345;97;249;284;31;21;16;1;0
145;Lazagurría;207;33;174;2;172;1;171;83;70;12;1;0;0;5;0;0;0
146;Leache;74;18;56;0;56;2;54;22;14;12;3;0;1;0;2;0;0
147;Legarda;86;27;59;0;59;1;58;13;24;5;1;4;4;5;2;0;0
148;Legaria;161;33;128;10;118;2;116;30;34;27;10;3;2;5;4;1;0
149;Leitza;2268;624;1644;17;1627;7;1620;83;409;77;543;437;31;15;24;1;0
150;Leoz;129;16;113;0;113;1;112;36;16;38;0;3;3;9;7;0;0
151;Lerga;151;45;106;0;106;0;106;30;43;6;16;1;1;7;1;1;0
152;Lerín;1846;537;1309;16;1293;16;1277;620;266;166;71;37;33;35;37;6;6
153;Lesaka;2164;558;1606;17;1589;9;1580;150;220;65;360;689;46;9;38;1;2
154;Lezáun;291;153;138;3;135;1;134;32;22;30;25;9;2;4;9;1;0
155;Liédena;321;51;270;5;265;1;264;118;78;33;4;9;7;8;5;1;1
156;Lizoáin;176;50;126;0;126;2;124;25;44;26;14;3;3;6;3;0;0
157;Lodosa;3317;894;2423;20;2403;10;2393;1253;527;412;93;46;19;6;26;9;2
158;Lónguida <> Longida;290;65;225;0;225;2;223;36;73;35;48;12;1;13;5;0;0
159;Lumbier;1242;268;974;9;965;8;957;136;363;114;133;49;33;120;7;2;0
160;Luquin;152;36;116;1;115;3;112;36;17;30;14;1;2;6;4;2;0
161;Mañeru;347;64;283;5;278;0;278;118;64;14;22;11;10;31;7;1;0
162;Marañón;91;14;77;1;76;0;76;22;16;25;6;1;1;2;3;0;0
163;Marcilla;1966;572;1394;21;1373;20;1353;629;362;162;40;89;18;18;24;9;2
164;Mélida;799;122;677;4;673;8;665;333;11;287;6;17;5;1;5;0;0
165;Mendavia;2730;556;2174;51;2123;11;2112;985;686;148;18;6;6;9;101;149;4
166;Mendaza;456;96;360;2;358;8;350;121;99;83;18;1;9;10;6;3;0
167;Mendigorría;809;151;658;7;651;5;646;193;194;136;68;3;14;30;7;1;0
168;Metauten;334;98;236;1;235;1;234;78;58;42;13;15;6;13;4;1;4
169;Milagro;1965;341;1624;4;1620;11;1609;759;527;283;18;4;2;5;8;2;1
170;Mirafuentes;73;22;51;0;51;1;50;16;15;17;1;1;0;0;0;0;0
171;Miranda de Arga;902;211;691;7;684;16;668;322;113;84;31;38;7;36;31;4;2
172;Monreal;229;62;167;1;166;2;164;45;59;44;4;1;0;7;3;0;1
173;Monteagudo;908;97;811;5;806;6;800;384;272;125;7;3;4;0;1;4;0
174;Morentin;124;25;99;0;99;0;99;33;41;15;0;5;0;3;1;0;1
175;Mués;175;46;129;4;125;2;123;19;71;17;4;6;1;3;2;0;0
176;Murchante;2172;381;1791;38;1753;16;1737;723;422;118;35;9;392;28;7;3;0
177;Murieta;217;83;134;0;134;3;131;34;48;20;4;7;0;16;1;1;0
178;Murillo el Cuende;458;103;355;5;350;4;346;152;34;146;5;3;2;1;0;3;0
179;Murillo el Fruto;769;234;535;6;529;8;521;213;98;127;26;23;5;13;4;3;9
180;Muruzábal;184;50;134;1;133;1;132;15;85;16;5;3;2;4;0;1;1
181;Navascués;286;141;145;1;144;0;144;42;57;12;21;2;2;3;5;0;0
182;Nazar;61;11;50;0;50;1;49;17;13;4;3;2;0;8;1;1;0
183;Obanos;560;106;454;4;450;9;441;115;202;38;38;16;14;11;7;0;0
184;Oco;81;16;65;0;65;0;65;18;30;3;4;4;2;4;0;0;0
185;Ochagavía <> Otsagabia;636;108;528;3;525;2;523;80;244;37;87;35;31;4;3;1;1
186;Odieta;273;112;161;1;160;1;159;33;31;21;21;34;3;13;2;0;1
187;Oitz;128;42;86;0;86;0;86;8;1;9;28;37;2;0;1;0;0
188;Oláibar;130;24;106;0;106;0;106;17;47;12;6;20;1;2;1;0;0
189;Olazti/Olazagutía;1497;447;1050;14;1036;20;1016;402;85;25;247;109;59;18;59;7;5
190;Olejua;78;24;54;0;54;3;51;13;14;12;6;2;0;4;0;0;0
191;Olite;2295;513;1782;26;1756;13;1743;561;484;283;100;195;28;43;44;4;1
192;Olóriz;137;37;100;4;96;2;94;28;41;4;4;3;0;10;4;0;0
193;Cendea de Olza <> Oltza Zendea;1497;385;1112;5;1107;8;1099;374;277;128;195;34;45;13;28;1;4
194;Ollo;301;126;175;0;175;0;175;54;40;38;16;8;5;10;4;0;0
195;Orbaitzeta;249;58;191;2;189;3;186;52;63;13;30;16;8;0;3;1;0
196;Orbara;71;18;53;2;51;0;51;15;9;9;11;4;3;0;0;0;0
197;Orísoain;65;11;54;0;54;2;52;18;13;9;6;0;4;1;0;0;1
198;Oronz <> Orontze;63;22;41;4;37;0;37;18;8;3;5;2;0;0;1;0;0
199;Oroz-Betelu;273;119;154;2;152;0;152;59;34;18;20;12;0;4;4;0;1
200;Oteiza;828;298;530;5;525;5;520;228;100;32;94;10;24;21;11;0;0
201;Pamplona <> Iruña;128772;42145;86627;869;85758;461;85297;29418;19155;11949;10705;5928;3432;1695;2497;395;123
202;Peralta;3316;577;2739;24;2715;22;2693;1023;449;747;79;33;80;85;174;15;8
203;Petilla de Aragón;67;26;41;0;41;0;41;24;13;1;2;0;0;0;1;0;0
204;Piedramillera;102;16;86;0;86;0;86;19;21;27;3;3;3;3;7;0;0
205;Pitillas;594;204;390;8;382;5;377;182;88;61;13;8;1;15;7;2;0
206;Puente la Reina <> Gares;1499;259;1240;24;1216;8;1208;225;517;59;162;40;41;150;10;4;0
207;Pueyo;285;47;238;9;229;2;227;47;106;20;32;4;11;4;3;0;0
208;Ribaforada;2302;441;1861;21;1840;18;1822;1005;122;446;62;11;20;21;90;28;17
209;Romanzado;161;72;89;1;88;1;87;20;26;21;6;2;1;11;0;0;0
210;Roncal <> Erronkari;348;80;268;1;267;2;265;72;98;36;22;6;14;7;10;0;0
211;Orreaga/Roncesvalles;38;9;29;0;29;1;28;3;15;6;0;4;0;0;0;0;0
212;Sada;304;129;175;1;174;1;173;41;82;34;4;4;3;0;3;0;2
213;Saldias;138;32;106;6;100;14;86;7;11;9;17;36;2;3;0;1;0
214;Salinas de Oro;98;28;70;1;69;0;69;4;22;15;11;8;3;4;1;1;0
215;San Adrián;3341;606;2735;43;2692;23;2669;1691;281;538;33;29;13;26;32;23;3
216;Sangüesa <> Zangoza;3576;875;2701;18;2683;16;2667;653;1393;124;130;55;51;165;89;5;2
217;San Martín de Unx;575;169;406;11;395;4;391;83;215;37;25;9;4;6;11;1;0
219;Sansol;159;37;122;0;122;2;120;48;40;8;4;9;2;5;2;1;1
220;Santacara;917;172;745;14;731;3;728;320;132;233;7;9;5;6;14;1;1
221;Doneztebe/Santesteban;785;103;682;10;672;15;657;75;214;28;32;274;17;7;9;0;1
222;Sarriés <> Sartze;101;31;70;0;70;1;69;21;27;8;6;1;3;3;0;0;0
223;Sartaguda;1125;166;959;3;956;5;951;480;19;287;151;1;4;2;6;1;0
224;Sesma;1377;245;1132;10;1122;14;1108;505;280;198;53;20;5;18;24;4;1
225;Sorlada;80;20;60;0;60;0;60;19;28;4;0;1;4;4;0;0;0
226;Sunbilla;569;144;425;4;421;1;420;31;106;19;87;174;1;1;0;0;1
227;Tafalla;7483;2102;5381;105;5276;11;5265;1794;962;633;800;306;48;321;383;9;9
228;Tiebas-Muruarte de Reta;452;114;338;3;335;3;332;112;101;60;14;9;6;27;1;0;2
229;Tirapu;57;10;47;1;46;3;43;8;8;20;5;2;0;0;0;0;0
230;Torralba del Río;173;48;125;1;124;0;124;26;60;26;6;1;2;1;1;0;1
231;Torres del Río;210;72;138;1;137;3;134;31;70;19;7;1;3;3;0;0;0
232;Tudela;18288;4824;13464;189;13275;90;13185;6705;1879;2557;569;102;431;477;190;240;35
233;Tulebras;93;11;82;1;81;0;81;28;34;13;1;4;1;0;0;0;0
234;Úcar;105;34;71;1;70;0;70;19;18;10;6;5;4;2;5;0;1
235;Ujué;342;84;258;1;257;0;257;63;106;24;36;3;10;5;6;2;2
236;Ultzama;1343;420;923;22;901;11;890;154;247;168;122;132;37;12;18;0;0
237;Unciti;159;35;124;0;124;2;122;29;54;17;4;1;4;8;4;1;0
238;Unzué;106;21;85;0;85;3;82;25;22;10;3;7;7;4;4;0;0
239;Urdazubi/Urdax;393;134;259;6;253;0;253;13;78;81;6;64;6;3;2;0;0
240;Urdiain;595;274;321;1;320;5;315;67;24;36;97;67;6;2;15;1;0
241;Urraúl Alto;138;65;73;0;73;0;73;10;35;14;5;5;3;0;1;0;0
242;Urraúl Bajo;290;86;204;5;199;0;199;29;92;26;12;14;16;8;2;0;0
243;Urroz-Villa;303;88;215;2;213;0;213;65;81;27;23;6;1;5;5;0;0
244;Urrotz;180;60;120;2;118;4;114;11;45;20;13;18;3;1;3;0;0
245;Urzainqui <> Urzainki;131;45;86;1;85;0;85;42;27;5;7;1;1;1;1;0;0
246;Uterga;113;31;82;2;80;0;80;21;27;7;3;3;0;17;1;1;0
247;Uztárroz <> Uztarroze;323;104;219;0;219;7;212;47;76;21;44;2;11;4;7;0;0
248;Luzaide/Valcarlos;440;61;379;9;370;4;366;88;67;54;47;87;8;5;9;0;1
249;Valtierra;2053;386;1667;14;1653;7;1646;1048;285;245;15;12;4;8;21;4;4
250;Bera/Vera de Bidasoa;2489;820;1669;12;1657;14;1643;320;230;132;346;493;37;11;68;2;4
251;Viana;2591;615;1976;26;1950;7;1943;367;1053;147;198;25;14;126;10;2;1
252;Vidángoz <> Bidankoze;127;57;70;0;70;0;70;23;31;2;10;2;1;0;1;0;0
253;Bidaurreta;122;26;96;1;95;1;94;16;16;12;11;8;25;3;3;0;0
254;Villafranca;2183;426;1757;17;1740;8;1732;825;450;188;177;29;12;12;25;14;0
255;Villamayor de Monjardín;101;28;73;3;70;5;65;8;9;37;6;0;4;0;1;0;0
256;Hiriberri/Villanueva de Aezkoa;171;75;96;2;94;0;94;37;14;11;19;8;3;0;2;0;0
257;Villatuerta;576;265;311;1;310;1;309;129;100;19;25;12;3;17;1;2;1
258;Villava <> Atarrabia;4351;1529;2822;31;2791;16;2775;1020;467;200;414;239;138;211;63;17;6
259;Igantzi;464;83;381;9;372;2;370;96;79;31;43;93;17;0;11;0;0
260;Valle de Yerri <> Deierri;1388;685;703;6;697;4;693;149;239;176;61;17;13;34;4;0;0
261;Yesa;256;31;225;7;218;1;217;87;86;20;0;15;0;1;8;0;0
262;Zabalza;118;28;90;3;87;0;87;10;37;15;4;5;5;8;3;0;0
263;Zubieta;300;91;209;2;207;0;207;14;59;19;41;43;10;2;19;0;0
264;Zugarramurdi;232;110;122;9;113;0;113;38;27;10;16;12;2;2;5;0;1
265;Zúñiga;127;18;109;1;108;1;107;27;13;28;14;10;4;0;11;0;0
